0.PE2-PESTF_0.1	14916	14918		YPO_RS01080	2
0.PE2-PESTF_0.1	106581	106588		YPO_RS01520	7
0.PE2-PESTF_0.1	401010	401047		YPO_RS02925	37
0.PE2-PESTF_0.1	467303	467381		YPO_RS03220	78
0.PE2-PESTF_0.1	797110	797236		YPO_RS04665	126
0.PE2-PESTF_0.1	797547	798037		YPO_RS04665	490
0.PE2-PESTF_0.1	798592	798728		YPO_RS04670	136
0.PE2-PESTF_0.1	798909	799561		YPO_RS04670	652
0.PE2-PESTF_0.1	799684	799705		YPO_RS04670	21
0.PE2-PESTF_0.1	800017	801294		fliD	1277
0.PE2-PESTF_0.1	801304	801684		fliS	380
0.PE2-PESTF_0.1	801686	802012		YPO_RS04685	326
0.PE2-PESTF_0.1	802014	803195		YPO_RS04690	1181
0.PE2-PESTF_0.1	803234	803704		YPO_RS04695	470
0.PE2-PESTF_0.1	803710	804405		YPO_RS04700	695
0.PE2-PESTF_0.1	804421	805287		motA	866
0.PE2-PESTF_0.1	805287	806198		lafU	911
0.PE2-PESTF_0.1	806658	807254		YPO_RS04715	596
0.PE2-PESTF_0.1	807251	807706		YPO_RS04720	455
0.PE2-PESTF_0.1	807690	808061		YPO_RS04725	371
0.PE2-PESTF_0.1	808939	809241		YPO_RS04735	302
0.PE2-PESTF_0.1	811232	812249		YPO_RS04745	1017
0.PE2-PESTF_0.1	812543	813562		YPO_RS04750	1019
0.PE2-PESTF_0.1	813844	815214		YPO_RS04755	1370
0.PE2-PESTF_0.1	815394	815807		YPO_RS04760	413
0.PE2-PESTF_0.1	816351	816737		YPO_RS04765	386
0.PE2-PESTF_0.1	816868	821184		YPO_RS04770	4316
0.PE2-PESTF_0.1	821198	822517		YPO_RS04775	1319
0.PE2-PESTF_0.1	822543	824768		vgrG	2225
0.PE2-PESTF_0.1	830118	831461		gntP	1343
0.PE2-PESTF_0.1	833001	833399		YPO_RS04795	398
0.PE2-PESTF_0.1	833835	834710		YPO_RS04800	875
0.PE2-PESTF_0.1	835033	836790		YPO_RS04805	1757
0.PE2-PESTF_0.1	836783	838555		YPO_RS04810	1772
0.PE2-PESTF_0.1	838555	839859		YPO_RS04815	1304
0.PE2-PESTF_0.1	839849	840613		YPO_RS04820	764
0.PE2-PESTF_0.1	840606	841733		YPO_RS04825	1127
0.PE2-PESTF_0.1	841730	842806		YPO_RS04830	1076
0.PE2-PESTF_0.1	842803	848622		YPO_RS04835	5819
0.PE2-PESTF_0.1	848635	850323		YPO_RS04840	1688
0.PE2-PESTF_0.1	850331	856789		YPO_RS04845	6458
0.PE2-PESTF_0.1	1071549	1071743		YPO_RS05785	194
0.PE2-PESTF_0.1	1071907	1072254		YPO_RS05790	347
0.PE2-PESTF_0.1	1072398	1074620		YPO_RS05795	2222
0.PE2-PESTF_0.1	1074635	1074720		YPO_RS05800	85
0.PE2-PESTF_0.1	1074923	1074926		YPO_RS05800	3
0.PE2-PESTF_0.1	1075059	1075182		YPO_RS05800	123
0.PE2-PESTF_0.1	1085925	1085926		tssB	1
0.PE2-PESTF_0.1	1086030	1086136		tssB	106
0.PE2-PESTF_0.1	1109070	1111436		YPO_RS05920	2366
0.PE2-PESTF_0.1	1111440	1111637		YPO_RS05925	197
0.PE2-PESTF_0.1	1112076	1113353		YPO_RS05930	1277
0.PE2-PESTF_0.1	1113366	1116485		YPO_RS05935	3119
0.PE2-PESTF_0.1	1116620	1118110		YPO_RS05940	1490
0.PE2-PESTF_0.1	1118388	1118975		YPO_RS05945	587
0.PE2-PESTF_0.1	1119829	1130946		yapH	11117
0.PE2-PESTF_0.1	1131049	1132929		YPO_RS05955	1880
0.PE2-PESTF_0.1	1133325	1133411		YPO_RS05960	86
0.PE2-PESTF_0.1	1133492	1134367		YPO_RS05965	875
0.PE2-PESTF_0.1	1134575	1136392		YPO_RS05970	1817
0.PE2-PESTF_0.1	1137111	1138667		YPO_RS05975	1556
0.PE2-PESTF_0.1	1138745	1139977		pepT	1232
0.PE2-PESTF_0.1	1140365	1142437		YPO_RS05985	2072
0.PE2-PESTF_0.1	1217391	1217402		YPO_RS06325	11
0.PE2-PESTF_0.1	1218461	1218462		YPO_RS06330	1
0.PE2-PESTF_0.1	1220120	1220121		YPO_RS06340	1
0.PE2-PESTF_0.1	1221219	1221220		YPO_RS06340	1
0.PE2-PESTF_0.1	1221601	1221602		YPO_RS06340	1
0.PE2-PESTF_0.1	1659299	1659311		tssK	12
0.PE2-PESTF_0.1	1668237	1668238		YPO_RS08350	1
0.PE2-PESTF_0.1	1904870	1904873		yapJ	3
0.PE2-PESTF_0.1	2237353	2237380		YPO_RS10835	27
0.PE2-PESTF_0.1	2434882	2435008		selD	126
0.PE2-PESTF_0.1	2505131	2505133		osmB	2
0.PE2-PESTF_0.1	2520343	2520404		rsxC	61
0.PE2-PESTF_0.1	2550507	2550543		YPO_RS12340	36
0.PE2-PESTF_0.1	2554373	2554633		YPO_RS12355	260
0.PE2-PESTF_0.1	2554658	2555065		YPO_RS12360	407
0.PE2-PESTF_0.1	2555162	2555608		YPO_RS12365	446
0.PE2-PESTF_0.1	2555780	2556832		YPO_RS12370	1052
0.PE2-PESTF_0.1	2556844	2557161		YPO_RS12375	317
0.PE2-PESTF_0.1	2557164	2557415		YPO_RS12380	251
0.PE2-PESTF_0.1	2557451	2557684		YPO_RS12385	233
0.PE2-PESTF_0.1	2557749	2559461		YPO_RS12390	1712
0.PE2-PESTF_0.1	2559474	2559761		YPO_RS12395	287
0.PE2-PESTF_0.1	2559765	2560790		YPO_RS12400	1025
0.PE2-PESTF_0.1	2560790	2562034		YPO_RS12405	1244
0.PE2-PESTF_0.1	2562123	2562371		YPO_RS12410	248
0.PE2-PESTF_0.1	2562568	2562765		YPO_RS12415	197
0.PE2-PESTF_0.1	2898280	2898285		YPO_RS13845	5
0.PE2-PESTF_0.1	2973846	2973850		proW	4
0.PE2-PESTF_0.1	3058043	3058503		YPO_RS14610	460
0.PE2-PESTF_0.1	3236861	3236888		hscA	27
0.PE2-PESTF_0.1	3332112	3332118		YPO_RS15865	6
0.PE2-PESTF_0.1	3649935	3649936		YPO_RS17290	1
0.PE2-PESTF_0.1	3757221	3757288		YPO_RS17810	67
0.PE2-PESTF_0.1	4017866	4017867		YPO_RS19000	1
0.PE2-PESTF_0.1	4176218	4176220		YPO_RS19645	2
0.PE2-PESTF_0.1	4194695	4194700		YPO_RS19740	5
0.PE2-PESTF_0.1	4223143	4223145		YPO_RS19870	2
0.PE2-PESTF_0.1	4385874	4385877		YPO_RS20660	3
0.PE2-PESTF_0.1	4389732	4389734		YPO_RS20670	2
ABI745_HiSeqL5L6	582	584		mioC	2
ABI745_HiSeqL5L6	4948	4951		ravA	3
ABI745_HiSeqL5L6	11271	11276		YPO_RS01060	5
ABI745_HiSeqL5L6	14440	14446		YPO_RS01080	6
ABI745_HiSeqL5L6	14918	14919		YPO_RS01080	1
ABI745_HiSeqL5L6	18096	18111		YPO_RS01090	15
ABI745_HiSeqL5L6	26154	26163		YPO_RS01125	9
ABI745_HiSeqL5L6	29240	29242		hemN	2
ABI745_HiSeqL5L6	30032	30035		hemN	3
ABI745_HiSeqL5L6	35542	35544		typA	2
ABI745_HiSeqL5L6	36912	36921		typA	9
ABI745_HiSeqL5L6	37714	37723		yihX	9
ABI745_HiSeqL5L6	39360	39385		YPO_RS01180	25
ABI745_HiSeqL5L6	39522	39523		YPO_RS01180	1
ABI745_HiSeqL5L6	39924	39931		YPO_RS01180	7
ABI745_HiSeqL5L6	39998	40000		YPO_RS01180	2
ABI745_HiSeqL5L6	40206	40240		YPO_RS01185	34
ABI745_HiSeqL5L6	40626	40634		YPO_RS01185	8
ABI745_HiSeqL5L6	40765	40792		YPO_RS01185	27
ABI745_HiSeqL5L6	40924	40976		YPO_RS01185	52
ABI745_HiSeqL5L6	41064	41082		YPO_RS01185	18
ABI745_HiSeqL5L6	48869	48885		recG	16
ABI745_HiSeqL5L6	48926	48938		recG	12
ABI745_HiSeqL5L6	50765	50800		spoT	35
ABI745_HiSeqL5L6	54150	54171		ligB	21
ABI745_HiSeqL5L6	54408	54411		ligB	3
ABI745_HiSeqL5L6	59622	59632		slmA	10
ABI745_HiSeqL5L6	61797	61806		YPO_RS01280	9
ABI745_HiSeqL5L6	63433	63436		mutM	3
ABI745_HiSeqL5L6	67095	67116		rfaC	21
ABI745_HiSeqL5L6	74747	74748		envC	1
ABI745_HiSeqL5L6	75284	75287		gpmM	3
ABI745_HiSeqL5L6	76086	76091		gpmM	5
ABI745_HiSeqL5L6	78330	78352		gpsA	22
ABI745_HiSeqL5L6	78952	78953		gpsA	1
ABI745_HiSeqL5L6	84779	84782		YPO_RS01405	3
ABI745_HiSeqL5L6	85709	85712		YPO_RS01420	3
ABI745_HiSeqL5L6	89895	89898		YPO_RS01435	3
ABI745_HiSeqL5L6	92817	92830		YPO_RS01445	13
ABI745_HiSeqL5L6	94464	94486		YPO_RS01455	22
ABI745_HiSeqL5L6	97927	97934		YPO_RS01475	7
ABI745_HiSeqL5L6	99207	99212		fpr	5
ABI745_HiSeqL5L6	105908	105991		YPO_RS01515	83
ABI745_HiSeqL5L6	106071	106119		YPO_RS01515	48
ABI745_HiSeqL5L6	106166	106239		YPO_RS01515	73
ABI745_HiSeqL5L6	106368	106370		YPO_RS01515	2
ABI745_HiSeqL5L6	106473	106498		YPO_RS01520	25
ABI745_HiSeqL5L6	106533	106544		YPO_RS01520	11
ABI745_HiSeqL5L6	106705	106744		YPO_RS01520	39
ABI745_HiSeqL5L6	106867	106876		YPO_RS01520	9
ABI745_HiSeqL5L6	106915	106920		YPO_RS01520	5
ABI745_HiSeqL5L6	106969	107003		YPO_RS01520	34
ABI745_HiSeqL5L6	107048	107066		YPO_RS01520	18
ABI745_HiSeqL5L6	107264	107266		YPO_RS01520	2
ABI745_HiSeqL5L6	107304	107308		YPO_RS01520	4
ABI745_HiSeqL5L6	112267	112276		YPO_RS01550	9
ABI745_HiSeqL5L6	117717	117719		priA	2
ABI745_HiSeqL5L6	118532	118544		priA	12
ABI745_HiSeqL5L6	121827	121861		metJ	34
ABI745_HiSeqL5L6	123484	123500		YPO_RS01600	16
ABI745_HiSeqL5L6	124594	124595		YPO_RS01600	1
ABI745_HiSeqL5L6	124790	124800		YPO_RS01600	10
ABI745_HiSeqL5L6	125006	125024		YPO_RS01600	18
ABI745_HiSeqL5L6	127139	127165		YPO_RS01610	26
ABI745_HiSeqL5L6	127243	127246		YPO_RS01610	3
ABI745_HiSeqL5L6	127296	127298		YPO_RS01610	2
ABI745_HiSeqL5L6	127409	127421		YPO_RS01610	12
ABI745_HiSeqL5L6	127498	127522		YPO_RS01610	24
ABI745_HiSeqL5L6	127908	127934		YPO_RS01610	26
ABI745_HiSeqL5L6	129152	129157		YPO_RS01615	5
ABI745_HiSeqL5L6	132954	132957		malT	3
ABI745_HiSeqL5L6	136920	136924		malQ	4
ABI745_HiSeqL5L6	145474	145477		YPO_RS01685	3
ABI745_HiSeqL5L6	145587	145592		YPO_RS01685	5
ABI745_HiSeqL5L6	152274	152275		pckA	1
ABI745_HiSeqL5L6	155054	155072		YPO_RS01725	18
ABI745_HiSeqL5L6	155906	155924		YPO_RS01725	18
ABI745_HiSeqL5L6	156894	156901		YPO_RS01725	7
ABI745_HiSeqL5L6	159514	159525		mrcA	11
ABI745_HiSeqL5L6	163651	163658		hofQ	7
ABI745_HiSeqL5L6	167905	167924		YPO_RS01775	19
ABI745_HiSeqL5L6	170120	170132		rpe	12
ABI745_HiSeqL5L6	171235	171238		trpS	3
ABI745_HiSeqL5L6	172493	172502		cobA	9
ABI745_HiSeqL5L6	173034	173047		cobA	13
ABI745_HiSeqL5L6	175898	175903		YPO_RS01815	5
ABI745_HiSeqL5L6	177499	177511		YPO_RS01815	12
ABI745_HiSeqL5L6	178371	178380		YPO_RS01820	9
ABI745_HiSeqL5L6	183391	183398		YPO_RS01835	7
ABI745_HiSeqL5L6	183561	183570		YPO_RS01835	9
ABI745_HiSeqL5L6	187206	187224		YPO_RS01850	18
ABI745_HiSeqL5L6	187429	187434		YPO_RS01850	5
ABI745_HiSeqL5L6	188329	188334		YPO_RS01850	5
ABI745_HiSeqL5L6	188540	188559		YPO_RS01850	19
ABI745_HiSeqL5L6	189363	189368		YPO_RS01855	5
ABI745_HiSeqL5L6	190282	190283		YPO_RS01865	1
ABI745_HiSeqL5L6	190842	190863		YPO_RS01865	21
ABI745_HiSeqL5L6	190905	190936		YPO_RS01865	31
ABI745_HiSeqL5L6	191245	191247		YPO_RS01870	2
ABI745_HiSeqL5L6	191311	191318		YPO_RS01870	7
ABI745_HiSeqL5L6	191495	191504		YPO_RS01870	9
ABI745_HiSeqL5L6	191645	191676		YPO_RS01870	31
ABI745_HiSeqL5L6	193144	193145		YPO_RS01880	1
ABI745_HiSeqL5L6	194784	194786		YPO_RS01880	2
ABI745_HiSeqL5L6	195201	195208		crp	7
ABI745_HiSeqL5L6	199727	199735		YPO_RS01915	8
ABI745_HiSeqL5L6	200858	200861		tauA	3
ABI745_HiSeqL5L6	203571	203573		tauD	2
ABI745_HiSeqL5L6	205196	205200		YPO_RS01945	4
ABI745_HiSeqL5L6	208656	208665		kefG	9
ABI745_HiSeqL5L6	209156	209186		kefB	30
ABI745_HiSeqL5L6	209492	209508		kefB	16
ABI745_HiSeqL5L6	215763	215765		rpsG	2
ABI745_HiSeqL5L6	217858	217861		fusA	3
ABI745_HiSeqL5L6	224555	224558		rpsS	3
ABI745_HiSeqL5L6	225110	225115		rpsC	5
ABI745_HiSeqL5L6	227024	227032		rplN	8
ABI745_HiSeqL5L6	227483	227491		rplX	8
ABI745_HiSeqL5L6	227506	227509		rplE	3
ABI745_HiSeqL5L6	227879	227880		rplE	1
ABI745_HiSeqL5L6	231390	231395		secY	5
ABI745_HiSeqL5L6	232963	232983		rpsK	20
ABI745_HiSeqL5L6	234041	234044		rpoA	3
ABI745_HiSeqL5L6	234447	234448		rpoA	1
ABI745_HiSeqL5L6	236447	236453		YPO_RS02185	6
ABI745_HiSeqL5L6	241072	241077		def	5
ABI745_HiSeqL5L6	241684	241687		dprA	3
ABI745_HiSeqL5L6	245928	245984		YPO_RS02245	56
ABI745_HiSeqL5L6	246255	246271		YPO_RS02245	16
ABI745_HiSeqL5L6	246308	246330		YPO_RS02245	22
ABI745_HiSeqL5L6	246404	246416		YPO_RS02245	12
ABI745_HiSeqL5L6	246609	246615		YPO_RS02250	6
ABI745_HiSeqL5L6	246692	246717		YPO_RS02250	25
ABI745_HiSeqL5L6	247038	247043		YPO_RS02250	5
ABI745_HiSeqL5L6	247149	247163		YPO_RS02250	14
ABI745_HiSeqL5L6	247329	247447		YPO_RS02250	118
ABI745_HiSeqL5L6	247483	247497		YPO_RS02250	14
ABI745_HiSeqL5L6	249006	249025		actP	19
ABI745_HiSeqL5L6	251861	251863		acs	2
ABI745_HiSeqL5L6	253964	253982		gltP	18
ABI745_HiSeqL5L6	255588	255591		YPO_RS02280	3
ABI745_HiSeqL5L6	258473	258476		YPO_RS02285	3
ABI745_HiSeqL5L6	265731	265736		YPO_RS02340	5
ABI745_HiSeqL5L6	267764	267766		YPO_RS02345	2
ABI745_HiSeqL5L6	267844	267859		YPO_RS02345	15
ABI745_HiSeqL5L6	268799	268810		YPO_RS02345	11
ABI745_HiSeqL5L6	275272	275273		yedF	1
ABI745_HiSeqL5L6	277916	277918		metC	2
ABI745_HiSeqL5L6	279451	279465		YPO_RS02410	14
ABI745_HiSeqL5L6	280834	280861		YPO_RS02415	27
ABI745_HiSeqL5L6	281332	281351		YPO_RS02420	19
ABI745_HiSeqL5L6	281417	281452		YPO_RS02420	35
ABI745_HiSeqL5L6	283421	283426		YPO_RS02430	5
ABI745_HiSeqL5L6	285631	285634		YPO_RS02440	3
ABI745_HiSeqL5L6	285679	285682		YPO_RS02440	3
ABI745_HiSeqL5L6	287166	287180		YPO_RS02450	14
ABI745_HiSeqL5L6	287939	287952		YPO_RS02450	13
ABI745_HiSeqL5L6	289623	289637		YPO_RS02460	14
ABI745_HiSeqL5L6	299100	299123		YPO_RS02510	23
ABI745_HiSeqL5L6	300883	300892		YPO_RS02520	9
ABI745_HiSeqL5L6	302128	302132		YPO_RS02525	4
ABI745_HiSeqL5L6	302993	303002		YPO_RS02530	9
ABI745_HiSeqL5L6	304118	304132		YPO_RS02530	14
ABI745_HiSeqL5L6	307731	307733		YPO_RS02550	2
ABI745_HiSeqL5L6	311486	311506		YPO_RS02555	20
ABI745_HiSeqL5L6	312769	312783		yapK	14
ABI745_HiSeqL5L6	313228	313234		yapK	6
ABI745_HiSeqL5L6	313564	313567		yapK	3
ABI745_HiSeqL5L6	314212	314238		yapK	26
ABI745_HiSeqL5L6	322138	322141		lexA	3
ABI745_HiSeqL5L6	325381	325386		YPO_RS02605	5
ABI745_HiSeqL5L6	325771	325772		YPO_RS02605	1
ABI745_HiSeqL5L6	327616	327620		dnaB	4
ABI745_HiSeqL5L6	332265	332267		uvrA	2
ABI745_HiSeqL5L6	332311	332317		uvrA	6
ABI745_HiSeqL5L6	334997	334998		ssb1	1
ABI745_HiSeqL5L6	335064	335065		ssb1	1
ABI745_HiSeqL5L6	336426	336427		fucO	1
ABI745_HiSeqL5L6	336910	336915		fucO	5
ABI745_HiSeqL5L6	336955	336983		fucO	28
ABI745_HiSeqL5L6	340016	340040		rhaB	24
ABI745_HiSeqL5L6	341846	341858		rhaS	12
ABI745_HiSeqL5L6	342164	342176		rhaR	12
ABI745_HiSeqL5L6	342477	342496		rhaR	19
ABI745_HiSeqL5L6	343258	343260		rhaT	2
ABI745_HiSeqL5L6	343481	343512		rhaT	31
ABI745_HiSeqL5L6	343597	343610		rhaT	13
ABI745_HiSeqL5L6	346044	346052		YPO_RS02695	8
ABI745_HiSeqL5L6	347461	347507		YPO_RS02695	46
ABI745_HiSeqL5L6	351965	351967		aegA	2
ABI745_HiSeqL5L6	353598	353602		fdhF	4
ABI745_HiSeqL5L6	356770	356787		cutA	17
ABI745_HiSeqL5L6	357963	357967		YPO_RS02735	4
ABI745_HiSeqL5L6	365212	365228		epmB	16
ABI745_HiSeqL5L6	366953	366970		YPO_RS02780	17
ABI745_HiSeqL5L6	367835	367842		frdD	7
ABI745_HiSeqL5L6	369988	369995		frdA	7
ABI745_HiSeqL5L6	371041	371054		YPO_RS02805	13
ABI745_HiSeqL5L6	376525	376533		psd	8
ABI745_HiSeqL5L6	377481	377493		rsgA	12
ABI745_HiSeqL5L6	377875	377881		rsgA	6
ABI745_HiSeqL5L6	383900	383917		amiB	17
ABI745_HiSeqL5L6	385274	385289		mutL	15
ABI745_HiSeqL5L6	385939	385968		mutL	29
ABI745_HiSeqL5L6	386633	386634		mutL	1
ABI745_HiSeqL5L6	389075	389086		hflX	11
ABI745_HiSeqL5L6	390461	390463		hflK	2
ABI745_HiSeqL5L6	392485	392514		YPO_RS02890	29
ABI745_HiSeqL5L6	401040	401063		YPO_RS02925	23
ABI745_HiSeqL5L6	401397	401570		YPO_RS02930	173
ABI745_HiSeqL5L6	401745	401753		YPO_RS02930	8
ABI745_HiSeqL5L6	401891	401893		YPO_RS02930	2
ABI745_HiSeqL5L6	401893	401900		YPO_RS02935	7
ABI745_HiSeqL5L6	401987	402023		YPO_RS02935	36
ABI745_HiSeqL5L6	402176	402257		YPO_RS02935	81
ABI745_HiSeqL5L6	402868	402869		YPO_RS02935	1
ABI745_HiSeqL5L6	403092	403102		YPO_RS02940	10
ABI745_HiSeqL5L6	403472	403493		YPO_RS02940	21
ABI745_HiSeqL5L6	403668	403689		YPO_RS02940	21
ABI745_HiSeqL5L6	410364	410398		YPO_RS02965	34
ABI745_HiSeqL5L6	410888	410891		YPO_RS02965	3
ABI745_HiSeqL5L6	413822	413836		YPO_RS02985	14
ABI745_HiSeqL5L6	415834	415852		YPO_RS02990	18
ABI745_HiSeqL5L6	421766	421768		ptsP	2
ABI745_HiSeqL5L6	422026	422029		ptsP	3
ABI745_HiSeqL5L6	422786	422787		ptsP	1
ABI745_HiSeqL5L6	423091	423100		ptsP	9
ABI745_HiSeqL5L6	424445	424448		YPO_RS03030	3
ABI745_HiSeqL5L6	425574	425594		lsrF	20
ABI745_HiSeqL5L6	428522	428526		lsrD	4
ABI745_HiSeqL5L6	429020	429021		lsrC	1
ABI745_HiSeqL5L6	429695	429701		lsrA	6
ABI745_HiSeqL5L6	429746	429752		lsrA	6
ABI745_HiSeqL5L6	433550	433557		lsrK	7
ABI745_HiSeqL5L6	435834	435846		YPO_RS03085	12
ABI745_HiSeqL5L6	438293	438300		YPO_RS03095	7
ABI745_HiSeqL5L6	438638	438647		YPO_RS03095	9
ABI745_HiSeqL5L6	446134	446141		YPO_RS03120	7
ABI745_HiSeqL5L6	446249	446259		YPO_RS03120	10
ABI745_HiSeqL5L6	450246	450255		prfC	9
ABI745_HiSeqL5L6	450970	450985		prfC	15
ABI745_HiSeqL5L6	452904	452907		YPO_RS03165	3
ABI745_HiSeqL5L6	453304	453312		YPO_RS03165	8
ABI745_HiSeqL5L6	455985	455992		YPO_RS03175	7
ABI745_HiSeqL5L6	466163	466173		nadR	10
ABI745_HiSeqL5L6	466803	466815		YPO_RS03220	12
ABI745_HiSeqL5L6	471754	471759		YPO_RS03240	5
ABI745_HiSeqL5L6	473148	473156		YPO_RS03245	8
ABI745_HiSeqL5L6	476599	476642		sltY	43
ABI745_HiSeqL5L6	482176	482179		arcA	3
ABI745_HiSeqL5L6	487779	487802		thrC	23
ABI745_HiSeqL5L6	493933	493946		YPO_RS03330	13
ABI745_HiSeqL5L6	494721	494735		YPO_RS03330	14
ABI745_HiSeqL5L6	496786	496794		satP	8
ABI745_HiSeqL5L6	501755	501761		nhaA	6
ABI745_HiSeqL5L6	505667	505675		ileS	8
ABI745_HiSeqL5L6	505819	505822		ileS	3
ABI745_HiSeqL5L6	506920	506928		ileS	8
ABI745_HiSeqL5L6	508057	508060		lspA	3
ABI745_HiSeqL5L6	510134	510138		YPO_RS03400	4
ABI745_HiSeqL5L6	510346	510360		YPO_RS03400	14
ABI745_HiSeqL5L6	517963	517969		YPO_RS03425	6
ABI745_HiSeqL5L6	518690	518692		YPO_RS03430	2
ABI745_HiSeqL5L6	518741	518781		YPO_RS03430	40
ABI745_HiSeqL5L6	520164	520190		YPO_RS03440	26
ABI745_HiSeqL5L6	522672	522673		apaG	1
ABI745_HiSeqL5L6	522911	522949		apaG	38
ABI745_HiSeqL5L6	526425	526432		lptD	7
ABI745_HiSeqL5L6	537795	537835		tssF	40
ABI745_HiSeqL5L6	541828	541829		tssH	1
ABI745_HiSeqL5L6	542981	542986		vgrG	5
ABI745_HiSeqL5L6	544153	544168		vgrG	15
ABI745_HiSeqL5L6	544296	544307		vgrG	11
ABI745_HiSeqL5L6	550413	550427		tssK	14
ABI745_HiSeqL5L6	550984	550985		tssK	1
ABI745_HiSeqL5L6	552909	552919		tssM	10
ABI745_HiSeqL5L6	554056	554075		tssM	19
ABI745_HiSeqL5L6	556002	556012		tssM	10
ABI745_HiSeqL5L6	556052	556062		tssM	10
ABI745_HiSeqL5L6	558628	558631		rapA	3
ABI745_HiSeqL5L6	562282	562284		YPO_RS03600	2
ABI745_HiSeqL5L6	565055	565061		thiP	6
ABI745_HiSeqL5L6	571251	571253		YPO_RS03635	2
ABI745_HiSeqL5L6	571346	571369		YPO_RS03635	23
ABI745_HiSeqL5L6	571561	571603		YPO_RS03635	42
ABI745_HiSeqL5L6	572105	572116		YPO_RS03640	11
ABI745_HiSeqL5L6	572464	572494		YPO_RS03640	30
ABI745_HiSeqL5L6	573013	573035		YPO_RS03640	22
ABI745_HiSeqL5L6	573140	573179		YPO_RS03645	39
ABI745_HiSeqL5L6	573307	573317		YPO_RS03645	10
ABI745_HiSeqL5L6	574024	574035		leuD	11
ABI745_HiSeqL5L6	574982	574989		leuC	7
ABI745_HiSeqL5L6	575497	575518		leuC	21
ABI745_HiSeqL5L6	575630	575634		leuC	4
ABI745_HiSeqL5L6	578559	578564		YPO_RS03670	5
ABI745_HiSeqL5L6	582863	582875		YPO_RS03685	12
ABI745_HiSeqL5L6	584455	584463		ilvI	8
ABI745_HiSeqL5L6	584605	584620		ilvI	15
ABI745_HiSeqL5L6	584700	584702		ilvI	2
ABI745_HiSeqL5L6	585902	585905		ilvN	3
ABI745_HiSeqL5L6	586659	586684		YPO_RS03700	25
ABI745_HiSeqL5L6	586814	586826		YPO_RS03700	12
ABI745_HiSeqL5L6	588789	588793		YPO_RS03710	4
ABI745_HiSeqL5L6	590316	590338		mraZ	22
ABI745_HiSeqL5L6	590839	590846		rsmH	7
ABI745_HiSeqL5L6	592027	592036		YPO_RS03735	9
ABI745_HiSeqL5L6	592405	592422		YPO_RS03735	17
ABI745_HiSeqL5L6	593284	593310		YPO_RS03735	26
ABI745_HiSeqL5L6	595518	595528		murF	10
ABI745_HiSeqL5L6	595784	595796		murF	12
ABI745_HiSeqL5L6	596770	596823		mraY	53
ABI745_HiSeqL5L6	597292	597295		mraY	3
ABI745_HiSeqL5L6	597579	597580		murD	1
ABI745_HiSeqL5L6	599518	599520		ftsW	2
ABI745_HiSeqL5L6	600897	600944		murG	47
ABI745_HiSeqL5L6	601387	601391		murC	4
ABI745_HiSeqL5L6	602361	602367		murC	6
ABI745_HiSeqL5L6	603583	603587		YPO_RS03775	4
ABI745_HiSeqL5L6	606546	606555		ftsZ	9
ABI745_HiSeqL5L6	608637	608641		YPO_RS03800	4
ABI745_HiSeqL5L6	610036	610044		secA	8
ABI745_HiSeqL5L6	610756	610758		secA	2
ABI745_HiSeqL5L6	611444	611447		secA	3
ABI745_HiSeqL5L6	612648	612649		mutT	1
ABI745_HiSeqL5L6	613220	613231		YPO_RS03820	11
ABI745_HiSeqL5L6	613431	613464		YPO_RS03820	33
ABI745_HiSeqL5L6	613903	613977		YPO_RS03825	74
ABI745_HiSeqL5L6	614039	614058		YPO_RS03825	19
ABI745_HiSeqL5L6	614119	614130		YPO_RS03825	11
ABI745_HiSeqL5L6	614173	614178		YPO_RS03825	5
ABI745_HiSeqL5L6	614326	614329		YPO_RS03825	3
ABI745_HiSeqL5L6	614537	614569		YPO_RS03825	32
ABI745_HiSeqL5L6	614809	614812		YPO_RS03825	3
ABI745_HiSeqL5L6	620918	620922		YPO_RS03880	4
ABI745_HiSeqL5L6	624598	624604		YPO_RS03890	6
ABI745_HiSeqL5L6	626360	626364		YPO_RS03895	4
ABI745_HiSeqL5L6	626671	626682		YPO_RS03895	11
ABI745_HiSeqL5L6	629135	629136		sstT	1
ABI745_HiSeqL5L6	629167	629179		sstT	12
ABI745_HiSeqL5L6	634200	634203		yapG	3
ABI745_HiSeqL5L6	641430	641453		YPO_RS03945	23
ABI745_HiSeqL5L6	641566	641571		YPO_RS03945	5
ABI745_HiSeqL5L6	641993	642002		YPO_RS03945	9
ABI745_HiSeqL5L6	643047	643055		YPO_RS03950	8
ABI745_HiSeqL5L6	644920	644967		YPO_RS03960	47
ABI745_HiSeqL5L6	645928	645960		YPO_RS03965	32
ABI745_HiSeqL5L6	649255	649257		YPO_RS03975	2
ABI745_HiSeqL5L6	650032	650042		cdiA	10
ABI745_HiSeqL5L6	650708	650709		cdiA	1
ABI745_HiSeqL5L6	652816	652833		cdiA	17
ABI745_HiSeqL5L6	654754	654764		cdiA	10
ABI745_HiSeqL5L6	655307	655310		cdiA	3
ABI745_HiSeqL5L6	659211	659221		cdiI	10
ABI745_HiSeqL5L6	661013	661018		YPO_RS04010	5
ABI745_HiSeqL5L6	662343	662365		yapF	22
ABI745_HiSeqL5L6	664002	664003		yapF	1
ABI745_HiSeqL5L6	664219	664224		YPO_RS04025	5
ABI745_HiSeqL5L6	664827	664841		YPO_RS04025	14
ABI745_HiSeqL5L6	665490	665503		YPO_RS04030	13
ABI745_HiSeqL5L6	667879	667886		YPO_RS04035	7
ABI745_HiSeqL5L6	668070	668084		YPO_RS04040	14
ABI745_HiSeqL5L6	668593	668594		YPO_RS04040	1
ABI745_HiSeqL5L6	671878	671881		YPO_RS04045	3
ABI745_HiSeqL5L6	674151	674155		YPO_RS04055	4
ABI745_HiSeqL5L6	675524	675536		YPO_RS04060	12
ABI745_HiSeqL5L6	676163	676169		YPO_RS04070	6
ABI745_HiSeqL5L6	678955	678961		YPO_RS04075	6
ABI745_HiSeqL5L6	680618	680624		YPO_RS04080	6
ABI745_HiSeqL5L6	681179	681188		YPO_RS04080	9
ABI745_HiSeqL5L6	684175	684190		YPO_RS04100	15
ABI745_HiSeqL5L6	684241	684253		YPO_RS04100	12
ABI745_HiSeqL5L6	684476	684480		YPO_RS04100	4
ABI745_HiSeqL5L6	685228	685233		YPO_RS04100	5
ABI745_HiSeqL5L6	686414	686417		YPO_RS04105	3
ABI745_HiSeqL5L6	687079	687141		YPO_RS04110	62
ABI745_HiSeqL5L6	690615	690628		YPO_RS04135	13
ABI745_HiSeqL5L6	690850	690871		YPO_RS04140	21
ABI745_HiSeqL5L6	694083	694095		YPO_RS04160	12
ABI745_HiSeqL5L6	694148	694202		YPO_RS04160	54
ABI745_HiSeqL5L6	694540	694541		YPO_RS04160	1
ABI745_HiSeqL5L6	694590	694595		YPO_RS04160	5
ABI745_HiSeqL5L6	694633	694640		YPO_RS04160	7
ABI745_HiSeqL5L6	694986	695002		YPO_RS04165	16
ABI745_HiSeqL5L6	695183	695215		YPO_RS04165	32
ABI745_HiSeqL5L6	696831	696833		YPO_RS04170	2
ABI745_HiSeqL5L6	696953	696956		YPO_RS04170	3
ABI745_HiSeqL5L6	700461	700472		rpoD	11
ABI745_HiSeqL5L6	700864	700868		rpoD	4
ABI745_HiSeqL5L6	701962	701967		dnaG	5
ABI745_HiSeqL5L6	704025	704031		tsaD	6
ABI745_HiSeqL5L6	704070	704074		tsaD	4
ABI745_HiSeqL5L6	704229	704253		tsaD	24
ABI745_HiSeqL5L6	706473	706479		bacA	6
ABI745_HiSeqL5L6	708551	708567		YPO_RS04230	16
ABI745_HiSeqL5L6	708815	708818		YPO_RS04235	3
ABI745_HiSeqL5L6	717345	717373		YPO_RS04260	28
ABI745_HiSeqL5L6	718622	718630		ribB	8
ABI745_HiSeqL5L6	726475	726481		yqiA	6
ABI745_HiSeqL5L6	728538	728548		parE	10
ABI745_HiSeqL5L6	733468	733472		YPO_RS04335	4
ABI745_HiSeqL5L6	733511	733512		YPO_RS04335	1
ABI745_HiSeqL5L6	734443	734467		ftsP	24
ABI745_HiSeqL5L6	740161	740163		yqhD	2
ABI745_HiSeqL5L6	742575	742591		YPO_RS04370	16
ABI745_HiSeqL5L6	744123	744133		metC	10
ABI745_HiSeqL5L6	746004	746023		exbD	19
ABI745_HiSeqL5L6	746288	746289		YPO_RS04390	1
ABI745_HiSeqL5L6	747785	747799		YPO_RS04390	14
ABI745_HiSeqL5L6	747943	747949		YPO_RS04395	6
ABI745_HiSeqL5L6	749368	749372		YPO_RS04405	4
ABI745_HiSeqL5L6	750327	750331		YPO_RS04410	4
ABI745_HiSeqL5L6	752609	752616		YPO_RS04420	7
ABI745_HiSeqL5L6	756958	756962		YPO_RS04455	4
ABI745_HiSeqL5L6	756992	756995		YPO_RS04455	3
ABI745_HiSeqL5L6	757298	757317		YPO_RS04455	19
ABI745_HiSeqL5L6	759897	759900		YPO_RS04465	3
ABI745_HiSeqL5L6	762387	762396		YPO_RS04475	9
ABI745_HiSeqL5L6	763720	763728		fepB	8
ABI745_HiSeqL5L6	772337	772339		YPO_RS04525	2
ABI745_HiSeqL5L6	772795	772806		YPO_RS04525	11
ABI745_HiSeqL5L6	775911	775917		fliF	6
ABI745_HiSeqL5L6	777164	777174		YPO_RS04545	10
ABI745_HiSeqL5L6	778679	778687		fliI	8
ABI745_HiSeqL5L6	779104	779119		fliI	15
ABI745_HiSeqL5L6	779686	779692		fliI	6
ABI745_HiSeqL5L6	779861	779869		fliJ	8
ABI745_HiSeqL5L6	780989	780990		flgM	1
ABI745_HiSeqL5L6	782463	782473		flgB	10
ABI745_HiSeqL5L6	785624	785630		YPO_RS04605	6
ABI745_HiSeqL5L6	786966	786973		flgG	7
ABI745_HiSeqL5L6	789095	789107		YPO_RS04625	12
ABI745_HiSeqL5L6	790557	790565		flgK	8
ABI745_HiSeqL5L6	794750	794751		YPO_RS04655	1
ABI745_HiSeqL5L6	796044	796057		YPO_RS04660	13
ABI745_HiSeqL5L6	798040	798059		YPO_RS04665	19
ABI745_HiSeqL5L6	801318	801343		fliS	25
ABI745_HiSeqL5L6	802567	802577		YPO_RS04690	10
ABI745_HiSeqL5L6	802617	802625		YPO_RS04690	8
ABI745_HiSeqL5L6	803081	803086		YPO_RS04690	5
ABI745_HiSeqL5L6	803883	803955		YPO_RS04700	72
ABI745_HiSeqL5L6	804297	804315		YPO_RS04700	18
ABI745_HiSeqL5L6	807288	807302		YPO_RS04720	14
ABI745_HiSeqL5L6	807415	807461		YPO_RS04720	46
ABI745_HiSeqL5L6	807607	807620		YPO_RS04720	13
ABI745_HiSeqL5L6	810358	810375		YPO_RS04740	17
ABI745_HiSeqL5L6	810598	810599		YPO_RS04740	1
ABI745_HiSeqL5L6	815602	815606		YPO_RS04760	4
ABI745_HiSeqL5L6	815685	815687		YPO_RS04760	2
ABI745_HiSeqL5L6	818453	818459		YPO_RS04770	6
ABI745_HiSeqL5L6	819091	819124		YPO_RS04770	33
ABI745_HiSeqL5L6	821543	821544		YPO_RS04775	1
ABI745_HiSeqL5L6	830321	830324		gntP	3
ABI745_HiSeqL5L6	835938	835939		YPO_RS04805	1
ABI745_HiSeqL5L6	835983	836008		YPO_RS04805	25
ABI745_HiSeqL5L6	836437	836445		YPO_RS04805	8
ABI745_HiSeqL5L6	838967	838973		YPO_RS04815	6
ABI745_HiSeqL5L6	841335	841353		YPO_RS04825	18
ABI745_HiSeqL5L6	841545	841569		YPO_RS04825	24
ABI745_HiSeqL5L6	842057	842080		YPO_RS04830	23
ABI745_HiSeqL5L6	845266	845269		YPO_RS04835	3
ABI745_HiSeqL5L6	845588	845594		YPO_RS04835	6
ABI745_HiSeqL5L6	847397	847399		YPO_RS04835	2
ABI745_HiSeqL5L6	848363	848375		YPO_RS04835	12
ABI745_HiSeqL5L6	850273	850283		YPO_RS04840	10
ABI745_HiSeqL5L6	853783	853795		YPO_RS04845	12
ABI745_HiSeqL5L6	856049	856053		YPO_RS04845	4
ABI745_HiSeqL5L6	856492	856494		YPO_RS04845	2
ABI745_HiSeqL5L6	857115	857119		YPO_RS04850	4
ABI745_HiSeqL5L6	857211	857216		YPO_RS04850	5
ABI745_HiSeqL5L6	857406	857475		YPO_RS04850	69
ABI745_HiSeqL5L6	857551	857558		YPO_RS04850	7
ABI745_HiSeqL5L6	857893	857894		YPO_RS04855	1
ABI745_HiSeqL5L6	858305	858318		YPO_RS04855	13
ABI745_HiSeqL5L6	858410	858418		YPO_RS04855	8
ABI745_HiSeqL5L6	860012	860039		thyA	27
ABI745_HiSeqL5L6	861678	861681		ptsP	3
ABI745_HiSeqL5L6	862814	862816		ptsP	2
ABI745_HiSeqL5L6	868679	868685		lplT	6
ABI745_HiSeqL5L6	871012	871020		aas	8
ABI745_HiSeqL5L6	871952	871974		YPO_RS04915	22
ABI745_HiSeqL5L6	873538	873552		YPO_RS04915	14
ABI745_HiSeqL5L6	874992	874994		galR	2
ABI745_HiSeqL5L6	877542	877547		YPO_RS04930	5
ABI745_HiSeqL5L6	878428	878446		YPO_RS04935	18
ABI745_HiSeqL5L6	880722	880727		YPO_RS04945	5
ABI745_HiSeqL5L6	881567	881570		YPO_RS04950	3
ABI745_HiSeqL5L6	884190	884193		YPO_RS04960	3
ABI745_HiSeqL5L6	884191	884193		YPO_RS04965	2
ABI745_HiSeqL5L6	884835	884836		YPO_RS04965	1
ABI745_HiSeqL5L6	886316	886319		YPO_RS04975	3
ABI745_HiSeqL5L6	887895	887900		gspL	5
ABI745_HiSeqL5L6	888159	888164		YPO_RS04990	5
ABI745_HiSeqL5L6	890012	890030		YPO_RS05005	18
ABI745_HiSeqL5L6	893705	893709		gspD	4
ABI745_HiSeqL5L6	893802	893828		gspD	26
ABI745_HiSeqL5L6	893864	893874		gspD	10
ABI745_HiSeqL5L6	902658	902659		yapM	1
ABI745_HiSeqL5L6	903062	903079		YPO_RS05060	17
ABI745_HiSeqL5L6	903439	903477		YPO_RS05060	38
ABI745_HiSeqL5L6	903906	903908		YPO_RS05060	2
ABI745_HiSeqL5L6	905288	905292		YPO_RS05060	4
ABI745_HiSeqL5L6	905854	905863		YPO_RS05060	9
ABI745_HiSeqL5L6	906238	906244		YPO_RS05065	6
ABI745_HiSeqL5L6	906634	906682		YPO_RS05065	48
ABI745_HiSeqL5L6	906955	906963		YPO_RS05065	8
ABI745_HiSeqL5L6	907037	907061		YPO_RS05070	24
ABI745_HiSeqL5L6	907132	907141		YPO_RS05070	9
ABI745_HiSeqL5L6	908096	908133		tnpA	37
ABI745_HiSeqL5L6	908236	908255		tnpA	19
ABI745_HiSeqL5L6	915911	915924		YPO_RS05105	13
ABI745_HiSeqL5L6	917558	917595		nagA	37
ABI745_HiSeqL5L6	917745	917762		nagA	17
ABI745_HiSeqL5L6	918810	918811		kduD	1
ABI745_HiSeqL5L6	919762	919786		YPO_RS05130	24
ABI745_HiSeqL5L6	921275	921280		YPO_RS05135	5
ABI745_HiSeqL5L6	921736	921744		YPO_RS05135	8
ABI745_HiSeqL5L6	928947	928948		YPO_RS05165	1
ABI745_HiSeqL5L6	931987	931992		YPO_RS05170	5
ABI745_HiSeqL5L6	935160	935181		YPO_RS05180	21
ABI745_HiSeqL5L6	935341	935342		YPO_RS05180	1
ABI745_HiSeqL5L6	936348	936350		YPO_RS05190	2
ABI745_HiSeqL5L6	938098	938111		YPO_RS05190	13
ABI745_HiSeqL5L6	938780	938798		YPO_RS05195	18
ABI745_HiSeqL5L6	940326	940328		YPO_RS05200	2
ABI745_HiSeqL5L6	943976	943980		YPO_RS05215	4
ABI745_HiSeqL5L6	945581	945589		YPO_RS05220	8
ABI745_HiSeqL5L6	951217	951224		YPO_RS05240	7
ABI745_HiSeqL5L6	953359	953367		YPO_RS05255	8
ABI745_HiSeqL5L6	954290	954306		YPO_RS05260	16
ABI745_HiSeqL5L6	957629	957630		YPO_RS05270	1
ABI745_HiSeqL5L6	959898	959906		YPO_RS05290	8
ABI745_HiSeqL5L6	964019	964020		YPO_RS05315	1
ABI745_HiSeqL5L6	964125	964154		YPO_RS05315	29
ABI745_HiSeqL5L6	966460	966467		YPO_RS05330	7
ABI745_HiSeqL5L6	969149	969171		YPO_RS05350	22
ABI745_HiSeqL5L6	976488	976492		dsbC	4
ABI745_HiSeqL5L6	978176	978191		fldB	15
ABI745_HiSeqL5L6	978992	978997		creD	5
ABI745_HiSeqL5L6	980060	980067		creD	7
ABI745_HiSeqL5L6	983468	983469		ygfZ	1
ABI745_HiSeqL5L6	986622	986627		YPO_RS05440	5
ABI745_HiSeqL5L6	986761	986769		YPO_RS05440	8
ABI745_HiSeqL5L6	992306	992310		gcvP	4
ABI745_HiSeqL5L6	993229	993233		gcvP	4
ABI745_HiSeqL5L6	995073	995086		gcvT	13
ABI745_HiSeqL5L6	995144	995154		gcvT	10
ABI745_HiSeqL5L6	995297	995298		gcvT	1
ABI745_HiSeqL5L6	995368	995377		gcvT	9
ABI745_HiSeqL5L6	997543	997549		ubiI	6
ABI745_HiSeqL5L6	998128	998134		ubiH	6
ABI745_HiSeqL5L6	999556	999557		pepP	1
ABI745_HiSeqL5L6	1001143	1001154		YPO_RS05490	11
ABI745_HiSeqL5L6	1001608	1001616		zapA	8
ABI745_HiSeqL5L6	1002144	1002162		ssrS	18
ABI745_HiSeqL5L6	1003521	1003549		serA	28
ABI745_HiSeqL5L6	1005292	1005294		rpiA	2
ABI745_HiSeqL5L6	1008866	1008891		mscS	25
ABI745_HiSeqL5L6	1010810	1010818		fbaA	8
ABI745_HiSeqL5L6	1013614	1013631		YPO_RS05555	17
ABI745_HiSeqL5L6	1013673	1013675		YPO_RS05555	2
ABI745_HiSeqL5L6	1014063	1014079		YPO_RS05555	16
ABI745_HiSeqL5L6	1014137	1014141		YPO_RS05555	4
ABI745_HiSeqL5L6	1014177	1014209		YPO_RS05555	32
ABI745_HiSeqL5L6	1014466	1014479		YPO_RS05560	13
ABI745_HiSeqL5L6	1014711	1014712		YPO_RS05560	1
ABI745_HiSeqL5L6	1014872	1014876		YPO_RS05560	4
ABI745_HiSeqL5L6	1014996	1015010		YPO_RS05560	14
ABI745_HiSeqL5L6	1015105	1015107		YPO_RS05560	2
ABI745_HiSeqL5L6	1015145	1015161		YPO_RS05560	16
ABI745_HiSeqL5L6	1015236	1015240		YPO_RS05560	4
ABI745_HiSeqL5L6	1015656	1015679		YPO_RS05565	23
ABI745_HiSeqL5L6	1020661	1020667		speA	6
ABI745_HiSeqL5L6	1022125	1022157		speA	32
ABI745_HiSeqL5L6	1025754	1025757		endA	3
ABI745_HiSeqL5L6	1026611	1026643		rsmE	32
ABI745_HiSeqL5L6	1027678	1027691		gshB	13
ABI745_HiSeqL5L6	1031315	1031323		aguA	8
ABI745_HiSeqL5L6	1031598	1031634		YPO_RS05640	36
ABI745_HiSeqL5L6	1033757	1033773		YPO_RS05650	16
ABI745_HiSeqL5L6	1039741	1039747		YPO_RS05675	6
ABI745_HiSeqL5L6	1040475	1040481		YPO_RS05675	6
ABI745_HiSeqL5L6	1040795	1040822		YPO_RS05675	27
ABI745_HiSeqL5L6	1041876	1041885		YPO_RS05675	9
ABI745_HiSeqL5L6	1043936	1043955		YPO_RS05675	19
ABI745_HiSeqL5L6	1045162	1045163		YPO_RS05675	1
ABI745_HiSeqL5L6	1055211	1055213		YPO_RS05720	2
ABI745_HiSeqL5L6	1058236	1058251		YPO_RS05730	15
ABI745_HiSeqL5L6	1061481	1061489		speF	8
ABI745_HiSeqL5L6	1067312	1067321		YPO_RS05765	9
ABI745_HiSeqL5L6	1069042	1069048		YPO_RS05770	6
ABI745_HiSeqL5L6	1070318	1070321		YPO_RS05775	3
ABI745_HiSeqL5L6	1072125	1072126		YPO_RS05790	1
ABI745_HiSeqL5L6	1072724	1072726		YPO_RS05795	2
ABI745_HiSeqL5L6	1072979	1072984		YPO_RS05795	5
ABI745_HiSeqL5L6	1075005	1075013		YPO_RS05800	8
ABI745_HiSeqL5L6	1076939	1076945		YPO_RS05800	6
ABI745_HiSeqL5L6	1078810	1078813		tssH	3
ABI745_HiSeqL5L6	1083845	1083865		tssK	20
ABI745_HiSeqL5L6	1088933	1088946		YPO_RS05845	13
ABI745_HiSeqL5L6	1090056	1090061		YPO_RS05850	5
ABI745_HiSeqL5L6	1091703	1091717		YPO_RS05855	14
ABI745_HiSeqL5L6	1094234	1094235		YPO_RS05865	1
ABI745_HiSeqL5L6	1096042	1096047		YPO_RS05875	5
ABI745_HiSeqL5L6	1102132	1102172		YPO_RS05900	40
ABI745_HiSeqL5L6	1102954	1102960		YPO_RS05900	6
ABI745_HiSeqL5L6	1103992	1103994		YPO_RS05905	2
ABI745_HiSeqL5L6	1104773	1104788		YPO_RS05905	15
ABI745_HiSeqL5L6	1106816	1106838		YPO_RS05910	22
ABI745_HiSeqL5L6	1106986	1106995		YPO_RS05910	9
ABI745_HiSeqL5L6	1107725	1107726		YPO_RS05915	1
ABI745_HiSeqL5L6	1108379	1108446		YPO_RS05915	67
ABI745_HiSeqL5L6	1108732	1108740		YPO_RS05915	8
ABI745_HiSeqL5L6	1111377	1111388		YPO_RS05920	11
ABI745_HiSeqL5L6	1114706	1114712		YPO_RS05935	6
ABI745_HiSeqL5L6	1116069	1116077		YPO_RS05935	8
ABI745_HiSeqL5L6	1120588	1120597		yapH	9
ABI745_HiSeqL5L6	1120673	1120686		yapH	13
ABI745_HiSeqL5L6	1121309	1121323		yapH	14
ABI745_HiSeqL5L6	1122177	1122190		yapH	13
ABI745_HiSeqL5L6	1122450	1122461		yapH	11
ABI745_HiSeqL5L6	1125212	1125235		yapH	23
ABI745_HiSeqL5L6	1131411	1131435		YPO_RS05955	24
ABI745_HiSeqL5L6	1132035	1132038		YPO_RS05955	3
ABI745_HiSeqL5L6	1132508	1132530		YPO_RS05955	22
ABI745_HiSeqL5L6	1135774	1135800		YPO_RS05970	26
ABI745_HiSeqL5L6	1139916	1139931		pepT	15
ABI745_HiSeqL5L6	1140996	1140999		YPO_RS05985	3
ABI745_HiSeqL5L6	1141981	1141982		YPO_RS05985	1
ABI745_HiSeqL5L6	1146745	1146746		YPO_RS05995	1
ABI745_HiSeqL5L6	1146827	1146832		YPO_RS05995	5
ABI745_HiSeqL5L6	1146954	1146969		YPO_RS05995	15
ABI745_HiSeqL5L6	1147179	1147207		YPO_RS06000	28
ABI745_HiSeqL5L6	1147338	1147352		YPO_RS06000	14
ABI745_HiSeqL5L6	1147518	1147522		YPO_RS06000	4
ABI745_HiSeqL5L6	1148639	1148656		YPO_RS06010	17
ABI745_HiSeqL5L6	1150899	1150913		recC	14
ABI745_HiSeqL5L6	1151240	1151248		recC	8
ABI745_HiSeqL5L6	1153385	1153401		ptrA	16
ABI745_HiSeqL5L6	1154245	1154247		ptrA	2
ABI745_HiSeqL5L6	1156532	1156542		recB	10
ABI745_HiSeqL5L6	1158076	1158081		recB	5
ABI745_HiSeqL5L6	1166617	1166619		tcdA	2
ABI745_HiSeqL5L6	1174616	1174621		YPO_RS06110	5
ABI745_HiSeqL5L6	1177528	1177552		YPO_RS06125	24
ABI745_HiSeqL5L6	1177864	1177889		YPO_RS06125	25
ABI745_HiSeqL5L6	1181762	1181778		glnD	16
ABI745_HiSeqL5L6	1185968	1185974		rpsB	6
ABI745_HiSeqL5L6	1193178	1193179		rseP	1
ABI745_HiSeqL5L6	1193799	1193805		bamA	6
ABI745_HiSeqL5L6	1197238	1197243		lpxD	5
ABI745_HiSeqL5L6	1200078	1200102		lpxB	24
ABI745_HiSeqL5L6	1203288	1203300		dnaE	12
ABI745_HiSeqL5L6	1206564	1206576		tilS	12
ABI745_HiSeqL5L6	1209255	1209268		YPO_RS06275	13
ABI745_HiSeqL5L6	1212188	1212202		proS	14
ABI745_HiSeqL5L6	1212960	1212974		tsaA	14
ABI745_HiSeqL5L6	1217466	1217467		YPO_RS06325	1
ABI745_HiSeqL5L6	1218461	1218463		YPO_RS06330	2
ABI745_HiSeqL5L6	1219814	1219816		YPO_RS06340	2
ABI745_HiSeqL5L6	1220115	1220126		YPO_RS06340	11
ABI745_HiSeqL5L6	1221215	1221232		YPO_RS06340	17
ABI745_HiSeqL5L6	1221602	1221605		YPO_RS06340	3
ABI745_HiSeqL5L6	1222501	1222502		rrf	1
ABI745_HiSeqL5L6	1225277	1225285		YPO_RS06365	8
ABI745_HiSeqL5L6	1230951	1230953		YPO_RS06400	2
ABI745_HiSeqL5L6	1232242	1232298		YPO_RS06405	56
ABI745_HiSeqL5L6	1232497	1232503		YPO_RS06410	6
ABI745_HiSeqL5L6	1233013	1233021		YPO_RS06410	8
ABI745_HiSeqL5L6	1233181	1233235		YPO_RS06415	54
ABI745_HiSeqL5L6	1233847	1233870		YPO_RS06415	23
ABI745_HiSeqL5L6	1233961	1233964		YPO_RS06415	3
ABI745_HiSeqL5L6	1233996	1234023		YPO_RS06415	27
ABI745_HiSeqL5L6	1238002	1238018		YPO_RS06445	16
ABI745_HiSeqL5L6	1238166	1238171		YPO_RS06445	5
ABI745_HiSeqL5L6	1243507	1243509		YPO_RS06475	2
ABI745_HiSeqL5L6	1259147	1259174		sucA	27
ABI745_HiSeqL5L6	1260633	1260642		odhB	9
ABI745_HiSeqL5L6	1262776	1262777		sucD	1
ABI745_HiSeqL5L6	1263051	1263059		sucD	8
ABI745_HiSeqL5L6	1264266	1264268		cydA	2
ABI745_HiSeqL5L6	1265219	1265238		cydA	19
ABI745_HiSeqL5L6	1265429	1265435		cydA	6
ABI745_HiSeqL5L6	1267336	1267339		ybgC	3
ABI745_HiSeqL5L6	1268456	1268459		tolR	3
ABI745_HiSeqL5L6	1270354	1270357		tolB	3
ABI745_HiSeqL5L6	1271957	1271973		pal	16
ABI745_HiSeqL5L6	1278340	1278354		YPO_RS06660	14
ABI745_HiSeqL5L6	1278661	1278670		YPO_RS06660	9
ABI745_HiSeqL5L6	1278796	1278806		YPO_RS06660	10
ABI745_HiSeqL5L6	1278887	1278908		YPO_RS06660	21
ABI745_HiSeqL5L6	1278908	1278919		YPO_RS06665	11
ABI745_HiSeqL5L6	1278995	1279005		YPO_RS06665	10
ABI745_HiSeqL5L6	1279154	1279155		YPO_RS06665	1
ABI745_HiSeqL5L6	1279231	1279240		YPO_RS06665	9
ABI745_HiSeqL5L6	1279355	1279381		YPO_RS06665	26
ABI745_HiSeqL5L6	1279528	1279538		YPO_RS06665	10
ABI745_HiSeqL5L6	1279669	1279711		YPO_RS06665	42
ABI745_HiSeqL5L6	1279757	1279783		YPO_RS06665	26
ABI745_HiSeqL5L6	1280013	1280050		YPO_RS06670	37
ABI745_HiSeqL5L6	1282546	1282558		galM	12
ABI745_HiSeqL5L6	1282951	1282965		YPO_RS06690	14
ABI745_HiSeqL5L6	1284570	1284593		galT	23
ABI745_HiSeqL5L6	1285169	1285184		galT	15
ABI745_HiSeqL5L6	1285916	1285920		galE	4
ABI745_HiSeqL5L6	1286158	1286185		galE	27
ABI745_HiSeqL5L6	1288407	1288413		modF	6
ABI745_HiSeqL5L6	1291007	1291018		modA	11
ABI745_HiSeqL5L6	1293037	1293074		modC	37
ABI745_HiSeqL5L6	1296923	1296944		bioA	21
ABI745_HiSeqL5L6	1299751	1299754		bioC	3
ABI745_HiSeqL5L6	1303227	1303239		uvrB	12
ABI745_HiSeqL5L6	1307609	1307613		moaA	4
ABI745_HiSeqL5L6	1310352	1310359		YPO_RS06825	7
ABI745_HiSeqL5L6	1312983	1312991		betB	8
ABI745_HiSeqL5L6	1314384	1314387		betI	3
ABI745_HiSeqL5L6	1315924	1315939		YPO_RS06845	15
ABI745_HiSeqL5L6	1317714	1317724		YPO_RS06850	10
ABI745_HiSeqL5L6	1318140	1318142		YPO_RS06850	2
ABI745_HiSeqL5L6	1318370	1318402		YPO_RS06855	32
ABI745_HiSeqL5L6	1321360	1321362		YPO_RS06870	2
ABI745_HiSeqL5L6	1322315	1322323		YPO_RS06875	8
ABI745_HiSeqL5L6	1322533	1322540		YPO_RS06875	7
ABI745_HiSeqL5L6	1326966	1326978		dld	12
ABI745_HiSeqL5L6	1328773	1328787		YPO_RS06905	14
ABI745_HiSeqL5L6	1333244	1333252		phnE	8
ABI745_HiSeqL5L6	1333930	1333945		phnE	15
ABI745_HiSeqL5L6	1334456	1334494		phnE	38
ABI745_HiSeqL5L6	1337438	1337458		urtB	20
ABI745_HiSeqL5L6	1338121	1338141		urtB	20
ABI745_HiSeqL5L6	1340435	1340450		urtD	15
ABI745_HiSeqL5L6	1341668	1341669		YPO_RS06970	1
ABI745_HiSeqL5L6	1350142	1350166		adiC	24
ABI745_HiSeqL5L6	1351054	1351057		adiC	3
ABI745_HiSeqL5L6	1357192	1357198		dinG	6
ABI745_HiSeqL5L6	1359305	1359306		YPO_RS07040	1
ABI745_HiSeqL5L6	1361805	1361814		tyrP	9
ABI745_HiSeqL5L6	1362848	1362861		tyrP	13
ABI745_HiSeqL5L6	1364932	1364934		eco	2
ABI745_HiSeqL5L6	1365766	1365775		nrdB	9
ABI745_HiSeqL5L6	1380704	1380710		YPO_RS07110	6
ABI745_HiSeqL5L6	1382509	1382531		YPO_RS07115	22
ABI745_HiSeqL5L6	1384845	1384868		ampH	23
ABI745_HiSeqL5L6	1388352	1388366		YPO_RS07145	14
ABI745_HiSeqL5L6	1388797	1388801		YPO_RS07145	4
ABI745_HiSeqL5L6	1395279	1395294		YPO_RS07175	15
ABI745_HiSeqL5L6	1395731	1395745		YPO_RS07175	14
ABI745_HiSeqL5L6	1395907	1395927		YPO_RS07175	20
ABI745_HiSeqL5L6	1401626	1401627		YPO_RS07215	1
ABI745_HiSeqL5L6	1402425	1402429		YPO_RS07225	4
ABI745_HiSeqL5L6	1404147	1404187		YPO_RS07230	40
ABI745_HiSeqL5L6	1405637	1405638		YPO_RS07235	1
ABI745_HiSeqL5L6	1405903	1405910		YPO_RS07235	7
ABI745_HiSeqL5L6	1407453	1407455		YPO_RS07245	2
ABI745_HiSeqL5L6	1411686	1411690		YPO_RS07275	4
ABI745_HiSeqL5L6	1423853	1423854		rsuA	1
ABI745_HiSeqL5L6	1424119	1424121		rsuA	2
ABI745_HiSeqL5L6	1425125	1425130		YPO_RS07340	5
ABI745_HiSeqL5L6	1427491	1427518		yejF	27
ABI745_HiSeqL5L6	1429138	1429141		YPO_RS07355	3
ABI745_HiSeqL5L6	1433499	1433507		YPO_RS07370	8
ABI745_HiSeqL5L6	1437347	1437373		YPO_RS07385	26
ABI745_HiSeqL5L6	1441779	1441782		uxuA	3
ABI745_HiSeqL5L6	1445691	1445693		YPO_RS07420	2
ABI745_HiSeqL5L6	1451107	1451114		xylB	7
ABI745_HiSeqL5L6	1454636	1454637		YPO_RS07455	1
ABI745_HiSeqL5L6	1457918	1457926		YPO_RS07470	8
ABI745_HiSeqL5L6	1459263	1459275		fruA	12
ABI745_HiSeqL5L6	1460267	1460274		fruA	7
ABI745_HiSeqL5L6	1460369	1460374		fruA	5
ABI745_HiSeqL5L6	1461457	1461467		YPO_RS07485	10
ABI745_HiSeqL5L6	1463139	1463152		psaA	13
ABI745_HiSeqL5L6	1463400	1463404		YPO_RS07500	4
ABI745_HiSeqL5L6	1463761	1463766		YPO_RS07500	5
ABI745_HiSeqL5L6	1464730	1464750		psaC	20
ABI745_HiSeqL5L6	1464796	1464810		psaC	14
ABI745_HiSeqL5L6	1465309	1465317		psaC	8
ABI745_HiSeqL5L6	1465636	1465648		psaC	12
ABI745_HiSeqL5L6	1472667	1472688		YPO_RS07530	21
ABI745_HiSeqL5L6	1482247	1482250		YPO_RS07565	3
ABI745_HiSeqL5L6	1490287	1490291		ybjG	4
ABI745_HiSeqL5L6	1490735	1490739		ybjG	4
ABI745_HiSeqL5L6	1491517	1491518		YPO_RS07605	1
ABI745_HiSeqL5L6	1492019	1492028		YPO_RS07610	9
ABI745_HiSeqL5L6	1496627	1496632		potF	5
ABI745_HiSeqL5L6	1497306	1497309		potF	3
ABI745_HiSeqL5L6	1500153	1500154		potI	1
ABI745_HiSeqL5L6	1500931	1500937		YPO_RS07650	6
ABI745_HiSeqL5L6	1502985	1502991		YPO_RS07665	6
ABI745_HiSeqL5L6	1503226	1503239		YPO_RS07665	13
ABI745_HiSeqL5L6	1503417	1503419		YPO_RS07665	2
ABI745_HiSeqL5L6	1503517	1503549		YPO_RS07665	32
ABI745_HiSeqL5L6	1503598	1503607		YPO_RS07665	9
ABI745_HiSeqL5L6	1503896	1503903		YPO_RS07670	7
ABI745_HiSeqL5L6	1504078	1504092		YPO_RS07670	14
ABI745_HiSeqL5L6	1504130	1504153		YPO_RS07670	23
ABI745_HiSeqL5L6	1504350	1504359		YPO_RS07670	9
ABI745_HiSeqL5L6	1504531	1504560		YPO_RS07670	29
ABI745_HiSeqL5L6	1505614	1505619		YPO_RS07680	5
ABI745_HiSeqL5L6	1507572	1507578		YPO_RS07690	6
ABI745_HiSeqL5L6	1514061	1514076		artM	15
ABI745_HiSeqL5L6	1523409	1523419		poxB	10
ABI745_HiSeqL5L6	1523911	1523917		hcr	6
ABI745_HiSeqL5L6	1525624	1525651		hcp	27
ABI745_HiSeqL5L6	1528357	1528424		YPO_RS07800	67
ABI745_HiSeqL5L6	1529499	1529507		YPO_RS07800	8
ABI745_HiSeqL5L6	1532447	1532450		macB	3
ABI745_HiSeqL5L6	1541381	1541392		cydC	11
ABI745_HiSeqL5L6	1543008	1543014		cydD	6
ABI745_HiSeqL5L6	1543143	1543160		cydD	17
ABI745_HiSeqL5L6	1544924	1544934		trxB	10
ABI745_HiSeqL5L6	1549668	1549675		YPO_RS07870	7
ABI745_HiSeqL5L6	1550279	1550288		YPO_RS07870	9
ABI745_HiSeqL5L6	1550741	1550743		lolA	2
ABI745_HiSeqL5L6	1554340	1554354		YPO_RS07890	14
ABI745_HiSeqL5L6	1555959	1555968		pflA	9
ABI745_HiSeqL5L6	1557446	1557451		YPO_RS07900	5
ABI745_HiSeqL5L6	1559607	1559611		pflB	4
ABI745_HiSeqL5L6	1567293	1567297		YPO_RS07930	4
ABI745_HiSeqL5L6	1567783	1567804		YPO_RS07930	21
ABI745_HiSeqL5L6	1568856	1568857		serC	1
ABI745_HiSeqL5L6	1569790	1569793		aroA	3
ABI745_HiSeqL5L6	1574849	1574863		YPO_RS07960	14
ABI745_HiSeqL5L6	1574926	1574929		YPO_RS07960	3
ABI745_HiSeqL5L6	1576002	1576010		YPO_RS07960	8
ABI745_HiSeqL5L6	1576354	1576356		YPO_RS07960	2
ABI745_HiSeqL5L6	1576442	1576447		YPO_RS07960	5
ABI745_HiSeqL5L6	1576613	1576626		YPO_RS07960	13
ABI745_HiSeqL5L6	1585993	1585997		cmoM	4
ABI745_HiSeqL5L6	1586263	1586269		cmoM	6
ABI745_HiSeqL5L6	1588040	1588057		mukE	17
ABI745_HiSeqL5L6	1589040	1589050		mukB	10
ABI745_HiSeqL5L6	1592719	1592723		mukB	4
ABI745_HiSeqL5L6	1598656	1598662		YPO_RS08045	6
ABI745_HiSeqL5L6	1608376	1608377		pyrD	1
ABI745_HiSeqL5L6	1608507	1608516		pyrD	9
ABI745_HiSeqL5L6	1615673	1615684		pqiA	11
ABI745_HiSeqL5L6	1615909	1615910		pqiA	1
ABI745_HiSeqL5L6	1618091	1618101		pqiC	10
ABI745_HiSeqL5L6	1619008	1619037		YPO_RS08115	29
ABI745_HiSeqL5L6	1620599	1620609		YPO_RS08125	10
ABI745_HiSeqL5L6	1620680	1620705		YPO_RS08125	25
ABI745_HiSeqL5L6	1620950	1620959		YPO_RS08125	9
ABI745_HiSeqL5L6	1621051	1621110		YPO_RS08125	59
ABI745_HiSeqL5L6	1621357	1621374		YPO_RS08130	17
ABI745_HiSeqL5L6	1621542	1621550		YPO_RS08130	8
ABI745_HiSeqL5L6	1621730	1621732		YPO_RS08130	2
ABI745_HiSeqL5L6	1621928	1621933		YPO_RS08130	5
ABI745_HiSeqL5L6	1621997	1622016		YPO_RS08130	19
ABI745_HiSeqL5L6	1622139	1622141		YPO_RS08130	2
ABI745_HiSeqL5L6	1626676	1626677		YPO_RS08160	1
ABI745_HiSeqL5L6	1626800	1626820		YPO_RS08160	20
ABI745_HiSeqL5L6	1631481	1631485		yccS	4
ABI745_HiSeqL5L6	1634109	1634161		helD	52
ABI745_HiSeqL5L6	1637321	1637324		hspQ	3
ABI745_HiSeqL5L6	1639222	1639229		tusE	7
ABI745_HiSeqL5L6	1643464	1643470		YPO_RS08245	6
ABI745_HiSeqL5L6	1643945	1643947		YPO_RS08245	2
ABI745_HiSeqL5L6	1644010	1644011		YPO_RS08245	1
ABI745_HiSeqL5L6	1647808	1647815		YPO_RS08260	7
ABI745_HiSeqL5L6	1648803	1648830		YPO_RS08265	27
ABI745_HiSeqL5L6	1652909	1652918		YPO_RS08290	9
ABI745_HiSeqL5L6	1654722	1654755		YPO_RS08305	33
ABI745_HiSeqL5L6	1656725	1656737		tssB	12
ABI745_HiSeqL5L6	1658257	1658277		tssC	20
ABI745_HiSeqL5L6	1658408	1658416		tssC	8
ABI745_HiSeqL5L6	1661882	1661902		YPO_RS08330	20
ABI745_HiSeqL5L6	1664446	1664465		tssH	19
ABI745_HiSeqL5L6	1665367	1665368		tssH	1
ABI745_HiSeqL5L6	1667361	1667367		YPO_RS08345	6
ABI745_HiSeqL5L6	1668237	1668244		YPO_RS08350	7
ABI745_HiSeqL5L6	1670478	1670485		YPO_RS08355	7
ABI745_HiSeqL5L6	1673078	1673083		YPO_RS08365	5
ABI745_HiSeqL5L6	1674226	1674234		YPO_RS08370	8
ABI745_HiSeqL5L6	1678114	1678136		YPO_RS08385	22
ABI745_HiSeqL5L6	1678906	1678920		YPO_RS08385	14
ABI745_HiSeqL5L6	1684081	1684109		YPO_RS08400	28
ABI745_HiSeqL5L6	1684968	1684979		tssF	11
ABI745_HiSeqL5L6	1686001	1686002		tssF	1
ABI745_HiSeqL5L6	1686391	1686407		tssF	16
ABI745_HiSeqL5L6	1687518	1687528		tssG	10
ABI745_HiSeqL5L6	1687518	1687536		tssJ	18
ABI745_HiSeqL5L6	1687960	1687963		tssJ	3
ABI745_HiSeqL5L6	1688217	1688241		tssE	24
ABI745_HiSeqL5L6	1688838	1688843		YPO_RS08425	5
ABI745_HiSeqL5L6	1689337	1689356		YPO_RS08425	19
ABI745_HiSeqL5L6	1690407	1690412		YPO_RS08430	5
ABI745_HiSeqL5L6	1693909	1693922		YPO_RS08440	13
ABI745_HiSeqL5L6	1695048	1695060		YPO_RS08445	12
ABI745_HiSeqL5L6	1695628	1695632		moeB	4
ABI745_HiSeqL5L6	1696105	1696115		moeA	10
ABI745_HiSeqL5L6	1698583	1698589		darE	6
ABI745_HiSeqL5L6	1701128	1701142		darC	14
ABI745_HiSeqL5L6	1705642	1705667		YPO_RS08490	25
ABI745_HiSeqL5L6	1705766	1705776		YPO_RS08490	10
ABI745_HiSeqL5L6	1706686	1706693		YPO_RS08495	7
ABI745_HiSeqL5L6	1712258	1712263		mglB	5
ABI745_HiSeqL5L6	1713498	1713516		mglA	18
ABI745_HiSeqL5L6	1715014	1715035		mglC	21
ABI745_HiSeqL5L6	1720209	1720218		YPO_RS08545	9
ABI745_HiSeqL5L6	1721221	1721226		YPO_RS08555	5
ABI745_HiSeqL5L6	1722722	1722729		YPO_RS08560	7
ABI745_HiSeqL5L6	1723301	1723302		YPO_RS08560	1
ABI745_HiSeqL5L6	1726282	1726288		YPO_RS08570	6
ABI745_HiSeqL5L6	1726659	1726718		YPO_RS08575	59
ABI745_HiSeqL5L6	1726814	1726846		YPO_RS08575	32
ABI745_HiSeqL5L6	1727081	1727088		YPO_RS08575	7
ABI745_HiSeqL5L6	1727305	1727312		YPO_RS08575	7
ABI745_HiSeqL5L6	1727450	1727469		YPO_RS08580	19
ABI745_HiSeqL5L6	1727531	1727538		YPO_RS08580	7
ABI745_HiSeqL5L6	1727769	1727804		YPO_RS08580	35
ABI745_HiSeqL5L6	1728186	1728191		YPO_RS08580	5
ABI745_HiSeqL5L6	1728255	1728274		YPO_RS08580	19
ABI745_HiSeqL5L6	1728775	1728803		YPO_RS08585	28
ABI745_HiSeqL5L6	1730206	1730211		metG	5
ABI745_HiSeqL5L6	1732829	1732843		udk	14
ABI745_HiSeqL5L6	1732977	1732986		udk	9
ABI745_HiSeqL5L6	1733180	1733183		udk	3
ABI745_HiSeqL5L6	1734456	1734458		asmA	2
ABI745_HiSeqL5L6	1742046	1742048		YPO_RS08630	2
ABI745_HiSeqL5L6	1742926	1742947		YPO_RS08640	21
ABI745_HiSeqL5L6	1743508	1743510		YPO_RS08640	2
ABI745_HiSeqL5L6	1743856	1743866		YPO_RS08640	10
ABI745_HiSeqL5L6	1750110	1750113		YPO_RS08665	3
ABI745_HiSeqL5L6	1750593	1750608		YPO_RS08665	15
ABI745_HiSeqL5L6	1752175	1752185		YPO_RS08670	10
ABI745_HiSeqL5L6	1752255	1752260		YPO_RS08670	5
ABI745_HiSeqL5L6	1752704	1752712		YPO_RS08670	8
ABI745_HiSeqL5L6	1754150	1754171		galU	21
ABI745_HiSeqL5L6	1758191	1758203		YPO_RS08690	12
ABI745_HiSeqL5L6	1758886	1758893		hisF	7
ABI745_HiSeqL5L6	1759848	1759850		hisA	2
ABI745_HiSeqL5L6	1760275	1760285		hisH	10
ABI745_HiSeqL5L6	1760933	1760948		hisB	15
ABI745_HiSeqL5L6	1761477	1761481		hisB	4
ABI745_HiSeqL5L6	1766075	1766088		YPO_RS08735	13
ABI745_HiSeqL5L6	1766734	1766746		YPO_RS08740	12
ABI745_HiSeqL5L6	1768931	1768952		YPO_RS08750	21
ABI745_HiSeqL5L6	1769654	1769660		YPO_RS08755	6
ABI745_HiSeqL5L6	1774618	1774619		sbcB	1
ABI745_HiSeqL5L6	1778136	1778153		YPO_RS08795	17
ABI745_HiSeqL5L6	1779056	1779059		YPO_RS08795	3
ABI745_HiSeqL5L6	1779056	1779080		YPO_RS08800	24
ABI745_HiSeqL5L6	1780196	1780200		YPO_RS08800	4
ABI745_HiSeqL5L6	1780860	1780862		YPO_RS08800	2
ABI745_HiSeqL5L6	1787859	1787860		YPO_RS08825	1
ABI745_HiSeqL5L6	1791652	1791655		YPO_RS08840	3
ABI745_HiSeqL5L6	1792776	1792777		YPO_RS08840	1
ABI745_HiSeqL5L6	1793072	1793079		YPO_RS08845	7
ABI745_HiSeqL5L6	1793311	1793337		YPO_RS08845	26
ABI745_HiSeqL5L6	1793700	1793711		YPO_RS08845	11
ABI745_HiSeqL5L6	1794112	1794117		YPO_RS08845	5
ABI745_HiSeqL5L6	1796115	1796120		YPO_RS08855	5
ABI745_HiSeqL5L6	1799206	1799219		YPO_RS08875	13
ABI745_HiSeqL5L6	1799586	1799600		YPO_RS08875	14
ABI745_HiSeqL5L6	1801232	1801233		YPO_RS08885	1
ABI745_HiSeqL5L6	1803756	1803766		YPO_RS08900	10
ABI745_HiSeqL5L6	1804854	1804855		YPO_RS08900	1
ABI745_HiSeqL5L6	1806980	1807028		YPO_RS08905	48
ABI745_HiSeqL5L6	1807248	1807272		YPO_RS08910	24
ABI745_HiSeqL5L6	1807360	1807367		YPO_RS08910	7
ABI745_HiSeqL5L6	1807410	1807454		YPO_RS08910	44
ABI745_HiSeqL5L6	1807706	1807716		YPO_RS08910	10
ABI745_HiSeqL5L6	1807881	1807883		YPO_RS08910	2
ABI745_HiSeqL5L6	1808281	1808309		bssS	28
ABI745_HiSeqL5L6	1808462	1808465		bssS	3
ABI745_HiSeqL5L6	1811541	1811546		YPO_RS08940	5
ABI745_HiSeqL5L6	1811965	1811970		YPO_RS08940	5
ABI745_HiSeqL5L6	1812013	1812014		YPO_RS08940	1
ABI745_HiSeqL5L6	1812119	1812161		YPO_RS08940	42
ABI745_HiSeqL5L6	1812213	1812230		YPO_RS08940	17
ABI745_HiSeqL5L6	1812356	1812361		YPO_RS08940	5
ABI745_HiSeqL5L6	1818411	1818420		YPO_RS08955	9
ABI745_HiSeqL5L6	1822540	1822546		fabD	6
ABI745_HiSeqL5L6	1825924	1825925		YPO_RS09005	1
ABI745_HiSeqL5L6	1826318	1826350		YPO_RS09005	32
ABI745_HiSeqL5L6	1828645	1828670		mltG	25
ABI745_HiSeqL5L6	1835690	1835695		YPO_RS09055	5
ABI745_HiSeqL5L6	1836109	1836125		lpoB	16
ABI745_HiSeqL5L6	1836819	1836826		thiK	7
ABI745_HiSeqL5L6	1840585	1840587		YPO_RS09080	2
ABI745_HiSeqL5L6	1840833	1840836		YPO_RS09080	3
ABI745_HiSeqL5L6	1842858	1842862		YPO_RS09095	4
ABI745_HiSeqL5L6	1843065	1843096		YPO_RS09095	31
ABI745_HiSeqL5L6	1843491	1843508		YPO_RS09095	17
ABI745_HiSeqL5L6	1843615	1843631		YPO_RS09095	16
ABI745_HiSeqL5L6	1844238	1844241		YPO_RS09100	3
ABI745_HiSeqL5L6	1844454	1844477		YPO_RS09100	23
ABI745_HiSeqL5L6	1844709	1844725		YPO_RS09100	16
ABI745_HiSeqL5L6	1844837	1844868		YPO_RS09100	31
ABI745_HiSeqL5L6	1844868	1844903		YPO_RS09105	35
ABI745_HiSeqL5L6	1845061	1845080		YPO_RS09105	19
ABI745_HiSeqL5L6	1845148	1845149		YPO_RS09105	1
ABI745_HiSeqL5L6	1845274	1845297		YPO_RS09105	23
ABI745_HiSeqL5L6	1845427	1845428		YPO_RS09105	1
ABI745_HiSeqL5L6	1845499	1845504		YPO_RS09105	5
ABI745_HiSeqL5L6	1845595	1845606		YPO_RS09105	11
ABI745_HiSeqL5L6	1852170	1852176		lolD	6
ABI745_HiSeqL5L6	1858071	1858082		YPO_RS09150	11
ABI745_HiSeqL5L6	1860163	1860175		phoP	12
ABI745_HiSeqL5L6	1864838	1864840		mnmA	2
ABI745_HiSeqL5L6	1865148	1865158		YPO_RS09185	10
ABI745_HiSeqL5L6	1869198	1869201		YPO_RS09205	3
ABI745_HiSeqL5L6	1869555	1869556		YPO_RS09210	1
ABI745_HiSeqL5L6	1871873	1871876		YPO_RS09215	3
ABI745_HiSeqL5L6	1872059	1872068		YPO_RS09215	9
ABI745_HiSeqL5L6	1872240	1872268		YPO_RS09215	28
ABI745_HiSeqL5L6	1873989	1874002		YPO_RS09230	13
ABI745_HiSeqL5L6	1878252	1878258		YPO_RS09250	6
ABI745_HiSeqL5L6	1880083	1880099		YPO_RS09260	16
ABI745_HiSeqL5L6	1887669	1887673		YPO_RS09280	4
ABI745_HiSeqL5L6	1889305	1889327		mgtA	22
ABI745_HiSeqL5L6	1895175	1895184		motB	9
ABI745_HiSeqL5L6	1897304	1897318		cheA	14
ABI745_HiSeqL5L6	1897366	1897372		cheA	6
ABI745_HiSeqL5L6	1906417	1906428		yapJ	11
ABI745_HiSeqL5L6	1915005	1915008		cheR	3
ABI745_HiSeqL5L6	1915459	1915470		cheR	11
ABI745_HiSeqL5L6	1928961	1928962		YPO_RS09430	1
ABI745_HiSeqL5L6	1929210	1929212		YPO_RS09430	2
ABI745_HiSeqL5L6	1929369	1929388		YPO_RS09430	19
ABI745_HiSeqL5L6	1929658	1929668		YPO_RS09430	10
ABI745_HiSeqL5L6	1929726	1929733		YPO_RS09435	7
ABI745_HiSeqL5L6	1930110	1930126		YPO_RS09435	16
ABI745_HiSeqL5L6	1930323	1930366		YPO_RS09435	43
ABI745_HiSeqL5L6	1930432	1930454		YPO_RS09435	22
ABI745_HiSeqL5L6	1940169	1940171		YPO_RS09480	2
ABI745_HiSeqL5L6	1941867	1941882		yebS	15
ABI745_HiSeqL5L6	1944607	1944617		prc	10
ABI745_HiSeqL5L6	1945103	1945113		prc	10
ABI745_HiSeqL5L6	1947668	1947681		htpX	13
ABI745_HiSeqL5L6	1950490	1950514		YPO_RS09520	24
ABI745_HiSeqL5L6	1951347	1951385		YPO_RS09520	38
ABI745_HiSeqL5L6	1953839	1953842		YPO_RS09530	3
ABI745_HiSeqL5L6	1957166	1957179		YPO_RS09540	13
ABI745_HiSeqL5L6	1958802	1958803		YPO_RS09550	1
ABI745_HiSeqL5L6	1965713	1965718		YPO_RS09575	5
ABI745_HiSeqL5L6	1966108	1966122		YPO_RS09580	14
ABI745_HiSeqL5L6	1972813	1972838		YPO_RS09610	25
ABI745_HiSeqL5L6	1973174	1973206		YPO_RS09610	32
ABI745_HiSeqL5L6	1973296	1973299		YPO_RS09610	3
ABI745_HiSeqL5L6	1973381	1973392		YPO_RS09610	11
ABI745_HiSeqL5L6	1974881	1974914		YPO_RS09620	33
ABI745_HiSeqL5L6	1975017	1975064		YPO_RS09620	47
ABI745_HiSeqL5L6	1975332	1975365		YPO_RS09620	33
ABI745_HiSeqL5L6	1975753	1975757		YPO_RS09620	4
ABI745_HiSeqL5L6	1975932	1975970		YPO_RS09625	38
ABI745_HiSeqL5L6	1976073	1976138		YPO_RS09625	65
ABI745_HiSeqL5L6	1976612	1976632		YPO_RS09630	20
ABI745_HiSeqL5L6	1976833	1976842		YPO_RS09630	9
ABI745_HiSeqL5L6	1977814	1977821		mtfA	7
ABI745_HiSeqL5L6	1978667	1978675		YPO_RS09645	8
ABI745_HiSeqL5L6	1986957	1986959		YPO_RS09700	2
ABI745_HiSeqL5L6	1988325	1988328		YPO_RS09705	3
ABI745_HiSeqL5L6	1990394	1990396		pgeF	2
ABI745_HiSeqL5L6	1993038	1993102		YPO_RS09735	64
ABI745_HiSeqL5L6	1993172	1993228		YPO_RS09735	56
ABI745_HiSeqL5L6	1993459	1993505		YPO_RS09735	46
ABI745_HiSeqL5L6	1993640	1993648		YPO_RS09735	8
ABI745_HiSeqL5L6	1993777	1993783		YPO_RS09740	6
ABI745_HiSeqL5L6	1993845	1993864		YPO_RS09740	19
ABI745_HiSeqL5L6	1993951	1993996		YPO_RS09740	45
ABI745_HiSeqL5L6	1994256	1994262		YPO_RS09740	6
ABI745_HiSeqL5L6	1994444	1994447		YPO_RS09740	3
ABI745_HiSeqL5L6	1994498	1994516		YPO_RS09745	18
ABI745_HiSeqL5L6	1996372	1996386		YPO_RS09745	14
ABI745_HiSeqL5L6	1997683	1997685		YPO_RS09750	2
ABI745_HiSeqL5L6	1999865	1999873		mntP	8
ABI745_HiSeqL5L6	2003208	2003223		manX	15
ABI745_HiSeqL5L6	2004532	2004543		YPO_RS09780	11
ABI745_HiSeqL5L6	2011807	2011833		hpaH	26
ABI745_HiSeqL5L6	2013941	2013945		hpaX	4
ABI745_HiSeqL5L6	2016666	2016680		YPO_RS09840	14
ABI745_HiSeqL5L6	2019639	2019654		pabB	15
ABI745_HiSeqL5L6	2021925	2021926		purT	1
ABI745_HiSeqL5L6	2024871	2024884		YPO_RS09880	13
ABI745_HiSeqL5L6	2025049	2025056		YPO_RS09880	7
ABI745_HiSeqL5L6	2027281	2027291		YPO_RS09885	10
ABI745_HiSeqL5L6	2039961	2039974		YPO_RS09950	13
ABI745_HiSeqL5L6	2043051	2043065		flgM	14
ABI745_HiSeqL5L6	2049844	2049851		YPO_RS10010	7
ABI745_HiSeqL5L6	2051000	2051004		flgJ	4
ABI745_HiSeqL5L6	2054370	2054377		flgL	7
ABI745_HiSeqL5L6	2057212	2057221		YPO_RS10035	9
ABI745_HiSeqL5L6	2058166	2058168		YPO_RS10035	2
ABI745_HiSeqL5L6	2058343	2058347		YPO_RS10035	4
ABI745_HiSeqL5L6	2058878	2058887		YPO_RS10040	9
ABI745_HiSeqL5L6	2059222	2059229		YPO_RS10040	7
ABI745_HiSeqL5L6	2063352	2063367		YPO_RS10055	15
ABI745_HiSeqL5L6	2064103	2064113		YPO_RS10060	10
ABI745_HiSeqL5L6	2068132	2068142		fliO	10
ABI745_HiSeqL5L6	2068142	2068144		fliN	2
ABI745_HiSeqL5L6	2070024	2070028		fliL	4
ABI745_HiSeqL5L6	2075991	2076002		fliF	11
ABI745_HiSeqL5L6	2077512	2077517		fliE	5
ABI745_HiSeqL5L6	2083756	2083774		YPO_RS10175	18
ABI745_HiSeqL5L6	2085627	2085633		fliD	6
ABI745_HiSeqL5L6	2085755	2085769		fliD	14
ABI745_HiSeqL5L6	2086305	2086312		fliD	7
ABI745_HiSeqL5L6	2087192	2087201		YPO_RS10195	9
ABI745_HiSeqL5L6	2087317	2087331		YPO_RS10195	14
ABI745_HiSeqL5L6	2088391	2088400		YPO_RS10200	9
ABI745_HiSeqL5L6	2089190	2089195		fliZ	5
ABI745_HiSeqL5L6	2098447	2098461		putA	14
ABI745_HiSeqL5L6	2099759	2099780		putP	21
ABI745_HiSeqL5L6	2104721	2104732		wrbA	11
ABI745_HiSeqL5L6	2105492	2105500		YPO_RS10275	8
ABI745_HiSeqL5L6	2109697	2109698		YPO_RS10290	1
ABI745_HiSeqL5L6	2109807	2109809		YPO_RS10290	2
ABI745_HiSeqL5L6	2111087	2111091		YPO_RS10305	4
ABI745_HiSeqL5L6	2117726	2117727		YPO_RS10355	1
ABI745_HiSeqL5L6	2119125	2119162		YPO_RS10365	37
ABI745_HiSeqL5L6	2126614	2126622		YPO_RS10420	8
ABI745_HiSeqL5L6	2130946	2130949		YPO_RS10440	3
ABI745_HiSeqL5L6	2131526	2131532		YPO_RS10440	6
ABI745_HiSeqL5L6	2131955	2131989		YPO_RS10445	34
ABI745_HiSeqL5L6	2132787	2132837		YPO_RS10450	50
ABI745_HiSeqL5L6	2134338	2134340		YPO_RS10455	2
ABI745_HiSeqL5L6	2135604	2135652		YPO_RS10475	48
ABI745_HiSeqL5L6	2135919	2135928		YPO_RS10475	9
ABI745_HiSeqL5L6	2136204	2136229		YPO_RS10475	25
ABI745_HiSeqL5L6	2136269	2136285		YPO_RS10475	16
ABI745_HiSeqL5L6	2136448	2136458		YPO_RS10475	10
ABI745_HiSeqL5L6	2136703	2136709		YPO_RS10480	6
ABI745_HiSeqL5L6	2136764	2136766		YPO_RS10480	2
ABI745_HiSeqL5L6	2137064	2137071		YPO_RS10480	7
ABI745_HiSeqL5L6	2137174	2137184		YPO_RS10480	10
ABI745_HiSeqL5L6	2137235	2137253		YPO_RS10480	18
ABI745_HiSeqL5L6	2137823	2137857		YPO_RS10490	34
ABI745_HiSeqL5L6	2141501	2141507		fyuA	6
ABI745_HiSeqL5L6	2142716	2142727		fyuA	11
ABI745_HiSeqL5L6	2143158	2143159		ybtE	1
ABI745_HiSeqL5L6	2146874	2146875		irp1	1
ABI745_HiSeqL5L6	2147040	2147041		irp1	1
ABI745_HiSeqL5L6	2160320	2160326		irp2	6
ABI745_HiSeqL5L6	2161948	2161959		irp2	11
ABI745_HiSeqL5L6	2164683	2164689		ybtP	6
ABI745_HiSeqL5L6	2165001	2165007		ybtP	6
ABI745_HiSeqL5L6	2165208	2165220		ybtP	12
ABI745_HiSeqL5L6	2165540	2165554		ybtQ	14
ABI745_HiSeqL5L6	2166919	2166928		ybtQ	9
ABI745_HiSeqL5L6	2168709	2168714		ybtS	5
ABI745_HiSeqL5L6	2172040	2172046		YPO_RS10580	6
ABI745_HiSeqL5L6	2172628	2172629		YPO_RS10585	1
ABI745_HiSeqL5L6	2176808	2176811		YPO_RS10595	3
ABI745_HiSeqL5L6	2178398	2178403		YPO_RS10605	5
ABI745_HiSeqL5L6	2178511	2178513		YPO_RS10605	2
ABI745_HiSeqL5L6	2182039	2182042		YPO_RS10615	3
ABI745_HiSeqL5L6	2187479	2187485		YPO_RS10640	6
ABI745_HiSeqL5L6	2187868	2187874		YPO_RS10645	6
ABI745_HiSeqL5L6	2189528	2189530		YPO_RS10650	2
ABI745_HiSeqL5L6	2190200	2190221		YPO_RS10655	21
ABI745_HiSeqL5L6	2192339	2192345		nqrE	6
ABI745_HiSeqL5L6	2194892	2194897		ansP	5
ABI745_HiSeqL5L6	2204119	2204125		YPO_RS10705	6
ABI745_HiSeqL5L6	2207567	2207570		YPO_RS10715	3
ABI745_HiSeqL5L6	2208887	2208901		YPO_RS10725	14
ABI745_HiSeqL5L6	2211140	2211142		tehB	2
ABI745_HiSeqL5L6	2212404	2212422		YPO_RS10745	18
ABI745_HiSeqL5L6	2215127	2215128		pgaA	1
ABI745_HiSeqL5L6	2215290	2215312		pgaA	22
ABI745_HiSeqL5L6	2216959	2216964		pgaB	5
ABI745_HiSeqL5L6	2217848	2217849		pgaB	1
ABI745_HiSeqL5L6	2217895	2217908		pgaB	13
ABI745_HiSeqL5L6	2217898	2217914		YPO_RS10760	16
ABI745_HiSeqL5L6	2221594	2221596		YPO_RS10775	2
ABI745_HiSeqL5L6	2221749	2221753		phoH	4
ABI745_HiSeqL5L6	2225999	2226017		narX	18
ABI745_HiSeqL5L6	2227296	2227313		YPO_RS10800	17
ABI745_HiSeqL5L6	2231183	2231184		astD	1
ABI745_HiSeqL5L6	2233530	2233532		astB	2
ABI745_HiSeqL5L6	2233949	2233960		astE	11
ABI745_HiSeqL5L6	2234377	2234393		astE	16
ABI745_HiSeqL5L6	2236570	2236591		YPO_RS10835	21
ABI745_HiSeqL5L6	2236630	2236645		YPO_RS10835	15
ABI745_HiSeqL5L6	2236680	2236700		YPO_RS10835	20
ABI745_HiSeqL5L6	2236913	2236928		YPO_RS10835	15
ABI745_HiSeqL5L6	2236976	2236977		YPO_RS10835	1
ABI745_HiSeqL5L6	2237104	2237125		YPO_RS10835	21
ABI745_HiSeqL5L6	2237255	2237259		YPO_RS10835	4
ABI745_HiSeqL5L6	2237302	2237303		YPO_RS10835	1
ABI745_HiSeqL5L6	2237348	2237390		YPO_RS10835	42
ABI745_HiSeqL5L6	2237818	2237822		YPO_RS10840	4
ABI745_HiSeqL5L6	2239391	2239405		hutG	14
ABI745_HiSeqL5L6	2239465	2239484		hutG	19
ABI745_HiSeqL5L6	2249427	2249429		YPO_RS10890	2
ABI745_HiSeqL5L6	2253334	2253350		YPO_RS10910	16
ABI745_HiSeqL5L6	2256705	2256713		YPO_RS10925	8
ABI745_HiSeqL5L6	2257308	2257329		YPO_RS10930	21
ABI745_HiSeqL5L6	2257461	2257487		YPO_RS10930	26
ABI745_HiSeqL5L6	2257896	2257926		YPO_RS10930	30
ABI745_HiSeqL5L6	2257956	2257977		YPO_RS10930	21
ABI745_HiSeqL5L6	2258076	2258096		YPO_RS10930	20
ABI745_HiSeqL5L6	2258513	2258516		YPO_RS10930	3
ABI745_HiSeqL5L6	2262783	2262791		YPO_RS10940	8
ABI745_HiSeqL5L6	2262883	2262885		YPO_RS10940	2
ABI745_HiSeqL5L6	2266355	2266362		YPO_RS10965	7
ABI745_HiSeqL5L6	2266403	2266409		YPO_RS10965	6
ABI745_HiSeqL5L6	2266462	2266478		YPO_RS10965	16
ABI745_HiSeqL5L6	2270182	2270184		YPO_RS10980	2
ABI745_HiSeqL5L6	2275189	2275197		YPO_RS11005	8
ABI745_HiSeqL5L6	2276164	2276174		YPO_RS11010	10
ABI745_HiSeqL5L6	2277180	2277182		YPO_RS11015	2
ABI745_HiSeqL5L6	2285093	2285103		YPO_RS11060	10
ABI745_HiSeqL5L6	2285518	2285527		YPO_RS11060	9
ABI745_HiSeqL5L6	2286461	2286466		ispE	5
ABI745_HiSeqL5L6	2286727	2286735		ispE	8
ABI745_HiSeqL5L6	2288433	2288441		hemA	8
ABI745_HiSeqL5L6	2288490	2288494		hemA	4
ABI745_HiSeqL5L6	2288528	2288558		hemA	30
ABI745_HiSeqL5L6	2289636	2289641		prfA	5
ABI745_HiSeqL5L6	2290725	2290734		prmC	9
ABI745_HiSeqL5L6	2295537	2295557		YPO_RS11115	20
ABI745_HiSeqL5L6	2295600	2295616		YPO_RS11115	16
ABI745_HiSeqL5L6	2296087	2296094		YPO_RS11120	7
ABI745_HiSeqL5L6	2296169	2296175		YPO_RS11120	6
ABI745_HiSeqL5L6	2296320	2296336		YPO_RS11120	16
ABI745_HiSeqL5L6	2296459	2296466		YPO_RS11120	7
ABI745_HiSeqL5L6	2296506	2296517		YPO_RS11120	11
ABI745_HiSeqL5L6	2296713	2296729		YPO_RS11120	16
ABI745_HiSeqL5L6	2299905	2299907		YPO_RS11135	2
ABI745_HiSeqL5L6	2300417	2300438		YPO_RS11140	21
ABI745_HiSeqL5L6	2313927	2313930		YPO_RS11210	3
ABI745_HiSeqL5L6	2316614	2316622		YPO_RS11220	8
ABI745_HiSeqL5L6	2317385	2317390		YPO_RS11220	5
ABI745_HiSeqL5L6	2319525	2319557		YPO_RS11225	32
ABI745_HiSeqL5L6	2320564	2320576		YPO_RS11225	12
ABI745_HiSeqL5L6	2321856	2321861		YPO_RS11225	5
ABI745_HiSeqL5L6	2329981	2329987		YPO_RS11260	6
ABI745_HiSeqL5L6	2332253	2332256		aspS	3
ABI745_HiSeqL5L6	2334286	2334301		YPO_RS11275	15
ABI745_HiSeqL5L6	2337547	2337584		znuB	37
ABI745_HiSeqL5L6	2341241	2341243		mepM	2
ABI745_HiSeqL5L6	2345607	2345632		YPO_RS11325	25
ABI745_HiSeqL5L6	2348222	2348244		YPO_RS11335	22
ABI745_HiSeqL5L6	2349819	2349823		mdtI	4
ABI745_HiSeqL5L6	2351309	2351316		YPO_RS11355	7
ABI745_HiSeqL5L6	2355148	2355159		fadD	11
ABI745_HiSeqL5L6	2361784	2361786		YPO_RS11410	2
ABI745_HiSeqL5L6	2362427	2362440		YPO_RS11410	13
ABI745_HiSeqL5L6	2364436	2364455		YPO_RS11425	19
ABI745_HiSeqL5L6	2364975	2364982		YPO_RS11425	7
ABI745_HiSeqL5L6	2365102	2365113		YPO_RS11425	11
ABI745_HiSeqL5L6	2365163	2365192		YPO_RS11425	29
ABI745_HiSeqL5L6	2365367	2365368		YPO_RS11430	1
ABI745_HiSeqL5L6	2365628	2365645		YPO_RS11430	17
ABI745_HiSeqL5L6	2365941	2366005		YPO_RS11430	64
ABI745_HiSeqL5L6	2367496	2367507		YPO_RS11440	11
ABI745_HiSeqL5L6	2369217	2369223		YPO_RS11460	6
ABI745_HiSeqL5L6	2371496	2371501		YPO_RS11485	5
ABI745_HiSeqL5L6	2375660	2375680		YPO_RS11510	20
ABI745_HiSeqL5L6	2376192	2376202		YPO_RS11515	10
ABI745_HiSeqL5L6	2376422	2376430		YPO_RS11515	8
ABI745_HiSeqL5L6	2376531	2376552		YPO_RS11515	21
ABI745_HiSeqL5L6	2376935	2376936		YPO_RS11515	1
ABI745_HiSeqL5L6	2376941	2376968		YPO_RS11520	27
ABI745_HiSeqL5L6	2378544	2378548		YPO_RS11525	4
ABI745_HiSeqL5L6	2379962	2379963		YPO_RS11535	1
ABI745_HiSeqL5L6	2383638	2383654		YPO_RS11560	16
ABI745_HiSeqL5L6	2383872	2383887		YPO_RS11565	15
ABI745_HiSeqL5L6	2385375	2385379		YPO_RS11575	4
ABI745_HiSeqL5L6	2385591	2385601		YPO_RS11575	10
ABI745_HiSeqL5L6	2387284	2387291		YPO_RS11590	7
ABI745_HiSeqL5L6	2387650	2387661		YPO_RS11590	11
ABI745_HiSeqL5L6	2388102	2388105		YPO_RS11590	3
ABI745_HiSeqL5L6	2389427	2389431		YPO_RS11590	4
ABI745_HiSeqL5L6	2390473	2390475		YPO_RS11600	2
ABI745_HiSeqL5L6	2391814	2391817		YPO_RS11610	3
ABI745_HiSeqL5L6	2394491	2394500		YPO_RS11630	9
ABI745_HiSeqL5L6	2395133	2395139		YPO_RS11630	6
ABI745_HiSeqL5L6	2400838	2400862		YPO_RS11665	24
ABI745_HiSeqL5L6	2402404	2402442		YPO_RS11670	38
ABI745_HiSeqL5L6	2403578	2403580		YPO_RS11680	2
ABI745_HiSeqL5L6	2403870	2403881		YPO_RS11680	11
ABI745_HiSeqL5L6	2404281	2404292		YPO_RS11680	11
ABI745_HiSeqL5L6	2405129	2405139		YPO_RS11685	10
ABI745_HiSeqL5L6	2405190	2405231		YPO_RS11685	41
ABI745_HiSeqL5L6	2405638	2405642		YPO_RS11685	4
ABI745_HiSeqL5L6	2406470	2406489		YPO_RS11690	19
ABI745_HiSeqL5L6	2406861	2406884		YPO_RS11690	23
ABI745_HiSeqL5L6	2415808	2415811		YPO_RS11725	3
ABI745_HiSeqL5L6	2417007	2417014		YPO_RS11730	7
ABI745_HiSeqL5L6	2418276	2418279		YPO_RS11735	3
ABI745_HiSeqL5L6	2419200	2419207		YPO_RS11740	7
ABI745_HiSeqL5L6	2434462	2434478		selD	16
ABI745_HiSeqL5L6	2434647	2434650		selD	3
ABI745_HiSeqL5L6	2437325	2437328		YPO_RS11820	3
ABI745_HiSeqL5L6	2439953	2439963		YPO_RS11830	10
ABI745_HiSeqL5L6	2441224	2441225		YPO_RS11850	1
ABI745_HiSeqL5L6	2441400	2441428		YPO_RS11850	28
ABI745_HiSeqL5L6	2441699	2441709		YPO_RS11850	10
ABI745_HiSeqL5L6	2441902	2441906		YPO_RS11850	4
ABI745_HiSeqL5L6	2442247	2442249		YPO_RS11850	2
ABI745_HiSeqL5L6	2442344	2442377		purU	33
ABI745_HiSeqL5L6	2442454	2442456		purU	2
ABI745_HiSeqL5L6	2445428	2445429		rssB	1
ABI745_HiSeqL5L6	2447008	2447009		YPO_RS11870	1
ABI745_HiSeqL5L6	2448274	2448283		hns	9
ABI745_HiSeqL5L6	2450572	2450607		YPO_RS11885	35
ABI745_HiSeqL5L6	2450667	2450683		YPO_RS11885	16
ABI745_HiSeqL5L6	2450738	2450750		YPO_RS11885	12
ABI745_HiSeqL5L6	2450985	2451013		YPO_RS11885	28
ABI745_HiSeqL5L6	2451145	2451179		YPO_RS11890	34
ABI745_HiSeqL5L6	2451282	2451362		YPO_RS11890	80
ABI745_HiSeqL5L6	2451633	2451670		YPO_RS11890	37
ABI745_HiSeqL5L6	2451777	2451779		YPO_RS11890	2
ABI745_HiSeqL5L6	2461221	2461248		YPO_RS11920	27
ABI745_HiSeqL5L6	2462599	2462618		YPO_RS11925	19
ABI745_HiSeqL5L6	2470795	2470805		YPO_RS11975	10
ABI745_HiSeqL5L6	2471074	2471091		YPO_RS11975	17
ABI745_HiSeqL5L6	2474018	2474028		YPO_RS11995	10
ABI745_HiSeqL5L6	2475272	2475275		YPO_RS12000	3
ABI745_HiSeqL5L6	2475408	2475416		YPO_RS12000	8
ABI745_HiSeqL5L6	2476069	2476071		ompW	2
ABI745_HiSeqL5L6	2478650	2478674		trpB	24
ABI745_HiSeqL5L6	2479218	2479232		trpB	14
ABI745_HiSeqL5L6	2481063	2481085		trpD	22
ABI745_HiSeqL5L6	2483881	2483900		YPO_RS12045	19
ABI745_HiSeqL5L6	2488067	2488075		cobO	8
ABI745_HiSeqL5L6	2495913	2495931		YPO_RS12105	18
ABI745_HiSeqL5L6	2500663	2500666		pgpB	3
ABI745_HiSeqL5L6	2502128	2502131		lapB	3
ABI745_HiSeqL5L6	2509923	2509924		YPO_RS12175	1
ABI745_HiSeqL5L6	2510227	2510233		YPO_RS12175	6
ABI745_HiSeqL5L6	2513381	2513396		YPO_RS12185	15
ABI745_HiSeqL5L6	2513515	2513535		YPO_RS12185	20
ABI745_HiSeqL5L6	2514542	2514545		YPO_RS12190	3
ABI745_HiSeqL5L6	2514706	2514724		YPO_RS12190	18
ABI745_HiSeqL5L6	2519424	2519425		YPO_RS12215	1
ABI745_HiSeqL5L6	2531427	2531451		araA	24
ABI745_HiSeqL5L6	2531971	2531977		YPO_RS12265	6
ABI745_HiSeqL5L6	2535492	2535504		YPO_RS12275	12
ABI745_HiSeqL5L6	2535559	2535568		YPO_RS12275	9
ABI745_HiSeqL5L6	2535692	2535702		YPO_RS12275	10
ABI745_HiSeqL5L6	2539673	2539688		YPO_RS12290	15
ABI745_HiSeqL5L6	2544185	2544204		manA	19
ABI745_HiSeqL5L6	2544857	2544874		manA	17
ABI745_HiSeqL5L6	2546257	2546273		fumC	16
ABI745_HiSeqL5L6	2546508	2546510		fumC	2
ABI745_HiSeqL5L6	2546906	2546919		YPO_RS12320	13
ABI745_HiSeqL5L6	2550469	2550505		YPO_RS12340	36
ABI745_HiSeqL5L6	2551038	2551041		YPO_RS12340	3
ABI745_HiSeqL5L6	2553422	2553431		clcB	9
ABI745_HiSeqL5L6	2554373	2554633		YPO_RS12355	260
ABI745_HiSeqL5L6	2554658	2555065		YPO_RS12360	407
ABI745_HiSeqL5L6	2555162	2555608		YPO_RS12365	446
ABI745_HiSeqL5L6	2555780	2556832		YPO_RS12370	1052
ABI745_HiSeqL5L6	2556844	2557161		YPO_RS12375	317
ABI745_HiSeqL5L6	2557164	2557415		YPO_RS12380	251
ABI745_HiSeqL5L6	2557451	2557684		YPO_RS12385	233
ABI745_HiSeqL5L6	2557749	2559461		YPO_RS12390	1712
ABI745_HiSeqL5L6	2559474	2559761		YPO_RS12395	287
ABI745_HiSeqL5L6	2559765	2560790		YPO_RS12400	1025
ABI745_HiSeqL5L6	2560790	2562034		YPO_RS12405	1244
ABI745_HiSeqL5L6	2562123	2562371		YPO_RS12410	248
ABI745_HiSeqL5L6	2562568	2562765		YPO_RS12415	197
ABI745_HiSeqL5L6	2564221	2564227		YPO_RS12420	6
ABI745_HiSeqL5L6	2568155	2568172		YPO_RS12445	17
ABI745_HiSeqL5L6	2572800	2572804		YPO_RS12455	4
ABI745_HiSeqL5L6	2578208	2578210		ivbL	2
ABI745_HiSeqL5L6	2579715	2579726		ilvB	11
ABI745_HiSeqL5L6	2580084	2580095		ilvN	11
ABI745_HiSeqL5L6	2589547	2589550		pntB	3
ABI745_HiSeqL5L6	2591381	2591385		pntA	4
ABI745_HiSeqL5L6	2593953	2593968		YPO_RS12535	15
ABI745_HiSeqL5L6	2598443	2598444		YPO_RS12555	1
ABI745_HiSeqL5L6	2598521	2598524		YPO_RS12555	3
ABI745_HiSeqL5L6	2598825	2598840		YPO_RS12555	15
ABI745_HiSeqL5L6	2599089	2599094		YPO_RS12555	5
ABI745_HiSeqL5L6	2599642	2599647		YPO_RS12560	5
ABI745_HiSeqL5L6	2606328	2606338		asr	10
ABI745_HiSeqL5L6	2607728	2607738		YPO_RS12595	10
ABI745_HiSeqL5L6	2610519	2610528		hrpA	9
ABI745_HiSeqL5L6	2611109	2611126		hrpA	17
ABI745_HiSeqL5L6	2613466	2613467		azoR	1
ABI745_HiSeqL5L6	2613553	2613565		azoR	12
ABI745_HiSeqL5L6	2614124	2614125		YPO_RS12615	1
ABI745_HiSeqL5L6	2620163	2620168		YPO_RS12640	5
ABI745_HiSeqL5L6	2620656	2620662		YPO_RS12640	6
ABI745_HiSeqL5L6	2625131	2625134		nifJ	3
ABI745_HiSeqL5L6	2625777	2625797		nifJ	20
ABI745_HiSeqL5L6	2629544	2629558		YPO_RS12675	14
ABI745_HiSeqL5L6	2639038	2639057		tyrR	19
ABI745_HiSeqL5L6	2641835	2641859		YPO_RS12735	24
ABI745_HiSeqL5L6	2643790	2643793		pspC	3
ABI745_HiSeqL5L6	2644282	2644283		pspA	1
ABI745_HiSeqL5L6	2646761	2646788		YPO_RS12765	27
ABI745_HiSeqL5L6	2651737	2651747		sapD	10
ABI745_HiSeqL5L6	2658092	2658114		YPO_RS12815	22
ABI745_HiSeqL5L6	2658486	2658566		YPO_RS12815	80
ABI745_HiSeqL5L6	2658690	2658731		YPO_RS12815	41
ABI745_HiSeqL5L6	2658868	2658871		YPO_RS12815	3
ABI745_HiSeqL5L6	2658871	2658888		YPO_RS12820	17
ABI745_HiSeqL5L6	2658996	2659000		YPO_RS12820	4
ABI745_HiSeqL5L6	2659085	2659134		YPO_RS12820	49
ABI745_HiSeqL5L6	2659223	2659241		YPO_RS12820	18
ABI745_HiSeqL5L6	2659496	2659498		YPO_RS12820	2
ABI745_HiSeqL5L6	2659598	2659621		YPO_RS12820	23
ABI745_HiSeqL5L6	2668478	2668480		YPO_RS12865	2
ABI745_HiSeqL5L6	2670164	2670167		eptA	3
ABI745_HiSeqL5L6	2671328	2671330		YPO_RS12880	2
ABI745_HiSeqL5L6	2671919	2671920		YPO_RS12885	1
ABI745_HiSeqL5L6	2672451	2672459		YPO_RS12885	8
ABI745_HiSeqL5L6	2674940	2674998		YPO_RS12890	58
ABI745_HiSeqL5L6	2676543	2676546		gloA	3
ABI745_HiSeqL5L6	2677696	2677710		YPO_RS12905	14
ABI745_HiSeqL5L6	2681294	2681303		purR	9
ABI745_HiSeqL5L6	2685053	2685069		cfa	16
ABI745_HiSeqL5L6	2686584	2686589		YPO_RS12950	5
ABI745_HiSeqL5L6	2689884	2689888		pykF	4
ABI745_HiSeqL5L6	2691912	2691918		YPO_RS12985	6
ABI745_HiSeqL5L6	2691951	2691958		YPO_RS12985	7
ABI745_HiSeqL5L6	2692894	2692923		YPO_RS12990	29
ABI745_HiSeqL5L6	2693021	2693050		YPO_RS12990	29
ABI745_HiSeqL5L6	2693177	2693216		YPO_RS12990	39
ABI745_HiSeqL5L6	2693290	2693309		YPO_RS12990	19
ABI745_HiSeqL5L6	2693686	2693707		YPO_RS12990	21
ABI745_HiSeqL5L6	2693901	2693930		YPO_RS12995	29
ABI745_HiSeqL5L6	2694106	2694111		YPO_RS12995	5
ABI745_HiSeqL5L6	2694305	2694330		YPO_RS12995	25
ABI745_HiSeqL5L6	2694609	2694635		YPO_RS13000	26
ABI745_HiSeqL5L6	2704446	2704453		YPO_RS13040	7
ABI745_HiSeqL5L6	2709597	2709600		ppsA	3
ABI745_HiSeqL5L6	2716033	2716034		YPO_RS13080	1
ABI745_HiSeqL5L6	2716881	2716928		arnF	47
ABI745_HiSeqL5L6	2719221	2719222		YPO_RS13105	1
ABI745_HiSeqL5L6	2721459	2721469		arnA	10
ABI745_HiSeqL5L6	2723429	2723436		arnB	7
ABI745_HiSeqL5L6	2726663	2726669		btuC	6
ABI745_HiSeqL5L6	2729408	2729423		pheT	15
ABI745_HiSeqL5L6	2730066	2730097		pheT	31
ABI745_HiSeqL5L6	2730350	2730366		pheT	16
ABI745_HiSeqL5L6	2737226	2737228		YPO_RS13195	2
ABI745_HiSeqL5L6	2745969	2746009		YPO_RS13245	40
ABI745_HiSeqL5L6	2746333	2746344		YPO_RS13245	11
ABI745_HiSeqL5L6	2746589	2746612		YPO_RS13245	23
ABI745_HiSeqL5L6	2748041	2748045		solA	4
ABI745_HiSeqL5L6	2748809	2748838		YPO_RS13255	29
ABI745_HiSeqL5L6	2753041	2753058		YPO_RS13280	17
ABI745_HiSeqL5L6	2758344	2758356		YPO_RS13305	12
ABI745_HiSeqL5L6	2759150	2759158		fae	8
ABI745_HiSeqL5L6	2759762	2759765		YPO_RS13315	3
ABI745_HiSeqL5L6	2762192	2762195		csy2	3
ABI745_HiSeqL5L6	2772821	2772828		YPO_RS13355	7
ABI745_HiSeqL5L6	2773044	2773051		YPO_RS13355	7
ABI745_HiSeqL5L6	2773228	2773237		YPO_RS13355	9
ABI745_HiSeqL5L6	2774388	2774389		YPO_RS13360	1
ABI745_HiSeqL5L6	2777434	2777438		YPO_RS13375	4
ABI745_HiSeqL5L6	2779319	2779327		YPO_RS13385	8
ABI745_HiSeqL5L6	2786558	2786579		YPO_RS13430	21
ABI745_HiSeqL5L6	2792174	2792177		cdiA	3
ABI745_HiSeqL5L6	2792365	2792378		cdiA	13
ABI745_HiSeqL5L6	2796643	2796657		cdiA	14
ABI745_HiSeqL5L6	2809183	2809189		YPO_RS13490	6
ABI745_HiSeqL5L6	2811082	2811085		YPO_RS13500	3
ABI745_HiSeqL5L6	2817547	2817573		rhtA	26
ABI745_HiSeqL5L6	2817774	2817784		rhtA	10
ABI745_HiSeqL5L6	2822518	2822522		glnH	4
ABI745_HiSeqL5L6	2825690	2825700		YPO_RS13570	10
ABI745_HiSeqL5L6	2826179	2826180		YPO_RS13570	1
ABI745_HiSeqL5L6	2826405	2826415		YPO_RS13575	10
ABI745_HiSeqL5L6	2826542	2826572		YPO_RS13575	30
ABI745_HiSeqL5L6	2826646	2826652		YPO_RS13575	6
ABI745_HiSeqL5L6	2826733	2826736		YPO_RS13575	3
ABI745_HiSeqL5L6	2826773	2826791		YPO_RS13575	18
ABI745_HiSeqL5L6	2826829	2826832		YPO_RS13575	3
ABI745_HiSeqL5L6	2826923	2826931		YPO_RS13575	8
ABI745_HiSeqL5L6	2827166	2827173		YPO_RS13575	7
ABI745_HiSeqL5L6	2827321	2827337		YPO_RS13580	16
ABI745_HiSeqL5L6	2827442	2827470		YPO_RS13580	28
ABI745_HiSeqL5L6	2827709	2827712		YPO_RS13580	3
ABI745_HiSeqL5L6	2828034	2828066		YPO_RS13580	32
ABI745_HiSeqL5L6	2831451	2831454		ybiB	3
ABI745_HiSeqL5L6	2832488	2832489		menE	1
ABI745_HiSeqL5L6	2835138	2835148		menH	10
ABI745_HiSeqL5L6	2835651	2835655		menH	4
ABI745_HiSeqL5L6	2836498	2836501		menD	3
ABI745_HiSeqL5L6	2843211	2843217		YPO_RS13645	6
ABI745_HiSeqL5L6	2845931	2845949		YPO_RS13655	18
ABI745_HiSeqL5L6	2846590	2846593		YPO_RS13660	3
ABI745_HiSeqL5L6	2854050	2854065		YPO_RS13690	15
ABI745_HiSeqL5L6	2854366	2854367		YPO_RS13690	1
ABI745_HiSeqL5L6	2855133	2855138		nuoN	5
ABI745_HiSeqL5L6	2857158	2857164		nuoM	6
ABI745_HiSeqL5L6	2857850	2857894		nuoM	44
ABI745_HiSeqL5L6	2858027	2858041		nuoM	14
ABI745_HiSeqL5L6	2859479	2859500		nuoL	21
ABI745_HiSeqL5L6	2859564	2859572		nuoL	8
ABI745_HiSeqL5L6	2859638	2859700		nuoL	62
ABI745_HiSeqL5L6	2864193	2864197		nuoG	4
ABI745_HiSeqL5L6	2865851	2865866		nuoF	15
ABI745_HiSeqL5L6	2871576	2871586		lrhA	10
ABI745_HiSeqL5L6	2874254	2874255		yfbR	1
ABI745_HiSeqL5L6	2878145	2878149		YPO_RS13785	4
ABI745_HiSeqL5L6	2879170	2879173		YPO_RS13790	3
ABI745_HiSeqL5L6	2880083	2880097		ackA	14
ABI745_HiSeqL5L6	2881992	2881996		pta	4
ABI745_HiSeqL5L6	2885170	2885181		YPO_RS13810	11
ABI745_HiSeqL5L6	2885774	2885775		YPO_RS13815	1
ABI745_HiSeqL5L6	2886241	2886248		YPO_RS13820	7
ABI745_HiSeqL5L6	2886374	2886380		YPO_RS13820	6
ABI745_HiSeqL5L6	2886812	2886831		YPO_RS13820	19
ABI745_HiSeqL5L6	2887075	2887089		YPO_RS13825	14
ABI745_HiSeqL5L6	2887722	2887744		YPO_RS13825	22
ABI745_HiSeqL5L6	2888500	2888504		YPO_RS13830	4
ABI745_HiSeqL5L6	2889940	2889943		YPO_RS13830	3
ABI745_HiSeqL5L6	2898232	2898238		YPO_RS13845	6
ABI745_HiSeqL5L6	2898433	2898434		iolD	1
ABI745_HiSeqL5L6	2902225	2902253		YPO_RS13860	28
ABI745_HiSeqL5L6	2905479	2905508		YPO_RS13875	29
ABI745_HiSeqL5L6	2905745	2905751		YPO_RS13875	6
ABI745_HiSeqL5L6	2909956	2909959		iolB	3
ABI745_HiSeqL5L6	2914284	2914285		YPO_RS13920	1
ABI745_HiSeqL5L6	2919762	2919766		lipA	4
ABI745_HiSeqL5L6	2923685	2923686		rlpA	1
ABI745_HiSeqL5L6	2924455	2924469		mrdB	14
ABI745_HiSeqL5L6	2925224	2925239		mrdB	15
ABI745_HiSeqL5L6	2925380	2925382		mrdB	2
ABI745_HiSeqL5L6	2929442	2929445		holA	3
ABI745_HiSeqL5L6	2931579	2931593		leuS	14
ABI745_HiSeqL5L6	2932559	2932566		leuS	7
ABI745_HiSeqL5L6	2935840	2935847		YPO_RS14030	7
ABI745_HiSeqL5L6	2936477	2936506		YPO_RS14030	29
ABI745_HiSeqL5L6	2941506	2941519		YPO_RS14055	13
ABI745_HiSeqL5L6	2943474	2943475		miaB	1
ABI745_HiSeqL5L6	2947666	2947672		asnB	6
ABI745_HiSeqL5L6	2948493	2948500		asnB	7
ABI745_HiSeqL5L6	2950949	2950950		YPO_RS14105	1
ABI745_HiSeqL5L6	2957402	2957404		glnS	2
ABI745_HiSeqL5L6	2969129	2969142		YPO_RS14185	13
ABI745_HiSeqL5L6	2969364	2969388		YPO_RS14185	24
ABI745_HiSeqL5L6	2969519	2969525		YPO_RS14185	6
ABI745_HiSeqL5L6	2969643	2969651		YPO_RS14185	8
ABI745_HiSeqL5L6	2969833	2969834		YPO_RS14190	1
ABI745_HiSeqL5L6	2970255	2970262		YPO_RS14190	7
ABI745_HiSeqL5L6	2970292	2970321		YPO_RS14190	29
ABI745_HiSeqL5L6	2970443	2970553		YPO_RS14190	110
ABI745_HiSeqL5L6	2970664	2970695		YPO_RS14190	31
ABI745_HiSeqL5L6	2976564	2976583		nrdF	19
ABI745_HiSeqL5L6	2978215	2978226		nrdE	11
ABI745_HiSeqL5L6	2982637	2982644		YPO_RS14250	7
ABI745_HiSeqL5L6	2983027	2983067		YPO_RS14250	40
ABI745_HiSeqL5L6	2983138	2983185		YPO_RS14250	47
ABI745_HiSeqL5L6	2983470	2983506		YPO_RS14250	36
ABI745_HiSeqL5L6	2985925	2985932		YPO_RS14265	7
ABI745_HiSeqL5L6	2986870	2986897		YPO_RS14265	27
ABI745_HiSeqL5L6	2987595	2987597		YPO_RS14270	2
ABI745_HiSeqL5L6	2991561	2991572		YPO_RS14290	11
ABI745_HiSeqL5L6	2992671	2992677		YPO_RS14300	6
ABI745_HiSeqL5L6	2998032	2998041		yut	9
ABI745_HiSeqL5L6	3000119	3000124		hdeB	5
ABI745_HiSeqL5L6	3001166	3001178		kch	12
ABI745_HiSeqL5L6	3005151	3005157		chbC	6
ABI745_HiSeqL5L6	3006769	3006780		chbR	11
ABI745_HiSeqL5L6	3007227	3007249		chbG	22
ABI745_HiSeqL5L6	3010102	3010108		pgm	6
ABI745_HiSeqL5L6	3012184	3012258		YPO_RS14405	74
ABI745_HiSeqL5L6	3017766	3017771		kdpB	5
ABI745_HiSeqL5L6	3018249	3018256		kdpB	7
ABI745_HiSeqL5L6	3023322	3023333		phrB	11
ABI745_HiSeqL5L6	3024706	3024716		YPO_RS14460	10
ABI745_HiSeqL5L6	3024999	3025019		YPO_RS14460	20
ABI745_HiSeqL5L6	3026116	3026123		YPO_RS14470	7
ABI745_HiSeqL5L6	3028485	3028500		pxpA	15
ABI745_HiSeqL5L6	3029273	3029275		YPO_RS14490	2
ABI745_HiSeqL5L6	3031196	3031199		pcp	3
ABI745_HiSeqL5L6	3031518	3031524		ung	6
ABI745_HiSeqL5L6	3033619	3033634		YPO_RS14515	15
ABI745_HiSeqL5L6	3044302	3044310		lepA	8
ABI745_HiSeqL5L6	3049065	3049077		YPO_RS14590	12
ABI745_HiSeqL5L6	3049178	3049243		YPO_RS14590	65
ABI745_HiSeqL5L6	3049732	3049767		YPO_RS14590	35
ABI745_HiSeqL5L6	3049849	3049862		YPO_RS14590	13
ABI745_HiSeqL5L6	3050327	3050347		YPO_RS14595	20
ABI745_HiSeqL5L6	3051928	3051930		tssM	2
ABI745_HiSeqL5L6	3054552	3054553		tssM	1
ABI745_HiSeqL5L6	3054626	3054675		tssM	49
ABI745_HiSeqL5L6	3057617	3057640		YPO_RS14610	23
ABI745_HiSeqL5L6	3060026	3060031		YPO_RS14625	5
ABI745_HiSeqL5L6	3060943	3060945		YPO_RS14630	2
ABI745_HiSeqL5L6	3067286	3067296		ccmB	10
ABI745_HiSeqL5L6	3068858	3068860		ccmE	2
ABI745_HiSeqL5L6	3070689	3070708		YPO_RS14690	19
ABI745_HiSeqL5L6	3073222	3073224		ccmI	2
ABI745_HiSeqL5L6	3073754	3073755		mlaA	1
ABI745_HiSeqL5L6	3073805	3073809		mlaA	4
ABI745_HiSeqL5L6	3075220	3075222		fadL	2
ABI745_HiSeqL5L6	3079885	3079917		fadJ	32
ABI745_HiSeqL5L6	3082302	3082319		smrB	17
ABI745_HiSeqL5L6	3084601	3084618		aroC	17
ABI745_HiSeqL5L6	3094376	3094387		YPO_RS14795	11
ABI745_HiSeqL5L6	3099396	3099398		YPO_RS14820	2
ABI745_HiSeqL5L6	3100705	3100707		truA	2
ABI745_HiSeqL5L6	3102521	3102524		accD	3
ABI745_HiSeqL5L6	3103845	3103909		folC	64
ABI745_HiSeqL5L6	3104439	3104440		folC	1
ABI745_HiSeqL5L6	3109481	3109498		hisJ	17
ABI745_HiSeqL5L6	3109581	3109620		hisJ	39
ABI745_HiSeqL5L6	3111466	3111469		hisP	3
ABI745_HiSeqL5L6	3113095	3113108		YPO_RS14885	13
ABI745_HiSeqL5L6	3114638	3114646		yfcE	8
ABI745_HiSeqL5L6	3115608	3115630		yfcD	22
ABI745_HiSeqL5L6	3116688	3116711		YPO_RS14905	23
ABI745_HiSeqL5L6	3117689	3117711		YPO_RS14910	22
ABI745_HiSeqL5L6	3117784	3117800		YPO_RS14910	16
ABI745_HiSeqL5L6	3118326	3118331		YPO_RS14910	5
ABI745_HiSeqL5L6	3118426	3118444		YPO_RS14910	18
ABI745_HiSeqL5L6	3122260	3122261		YPO_RS14930	1
ABI745_HiSeqL5L6	3125545	3125548		yapC	3
ABI745_HiSeqL5L6	3128680	3128686		YPO_RS14975	6
ABI745_HiSeqL5L6	3128859	3128869		YPO_RS14975	10
ABI745_HiSeqL5L6	3128911	3128939		YPO_RS14975	28
ABI745_HiSeqL5L6	3128993	3129014		YPO_RS14975	21
ABI745_HiSeqL5L6	3129402	3129414		YPO_RS14975	12
ABI745_HiSeqL5L6	3129508	3129524		YPO_RS14975	16
ABI745_HiSeqL5L6	3129600	3129613		YPO_RS14975	13
ABI745_HiSeqL5L6	3130401	3130413		YPO_RS14980	12
ABI745_HiSeqL5L6	3131008	3131017		YPO_RS14980	9
ABI745_HiSeqL5L6	3136848	3136868		YPO_RS14995	20
ABI745_HiSeqL5L6	3140417	3140422		YPO_RS15010	5
ABI745_HiSeqL5L6	3140664	3140672		YPO_RS15015	8
ABI745_HiSeqL5L6	3140718	3140741		YPO_RS15015	23
ABI745_HiSeqL5L6	3140968	3141033		YPO_RS15015	65
ABI745_HiSeqL5L6	3141183	3141204		YPO_RS15015	21
ABI745_HiSeqL5L6	3141441	3141443		YPO_RS15015	2
ABI745_HiSeqL5L6	3141696	3141710		YPO_RS15020	14
ABI745_HiSeqL5L6	3141851	3141858		YPO_RS15020	7
ABI745_HiSeqL5L6	3141952	3141956		YPO_RS15020	4
ABI745_HiSeqL5L6	3142778	3142837		YPO_RS15025	59
ABI745_HiSeqL5L6	3149957	3149980		YPO_RS15070	23
ABI745_HiSeqL5L6	3151678	3151680		YPO_RS15090	2
ABI745_HiSeqL5L6	3154169	3154177		upp	8
ABI745_HiSeqL5L6	3157217	3157225		speG	8
ABI745_HiSeqL5L6	3159628	3159644		pstB	16
ABI745_HiSeqL5L6	3160368	3160373		pstA	5
ABI745_HiSeqL5L6	3161013	3161033		pstA	20
ABI745_HiSeqL5L6	3161601	3161616		YPO_RS15145	15
ABI745_HiSeqL5L6	3164189	3164190		ppk1	1
ABI745_HiSeqL5L6	3165416	3165435		ppk1	19
ABI745_HiSeqL5L6	3165613	3165647		ppk1	34
ABI745_HiSeqL5L6	3175031	3175039		YPO_RS15190	8
ABI745_HiSeqL5L6	3175129	3175135		YPO_RS15190	6
ABI745_HiSeqL5L6	3177274	3177275		YPO_RS15195	1
ABI745_HiSeqL5L6	3179866	3179868		YPO_RS15205	2
ABI745_HiSeqL5L6	3181172	3181187		YPO_RS15210	15
ABI745_HiSeqL5L6	3184287	3184292		mdtC	5
ABI745_HiSeqL5L6	3184468	3184477		mdtC	9
ABI745_HiSeqL5L6	3184727	3184737		mdtC	10
ABI745_HiSeqL5L6	3186917	3186921		mdtC	4
ABI745_HiSeqL5L6	3186955	3186960		YPO_RS15220	5
ABI745_HiSeqL5L6	3190016	3190041		baeR	25
ABI745_HiSeqL5L6	3190372	3190390		baeR	18
ABI745_HiSeqL5L6	3192248	3192275		YPO_RS15240	27
ABI745_HiSeqL5L6	3196363	3196367		thiD	4
ABI745_HiSeqL5L6	3198222	3198249		YPO_RS15270	27
ABI745_HiSeqL5L6	3198303	3198305		YPO_RS15275	2
ABI745_HiSeqL5L6	3198663	3198665		YPO_RS15275	2
ABI745_HiSeqL5L6	3200342	3200353		YPO_RS15285	11
ABI745_HiSeqL5L6	3200390	3200424		YPO_RS15285	34
ABI745_HiSeqL5L6	3202983	3202985		YPO_RS15310	2
ABI745_HiSeqL5L6	3204761	3204771		guaA	10
ABI745_HiSeqL5L6	3208576	3208579		YPO_RS15330	3
ABI745_HiSeqL5L6	3211239	3211244		der	5
ABI745_HiSeqL5L6	3212523	3212528		bamB	5
ABI745_HiSeqL5L6	3213247	3213259		YPO_RS15350	12
ABI745_HiSeqL5L6	3216395	3216405		rodZ	10
ABI745_HiSeqL5L6	3219036	3219039		trmG/rlmN	3
ABI745_HiSeqL5L6	3221454	3221460		YPO_RS15385	6
ABI745_HiSeqL5L6	3221501	3221512		YPO_RS15385	11
ABI745_HiSeqL5L6	3222645	3222651		YPO_RS15385	6
ABI745_HiSeqL5L6	3225463	3225485		yapA	22
ABI745_HiSeqL5L6	3231859	3231871		YPO_RS15405	12
ABI745_HiSeqL5L6	3232257	3232261		sseB	4
ABI745_HiSeqL5L6	3235072	3235096		fdx	24
ABI745_HiSeqL5L6	3238984	3238990		YPO_RS15450	6
ABI745_HiSeqL5L6	3241556	3241558		trmJ	2
ABI745_HiSeqL5L6	3242887	3242894		YPO_RS15470	7
ABI745_HiSeqL5L6	3242953	3242956		YPO_RS15470	3
ABI745_HiSeqL5L6	3251239	3251245		hmpA	6
ABI745_HiSeqL5L6	3251831	3251836		hmpA	5
ABI745_HiSeqL5L6	3258546	3258551		YPO_RS15540	5
ABI745_HiSeqL5L6	3259205	3259212		YPO_RS15540	7
ABI745_HiSeqL5L6	3259752	3259763		YPO_RS15545	11
ABI745_HiSeqL5L6	3264497	3264505		purL	8
ABI745_HiSeqL5L6	3264763	3264765		purL	2
ABI745_HiSeqL5L6	3268662	3268664		mltF	2
ABI745_HiSeqL5L6	3272238	3272240		YPO_RS15595	2
ABI745_HiSeqL5L6	3272529	3272540		YPO_RS15595	11
ABI745_HiSeqL5L6	3272897	3272903		YPO_RS15600	6
ABI745_HiSeqL5L6	3273262	3273266		YPO_RS15605	4
ABI745_HiSeqL5L6	3275435	3275437		YPO_RS15620	2
ABI745_HiSeqL5L6	3275582	3275690		YPO_RS15620	108
ABI745_HiSeqL5L6	3275760	3275777		YPO_RS15620	17
ABI745_HiSeqL5L6	3276104	3276107		YPO_RS15625	3
ABI745_HiSeqL5L6	3276161	3276200		YPO_RS15625	39
ABI745_HiSeqL5L6	3276251	3276258		YPO_RS15625	7
ABI745_HiSeqL5L6	3276445	3276497		YPO_RS15625	52
ABI745_HiSeqL5L6	3276749	3276796		YPO_RS15625	47
ABI745_HiSeqL5L6	3276915	3276923		YPO_RS15625	8
ABI745_HiSeqL5L6	3280150	3280164		YPO_RS15645	14
ABI745_HiSeqL5L6	3281273	3281310		tssC	37
ABI745_HiSeqL5L6	3283115	3283122		YPO_RS15660	7
ABI745_HiSeqL5L6	3283399	3283417		YPO_RS15665	18
ABI745_HiSeqL5L6	3283575	3283586		YPO_RS15665	11
ABI745_HiSeqL5L6	3284504	3284522		YPO_RS15665	18
ABI745_HiSeqL5L6	3284741	3284763		YPO_RS15670	22
ABI745_HiSeqL5L6	3284873	3284875		YPO_RS15670	2
ABI745_HiSeqL5L6	3285810	3285816		YPO_RS15675	6
ABI745_HiSeqL5L6	3287125	3287141		YPO_RS15675	16
ABI745_HiSeqL5L6	3296516	3296533		YPO_RS15705	17
ABI745_HiSeqL5L6	3298462	3298466		YPO_RS15715	4
ABI745_HiSeqL5L6	3298993	3299008		YPO_RS15715	15
ABI745_HiSeqL5L6	3299232	3299242		YPO_RS15720	10
ABI745_HiSeqL5L6	3308546	3308551		YPO_RS15755	5
ABI745_HiSeqL5L6	3310557	3310564		YPO_RS15765	7
ABI745_HiSeqL5L6	3310677	3310681		YPO_RS15765	4
ABI745_HiSeqL5L6	3314945	3314956		YPO_RS15775	11
ABI745_HiSeqL5L6	3315148	3315163		YPO_RS15775	15
ABI745_HiSeqL5L6	3315755	3315776		dmsB	21
ABI745_HiSeqL5L6	3316509	3316514		YPO_RS15785	5
ABI745_HiSeqL5L6	3317317	3317325		YPO_RS15790	8
ABI745_HiSeqL5L6	3323352	3323361		alaC	9
ABI745_HiSeqL5L6	3323995	3324000		YPO_RS15830	5
ABI745_HiSeqL5L6	3327177	3327180		YPO_RS15845	3
ABI745_HiSeqL5L6	3327429	3327430		YPO_RS15845	1
ABI745_HiSeqL5L6	3328263	3328298		YPO_RS15850	35
ABI745_HiSeqL5L6	3329683	3329697		YPO_RS15860	14
ABI745_HiSeqL5L6	3331679	3331687		YPO_RS15865	8
ABI745_HiSeqL5L6	3336256	3336263		YPO_RS15920	7
ABI745_HiSeqL5L6	3338512	3338514		ligA	2
ABI745_HiSeqL5L6	3341353	3341371		cysZ	18
ABI745_HiSeqL5L6	3347721	3347726		YPO_RS15975	5
ABI745_HiSeqL5L6	3351517	3351547		macB	30
ABI745_HiSeqL5L6	3353357	3353420		YPO_RS15995	63
ABI745_HiSeqL5L6	3354638	3354651		YPO_RS16000	13
ABI745_HiSeqL5L6	3355527	3355546		YPO_RS16000	19
ABI745_HiSeqL5L6	3362006	3362019		YPO_RS16030	13
ABI745_HiSeqL5L6	3363802	3363803		YPO_RS16040	1
ABI745_HiSeqL5L6	3363886	3363896		YPO_RS16040	10
ABI745_HiSeqL5L6	3364527	3364567		YPO_RS16040	40
ABI745_HiSeqL5L6	3372388	3372408		YPO_RS16075	20
ABI745_HiSeqL5L6	3372625	3372649		YPO_RS16075	24
ABI745_HiSeqL5L6	3374449	3374452		YPO_RS16085	3
ABI745_HiSeqL5L6	3376593	3376635		YPO_RS16095	42
ABI745_HiSeqL5L6	3378194	3378198		YPO_RS16105	4
ABI745_HiSeqL5L6	3381807	3381829		yapL	22
ABI745_HiSeqL5L6	3382299	3382303		yapL	4
ABI745_HiSeqL5L6	3383555	3383582		YPO_RS16125	27
ABI745_HiSeqL5L6	3383731	3383741		YPO_RS16125	10
ABI745_HiSeqL5L6	3385073	3385103		hemF	30
ABI745_HiSeqL5L6	3387988	3387991		maeB	3
ABI745_HiSeqL5L6	3391086	3391090		napA	4
ABI745_HiSeqL5L6	3391350	3391363		napA	13
ABI745_HiSeqL5L6	3391749	3391750		napA	1
ABI745_HiSeqL5L6	3392245	3392248		napA	3
ABI745_HiSeqL5L6	3397156	3397161		acrD	5
ABI745_HiSeqL5L6	3397932	3397936		acrD	4
ABI745_HiSeqL5L6	3399462	3399473		acrD	11
ABI745_HiSeqL5L6	3399965	3399973		YPO_RS16195	8
ABI745_HiSeqL5L6	3400035	3400037		YPO_RS16195	2
ABI745_HiSeqL5L6	3402311	3402365		YPO_RS16205	54
ABI745_HiSeqL5L6	3407194	3407208		YPO_RS16225	14
ABI745_HiSeqL5L6	3407801	3407806		YPO_RS16225	5
ABI745_HiSeqL5L6	3408730	3408748		YPO_RS16230	18
ABI745_HiSeqL5L6	3410079	3410118		YPO_RS16235	39
ABI745_HiSeqL5L6	3411374	3411393		dapE	19
ABI745_HiSeqL5L6	3413251	3413278		YPO_RS16260	27
ABI745_HiSeqL5L6	3414197	3414205		YPO_RS16260	8
ABI745_HiSeqL5L6	3415275	3415277		YPO_RS16265	2
ABI745_HiSeqL5L6	3417625	3417633		YPO_RS16280	8
ABI745_HiSeqL5L6	3419793	3419800		dapA	7
ABI745_HiSeqL5L6	3419874	3419879		dapA	5
ABI745_HiSeqL5L6	3422137	3422141		YPO_RS16305	4
ABI745_HiSeqL5L6	3422179	3422197		YPO_RS16305	18
ABI745_HiSeqL5L6	3428769	3428772		cysS	3
ABI745_HiSeqL5L6	3428864	3428871		cysS	7
ABI745_HiSeqL5L6	3434561	3434567		YPO_RS16360	6
ABI745_HiSeqL5L6	3434608	3434615		YPO_RS16360	7
ABI745_HiSeqL5L6	3436886	3436892		tesA	6
ABI745_HiSeqL5L6	3443003	3443007		copA	4
ABI745_HiSeqL5L6	3451572	3451608		YPO_RS16430	36
ABI745_HiSeqL5L6	3452784	3452800		YPO_RS16435	16
ABI745_HiSeqL5L6	3457108	3457109		YPO_RS16450	1
ABI745_HiSeqL5L6	3457651	3457660		YPO_RS16455	9
ABI745_HiSeqL5L6	3458174	3458178		YPO_RS16455	4
ABI745_HiSeqL5L6	3464884	3464887		YPO_RS16485	3
ABI745_HiSeqL5L6	3464964	3464965		YPO_RS16485	1
ABI745_HiSeqL5L6	3465065	3465084		YPO_RS16485	19
ABI745_HiSeqL5L6	3465567	3465569		YPO_RS16490	2
ABI745_HiSeqL5L6	3466654	3466674		YPO_RS16490	20
ABI745_HiSeqL5L6	3476843	3476845		htpG	2
ABI745_HiSeqL5L6	3478285	3478290		recR	5
ABI745_HiSeqL5L6	3482014	3482016		apt	2
ABI745_HiSeqL5L6	3482972	3483010		YPO_RS16560	38
ABI745_HiSeqL5L6	3483048	3483096		YPO_RS16560	48
ABI745_HiSeqL5L6	3483328	3483339		YPO_RS16560	11
ABI745_HiSeqL5L6	3488563	3488571		mscK	8
ABI745_HiSeqL5L6	3490953	3490959		YPO_RS16600	6
ABI745_HiSeqL5L6	3492266	3492271		YPO_RS16605	5
ABI745_HiSeqL5L6	3494549	3494550		YPO_RS16605	1
ABI745_HiSeqL5L6	3497456	3497457		tomB	1
ABI745_HiSeqL5L6	3497645	3497668		tomB	23
ABI745_HiSeqL5L6	3504145	3504160		YPO_RS16665	15
ABI745_HiSeqL5L6	3505596	3505601		YPO_RS16670	5
ABI745_HiSeqL5L6	3508295	3508308		YPO_RS16680	13
ABI745_HiSeqL5L6	3509078	3509089		cof	11
ABI745_HiSeqL5L6	3509909	3509912		YPO_RS16690	3
ABI745_HiSeqL5L6	3511081	3511085		YPO_RS16690	4
ABI745_HiSeqL5L6	3521644	3521646		tig	2
ABI745_HiSeqL5L6	3527261	3527264		YPO_RS16755	3
ABI745_HiSeqL5L6	3529273	3529282		cyoB	9
ABI745_HiSeqL5L6	3529390	3529405		cyoB	15
ABI745_HiSeqL5L6	3529900	3529937		cyoB	37
ABI745_HiSeqL5L6	3535158	3535161		panE	3
ABI745_HiSeqL5L6	3537680	3537684		thiI	4
ABI745_HiSeqL5L6	3538713	3538728		ispA	15
ABI745_HiSeqL5L6	3540824	3540842		dxs	18
ABI745_HiSeqL5L6	3541502	3541508		dxs	6
ABI745_HiSeqL5L6	3542572	3542574		pgpA	2
ABI745_HiSeqL5L6	3543222	3543228		thiL	6
ABI745_HiSeqL5L6	3548150	3548160		YPO_RS16865	10
ABI745_HiSeqL5L6	3548648	3548657		YPO_RS16870	9
ABI745_HiSeqL5L6	3548715	3548732		YPO_RS16870	17
ABI745_HiSeqL5L6	3549058	3549082		YPO_RS16870	24
ABI745_HiSeqL5L6	3551004	3551006		secD	2
ABI745_HiSeqL5L6	3552956	3552965		tgt	9
ABI745_HiSeqL5L6	3554320	3554323		queA	3
ABI745_HiSeqL5L6	3557218	3557228		YPO_RS16910	10
ABI745_HiSeqL5L6	3560687	3560700		malZ	13
ABI745_HiSeqL5L6	3563545	3563550		proY	5
ABI745_HiSeqL5L6	3564878	3564895		brnQ	17
ABI745_HiSeqL5L6	3567738	3567757		phoR	19
ABI745_HiSeqL5L6	3568308	3568309		phoR	1
ABI745_HiSeqL5L6	3569763	3569766		sbcD	3
ABI745_HiSeqL5L6	3571307	3571313		YPO_RS16965	6
ABI745_HiSeqL5L6	3574424	3574435		YPO_RS16965	11
ABI745_HiSeqL5L6	3574562	3574579		YPO_RS16970	17
ABI745_HiSeqL5L6	3574639	3574676		YPO_RS16970	37
ABI745_HiSeqL5L6	3574838	3574840		YPO_RS16970	2
ABI745_HiSeqL5L6	3574875	3574877		YPO_RS16970	2
ABI745_HiSeqL5L6	3574908	3574964		YPO_RS16970	56
ABI745_HiSeqL5L6	3575148	3575150		YPO_RS16970	2
ABI745_HiSeqL5L6	3575256	3575266		YPO_RS16970	10
ABI745_HiSeqL5L6	3575266	3575300		YPO_RS16975	34
ABI745_HiSeqL5L6	3575758	3575770		YPO_RS16975	12
ABI745_HiSeqL5L6	3575887	3575897		YPO_RS16975	10
ABI745_HiSeqL5L6	3576123	3576129		YPO_RS16975	6
ABI745_HiSeqL5L6	3576249	3576274		YPO_RS16975	25
ABI745_HiSeqL5L6	3584039	3584045		YPO_RS17015	6
ABI745_HiSeqL5L6	3599609	3599619		YPO_RS17080	10
ABI745_HiSeqL5L6	3599831	3599850		YPO_RS17080	19
ABI745_HiSeqL5L6	3601148	3601154		nqrF	6
ABI745_HiSeqL5L6	3608776	3608793		lpcA	17
ABI745_HiSeqL5L6	3608992	3608999		lpcA	7
ABI745_HiSeqL5L6	3609518	3609523		YPO_RS17130	5
ABI745_HiSeqL5L6	3613681	3613696		YPO_RS17140	15
ABI745_HiSeqL5L6	3616268	3616279		YPO_RS17145	11
ABI745_HiSeqL5L6	3620542	3620548		YPO_RS17145	6
ABI745_HiSeqL5L6	3621498	3621503		YPO_RS17150	5
ABI745_HiSeqL5L6	3625259	3625265		YPO_RS17165	6
ABI745_HiSeqL5L6	3625401	3625416		YPO_RS17170	15
ABI745_HiSeqL5L6	3625482	3625545		YPO_RS17170	63
ABI745_HiSeqL5L6	3626700	3626735		YPO_RS17175	35
ABI745_HiSeqL5L6	3627023	3627063		YPO_RS17175	40
ABI745_HiSeqL5L6	3627204	3627213		YPO_RS17180	9
ABI745_HiSeqL5L6	3628803	3628814		YPO_RS17185	11
ABI745_HiSeqL5L6	3634055	3634061		YPO_RS17215	6
ABI745_HiSeqL5L6	3634499	3634502		hpxZ	3
ABI745_HiSeqL5L6	3637128	3637130		ygaH	2
ABI745_HiSeqL5L6	3638498	3638502		emrA	4
ABI745_HiSeqL5L6	3639239	3639246		emrA	7
ABI745_HiSeqL5L6	3640019	3640026		emrB	7
ABI745_HiSeqL5L6	3641613	3641617		YPO_RS17255	4
ABI745_HiSeqL5L6	3642330	3642333		YPO_RS17255	3
ABI745_HiSeqL5L6	3647061	3647063		pssA	2
ABI745_HiSeqL5L6	3647875	3647887		pssA	12
ABI745_HiSeqL5L6	3649927	3649936		YPO_RS17290	9
ABI745_HiSeqL5L6	3661795	3661796		pheA	1
ABI745_HiSeqL5L6	3662663	3662699		pheA	36
ABI745_HiSeqL5L6	3662960	3662997		YPO_RS17350	37
ABI745_HiSeqL5L6	3663352	3663368		YPO_RS17350	16
ABI745_HiSeqL5L6	3663425	3663442		YPO_RS17350	17
ABI745_HiSeqL5L6	3663486	3663491		YPO_RS17350	5
ABI745_HiSeqL5L6	3663694	3663711		YPO_RS17350	17
ABI745_HiSeqL5L6	3664010	3664013		YPO_RS17355	3
ABI745_HiSeqL5L6	3664160	3664173		YPO_RS17355	13
ABI745_HiSeqL5L6	3664523	3664537		YPO_RS17355	14
ABI745_HiSeqL5L6	3674642	3674647		ffh	5
ABI745_HiSeqL5L6	3674777	3674781		ffh	4
ABI745_HiSeqL5L6	3675474	3675482		ffh	8
ABI745_HiSeqL5L6	3678245	3678256		YPO_RS17430	11
ABI745_HiSeqL5L6	3683823	3683825		alaS	2
ABI745_HiSeqL5L6	3686291	3686293		alaS	2
ABI745_HiSeqL5L6	3688367	3688371		pncC	4
ABI745_HiSeqL5L6	3689935	3689948		YPO_RS17505	13
ABI745_HiSeqL5L6	3692587	3692614		YPO_RS17515	27
ABI745_HiSeqL5L6	3693577	3693586		YPO_RS17520	9
ABI745_HiSeqL5L6	3695387	3695401		YPO_RS17525	14
ABI745_HiSeqL5L6	3695603	3695621		YPO_RS17525	18
ABI745_HiSeqL5L6	3696519	3696524		YPO_RS17530	5
ABI745_HiSeqL5L6	3699132	3699135		YPO_RS17540	3
ABI745_HiSeqL5L6	3702079	3702095		katG	16
ABI745_HiSeqL5L6	3702236	3702239		katG	3
ABI745_HiSeqL5L6	3703050	3703061		katG	11
ABI745_HiSeqL5L6	3704344	3704359		cybC	15
ABI745_HiSeqL5L6	3709092	3709109		dmsA	17
ABI745_HiSeqL5L6	3713636	3713647		YPO_RS17600	11
ABI745_HiSeqL5L6	3713908	3713911		YPO_RS17600	3
ABI745_HiSeqL5L6	3714429	3714432		YPO_RS17605	3
ABI745_HiSeqL5L6	3716266	3716284		YPO_RS17610	18
ABI745_HiSeqL5L6	3716390	3716403		YPO_RS17615	13
ABI745_HiSeqL5L6	3717042	3717043		YPO_RS17615	1
ABI745_HiSeqL5L6	3723995	3724007		map	12
ABI745_HiSeqL5L6	3725703	3725704		YPO_RS17650	1
ABI745_HiSeqL5L6	3729036	3729046		YPO_RS17665	10
ABI745_HiSeqL5L6	3729138	3729158		YPO_RS17665	20
ABI745_HiSeqL5L6	3729916	3729922		YPO_RS17665	6
ABI745_HiSeqL5L6	3730451	3730453		YPO_RS17670	2
ABI745_HiSeqL5L6	3730696	3730700		YPO_RS17670	4
ABI745_HiSeqL5L6	3730932	3730938		YPO_RS17670	6
ABI745_HiSeqL5L6	3731060	3731067		YPO_RS17670	7
ABI745_HiSeqL5L6	3733236	3733238		arsB	2
ABI745_HiSeqL5L6	3733539	3733542		arsB	3
ABI745_HiSeqL5L6	3736532	3736541		dhaL	9
ABI745_HiSeqL5L6	3737570	3737573		YPO_RS17705	3
ABI745_HiSeqL5L6	3737842	3737864		YPO_RS17710	22
ABI745_HiSeqL5L6	3738988	3738991		YPO_RS17715	3
ABI745_HiSeqL5L6	3741553	3741559		mutS	6
ABI745_HiSeqL5L6	3744676	3744680		rpoS	4
ABI745_HiSeqL5L6	3746101	3746113		nlpD	12
ABI745_HiSeqL5L6	3747295	3747300		surE	5
ABI745_HiSeqL5L6	3752112	3752119		cysN	7
ABI745_HiSeqL5L6	3754610	3754614		cobA	4
ABI745_HiSeqL5L6	3759108	3759152		cysI	44
ABI745_HiSeqL5L6	3759518	3759545		cysI	27
ABI745_HiSeqL5L6	3763621	3763625		YPO_RS17840	4
ABI745_HiSeqL5L6	3771217	3771231		YPO_RS17870	14
ABI745_HiSeqL5L6	3774380	3774386		degP	6
ABI745_HiSeqL5L6	3776047	3776057		dgt	10
ABI745_HiSeqL5L6	3776605	3776609		dgt	4
ABI745_HiSeqL5L6	3778607	3778617		btuF	10
ABI745_HiSeqL5L6	3778895	3778905		btuF	10
ABI745_HiSeqL5L6	3780423	3780444		erpA	21
ABI745_HiSeqL5L6	3780846	3780852		clcA	6
ABI745_HiSeqL5L6	3782684	3782690		hemL	6
ABI745_HiSeqL5L6	3784485	3784488		fhuB	3
ABI745_HiSeqL5L6	3785526	3785532		fhuB	6
ABI745_HiSeqL5L6	3789469	3789479		mrcB	10
ABI745_HiSeqL5L6	3789543	3789550		mrcB	7
ABI745_HiSeqL5L6	3790729	3790735		mrcB	6
ABI745_HiSeqL5L6	3791287	3791297		hrpB	10
ABI745_HiSeqL5L6	3793878	3793879		thpR	1
ABI745_HiSeqL5L6	3798210	3798221		pcnB	11
ABI745_HiSeqL5L6	3800297	3800303		panC	6
ABI745_HiSeqL5L6	3801880	3801881		YPO_RS17990	1
ABI745_HiSeqL5L6	3802558	3802568		YPO_RS17990	10
ABI745_HiSeqL5L6	3804151	3804160		YPO_RS17995	9
ABI745_HiSeqL5L6	3809306	3809312		speE	6
ABI745_HiSeqL5L6	3811813	3811841		YPO_RS18035	28
ABI745_HiSeqL5L6	3812188	3812189		YPO_RS18035	1
ABI745_HiSeqL5L6	3813530	3813564		acnB	34
ABI745_HiSeqL5L6	3815354	3815377		acnB	23
ABI745_HiSeqL5L6	3816691	3816695		YPO_RS18050	4
ABI745_HiSeqL5L6	3817532	3817541		lpdA	9
ABI745_HiSeqL5L6	3818805	3818836		aceF	31
ABI745_HiSeqL5L6	3820301	3820305		aceE	4
ABI745_HiSeqL5L6	3823900	3823901		pdhR	1
ABI745_HiSeqL5L6	3826831	3826833		ampE	2
ABI745_HiSeqL5L6	3829692	3829695		ppdD	3
ABI745_HiSeqL5L6	3830783	3830794		gspE	11
ABI745_HiSeqL5L6	3831096	3831097		gspE	1
ABI745_HiSeqL5L6	3835239	3835243		zapD	4
ABI745_HiSeqL5L6	3837206	3837238		YPO_RS18135	32
ABI745_HiSeqL5L6	3837338	3837351		YPO_RS18135	13
ABI745_HiSeqL5L6	3837460	3837512		YPO_RS18135	52
ABI745_HiSeqL5L6	3837607	3837618		YPO_RS18135	11
ABI745_HiSeqL5L6	3837786	3837791		YPO_RS18135	5
ABI745_HiSeqL5L6	3837892	3837921		YPO_RS18135	29
ABI745_HiSeqL5L6	3838346	3838349		YPO_RS18140	3
ABI745_HiSeqL5L6	3838476	3838531		YPO_RS18140	55
ABI745_HiSeqL5L6	3838863	3838872		YPO_RS18145	9
ABI745_HiSeqL5L6	3841024	3841033		YPO_RS18150	9
ABI745_HiSeqL5L6	3841230	3841237		YPO_RS18150	7
ABI745_HiSeqL5L6	3844926	3844940		lptF	14
ABI745_HiSeqL5L6	3848113	3848134		YPO_RS18180	21
ABI745_HiSeqL5L6	3858679	3858680		YPO_RS18220	1
ABI745_HiSeqL5L6	3861680	3861704		nrdD	24
ABI745_HiSeqL5L6	3861742	3861747		nrdD	5
ABI745_HiSeqL5L6	3868128	3868142		phnK	14
ABI745_HiSeqL5L6	3872017	3872019		phnP	2
ABI745_HiSeqL5L6	3873683	3873687		YPO_RS18305	4
ABI745_HiSeqL5L6	3878836	3878848		YPO_RS18325	12
ABI745_HiSeqL5L6	3880169	3880179		YPO_RS18330	10
ABI745_HiSeqL5L6	3882328	3882333		YPO_RS18335	5
ABI745_HiSeqL5L6	3884129	3884134		YPO_RS18350	5
ABI745_HiSeqL5L6	3886519	3886529		YPO_RS18360	10
ABI745_HiSeqL5L6	3887304	3887310		YPO_RS18365	6
ABI745_HiSeqL5L6	3887406	3887422		YPO_RS18365	16
ABI745_HiSeqL5L6	3891951	3891957		YPO_RS18375	6
ABI745_HiSeqL5L6	3893053	3893055		YPO_RS18380	2
ABI745_HiSeqL5L6	3898001	3898017		nlpI	16
ABI745_HiSeqL5L6	3899610	3899611		pnp	1
ABI745_HiSeqL5L6	3900901	3900909		YPO_RS18420	8
ABI745_HiSeqL5L6	3901354	3901368		YPO_RS18420	14
ABI745_HiSeqL5L6	3901634	3901636		YPO_RS18420	2
ABI745_HiSeqL5L6	3902403	3902410		rpsO	7
ABI745_HiSeqL5L6	3904841	3904882		infB	41
ABI745_HiSeqL5L6	3905819	3905826		infB	7
ABI745_HiSeqL5L6	3906825	3906843		nusA	18
ABI745_HiSeqL5L6	3911647	3911658		folP	11
ABI745_HiSeqL5L6	3915536	3915562		greA	26
ABI745_HiSeqL5L6	3918156	3918162		pmrA	6
ABI745_HiSeqL5L6	3923139	3923145		ispB	6
ABI745_HiSeqL5L6	3926560	3926562		argR	2
ABI745_HiSeqL5L6	3927874	3927880		mpl	6
ABI745_HiSeqL5L6	3928688	3928718		mpl	30
ABI745_HiSeqL5L6	3928879	3928883		mpl	4
ABI745_HiSeqL5L6	3940447	3940452		YPO_RS18610	5
ABI745_HiSeqL5L6	3946976	3946986		YPO_RS18640	10
ABI745_HiSeqL5L6	3947517	3947537		YPO_RS18645	20
ABI745_HiSeqL5L6	3950360	3950410		yjfP	50
ABI745_HiSeqL5L6	3950505	3950532		YPO_RS18675	27
ABI745_HiSeqL5L6	3950664	3950677		YPO_RS18675	13
ABI745_HiSeqL5L6	3951134	3951136		YPO_RS18675	2
ABI745_HiSeqL5L6	3951201	3951204		YPO_RS18675	3
ABI745_HiSeqL5L6	3951373	3951392		YPO_RS18675	19
ABI745_HiSeqL5L6	3951443	3951484		YPO_RS18675	41
ABI745_HiSeqL5L6	3951746	3951749		YPO_RS18680	3
ABI745_HiSeqL5L6	3951798	3951876		YPO_RS18680	78
ABI745_HiSeqL5L6	3953515	3953517		YPO_RS18690	2
ABI745_HiSeqL5L6	3954121	3954129		YPO_RS18690	8
ABI745_HiSeqL5L6	3955173	3955175		YPO_RS18695	2
ABI745_HiSeqL5L6	3956280	3956287		rsmI	7
ABI745_HiSeqL5L6	3958799	3958803		YPO_RS18710	4
ABI745_HiSeqL5L6	3961821	3961824		mtgA	3
ABI745_HiSeqL5L6	3963330	3963343		arcB	13
ABI745_HiSeqL5L6	3967380	3967386		gltB	6
ABI745_HiSeqL5L6	3968322	3968331		gltB	9
ABI745_HiSeqL5L6	3968680	3968692		gltB	12
ABI745_HiSeqL5L6	3969534	3969537		gltB	3
ABI745_HiSeqL5L6	3970933	3970937		gltB	4
ABI745_HiSeqL5L6	3975102	3975116		sspA	14
ABI745_HiSeqL5L6	3975493	3975496		YPO_RS18775	3
ABI745_HiSeqL5L6	3975601	3975619		YPO_RS18775	18
ABI745_HiSeqL5L6	3977430	3977453		YPO_RS18790	23
ABI745_HiSeqL5L6	3978957	3978968		degQ	11
ABI745_HiSeqL5L6	3982845	3982871		murA	26
ABI745_HiSeqL5L6	3983516	3983518		murA	2
ABI745_HiSeqL5L6	3983926	3983927		ibaG	1
ABI745_HiSeqL5L6	3984781	3984820		mlaC	39
ABI745_HiSeqL5L6	3986894	3986906		mlaF	12
ABI745_HiSeqL5L6	3987256	3987266		mlaF	10
ABI745_HiSeqL5L6	3989415	3989423		kdsD	8
ABI745_HiSeqL5L6	3990717	3990718		lptC	1
ABI745_HiSeqL5L6	3992694	3992699		rpoN	5
ABI745_HiSeqL5L6	3998964	3998989		YPO_RS18920	25
ABI745_HiSeqL5L6	3999127	3999163		YPO_RS18920	36
ABI745_HiSeqL5L6	3999427	3999428		YPO_RS18920	1
ABI745_HiSeqL5L6	3999480	3999509		YPO_RS18920	29
ABI745_HiSeqL5L6	3999556	3999574		YPO_RS18920	18
ABI745_HiSeqL5L6	3999798	3999801		YPO_RS18920	3
ABI745_HiSeqL5L6	3999900	3999922		YPO_RS18925	22
ABI745_HiSeqL5L6	4000053	4000056		YPO_RS18925	3
ABI745_HiSeqL5L6	4000166	4000247		YPO_RS18925	81
ABI745_HiSeqL5L6	4000379	4000383		YPO_RS18925	4
ABI745_HiSeqL5L6	4000486	4000514		YPO_RS18925	28
ABI745_HiSeqL5L6	4004709	4004719		tssJ	10
ABI745_HiSeqL5L6	4004961	4004968		tssK	7
ABI745_HiSeqL5L6	4006791	4006796		YPO_RS18960	5
ABI745_HiSeqL5L6	4006843	4006848		YPO_RS18960	5
ABI745_HiSeqL5L6	4010755	4010757		tagO	2
ABI745_HiSeqL5L6	4012410	4012414		tssM	4
ABI745_HiSeqL5L6	4012512	4012515		tssM	3
ABI745_HiSeqL5L6	4016971	4016980		YPO_RS18995	9
ABI745_HiSeqL5L6	4018157	4018158		YPO_RS19000	1
ABI745_HiSeqL5L6	4021151	4021159		YPO_RS19010	8
ABI745_HiSeqL5L6	4022972	4022980		YPO_RS19010	8
ABI745_HiSeqL5L6	4024261	4024267		YPO_RS19015	6
ABI745_HiSeqL5L6	4027443	4027444		YPO_RS19045	1
ABI745_HiSeqL5L6	4027517	4027523		YPO_RS19045	6
ABI745_HiSeqL5L6	4031527	4031538		YPO_RS19055	11
ABI745_HiSeqL5L6	4032786	4032811		YPO_RS19055	25
ABI745_HiSeqL5L6	4033434	4033439		YPO_RS19055	5
ABI745_HiSeqL5L6	4033984	4033987		YPO_RS19060	3
ABI745_HiSeqL5L6	4034507	4034508		YPO_RS19065	1
ABI745_HiSeqL5L6	4034654	4034667		YPO_RS19065	13
ABI745_HiSeqL5L6	4034984	4034992		YPO_RS19070	8
ABI745_HiSeqL5L6	4037596	4037637		YPO_RS19080	41
ABI745_HiSeqL5L6	4038408	4038410		rbsD	2
ABI745_HiSeqL5L6	4039022	4039031		YPO_RS19090	9
ABI745_HiSeqL5L6	4043389	4043413		ssuD	24
ABI745_HiSeqL5L6	4045078	4045089		ssuB	11
ABI745_HiSeqL5L6	4045119	4045127		ssuB	8
ABI745_HiSeqL5L6	4048644	4048651		YPO_RS19140	7
ABI745_HiSeqL5L6	4051709	4051716		lpxP	7
ABI745_HiSeqL5L6	4051890	4051893		lpxP	3
ABI745_HiSeqL5L6	4052031	4052039		lpxP	8
ABI745_HiSeqL5L6	4055870	4055895		YPO_RS19160	25
ABI745_HiSeqL5L6	4058563	4058582		YPO_RS19175	19
ABI745_HiSeqL5L6	4060473	4060477		yghU	4
ABI745_HiSeqL5L6	4060822	4060834		yghU	12
ABI745_HiSeqL5L6	4062646	4062663		YPO_RS19190	17
ABI745_HiSeqL5L6	4064878	4064891		YPO_RS19200	13
ABI745_HiSeqL5L6	4067619	4067628		YPO_RS19220	9
ABI745_HiSeqL5L6	4067966	4067971		YPO_RS19220	5
ABI745_HiSeqL5L6	4072025	4072042		YPO_RS19245	17
ABI745_HiSeqL5L6	4081923	4081961		msrQ	38
ABI745_HiSeqL5L6	4083762	4083768		YPO_RS19315	6
ABI745_HiSeqL5L6	4086177	4086181		csrD	4
ABI745_HiSeqL5L6	4087793	4087799		YPO_RS19325	6
ABI745_HiSeqL5L6	4096496	4096497		YPO_RS19355	1
ABI745_HiSeqL5L6	4096792	4096803		YPO_RS19355	11
ABI745_HiSeqL5L6	4096965	4096973		YPO_RS19355	8
ABI745_HiSeqL5L6	4099529	4099548		YPO_RS19365	19
ABI745_HiSeqL5L6	4100283	4100294		YPO_RS19365	11
ABI745_HiSeqL5L6	4101537	4101545		YPO_RS19370	8
ABI745_HiSeqL5L6	4102280	4102288		YPO_RS19370	8
ABI745_HiSeqL5L6	4102876	4102878		YPO_RS19370	2
ABI745_HiSeqL5L6	4108571	4108584		YPO_RS19390	13
ABI745_HiSeqL5L6	4108875	4108883		YPO_RS19390	8
ABI745_HiSeqL5L6	4116799	4116802		YPO_RS19410	3
ABI745_HiSeqL5L6	4119133	4119152		YPO_RS19420	19
ABI745_HiSeqL5L6	4119805	4119806		aaeA	1
ABI745_HiSeqL5L6	4121710	4121718		aaeB	8
ABI745_HiSeqL5L6	4124464	4124477		YPO_RS19440	13
ABI745_HiSeqL5L6	4124515	4124518		YPO_RS19440	3
ABI745_HiSeqL5L6	4127422	4127427		YPO_RS19460	5
ABI745_HiSeqL5L6	4130659	4130670		treC	11
ABI745_HiSeqL5L6	4131113	4131126		treC	13
ABI745_HiSeqL5L6	4132152	4132154		treB	2
ABI745_HiSeqL5L6	4133195	4133223		treR	28
ABI745_HiSeqL5L6	4134234	4134243		YPO_RS19490	9
ABI745_HiSeqL5L6	4134288	4134291		YPO_RS19490	3
ABI745_HiSeqL5L6	4134943	4134946		YPO_RS19495	3
ABI745_HiSeqL5L6	4134999	4135034		YPO_RS19495	35
ABI745_HiSeqL5L6	4135272	4135293		YPO_RS19495	21
ABI745_HiSeqL5L6	4135368	4135373		YPO_RS19495	5
ABI745_HiSeqL5L6	4135563	4135570		YPO_RS19495	7
ABI745_HiSeqL5L6	4135672	4135695		YPO_RS19500	23
ABI745_HiSeqL5L6	4135887	4135891		YPO_RS19500	4
ABI745_HiSeqL5L6	4135957	4136024		YPO_RS19500	67
ABI745_HiSeqL5L6	4136335	4136362		YPO_RS19500	27
ABI745_HiSeqL5L6	4136411	4136421		YPO_RS19500	10
ABI745_HiSeqL5L6	4139724	4139725		tssC	1
ABI745_HiSeqL5L6	4140896	4140911		tssC	15
ABI745_HiSeqL5L6	4141079	4141088		tssB	9
ABI745_HiSeqL5L6	4144263	4144281		malM	18
ABI745_HiSeqL5L6	4148939	4148944		malE	5
ABI745_HiSeqL5L6	4156517	4156542		YPO_RS19590	25
ABI745_HiSeqL5L6	4160532	4160546		YPO_RS19595	14
ABI745_HiSeqL5L6	4160588	4160592		YPO_RS19595	4
ABI745_HiSeqL5L6	4164411	4164423		metH	12
ABI745_HiSeqL5L6	4170990	4171000		aceA	10
ABI745_HiSeqL5L6	4172398	4172402		aceB	4
ABI745_HiSeqL5L6	4176213	4176228		YPO_RS19645	15
ABI745_HiSeqL5L6	4181967	4181995		purH	28
ABI745_HiSeqL5L6	4182160	4182162		purH	2
ABI745_HiSeqL5L6	4182279	4182280		purH	1
ABI745_HiSeqL5L6	4183378	4183391		purD	13
ABI745_HiSeqL5L6	4186385	4186397		nfi	12
ABI745_HiSeqL5L6	4189532	4189533		nudC	1
ABI745_HiSeqL5L6	4190032	4190034		rsd	2
ABI745_HiSeqL5L6	4193718	4193723		YPO_RS19730	5
ABI745_HiSeqL5L6	4198407	4198411		rpoC	4
ABI745_HiSeqL5L6	4201704	4201710		rpoB	6
ABI745_HiSeqL5L6	4203658	4203660		rpoB	2
ABI745_HiSeqL5L6	4205592	4205617		rpoB	25
ABI745_HiSeqL5L6	4207766	4207772		rplA	6
ABI745_HiSeqL5L6	4208372	4208394		rplK	22
ABI745_HiSeqL5L6	4210548	4210557		tuf	9
ABI745_HiSeqL5L6	4212619	4212620		YPO_RS19820	1
ABI745_HiSeqL5L6	4212626	4212628		YPO_RS19820	2
ABI745_HiSeqL5L6	4212850	4212903		YPO_RS19825	53
ABI745_HiSeqL5L6	4213062	4213168		YPO_RS19825	106
ABI745_HiSeqL5L6	4213254	4213271		YPO_RS19825	17
ABI745_HiSeqL5L6	4213541	4213574		YPO_RS19825	33
ABI745_HiSeqL5L6	4213615	4213618		YPO_RS19825	3
ABI745_HiSeqL5L6	4213783	4213793		YPO_RS19825	10
ABI745_HiSeqL5L6	4215358	4215377		coaA	19
ABI745_HiSeqL5L6	4215468	4215470		coaA	2
ABI745_HiSeqL5L6	4216378	4216397		birA	19
ABI745_HiSeqL5L6	4216827	4216830		murB	3
ABI745_HiSeqL5L6	4217073	4217075		murB	2
ABI745_HiSeqL5L6	4223136	4223146		YPO_RS19870	10
ABI745_HiSeqL5L6	4225355	4225362		trkH	7
ABI745_HiSeqL5L6	4226843	4226851		YPO_RS19895	8
ABI745_HiSeqL5L6	4227076	4227100		YPO_RS19900	24
ABI745_HiSeqL5L6	4230801	4230805		fadB	4
ABI745_HiSeqL5L6	4232029	4232044		fadA	15
ABI745_HiSeqL5L6	4232904	4232908		fre	4
ABI745_HiSeqL5L6	4233212	4233218		ubiD	6
ABI745_HiSeqL5L6	4233635	4233639		ubiD	4
ABI745_HiSeqL5L6	4236797	4236817		YPO_RS19940	20
ABI745_HiSeqL5L6	4236948	4236955		YPO_RS19945	7
ABI745_HiSeqL5L6	4237013	4237028		YPO_RS19945	15
ABI745_HiSeqL5L6	4237174	4237185		YPO_RS19945	11
ABI745_HiSeqL5L6	4237301	4237330		YPO_RS19945	29
ABI745_HiSeqL5L6	4237377	4237380		YPO_RS19945	3
ABI745_HiSeqL5L6	4237492	4237523		YPO_RS19945	31
ABI745_HiSeqL5L6	4237712	4237762		YPO_RS19950	50
ABI745_HiSeqL5L6	4237929	4237974		YPO_RS19950	45
ABI745_HiSeqL5L6	4238049	4238058		YPO_RS19950	9
ABI745_HiSeqL5L6	4238098	4238106		YPO_RS19950	8
ABI745_HiSeqL5L6	4238181	4238186		YPO_RS19950	5
ABI745_HiSeqL5L6	4243426	4243449		YPO_RS19980	23
ABI745_HiSeqL5L6	4244379	4244384		rmuC	5
ABI745_HiSeqL5L6	4248574	4248587		YPO_RS20000	13
ABI745_HiSeqL5L6	4255558	4255568		YPO_RS20030	10
ABI745_HiSeqL5L6	4255987	4256019		YPO_RS20030	32
ABI745_HiSeqL5L6	4256856	4256867		YPO_RS20035	11
ABI745_HiSeqL5L6	4256992	4256994		YPO_RS20035	2
ABI745_HiSeqL5L6	4257904	4257921		ugpQ	17
ABI745_HiSeqL5L6	4259481	4259484		ugpE	3
ABI745_HiSeqL5L6	4261129	4261152		ugpA	23
ABI745_HiSeqL5L6	4262486	4262493		ugpB	7
ABI745_HiSeqL5L6	4265930	4265931		YPO_RS20070	1
ABI745_HiSeqL5L6	4268802	4268808		YPO_RS20090	6
ABI745_HiSeqL5L6	4270103	4270116		YPO_RS20095	13
ABI745_HiSeqL5L6	4271603	4271624		YPO_RS20105	21
ABI745_HiSeqL5L6	4282543	4282548		YPO_RS20160	5
ABI745_HiSeqL5L6	4285251	4285262		YPO_RS20180	11
ABI745_HiSeqL5L6	4285298	4285301		YPO_RS20180	3
ABI745_HiSeqL5L6	4293062	4293075		glpA	13
ABI745_HiSeqL5L6	4295337	4295345		glpQ	8
ABI745_HiSeqL5L6	4298168	4298170		pldB	2
ABI745_HiSeqL5L6	4298209	4298212		pldB	3
ABI745_HiSeqL5L6	4298394	4298415		pldB	21
ABI745_HiSeqL5L6	4299653	4299658		rhtB	5
ABI745_HiSeqL5L6	4300175	4300182		rhtC	7
ABI745_HiSeqL5L6	4305851	4305866		corA	15
ABI745_HiSeqL5L6	4317999	4318002		YPO_RS20325	3
ABI745_HiSeqL5L6	4318740	4318742		YPO_RS20325	2
ABI745_HiSeqL5L6	4319033	4319053		YPO_RS20325	20
ABI745_HiSeqL5L6	4320321	4320354		hemC	33
ABI745_HiSeqL5L6	4320986	4320991		hemD	5
ABI745_HiSeqL5L6	4321848	4321852		hemX	4
ABI745_HiSeqL5L6	4322592	4322593		hemY	1
ABI745_HiSeqL5L6	4323214	4323220		hemY	6
ABI745_HiSeqL5L6	4329648	4329681		wzyE	33
ABI745_HiSeqL5L6	4330234	4330236		YPO_RS20395	2
ABI745_HiSeqL5L6	4330482	4330505		YPO_RS20395	23
ABI745_HiSeqL5L6	4330866	4330868		YPO_RS20395	2
ABI745_HiSeqL5L6	4333332	4333341		rffA	9
ABI745_HiSeqL5L6	4333524	4333537		rffC	13
ABI745_HiSeqL5L6	4335519	4335521		rffG	2
ABI745_HiSeqL5L6	4338435	4338443		wecB	8
ABI745_HiSeqL5L6	4340395	4340398		wecA	3
ABI745_HiSeqL5L6	4350079	4350092		YPO_RS20480	13
ABI745_HiSeqL5L6	4350557	4350559		YPO_RS20485	2
ABI745_HiSeqL5L6	4350867	4350899		YPO_RS20485	32
ABI745_HiSeqL5L6	4351022	4351025		YPO_RS20485	3
ABI745_HiSeqL5L6	4351461	4351473		YPO_RS20485	12
ABI745_HiSeqL5L6	4351736	4351740		YPO_RS20485	4
ABI745_HiSeqL5L6	4353473	4353492		YPO_RS20495	19
ABI745_HiSeqL5L6	4354746	4354747		YPO_RS20500	1
ABI745_HiSeqL5L6	4359407	4359415		YPO_RS20515	8
ABI745_HiSeqL5L6	4360916	4360938		YPO_RS20530	22
ABI745_HiSeqL5L6	4365144	4365151		YPO_RS20550	7
ABI745_HiSeqL5L6	4367225	4367227		YPO_RS20565	2
ABI745_HiSeqL5L6	4367745	4367769		YPO_RS20570	24
ABI745_HiSeqL5L6	4371547	4371565		ilvD	18
ABI745_HiSeqL5L6	4371911	4371915		ilvD	4
ABI745_HiSeqL5L6	4375268	4375272		ilvL	4
ABI745_HiSeqL5L6	4376891	4376895		YPO_RS20610	4
ABI745_HiSeqL5L6	4376993	4376996		YPO_RS20610	3
ABI745_HiSeqL5L6	4378515	4378523		hdfR	8
ABI745_HiSeqL5L6	4382101	4382105		YPO_RS20635	4
ABI745_HiSeqL5L6	4384336	4384342		YPO_RS20645	6
ABI745_HiSeqL5L6	4388478	4388487		YPO_RS20670	9
ABI745_HiSeqL5L6	4390922	4390923		murI	1
ABI745_HiSeqL5L6	4392069	4392111		btuB	42
ABI745_HiSeqL5L6	4403610	4403613		YPO_RS20735	3
ABI745_HiSeqL5L6	4404699	4404712		YPO_RS20735	13
ABI745_HiSeqL5L6	4410471	4410473		argB	2
ABI745_HiSeqL5L6	4410824	4410826		argB	2
ABI745_HiSeqL5L6	4411105	4411115		argB	10
ABI745_HiSeqL5L6	4416195	4416201		ppc	6
ABI745_HiSeqL5L6	4418120	4418136		YPO_RS20775	16
ABI745_HiSeqL5L6	4418527	4418558		YPO_RS20775	31
ABI745_HiSeqL5L6	4421272	4421282		glpD	10
ABI745_HiSeqL5L6	4425730	4425740		glgA	10
ABI745_HiSeqL5L6	4426824	4426826		glgA	2
ABI745_HiSeqL5L6	4431994	4432004		glgB	10
ABI745_HiSeqL5L6	4436306	4436310		YPO_RS20830	4
ABI745_HiSeqL5L6	4437140	4437184		YPO_RS20830	44
ABI745_HiSeqL5L6	4437247	4437259		YPO_RS20830	12
ABI745_HiSeqL5L6	4437668	4437670		YPO_RS20830	2
ABI745_HiSeqL5L6	4439245	4439257		YPO_RS20830	12
ABI745_HiSeqL5L6	4439785	4439789		YPO_RS20830	4
ABI745_HiSeqL5L6	4439829	4439856		YPO_RS20830	27
ABI745_HiSeqL5L6	4440848	4440862		YPO_RS20830	14
ABI745_HiSeqL5L6	4441268	4441288		YPO_RS20830	20
ABI745_HiSeqL5L6	4442490	4442508		YPO_RS20830	18
ABI745_HiSeqL5L6	4442609	4442615		YPO_RS20830	6
ABI745_HiSeqL5L6	4443927	4443949		YPO_RS20830	22
ABI745_HiSeqL5L6	4447675	4447678		asd	3
ABI745_HiSeqL5L6	4449541	4449544		YPO_RS20870	3
ABI745_HiSeqL5L6	4450280	4450283		YPO_RS20875	3
ABI745_HiSeqL5L6	4454766	4454779		YPO_RS20900	13
ABI745_HiSeqL5L6	4456362	4456370		YPO_RS20910	8
ABI745_HiSeqL5L6	4456794	4456800		YPO_RS20910	6
ABI745_HiSeqL5L6	4457439	4457443		YPO_RS20915	4
ABI745_HiSeqL5L6	4463858	4463863		YPO_RS20940	5
ABI745_HiSeqL5L6	4467134	4467142		pitA	8
ABI745_HiSeqL5L6	4467292	4467293		pitA	1
ABI745_HiSeqL5L6	4473953	4473962		rsmJ	9
ABI745_HiSeqL5L6	4475284	4475290		prlC	6
ABI745_HiSeqL5L6	4475854	4475873		prlC	19
ABI745_HiSeqL5L6	4479232	4479234		gorA	2
ABI745_HiSeqL5L6	4479748	4479793		YPO_RS21000	45
ABI745_HiSeqL5L6	4485846	4485857		yapE	11
ABI745_HiSeqL5L6	4486828	4486832		yapE	4
ABI745_HiSeqL5L6	4487386	4487397		yapE	11
ABI745_HiSeqL5L6	4491381	4491405		YPO_RS21050	24
ABI745_HiSeqL5L6	4495511	4495523		YPO_RS21065	12
ABI745_HiSeqL5L6	4502755	4502756		YPO_RS21090	1
ABI745_HiSeqL5L6	4505373	4505377		hmsP	4
ABI745_HiSeqL5L6	4507636	4507651		YPO_RS21110	15
ABI745_HiSeqL5L6	4511463	4511465		dppB	2
ABI745_HiSeqL5L6	4516122	4516131		YPO_RS21140	9
ABI745_HiSeqL5L6	4520274	4520282		YPO_RS21160	8
ABI745_HiSeqL5L6	4520547	4520578		YPO_RS21160	31
ABI745_HiSeqL5L6	4520711	4520721		YPO_RS21160	10
ABI745_HiSeqL5L6	4521217	4521224		YPO_RS21165	7
ABI745_HiSeqL5L6	4521376	4521391		YPO_RS21165	15
ABI745_HiSeqL5L6	4521572	4521582		YPO_RS21165	10
ABI745_HiSeqL5L6	4523037	4523042		uhpA	5
ABI745_HiSeqL5L6	4523768	4523773		eptB	5
ABI745_HiSeqL5L6	4524460	4524465		eptB	5
ABI745_HiSeqL5L6	4524597	4524603		eptB	6
ABI745_HiSeqL5L6	4527107	4527112		YPO_RS21185	5
ABI745_HiSeqL5L6	4528656	4528691		YPO_RS21190	35
ABI745_HiSeqL5L6	4531575	4531590		hutU	15
ABI745_HiSeqL5L6	4535503	4535506		YPO_RS21215	3
ABI745_HiSeqL5L6	4535578	4535588		YPO_RS21215	10
ABI745_HiSeqL5L6	4540976	4540998		YPO_RS21240	22
ABI745_HiSeqL5L6	4541181	4541204		YPO_RS21240	23
ABI745_HiSeqL5L6	4545393	4545397		YPO_RS21280	4
ABI745_HiSeqL5L6	4546801	4546811		YPO_RS21285	10
ABI745_HiSeqL5L6	4551099	4551114		YPO_RS21305	15
ABI745_HiSeqL5L6	4553247	4553251		xylF	4
ABI745_HiSeqL5L6	4555826	4555834		xylB	8
ABI745_HiSeqL5L6	4555942	4555965		xylB	23
ABI745_HiSeqL5L6	4564150	4564164		YPO_RS21355	14
ABI745_HiSeqL5L6	4564676	4564698		YPO_RS21355	22
ABI745_HiSeqL5L6	4564976	4565029		YPO_RS21355	53
ABI745_HiSeqL5L6	4565395	4565412		YPO_RS21355	17
ABI745_HiSeqL5L6	4570355	4570390		selB	35
ABI745_HiSeqL5L6	4570628	4570655		selB	27
ABI745_HiSeqL5L6	4571288	4571302		YPO_RS21395	14
ABI745_HiSeqL5L6	4572463	4572477		YPO_RS21400	14
ABI745_HiSeqL5L6	4573079	4573095		fdhE	16
ABI745_HiSeqL5L6	4573538	4573544		fdhE	6
ABI745_HiSeqL5L6	4575748	4575753		fdnG	5
ABI745_HiSeqL5L6	4577443	4577446		fdnG	3
ABI745_HiSeqL5L6	4579246	4579249		fdhD	3
ABI745_HiSeqL5L6	4581979	4581991		YPO_RS21435	12
ABI745_HiSeqL5L6	4596170	4596173		YPO_RS21500	3
ABI745_HiSeqL5L6	4596324	4596349		YPO_RS21500	25
ABI745_HiSeqL5L6	4599875	4599884		YPO_RS21515	9
ABI745_HiSeqL5L6	4604146	4604154		YPO_RS21530	8
ABI745_HiSeqL5L6	4605465	4605479		YPO_RS21530	14
ABI745_HiSeqL5L6	4610864	4610870		YPO_RS21565	6
ABI745_HiSeqL5L6	4611353	4611377		YPO_RS21565	24
ABI745_HiSeqL5L6	4612519	4612526		yidA	7
ABI745_HiSeqL5L6	4612592	4612599		yidA	7
ABI745_HiSeqL5L6	4615909	4615925		gyrB	16
ABI745_HiSeqL5L6	4616898	4616914		recF	16
ABI745_HiSeqL5L6	4621851	4621859		yidC	8
ABI745_HiSeqL5L6	4628031	4628044		YPO_RS21640	13
ABI745_HiSeqL5L6	4630737	4630739		YPO_RS21655	2
ABI745_HiSeqL5L6	4630896	4630919		YPO_RS21655	23
ABI745_HiSeqL5L6	4631046	4631049		YPO_RS21660	3
ABI745_HiSeqL5L6	4633982	4633985		phoU	3
ABI745_HiSeqL5L6	4634545	4634559		phoU	14
ABI745_HiSeqL5L6	4636482	4636485		pstA	3
ABI745_HiSeqL5L6	4636487	4636489		pstC	2
ABI745_HiSeqL5L6	4636697	4636703		pstC	6
ABI745_HiSeqL5L6	4639390	4639391		glmS	1
ABI745_HiSeqL5L6	4642432	4642440		glmU	8
ABI745_HiSeqL5L6	4648434	4648439		atpF	5
ABI843_nonUDG	1704	1707		YPO_RS01015	3
ABI843_nonUDG	3168	3183		viaA	15
ABI843_nonUDG	4233	4249		ravA	16
ABI843_nonUDG	5898	5909		kup	11
ABI843_nonUDG	6130	6133		kup	3
ABI843_nonUDG	6833	6860		kup	27
ABI843_nonUDG	7328	7349		kup	21
ABI843_nonUDG	7973	7981		rbsD	8
ABI843_nonUDG	8621	8643		rbsK	22
ABI843_nonUDG	9619	9649		YPO_RS01055	30
ABI843_nonUDG	10470	10476		YPO_RS01055	6
ABI843_nonUDG	10854	10870		YPO_RS01055	16
ABI843_nonUDG	11377	11401		YPO_RS01060	24
ABI843_nonUDG	13700	13706		YPO_RS01070	6
ABI843_nonUDG	15862	15877		YPO_RS01080	15
ABI843_nonUDG	17369	17375		rrf	6
ABI843_nonUDG	19109	19114		YPO_RS01090	5
ABI843_nonUDG	19172	19177		mobB	5
ABI843_nonUDG	19385	19394		mobB	9
ABI843_nonUDG	20079	20092		mobA	13
ABI843_nonUDG	21820	21829		dsbA	9
ABI843_nonUDG	21930	21944		dsbA	14
ABI843_nonUDG	21995	21997		dsbA	2
ABI843_nonUDG	22362	22370		dsbA	8
ABI843_nonUDG	23670	23691		polA	21
ABI843_nonUDG	24015	24017		polA	2
ABI843_nonUDG	24669	24690		polA	21
ABI843_nonUDG	26311	26320		YPO_RS01125	9
ABI843_nonUDG	27242	27253		YPO_RS01130	11
ABI843_nonUDG	28471	28476		yihI	5
ABI843_nonUDG	28599	28609		yihI	10
ABI843_nonUDG	29315	29318		hemN	3
ABI843_nonUDG	29508	29511		hemN	3
ABI843_nonUDG	31442	31443		glnG	1
ABI843_nonUDG	32640	32642		glnL	2
ABI843_nonUDG	33370	33396		glnA	26
ABI843_nonUDG	33537	33554		glnA	17
ABI843_nonUDG	34321	34342		glnA	21
ABI843_nonUDG	35164	35178		typA	14
ABI843_nonUDG	35627	35633		typA	6
ABI843_nonUDG	36383	36397		typA	14
ABI843_nonUDG	36660	36661		typA	1
ABI843_nonUDG	38537	38541		YPO_RS01170	4
ABI843_nonUDG	38655	38701		YPO_RS01170	46
ABI843_nonUDG	38808	38817		YPO_RS01170	9
ABI843_nonUDG	39425	39436		YPO_RS01180	11
ABI843_nonUDG	39731	39793		YPO_RS01180	62
ABI843_nonUDG	40357	40368		YPO_RS01185	11
ABI843_nonUDG	40530	40533		YPO_RS01185	3
ABI843_nonUDG	40738	40759		YPO_RS01185	21
ABI843_nonUDG	41541	41574		fabY	33
ABI843_nonUDG	41704	41708		fabY	4
ABI843_nonUDG	43724	43728		YPO_RS01195	4
ABI843_nonUDG	44447	44451		YPO_RS01200	4
ABI843_nonUDG	44550	44553		YPO_RS01200	3
ABI843_nonUDG	45491	45496		YPO_RS01200	5
ABI843_nonUDG	45631	45640		YPO_RS01200	9
ABI843_nonUDG	46457	46458		gltS	1
ABI843_nonUDG	46518	46520		gltS	2
ABI843_nonUDG	46601	46605		gltS	4
ABI843_nonUDG	46888	46918		gltS	30
ABI843_nonUDG	47771	47778		recG	7
ABI843_nonUDG	47930	47932		recG	2
ABI843_nonUDG	48886	48918		recG	32
ABI843_nonUDG	49077	49083		recG	6
ABI843_nonUDG	49399	49415		recG	16
ABI843_nonUDG	50568	50572		spoT	4
ABI843_nonUDG	50652	50656		spoT	4
ABI843_nonUDG	54813	54827		ligB	14
ABI843_nonUDG	57341	57342		YPO_RS01250	1
ABI843_nonUDG	57700	57712		rph	12
ABI843_nonUDG	58100	58118		rph	18
ABI843_nonUDG	59596	59600		slmA	4
ABI843_nonUDG	62337	62368		YPO_RS01280	31
ABI843_nonUDG	65481	65503		waaA	22
ABI843_nonUDG	65741	65745		waaA	4
ABI843_nonUDG	66028	66033		waaA	5
ABI843_nonUDG	67118	67120		rfaC	2
ABI843_nonUDG	68180	68181		rfaF	1
ABI843_nonUDG	69669	69715		rfaD	46
ABI843_nonUDG	69872	69874		rfaD	2
ABI843_nonUDG	70195	70212		YPO_RS01335	17
ABI843_nonUDG	71659	71670		tdh	11
ABI843_nonUDG	72175	72188		tdh	13
ABI843_nonUDG	73687	73696		envC	9
ABI843_nonUDG	75535	75536		gpmM	1
ABI843_nonUDG	76080	76081		gpmM	1
ABI843_nonUDG	78917	78927		gpsA	10
ABI843_nonUDG	79810	79817		cysE	7
ABI843_nonUDG	79975	79980		cysE	5
ABI843_nonUDG	80740	80747		trmL	7
ABI843_nonUDG	82443	82480		cpxA	37
ABI843_nonUDG	84482	84485		YPO_RS01405	3
ABI843_nonUDG	85572	85575		YPO_RS01415	3
ABI843_nonUDG	85697	85699		YPO_RS01420	2
ABI843_nonUDG	85878	85892		YPO_RS01420	14
ABI843_nonUDG	87762	87775		fieF	13
ABI843_nonUDG	90833	90847		YPO_RS01440	14
ABI843_nonUDG	91758	91769		YPO_RS01445	11
ABI843_nonUDG	93025	93053		YPO_RS01445	28
ABI843_nonUDG	93301	93314		ligK	13
ABI843_nonUDG	93610	93617		ligK	7
ABI843_nonUDG	94179	94197		YPO_RS01455	18
ABI843_nonUDG	94851	94861		YPO_RS01460	10
ABI843_nonUDG	95003	95022		YPO_RS01460	19
ABI843_nonUDG	97614	97639		YPO_RS01470	25
ABI843_nonUDG	98917	98924		fpr	7
ABI843_nonUDG	101833	101847		YPO_RS01495	14
ABI843_nonUDG	105733	105768		YPO_RS01515	35
ABI843_nonUDG	105803	105805		YPO_RS01515	2
ABI843_nonUDG	105903	105933		YPO_RS01515	30
ABI843_nonUDG	106036	106040		YPO_RS01515	4
ABI843_nonUDG	106451	106477		YPO_RS01520	26
ABI843_nonUDG	106577	106596		YPO_RS01520	19
ABI843_nonUDG	106693	106734		YPO_RS01520	41
ABI843_nonUDG	106764	106784		YPO_RS01520	20
ABI843_nonUDG	106944	106977		YPO_RS01520	33
ABI843_nonUDG	107150	107161		YPO_RS01520	11
ABI843_nonUDG	108510	108526		YPO_RS01530	16
ABI843_nonUDG	108619	108622		YPO_RS01530	3
ABI843_nonUDG	109257	109285		YPO_RS01530	28
ABI843_nonUDG	110089	110102		YPO_RS01535	13
ABI843_nonUDG	112147	112154		YPO_RS01550	7
ABI843_nonUDG	112388	112390		YPO_RS01550	2
ABI843_nonUDG	112523	112528		YPO_RS01550	5
ABI843_nonUDG	112645	112647		YPO_RS01550	2
ABI843_nonUDG	113643	113644		hslU	1
ABI843_nonUDG	113968	113981		hslU	13
ABI843_nonUDG	114816	114828		hslV	12
ABI843_nonUDG	115974	115979		ftsN	5
ABI843_nonUDG	116150	116153		cytR	3
ABI843_nonUDG	116402	116408		cytR	6
ABI843_nonUDG	116544	116550		cytR	6
ABI843_nonUDG	116775	116778		cytR	3
ABI843_nonUDG	120046	120056		rpmE	10
ABI843_nonUDG	120825	120828		YPO_RS01585	3
ABI843_nonUDG	120899	120905		YPO_RS01585	6
ABI843_nonUDG	121847	121854		metJ	7
ABI843_nonUDG	123546	123548		YPO_RS01600	2
ABI843_nonUDG	124030	124049		YPO_RS01600	19
ABI843_nonUDG	124113	124122		YPO_RS01600	9
ABI843_nonUDG	126400	126402		metF	2
ABI843_nonUDG	127293	127302		YPO_RS01610	9
ABI843_nonUDG	127335	127337		YPO_RS01610	2
ABI843_nonUDG	127531	127563		YPO_RS01610	32
ABI843_nonUDG	127910	127937		YPO_RS01610	27
ABI843_nonUDG	128164	128165		YPO_RS01610	1
ABI843_nonUDG	128339	128346		YPO_RS01610	7
ABI843_nonUDG	128464	128488		YPO_RS01610	24
ABI843_nonUDG	129400	129403		YPO_RS01615	3
ABI843_nonUDG	129729	129737		glpG	8
ABI843_nonUDG	129925	129996		glpG	71
ABI843_nonUDG	130265	130266		glpG	1
ABI843_nonUDG	131200	131228		malT	28
ABI843_nonUDG	131771	131783		malT	12
ABI843_nonUDG	132688	132692		malT	4
ABI843_nonUDG	132783	132785		malT	2
ABI843_nonUDG	133232	133257		malT	25
ABI843_nonUDG	136630	136655		malQ	25
ABI843_nonUDG	137096	137110		malQ	14
ABI843_nonUDG	140517	140521		bioH	4
ABI843_nonUDG	142508	142540		feoB	32
ABI843_nonUDG	142601	142636		feoB	35
ABI843_nonUDG	143050	143059		feoB	9
ABI843_nonUDG	143445	143454		feoB	9
ABI843_nonUDG	145564	145567		YPO_RS01685	3
ABI843_nonUDG	149184	149197		ompR	13
ABI843_nonUDG	149370	149382		ompR	12
ABI843_nonUDG	149505	149511		envZ	6
ABI843_nonUDG	149903	149928		envZ	25
ABI843_nonUDG	150749	150759		envZ	10
ABI843_nonUDG	151073	151078		pckA	5
ABI843_nonUDG	152514	152517		pckA	3
ABI843_nonUDG	152946	152960		hslO	14
ABI843_nonUDG	153473	153508		hslO	35
ABI843_nonUDG	154297	154303		yrfG	6
ABI843_nonUDG	155762	155797		YPO_RS01725	35
ABI843_nonUDG	155925	155928		YPO_RS01725	3
ABI843_nonUDG	156659	156663		YPO_RS01725	4
ABI843_nonUDG	156914	156923		YPO_RS01725	9
ABI843_nonUDG	158486	158509		mrcA	23
ABI843_nonUDG	159203	159223		mrcA	20
ABI843_nonUDG	161843	161847		YPO_RS01740	4
ABI843_nonUDG	166083	166100		aroB	17
ABI843_nonUDG	167897	167917		YPO_RS01775	20
ABI843_nonUDG	168239	168258		YPO_RS01775	19
ABI843_nonUDG	168362	168369		YPO_RS01775	7
ABI843_nonUDG	169994	169997		rpe	3
ABI843_nonUDG	171222	171228		trpS	6
ABI843_nonUDG	171910	171928		trpS	18
ABI843_nonUDG	172694	172696		cobA	2
ABI843_nonUDG	172957	172968		cobA	11
ABI843_nonUDG	174449	174459		nirC	10
ABI843_nonUDG	174963	174970		nirD	7
ABI843_nonUDG	175626	175630		YPO_RS01815	4
ABI843_nonUDG	175881	175897		YPO_RS01815	16
ABI843_nonUDG	176084	176109		YPO_RS01815	25
ABI843_nonUDG	176299	176303		YPO_RS01815	4
ABI843_nonUDG	176735	176745		YPO_RS01815	10
ABI843_nonUDG	179913	179925		tsgA	12
ABI843_nonUDG	180053	180078		tsgA	25
ABI843_nonUDG	181108	181113		YPO_RS01830	5
ABI843_nonUDG	182539	182551		YPO_RS01830	12
ABI843_nonUDG	183846	183867		YPO_RS01835	21
ABI843_nonUDG	184347	184351		YPO_RS01840	4
ABI843_nonUDG	184524	184531		YPO_RS01840	7
ABI843_nonUDG	184848	184863		YPO_RS01840	15
ABI843_nonUDG	184931	184937		YPO_RS01840	6
ABI843_nonUDG	185001	185005		YPO_RS01840	4
ABI843_nonUDG	185157	185161		YPO_RS01840	4
ABI843_nonUDG	185420	185421		YPO_RS01840	1
ABI843_nonUDG	186456	186460		ppiA	4
ABI843_nonUDG	188810	188817		YPO_RS01855	7
ABI843_nonUDG	188943	188958		YPO_RS01855	15
ABI843_nonUDG	190324	190327		YPO_RS01865	3
ABI843_nonUDG	190537	190540		YPO_RS01865	3
ABI843_nonUDG	191061	191072		YPO_RS01865	11
ABI843_nonUDG	191312	191324		YPO_RS01870	12
ABI843_nonUDG	191396	191429		YPO_RS01870	33
ABI843_nonUDG	191497	191507		YPO_RS01870	10
ABI843_nonUDG	191611	191666		YPO_RS01870	55
ABI843_nonUDG	193068	193082		YPO_RS01880	14
ABI843_nonUDG	194992	195037		YPO_RS01880	45
ABI843_nonUDG	196628	196638		YPO_RS01895	10
ABI843_nonUDG	199015	199020		YPO_RS01910	5
ABI843_nonUDG	199382	199384		YPO_RS01910	2
ABI843_nonUDG	199892	199894		YPO_RS01915	2
ABI843_nonUDG	200859	200867		tauA	8
ABI843_nonUDG	202350	202352		tauC	2
ABI843_nonUDG	202409	202410		tauC	1
ABI843_nonUDG	202472	202483		tauC	11
ABI843_nonUDG	208574	208576		kefG	2
ABI843_nonUDG	209512	209518		kefB	6
ABI843_nonUDG	210743	210744		YPO_RS01965	1
ABI843_nonUDG	210800	210802		YPO_RS01965	2
ABI843_nonUDG	211197	211205		slyD	8
ABI843_nonUDG	214085	214092		tusD	7
ABI843_nonUDG	214474	214494		tusC	20
ABI843_nonUDG	215450	215468		rpsL	18
ABI843_nonUDG	216484	216488		fusA	4
ABI843_nonUDG	216543	216548		fusA	5
ABI843_nonUDG	217459	217465		fusA	6
ABI843_nonUDG	217777	217786		fusA	9
ABI843_nonUDG	217816	217878		fusA	62
ABI843_nonUDG	218010	218016		fusA	6
ABI843_nonUDG	218335	218337		fusA	2
ABI843_nonUDG	218507	218509		tuf	2
ABI843_nonUDG	220256	220263		YPO_RS02025	7
ABI843_nonUDG	220495	220499		bfd	4
ABI843_nonUDG	221059	221080		bfr	21
ABI843_nonUDG	222330	222333		rplC	3
ABI843_nonUDG	222748	222762		rplD	14
ABI843_nonUDG	223207	223212		rplD	5
ABI843_nonUDG	223713	223732		rplB	19
ABI843_nonUDG	224303	224326		rplB	23
ABI843_nonUDG	225060	225086		rpsC	26
ABI843_nonUDG	226004	226006		rplP	2
ABI843_nonUDG	226408	226453		rpsQ	45
ABI843_nonUDG	227508	227515		rplE	7
ABI843_nonUDG	227973	227981		rplE	8
ABI843_nonUDG	228124	228158		rpsN	34
ABI843_nonUDG	228566	228612		rpsH	46
ABI843_nonUDG	229013	229031		rplF	18
ABI843_nonUDG	229251	229258		rplF	7
ABI843_nonUDG	229430	229432		rplR	2
ABI843_nonUDG	230393	230394		rpmD	1
ABI843_nonUDG	230476	230502		rplO	26
ABI843_nonUDG	231642	231658		secY	16
ABI843_nonUDG	231966	231987		secY	21
ABI843_nonUDG	232052	232062		secY	10
ABI843_nonUDG	232800	232813		rpsM	13
ABI843_nonUDG	232910	232918		rpsK	8
ABI843_nonUDG	234104	234122		rpoA	18
ABI843_nonUDG	235888	235893		zntR	5
ABI843_nonUDG	236297	236312		YPO_RS02185	15
ABI843_nonUDG	237606	237642		trkA	36
ABI843_nonUDG	238939	238951		rsmB	12
ABI843_nonUDG	241596	241623		dprA	27
ABI843_nonUDG	241777	241781		dprA	4
ABI843_nonUDG	242434	242465		dprA	31
ABI843_nonUDG	242548	242553		dprA	5
ABI843_nonUDG	242985	242987		YPO_RS02220	2
ABI843_nonUDG	243087	243088		YPO_RS02220	1
ABI843_nonUDG	243223	243242		YPO_RS02225	19
ABI843_nonUDG	244905	244950		aroE	45
ABI843_nonUDG	245088	245114		aroE	26
ABI843_nonUDG	245522	245547		YPO_RS02240	25
ABI843_nonUDG	245962	245971		YPO_RS02245	9
ABI843_nonUDG	246067	246086		YPO_RS02245	19
ABI843_nonUDG	246234	246314		YPO_RS02245	80
ABI843_nonUDG	246622	246629		YPO_RS02250	7
ABI843_nonUDG	246700	246709		YPO_RS02250	9
ABI843_nonUDG	246872	246897		YPO_RS02250	25
ABI843_nonUDG	247792	247799		YPO_RS02255	7
ABI843_nonUDG	248868	248869		actP	1
ABI843_nonUDG	248905	248928		actP	23
ABI843_nonUDG	249202	249212		actP	10
ABI843_nonUDG	249555	249578		actP	23
ABI843_nonUDG	249608	249618		actP	10
ABI843_nonUDG	251305	251313		acs	8
ABI843_nonUDG	251761	251800		acs	39
ABI843_nonUDG	254140	254148		gltP	8
ABI843_nonUDG	254183	254185		gltP	2
ABI843_nonUDG	254609	254615		gltP	6
ABI843_nonUDG	254651	254654		gltP	3
ABI843_nonUDG	255184	255185		YPO_RS02280	1
ABI843_nonUDG	255238	255249		YPO_RS02280	11
ABI843_nonUDG	255280	255308		YPO_RS02280	28
ABI843_nonUDG	255725	255755		YPO_RS02285	30
ABI843_nonUDG	256105	256110		YPO_RS02285	5
ABI843_nonUDG	256787	256812		YPO_RS02285	25
ABI843_nonUDG	257402	257423		YPO_RS02285	21
ABI843_nonUDG	257965	257981		YPO_RS02285	16
ABI843_nonUDG	258202	258219		YPO_RS02285	17
ABI843_nonUDG	259371	259397		YPO_RS02290	26
ABI843_nonUDG	259819	259820		YPO_RS02290	1
ABI843_nonUDG	260406	260412		sctD	6
ABI843_nonUDG	260608	260609		sctD	1
ABI843_nonUDG	261136	261154		sctD	18
ABI843_nonUDG	261504	261521		YPO_RS02300	17
ABI843_nonUDG	262509	262518		sctF	9
ABI843_nonUDG	264349	264354		YPO_RS02330	5
ABI843_nonUDG	265040	265050		sctL	10
ABI843_nonUDG	265546	265567		YPO_RS02340	21
ABI843_nonUDG	265681	265685		YPO_RS02340	4
ABI843_nonUDG	265996	266000		YPO_RS02340	4
ABI843_nonUDG	266469	266472		YPO_RS02340	3
ABI843_nonUDG	266820	266872		YPO_RS02340	52
ABI843_nonUDG	267747	267757		YPO_RS02345	10
ABI843_nonUDG	269642	269645		YPO_RS02360	3
ABI843_nonUDG	270664	270710		sctR	46
ABI843_nonUDG	271316	271338		YPO_RS02370	22
ABI843_nonUDG	272174	272181		sctT	7
ABI843_nonUDG	275513	275515		YPO_RS02395	2
ABI843_nonUDG	275947	275949		YPO_RS02395	2
ABI843_nonUDG	276062	276070		YPO_RS02395	8
ABI843_nonUDG	276841	276860		YPO_RS02400	19
ABI843_nonUDG	276984	276985		YPO_RS02400	1
ABI843_nonUDG	277520	277521		YPO_RS02400	1
ABI843_nonUDG	277987	277992		metC	5
ABI843_nonUDG	278051	278062		metC	11
ABI843_nonUDG	278279	278284		metC	5
ABI843_nonUDG	278653	278654		metC	1
ABI843_nonUDG	280394	280396		YPO_RS02415	2
ABI843_nonUDG	283115	283121		YPO_RS02430	6
ABI843_nonUDG	283423	283440		YPO_RS02430	17
ABI843_nonUDG	284107	284133		YPO_RS02430	26
ABI843_nonUDG	284174	284182		YPO_RS02430	8
ABI843_nonUDG	284909	284924		YPO_RS02430	15
ABI843_nonUDG	284956	284958		YPO_RS02430	2
ABI843_nonUDG	285816	285823		YPO_RS02440	7
ABI843_nonUDG	287008	287020		YPO_RS02450	12
ABI843_nonUDG	287479	287481		YPO_RS02450	2
ABI843_nonUDG	287662	287665		YPO_RS02450	3
ABI843_nonUDG	287971	287973		YPO_RS02450	2
ABI843_nonUDG	290450	290456		YPO_RS02465	6
ABI843_nonUDG	290904	290927		YPO_RS02465	23
ABI843_nonUDG	291853	291883		YPO_RS02470	30
ABI843_nonUDG	292898	292900		YPO_RS02475	2
ABI843_nonUDG	293483	293484		YPO_RS02480	1
ABI843_nonUDG	293571	293591		YPO_RS02480	20
ABI843_nonUDG	297720	297725		YPO_RS02500	5
ABI843_nonUDG	299254	299267		YPO_RS02510	13
ABI843_nonUDG	300728	300753		YPO_RS02520	25
ABI843_nonUDG	302254	302256		YPO_RS02525	2
ABI843_nonUDG	303457	303466		YPO_RS02530	9
ABI843_nonUDG	303544	303572		YPO_RS02530	28
ABI843_nonUDG	304244	304288		YPO_RS02530	44
ABI843_nonUDG	304327	304334		YPO_RS02530	7
ABI843_nonUDG	304825	304839		YPO_RS02530	14
ABI843_nonUDG	308259	308266		YPO_RS02550	7
ABI843_nonUDG	310908	310912		YPO_RS02555	4
ABI843_nonUDG	311360	311364		YPO_RS02555	4
ABI843_nonUDG	313952	313968		yapK	16
ABI843_nonUDG	314220	314232		yapK	12
ABI843_nonUDG	318575	318596		plsB	21
ABI843_nonUDG	318751	318755		plsB	4
ABI843_nonUDG	319482	319485		plsB	3
ABI843_nonUDG	319966	320004		plsB	38
ABI843_nonUDG	325387	325392		YPO_RS02605	5
ABI843_nonUDG	327327	327328		dnaB	1
ABI843_nonUDG	328817	328845		alr	28
ABI843_nonUDG	328959	328988		alr	29
ABI843_nonUDG	329921	329928		YPO_RS02620	7
ABI843_nonUDG	335040	335053		ssb1	13
ABI843_nonUDG	335870	335876		fucO	6
ABI843_nonUDG	336069	336077		fucO	8
ABI843_nonUDG	336427	336428		fucO	1
ABI843_nonUDG	336804	336822		fucO	18
ABI843_nonUDG	337354	337372		rhaD	18
ABI843_nonUDG	337567	337604		rhaD	37
ABI843_nonUDG	339063	339070		YPO_RS02655	7
ABI843_nonUDG	339447	339464		rhaB	17
ABI843_nonUDG	339856	339863		rhaB	7
ABI843_nonUDG	339948	339950		rhaB	2
ABI843_nonUDG	340418	340434		rhaB	16
ABI843_nonUDG	340649	340664		YPO_RS02665	15
ABI843_nonUDG	342666	342682		rhaR	16
ABI843_nonUDG	343404	343415		rhaT	11
ABI843_nonUDG	345851	345861		YPO_RS02695	10
ABI843_nonUDG	345986	346046		YPO_RS02695	60
ABI843_nonUDG	346585	346609		YPO_RS02695	24
ABI843_nonUDG	346896	346997		YPO_RS02695	101
ABI843_nonUDG	348037	348072		YPO_RS02695	35
ABI843_nonUDG	350026	350030		aegA	4
ABI843_nonUDG	351079	351082		aegA	3
ABI843_nonUDG	352100	352105		YPO_RS02715	5
ABI843_nonUDG	352241	352246		YPO_RS02715	5
ABI843_nonUDG	352896	352906		fdhF	10
ABI843_nonUDG	353471	353478		fdhF	7
ABI843_nonUDG	353739	353740		fdhF	1
ABI843_nonUDG	353926	353952		fdhF	26
ABI843_nonUDG	354335	354347		fdhF	12
ABI843_nonUDG	354425	354427		fdhF	2
ABI843_nonUDG	354569	354582		fdhF	13
ABI843_nonUDG	355509	355519		YPO_RS02725	10
ABI843_nonUDG	355757	355761		YPO_RS02725	4
ABI843_nonUDG	356198	356205		YPO_RS02725	7
ABI843_nonUDG	359932	359960		aspA	28
ABI843_nonUDG	360495	360520		fxsA	25
ABI843_nonUDG	360784	360804		fxsA	20
ABI843_nonUDG	360979	360988		fxsA	9
ABI843_nonUDG	364605	364615		epmB	10
ABI843_nonUDG	364902	364912		epmB	10
ABI843_nonUDG	364962	364999		epmB	37
ABI843_nonUDG	365820	365830		efp	10
ABI843_nonUDG	365905	365921		efp	16
ABI843_nonUDG	366413	366418		sugE	5
ABI843_nonUDG	367019	367030		YPO_RS02780	11
ABI843_nonUDG	367167	367168		YPO_RS02780	1
ABI843_nonUDG	373279	373323		mscM	44
ABI843_nonUDG	373435	373438		mscM	3
ABI843_nonUDG	375883	375892		psd	9
ABI843_nonUDG	376034	376037		psd	3
ABI843_nonUDG	376728	376729		psd	1
ABI843_nonUDG	378524	378530		orn	6
ABI843_nonUDG	378615	378617		orn	2
ABI843_nonUDG	380341	380360		queG	19
ABI843_nonUDG	381230	381235		nnr	5
ABI843_nonUDG	382014	382031		nnr	17
ABI843_nonUDG	382348	382349		nnr	1
ABI843_nonUDG	383544	383554		amiB	10
ABI843_nonUDG	386177	386186		mutL	9
ABI843_nonUDG	386754	386760		mutL	6
ABI843_nonUDG	387805	387828		miaA	23
ABI843_nonUDG	389246	389251		hflX	5
ABI843_nonUDG	390462	390472		hflK	10
ABI843_nonUDG	391838	391842		hflC	4
ABI843_nonUDG	392055	392056		hflC	1
ABI843_nonUDG	393004	393012		YPO_RS02895	8
ABI843_nonUDG	393797	393801		YPO_RS02895	4
ABI843_nonUDG	395269	395310		rnr	41
ABI843_nonUDG	395989	395994		rnr	5
ABI843_nonUDG	398252	398258		rlmB	6
ABI843_nonUDG	399840	399849		YPO_RS02915	9
ABI843_nonUDG	400030	400035		YPO_RS02915	5
ABI843_nonUDG	401037	401058		YPO_RS02925	21
ABI843_nonUDG	401114	401129		YPO_RS02930	15
ABI843_nonUDG	401476	401494		YPO_RS02930	18
ABI843_nonUDG	401556	401578		YPO_RS02930	22
ABI843_nonUDG	402026	402027		YPO_RS02935	1
ABI843_nonUDG	402437	402438		YPO_RS02935	1
ABI843_nonUDG	403925	403928		YPO_RS02940	3
ABI843_nonUDG	405995	406051		YPO_RS02945	56
ABI843_nonUDG	406243	406252		YPO_RS02945	9
ABI843_nonUDG	407750	407751		YPO_RS02955	1
ABI843_nonUDG	409565	409568		YPO_RS02965	3
ABI843_nonUDG	409669	409695		YPO_RS02965	26
ABI843_nonUDG	410149	410154		YPO_RS02965	5
ABI843_nonUDG	410349	410367		YPO_RS02965	18
ABI843_nonUDG	410853	410891		YPO_RS02965	38
ABI843_nonUDG	411235	411239		YPO_RS02970	4
ABI843_nonUDG	413287	413298		YPO_RS02980	11
ABI843_nonUDG	413806	413821		YPO_RS02985	15
ABI843_nonUDG	414213	414223		YPO_RS02985	10
ABI843_nonUDG	414399	414416		YPO_RS02985	17
ABI843_nonUDG	415157	415170		YPO_RS02990	13
ABI843_nonUDG	415542	415549		YPO_RS02990	7
ABI843_nonUDG	415617	415634		YPO_RS02990	17
ABI843_nonUDG	416088	416116		YPO_RS02995	28
ABI843_nonUDG	416474	416489		YPO_RS02995	15
ABI843_nonUDG	416850	416855		YPO_RS02995	5
ABI843_nonUDG	417893	417901		YPO_RS03000	8
ABI843_nonUDG	418403	418404		YPO_RS03005	1
ABI843_nonUDG	418449	418473		YPO_RS03005	24
ABI843_nonUDG	418827	418830		YPO_RS03005	3
ABI843_nonUDG	419500	419501		YPO_RS03010	1
ABI843_nonUDG	419923	419930		YPO_RS03015	7
ABI843_nonUDG	420605	420615		YPO_RS03020	10
ABI843_nonUDG	420921	420937		YPO_RS03020	16
ABI843_nonUDG	423454	423455		ptsP	1
ABI843_nonUDG	423719	423721		ptsP	2
ABI843_nonUDG	424151	424154		ptsP	3
ABI843_nonUDG	425243	425254		lsrG	11
ABI843_nonUDG	426564	426580		lsrB	16
ABI843_nonUDG	427069	427119		lsrB	50
ABI843_nonUDG	427296	427327		lsrB	31
ABI843_nonUDG	427886	427890		lsrD	4
ABI843_nonUDG	428131	428153		lsrD	22
ABI843_nonUDG	429000	429009		lsrC	9
ABI843_nonUDG	431148	431153		lsrA	5
ABI843_nonUDG	434192	434202		lsrK	10
ABI843_nonUDG	434840	434870		rfaQ	30
ABI843_nonUDG	435567	435574		rfaQ	7
ABI843_nonUDG	435907	435913		YPO_RS03085	6
ABI843_nonUDG	436073	436105		YPO_RS03085	32
ABI843_nonUDG	436453	436455		YPO_RS03085	2
ABI843_nonUDG	437878	437879		YPO_RS03090	1
ABI843_nonUDG	438628	438636		YPO_RS03095	8
ABI843_nonUDG	439277	439305		YPO_RS03100	28
ABI843_nonUDG	439604	439612		YPO_RS03100	8
ABI843_nonUDG	440285	440293		YPO_RS03100	8
ABI843_nonUDG	441264	441267		YPO_RS03100	3
ABI843_nonUDG	441342	441347		YPO_RS03100	5
ABI843_nonUDG	441423	441431		YPO_RS03100	8
ABI843_nonUDG	442018	442023		YPO_RS03100	5
ABI843_nonUDG	442228	442247		YPO_RS03100	19
ABI843_nonUDG	442758	442769		YPO_RS03105	11
ABI843_nonUDG	444048	444049		YPO_RS03115	1
ABI843_nonUDG	446200	446222		YPO_RS03120	22
ABI843_nonUDG	446581	446586		YPO_RS03120	5
ABI843_nonUDG	446892	446894		YPO_RS03125	2
ABI843_nonUDG	447752	447766		rsmC	14
ABI843_nonUDG	447862	447881		rsmC	19
ABI843_nonUDG	448055	448057		rsmC	2
ABI843_nonUDG	450456	450462		prfC	6
ABI843_nonUDG	450921	451028		prfC	107
ABI843_nonUDG	451187	451191		prfC	4
ABI843_nonUDG	452797	452799		YPO_RS03165	2
ABI843_nonUDG	453710	453721		YPO_RS03165	11
ABI843_nonUDG	453967	453978		YPO_RS03165	11
ABI843_nonUDG	454253	454303		YPO_RS03170	50
ABI843_nonUDG	455422	455430		YPO_RS03175	8
ABI843_nonUDG	455465	455476		YPO_RS03175	11
ABI843_nonUDG	456376	456377		YPO_RS03175	1
ABI843_nonUDG	460779	460783		deoB	4
ABI843_nonUDG	461200	461203		deoD	3
ABI843_nonUDG	462984	462989		serB	5
ABI843_nonUDG	464103	464105		radA	2
ABI843_nonUDG	466116	466137		nadR	21
ABI843_nonUDG	470673	470678		YPO_RS03235	5
ABI843_nonUDG	472800	472817		YPO_RS03245	17
ABI843_nonUDG	472866	472888		YPO_RS03245	22
ABI843_nonUDG	473218	473222		YPO_RS03245	4
ABI843_nonUDG	474707	474712		YPO_RS03245	5
ABI843_nonUDG	476871	476893		sltY	22
ABI843_nonUDG	476984	476986		sltY	2
ABI843_nonUDG	479209	479211		gpmB	2
ABI843_nonUDG	479335	479338		gpmB	3
ABI843_nonUDG	480352	480353		robA	1
ABI843_nonUDG	481376	481391		creA	15
ABI843_nonUDG	482288	482291		arcA	3
ABI843_nonUDG	483897	483898		thrA	1
ABI843_nonUDG	484174	484175		thrA	1
ABI843_nonUDG	484561	484565		thrA	4
ABI843_nonUDG	484803	484818		thrA	15
ABI843_nonUDG	490229	490244		tal	15
ABI843_nonUDG	493382	493384		YPO_RS03325	2
ABI843_nonUDG	493524	493526		YPO_RS03325	2
ABI843_nonUDG	493748	493759		YPO_RS03330	11
ABI843_nonUDG	494028	494052		YPO_RS03330	24
ABI843_nonUDG	494134	494141		YPO_RS03330	7
ABI843_nonUDG	494320	494345		YPO_RS03330	25
ABI843_nonUDG	494523	494537		YPO_RS03330	14
ABI843_nonUDG	494717	494731		YPO_RS03330	14
ABI843_nonUDG	495843	495844		YPO_RS03330	1
ABI843_nonUDG	496621	496634		satP	13
ABI843_nonUDG	497353	497362		dnaK	9
ABI843_nonUDG	498000	498015		dnaK	15
ABI843_nonUDG	498295	498297		dnaK	2
ABI843_nonUDG	498524	498561		dnaK	37
ABI843_nonUDG	501230	501271		nhaA	41
ABI843_nonUDG	501322	501345		nhaA	23
ABI843_nonUDG	501853	501857		nhaA	4
ABI843_nonUDG	502313	502321		nhaR	8
ABI843_nonUDG	504180	504187		ribF	7
ABI843_nonUDG	504455	504468		ribF	13
ABI843_nonUDG	504745	504749		ileS	4
ABI843_nonUDG	504995	505002		ileS	7
ABI843_nonUDG	506022	506024		ileS	2
ABI843_nonUDG	507624	507646		lspA	22
ABI843_nonUDG	507792	507794		lspA	2
ABI843_nonUDG	508241	508255		fkpB	14
ABI843_nonUDG	509185	509186		ispH	1
ABI843_nonUDG	510236	510245		YPO_RS03400	9
ABI843_nonUDG	511118	511126		dapB	8
ABI843_nonUDG	512979	512984		carA	5
ABI843_nonUDG	514646	514655		carB	9
ABI843_nonUDG	514752	514755		carB	3
ABI843_nonUDG	517739	517765		YPO_RS03425	26
ABI843_nonUDG	519794	519795		YPO_RS03440	1
ABI843_nonUDG	520032	520038		YPO_RS03440	6
ABI843_nonUDG	520119	520120		YPO_RS03440	1
ABI843_nonUDG	521326	521355		YPO_RS03450	29
ABI843_nonUDG	522554	522557		apaH	3
ABI843_nonUDG	522574	522584		apaG	10
ABI843_nonUDG	523048	523051		rsmA	3
ABI843_nonUDG	523380	523389		rsmA	9
ABI843_nonUDG	524102	524115		pdxA	13
ABI843_nonUDG	524324	524326		pdxA	2
ABI843_nonUDG	525839	525841		surA	2
ABI843_nonUDG	526303	526312		lptD	9
ABI843_nonUDG	526360	526362		lptD	2
ABI843_nonUDG	526618	526632		lptD	14
ABI843_nonUDG	526818	526834		lptD	16
ABI843_nonUDG	527216	527219		lptD	3
ABI843_nonUDG	527260	527264		lptD	4
ABI843_nonUDG	527716	527733		lptD	17
ABI843_nonUDG	528347	528349		lptD	2
ABI843_nonUDG	528393	528394		lptD	1
ABI843_nonUDG	528876	528878		djlA	2
ABI843_nonUDG	529089	529093		djlA	4
ABI843_nonUDG	529204	529213		djlA	9
ABI843_nonUDG	529305	529314		djlA	9
ABI843_nonUDG	529933	529943		rluA	10
ABI843_nonUDG	532071	532079		YPO_RS03495	8
ABI843_nonUDG	532165	532179		YPO_RS03495	14
ABI843_nonUDG	532956	532970		YPO_RS03500	14
ABI843_nonUDG	533138	533141		YPO_RS03500	3
ABI843_nonUDG	534888	534897		tssC	9
ABI843_nonUDG	534970	534990		tssC	20
ABI843_nonUDG	537142	537143		tssF	1
ABI843_nonUDG	537281	537291		tssF	10
ABI843_nonUDG	538061	538074		tssF	13
ABI843_nonUDG	539439	539450		tssG	11
ABI843_nonUDG	539590	539591		tssG	1
ABI843_nonUDG	539832	539847		tssG	15
ABI843_nonUDG	540776	540789		tssH	13
ABI843_nonUDG	541764	541777		tssH	13
ABI843_nonUDG	542889	542897		vgrG	8
ABI843_nonUDG	543065	543097		vgrG	32
ABI843_nonUDG	544149	544163		vgrG	14
ABI843_nonUDG	544304	544334		vgrG	30
ABI843_nonUDG	544536	544573		vgrG	37
ABI843_nonUDG	544793	544807		vgrG	14
ABI843_nonUDG	545265	545270		YPO_RS03545	5
ABI843_nonUDG	546448	546453		YPO_RS03550	5
ABI843_nonUDG	547165	547170		YPO_RS03555	5
ABI843_nonUDG	547447	547450		YPO_RS03555	3
ABI843_nonUDG	548425	548428		YPO_RS03560	3
ABI843_nonUDG	548795	548810		YPO_RS03560	15
ABI843_nonUDG	549105	549123		YPO_RS03565	18
ABI843_nonUDG	551791	551812		YPO_RS03580	21
ABI843_nonUDG	552176	552178		YPO_RS03580	2
ABI843_nonUDG	554055	554059		tssM	4
ABI843_nonUDG	554508	554518		tssM	10
ABI843_nonUDG	555363	555368		tssM	5
ABI843_nonUDG	555578	555582		tssM	4
ABI843_nonUDG	556377	556379		YPO_RS03590	2
ABI843_nonUDG	556608	556614		YPO_RS03590	6
ABI843_nonUDG	556946	556952		rapA	6
ABI843_nonUDG	557168	557198		rapA	30
ABI843_nonUDG	557770	557779		rapA	9
ABI843_nonUDG	558612	558620		rapA	8
ABI843_nonUDG	558780	558782		rapA	2
ABI843_nonUDG	559003	559006		rapA	3
ABI843_nonUDG	559310	559317		rapA	7
ABI843_nonUDG	559759	559776		rapA	17
ABI843_nonUDG	560342	560345		YPO_RS03600	3
ABI843_nonUDG	561075	561077		YPO_RS03600	2
ABI843_nonUDG	563777	563797		thiQ	20
ABI843_nonUDG	564129	564132		thiQ	3
ABI843_nonUDG	566882	566906		YPO_RS03620	24
ABI843_nonUDG	568154	568155		YPO_RS03625	1
ABI843_nonUDG	568257	568266		YPO_RS03625	9
ABI843_nonUDG	568421	568434		YPO_RS03625	13
ABI843_nonUDG	569309	569312		YPO_RS03625	3
ABI843_nonUDG	571251	571256		YPO_RS03635	5
ABI843_nonUDG	571550	571579		YPO_RS03635	29
ABI843_nonUDG	571661	571720		YPO_RS03635	59
ABI843_nonUDG	571809	571811		YPO_RS03635	2
ABI843_nonUDG	571891	571916		YPO_RS03635	25
ABI843_nonUDG	572121	572141		YPO_RS03640	20
ABI843_nonUDG	572563	572564		YPO_RS03640	1
ABI843_nonUDG	572868	572899		YPO_RS03640	31
ABI843_nonUDG	573687	573714		leuD	27
ABI843_nonUDG	574546	574553		leuC	7
ABI843_nonUDG	574831	574839		leuC	8
ABI843_nonUDG	575122	575125		leuC	3
ABI843_nonUDG	575289	575307		leuC	18
ABI843_nonUDG	575585	575601		leuC	16
ABI843_nonUDG	577023	577035		leuA	12
ABI843_nonUDG	577797	577811		leuA	14
ABI843_nonUDG	577845	577848		leuA	3
ABI843_nonUDG	578566	578616		YPO_RS03670	50
ABI843_nonUDG	578862	578871		YPO_RS03670	9
ABI843_nonUDG	579578	579583		YPO_RS03675	5
ABI843_nonUDG	580938	581005		leuO	67
ABI843_nonUDG	584121	584172		ilvI	51
ABI843_nonUDG	584308	584309		ilvI	1
ABI843_nonUDG	585192	585203		ilvI	11
ABI843_nonUDG	586794	586799		YPO_RS03700	5
ABI843_nonUDG	590998	591004		rsmH	6
ABI843_nonUDG	591137	591171		rsmH	34
ABI843_nonUDG	592189	592193		YPO_RS03735	4
ABI843_nonUDG	592431	592434		YPO_RS03735	3
ABI843_nonUDG	592870	592889		YPO_RS03735	19
ABI843_nonUDG	593077	593090		YPO_RS03735	13
ABI843_nonUDG	593122	593150		YPO_RS03735	28
ABI843_nonUDG	593195	593201		YPO_RS03735	6
ABI843_nonUDG	595000	595008		murE	8
ABI843_nonUDG	595230	595232		murF	2
ABI843_nonUDG	597372	597386		mraY	14
ABI843_nonUDG	597664	597668		murD	4
ABI843_nonUDG	598769	598772		murD	3
ABI843_nonUDG	598808	598811		murD	3
ABI843_nonUDG	599971	599978		ftsW	7
ABI843_nonUDG	600139	600143		murG	4
ABI843_nonUDG	601399	601400		murC	1
ABI843_nonUDG	602530	602548		murC	18
ABI843_nonUDG	603025	603031		YPO_RS03775	6
ABI843_nonUDG	603828	603847		ftsQ	19
ABI843_nonUDG	604692	604704		ftsA	12
ABI843_nonUDG	606206	606207		ftsZ	1
ABI843_nonUDG	606341	606360		ftsZ	19
ABI843_nonUDG	606883	606897		ftsZ	14
ABI843_nonUDG	608023	608045		lpxC	22
ABI843_nonUDG	610337	610347		secA	10
ABI843_nonUDG	611731	611733		secA	2
ABI843_nonUDG	612510	612511		mutT	1
ABI843_nonUDG	612581	612595		mutT	14
ABI843_nonUDG	612653	612691		mutT	38
ABI843_nonUDG	613277	613325		YPO_RS03820	48
ABI843_nonUDG	613649	613656		YPO_RS03820	7
ABI843_nonUDG	613809	613812		YPO_RS03820	3
ABI843_nonUDG	613812	613821		YPO_RS03825	9
ABI843_nonUDG	613939	613970		YPO_RS03825	31
ABI843_nonUDG	614217	614240		YPO_RS03825	23
ABI843_nonUDG	614507	614508		YPO_RS03825	1
ABI843_nonUDG	614641	614671		YPO_RS03825	30
ABI843_nonUDG	618135	618147		YPO_RS03865	12
ABI843_nonUDG	620905	620919		YPO_RS03880	14
ABI843_nonUDG	621870	621872		YPO_RS03880	2
ABI843_nonUDG	623887	623889		uxaC	2
ABI843_nonUDG	625159	625169		YPO_RS03890	10
ABI843_nonUDG	625561	625562		YPO_RS03890	1
ABI843_nonUDG	625623	625625		YPO_RS03890	2
ABI843_nonUDG	626230	626246		YPO_RS03895	16
ABI843_nonUDG	626673	626692		YPO_RS03895	19
ABI843_nonUDG	627745	627750		YPO_RS03900	5
ABI843_nonUDG	627880	627895		YPO_RS03900	15
ABI843_nonUDG	628179	628191		YPO_RS03905	12
ABI843_nonUDG	628249	628251		YPO_RS03905	2
ABI843_nonUDG	629103	629105		sstT	2
ABI843_nonUDG	629174	629181		sstT	7
ABI843_nonUDG	629730	629759		sstT	29
ABI843_nonUDG	630721	630722		YPO_RS03915	1
ABI843_nonUDG	631263	631283		YPO_RS03915	20
ABI843_nonUDG	631864	631869		YPO_RS03920	5
ABI843_nonUDG	632809	632831		yapG	22
ABI843_nonUDG	633483	633497		yapG	14
ABI843_nonUDG	633659	633661		yapG	2
ABI843_nonUDG	634664	634682		yapG	18
ABI843_nonUDG	634760	634816		yapG	56
ABI843_nonUDG	634993	635005		yapG	12
ABI843_nonUDG	637039	637042		rlmG	3
ABI843_nonUDG	637504	637512		YPO_RS03935	8
ABI843_nonUDG	637708	637713		YPO_RS03935	5
ABI843_nonUDG	637923	637933		YPO_RS03935	10
ABI843_nonUDG	639327	639336		YPO_RS03935	9
ABI843_nonUDG	639841	639852		YPO_RS03940	11
ABI843_nonUDG	640115	640123		YPO_RS03940	8
ABI843_nonUDG	640547	640559		YPO_RS03945	12
ABI843_nonUDG	640646	640669		YPO_RS03945	23
ABI843_nonUDG	641454	641469		YPO_RS03945	15
ABI843_nonUDG	641561	641564		YPO_RS03945	3
ABI843_nonUDG	642483	642487		YPO_RS03950	4
ABI843_nonUDG	643839	643840		YPO_RS03955	1
ABI843_nonUDG	644311	644321		YPO_RS03955	10
ABI843_nonUDG	645562	645575		YPO_RS03965	13
ABI843_nonUDG	646118	646120		YPO_RS03965	2
ABI843_nonUDG	648612	648617		YPO_RS03975	5
ABI843_nonUDG	649862	649875		cdiA	13
ABI843_nonUDG	650642	650647		cdiA	5
ABI843_nonUDG	650708	650712		cdiA	4
ABI843_nonUDG	650969	650974		cdiA	5
ABI843_nonUDG	651163	651165		cdiA	2
ABI843_nonUDG	651540	651542		cdiA	2
ABI843_nonUDG	651676	651680		cdiA	4
ABI843_nonUDG	652805	652839		cdiA	34
ABI843_nonUDG	653057	653069		cdiA	12
ABI843_nonUDG	654154	654157		cdiA	3
ABI843_nonUDG	654839	654842		cdiA	3
ABI843_nonUDG	655204	655224		cdiA	20
ABI843_nonUDG	655912	655913		cdiA	1
ABI843_nonUDG	656471	656474		cdiA	3
ABI843_nonUDG	658086	658097		cdiA	11
ABI843_nonUDG	658169	658179		cdiA	10
ABI843_nonUDG	658691	658696		cdiA	5
ABI843_nonUDG	658972	658976		cdiA	4
ABI843_nonUDG	659386	659391		cdiI	5
ABI843_nonUDG	660146	660181		YPO_RS04005	35
ABI843_nonUDG	660218	660227		YPO_RS04005	9
ABI843_nonUDG	661827	661829		yapF	2
ABI843_nonUDG	662153	662156		yapF	3
ABI843_nonUDG	662280	662289		yapF	9
ABI843_nonUDG	662505	662518		yapF	13
ABI843_nonUDG	662797	662812		yapF	15
ABI843_nonUDG	663000	663006		yapF	6
ABI843_nonUDG	663195	663202		yapF	7
ABI843_nonUDG	663582	663602		yapF	20
ABI843_nonUDG	664229	664241		YPO_RS04025	12
ABI843_nonUDG	664733	664744		YPO_RS04025	11
ABI843_nonUDG	665204	665216		YPO_RS04030	12
ABI843_nonUDG	668271	668274		YPO_RS04040	3
ABI843_nonUDG	668914	668923		YPO_RS04040	9
ABI843_nonUDG	669223	669227		YPO_RS04040	4
ABI843_nonUDG	669525	669549		YPO_RS04040	24
ABI843_nonUDG	669676	669686		YPO_RS04040	10
ABI843_nonUDG	671978	671980		YPO_RS04045	2
ABI843_nonUDG	674215	674221		YPO_RS04055	6
ABI843_nonUDG	674632	674641		YPO_RS04055	9
ABI843_nonUDG	675432	675442		YPO_RS04060	10
ABI843_nonUDG	676092	676104		YPO_RS04065	12
ABI843_nonUDG	676155	676166		YPO_RS04070	11
ABI843_nonUDG	676731	676760		YPO_RS04070	29
ABI843_nonUDG	677084	677085		YPO_RS04070	1
ABI843_nonUDG	677496	677499		YPO_RS04070	3
ABI843_nonUDG	677959	677978		YPO_RS04070	19
ABI843_nonUDG	678054	678087		YPO_RS04070	33
ABI843_nonUDG	678402	678427		YPO_RS04075	25
ABI843_nonUDG	679111	679123		YPO_RS04075	12
ABI843_nonUDG	679513	679539		YPO_RS04075	26
ABI843_nonUDG	681058	681069		YPO_RS04080	11
ABI843_nonUDG	681591	681592		YPO_RS04080	1
ABI843_nonUDG	683284	683286		YPO_RS04095	2
ABI843_nonUDG	684979	684984		YPO_RS04100	5
ABI843_nonUDG	685186	685191		YPO_RS04100	5
ABI843_nonUDG	685232	685240		YPO_RS04100	8
ABI843_nonUDG	685289	685316		YPO_RS04100	27
ABI843_nonUDG	685391	685400		YPO_RS04100	9
ABI843_nonUDG	686333	686337		YPO_RS04105	4
ABI843_nonUDG	686864	686879		YPO_RS04110	15
ABI843_nonUDG	687454	687455		YPO_RS04115	1
ABI843_nonUDG	687820	687837		YPO_RS04115	17
ABI843_nonUDG	689622	689644		YPO_RS04130	22
ABI843_nonUDG	690430	690436		YPO_RS04135	6
ABI843_nonUDG	693991	693992		YPO_RS04160	1
ABI843_nonUDG	694192	694210		YPO_RS04160	18
ABI843_nonUDG	694300	694310		YPO_RS04160	10
ABI843_nonUDG	694407	694414		YPO_RS04160	7
ABI843_nonUDG	694907	694938		YPO_RS04165	31
ABI843_nonUDG	695060	695080		YPO_RS04165	20
ABI843_nonUDG	695180	695192		YPO_RS04165	12
ABI843_nonUDG	695228	695238		YPO_RS04165	10
ABI843_nonUDG	695292	695341		YPO_RS04165	49
ABI843_nonUDG	695780	695784		YPO_RS04170	4
ABI843_nonUDG	696005	696014		YPO_RS04170	9
ABI843_nonUDG	696372	696393		YPO_RS04170	21
ABI843_nonUDG	696519	696532		YPO_RS04170	13
ABI843_nonUDG	696708	696720		YPO_RS04170	12
ABI843_nonUDG	697199	697202		YPO_RS04175	3
ABI843_nonUDG	697439	697465		YPO_RS04175	26
ABI843_nonUDG	697575	697577		YPO_RS04175	2
ABI843_nonUDG	699342	699344		rpoD	2
ABI843_nonUDG	700617	700643		rpoD	26
ABI843_nonUDG	700882	700886		rpoD	4
ABI843_nonUDG	701972	701979		dnaG	7
ABI843_nonUDG	702154	702161		dnaG	7
ABI843_nonUDG	703820	703835		tsaD	15
ABI843_nonUDG	704027	704051		tsaD	24
ABI843_nonUDG	705210	705212		plsY	2
ABI843_nonUDG	705422	705435		plsY	13
ABI843_nonUDG	705610	705618		plsY	8
ABI843_nonUDG	707865	707873		YPO_RS04230	8
ABI843_nonUDG	709273	709285		YPO_RS04235	12
ABI843_nonUDG	711939	711941		glnE	2
ABI843_nonUDG	712093	712109		glnE	16
ABI843_nonUDG	712801	712818		glnE	17
ABI843_nonUDG	713195	713209		glnE	14
ABI843_nonUDG	713298	713319		glnE	21
ABI843_nonUDG	715592	715601		hldE	9
ABI843_nonUDG	715683	715684		yjeH	1
ABI843_nonUDG	716042	716044		yjeH	2
ABI843_nonUDG	719818	719831		ygiD	13
ABI843_nonUDG	720488	720507		YPO_RS04275	19
ABI843_nonUDG	720750	720763		YPO_RS04275	13
ABI843_nonUDG	721461	721463		YPO_RS04275	2
ABI843_nonUDG	722736	722743		tolC	7
ABI843_nonUDG	723009	723024		tolC	15
ABI843_nonUDG	723780	723785		tolC	5
ABI843_nonUDG	724755	724767		nudF	12
ABI843_nonUDG	724895	724898		nudF	3
ABI843_nonUDG	726650	726664		yqiA	14
ABI843_nonUDG	727248	727255		parE	7
ABI843_nonUDG	728905	728907		parE	2
ABI843_nonUDG	729499	729500		YPO_RS04315	1
ABI843_nonUDG	730561	730574		YPO_RS04325	13
ABI843_nonUDG	730695	730698		YPO_RS04325	3
ABI843_nonUDG	731249	731253		parC	4
ABI843_nonUDG	731829	731830		parC	1
ABI843_nonUDG	732312	732313		parC	1
ABI843_nonUDG	733655	733658		YPO_RS04335	3
ABI843_nonUDG	733730	733756		YPO_RS04335	26
ABI843_nonUDG	734346	734350		ftsP	4
ABI843_nonUDG	734571	734592		ftsP	21
ABI843_nonUDG	735094	735107		ftsP	13
ABI843_nonUDG	735276	735292		ftsP	16
ABI843_nonUDG	739497	739511		YPO_RS04355	14
ABI843_nonUDG	741341	741351		YPO_RS04365	10
ABI843_nonUDG	743797	743801		metC	4
ABI843_nonUDG	744973	744981		exbB	8
ABI843_nonUDG	746132	746142		exbD	10
ABI843_nonUDG	746621	746627		YPO_RS04390	6
ABI843_nonUDG	747156	747172		YPO_RS04390	16
ABI843_nonUDG	747604	747607		YPO_RS04390	3
ABI843_nonUDG	747921	747933		YPO_RS04395	12
ABI843_nonUDG	748031	748034		YPO_RS04395	3
ABI843_nonUDG	748231	748237		YPO_RS04395	6
ABI843_nonUDG	748921	748935		YPO_RS04405	14
ABI843_nonUDG	749186	749196		YPO_RS04405	10
ABI843_nonUDG	749392	749395		YPO_RS04405	3
ABI843_nonUDG	749720	749722		YPO_RS04410	2
ABI843_nonUDG	750505	750579		YPO_RS04415	74
ABI843_nonUDG	750958	750966		YPO_RS04415	8
ABI843_nonUDG	751082	751106		YPO_RS04415	24
ABI843_nonUDG	751434	751478		YPO_RS04420	44
ABI843_nonUDG	752376	752379		YPO_RS04420	3
ABI843_nonUDG	752814	752817		YPO_RS04425	3
ABI843_nonUDG	753476	753482		YPO_RS04425	6
ABI843_nonUDG	753822	753833		YPO_RS04430	11
ABI843_nonUDG	754412	754417		YPO_RS04435	5
ABI843_nonUDG	754454	754460		YPO_RS04435	6
ABI843_nonUDG	754558	754569		YPO_RS04440	11
ABI843_nonUDG	754856	754857		YPO_RS04440	1
ABI843_nonUDG	755254	755257		YPO_RS04440	3
ABI843_nonUDG	755320	755326		YPO_RS04440	6
ABI843_nonUDG	755378	755409		YPO_RS04445	31
ABI843_nonUDG	755583	755584		YPO_RS04445	1
ABI843_nonUDG	755767	755779		YPO_RS04445	12
ABI843_nonUDG	756556	756568		YPO_RS04450	12
ABI843_nonUDG	757945	757963		YPO_RS04460	18
ABI843_nonUDG	758460	758468		YPO_RS04465	8
ABI843_nonUDG	758602	758612		YPO_RS04465	10
ABI843_nonUDG	759115	759126		YPO_RS04465	11
ABI843_nonUDG	760191	760230		YPO_RS04465	39
ABI843_nonUDG	760535	760538		YPO_RS04465	3
ABI843_nonUDG	760689	760690		YPO_RS04465	1
ABI843_nonUDG	760825	760837		YPO_RS04465	12
ABI843_nonUDG	761077	761078		YPO_RS04470	1
ABI843_nonUDG	761958	761966		YPO_RS04475	8
ABI843_nonUDG	761971	761972		YPO_RS04475	1
ABI843_nonUDG	762048	762050		YPO_RS04475	2
ABI843_nonUDG	762300	762317		YPO_RS04475	17
ABI843_nonUDG	762505	762534		YPO_RS04475	29
ABI843_nonUDG	762566	762567		YPO_RS04475	1
ABI843_nonUDG	764960	764992		YPO_RS04485	32
ABI843_nonUDG	765677	765694		YPO_RS04485	17
ABI843_nonUDG	766181	766182		YPO_RS04490	1
ABI843_nonUDG	766440	766450		YPO_RS04490	10
ABI843_nonUDG	769015	769028		flhB	13
ABI843_nonUDG	769454	769455		flhB	1
ABI843_nonUDG	769520	769534		flhB	14
ABI843_nonUDG	769589	769602		flhB	13
ABI843_nonUDG	770000	770001		flhB	1
ABI843_nonUDG	770202	770209		YPO_RS04505	7
ABI843_nonUDG	770504	770523		YPO_RS04505	19
ABI843_nonUDG	770621	770625		YPO_RS04505	4
ABI843_nonUDG	771364	771376		fliP	12
ABI843_nonUDG	771999	772017		fliN	18
ABI843_nonUDG	773715	773720		YPO_RS04530	5
ABI843_nonUDG	774192	774197		YPO_RS04530	5
ABI843_nonUDG	776293	776302		fliF	9
ABI843_nonUDG	776852	776862		YPO_RS04545	10
ABI843_nonUDG	777982	777987		YPO_RS04550	5
ABI843_nonUDG	778069	778082		YPO_RS04550	13
ABI843_nonUDG	778659	778704		fliI	45
ABI843_nonUDG	779794	779803		fliI	9
ABI843_nonUDG	779807	779816		fliJ	9
ABI843_nonUDG	779864	779886		fliJ	22
ABI843_nonUDG	780010	780015		fliJ	5
ABI843_nonUDG	781856	781864		flgA	8
ABI843_nonUDG	783809	783824		flgD	15
ABI843_nonUDG	784214	784216		flaE	2
ABI843_nonUDG	784673	784683		flaE	10
ABI843_nonUDG	785489	785506		YPO_RS04605	17
ABI843_nonUDG	786144	786158		flgF	14
ABI843_nonUDG	786316	786329		flgF	13
ABI843_nonUDG	786878	786881		flgG	3
ABI843_nonUDG	786967	786970		flgG	3
ABI843_nonUDG	787368	787394		flgG	26
ABI843_nonUDG	787651	787652		flgH	1
ABI843_nonUDG	789353	789364		YPO_RS04625	11
ABI843_nonUDG	789374	789381		flgJ	7
ABI843_nonUDG	790093	790098		flgK	5
ABI843_nonUDG	790424	790449		flgK	25
ABI843_nonUDG	791020	791021		flgK	1
ABI843_nonUDG	791192	791198		flgL	6
ABI843_nonUDG	791294	791311		flgL	17
ABI843_nonUDG	791346	791361		flgL	15
ABI843_nonUDG	791615	791619		flgL	4
ABI843_nonUDG	792114	792133		YPO_RS04645	19
ABI843_nonUDG	793325	793330		YPO_RS04650	5
ABI843_nonUDG	796064	796076		YPO_RS04660	12
ABI843_nonUDG	798596	798607		YPO_RS04670	11
ABI843_nonUDG	801038	801095		fliD	57
ABI843_nonUDG	801768	801774		YPO_RS04685	6
ABI843_nonUDG	803078	803082		YPO_RS04690	4
ABI843_nonUDG	803362	803368		YPO_RS04695	6
ABI843_nonUDG	803577	803589		YPO_RS04695	12
ABI843_nonUDG	805301	805304		lafU	3
ABI843_nonUDG	806787	806798		YPO_RS04715	11
ABI843_nonUDG	807954	807971		YPO_RS04725	17
ABI843_nonUDG	809054	809071		YPO_RS04735	17
ABI843_nonUDG	809238	809241		YPO_RS04735	3
ABI843_nonUDG	810464	810466		YPO_RS04740	2
ABI843_nonUDG	810724	810726		YPO_RS04740	2
ABI843_nonUDG	810816	810827		YPO_RS04740	11
ABI843_nonUDG	810907	810924		YPO_RS04740	17
ABI843_nonUDG	811016	811018		YPO_RS04740	2
ABI843_nonUDG	811227	811242		YPO_RS04745	15
ABI843_nonUDG	811347	811370		YPO_RS04745	23
ABI843_nonUDG	811505	811506		YPO_RS04745	1
ABI843_nonUDG	811823	811851		YPO_RS04745	28
ABI843_nonUDG	813477	813499		YPO_RS04750	22
ABI843_nonUDG	813922	813947		YPO_RS04755	25
ABI843_nonUDG	813979	814004		YPO_RS04755	25
ABI843_nonUDG	814062	814075		YPO_RS04755	13
ABI843_nonUDG	815140	815145		YPO_RS04755	5
ABI843_nonUDG	816713	816737		YPO_RS04765	24
ABI843_nonUDG	817088	817092		YPO_RS04770	4
ABI843_nonUDG	818751	818752		YPO_RS04770	1
ABI843_nonUDG	818848	818852		YPO_RS04770	4
ABI843_nonUDG	820481	820506		YPO_RS04770	25
ABI843_nonUDG	821094	821113		YPO_RS04770	19
ABI843_nonUDG	821737	821739		YPO_RS04775	2
ABI843_nonUDG	822569	822596		vgrG	27
ABI843_nonUDG	823175	823182		vgrG	7
ABI843_nonUDG	823672	823676		vgrG	4
ABI843_nonUDG	824150	824151		vgrG	1
ABI843_nonUDG	830336	830338		gntP	2
ABI843_nonUDG	830762	830769		gntP	7
ABI843_nonUDG	830914	830917		gntP	3
ABI843_nonUDG	831453	831460		gntP	7
ABI843_nonUDG	834206	834208		YPO_RS04800	2
ABI843_nonUDG	834382	834411		YPO_RS04800	29
ABI843_nonUDG	835964	835972		YPO_RS04805	8
ABI843_nonUDG	836714	836725		YPO_RS04805	11
ABI843_nonUDG	837344	837362		YPO_RS04810	18
ABI843_nonUDG	837664	837666		YPO_RS04810	2
ABI843_nonUDG	838436	838454		YPO_RS04810	18
ABI843_nonUDG	838928	838940		YPO_RS04815	12
ABI843_nonUDG	839047	839055		YPO_RS04815	8
ABI843_nonUDG	839324	839326		YPO_RS04815	2
ABI843_nonUDG	839451	839456		YPO_RS04815	5
ABI843_nonUDG	839599	839602		YPO_RS04815	3
ABI843_nonUDG	841004	841046		YPO_RS04825	42
ABI843_nonUDG	841578	841586		YPO_RS04825	8
ABI843_nonUDG	841893	841895		YPO_RS04830	2
ABI843_nonUDG	842065	842081		YPO_RS04830	16
ABI843_nonUDG	842959	842964		YPO_RS04835	5
ABI843_nonUDG	843836	843842		YPO_RS04835	6
ABI843_nonUDG	844039	844056		YPO_RS04835	17
ABI843_nonUDG	844744	844750		YPO_RS04835	6
ABI843_nonUDG	844890	844895		YPO_RS04835	5
ABI843_nonUDG	845145	845168		YPO_RS04835	23
ABI843_nonUDG	845555	845558		YPO_RS04835	3
ABI843_nonUDG	845588	845592		YPO_RS04835	4
ABI843_nonUDG	845982	845996		YPO_RS04835	14
ABI843_nonUDG	846494	846498		YPO_RS04835	4
ABI843_nonUDG	846836	846861		YPO_RS04835	25
ABI843_nonUDG	847086	847092		YPO_RS04835	6
ABI843_nonUDG	848482	848484		YPO_RS04835	2
ABI843_nonUDG	849701	849703		YPO_RS04840	2
ABI843_nonUDG	849960	849982		YPO_RS04840	22
ABI843_nonUDG	850259	850314		YPO_RS04840	55
ABI843_nonUDG	851308	851311		YPO_RS04845	3
ABI843_nonUDG	851572	851576		YPO_RS04845	4
ABI843_nonUDG	851762	851797		YPO_RS04845	35
ABI843_nonUDG	852485	852497		YPO_RS04845	12
ABI843_nonUDG	852930	852942		YPO_RS04845	12
ABI843_nonUDG	853055	853066		YPO_RS04845	11
ABI843_nonUDG	853756	853770		YPO_RS04845	14
ABI843_nonUDG	854517	854525		YPO_RS04845	8
ABI843_nonUDG	854971	855021		YPO_RS04845	50
ABI843_nonUDG	856546	856549		YPO_RS04845	3
ABI843_nonUDG	857595	857633		YPO_RS04850	38
ABI843_nonUDG	857779	857821		YPO_RS04855	42
ABI843_nonUDG	857875	857911		YPO_RS04855	36
ABI843_nonUDG	858095	858126		YPO_RS04855	31
ABI843_nonUDG	858399	858405		YPO_RS04855	6
ABI843_nonUDG	858469	858522		YPO_RS04855	53
ABI843_nonUDG	858927	858930		YPO_RS04860	3
ABI843_nonUDG	858968	858984		YPO_RS04860	16
ABI843_nonUDG	860120	860149		thyA	29
ABI843_nonUDG	860559	860566		lgt	7
ABI843_nonUDG	860931	860932		lgt	1
ABI843_nonUDG	861114	861118		lgt	4
ABI843_nonUDG	861494	861516		ptsP	22
ABI843_nonUDG	861646	861659		ptsP	13
ABI843_nonUDG	861774	861786		ptsP	12
ABI843_nonUDG	862486	862491		ptsP	5
ABI843_nonUDG	862558	862575		ptsP	17
ABI843_nonUDG	863521	863542		ptsP	21
ABI843_nonUDG	863822	863825		rppH	3
ABI843_nonUDG	863875	863884		rppH	9
ABI843_nonUDG	864958	864960		mutH	2
ABI843_nonUDG	865105	865106		mutH	1
ABI843_nonUDG	866936	866957		YPO_RS04890	21
ABI843_nonUDG	867437	867457		YPO_RS04895	20
ABI843_nonUDG	868192	868203		lplT	11
ABI843_nonUDG	868562	868565		lplT	3
ABI843_nonUDG	869631	869632		aas	1
ABI843_nonUDG	871955	871961		YPO_RS04915	6
ABI843_nonUDG	872793	872817		YPO_RS04915	24
ABI843_nonUDG	873252	873263		YPO_RS04915	11
ABI843_nonUDG	874007	874016		YPO_RS04915	9
ABI843_nonUDG	877575	877613		YPO_RS04930	38
ABI843_nonUDG	878511	878513		YPO_RS04935	2
ABI843_nonUDG	878887	878896		YPO_RS04935	9
ABI843_nonUDG	880402	880411		YPO_RS04945	9
ABI843_nonUDG	880717	880719		YPO_RS04945	2
ABI843_nonUDG	880849	880860		YPO_RS04945	11
ABI843_nonUDG	882550	882552		YPO_RS04955	2
ABI843_nonUDG	882981	883001		YPO_RS04955	20
ABI843_nonUDG	883048	883050		YPO_RS04955	2
ABI843_nonUDG	884012	884014		YPO_RS04960	2
ABI843_nonUDG	884627	884682		YPO_RS04965	55
ABI843_nonUDG	884787	884789		YPO_RS04965	2
ABI843_nonUDG	886484	886500		YPO_RS04980	16
ABI843_nonUDG	886619	886626		YPO_RS04980	7
ABI843_nonUDG	887160	887162		gspL	2
ABI843_nonUDG	887405	887417		gspL	12
ABI843_nonUDG	888110	888192		YPO_RS04990	82
ABI843_nonUDG	888936	888939		YPO_RS04990	3
ABI843_nonUDG	888977	888986		YPO_RS04990	9
ABI843_nonUDG	889052	889066		gspJ	14
ABI843_nonUDG	889309	889403		gspJ	94
ABI843_nonUDG	889498	889509		gspJ	11
ABI843_nonUDG	889559	889569		gspJ	10
ABI843_nonUDG	889984	890010		YPO_RS05005	26
ABI843_nonUDG	890134	890156		YPO_RS05005	22
ABI843_nonUDG	890450	890454		YPO_RS05005	4
ABI843_nonUDG	890874	890903		gspG	29
ABI843_nonUDG	893360	893364		gspE	4
ABI843_nonUDG	893950	893953		gspD	3
ABI843_nonUDG	894871	894876		gspD	5
ABI843_nonUDG	895340	895378		gspD	38
ABI843_nonUDG	895449	895493		gspD	44
ABI843_nonUDG	895539	895606		gspD	67
ABI843_nonUDG	895723	895754		YPO_RS05030	31
ABI843_nonUDG	895974	895993		YPO_RS05030	19
ABI843_nonUDG	896154	896158		YPO_RS05030	4
ABI843_nonUDG	896263	896267		YPO_RS05035	4
ABI843_nonUDG	896410	896417		YPO_RS05035	7
ABI843_nonUDG	896673	896674		YPO_RS05035	1
ABI843_nonUDG	899669	899716		YPO_RS05050	47
ABI843_nonUDG	900170	900172		YPO_RS05050	2
ABI843_nonUDG	900339	900343		YPO_RS05050	4
ABI843_nonUDG	900834	900861		yapM	27
ABI843_nonUDG	901349	901382		yapM	33
ABI843_nonUDG	901520	901531		yapM	11
ABI843_nonUDG	901725	901740		yapM	15
ABI843_nonUDG	902792	902818		YPO_RS05060	26
ABI843_nonUDG	902849	902857		YPO_RS05060	8
ABI843_nonUDG	903926	903962		YPO_RS05060	36
ABI843_nonUDG	904039	904046		YPO_RS05060	7
ABI843_nonUDG	904382	904391		YPO_RS05060	9
ABI843_nonUDG	904442	904456		YPO_RS05060	14
ABI843_nonUDG	904814	904832		YPO_RS05060	18
ABI843_nonUDG	904971	904996		YPO_RS05060	25
ABI843_nonUDG	905319	905321		YPO_RS05060	2
ABI843_nonUDG	906320	906321		YPO_RS05065	1
ABI843_nonUDG	906389	906417		YPO_RS05065	28
ABI843_nonUDG	906496	906500		YPO_RS05065	4
ABI843_nonUDG	906625	906694		YPO_RS05065	69
ABI843_nonUDG	907042	907048		YPO_RS05070	6
ABI843_nonUDG	907139	907150		YPO_RS05070	11
ABI843_nonUDG	907204	907217		YPO_RS05070	13
ABI843_nonUDG	907254	907259		YPO_RS05070	5
ABI843_nonUDG	907321	907337		YPO_RS05070	16
ABI843_nonUDG	907718	907762		YPO_RS05070	44
ABI843_nonUDG	908114	908125		tnpA	11
ABI843_nonUDG	909383	909386		YPO_RS05080	3
ABI843_nonUDG	910185	910192		YPO_RS05080	7
ABI843_nonUDG	910256	910281		YPO_RS05080	25
ABI843_nonUDG	911745	911746		YPO_RS05085	1
ABI843_nonUDG	913347	913355		kbaZ	8
ABI843_nonUDG	913934	913936		YPO_RS05095	2
ABI843_nonUDG	914018	914025		YPO_RS05095	7
ABI843_nonUDG	914168	914196		YPO_RS05095	28
ABI843_nonUDG	914467	914491		YPO_RS05095	24
ABI843_nonUDG	915017	915018		YPO_RS05100	1
ABI843_nonUDG	915366	915387		YPO_RS05105	21
ABI843_nonUDG	917669	917670		nagA	1
ABI843_nonUDG	920127	920132		YPO_RS05130	5
ABI843_nonUDG	922162	922173		YPO_RS05140	11
ABI843_nonUDG	922478	922484		YPO_RS05140	6
ABI843_nonUDG	923104	923134		YPO_RS05140	30
ABI843_nonUDG	923210	923218		YPO_RS05140	8
ABI843_nonUDG	923591	923606		YPO_RS05140	15
ABI843_nonUDG	923908	923925		YPO_RS05145	17
ABI843_nonUDG	924505	924522		YPO_RS05145	17
ABI843_nonUDG	925500	925502		YPO_RS05150	2
ABI843_nonUDG	925968	925987		YPO_RS05150	19
ABI843_nonUDG	926579	926582		YPO_RS05155	3
ABI843_nonUDG	926689	926703		YPO_RS05155	14
ABI843_nonUDG	927555	927560		YPO_RS05160	5
ABI843_nonUDG	928132	928133		YPO_RS05160	1
ABI843_nonUDG	929075	929078		YPO_RS05165	3
ABI843_nonUDG	929578	929599		YPO_RS05165	21
ABI843_nonUDG	931729	931740		YPO_RS05170	11
ABI843_nonUDG	931849	931852		YPO_RS05170	3
ABI843_nonUDG	932106	932107		YPO_RS05170	1
ABI843_nonUDG	932840	932841		YPO_RS05175	1
ABI843_nonUDG	932961	932972		YPO_RS05175	11
ABI843_nonUDG	934343	934379		YPO_RS05180	36
ABI843_nonUDG	935120	935125		YPO_RS05180	5
ABI843_nonUDG	936046	936052		YPO_RS05185	6
ABI843_nonUDG	936164	936199		YPO_RS05190	35
ABI843_nonUDG	936327	936332		YPO_RS05190	5
ABI843_nonUDG	936835	936837		YPO_RS05190	2
ABI843_nonUDG	937858	937882		YPO_RS05190	24
ABI843_nonUDG	938080	938103		YPO_RS05190	23
ABI843_nonUDG	939893	939905		YPO_RS05200	12
ABI843_nonUDG	940204	940242		YPO_RS05200	38
ABI843_nonUDG	940613	940615		YPO_RS05205	2
ABI843_nonUDG	942154	942161		YPO_RS05210	7
ABI843_nonUDG	942721	942729		YPO_RS05210	8
ABI843_nonUDG	942797	942804		YPO_RS05210	7
ABI843_nonUDG	943599	943606		YPO_RS05215	7
ABI843_nonUDG	945352	945368		YPO_RS05220	16
ABI843_nonUDG	945559	945570		YPO_RS05220	11
ABI843_nonUDG	946980	946986		YPO_RS05225	6
ABI843_nonUDG	947182	947201		YPO_RS05225	19
ABI843_nonUDG	948333	948344		YPO_RS05230	11
ABI843_nonUDG	949967	949983		YPO_RS05235	16
ABI843_nonUDG	952063	952066		YPO_RS05245	3
ABI843_nonUDG	953897	953919		YPO_RS05260	22
ABI843_nonUDG	953950	953960		YPO_RS05260	10
ABI843_nonUDG	954151	954159		YPO_RS05260	8
ABI843_nonUDG	954316	954337		YPO_RS05260	21
ABI843_nonUDG	954392	954409		YPO_RS05260	17
ABI843_nonUDG	955127	955196		YPO_RS05265	69
ABI843_nonUDG	955384	955387		YPO_RS05265	3
ABI843_nonUDG	955861	955897		YPO_RS05270	36
ABI843_nonUDG	956002	956045		YPO_RS05270	43
ABI843_nonUDG	956606	956631		YPO_RS05270	25
ABI843_nonUDG	956823	956825		YPO_RS05270	2
ABI843_nonUDG	957047	957054		YPO_RS05270	7
ABI843_nonUDG	957500	957503		YPO_RS05270	3
ABI843_nonUDG	957903	957918		YPO_RS05270	15
ABI843_nonUDG	958610	958612		YPO_RS05275	2
ABI843_nonUDG	960055	960058		YPO_RS05290	3
ABI843_nonUDG	960220	960232		YPO_RS05290	12
ABI843_nonUDG	960662	960685		YPO_RS05290	23
ABI843_nonUDG	961858	961870		YPO_RS05295	12
ABI843_nonUDG	963228	963244		YPO_RS05300	16
ABI843_nonUDG	963457	963467		YPO_RS05305	10
ABI843_nonUDG	964125	964129		YPO_RS05315	4
ABI843_nonUDG	968806	968818		YPO_RS05345	12
ABI843_nonUDG	969023	969037		YPO_RS05350	14
ABI843_nonUDG	970611	970618		YPO_RS05360	7
ABI843_nonUDG	970829	970836		YPO_RS05360	7
ABI843_nonUDG	971013	971017		YPO_RS05360	4
ABI843_nonUDG	971849	971856		lysS	7
ABI843_nonUDG	972760	972786		lysS	26
ABI843_nonUDG	974298	974308		prfB	10
ABI843_nonUDG	974818	974841		recJ	23
ABI843_nonUDG	975568	975583		recJ	15
ABI843_nonUDG	975950	975964		recJ	14
ABI843_nonUDG	977199	977214		xerD	15
ABI843_nonUDG	977342	977358		xerD	16
ABI843_nonUDG	978441	978445		fldB	4
ABI843_nonUDG	979247	979251		creD	4
ABI843_nonUDG	979531	979557		creD	26
ABI843_nonUDG	981155	981162		creC	7
ABI843_nonUDG	981629	981632		creC	3
ABI843_nonUDG	982306	982337		creB	31
ABI843_nonUDG	982659	982668		YPO_RS05415	9
ABI843_nonUDG	983437	983451		ygfZ	14
ABI843_nonUDG	984806	984839		YPO_RS05430	33
ABI843_nonUDG	985305	985318		YPO_RS05435	13
ABI843_nonUDG	985647	985649		YPO_RS05435	2
ABI843_nonUDG	985855	985860		YPO_RS05435	5
ABI843_nonUDG	986849	986855		YPO_RS05440	6
ABI843_nonUDG	987101	987142		YPO_RS05440	41
ABI843_nonUDG	991288	991298		gcvP	10
ABI843_nonUDG	992493	992511		gcvP	18
ABI843_nonUDG	993133	993154		gcvP	21
ABI843_nonUDG	993988	993997		gcvP	9
ABI843_nonUDG	994655	994684		gcvH	29
ABI843_nonUDG	995775	995778		gcvT	3
ABI843_nonUDG	999137	999138		ubiH	1
ABI843_nonUDG	999292	999310		pepP	18
ABI843_nonUDG	999560	999561		pepP	1
ABI843_nonUDG	1004148	1004154		serA	6
ABI843_nonUDG	1004824	1004827		rpiA	3
ABI843_nonUDG	1005306	1005308		rpiA	2
ABI843_nonUDG	1006408	1006415		YPO_RS05520	7
ABI843_nonUDG	1006578	1006582		YPO_RS05520	4
ABI843_nonUDG	1008741	1008760		mscS	19
ABI843_nonUDG	1010013	1010018		fbaA	5
ABI843_nonUDG	1010301	1010324		fbaA	23
ABI843_nonUDG	1011383	1011404		pgk	21
ABI843_nonUDG	1011616	1011626		pgk	10
ABI843_nonUDG	1011981	1012004		pgk	23
ABI843_nonUDG	1012725	1012729		epd	4
ABI843_nonUDG	1013851	1013858		YPO_RS05555	7
ABI843_nonUDG	1013971	1014000		YPO_RS05555	29
ABI843_nonUDG	1014033	1014034		YPO_RS05555	1
ABI843_nonUDG	1014393	1014407		YPO_RS05560	14
ABI843_nonUDG	1014476	1014495		YPO_RS05560	19
ABI843_nonUDG	1014659	1014677		YPO_RS05560	18
ABI843_nonUDG	1014772	1014787		YPO_RS05560	15
ABI843_nonUDG	1014892	1014897		YPO_RS05560	5
ABI843_nonUDG	1015079	1015093		YPO_RS05560	14
ABI843_nonUDG	1015631	1015632		YPO_RS05565	1
ABI843_nonUDG	1017645	1017685		tkt	40
ABI843_nonUDG	1019233	1019247		YPO_RS05575	14
ABI843_nonUDG	1019297	1019311		YPO_RS05575	14
ABI843_nonUDG	1019495	1019496		YPO_RS05575	1
ABI843_nonUDG	1019979	1019982		YPO_RS05585	3
ABI843_nonUDG	1020063	1020082		YPO_RS05585	19
ABI843_nonUDG	1020340	1020362		speA	22
ABI843_nonUDG	1020686	1020690		speA	4
ABI843_nonUDG	1021201	1021203		speA	2
ABI843_nonUDG	1021388	1021389		speA	1
ABI843_nonUDG	1023770	1023771		metK	1
ABI843_nonUDG	1023917	1023926		metK	9
ABI843_nonUDG	1024408	1024414		metK	6
ABI843_nonUDG	1026976	1026985		rsmE	9
ABI843_nonUDG	1027689	1027699		gshB	10
ABI843_nonUDG	1030983	1030998		aguA	15
ABI843_nonUDG	1031332	1031351		aguA	19
ABI843_nonUDG	1031663	1031664		YPO_RS05640	1
ABI843_nonUDG	1031966	1031969		YPO_RS05640	3
ABI843_nonUDG	1032041	1032068		YPO_RS05640	27
ABI843_nonUDG	1033144	1033157		YPO_RS05645	13
ABI843_nonUDG	1035573	1035590		YPO_RS05665	17
ABI843_nonUDG	1036387	1036390		hemW	3
ABI843_nonUDG	1037140	1037148		hemW	8
ABI843_nonUDG	1037590	1037627		YPO_RS05675	37
ABI843_nonUDG	1039456	1039474		YPO_RS05675	18
ABI843_nonUDG	1039561	1039580		YPO_RS05675	19
ABI843_nonUDG	1039706	1039737		YPO_RS05675	31
ABI843_nonUDG	1039904	1039907		YPO_RS05675	3
ABI843_nonUDG	1040585	1040596		YPO_RS05675	11
ABI843_nonUDG	1041220	1041230		YPO_RS05675	10
ABI843_nonUDG	1041325	1041333		YPO_RS05675	8
ABI843_nonUDG	1041910	1041927		YPO_RS05675	17
ABI843_nonUDG	1043019	1043044		YPO_RS05675	25
ABI843_nonUDG	1043629	1043659		YPO_RS05675	30
ABI843_nonUDG	1044292	1044310		YPO_RS05675	18
ABI843_nonUDG	1044805	1044818		YPO_RS05675	13
ABI843_nonUDG	1044914	1044915		YPO_RS05675	1
ABI843_nonUDG	1045835	1045842		YPO_RS05675	7
ABI843_nonUDG	1046357	1046366		YPO_RS05675	9
ABI843_nonUDG	1046401	1046415		YPO_RS05675	14
ABI843_nonUDG	1046479	1046512		YPO_RS05675	33
ABI843_nonUDG	1048628	1048631		glsB	3
ABI843_nonUDG	1049604	1049613		trmB	9
ABI843_nonUDG	1052684	1052688		mltC	4
ABI843_nonUDG	1055887	1055895		YPO_RS05720	8
ABI843_nonUDG	1056020	1056023		YPO_RS05720	3
ABI843_nonUDG	1056399	1056409		YPO_RS05720	10
ABI843_nonUDG	1056549	1056553		YPO_RS05720	4
ABI843_nonUDG	1057085	1057088		YPO_RS05725	3
ABI843_nonUDG	1057770	1057771		YPO_RS05725	1
ABI843_nonUDG	1058758	1058763		YPO_RS05730	5
ABI843_nonUDG	1059519	1059534		YPO_RS05730	15
ABI843_nonUDG	1062343	1062375		speF	32
ABI843_nonUDG	1065829	1065836		YPO_RS05760	7
ABI843_nonUDG	1066705	1066722		YPO_RS05765	17
ABI843_nonUDG	1067300	1067324		YPO_RS05765	24
ABI843_nonUDG	1068435	1068438		YPO_RS05770	3
ABI843_nonUDG	1069660	1069666		YPO_RS05770	6
ABI843_nonUDG	1071670	1071675		YPO_RS05785	5
ABI843_nonUDG	1071926	1071933		YPO_RS05790	7
ABI843_nonUDG	1073091	1073162		YPO_RS05795	71
ABI843_nonUDG	1073276	1073277		YPO_RS05795	1
ABI843_nonUDG	1073677	1073692		YPO_RS05795	15
ABI843_nonUDG	1076275	1076310		YPO_RS05800	35
ABI843_nonUDG	1077432	1077436		tssH	4
ABI843_nonUDG	1078667	1078675		tssH	8
ABI843_nonUDG	1080393	1080396		YPO_RS05810	3
ABI843_nonUDG	1082935	1082945		YPO_RS05820	10
ABI843_nonUDG	1083010	1083016		tssK	6
ABI843_nonUDG	1083425	1083428		tssK	3
ABI843_nonUDG	1084084	1084089		tssK	5
ABI843_nonUDG	1089014	1089017		YPO_RS05845	3
ABI843_nonUDG	1089599	1089605		YPO_RS05850	6
ABI843_nonUDG	1090023	1090029		YPO_RS05850	6
ABI843_nonUDG	1091416	1091420		YPO_RS05855	4
ABI843_nonUDG	1092640	1092641		YPO_RS05860	1
ABI843_nonUDG	1093927	1093946		YPO_RS05865	19
ABI843_nonUDG	1094441	1094442		YPO_RS05865	1
ABI843_nonUDG	1096484	1096503		YPO_RS05880	19
ABI843_nonUDG	1097276	1097277		YPO_RS05880	1
ABI843_nonUDG	1099391	1099393		YPO_RS05890	2
ABI843_nonUDG	1099435	1099440		YPO_RS05890	5
ABI843_nonUDG	1099860	1099867		YPO_RS05890	7
ABI843_nonUDG	1102196	1102205		YPO_RS05900	9
ABI843_nonUDG	1102977	1102978		YPO_RS05900	1
ABI843_nonUDG	1103416	1103420		YPO_RS05905	4
ABI843_nonUDG	1105357	1105369		YPO_RS05905	12
ABI843_nonUDG	1106021	1106026		YPO_RS05910	5
ABI843_nonUDG	1106190	1106202		YPO_RS05910	12
ABI843_nonUDG	1106610	1106612		YPO_RS05910	2
ABI843_nonUDG	1107205	1107220		YPO_RS05910	15
ABI843_nonUDG	1108826	1108828		YPO_RS05915	2
ABI843_nonUDG	1109225	1109232		YPO_RS05920	7
ABI843_nonUDG	1109422	1109434		YPO_RS05920	12
ABI843_nonUDG	1109753	1109763		YPO_RS05920	10
ABI843_nonUDG	1109968	1109983		YPO_RS05920	15
ABI843_nonUDG	1113499	1113503		YPO_RS05935	4
ABI843_nonUDG	1113839	1113859		YPO_RS05935	20
ABI843_nonUDG	1114576	1114578		YPO_RS05935	2
ABI843_nonUDG	1114712	1114715		YPO_RS05935	3
ABI843_nonUDG	1115008	1115020		YPO_RS05935	12
ABI843_nonUDG	1115133	1115145		YPO_RS05935	12
ABI843_nonUDG	1116026	1116036		YPO_RS05935	10
ABI843_nonUDG	1116714	1116718		YPO_RS05940	4
ABI843_nonUDG	1117482	1117483		YPO_RS05940	1
ABI843_nonUDG	1118042	1118064		YPO_RS05940	22
ABI843_nonUDG	1118440	1118447		YPO_RS05945	7
ABI843_nonUDG	1118809	1118811		YPO_RS05945	2
ABI843_nonUDG	1119946	1119950		yapH	4
ABI843_nonUDG	1121444	1121451		yapH	7
ABI843_nonUDG	1121681	1121688		yapH	7
ABI843_nonUDG	1121818	1121835		yapH	17
ABI843_nonUDG	1122198	1122208		yapH	10
ABI843_nonUDG	1124062	1124184		yapH	122
ABI843_nonUDG	1124225	1124227		yapH	2
ABI843_nonUDG	1124268	1124299		yapH	31
ABI843_nonUDG	1124376	1124407		yapH	31
ABI843_nonUDG	1124469	1124940		yapH	471
ABI843_nonUDG	1124993	1125022		yapH	29
ABI843_nonUDG	1125064	1125072		yapH	8
ABI843_nonUDG	1125104	1125263		yapH	159
ABI843_nonUDG	1125298	1125406		yapH	108
ABI843_nonUDG	1125446	1125495		yapH	49
ABI843_nonUDG	1125541	1125696		yapH	155
ABI843_nonUDG	1125999	1126002		yapH	3
ABI843_nonUDG	1126693	1126695		yapH	2
ABI843_nonUDG	1126844	1126846		yapH	2
ABI843_nonUDG	1127489	1127534		yapH	45
ABI843_nonUDG	1128290	1128294		yapH	4
ABI843_nonUDG	1128722	1128725		yapH	3
ABI843_nonUDG	1128838	1128858		yapH	20
ABI843_nonUDG	1129038	1129041		yapH	3
ABI843_nonUDG	1129690	1129708		yapH	18
ABI843_nonUDG	1130502	1130508		yapH	6
ABI843_nonUDG	1131095	1131101		YPO_RS05955	6
ABI843_nonUDG	1131280	1131314		YPO_RS05955	34
ABI843_nonUDG	1131491	1131499		YPO_RS05955	8
ABI843_nonUDG	1131757	1131764		YPO_RS05955	7
ABI843_nonUDG	1132458	1132479		YPO_RS05955	21
ABI843_nonUDG	1135336	1135339		YPO_RS05970	3
ABI843_nonUDG	1136129	1136140		YPO_RS05970	11
ABI843_nonUDG	1136249	1136254		YPO_RS05970	5
ABI843_nonUDG	1137735	1137739		YPO_RS05975	4
ABI843_nonUDG	1138577	1138590		YPO_RS05975	13
ABI843_nonUDG	1141207	1141218		YPO_RS05985	11
ABI843_nonUDG	1141277	1141278		YPO_RS05985	1
ABI843_nonUDG	1141420	1141422		YPO_RS05985	2
ABI843_nonUDG	1141532	1141533		YPO_RS05985	1
ABI843_nonUDG	1142205	1142261		YPO_RS05985	56
ABI843_nonUDG	1142425	1142437		YPO_RS05985	12
ABI843_nonUDG	1146437	1146456		YPO_RS05995	19
ABI843_nonUDG	1146546	1146550		YPO_RS05995	4
ABI843_nonUDG	1146727	1146740		YPO_RS05995	13
ABI843_nonUDG	1146966	1146984		YPO_RS05995	18
ABI843_nonUDG	1147030	1147033		YPO_RS05995	3
ABI843_nonUDG	1147135	1147186		YPO_RS06000	51
ABI843_nonUDG	1147274	1147275		YPO_RS06000	1
ABI843_nonUDG	1147417	1147456		YPO_RS06000	39
ABI843_nonUDG	1147967	1147970		YPO_RS06005	3
ABI843_nonUDG	1148620	1148645		YPO_RS06010	25
ABI843_nonUDG	1149264	1149285		YPO_RS06020	21
ABI843_nonUDG	1150153	1150169		recC	16
ABI843_nonUDG	1150312	1150318		recC	6
ABI843_nonUDG	1150360	1150385		recC	25
ABI843_nonUDG	1151066	1151067		recC	1
ABI843_nonUDG	1152921	1152928		recC	7
ABI843_nonUDG	1154041	1154049		ptrA	8
ABI843_nonUDG	1155444	1155464		ptrA	20
ABI843_nonUDG	1156046	1156055		recB	9
ABI843_nonUDG	1158299	1158301		recB	2
ABI843_nonUDG	1160454	1160465		recD	11
ABI843_nonUDG	1161263	1161295		recD	32
ABI843_nonUDG	1162696	1162718		argA	22
ABI843_nonUDG	1162914	1162963		argA	49
ABI843_nonUDG	1163768	1163775		YPO_RS06050	7
ABI843_nonUDG	1163897	1163919		YPO_RS06050	22
ABI843_nonUDG	1165528	1165554		mltA	26
ABI843_nonUDG	1165641	1165662		mltA	21
ABI843_nonUDG	1165935	1165937		mltA	2
ABI843_nonUDG	1166446	1166450		mltA	4
ABI843_nonUDG	1168194	1168196		csdA	2
ABI843_nonUDG	1168471	1168482		csdA	11
ABI843_nonUDG	1169435	1169439		YPO_RS06085	4
ABI843_nonUDG	1173430	1173434		xni	4
ABI843_nonUDG	1173787	1173790		YPO_RS06110	3
ABI843_nonUDG	1174072	1174095		YPO_RS06110	23
ABI843_nonUDG	1174565	1174567		YPO_RS06110	2
ABI843_nonUDG	1175330	1175344		queF	14
ABI843_nonUDG	1175608	1175624		queF	16
ABI843_nonUDG	1176805	1176811		syd	6
ABI843_nonUDG	1177501	1177507		YPO_RS06125	6
ABI843_nonUDG	1179062	1179066		truC	4
ABI843_nonUDG	1179224	1179238		truC	14
ABI843_nonUDG	1181777	1181780		glnD	3
ABI843_nonUDG	1182497	1182498		glnD	1
ABI843_nonUDG	1183103	1183150		glnD	47
ABI843_nonUDG	1183403	1183406		glnD	3
ABI843_nonUDG	1184147	1184161		map	14
ABI843_nonUDG	1185380	1185411		rpsB	31
ABI843_nonUDG	1185908	1185915		rpsB	7
ABI843_nonUDG	1189081	1189097		ispC	16
ABI843_nonUDG	1189238	1189249		ispC	11
ABI843_nonUDG	1189294	1189308		ispC	14
ABI843_nonUDG	1190541	1190542		ispU	1
ABI843_nonUDG	1191876	1191886		cdsA	10
ABI843_nonUDG	1192820	1192830		rseP	10
ABI843_nonUDG	1193019	1193038		rseP	19
ABI843_nonUDG	1193936	1193940		bamA	4
ABI843_nonUDG	1193987	1193992		bamA	5
ABI843_nonUDG	1194898	1194909		bamA	11
ABI843_nonUDG	1195419	1195435		bamA	16
ABI843_nonUDG	1195550	1195552		bamA	2
ABI843_nonUDG	1196473	1196484		lpxD	11
ABI843_nonUDG	1196699	1196700		lpxD	1
ABI843_nonUDG	1197614	1197624		fabZ	10
ABI843_nonUDG	1198463	1198467		lpxA	4
ABI843_nonUDG	1199167	1199174		lpxB	7
ABI843_nonUDG	1200185	1200190		rnhB	5
ABI843_nonUDG	1200414	1200437		rnhB	23
ABI843_nonUDG	1200576	1200584		rnhB	8
ABI843_nonUDG	1200997	1201002		dnaE	5
ABI843_nonUDG	1202549	1202556		dnaE	7
ABI843_nonUDG	1203237	1203239		dnaE	2
ABI843_nonUDG	1203553	1203554		dnaE	1
ABI843_nonUDG	1204148	1204149		dnaE	1
ABI843_nonUDG	1204780	1204785		accA	5
ABI843_nonUDG	1204863	1204864		accA	1
ABI843_nonUDG	1204979	1205015		accA	36
ABI843_nonUDG	1206178	1206179		tilS	1
ABI843_nonUDG	1206801	1206804		tilS	3
ABI843_nonUDG	1207674	1207675		YPO_RS06260	1
ABI843_nonUDG	1209894	1209899		nlpE	5
ABI843_nonUDG	1210118	1210121		nlpE	3
ABI843_nonUDG	1212515	1212519		tsaA	4
ABI843_nonUDG	1213887	1213889		YPO_RS06305	2
ABI843_nonUDG	1214125	1214131		YPO_RS06305	6
ABI843_nonUDG	1214670	1214679		metI	9
ABI843_nonUDG	1215151	1215170		metI	19
ABI843_nonUDG	1215366	1215375		metN	9
ABI843_nonUDG	1215494	1215498		metN	4
ABI843_nonUDG	1215592	1215613		metN	21
ABI843_nonUDG	1216142	1216143		metN	1
ABI843_nonUDG	1217612	1217621		YPO_RS06330	9
ABI843_nonUDG	1219476	1219478		YPO_RS06340	2
ABI843_nonUDG	1219625	1219638		YPO_RS06340	13
ABI843_nonUDG	1220107	1220133		YPO_RS06340	26
ABI843_nonUDG	1220653	1220672		YPO_RS06340	19
ABI843_nonUDG	1221215	1221221		YPO_RS06340	6
ABI843_nonUDG	1221598	1221612		YPO_RS06340	14
ABI843_nonUDG	1221689	1221701		YPO_RS06340	12
ABI843_nonUDG	1222511	1222515		rrf	4
ABI843_nonUDG	1223446	1223457		dkgB	11
ABI843_nonUDG	1225017	1225023		YPO_RS06365	6
ABI843_nonUDG	1225271	1225291		YPO_RS06365	20
ABI843_nonUDG	1225575	1225578		YPO_RS06365	3
ABI843_nonUDG	1226054	1226062		mltD	8
ABI843_nonUDG	1227695	1227705		gloB	10
ABI843_nonUDG	1228494	1228496		YPO_RS06380	2
ABI843_nonUDG	1229096	1229101		rnhA	5
ABI843_nonUDG	1229415	1229416		dnaQ	1
ABI843_nonUDG	1230667	1230668		YPO_RS06400	1
ABI843_nonUDG	1230764	1230770		YPO_RS06400	6
ABI843_nonUDG	1231523	1231529		YPO_RS06400	6
ABI843_nonUDG	1232275	1232283		YPO_RS06405	8
ABI843_nonUDG	1232425	1232438		YPO_RS06410	13
ABI843_nonUDG	1232506	1232511		YPO_RS06410	5
ABI843_nonUDG	1232682	1232688		YPO_RS06410	6
ABI843_nonUDG	1232859	1232861		YPO_RS06410	2
ABI843_nonUDG	1232977	1233033		YPO_RS06410	56
ABI843_nonUDG	1233443	1233486		YPO_RS06415	43
ABI843_nonUDG	1233602	1233604		YPO_RS06415	2
ABI843_nonUDG	1233760	1233775		YPO_RS06415	15
ABI843_nonUDG	1233966	1233985		YPO_RS06415	19
ABI843_nonUDG	1235214	1235218		YPO_RS06430	4
ABI843_nonUDG	1235327	1235330		YPO_RS06430	3
ABI843_nonUDG	1236727	1236741		YPO_RS06435	14
ABI843_nonUDG	1237998	1238008		YPO_RS06445	10
ABI843_nonUDG	1238697	1238711		YPO_RS06455	14
ABI843_nonUDG	1239287	1239292		YPO_RS06455	5
ABI843_nonUDG	1240244	1240248		YPO_RS06460	4
ABI843_nonUDG	1241590	1241607		YPO_RS06465	17
ABI843_nonUDG	1242357	1242383		YPO_RS06470	26
ABI843_nonUDG	1242662	1242687		YPO_RS06470	25
ABI843_nonUDG	1242970	1242988		YPO_RS06470	18
ABI843_nonUDG	1243259	1243272		YPO_RS06470	13
ABI843_nonUDG	1243305	1243306		YPO_RS06470	1
ABI843_nonUDG	1243609	1243629		YPO_RS06475	20
ABI843_nonUDG	1244025	1244026		YPO_RS06475	1
ABI843_nonUDG	1244191	1244192		YPO_RS06475	1
ABI843_nonUDG	1244504	1244527		YPO_RS06475	23
ABI843_nonUDG	1245681	1245692		ssrA	11
ABI843_nonUDG	1246747	1246752		YPO_RS06495	5
ABI843_nonUDG	1246833	1246873		YPO_RS06495	40
ABI843_nonUDG	1247697	1247715		bamE	18
ABI843_nonUDG	1248236	1248244		recN	8
ABI843_nonUDG	1248741	1248747		recN	6
ABI843_nonUDG	1250447	1250461		nadK	14
ABI843_nonUDG	1252019	1252033		YPO_RS06525	14
ABI843_nonUDG	1252343	1252350		YPO_RS06525	7
ABI843_nonUDG	1252616	1252623		YPO_RS06525	7
ABI843_nonUDG	1255820	1255822		sdhA	2
ABI843_nonUDG	1258791	1258820		sucA	29
ABI843_nonUDG	1259159	1259164		sucA	5
ABI843_nonUDG	1259355	1259363		sucA	8
ABI843_nonUDG	1259736	1259781		sucA	45
ABI843_nonUDG	1259874	1259897		odhB	23
ABI843_nonUDG	1260936	1260946		odhB	10
ABI843_nonUDG	1261050	1261052		odhB	2
ABI843_nonUDG	1261304	1261305		sucC	1
ABI843_nonUDG	1263011	1263044		sucD	33
ABI843_nonUDG	1264237	1264241		cydA	4
ABI843_nonUDG	1264344	1264358		cydA	14
ABI843_nonUDG	1266350	1266365		cydB	15
ABI843_nonUDG	1266435	1266447		cydB	12
ABI843_nonUDG	1266880	1266884		ybgE	4
ABI843_nonUDG	1267599	1267605		ybgC	6
ABI843_nonUDG	1268052	1268087		tolQ	35
ABI843_nonUDG	1268602	1268625		tolR	23
ABI843_nonUDG	1270059	1270069		tolA	10
ABI843_nonUDG	1271908	1271911		pal	3
ABI843_nonUDG	1271980	1271984		pal	4
ABI843_nonUDG	1272636	1272658		cpoB	22
ABI843_nonUDG	1274245	1274256		nadA	11
ABI843_nonUDG	1274353	1274355		nadA	2
ABI843_nonUDG	1274638	1274639		nadA	1
ABI843_nonUDG	1275290	1275295		YPO_RS06645	5
ABI843_nonUDG	1275819	1275843		zitB	24
ABI843_nonUDG	1275928	1275936		zitB	8
ABI843_nonUDG	1277808	1277817		aroG	9
ABI843_nonUDG	1278067	1278073		aroG	6
ABI843_nonUDG	1278213	1278266		YPO_RS06660	53
ABI843_nonUDG	1278416	1278424		YPO_RS06660	8
ABI843_nonUDG	1278573	1278583		YPO_RS06660	10
ABI843_nonUDG	1278745	1278749		YPO_RS06660	4
ABI843_nonUDG	1278891	1278899		YPO_RS06660	8
ABI843_nonUDG	1278949	1278958		YPO_RS06665	9
ABI843_nonUDG	1279016	1279056		YPO_RS06665	40
ABI843_nonUDG	1279915	1279930		YPO_RS06665	15
ABI843_nonUDG	1279989	1280022		YPO_RS06670	33
ABI843_nonUDG	1280492	1280502		gpmA	10
ABI843_nonUDG	1282550	1282558		galM	8
ABI843_nonUDG	1282775	1282776		galM	1
ABI843_nonUDG	1283250	1283254		galK	4
ABI843_nonUDG	1285412	1285418		galE	6
ABI843_nonUDG	1285596	1285634		galE	38
ABI843_nonUDG	1286991	1286996		YPO_RS06710	5
ABI843_nonUDG	1287154	1287183		YPO_RS06710	29
ABI843_nonUDG	1287387	1287416		YPO_RS06710	29
ABI843_nonUDG	1288454	1288455		modF	1
ABI843_nonUDG	1289674	1289689		modE	15
ABI843_nonUDG	1291760	1291769		modB	9
ABI843_nonUDG	1292719	1292728		modC	9
ABI843_nonUDG	1292899	1292916		modC	17
ABI843_nonUDG	1295007	1295017		pgl	10
ABI843_nonUDG	1295494	1295502		pgl	8
ABI843_nonUDG	1295803	1295813		bioA	10
ABI843_nonUDG	1296926	1296943		bioA	17
ABI843_nonUDG	1299149	1299160		bioF	11
ABI843_nonUDG	1299410	1299414		bioC	4
ABI843_nonUDG	1300479	1300484		bioD	5
ABI843_nonUDG	1301469	1301476		YPO_RS06780	7
ABI843_nonUDG	1303196	1303214		uvrB	18
ABI843_nonUDG	1309766	1309771		YPO_RS06820	5
ABI843_nonUDG	1310368	1310386		YPO_RS06825	18
ABI843_nonUDG	1310522	1310541		YPO_RS06825	19
ABI843_nonUDG	1311892	1311902		betA	10
ABI843_nonUDG	1312486	1312487		betA	1
ABI843_nonUDG	1313388	1313461		betB	73
ABI843_nonUDG	1314502	1314514		betI	12
ABI843_nonUDG	1315212	1315223		YPO_RS06845	11
ABI843_nonUDG	1315921	1315937		YPO_RS06845	16
ABI843_nonUDG	1316285	1316293		YPO_RS06845	8
ABI843_nonUDG	1316416	1316418		YPO_RS06845	2
ABI843_nonUDG	1316683	1316701		YPO_RS06845	18
ABI843_nonUDG	1318398	1318411		YPO_RS06855	13
ABI843_nonUDG	1320080	1320084		xapA	4
ABI843_nonUDG	1322734	1322736		YPO_RS06875	2
ABI843_nonUDG	1323027	1323038		YPO_RS06875	11
ABI843_nonUDG	1325634	1325643		pbpG	9
ABI843_nonUDG	1326570	1326571		dld	1
ABI843_nonUDG	1327387	1327391		dld	4
ABI843_nonUDG	1328178	1328210		cyaB	32
ABI843_nonUDG	1329850	1329869		YPO_RS06910	19
ABI843_nonUDG	1330579	1330585		YPO_RS06915	6
ABI843_nonUDG	1330889	1330895		phnC	6
ABI843_nonUDG	1331071	1331074		phnC	3
ABI843_nonUDG	1331214	1331224		phnC	10
ABI843_nonUDG	1331606	1331626		phnC	20
ABI843_nonUDG	1332328	1332357		phnD	29
ABI843_nonUDG	1333517	1333537		phnE	20
ABI843_nonUDG	1334742	1334766		YPO_RS06940	24
ABI843_nonUDG	1336254	1336290		urtA	36
ABI843_nonUDG	1336753	1336760		urtA	7
ABI843_nonUDG	1337590	1337592		urtB	2
ABI843_nonUDG	1337828	1337856		urtB	28
ABI843_nonUDG	1339533	1339538		urtC	5
ABI843_nonUDG	1339952	1339953		urtD	1
ABI843_nonUDG	1340864	1340873		urtE	9
ABI843_nonUDG	1347239	1347248		YPO_RS06995	9
ABI843_nonUDG	1347706	1347715		YPO_RS06995	9
ABI843_nonUDG	1349033	1349037		YPO_RS07005	4
ABI843_nonUDG	1350091	1350115		adiC	24
ABI843_nonUDG	1353080	1353095		YPO_RS07015	15
ABI843_nonUDG	1355641	1355660		ompF2	19
ABI843_nonUDG	1356031	1356038		ompF2	7
ABI843_nonUDG	1356206	1356210		ompF2	4
ABI843_nonUDG	1356301	1356328		ompF2	27
ABI843_nonUDG	1356433	1356435		ompF2	2
ABI843_nonUDG	1358972	1358976		dinG	4
ABI843_nonUDG	1359048	1359050		dinG	2
ABI843_nonUDG	1359814	1359830		YPO_RS07040	16
ABI843_nonUDG	1360214	1360229		YPO_RS07040	15
ABI843_nonUDG	1362122	1362123		tyrP	1
ABI843_nonUDG	1362367	1362372		tyrP	5
ABI843_nonUDG	1362920	1362949		tyrP	29
ABI843_nonUDG	1364216	1364227		YPO_RS07055	11
ABI843_nonUDG	1365329	1365360		eco	31
ABI843_nonUDG	1365424	1365445		YPO_RS07065	21
ABI843_nonUDG	1365809	1365828		nrdB	19
ABI843_nonUDG	1367471	1367481		nrdA	10
ABI843_nonUDG	1368153	1368192		nrdA	39
ABI843_nonUDG	1369924	1369926		YPO_RS07080	2
ABI843_nonUDG	1370882	1370900		gyrA	18
ABI843_nonUDG	1370973	1370977		gyrA	4
ABI843_nonUDG	1371042	1371043		gyrA	1
ABI843_nonUDG	1371340	1371350		gyrA	10
ABI843_nonUDG	1371726	1371736		gyrA	10
ABI843_nonUDG	1372008	1372011		gyrA	3
ABI843_nonUDG	1372341	1372362		gyrA	21
ABI843_nonUDG	1373174	1373197		gyrA	23
ABI843_nonUDG	1373882	1373887		rcsC	5
ABI843_nonUDG	1374204	1374215		rcsC	11
ABI843_nonUDG	1374749	1374791		rcsC	42
ABI843_nonUDG	1375362	1375363		rcsC	1
ABI843_nonUDG	1375536	1375545		rcsC	9
ABI843_nonUDG	1376638	1376640		rcsB	2
ABI843_nonUDG	1377008	1377015		rcsB	7
ABI843_nonUDG	1377158	1377159		rcsB	1
ABI843_nonUDG	1379774	1379788		rcsD	14
ABI843_nonUDG	1380225	1380239		YPO_RS07110	14
ABI843_nonUDG	1380322	1380324		YPO_RS07110	2
ABI843_nonUDG	1380723	1380725		YPO_RS07110	2
ABI843_nonUDG	1380976	1380981		YPO_RS07110	5
ABI843_nonUDG	1383107	1383116		YPO_RS07115	9
ABI843_nonUDG	1383710	1383720		YPO_RS07120	10
ABI843_nonUDG	1383860	1383869		YPO_RS07120	9
ABI843_nonUDG	1385697	1385726		ampH	29
ABI843_nonUDG	1386302	1386308		YPO_RS07140	6
ABI843_nonUDG	1386381	1386420		YPO_RS07140	39
ABI843_nonUDG	1386620	1386644		YPO_RS07140	24
ABI843_nonUDG	1387049	1387051		YPO_RS07140	2
ABI843_nonUDG	1387317	1387323		YPO_RS07140	6
ABI843_nonUDG	1387422	1387429		YPO_RS07140	7
ABI843_nonUDG	1388594	1388602		YPO_RS07145	8
ABI843_nonUDG	1390108	1390112		YPO_RS07150	4
ABI843_nonUDG	1390412	1390424		YPO_RS07150	12
ABI843_nonUDG	1390823	1390826		YPO_RS07150	3
ABI843_nonUDG	1391793	1391823		ycoA	30
ABI843_nonUDG	1392086	1392103		ycoA	17
ABI843_nonUDG	1394004	1394019		YPO_RS07170	15
ABI843_nonUDG	1397499	1397517		YPO_RS07190	18
ABI843_nonUDG	1397752	1397760		YPO_RS07190	8
ABI843_nonUDG	1398110	1398126		YPO_RS07190	16
ABI843_nonUDG	1400677	1400687		YPO_RS07210	10
ABI843_nonUDG	1400859	1400870		YPO_RS07210	11
ABI843_nonUDG	1402680	1402681		YPO_RS07225	1
ABI843_nonUDG	1402828	1402831		YPO_RS07225	3
ABI843_nonUDG	1403080	1403098		YPO_RS07225	18
ABI843_nonUDG	1404290	1404305		YPO_RS07230	15
ABI843_nonUDG	1404546	1404550		YPO_RS07230	4
ABI843_nonUDG	1404918	1404936		YPO_RS07230	18
ABI843_nonUDG	1404967	1404968		YPO_RS07230	1
ABI843_nonUDG	1405554	1405557		YPO_RS07235	3
ABI843_nonUDG	1405623	1405636		YPO_RS07235	13
ABI843_nonUDG	1406127	1406134		YPO_RS07235	7
ABI843_nonUDG	1406733	1406735		YPO_RS07240	2
ABI843_nonUDG	1407390	1407397		YPO_RS07245	7
ABI843_nonUDG	1407458	1407467		YPO_RS07245	9
ABI843_nonUDG	1407750	1407754		YPO_RS07250	4
ABI843_nonUDG	1407942	1407948		YPO_RS07250	6
ABI843_nonUDG	1408371	1408372		YPO_RS07250	1
ABI843_nonUDG	1408762	1408788		YPO_RS07255	26
ABI843_nonUDG	1410904	1410910		YPO_RS07270	6
ABI843_nonUDG	1411096	1411124		YPO_RS07270	28
ABI843_nonUDG	1411688	1411695		YPO_RS07275	7
ABI843_nonUDG	1412774	1412775		YPO_RS07275	1
ABI843_nonUDG	1414279	1414295		YPO_RS07285	16
ABI843_nonUDG	1414487	1414500		YPO_RS07285	13
ABI843_nonUDG	1416854	1416865		YPO_RS07305	11
ABI843_nonUDG	1419303	1419304		yejK	1
ABI843_nonUDG	1420614	1420639		YPO_RS07320	25
ABI843_nonUDG	1422029	1422040		YPO_RS07330	11
ABI843_nonUDG	1422479	1422484		YPO_RS07330	5
ABI843_nonUDG	1424504	1424506		YPO_RS07340	2
ABI843_nonUDG	1425210	1425213		YPO_RS07340	3
ABI843_nonUDG	1425387	1425396		YPO_RS07340	9
ABI843_nonUDG	1426900	1426901		yejF	1
ABI843_nonUDG	1427373	1427381		yejF	8
ABI843_nonUDG	1427497	1427499		yejF	2
ABI843_nonUDG	1427721	1427737		yejF	16
ABI843_nonUDG	1428495	1428501		YPO_RS07355	6
ABI843_nonUDG	1428601	1428612		YPO_RS07355	11
ABI843_nonUDG	1429557	1429598		YPO_RS07360	41
ABI843_nonUDG	1430140	1430143		YPO_RS07360	3
ABI843_nonUDG	1430498	1430506		YPO_RS07360	8
ABI843_nonUDG	1431818	1431844		YPO_RS07365	26
ABI843_nonUDG	1431995	1431999		YPO_RS07365	4
ABI843_nonUDG	1432625	1432626		YPO_RS07370	1
ABI843_nonUDG	1433376	1433392		YPO_RS07370	16
ABI843_nonUDG	1437264	1437275		YPO_RS07385	11
ABI843_nonUDG	1439362	1439378		YPO_RS07395	16
ABI843_nonUDG	1439600	1439601		YPO_RS07395	1
ABI843_nonUDG	1440138	1440141		YPO_RS07395	3
ABI843_nonUDG	1440499	1440506		YPO_RS07395	7
ABI843_nonUDG	1441401	1441405		uxuA	4
ABI843_nonUDG	1442858	1442859		yeiP	1
ABI843_nonUDG	1444197	1444217		mtr	20
ABI843_nonUDG	1445743	1445745		YPO_RS07420	2
ABI843_nonUDG	1446012	1446028		YPO_RS07425	16
ABI843_nonUDG	1446274	1446275		YPO_RS07425	1
ABI843_nonUDG	1446329	1446333		YPO_RS07425	4
ABI843_nonUDG	1446495	1446499		YPO_RS07425	4
ABI843_nonUDG	1447162	1447172		YPO_RS07430	10
ABI843_nonUDG	1447468	1447469		YPO_RS07430	1
ABI843_nonUDG	1448927	1448929		YPO_RS07435	2
ABI843_nonUDG	1449831	1449842		YPO_RS07435	11
ABI843_nonUDG	1450652	1450660		xylB	8
ABI843_nonUDG	1451110	1451136		xylB	26
ABI843_nonUDG	1452954	1452967		YPO_RS07450	13
ABI843_nonUDG	1453033	1453047		YPO_RS07450	14
ABI843_nonUDG	1453556	1453583		YPO_RS07455	27
ABI843_nonUDG	1453791	1453792		YPO_RS07455	1
ABI843_nonUDG	1454614	1454622		YPO_RS07455	8
ABI843_nonUDG	1455545	1455552		YPO_RS07460	7
ABI843_nonUDG	1455696	1455702		YPO_RS07460	6
ABI843_nonUDG	1455761	1455769		YPO_RS07460	8
ABI843_nonUDG	1456016	1456019		YPO_RS07460	3
ABI843_nonUDG	1457576	1457621		YPO_RS07470	45
ABI843_nonUDG	1458254	1458309		fruK	55
ABI843_nonUDG	1459666	1459670		fruA	4
ABI843_nonUDG	1459839	1459849		fruA	10
ABI843_nonUDG	1461117	1461123		YPO_RS07485	6
ABI843_nonUDG	1461227	1461233		YPO_RS07485	6
ABI843_nonUDG	1461545	1461620		YPO_RS07485	75
ABI843_nonUDG	1463098	1463105		psaA	7
ABI843_nonUDG	1463421	1463457		YPO_RS07500	36
ABI843_nonUDG	1463859	1463868		YPO_RS07500	9
ABI843_nonUDG	1465453	1465457		psaC	4
ABI843_nonUDG	1465512	1465526		psaC	14
ABI843_nonUDG	1465990	1466004		psaC	14
ABI843_nonUDG	1466105	1466118		psaC	13
ABI843_nonUDG	1467280	1467286		nfo	6
ABI843_nonUDG	1467863	1467871		YPO_RS07515	8
ABI843_nonUDG	1468004	1468037		YPO_RS07515	33
ABI843_nonUDG	1470110	1470122		YPO_RS07520	12
ABI843_nonUDG	1470229	1470230		YPO_RS07520	1
ABI843_nonUDG	1471041	1471071		YPO_RS07525	30
ABI843_nonUDG	1471149	1471161		YPO_RS07525	12
ABI843_nonUDG	1471866	1471879		YPO_RS07525	13
ABI843_nonUDG	1472855	1472871		YPO_RS07530	16
ABI843_nonUDG	1474105	1474115		YPO_RS07535	10
ABI843_nonUDG	1474813	1474831		YPO_RS07535	18
ABI843_nonUDG	1475459	1475460		YPO_RS07540	1
ABI843_nonUDG	1476255	1476256		YPO_RS07545	1
ABI843_nonUDG	1476609	1476635		YPO_RS07545	26
ABI843_nonUDG	1477516	1477538		YPO_RS07545	22
ABI843_nonUDG	1480655	1480684		YPO_RS07560	29
ABI843_nonUDG	1482337	1482354		YPO_RS07570	17
ABI843_nonUDG	1483579	1483588		YPO_RS07575	9
ABI843_nonUDG	1483754	1483764		YPO_RS07575	10
ABI843_nonUDG	1483912	1483915		YPO_RS07575	3
ABI843_nonUDG	1484360	1484363		YPO_RS07580	3
ABI843_nonUDG	1484663	1484674		YPO_RS07580	11
ABI843_nonUDG	1485986	1485993		YPO_RS07585	7
ABI843_nonUDG	1486151	1486154		YPO_RS07585	3
ABI843_nonUDG	1486841	1486857		YPO_RS07585	16
ABI843_nonUDG	1488391	1488393		deoR	2
ABI843_nonUDG	1489444	1489451		YPO_RS07595	7
ABI843_nonUDG	1489730	1489739		YPO_RS07595	9
ABI843_nonUDG	1489879	1489882		YPO_RS07595	3
ABI843_nonUDG	1490431	1490433		ybjG	2
ABI843_nonUDG	1490730	1490747		ybjG	17
ABI843_nonUDG	1492055	1492077		YPO_RS07610	22
ABI843_nonUDG	1493146	1493148		YPO_RS07610	2
ABI843_nonUDG	1493307	1493310		YPO_RS07610	3
ABI843_nonUDG	1493559	1493562		YPO_RS07610	3
ABI843_nonUDG	1494983	1494986		YPO_RS07620	3
ABI843_nonUDG	1495294	1495308		YPO_RS07625	14
ABI843_nonUDG	1495755	1495757		YPO_RS07625	2
ABI843_nonUDG	1496966	1496968		potF	2
ABI843_nonUDG	1498633	1498644		potG	11
ABI843_nonUDG	1499757	1499758		potI	1
ABI843_nonUDG	1499849	1499850		potI	1
ABI843_nonUDG	1500141	1500151		potI	10
ABI843_nonUDG	1500215	1500235		potI	20
ABI843_nonUDG	1501442	1501444		rlmC	2
ABI843_nonUDG	1502972	1502979		YPO_RS07665	7
ABI843_nonUDG	1503035	1503040		YPO_RS07665	5
ABI843_nonUDG	1503469	1503479		YPO_RS07665	10
ABI843_nonUDG	1503530	1503556		YPO_RS07665	26
ABI843_nonUDG	1503606	1503610		YPO_RS07665	4
ABI843_nonUDG	1503704	1503706		YPO_RS07665	2
ABI843_nonUDG	1503751	1503752		YPO_RS07665	1
ABI843_nonUDG	1503950	1503959		YPO_RS07670	9
ABI843_nonUDG	1504171	1504222		YPO_RS07670	51
ABI843_nonUDG	1504326	1504351		YPO_RS07670	25
ABI843_nonUDG	1505975	1505987		YPO_RS07685	12
ABI843_nonUDG	1506286	1506294		YPO_RS07685	8
ABI843_nonUDG	1508392	1508404		YPO_RS07690	12
ABI843_nonUDG	1508404	1508405		YPO_RS07695	1
ABI843_nonUDG	1508504	1508508		YPO_RS07695	4
ABI843_nonUDG	1509343	1509368		YPO_RS07705	25
ABI843_nonUDG	1511097	1511101		YPO_RS07720	4
ABI843_nonUDG	1511188	1511189		YPO_RS07720	1
ABI843_nonUDG	1511907	1511910		YPO_RS07720	3
ABI843_nonUDG	1511944	1511953		YPO_RS07720	9
ABI843_nonUDG	1512590	1512592		YPO_RS07725	2
ABI843_nonUDG	1513308	1513321		YPO_RS07730	13
ABI843_nonUDG	1513535	1513554		artM	19
ABI843_nonUDG	1515058	1515070		artJ	12
ABI843_nonUDG	1516612	1516618		YPO_RS07755	6
ABI843_nonUDG	1518922	1518925		YPO_RS07765	3
ABI843_nonUDG	1520554	1520564		YPO_RS07770	10
ABI843_nonUDG	1522019	1522026		poxB	7
ABI843_nonUDG	1522540	1522554		poxB	14
ABI843_nonUDG	1522934	1522937		poxB	3
ABI843_nonUDG	1525158	1525161		hcp	3
ABI843_nonUDG	1526271	1526275		hcp	4
ABI843_nonUDG	1528387	1528393		YPO_RS07800	6
ABI843_nonUDG	1528819	1528821		YPO_RS07800	2
ABI843_nonUDG	1528890	1528896		YPO_RS07800	6
ABI843_nonUDG	1529026	1529039		YPO_RS07800	13
ABI843_nonUDG	1530012	1530018		YPO_RS07805	6
ABI843_nonUDG	1530463	1530492		YPO_RS07805	29
ABI843_nonUDG	1530759	1530761		YPO_RS07805	2
ABI843_nonUDG	1531730	1531731		macA	1
ABI843_nonUDG	1532342	1532346		macB	4
ABI843_nonUDG	1533019	1533027		macB	8
ABI843_nonUDG	1533123	1533149		macB	26
ABI843_nonUDG	1537113	1537114		clpA	1
ABI843_nonUDG	1537448	1537457		clpA	9
ABI843_nonUDG	1538258	1538272		YPO_RS07835	14
ABI843_nonUDG	1539754	1539767		aat	13
ABI843_nonUDG	1542145	1542184		cydD	39
ABI843_nonUDG	1545880	1545882		lrp	2
ABI843_nonUDG	1547015	1547017		YPO_RS07870	2
ABI843_nonUDG	1547274	1547278		YPO_RS07870	4
ABI843_nonUDG	1547601	1547655		YPO_RS07870	54
ABI843_nonUDG	1549093	1549114		YPO_RS07870	21
ABI843_nonUDG	1549632	1549638		YPO_RS07870	6
ABI843_nonUDG	1549920	1549924		YPO_RS07870	4
ABI843_nonUDG	1550620	1550623		lolA	3
ABI843_nonUDG	1551363	1551364		YPO_RS07880	1
ABI843_nonUDG	1551481	1551505		YPO_RS07880	24
ABI843_nonUDG	1553729	1553744		serS	15
ABI843_nonUDG	1554883	1554939		YPO_RS07890	56
ABI843_nonUDG	1554986	1555000		YPO_RS07890	14
ABI843_nonUDG	1555303	1555319		YPO_RS07890	16
ABI843_nonUDG	1555546	1555564		pflA	18
ABI843_nonUDG	1555629	1555642		pflA	13
ABI843_nonUDG	1558762	1558769		pflB	7
ABI843_nonUDG	1559128	1559147		pflB	19
ABI843_nonUDG	1559243	1559251		pflB	8
ABI843_nonUDG	1560275	1560285		pflB	10
ABI843_nonUDG	1560992	1560996		focA	4
ABI843_nonUDG	1562808	1562809		YPO_RS07915	1
ABI843_nonUDG	1563243	1563249		YPO_RS07915	6
ABI843_nonUDG	1564639	1564643		ansB	4
ABI843_nonUDG	1565406	1565424		YPO_RS07925	18
ABI843_nonUDG	1565875	1565879		YPO_RS07925	4
ABI843_nonUDG	1566380	1566402		YPO_RS07930	22
ABI843_nonUDG	1566513	1566542		YPO_RS07930	29
ABI843_nonUDG	1566660	1566665		YPO_RS07930	5
ABI843_nonUDG	1566952	1566955		YPO_RS07930	3
ABI843_nonUDG	1567026	1567027		YPO_RS07930	1
ABI843_nonUDG	1567533	1567563		YPO_RS07930	30
ABI843_nonUDG	1567714	1567717		YPO_RS07930	3
ABI843_nonUDG	1567764	1567767		YPO_RS07930	3
ABI843_nonUDG	1568067	1568108		YPO_RS07930	41
ABI843_nonUDG	1569184	1569194		serC	10
ABI843_nonUDG	1569337	1569344		serC	7
ABI843_nonUDG	1572807	1572820		rpsA	13
ABI843_nonUDG	1573330	1573338		rpsA	8
ABI843_nonUDG	1575205	1575238		YPO_RS07960	33
ABI843_nonUDG	1575357	1575375		YPO_RS07960	18
ABI843_nonUDG	1575710	1575715		YPO_RS07960	5
ABI843_nonUDG	1576578	1576661		YPO_RS07960	83
ABI843_nonUDG	1576955	1576956		YPO_RS07960	1
ABI843_nonUDG	1577123	1577127		msbA	4
ABI843_nonUDG	1579812	1579824		lpxK	12
ABI843_nonUDG	1580159	1580163		YPO_RS07975	4
ABI843_nonUDG	1580500	1580518		YPO_RS07975	18
ABI843_nonUDG	1581268	1581272		YPO_RS07975	4
ABI843_nonUDG	1583488	1583495		kdsB	7
ABI843_nonUDG	1584704	1584721		YPO_RS07995	17
ABI843_nonUDG	1587302	1587324		mukF	22
ABI843_nonUDG	1587355	1587357		mukF	2
ABI843_nonUDG	1587925	1587930		mukE	5
ABI843_nonUDG	1588151	1588171		mukE	20
ABI843_nonUDG	1588478	1588482		mukE	4
ABI843_nonUDG	1588609	1588611		mukB	2
ABI843_nonUDG	1589259	1589292		mukB	33
ABI843_nonUDG	1591137	1591147		mukB	10
ABI843_nonUDG	1591401	1591421		mukB	20
ABI843_nonUDG	1592693	1592701		mukB	8
ABI843_nonUDG	1592942	1592975		mukB	33
ABI843_nonUDG	1594723	1594728		ldtD	5
ABI843_nonUDG	1595293	1595302		ldtD	9
ABI843_nonUDG	1595458	1595474		ldtD	16
ABI843_nonUDG	1596777	1596790		YPO_RS08035	13
ABI843_nonUDG	1597202	1597208		YPO_RS08035	6
ABI843_nonUDG	1598117	1598120		YPO_RS08045	3
ABI843_nonUDG	1599247	1599257		ompF	10
ABI843_nonUDG	1599311	1599334		ompF	23
ABI843_nonUDG	1599432	1599435		ompF	3
ABI843_nonUDG	1599473	1599491		ompF	18
ABI843_nonUDG	1600988	1600992		asnS	4
ABI843_nonUDG	1602862	1602872		pncB	10
ABI843_nonUDG	1603480	1603484		pncB	4
ABI843_nonUDG	1604875	1604881		pepN	6
ABI843_nonUDG	1605132	1605133		pepN	1
ABI843_nonUDG	1605302	1605314		pepN	12
ABI843_nonUDG	1605547	1605548		pepN	1
ABI843_nonUDG	1606627	1606647		pepN	20
ABI843_nonUDG	1607829	1607845		pyrD	16
ABI843_nonUDG	1608056	1608091		pyrD	35
ABI843_nonUDG	1608399	1608429		pyrD	30
ABI843_nonUDG	1610655	1610666		rlmKL	11
ABI843_nonUDG	1611453	1611464		rlmKL	11
ABI843_nonUDG	1612074	1612109		rlmKL	35
ABI843_nonUDG	1612409	1612422		rlmKL	13
ABI843_nonUDG	1614113	1614114		YPO_RS08090	1
ABI843_nonUDG	1614157	1614167		YPO_RS08090	10
ABI843_nonUDG	1614802	1614834		pqiA	32
ABI843_nonUDG	1615877	1615885		pqiA	8
ABI843_nonUDG	1618635	1618659		rmf	24
ABI843_nonUDG	1618863	1618865		YPO_RS08115	2
ABI843_nonUDG	1620571	1620634		YPO_RS08125	63
ABI843_nonUDG	1621073	1621090		YPO_RS08125	17
ABI843_nonUDG	1621564	1621579		YPO_RS08130	15
ABI843_nonUDG	1621783	1621789		YPO_RS08130	6
ABI843_nonUDG	1624219	1624222		YPO_RS08150	3
ABI843_nonUDG	1625257	1625266		YPO_RS08150	9
ABI843_nonUDG	1626007	1626009		matP	2
ABI843_nonUDG	1626552	1626566		YPO_RS08160	14
ABI843_nonUDG	1626762	1626769		YPO_RS08160	7
ABI843_nonUDG	1627897	1627904		ompA	7
ABI843_nonUDG	1628111	1628144		ompA	33
ABI843_nonUDG	1630192	1630198		yccS	6
ABI843_nonUDG	1630661	1630680		yccS	19
ABI843_nonUDG	1631309	1631312		yccS	3
ABI843_nonUDG	1631591	1631594		yccS	3
ABI843_nonUDG	1631642	1631648		yccS	6
ABI843_nonUDG	1631803	1631814		yccS	11
ABI843_nonUDG	1631912	1631915		yccS	3
ABI843_nonUDG	1633157	1633163		helD	6
ABI843_nonUDG	1634798	1634808		helD	10
ABI843_nonUDG	1634847	1634863		helD	16
ABI843_nonUDG	1636022	1636067		YPO_RS08200	45
ABI843_nonUDG	1637247	1637276		hspQ	29
ABI843_nonUDG	1637327	1637341		hspQ	14
ABI843_nonUDG	1643677	1643710		YPO_RS08245	33
ABI843_nonUDG	1643970	1643984		YPO_RS08245	14
ABI843_nonUDG	1644808	1644809		YPO_RS08245	1
ABI843_nonUDG	1646214	1646240		YPO_RS08250	26
ABI843_nonUDG	1647830	1647842		YPO_RS08260	12
ABI843_nonUDG	1648861	1648867		YPO_RS08265	6
ABI843_nonUDG	1648978	1649012		YPO_RS08265	34
ABI843_nonUDG	1649350	1649351		YPO_RS08265	1
ABI843_nonUDG	1649583	1649591		YPO_RS08270	8
ABI843_nonUDG	1650312	1650313		YPO_RS08275	1
ABI843_nonUDG	1650703	1650712		YPO_RS08275	9
ABI843_nonUDG	1650869	1650879		YPO_RS08275	10
ABI843_nonUDG	1651277	1651306		YPO_RS08275	29
ABI843_nonUDG	1651337	1651350		YPO_RS08275	13
ABI843_nonUDG	1651516	1651519		YPO_RS08280	3
ABI843_nonUDG	1651767	1651775		YPO_RS08280	8
ABI843_nonUDG	1652514	1652546		YPO_RS08285	32
ABI843_nonUDG	1653171	1653178		YPO_RS08290	7
ABI843_nonUDG	1653803	1653832		YPO_RS08295	29
ABI843_nonUDG	1655331	1655340		YPO_RS08305	9
ABI843_nonUDG	1655404	1655405		YPO_RS08305	1
ABI843_nonUDG	1657946	1657963		tssC	17
ABI843_nonUDG	1658257	1658296		tssC	39
ABI843_nonUDG	1658412	1658414		tssC	2
ABI843_nonUDG	1658969	1658984		tssK	15
ABI843_nonUDG	1659509	1659511		tssK	2
ABI843_nonUDG	1659872	1659880		YPO_RS08325	8
ABI843_nonUDG	1659914	1659940		YPO_RS08325	26
ABI843_nonUDG	1660772	1660790		YPO_RS08330	18
ABI843_nonUDG	1661824	1661828		YPO_RS08330	4
ABI843_nonUDG	1662173	1662183		YPO_RS08330	10
ABI843_nonUDG	1663340	1663369		tssH	29
ABI843_nonUDG	1664446	1664450		tssH	4
ABI843_nonUDG	1667009	1667017		YPO_RS08345	8
ABI843_nonUDG	1667197	1667207		YPO_RS08345	10
ABI843_nonUDG	1668232	1668247		YPO_RS08350	15
ABI843_nonUDG	1671412	1671430		YPO_RS08360	18
ABI843_nonUDG	1674193	1674200		YPO_RS08370	7
ABI843_nonUDG	1676900	1676914		YPO_RS08380	14
ABI843_nonUDG	1679143	1679145		YPO_RS08385	2
ABI843_nonUDG	1679247	1679268		YPO_RS08385	21
ABI843_nonUDG	1680186	1680188		YPO_RS08385	2
ABI843_nonUDG	1681053	1681061		YPO_RS08385	8
ABI843_nonUDG	1681459	1681482		tssA	23
ABI843_nonUDG	1683593	1683608		YPO_RS08395	15
ABI843_nonUDG	1683692	1683706		YPO_RS08395	14
ABI843_nonUDG	1683838	1683842		YPO_RS08395	4
ABI843_nonUDG	1684004	1684025		YPO_RS08395	21
ABI843_nonUDG	1684476	1684495		YPO_RS08400	19
ABI843_nonUDG	1685440	1685443		tssF	3
ABI843_nonUDG	1686996	1687011		tssG	15
ABI843_nonUDG	1687387	1687390		tssG	3
ABI843_nonUDG	1688376	1688387		tssE	11
ABI843_nonUDG	1689350	1689360		YPO_RS08425	10
ABI843_nonUDG	1689895	1689921		YPO_RS08425	26
ABI843_nonUDG	1690317	1690319		YPO_RS08430	2
ABI843_nonUDG	1692047	1692056		YPO_RS08435	9
ABI843_nonUDG	1692831	1692832		YPO_RS08435	1
ABI843_nonUDG	1692890	1692899		YPO_RS08435	9
ABI843_nonUDG	1693734	1693735		YPO_RS08440	1
ABI843_nonUDG	1694168	1694193		YPO_RS08445	25
ABI843_nonUDG	1694643	1694645		YPO_RS08445	2
ABI843_nonUDG	1695010	1695018		YPO_RS08445	8
ABI843_nonUDG	1695126	1695127		YPO_RS08445	1
ABI843_nonUDG	1696368	1696372		moeA	4
ABI843_nonUDG	1697941	1697999		darE	58
ABI843_nonUDG	1698192	1698195		darE	3
ABI843_nonUDG	1698679	1698709		darE	30
ABI843_nonUDG	1700423	1700427		darC	4
ABI843_nonUDG	1700556	1700585		darC	29
ABI843_nonUDG	1701240	1701266		darB	26
ABI843_nonUDG	1701330	1701331		darB	1
ABI843_nonUDG	1702215	1702224		darB	9
ABI843_nonUDG	1702260	1702268		darB	8
ABI843_nonUDG	1702504	1702518		darB	14
ABI843_nonUDG	1703430	1703437		darB	7
ABI843_nonUDG	1703627	1703676		darA-c	49
ABI843_nonUDG	1704058	1704071		fghA	13
ABI843_nonUDG	1704809	1704812		fghA	3
ABI843_nonUDG	1705799	1705802		YPO_RS08490	3
ABI843_nonUDG	1705920	1705922		YPO_RS08490	2
ABI843_nonUDG	1706685	1706695		YPO_RS08495	10
ABI843_nonUDG	1707186	1707191		YPO_RS08495	5
ABI843_nonUDG	1708981	1708991		folE	10
ABI843_nonUDG	1709616	1709643		YPO_RS08510	27
ABI843_nonUDG	1709816	1709819		YPO_RS08510	3
ABI843_nonUDG	1711331	1711350		mglB	19
ABI843_nonUDG	1712128	1712143		mglB	15
ABI843_nonUDG	1712806	1712807		mglA	1
ABI843_nonUDG	1713059	1713072		mglA	13
ABI843_nonUDG	1713213	1713264		mglA	51
ABI843_nonUDG	1714655	1714676		mglC	21
ABI843_nonUDG	1714972	1714973		mglC	1
ABI843_nonUDG	1715619	1715643		sanA	24
ABI843_nonUDG	1715771	1715773		sanA	2
ABI843_nonUDG	1716013	1716039		sanA	26
ABI843_nonUDG	1717952	1717961		YPO_RS08535	9
ABI843_nonUDG	1718775	1718776		cdd	1
ABI843_nonUDG	1720487	1720514		YPO_RS08545	27
ABI843_nonUDG	1720511	1720523		YPO_RS08550	12
ABI843_nonUDG	1720579	1720603		YPO_RS08550	24
ABI843_nonUDG	1723204	1723209		YPO_RS08560	5
ABI843_nonUDG	1723414	1723427		YPO_RS08560	13
ABI843_nonUDG	1723796	1723824		YPO_RS08560	28
ABI843_nonUDG	1724014	1724018		YPO_RS08565	4
ABI843_nonUDG	1725772	1725773		YPO_RS08570	1
ABI843_nonUDG	1725958	1725970		YPO_RS08570	12
ABI843_nonUDG	1727095	1727099		YPO_RS08575	4
ABI843_nonUDG	1727668	1727674		YPO_RS08580	6
ABI843_nonUDG	1727746	1727846		YPO_RS08580	100
ABI843_nonUDG	1727940	1727958		YPO_RS08580	18
ABI843_nonUDG	1728078	1728082		YPO_RS08580	4
ABI843_nonUDG	1728748	1728793		YPO_RS08585	45
ABI843_nonUDG	1728909	1728921		YPO_RS08585	12
ABI843_nonUDG	1728990	1729006		YPO_RS08585	16
ABI843_nonUDG	1731026	1731030		metG	4
ABI843_nonUDG	1731497	1731515		apbC	18
ABI843_nonUDG	1731775	1731778		apbC	3
ABI843_nonUDG	1732060	1732069		apbC	9
ABI843_nonUDG	1732133	1732152		apbC	19
ABI843_nonUDG	1733930	1733944		dcd	14
ABI843_nonUDG	1734129	1734149		dcd	20
ABI843_nonUDG	1735004	1735046		asmA	42
ABI843_nonUDG	1735719	1735730		asmA	11
ABI843_nonUDG	1735769	1735779		asmA	10
ABI843_nonUDG	1736470	1736474		YPO_RS08615	4
ABI843_nonUDG	1736906	1736914		YPO_RS08615	8
ABI843_nonUDG	1737004	1737022		YPO_RS08615	18
ABI843_nonUDG	1737290	1737291		YPO_RS08615	1
ABI843_nonUDG	1737466	1737477		YPO_RS08615	11
ABI843_nonUDG	1737696	1737703		YPO_RS08615	7
ABI843_nonUDG	1738654	1738691		fhuF	37
ABI843_nonUDG	1738936	1738937		fhuF	1
ABI843_nonUDG	1739310	1739322		YPO_RS08625	12
ABI843_nonUDG	1739448	1739452		YPO_RS08625	4
ABI843_nonUDG	1739606	1739607		YPO_RS08625	1
ABI843_nonUDG	1739775	1739781		YPO_RS08625	6
ABI843_nonUDG	1740081	1740094		YPO_RS08625	13
ABI843_nonUDG	1740187	1740201		YPO_RS08625	14
ABI843_nonUDG	1740710	1740721		YPO_RS08625	11
ABI843_nonUDG	1741703	1741722		YPO_RS08630	19
ABI843_nonUDG	1742944	1742946		YPO_RS08640	2
ABI843_nonUDG	1743599	1743612		YPO_RS08640	13
ABI843_nonUDG	1743729	1743746		YPO_RS08640	17
ABI843_nonUDG	1743861	1743875		YPO_RS08640	14
ABI843_nonUDG	1745868	1745870		YPO_RS08650	2
ABI843_nonUDG	1745916	1745921		YPO_RS08650	5
ABI843_nonUDG	1746149	1746152		YPO_RS08650	3
ABI843_nonUDG	1747090	1747096		YPO_RS08655	6
ABI843_nonUDG	1747346	1747350		YPO_RS08655	4
ABI843_nonUDG	1748111	1748114		YPO_RS08660	3
ABI843_nonUDG	1749574	1749583		YPO_RS08665	9
ABI843_nonUDG	1749646	1749650		YPO_RS08665	4
ABI843_nonUDG	1749761	1749771		YPO_RS08665	10
ABI843_nonUDG	1750354	1750359		YPO_RS08665	5
ABI843_nonUDG	1750799	1750813		YPO_RS08665	14
ABI843_nonUDG	1751728	1751733		YPO_RS08670	5
ABI843_nonUDG	1752331	1752343		YPO_RS08670	12
ABI843_nonUDG	1752922	1752931		YPO_RS08670	9
ABI843_nonUDG	1755321	1755331		galU	10
ABI843_nonUDG	1756585	1756586		gndA	1
ABI843_nonUDG	1757039	1757044		gndA	5
ABI843_nonUDG	1757569	1757571		gndA	2
ABI843_nonUDG	1757962	1757982		YPO_RS08690	20
ABI843_nonUDG	1759138	1759145		hisF	7
ABI843_nonUDG	1760525	1760528		hisH	3
ABI843_nonUDG	1760583	1760584		hisH	1
ABI843_nonUDG	1760584	1760610		hisB	26
ABI843_nonUDG	1761271	1761279		hisB	8
ABI843_nonUDG	1762900	1762916		hisD	16
ABI843_nonUDG	1762998	1762999		hisD	1
ABI843_nonUDG	1763146	1763163		hisD	17
ABI843_nonUDG	1763413	1763437		hisD	24
ABI843_nonUDG	1764110	1764111		hisD	1
ABI843_nonUDG	1764163	1764165		hisG	2
ABI843_nonUDG	1766758	1766765		YPO_RS08740	7
ABI843_nonUDG	1768153	1768158		YPO_RS08745	5
ABI843_nonUDG	1768485	1768494		YPO_RS08750	9
ABI843_nonUDG	1769261	1769267		YPO_RS08755	6
ABI843_nonUDG	1769663	1769664		YPO_RS08755	1
ABI843_nonUDG	1771227	1771230		YPO_RS08760	3
ABI843_nonUDG	1772087	1772108		YPO_RS08770	21
ABI843_nonUDG	1772317	1772332		YPO_RS08770	15
ABI843_nonUDG	1772538	1772545		YPO_RS08770	7
ABI843_nonUDG	1774572	1774600		sbcB	28
ABI843_nonUDG	1774693	1774699		sbcB	6
ABI843_nonUDG	1775686	1775697		YPO_RS08785	11
ABI843_nonUDG	1777986	1778012		YPO_RS08795	26
ABI843_nonUDG	1778329	1778331		YPO_RS08795	2
ABI843_nonUDG	1778416	1778421		YPO_RS08795	5
ABI843_nonUDG	1778671	1778676		YPO_RS08795	5
ABI843_nonUDG	1779356	1779372		YPO_RS08800	16
ABI843_nonUDG	1780080	1780091		YPO_RS08800	11
ABI843_nonUDG	1780291	1780299		YPO_RS08800	8
ABI843_nonUDG	1780790	1780791		YPO_RS08800	1
ABI843_nonUDG	1780851	1780857		YPO_RS08800	6
ABI843_nonUDG	1781277	1781338		YPO_RS08800	61
ABI843_nonUDG	1781950	1781959		YPO_RS08800	9
ABI843_nonUDG	1783224	1783271		YPO_RS08805	47
ABI843_nonUDG	1783487	1783494		YPO_RS08805	7
ABI843_nonUDG	1783813	1783822		YPO_RS08805	9
ABI843_nonUDG	1785419	1785422		YPO_RS08815	3
ABI843_nonUDG	1785507	1785516		YPO_RS08815	9
ABI843_nonUDG	1785712	1785722		YPO_RS08815	10
ABI843_nonUDG	1786242	1786246		YPO_RS08820	4
ABI843_nonUDG	1786678	1786682		YPO_RS08820	4
ABI843_nonUDG	1787139	1787143		YPO_RS08825	4
ABI843_nonUDG	1788125	1788174		YPO_RS08825	49
ABI843_nonUDG	1790120	1790130		argG	10
ABI843_nonUDG	1790334	1790359		argG	25
ABI843_nonUDG	1791766	1791773		YPO_RS08840	7
ABI843_nonUDG	1792577	1792590		YPO_RS08840	13
ABI843_nonUDG	1796385	1796400		YPO_RS08855	15
ABI843_nonUDG	1800469	1800476		YPO_RS08880	7
ABI843_nonUDG	1800794	1800795		YPO_RS08880	1
ABI843_nonUDG	1801228	1801240		YPO_RS08885	12
ABI843_nonUDG	1801453	1801461		YPO_RS08885	8
ABI843_nonUDG	1801577	1801580		YPO_RS08885	3
ABI843_nonUDG	1802436	1802444		YPO_RS08890	8
ABI843_nonUDG	1803158	1803161		YPO_RS08890	3
ABI843_nonUDG	1803811	1803819		YPO_RS08900	8
ABI843_nonUDG	1804059	1804070		YPO_RS08900	11
ABI843_nonUDG	1804496	1804510		YPO_RS08900	14
ABI843_nonUDG	1805680	1805682		YPO_RS08900	2
ABI843_nonUDG	1806976	1807004		YPO_RS08905	28
ABI843_nonUDG	1807147	1807152		YPO_RS08910	5
ABI843_nonUDG	1807463	1807473		YPO_RS08910	10
ABI843_nonUDG	1807632	1807644		YPO_RS08910	12
ABI843_nonUDG	1807830	1807875		YPO_RS08910	45
ABI843_nonUDG	1808281	1808325		bssS	44
ABI843_nonUDG	1808409	1808490		bssS	81
ABI843_nonUDG	1812149	1812163		YPO_RS08940	14
ABI843_nonUDG	1812326	1812337		YPO_RS08940	11
ABI843_nonUDG	1814053	1814059		rne	6
ABI843_nonUDG	1814718	1814729		rne	11
ABI843_nonUDG	1815196	1815201		rne	5
ABI843_nonUDG	1817182	1817198		rluC	16
ABI843_nonUDG	1824686	1824709		fabF	23
ABI843_nonUDG	1824881	1824895		fabF	14
ABI843_nonUDG	1827527	1827532		pabC	5
ABI843_nonUDG	1829418	1829420		YPO_RS09020	2
ABI843_nonUDG	1830228	1830240		holB	12
ABI843_nonUDG	1830520	1830531		holB	11
ABI843_nonUDG	1832368	1832369		ptsG	1
ABI843_nonUDG	1832528	1832550		ptsG	22
ABI843_nonUDG	1832921	1832924		ptsG	3
ABI843_nonUDG	1833467	1833485		YPO_RS09040	18
ABI843_nonUDG	1834279	1834280		YPO_RS09045	1
ABI843_nonUDG	1834893	1834896		YPO_RS09045	3
ABI843_nonUDG	1835525	1835535		hinT	10
ABI843_nonUDG	1835690	1835705		YPO_RS09055	15
ABI843_nonUDG	1836653	1836664		thiK	11
ABI843_nonUDG	1838232	1838237		nagZ	5
ABI843_nonUDG	1838978	1838987		YPO_RS09075	9
ABI843_nonUDG	1839095	1839102		YPO_RS09075	7
ABI843_nonUDG	1839605	1839607		YPO_RS09080	2
ABI843_nonUDG	1839879	1839891		YPO_RS09080	12
ABI843_nonUDG	1840321	1840323		YPO_RS09080	2
ABI843_nonUDG	1840710	1840734		YPO_RS09080	24
ABI843_nonUDG	1842105	1842122		YPO_RS09090	17
ABI843_nonUDG	1842376	1842401		YPO_RS09090	25
ABI843_nonUDG	1842635	1842657		YPO_RS09095	22
ABI843_nonUDG	1842822	1842838		YPO_RS09095	16
ABI843_nonUDG	1844266	1844278		YPO_RS09100	12
ABI843_nonUDG	1844376	1844379		YPO_RS09100	3
ABI843_nonUDG	1844443	1844502		YPO_RS09100	59
ABI843_nonUDG	1844540	1844544		YPO_RS09100	4
ABI843_nonUDG	1844687	1844688		YPO_RS09100	1
ABI843_nonUDG	1844903	1844928		YPO_RS09105	25
ABI843_nonUDG	1844967	1845000		YPO_RS09105	33
ABI843_nonUDG	1845168	1845182		YPO_RS09105	14
ABI843_nonUDG	1845215	1845217		YPO_RS09105	2
ABI843_nonUDG	1845277	1845280		YPO_RS09105	3
ABI843_nonUDG	1845460	1845472		YPO_RS09105	12
ABI843_nonUDG	1845503	1845508		YPO_RS09105	5
ABI843_nonUDG	1845573	1845587		YPO_RS09105	14
ABI843_nonUDG	1846258	1846261		YPO_RS09110	3
ABI843_nonUDG	1848597	1848602		mfd	5
ABI843_nonUDG	1849684	1849698		mfd	14
ABI843_nonUDG	1850595	1850608		lolC	13
ABI843_nonUDG	1851486	1851489		lolC	3
ABI843_nonUDG	1851578	1851588		lolC	10
ABI843_nonUDG	1851752	1851759		lolD	7
ABI843_nonUDG	1851846	1851871		lolD	25
ABI843_nonUDG	1852698	1852711		lolE	13
ABI843_nonUDG	1852986	1853002		lolE	16
ABI843_nonUDG	1853143	1853161		lolE	18
ABI843_nonUDG	1853289	1853310		lolE	21
ABI843_nonUDG	1853400	1853401		lolE	1
ABI843_nonUDG	1855308	1855345		cobB	37
ABI843_nonUDG	1856543	1856548		pepT	5
ABI843_nonUDG	1859391	1859400		phoQ	9
ABI843_nonUDG	1861907	1861912		purB	5
ABI843_nonUDG	1864064	1864081		mnmA	17
ABI843_nonUDG	1864188	1864195		mnmA	7
ABI843_nonUDG	1868075	1868078		YPO_RS09200	3
ABI843_nonUDG	1869493	1869499		YPO_RS09210	6
ABI843_nonUDG	1873144	1873147		YPO_RS09220	3
ABI843_nonUDG	1874070	1874078		YPO_RS09230	8
ABI843_nonUDG	1874821	1874841		YPO_RS09230	20
ABI843_nonUDG	1876937	1876948		YPO_RS09245	11
ABI843_nonUDG	1877046	1877075		YPO_RS09245	29
ABI843_nonUDG	1877257	1877261		YPO_RS09245	4
ABI843_nonUDG	1878147	1878152		YPO_RS09250	5
ABI843_nonUDG	1879166	1879171		YPO_RS09255	5
ABI843_nonUDG	1881013	1881043		YPO_RS09260	30
ABI843_nonUDG	1881455	1881479		YPO_RS09260	24
ABI843_nonUDG	1881775	1881779		YPO_RS09260	4
ABI843_nonUDG	1882116	1882127		YPO_RS09260	11
ABI843_nonUDG	1882314	1882339		YPO_RS09260	25
ABI843_nonUDG	1882905	1882940		YPO_RS09260	35
ABI843_nonUDG	1883116	1883118		YPO_RS09260	2
ABI843_nonUDG	1883209	1883232		YPO_RS09260	23
ABI843_nonUDG	1883893	1883918		cspE	25
ABI843_nonUDG	1884151	1884193		dsrB	42
ABI843_nonUDG	1889284	1889299		mgtA	15
ABI843_nonUDG	1890082	1890087		mgtA	5
ABI843_nonUDG	1890146	1890149		mgtA	3
ABI843_nonUDG	1890476	1890489		mgtA	13
ABI843_nonUDG	1892919	1892925		flhC	6
ABI843_nonUDG	1894050	1894077		motA	27
ABI843_nonUDG	1896122	1896141		cheA	19
ABI843_nonUDG	1896373	1896389		cheA	16
ABI843_nonUDG	1897363	1897364		cheA	1
ABI843_nonUDG	1897444	1897459		cheA	15
ABI843_nonUDG	1897737	1897741		cheA	4
ABI843_nonUDG	1898173	1898226		cheW	53
ABI843_nonUDG	1898314	1898315		cheW	1
ABI843_nonUDG	1898568	1898570		cheW	2
ABI843_nonUDG	1899654	1899655		YPO_RS09320	1
ABI843_nonUDG	1899958	1899963		YPO_RS09320	5
ABI843_nonUDG	1901763	1901776		YPO_RS09335	13
ABI843_nonUDG	1901938	1901945		YPO_RS09335	7
ABI843_nonUDG	1901981	1901993		YPO_RS09335	12
ABI843_nonUDG	1903255	1903258		yapJ	3
ABI843_nonUDG	1903777	1903786		yapJ	9
ABI843_nonUDG	1904044	1904058		yapJ	14
ABI843_nonUDG	1904288	1904310		yapJ	22
ABI843_nonUDG	1904857	1904896		yapJ	39
ABI843_nonUDG	1905001	1905010		yapJ	9
ABI843_nonUDG	1905172	1905174		yapJ	2
ABI843_nonUDG	1905324	1905328		yapJ	4
ABI843_nonUDG	1905673	1905676		yapJ	3
ABI843_nonUDG	1906175	1906185		yapJ	10
ABI843_nonUDG	1908489	1908492		YPO_RS09345	3
ABI843_nonUDG	1909434	1909451		YPO_RS09345	17
ABI843_nonUDG	1909553	1909555		YPO_RS09345	2
ABI843_nonUDG	1909729	1909754		YPO_RS09345	25
ABI843_nonUDG	1909863	1909901		YPO_RS09345	38
ABI843_nonUDG	1911026	1911046		YPO_RS09355	20
ABI843_nonUDG	1911267	1911286		YPO_RS09355	19
ABI843_nonUDG	1915568	1915624		YPO_RS09370	56
ABI843_nonUDG	1916271	1916286		YPO_RS09370	15
ABI843_nonUDG	1917197	1917220		cheZ	23
ABI843_nonUDG	1918590	1918602		YPO_RS09385	12
ABI843_nonUDG	1920642	1920644		YPO_RS09390	2
ABI843_nonUDG	1922143	1922149		YPO_RS09400	6
ABI843_nonUDG	1923878	1923892		YPO_RS09405	14
ABI843_nonUDG	1924323	1924326		YPO_RS09405	3
ABI843_nonUDG	1924676	1924715		YPO_RS09405	39
ABI843_nonUDG	1925527	1925540		YPO_RS09410	13
ABI843_nonUDG	1926907	1926919		YPO_RS09420	12
ABI843_nonUDG	1927181	1927197		YPO_RS09420	16
ABI843_nonUDG	1927687	1927693		YPO_RS09420	6
ABI843_nonUDG	1928373	1928381		YPO_RS09425	8
ABI843_nonUDG	1928939	1928945		YPO_RS09430	6
ABI843_nonUDG	1929241	1929249		YPO_RS09430	8
ABI843_nonUDG	1929351	1929371		YPO_RS09430	20
ABI843_nonUDG	1929754	1929759		YPO_RS09435	5
ABI843_nonUDG	1929963	1930003		YPO_RS09435	40
ABI843_nonUDG	1930060	1930075		YPO_RS09435	15
ABI843_nonUDG	1930440	1930441		YPO_RS09435	1
ABI843_nonUDG	1931477	1931483		YPO_RS09440	6
ABI843_nonUDG	1931684	1931703		YPO_RS09445	19
ABI843_nonUDG	1932645	1932655		YPO_RS09450	10
ABI843_nonUDG	1933292	1933295		YPO_RS09455	3
ABI843_nonUDG	1933388	1933389		YPO_RS09455	1
ABI843_nonUDG	1934545	1934561		YPO_RS09455	16
ABI843_nonUDG	1935550	1935556		YPO_RS09455	6
ABI843_nonUDG	1936909	1936912		YPO_RS09465	3
ABI843_nonUDG	1937256	1937263		YPO_RS09465	7
ABI843_nonUDG	1938306	1938310		YPO_RS09475	4
ABI843_nonUDG	1939320	1939328		YPO_RS09480	8
ABI843_nonUDG	1940268	1940276		YPO_RS09480	8
ABI843_nonUDG	1940915	1940926		YPO_RS09480	11
ABI843_nonUDG	1941965	1942014		yebS	49
ABI843_nonUDG	1942481	1942526		yebS	45
ABI843_nonUDG	1942615	1942617		yebS	2
ABI843_nonUDG	1944512	1944518		prc	6
ABI843_nonUDG	1945064	1945066		prc	2
ABI843_nonUDG	1945357	1945358		prc	1
ABI843_nonUDG	1945922	1945934		prc	12
ABI843_nonUDG	1947447	1947453		htpX	6
ABI843_nonUDG	1948455	1948459		YPO_RS09510	4
ABI843_nonUDG	1948641	1948650		YPO_RS09510	9
ABI843_nonUDG	1949211	1949215		YPO_RS09515	4
ABI843_nonUDG	1949337	1949350		YPO_RS09515	13
ABI843_nonUDG	1949919	1949926		YPO_RS09520	7
ABI843_nonUDG	1950912	1950913		YPO_RS09520	1
ABI843_nonUDG	1951087	1951098		YPO_RS09520	11
ABI843_nonUDG	1951709	1951750		YPO_RS09520	41
ABI843_nonUDG	1952756	1952791		YPO_RS09525	35
ABI843_nonUDG	1953574	1953577		YPO_RS09525	3
ABI843_nonUDG	1954200	1954208		YPO_RS09530	8
ABI843_nonUDG	1954588	1954597		YPO_RS09535	9
ABI843_nonUDG	1955351	1955357		YPO_RS09535	6
ABI843_nonUDG	1955424	1955429		YPO_RS09535	5
ABI843_nonUDG	1955474	1955490		YPO_RS09535	16
ABI843_nonUDG	1956420	1956427		YPO_RS09540	7
ABI843_nonUDG	1957920	1957933		kdgR	13
ABI843_nonUDG	1958197	1958200		kdgR	3
ABI843_nonUDG	1959077	1959098		YPO_RS09550	21
ABI843_nonUDG	1959606	1959615		YPO_RS09550	9
ABI843_nonUDG	1960144	1960160		YPO_RS09555	16
ABI843_nonUDG	1961676	1961691		YPO_RS09560	15
ABI843_nonUDG	1963998	1964032		YPO_RS09570	34
ABI843_nonUDG	1964321	1964359		YPO_RS09570	38
ABI843_nonUDG	1964736	1964740		YPO_RS09570	4
ABI843_nonUDG	1966085	1966096		YPO_RS09580	11
ABI843_nonUDG	1966963	1967043		YPO_RS09585	80
ABI843_nonUDG	1967600	1967607		YPO_RS09585	7
ABI843_nonUDG	1967664	1967675		YPO_RS09585	11
ABI843_nonUDG	1968965	1968972		YPO_RS09590	7
ABI843_nonUDG	1970682	1970703		kduI	21
ABI843_nonUDG	1970841	1970890		kduI	49
ABI843_nonUDG	1971786	1971797		YPO_RS09605	11
ABI843_nonUDG	1972818	1972830		YPO_RS09610	12
ABI843_nonUDG	1972874	1972896		YPO_RS09610	22
ABI843_nonUDG	1972932	1972957		YPO_RS09610	25
ABI843_nonUDG	1975363	1975372		YPO_RS09620	9
ABI843_nonUDG	1975457	1975494		YPO_RS09620	37
ABI843_nonUDG	1975655	1975693		YPO_RS09620	38
ABI843_nonUDG	1975751	1975752		YPO_RS09620	1
ABI843_nonUDG	1976007	1976024		YPO_RS09625	17
ABI843_nonUDG	1976085	1976137		YPO_RS09625	52
ABI843_nonUDG	1976460	1976485		YPO_RS09625	25
ABI843_nonUDG	1976590	1976629		YPO_RS09630	39
ABI843_nonUDG	1977668	1977674		mtfA	6
ABI843_nonUDG	1979964	1979977		YPO_RS09655	13
ABI843_nonUDG	1981210	1981213		YPO_RS09655	3
ABI843_nonUDG	1981451	1981481		YPO_RS09655	30
ABI843_nonUDG	1982367	1982374		YPO_RS09660	7
ABI843_nonUDG	1982558	1982573		YPO_RS09665	15
ABI843_nonUDG	1983997	1984000		YPO_RS09675	3
ABI843_nonUDG	1984371	1984377		mgrB	6
ABI843_nonUDG	1986051	1986061		YPO_RS09700	10
ABI843_nonUDG	1986795	1986802		YPO_RS09700	7
ABI843_nonUDG	1986953	1986967		YPO_RS09700	14
ABI843_nonUDG	1987265	1987274		YPO_RS09700	9
ABI843_nonUDG	1987408	1987424		YPO_RS09700	16
ABI843_nonUDG	1987777	1987782		YPO_RS09705	5
ABI843_nonUDG	1988040	1988052		YPO_RS09705	12
ABI843_nonUDG	1988212	1988221		YPO_RS09705	9
ABI843_nonUDG	1988312	1988316		YPO_RS09705	4
ABI843_nonUDG	1989546	1989557		cspE	11
ABI843_nonUDG	1990344	1990360		pgeF	16
ABI843_nonUDG	1992935	1992944		YPO_RS09735	9
ABI843_nonUDG	1993029	1993056		YPO_RS09735	27
ABI843_nonUDG	1993261	1993281		YPO_RS09735	20
ABI843_nonUDG	1993838	1993864		YPO_RS09740	26
ABI843_nonUDG	1993984	1993996		YPO_RS09740	12
ABI843_nonUDG	1994262	1994326		YPO_RS09740	64
ABI843_nonUDG	1994498	1994509		YPO_RS09745	11
ABI843_nonUDG	1994841	1994861		YPO_RS09745	20
ABI843_nonUDG	1995130	1995157		YPO_RS09745	27
ABI843_nonUDG	1995422	1995452		YPO_RS09745	30
ABI843_nonUDG	1995708	1995725		YPO_RS09745	17
ABI843_nonUDG	1997337	1997346		YPO_RS09750	9
ABI843_nonUDG	1998458	1998472		YPO_RS09750	14
ABI843_nonUDG	1998924	1998935		YPO_RS09750	11
ABI843_nonUDG	1999336	1999349		mntP	13
ABI843_nonUDG	1999860	1999876		mntP	16
ABI843_nonUDG	2000582	2000607		YPO_RS09760	25
ABI843_nonUDG	2000708	2000717		YPO_RS09760	9
ABI843_nonUDG	2001207	2001247		YPO_RS09765	40
ABI843_nonUDG	2001965	2001970		YPO_RS09770	5
ABI843_nonUDG	2002459	2002479		YPO_RS09770	20
ABI843_nonUDG	2005671	2005692		YPO_RS09780	21
ABI843_nonUDG	2006459	2006472		hpaR	13
ABI843_nonUDG	2007528	2007534		YPO_RS09795	6
ABI843_nonUDG	2008364	2008366		YPO_RS09800	2
ABI843_nonUDG	2008814	2008829		YPO_RS09800	15
ABI843_nonUDG	2009266	2009271		YPO_RS09800	5
ABI843_nonUDG	2009465	2009472		YPO_RS09800	7
ABI843_nonUDG	2011023	2011037		YPO_RS09810	14
ABI843_nonUDG	2012905	2012923		hpaX	18
ABI843_nonUDG	2014292	2014316		hpaB	24
ABI843_nonUDG	2015432	2015433		hpaB	1
ABI843_nonUDG	2016080	2016115		hpaC	35
ABI843_nonUDG	2016190	2016195		hpaC	5
ABI843_nonUDG	2016685	2016701		YPO_RS09840	16
ABI843_nonUDG	2017660	2017664		YPO_RS09840	4
ABI843_nonUDG	2019302	2019308		pabB	6
ABI843_nonUDG	2020409	2020411		pabB	2
ABI843_nonUDG	2020700	2020714		YPO_RS09855	14
ABI843_nonUDG	2020784	2020792		YPO_RS09855	8
ABI843_nonUDG	2021159	2021166		purT	7
ABI843_nonUDG	2024281	2024285		YPO_RS09870	4
ABI843_nonUDG	2024864	2024880		YPO_RS09880	16
ABI843_nonUDG	2025548	2025567		YPO_RS09885	19
ABI843_nonUDG	2025626	2025654		YPO_RS09885	28
ABI843_nonUDG	2025853	2025862		YPO_RS09885	9
ABI843_nonUDG	2026157	2026179		YPO_RS09885	22
ABI843_nonUDG	2026811	2026815		YPO_RS09885	4
ABI843_nonUDG	2027182	2027184		YPO_RS09885	2
ABI843_nonUDG	2029096	2029101		pip	5
ABI843_nonUDG	2029197	2029202		pip	5
ABI843_nonUDG	2031876	2031878		copD	2
ABI843_nonUDG	2031953	2031970		copD	17
ABI843_nonUDG	2033245	2033276		YPO_RS09920	31
ABI843_nonUDG	2035035	2035049		flhB	14
ABI843_nonUDG	2035670	2035687		flhA	17
ABI843_nonUDG	2035928	2035975		flhA	47
ABI843_nonUDG	2036456	2036465		flhA	9
ABI843_nonUDG	2036655	2036668		flhA	13
ABI843_nonUDG	2037155	2037169		flhA	14
ABI843_nonUDG	2037275	2037278		flhA	3
ABI843_nonUDG	2037502	2037508		flhA	6
ABI843_nonUDG	2039730	2039732		YPO_RS09950	2
ABI843_nonUDG	2040067	2040070		YPO_RS09950	3
ABI843_nonUDG	2044808	2044817		flgC	9
ABI843_nonUDG	2045527	2045529		flgD	2
ABI843_nonUDG	2046150	2046159		YPO_RS09990	9
ABI843_nonUDG	2046298	2046319		YPO_RS09990	21
ABI843_nonUDG	2046656	2046678		YPO_RS09990	22
ABI843_nonUDG	2048017	2048021		flgG	4
ABI843_nonUDG	2048588	2048603		flgG	15
ABI843_nonUDG	2050019	2050024		YPO_RS10010	5
ABI843_nonUDG	2050869	2050872		flgJ	3
ABI843_nonUDG	2051594	2051597		flgJ	3
ABI843_nonUDG	2053153	2053155		flgK	2
ABI843_nonUDG	2053454	2053478		flgK	24
ABI843_nonUDG	2053594	2053597		flgK	3
ABI843_nonUDG	2054321	2054324		flgL	3
ABI843_nonUDG	2054653	2054655		flgL	2
ABI843_nonUDG	2055596	2055619		YPO_RS10030	23
ABI843_nonUDG	2056236	2056244		YPO_RS10030	8
ABI843_nonUDG	2057628	2057654		YPO_RS10035	26
ABI843_nonUDG	2058461	2058465		YPO_RS10035	4
ABI843_nonUDG	2058845	2058854		YPO_RS10040	9
ABI843_nonUDG	2059021	2059024		YPO_RS10040	3
ABI843_nonUDG	2059583	2059590		YPO_RS10040	7
ABI843_nonUDG	2060201	2060208		YPO_RS10045	7
ABI843_nonUDG	2060821	2060838		YPO_RS10045	17
ABI843_nonUDG	2061719	2061730		YPO_RS10050	11
ABI843_nonUDG	2062219	2062240		YPO_RS10050	21
ABI843_nonUDG	2062464	2062481		YPO_RS10050	17
ABI843_nonUDG	2062484	2062486		YPO_RS10055	2
ABI843_nonUDG	2062836	2062853		YPO_RS10055	17
ABI843_nonUDG	2062930	2062941		YPO_RS10055	11
ABI843_nonUDG	2063368	2063384		YPO_RS10055	16
ABI843_nonUDG	2064348	2064351		YPO_RS10060	3
ABI843_nonUDG	2065743	2065749		fliR	6
ABI843_nonUDG	2065840	2065864		fliR	24
ABI843_nonUDG	2066256	2066282		fliR	26
ABI843_nonUDG	2066422	2066432		fliQ	10
ABI843_nonUDG	2066598	2066611		fliQ	13
ABI843_nonUDG	2067960	2067968		fliO	8
ABI843_nonUDG	2068570	2068576		fliM	6
ABI843_nonUDG	2068981	2068993		fliM	12
ABI843_nonUDG	2069562	2069580		fliL	18
ABI843_nonUDG	2071420	2071423		YPO_RS10110	3
ABI843_nonUDG	2071986	2071996		fliJ	10
ABI843_nonUDG	2072423	2072439		fliI	16
ABI843_nonUDG	2073640	2073648		fliI	8
ABI843_nonUDG	2073640	2073652		fliH	12
ABI843_nonUDG	2073946	2073948		fliH	2
ABI843_nonUDG	2074573	2074583		fliG	10
ABI843_nonUDG	2076584	2076596		fliF	12
ABI843_nonUDG	2076785	2076795		fliF	10
ABI843_nonUDG	2077578	2077581		fliE	3
ABI843_nonUDG	2077840	2077851		YPO_RS10145	11
ABI843_nonUDG	2078136	2078163		YPO_RS10150	27
ABI843_nonUDG	2078662	2078669		YPO_RS10155	7
ABI843_nonUDG	2078721	2078723		YPO_RS10155	2
ABI843_nonUDG	2079798	2079811		YPO_RS10165	13
ABI843_nonUDG	2080008	2080022		YPO_RS10165	14
ABI843_nonUDG	2080112	2080129		YPO_RS10165	17
ABI843_nonUDG	2080275	2080290		YPO_RS10165	15
ABI843_nonUDG	2080753	2080754		YPO_RS10170	1
ABI843_nonUDG	2081685	2081743		YPO_RS10170	58
ABI843_nonUDG	2083663	2083665		YPO_RS10175	2
ABI843_nonUDG	2084878	2084898		fliS	20
ABI843_nonUDG	2085134	2085137		fliD	3
ABI843_nonUDG	2085735	2085767		fliD	32
ABI843_nonUDG	2085872	2085874		fliD	2
ABI843_nonUDG	2087668	2087677		YPO_RS10195	9
ABI843_nonUDG	2087758	2087760		YPO_RS10195	2
ABI843_nonUDG	2089286	2089298		fliZ	12
ABI843_nonUDG	2090205	2090223		YPO_RS10210	18
ABI843_nonUDG	2090661	2090667		YPO_RS10210	6
ABI843_nonUDG	2091992	2092002		tcyL	10
ABI843_nonUDG	2092765	2092766		yecC	1
ABI843_nonUDG	2092979	2093005		yecC	26
ABI843_nonUDG	2094694	2094700		putA	6
ABI843_nonUDG	2095467	2095495		putA	28
ABI843_nonUDG	2096664	2096667		putA	3
ABI843_nonUDG	2096886	2096898		putA	12
ABI843_nonUDG	2097027	2097041		putA	14
ABI843_nonUDG	2098005	2098010		putA	5
ABI843_nonUDG	2099005	2099013		YPO_RS10245	8
ABI843_nonUDG	2099564	2099595		putP	31
ABI843_nonUDG	2100339	2100341		putP	2
ABI843_nonUDG	2103582	2103595		efeB	13
ABI843_nonUDG	2103881	2103890		efeB	9
ABI843_nonUDG	2104033	2104048		efeB	15
ABI843_nonUDG	2104646	2104657		wrbA	11
ABI843_nonUDG	2105485	2105487		YPO_RS10275	2
ABI843_nonUDG	2106388	2106397		YPO_RS10275	9
ABI843_nonUDG	2107395	2107403		cycA	8
ABI843_nonUDG	2107855	2107858		cycA	3
ABI843_nonUDG	2109339	2109353		YPO_RS10290	14
ABI843_nonUDG	2109663	2109703		YPO_RS10290	40
ABI843_nonUDG	2110742	2110783		YPO_RS10300	41
ABI843_nonUDG	2112110	2112163		uvrY	53
ABI843_nonUDG	2113402	2113409		uvrC	7
ABI843_nonUDG	2113649	2113681		uvrC	32
ABI843_nonUDG	2114338	2114342		pgsA	4
ABI843_nonUDG	2114546	2114574		pgsA	28
ABI843_nonUDG	2115479	2115481		YPO_RS10340	2
ABI843_nonUDG	2117713	2117720		YPO_RS10355	7
ABI843_nonUDG	2119139	2119152		YPO_RS10365	13
ABI843_nonUDG	2122449	2122462		YPO_RS10390	13
ABI843_nonUDG	2122639	2122654		YPO_RS10395	15
ABI843_nonUDG	2122783	2122816		YPO_RS10395	33
ABI843_nonUDG	2123522	2123527		YPO_RS10405	5
ABI843_nonUDG	2123740	2123767		YPO_RS10405	27
ABI843_nonUDG	2126049	2126059		YPO_RS10415	10
ABI843_nonUDG	2126288	2126306		YPO_RS10415	18
ABI843_nonUDG	2126912	2126941		YPO_RS10420	29
ABI843_nonUDG	2131498	2131547		YPO_RS10440	49
ABI843_nonUDG	2131643	2131648		YPO_RS10440	5
ABI843_nonUDG	2132642	2132643		YPO_RS10445	1
ABI843_nonUDG	2132712	2132720		YPO_RS10450	8
ABI843_nonUDG	2133075	2133091		YPO_RS10450	16
ABI843_nonUDG	2133228	2133233		YPO_RS10450	5
ABI843_nonUDG	2134339	2134344		YPO_RS10455	5
ABI843_nonUDG	2134999	2135005		YPO_RS10470	6
ABI843_nonUDG	2135858	2135888		YPO_RS10475	30
ABI843_nonUDG	2136148	2136161		YPO_RS10475	13
ABI843_nonUDG	2136234	2136257		YPO_RS10475	23
ABI843_nonUDG	2136307	2136319		YPO_RS10475	12
ABI843_nonUDG	2136518	2136554		YPO_RS10475	36
ABI843_nonUDG	2136853	2136893		YPO_RS10480	40
ABI843_nonUDG	2136946	2136956		YPO_RS10480	10
ABI843_nonUDG	2137036	2137065		YPO_RS10480	29
ABI843_nonUDG	2137245	2137286		YPO_RS10480	41
ABI843_nonUDG	2138029	2138033		YPO_RS10495	4
ABI843_nonUDG	2138792	2138796		YPO_RS10500	4
ABI843_nonUDG	2139177	2139184		YPO_RS10505	7
ABI843_nonUDG	2139232	2139237		YPO_RS10505	5
ABI843_nonUDG	2140899	2140911		fyuA	12
ABI843_nonUDG	2141571	2141573		fyuA	2
ABI843_nonUDG	2142093	2142123		fyuA	30
ABI843_nonUDG	2142301	2142302		fyuA	1
ABI843_nonUDG	2143330	2143340		ybtE	10
ABI843_nonUDG	2143825	2143830		ybtE	5
ABI843_nonUDG	2145995	2145996		ybtU	1
ABI843_nonUDG	2146670	2146685		irp1	15
ABI843_nonUDG	2147067	2147070		irp1	3
ABI843_nonUDG	2147964	2147967		irp1	3
ABI843_nonUDG	2149161	2149168		irp1	7
ABI843_nonUDG	2153396	2153402		irp1	6
ABI843_nonUDG	2154721	2154725		irp1	4
ABI843_nonUDG	2155887	2155901		irp1	14
ABI843_nonUDG	2156970	2156979		irp2	9
ABI843_nonUDG	2157370	2157374		irp2	4
ABI843_nonUDG	2159462	2159481		irp2	19
ABI843_nonUDG	2159988	2160021		irp2	33
ABI843_nonUDG	2161911	2161934		irp2	23
ABI843_nonUDG	2164141	2164182		ybtP	41
ABI843_nonUDG	2164355	2164356		ybtP	1
ABI843_nonUDG	2164705	2164714		ybtP	9
ABI843_nonUDG	2165211	2165218		ybtP	7
ABI843_nonUDG	2166086	2166088		ybtQ	2
ABI843_nonUDG	2166913	2166961		ybtQ	48
ABI843_nonUDG	2167833	2167839		ybtX	6
ABI843_nonUDG	2168860	2168871		ybtS	11
ABI843_nonUDG	2170177	2170183		YPO_RS10570	6
ABI843_nonUDG	2171909	2171910		YPO_RS10580	1
ABI843_nonUDG	2172190	2172207		YPO_RS10580	17
ABI843_nonUDG	2172960	2172976		YPO_RS10585	16
ABI843_nonUDG	2173086	2173090		YPO_RS10585	4
ABI843_nonUDG	2173365	2173382		YPO_RS10585	17
ABI843_nonUDG	2173555	2173596		YPO_RS10585	41
ABI843_nonUDG	2174596	2174631		YPO_RS10590	35
ABI843_nonUDG	2174667	2174668		YPO_RS10590	1
ABI843_nonUDG	2175692	2175696		YPO_RS10590	4
ABI843_nonUDG	2176252	2176256		YPO_RS10590	4
ABI843_nonUDG	2176634	2176675		YPO_RS10595	41
ABI843_nonUDG	2178302	2178305		YPO_RS10605	3
ABI843_nonUDG	2180808	2180831		YPO_RS10610	23
ABI843_nonUDG	2181059	2181063		YPO_RS10610	4
ABI843_nonUDG	2181353	2181356		YPO_RS10610	3
ABI843_nonUDG	2181865	2181870		YPO_RS10610	5
ABI843_nonUDG	2183678	2183680		YPO_RS10620	2
ABI843_nonUDG	2184150	2184161		YPO_RS10620	11
ABI843_nonUDG	2184757	2184792		YPO_RS10620	35
ABI843_nonUDG	2185187	2185193		YPO_RS10625	6
ABI843_nonUDG	2187174	2187179		YPO_RS10635	5
ABI843_nonUDG	2187797	2187815		YPO_RS10645	18
ABI843_nonUDG	2188039	2188088		YPO_RS10645	49
ABI843_nonUDG	2188225	2188241		YPO_RS10645	16
ABI843_nonUDG	2189006	2189025		YPO_RS10650	19
ABI843_nonUDG	2189999	2190000		YPO_RS10655	1
ABI843_nonUDG	2190089	2190094		YPO_RS10655	5
ABI843_nonUDG	2190373	2190377		YPO_RS10655	4
ABI843_nonUDG	2191520	2191521		YPO_RS10660	1
ABI843_nonUDG	2191763	2191768		YPO_RS10660	5
ABI843_nonUDG	2194850	2194857		ansP	7
ABI843_nonUDG	2195041	2195069		ansP	28
ABI843_nonUDG	2195277	2195291		ansP	14
ABI843_nonUDG	2197103	2197106		YPO_RS10680	3
ABI843_nonUDG	2197437	2197446		YPO_RS10680	9
ABI843_nonUDG	2198690	2198696		glsA	6
ABI843_nonUDG	2199272	2199280		glsA	8
ABI843_nonUDG	2199575	2199584		glsA	9
ABI843_nonUDG	2199929	2199932		YPO_RS10695	3
ABI843_nonUDG	2200533	2200534		YPO_RS10695	1
ABI843_nonUDG	2200745	2200759		YPO_RS10695	14
ABI843_nonUDG	2200899	2200921		YPO_RS10695	22
ABI843_nonUDG	2202067	2202082		YPO_RS10700	15
ABI843_nonUDG	2202691	2202693		YPO_RS10700	2
ABI843_nonUDG	2202871	2202878		YPO_RS10700	7
ABI843_nonUDG	2204380	2204402		YPO_RS10705	22
ABI843_nonUDG	2205268	2205271		YPO_RS10710	3
ABI843_nonUDG	2205824	2205833		YPO_RS10710	9
ABI843_nonUDG	2206176	2206179		YPO_RS10710	3
ABI843_nonUDG	2206720	2206724		YPO_RS10715	4
ABI843_nonUDG	2207567	2207579		YPO_RS10715	12
ABI843_nonUDG	2208433	2208435		YPO_RS10720	2
ABI843_nonUDG	2209479	2209510		YPO_RS10725	31
ABI843_nonUDG	2211024	2211032		tehB	8
ABI843_nonUDG	2213406	2213430		pgaA	24
ABI843_nonUDG	2213811	2213835		pgaA	24
ABI843_nonUDG	2214837	2214846		pgaA	9
ABI843_nonUDG	2215785	2215791		pgaA	6
ABI843_nonUDG	2216684	2216714		pgaB	30
ABI843_nonUDG	2217113	2217120		pgaB	7
ABI843_nonUDG	2217889	2217894		pgaB	5
ABI843_nonUDG	2218228	2218230		YPO_RS10760	2
ABI843_nonUDG	2218914	2218938		YPO_RS10760	24
ABI843_nonUDG	2220288	2220293		YPO_RS10770	5
ABI843_nonUDG	2220486	2220508		YPO_RS10770	22
ABI843_nonUDG	2220804	2220812		YPO_RS10770	8
ABI843_nonUDG	2221528	2221530		YPO_RS10775	2
ABI843_nonUDG	2222596	2222621		chaA	25
ABI843_nonUDG	2224318	2224327		narX	9
ABI843_nonUDG	2224395	2224404		narX	9
ABI843_nonUDG	2225843	2225866		narX	23
ABI843_nonUDG	2227103	2227113		YPO_RS10800	10
ABI843_nonUDG	2227589	2227603		YPO_RS10800	14
ABI843_nonUDG	2230260	2230270		astA	10
ABI843_nonUDG	2230459	2230550		astA	91
ABI843_nonUDG	2232060	2232069		astD	9
ABI843_nonUDG	2232168	2232169		astD	1
ABI843_nonUDG	2232322	2232335		astB	13
ABI843_nonUDG	2233042	2233043		astB	1
ABI843_nonUDG	2233401	2233440		astB	39
ABI843_nonUDG	2234146	2234155		astE	9
ABI843_nonUDG	2236940	2236955		YPO_RS10835	15
ABI843_nonUDG	2237124	2237131		YPO_RS10835	7
ABI843_nonUDG	2237356	2237375		YPO_RS10835	19
ABI843_nonUDG	2237548	2237565		YPO_RS10840	17
ABI843_nonUDG	2238124	2238149		YPO_RS10840	25
ABI843_nonUDG	2239382	2239406		hutG	24
ABI843_nonUDG	2239882	2239885		YPO_RS10855	3
ABI843_nonUDG	2240158	2240166		YPO_RS10855	8
ABI843_nonUDG	2240984	2240988		hutC	4
ABI843_nonUDG	2241177	2241184		hutC	7
ABI843_nonUDG	2242979	2243010		YPO_RS10865	31
ABI843_nonUDG	2244070	2244073		YPO_RS10875	3
ABI843_nonUDG	2248465	2248467		YPO_RS10885	2
ABI843_nonUDG	2249219	2249243		YPO_RS10890	24
ABI843_nonUDG	2249552	2249560		YPO_RS10895	8
ABI843_nonUDG	2249656	2249678		YPO_RS10895	22
ABI843_nonUDG	2251797	2251810		YPO_RS10900	13
ABI843_nonUDG	2252382	2252386		YPO_RS10905	4
ABI843_nonUDG	2252731	2252738		YPO_RS10905	7
ABI843_nonUDG	2252982	2252993		YPO_RS10910	11
ABI843_nonUDG	2254353	2254372		YPO_RS10915	19
ABI843_nonUDG	2255150	2255158		YPO_RS10920	8
ABI843_nonUDG	2255269	2255289		YPO_RS10920	20
ABI843_nonUDG	2255360	2255361		YPO_RS10920	1
ABI843_nonUDG	2256218	2256226		YPO_RS10925	8
ABI843_nonUDG	2256503	2256504		YPO_RS10925	1
ABI843_nonUDG	2256634	2256639		YPO_RS10925	5
ABI843_nonUDG	2257081	2257096		YPO_RS10925	15
ABI843_nonUDG	2257464	2257467		YPO_RS10930	3
ABI843_nonUDG	2257770	2257772		YPO_RS10930	2
ABI843_nonUDG	2257876	2257882		YPO_RS10930	6
ABI843_nonUDG	2258043	2258075		YPO_RS10930	32
ABI843_nonUDG	2258203	2258208		YPO_RS10930	5
ABI843_nonUDG	2258297	2258298		YPO_RS10930	1
ABI843_nonUDG	2259163	2259196		YPO_RS10935	33
ABI843_nonUDG	2259542	2259579		YPO_RS10935	37
ABI843_nonUDG	2259689	2259709		YPO_RS10935	20
ABI843_nonUDG	2260017	2260018		YPO_RS10935	1
ABI843_nonUDG	2261412	2261428		YPO_RS10940	16
ABI843_nonUDG	2261691	2261704		YPO_RS10940	13
ABI843_nonUDG	2263224	2263229		YPO_RS10940	5
ABI843_nonUDG	2267438	2267441		YPO_RS10970	3
ABI843_nonUDG	2270394	2270411		YPO_RS10980	17
ABI843_nonUDG	2270658	2270661		YPO_RS10980	3
ABI843_nonUDG	2270732	2270831		YPO_RS10980	99
ABI843_nonUDG	2271196	2271201		YPO_RS10985	5
ABI843_nonUDG	2272645	2272652		YPO_RS10995	7
ABI843_nonUDG	2273493	2273499		YPO_RS10995	6
ABI843_nonUDG	2274094	2274112		YPO_RS11000	18
ABI843_nonUDG	2274327	2274346		YPO_RS11000	19
ABI843_nonUDG	2275004	2275011		YPO_RS11005	7
ABI843_nonUDG	2275416	2275445		YPO_RS11005	29
ABI843_nonUDG	2276440	2276443		YPO_RS11010	3
ABI843_nonUDG	2276734	2276784		YPO_RS11015	50
ABI843_nonUDG	2277383	2277384		YPO_RS11015	1
ABI843_nonUDG	2277814	2277816		YPO_RS11020	2
ABI843_nonUDG	2278009	2278026		YPO_RS11020	17
ABI843_nonUDG	2279148	2279169		YPO_RS11025	21
ABI843_nonUDG	2279703	2279705		YPO_RS11025	2
ABI843_nonUDG	2280093	2280108		YPO_RS11030	15
ABI843_nonUDG	2280788	2280801		YPO_RS11035	13
ABI843_nonUDG	2282146	2282166		ychF	20
ABI843_nonUDG	2282318	2282350		ychF	32
ABI843_nonUDG	2282475	2282479		ychF	4
ABI843_nonUDG	2286568	2286607		ispE	39
ABI843_nonUDG	2287127	2287135		lolB	8
ABI843_nonUDG	2287360	2287380		lolB	20
ABI843_nonUDG	2288075	2288083		hemA	8
ABI843_nonUDG	2288959	2288964		hemA	5
ABI843_nonUDG	2290385	2290387		prmC	2
ABI843_nonUDG	2290880	2290893		prmC	13
ABI843_nonUDG	2292777	2292778		kdsA	1
ABI843_nonUDG	2292898	2292900		kdsA	2
ABI843_nonUDG	2292997	2293005		kdsA	8
ABI843_nonUDG	2293864	2293875		YPO_RS11105	11
ABI843_nonUDG	2294081	2294087		YPO_RS11105	6
ABI843_nonUDG	2294205	2294220		YPO_RS11105	15
ABI843_nonUDG	2294757	2294759		YPO_RS11110	2
ABI843_nonUDG	2295357	2295397		YPO_RS11115	40
ABI843_nonUDG	2295506	2295525		YPO_RS11115	19
ABI843_nonUDG	2295571	2295612		YPO_RS11115	41
ABI843_nonUDG	2295691	2295707		YPO_RS11115	16
ABI843_nonUDG	2295707	2295708		YPO_RS11120	1
ABI843_nonUDG	2295829	2295833		YPO_RS11120	4
ABI843_nonUDG	2296008	2296009		YPO_RS11120	1
ABI843_nonUDG	2296055	2296061		YPO_RS11120	6
ABI843_nonUDG	2296122	2296135		YPO_RS11120	13
ABI843_nonUDG	2296324	2296348		YPO_RS11120	24
ABI843_nonUDG	2296394	2296421		YPO_RS11120	27
ABI843_nonUDG	2299567	2299578		YPO_RS11135	11
ABI843_nonUDG	2299982	2299988		YPO_RS11135	6
ABI843_nonUDG	2301063	2301065		YPO_RS11140	2
ABI843_nonUDG	2302354	2302370		YPO_RS11150	16
ABI843_nonUDG	2302497	2302508		YPO_RS11150	11
ABI843_nonUDG	2303025	2303035		YPO_RS11150	10
ABI843_nonUDG	2303249	2303256		YPO_RS11155	7
ABI843_nonUDG	2303895	2303906		YPO_RS11155	11
ABI843_nonUDG	2304076	2304085		YPO_RS11160	9
ABI843_nonUDG	2304267	2304268		YPO_RS11160	1
ABI843_nonUDG	2304372	2304374		YPO_RS11160	2
ABI843_nonUDG	2304465	2304480		YPO_RS11160	15
ABI843_nonUDG	2305881	2305889		YPO_RS11170	8
ABI843_nonUDG	2306009	2306014		YPO_RS11175	5
ABI843_nonUDG	2306245	2306265		YPO_RS11175	20
ABI843_nonUDG	2306894	2306897		YPO_RS11175	3
ABI843_nonUDG	2307736	2307754		YPO_RS11185	18
ABI843_nonUDG	2310992	2311012		mdtH	20
ABI843_nonUDG	2311320	2311321		mdtH	1
ABI843_nonUDG	2311662	2311663		mdtH	1
ABI843_nonUDG	2311957	2311983		rimJ	26
ABI843_nonUDG	2312316	2312318		rimJ	2
ABI843_nonUDG	2312479	2312499		rimJ	20
ABI843_nonUDG	2312615	2312618		YPO_RS11210	3
ABI843_nonUDG	2313461	2313474		YPO_RS11210	13
ABI843_nonUDG	2313860	2313883		YPO_RS11210	23
ABI843_nonUDG	2314522	2314525		murJ	3
ABI843_nonUDG	2317377	2317387		YPO_RS11220	10
ABI843_nonUDG	2317463	2317468		YPO_RS11220	5
ABI843_nonUDG	2318080	2318102		YPO_RS11220	22
ABI843_nonUDG	2318277	2318297		YPO_RS11225	20
ABI843_nonUDG	2318525	2318541		YPO_RS11225	16
ABI843_nonUDG	2318751	2318753		YPO_RS11225	2
ABI843_nonUDG	2318853	2318859		YPO_RS11225	6
ABI843_nonUDG	2319105	2319108		YPO_RS11225	3
ABI843_nonUDG	2319213	2319227		YPO_RS11225	14
ABI843_nonUDG	2319274	2319318		YPO_RS11225	44
ABI843_nonUDG	2319640	2319644		YPO_RS11225	4
ABI843_nonUDG	2319718	2319731		YPO_RS11225	13
ABI843_nonUDG	2320403	2320426		YPO_RS11225	23
ABI843_nonUDG	2320565	2320574		YPO_RS11225	9
ABI843_nonUDG	2320706	2320707		YPO_RS11225	1
ABI843_nonUDG	2320804	2320810		YPO_RS11225	6
ABI843_nonUDG	2321736	2321737		YPO_RS11225	1
ABI843_nonUDG	2322124	2322129		YPO_RS11225	5
ABI843_nonUDG	2322329	2322350		YPO_RS11225	21
ABI843_nonUDG	2323720	2323727		argS	7
ABI843_nonUDG	2323966	2323970		argS	4
ABI843_nonUDG	2324044	2324055		argS	11
ABI843_nonUDG	2325769	2325784		YPO_RS11235	15
ABI843_nonUDG	2327233	2327239		cmoB	6
ABI843_nonUDG	2327311	2327324		cmoB	13
ABI843_nonUDG	2327588	2327595		cmoB	7
ABI843_nonUDG	2329534	2329560		YPO_RS11255	26
ABI843_nonUDG	2334187	2334197		YPO_RS11275	10
ABI843_nonUDG	2334276	2334292		YPO_RS11275	16
ABI843_nonUDG	2336449	2336450		ruvB	1
ABI843_nonUDG	2337709	2337714		znuB	5
ABI843_nonUDG	2338174	2338184		znuB	10
ABI843_nonUDG	2339461	2339476		znuA	15
ABI843_nonUDG	2339993	2340005		znuA	12
ABI843_nonUDG	2340138	2340163		mepM	25
ABI843_nonUDG	2340372	2340378		mepM	6
ABI843_nonUDG	2343157	2343167		pyk	10
ABI843_nonUDG	2343517	2343522		pyk	5
ABI843_nonUDG	2343564	2343588		pyk	24
ABI843_nonUDG	2343996	2344022		pyk	26
ABI843_nonUDG	2350664	2350665		YPO_RS11355	1
ABI843_nonUDG	2351025	2351030		YPO_RS11355	5
ABI843_nonUDG	2353336	2353347		YPO_RS11365	11
ABI843_nonUDG	2354813	2354818		fadD	5
ABI843_nonUDG	2354946	2354997		fadD	51
ABI843_nonUDG	2355159	2355162		fadD	3
ABI843_nonUDG	2355565	2355576		fadD	11
ABI843_nonUDG	2356051	2356059		fadD	8
ABI843_nonUDG	2356455	2356456		rnd	1
ABI843_nonUDG	2357123	2357139		rnd	16
ABI843_nonUDG	2358727	2358728		minD	1
ABI843_nonUDG	2359028	2359035		minC	7
ABI843_nonUDG	2360723	2360776		YPO_RS11405	53
ABI843_nonUDG	2361105	2361110		YPO_RS11405	5
ABI843_nonUDG	2361677	2361685		YPO_RS11405	8
ABI843_nonUDG	2361877	2361901		YPO_RS11410	24
ABI843_nonUDG	2362834	2362849		YPO_RS11415	15
ABI843_nonUDG	2363299	2363307		YPO_RS11420	8
ABI843_nonUDG	2363668	2363674		YPO_RS11420	6
ABI843_nonUDG	2363920	2363950		YPO_RS11420	30
ABI843_nonUDG	2364220	2364236		YPO_RS11420	16
ABI843_nonUDG	2364583	2364595		YPO_RS11425	12
ABI843_nonUDG	2364707	2364713		YPO_RS11425	6
ABI843_nonUDG	2364798	2364810		YPO_RS11425	12
ABI843_nonUDG	2364966	2365019		YPO_RS11425	53
ABI843_nonUDG	2365402	2365505		YPO_RS11430	103
ABI843_nonUDG	2365651	2365675		YPO_RS11430	24
ABI843_nonUDG	2366019	2366034		YPO_RS11430	15
ABI843_nonUDG	2368402	2368427		YPO_RS11450	25
ABI843_nonUDG	2368873	2368875		YPO_RS11455	2
ABI843_nonUDG	2369309	2369315		YPO_RS11460	6
ABI843_nonUDG	2369364	2369369		YPO_RS11465	5
ABI843_nonUDG	2369705	2369709		YPO_RS11465	4
ABI843_nonUDG	2370644	2370648		YPO_RS11475	4
ABI843_nonUDG	2370698	2370712		YPO_RS11475	14
ABI843_nonUDG	2371411	2371418		YPO_RS11485	7
ABI843_nonUDG	2371480	2371488		YPO_RS11485	8
ABI843_nonUDG	2372232	2372246		YPO_RS11490	14
ABI843_nonUDG	2373009	2373018		YPO_RS11495	9
ABI843_nonUDG	2374100	2374102		YPO_RS11500	2
ABI843_nonUDG	2374186	2374204		YPO_RS11500	18
ABI843_nonUDG	2374901	2374905		YPO_RS11505	4
ABI843_nonUDG	2375238	2375241		YPO_RS11510	3
ABI843_nonUDG	2375657	2375663		YPO_RS11510	6
ABI843_nonUDG	2375886	2375889		YPO_RS11515	3
ABI843_nonUDG	2376003	2376007		YPO_RS11515	4
ABI843_nonUDG	2376837	2376845		YPO_RS11515	8
ABI843_nonUDG	2376960	2376968		YPO_RS11520	8
ABI843_nonUDG	2377911	2377915		YPO_RS11520	4
ABI843_nonUDG	2377915	2377928		YPO_RS11525	13
ABI843_nonUDG	2378738	2378751		YPO_RS11530	13
ABI843_nonUDG	2379003	2379013		YPO_RS11530	10
ABI843_nonUDG	2379341	2379364		YPO_RS11535	23
ABI843_nonUDG	2381071	2381100		YPO_RS11540	29
ABI843_nonUDG	2381335	2381374		YPO_RS11545	39
ABI843_nonUDG	2382496	2382497		YPO_RS11545	1
ABI843_nonUDG	2383826	2383827		YPO_RS11565	1
ABI843_nonUDG	2384338	2384348		YPO_RS11570	10
ABI843_nonUDG	2384813	2384814		YPO_RS11575	1
ABI843_nonUDG	2385380	2385392		YPO_RS11575	12
ABI843_nonUDG	2386137	2386139		YPO_RS11585	2
ABI843_nonUDG	2386351	2386364		YPO_RS11590	13
ABI843_nonUDG	2386648	2386652		YPO_RS11590	4
ABI843_nonUDG	2387637	2387642		YPO_RS11590	5
ABI843_nonUDG	2391345	2391378		YPO_RS11605	33
ABI843_nonUDG	2391908	2391936		YPO_RS11610	28
ABI843_nonUDG	2392820	2392822		YPO_RS11615	2
ABI843_nonUDG	2393440	2393471		YPO_RS11620	31
ABI843_nonUDG	2394442	2394457		YPO_RS11630	15
ABI843_nonUDG	2394733	2394749		YPO_RS11630	16
ABI843_nonUDG	2394850	2394857		YPO_RS11630	7
ABI843_nonUDG	2394914	2394916		YPO_RS11630	2
ABI843_nonUDG	2395055	2395073		YPO_RS11630	18
ABI843_nonUDG	2395418	2395434		YPO_RS11635	16
ABI843_nonUDG	2395773	2395780		YPO_RS11635	7
ABI843_nonUDG	2396578	2396582		YPO_RS11645	4
ABI843_nonUDG	2396760	2396762		YPO_RS11645	2
ABI843_nonUDG	2397029	2397058		YPO_RS11650	29
ABI843_nonUDG	2397683	2397697		YPO_RS11660	14
ABI843_nonUDG	2398254	2398308		YPO_RS11660	54
ABI843_nonUDG	2398468	2398500		YPO_RS11660	32
ABI843_nonUDG	2399232	2399256		YPO_RS11660	24
ABI843_nonUDG	2399694	2399697		YPO_RS11660	3
ABI843_nonUDG	2399764	2399772		YPO_RS11660	8
ABI843_nonUDG	2400248	2400252		YPO_RS11660	4
ABI843_nonUDG	2400728	2400732		YPO_RS11665	4
ABI843_nonUDG	2400916	2400917		YPO_RS11665	1
ABI843_nonUDG	2401622	2401629		YPO_RS11665	7
ABI843_nonUDG	2401790	2401791		YPO_RS11670	1
ABI843_nonUDG	2402721	2402730		YPO_RS11675	9
ABI843_nonUDG	2403351	2403383		YPO_RS11680	32
ABI843_nonUDG	2403739	2403768		YPO_RS11680	29
ABI843_nonUDG	2403873	2403879		YPO_RS11680	6
ABI843_nonUDG	2404913	2404923		YPO_RS11685	10
ABI843_nonUDG	2405142	2405164		YPO_RS11685	22
ABI843_nonUDG	2409342	2409377		YPO_RS11700	35
ABI843_nonUDG	2410132	2410146		dsbB	14
ABI843_nonUDG	2410568	2410571		nhaB	3
ABI843_nonUDG	2410707	2410709		nhaB	2
ABI843_nonUDG	2411484	2411493		nhaB	9
ABI843_nonUDG	2414352	2414382		YPO_RS11720	30
ABI843_nonUDG	2414634	2414648		YPO_RS11720	14
ABI843_nonUDG	2414692	2414715		YPO_RS11720	23
ABI843_nonUDG	2416015	2416031		YPO_RS11725	16
ABI843_nonUDG	2416246	2416248		YPO_RS11725	2
ABI843_nonUDG	2417174	2417189		YPO_RS11730	15
ABI843_nonUDG	2417743	2417778		YPO_RS11730	35
ABI843_nonUDG	2418261	2418279		YPO_RS11735	18
ABI843_nonUDG	2419352	2419357		YPO_RS11740	5
ABI843_nonUDG	2419695	2419713		YPO_RS11740	18
ABI843_nonUDG	2419857	2419883		YPO_RS11740	26
ABI843_nonUDG	2419985	2419990		YPO_RS11740	5
ABI843_nonUDG	2420300	2420355		YPO_RS11745	55
ABI843_nonUDG	2420632	2420643		YPO_RS11745	11
ABI843_nonUDG	2420936	2420966		YPO_RS11745	30
ABI843_nonUDG	2421821	2421836		YPO_RS11750	15
ABI843_nonUDG	2424135	2424141		yeaG	6
ABI843_nonUDG	2425830	2425852		YPO_RS11760	22
ABI843_nonUDG	2426216	2426225		YPO_RS11765	9
ABI843_nonUDG	2427762	2427772		gapA	10
ABI843_nonUDG	2427949	2427958		gapA	9
ABI843_nonUDG	2428015	2428023		gapA	8
ABI843_nonUDG	2428603	2428620		msrB	17
ABI843_nonUDG	2428720	2428749		msrB	29
ABI843_nonUDG	2429161	2429162		YPO_RS11780	1
ABI843_nonUDG	2430214	2430216		ansA	2
ABI843_nonUDG	2430330	2430332		ansA	2
ABI843_nonUDG	2430567	2430579		ansA	12
ABI843_nonUDG	2431500	2431510		sppA	10
ABI843_nonUDG	2431692	2431716		sppA	24
ABI843_nonUDG	2432232	2432238		sppA	6
ABI843_nonUDG	2436709	2436717		YPO_RS11810	8
ABI843_nonUDG	2436944	2436954		YPO_RS11810	10
ABI843_nonUDG	2440023	2440036		YPO_RS11830	13
ABI843_nonUDG	2440217	2440219		YPO_RS11830	2
ABI843_nonUDG	2440617	2440625		YPO_RS11840	8
ABI843_nonUDG	2440714	2440715		YPO_RS11840	1
ABI843_nonUDG	2441611	2441627		YPO_RS11850	16
ABI843_nonUDG	2441675	2441676		YPO_RS11850	1
ABI843_nonUDG	2442374	2442387		purU	13
ABI843_nonUDG	2442435	2442473		purU	38
ABI843_nonUDG	2445737	2445769		rssB	32
ABI843_nonUDG	2446011	2446025		rssB	14
ABI843_nonUDG	2446606	2446637		YPO_RS11870	31
ABI843_nonUDG	2446678	2446686		YPO_RS11870	8
ABI843_nonUDG	2448293	2448294		hns	1
ABI843_nonUDG	2450691	2450717		YPO_RS11885	26
ABI843_nonUDG	2451095	2451101		YPO_RS11890	6
ABI843_nonUDG	2451158	2451198		YPO_RS11890	40
ABI843_nonUDG	2451344	2451349		YPO_RS11890	5
ABI843_nonUDG	2451563	2451565		YPO_RS11890	2
ABI843_nonUDG	2451666	2451681		YPO_RS11890	15
ABI843_nonUDG	2453282	2453283		adhE	1
ABI843_nonUDG	2454940	2454942		adhE	2
ABI843_nonUDG	2458952	2458963		oppA	11
ABI843_nonUDG	2459163	2459190		oppA	27
ABI843_nonUDG	2459462	2459464		oppB	2
ABI843_nonUDG	2460203	2460213		oppB	10
ABI843_nonUDG	2461813	2461815		YPO_RS11920	2
ABI843_nonUDG	2462172	2462196		YPO_RS11925	24
ABI843_nonUDG	2462303	2462315		YPO_RS11925	12
ABI843_nonUDG	2465100	2465115		cls	15
ABI843_nonUDG	2468222	2468228		YPO_RS11955	6
ABI843_nonUDG	2468388	2468392		YPO_RS11960	4
ABI843_nonUDG	2469991	2470003		tonB	12
ABI843_nonUDG	2470299	2470307		YPO_RS11975	8
ABI843_nonUDG	2470413	2470425		YPO_RS11975	12
ABI843_nonUDG	2470743	2470744		YPO_RS11975	1
ABI843_nonUDG	2471258	2471270		YPO_RS11975	12
ABI843_nonUDG	2471330	2471348		YPO_RS11975	18
ABI843_nonUDG	2471802	2471803		yciA	1
ABI843_nonUDG	2471889	2471900		yciA	11
ABI843_nonUDG	2472459	2472468		YPO_RS11985	9
ABI843_nonUDG	2473389	2473394		YPO_RS11990	5
ABI843_nonUDG	2473460	2473466		YPO_RS11990	6
ABI843_nonUDG	2473728	2473731		YPO_RS11990	3
ABI843_nonUDG	2474180	2474211		YPO_RS11995	31
ABI843_nonUDG	2474828	2474842		YPO_RS12000	14
ABI843_nonUDG	2475062	2475085		YPO_RS12000	23
ABI843_nonUDG	2475259	2475269		YPO_RS12000	10
ABI843_nonUDG	2475477	2475490		YPO_RS12000	13
ABI843_nonUDG	2475856	2475867		YPO_RS12005	11
ABI843_nonUDG	2476030	2476034		ompW	4
ABI843_nonUDG	2478087	2478094		trpA	7
ABI843_nonUDG	2478482	2478484		trpB	2
ABI843_nonUDG	2478879	2478887		trpB	8
ABI843_nonUDG	2480423	2480449		trpCF	26
ABI843_nonUDG	2481726	2481741		trpD	15
ABI843_nonUDG	2482264	2482276		YPO_RS12040	12
ABI843_nonUDG	2482391	2482417		YPO_RS12040	26
ABI843_nonUDG	2483757	2483779		YPO_RS12045	22
ABI843_nonUDG	2484137	2484154		YPO_RS12045	17
ABI843_nonUDG	2484919	2484931		YPO_RS12055	12
ABI843_nonUDG	2485803	2485815		YPO_RS12060	12
ABI843_nonUDG	2486121	2486140		YPO_RS12060	19
ABI843_nonUDG	2488054	2488057		cobO	3
ABI843_nonUDG	2488450	2488459		YPO_RS12075	9
ABI843_nonUDG	2488611	2488626		YPO_RS12075	15
ABI843_nonUDG	2490166	2490181		sohB	15
ABI843_nonUDG	2491248	2491263		topA	15
ABI843_nonUDG	2491576	2491585		topA	9
ABI843_nonUDG	2491700	2491706		topA	6
ABI843_nonUDG	2492151	2492171		topA	20
ABI843_nonUDG	2494068	2494100		cysB	32
ABI843_nonUDG	2495347	2495362		YPO_RS12105	15
ABI843_nonUDG	2495727	2495736		YPO_RS12105	9
ABI843_nonUDG	2495927	2495971		YPO_RS12105	44
ABI843_nonUDG	2496183	2496197		YPO_RS12105	14
ABI843_nonUDG	2497202	2497229		acnA	27
ABI843_nonUDG	2499071	2499072		acnA	1
ABI843_nonUDG	2500591	2500592		pgpB	1
ABI843_nonUDG	2503319	2503337		YPO_RS12135	18
ABI843_nonUDG	2504166	2504215		pyrF	49
ABI843_nonUDG	2504432	2504450		pyrF	18
ABI843_nonUDG	2505158	2505159		osmB	1
ABI843_nonUDG	2506166	2506201		araD	35
ABI843_nonUDG	2507432	2507436		fsa	4
ABI843_nonUDG	2508089	2508102		YPO_RS12170	13
ABI843_nonUDG	2508633	2508635		YPO_RS12175	2
ABI843_nonUDG	2508790	2508800		YPO_RS12175	10
ABI843_nonUDG	2509382	2509390		YPO_RS12175	8
ABI843_nonUDG	2509430	2509432		YPO_RS12175	2
ABI843_nonUDG	2509960	2509964		YPO_RS12175	4
ABI843_nonUDG	2510212	2510224		YPO_RS12175	12
ABI843_nonUDG	2510899	2510901		YPO_RS12180	2
ABI843_nonUDG	2511217	2511230		YPO_RS12180	13
ABI843_nonUDG	2513509	2513511		YPO_RS12185	2
ABI843_nonUDG	2513688	2513696		YPO_RS12185	8
ABI843_nonUDG	2514536	2514544		YPO_RS12190	8
ABI843_nonUDG	2514599	2514619		YPO_RS12190	20
ABI843_nonUDG	2514682	2514721		YPO_RS12190	39
ABI843_nonUDG	2514987	2514989		YPO_RS12190	2
ABI843_nonUDG	2515903	2515911		nth	8
ABI843_nonUDG	2516118	2516119		nth	1
ABI843_nonUDG	2516748	2516749		YPO_RS12200	1
ABI843_nonUDG	2516977	2516988		YPO_RS12200	11
ABI843_nonUDG	2517897	2517925		rsxD	28
ABI843_nonUDG	2517997	2518008		rsxD	11
ABI843_nonUDG	2519275	2519284		YPO_RS12215	9
ABI843_nonUDG	2520585	2520590		rsxC	5
ABI843_nonUDG	2521116	2521122		rsxC	6
ABI843_nonUDG	2522307	2522309		rsxB	2
ABI843_nonUDG	2522586	2522596		rsxB	10
ABI843_nonUDG	2527613	2527651		YPO_RS12250	38
ABI843_nonUDG	2528090	2528098		YPO_RS12255	8
ABI843_nonUDG	2530634	2530642		araA	8
ABI843_nonUDG	2531604	2531605		araA	1
ABI843_nonUDG	2532399	2532422		YPO_RS12265	23
ABI843_nonUDG	2532556	2532558		YPO_RS12265	2
ABI843_nonUDG	2533325	2533333		YPO_RS12265	8
ABI843_nonUDG	2533437	2533444		YPO_RS12265	7
ABI843_nonUDG	2535130	2535146		YPO_RS12275	16
ABI843_nonUDG	2535308	2535309		YPO_RS12275	1
ABI843_nonUDG	2535550	2535557		YPO_RS12275	7
ABI843_nonUDG	2535620	2535621		YPO_RS12275	1
ABI843_nonUDG	2535712	2535714		YPO_RS12275	2
ABI843_nonUDG	2535877	2535889		YPO_RS12275	12
ABI843_nonUDG	2536882	2536895		YPO_RS12280	13
ABI843_nonUDG	2537382	2537387		YPO_RS12280	5
ABI843_nonUDG	2537991	2538020		araC	29
ABI843_nonUDG	2538155	2538163		araC	8
ABI843_nonUDG	2538885	2538896		YPO_RS12290	11
ABI843_nonUDG	2539059	2539065		YPO_RS12290	6
ABI843_nonUDG	2539362	2539379		YPO_RS12290	17
ABI843_nonUDG	2540995	2541027		YPO_RS12295	32
ABI843_nonUDG	2541489	2541504		YPO_RS12300	15
ABI843_nonUDG	2543000	2543001		YPO_RS12305	1
ABI843_nonUDG	2543238	2543240		YPO_RS12305	2
ABI843_nonUDG	2543454	2543463		YPO_RS12305	9
ABI843_nonUDG	2544010	2544030		manA	20
ABI843_nonUDG	2544150	2544151		manA	1
ABI843_nonUDG	2544886	2544910		manA	24
ABI843_nonUDG	2545900	2545903		fumC	3
ABI843_nonUDG	2547366	2547375		YPO_RS12320	9
ABI843_nonUDG	2548039	2548042		YPO_RS12325	3
ABI843_nonUDG	2548325	2548326		YPO_RS12325	1
ABI843_nonUDG	2549506	2549510		YPO_RS12330	4
ABI843_nonUDG	2549744	2549745		YPO_RS12335	1
ABI843_nonUDG	2550499	2550515		YPO_RS12340	16
ABI843_nonUDG	2552102	2552114		bioD	12
ABI843_nonUDG	2552358	2552382		bioD	24
ABI843_nonUDG	2553866	2553871		clcB	5
ABI843_nonUDG	2554373	2554633		YPO_RS12355	260
ABI843_nonUDG	2554658	2555065		YPO_RS12360	407
ABI843_nonUDG	2555162	2555608		YPO_RS12365	446
ABI843_nonUDG	2555780	2556832		YPO_RS12370	1052
ABI843_nonUDG	2556844	2557161		YPO_RS12375	317
ABI843_nonUDG	2557164	2557415		YPO_RS12380	251
ABI843_nonUDG	2557451	2557684		YPO_RS12385	233
ABI843_nonUDG	2557749	2559461		YPO_RS12390	1712
ABI843_nonUDG	2559474	2559761		YPO_RS12395	287
ABI843_nonUDG	2559765	2560790		YPO_RS12400	1025
ABI843_nonUDG	2560790	2562034		YPO_RS12405	1244
ABI843_nonUDG	2562123	2562371		YPO_RS12410	248
ABI843_nonUDG	2562568	2562765		YPO_RS12415	197
ABI843_nonUDG	2564515	2564523		YPO_RS12425	8
ABI843_nonUDG	2565912	2565915		YPO_RS12435	3
ABI843_nonUDG	2566845	2566851		YPO_RS12440	6
ABI843_nonUDG	2567562	2567581		YPO_RS12440	19
ABI843_nonUDG	2568158	2568166		YPO_RS12445	8
ABI843_nonUDG	2568476	2568488		YPO_RS12445	12
ABI843_nonUDG	2569874	2569881		YPO_RS12450	7
ABI843_nonUDG	2570425	2570441		YPO_RS12450	16
ABI843_nonUDG	2570701	2570721		YPO_RS12450	20
ABI843_nonUDG	2571200	2571202		YPO_RS12450	2
ABI843_nonUDG	2571423	2571429		YPO_RS12455	6
ABI843_nonUDG	2571981	2571996		YPO_RS12455	15
ABI843_nonUDG	2572357	2572363		YPO_RS12455	6
ABI843_nonUDG	2572794	2572839		YPO_RS12455	45
ABI843_nonUDG	2573502	2573511		YPO_RS12455	9
ABI843_nonUDG	2574355	2574366		YPO_RS12460	11
ABI843_nonUDG	2574701	2574705		YPO_RS12460	4
ABI843_nonUDG	2575532	2575539		YPO_RS12460	7
ABI843_nonUDG	2575781	2575795		YPO_RS12460	14
ABI843_nonUDG	2575833	2575837		YPO_RS12460	4
ABI843_nonUDG	2576033	2576038		YPO_RS12460	5
ABI843_nonUDG	2576630	2576640		YPO_RS12460	10
ABI843_nonUDG	2577325	2577348		YPO_RS12465	23
ABI843_nonUDG	2578516	2578528		ilvB	12
ABI843_nonUDG	2579092	2579113		ilvB	21
ABI843_nonUDG	2579260	2579270		ilvB	10
ABI843_nonUDG	2579544	2579550		ilvB	6
ABI843_nonUDG	2580081	2580091		ilvN	10
ABI843_nonUDG	2580214	2580218		ilvN	4
ABI843_nonUDG	2580356	2580369		ilvN	13
ABI843_nonUDG	2580504	2580515		yjjG	11
ABI843_nonUDG	2581747	2581766		YPO_RS12490	19
ABI843_nonUDG	2581854	2581893		YPO_RS12490	39
ABI843_nonUDG	2582005	2582019		YPO_RS12490	14
ABI843_nonUDG	2582341	2582344		YPO_RS12490	3
ABI843_nonUDG	2584737	2584748		phoA	11
ABI843_nonUDG	2586355	2586367		ogt	12
ABI843_nonUDG	2587046	2587049		YPO_RS12510	3
ABI843_nonUDG	2587848	2587857		uspE	9
ABI843_nonUDG	2588717	2588723		pntB	6
ABI843_nonUDG	2588855	2588895		pntB	40
ABI843_nonUDG	2589267	2589268		pntB	1
ABI843_nonUDG	2590598	2590599		pntA	1
ABI843_nonUDG	2592332	2592355		YPO_RS12530	23
ABI843_nonUDG	2593945	2593958		YPO_RS12535	13
ABI843_nonUDG	2594599	2594617		YPO_RS12535	18
ABI843_nonUDG	2595539	2595548		rstA	9
ABI843_nonUDG	2595879	2595882		rstA	3
ABI843_nonUDG	2596062	2596076		rstA	14
ABI843_nonUDG	2596505	2596528		rstB	23
ABI843_nonUDG	2597181	2597188		rstB	7
ABI843_nonUDG	2597219	2597233		rstB	14
ABI843_nonUDG	2597393	2597407		rstB	14
ABI843_nonUDG	2597602	2597612		YPO_RS12555	10
ABI843_nonUDG	2598180	2598184		YPO_RS12555	4
ABI843_nonUDG	2598951	2598981		YPO_RS12555	30
ABI843_nonUDG	2599053	2599054		YPO_RS12555	1
ABI843_nonUDG	2605064	2605083		YPO_RS12580	19
ABI843_nonUDG	2605579	2605592		YPO_RS12580	13
ABI843_nonUDG	2606936	2606939		YPO_RS12590	3
ABI843_nonUDG	2608304	2608314		YPO_RS12600	10
ABI843_nonUDG	2610351	2610359		hrpA	8
ABI843_nonUDG	2613814	2613816		YPO_RS12615	2
ABI843_nonUDG	2615260	2615277		YPO_RS12620	17
ABI843_nonUDG	2615921	2615927		YPO_RS12620	6
ABI843_nonUDG	2616901	2616914		YPO_RS12630	13
ABI843_nonUDG	2617716	2617733		YPO_RS12635	17
ABI843_nonUDG	2618528	2618531		YPO_RS12635	3
ABI843_nonUDG	2618918	2618956		YPO_RS12635	38
ABI843_nonUDG	2619333	2619340		YPO_RS12635	7
ABI843_nonUDG	2619538	2619546		YPO_RS12635	8
ABI843_nonUDG	2620313	2620323		YPO_RS12640	10
ABI843_nonUDG	2621026	2621035		YPO_RS12640	9
ABI843_nonUDG	2621219	2621232		hslJ	13
ABI843_nonUDG	2621312	2621315		hslJ	3
ABI843_nonUDG	2622365	2622368		YPO_RS12655	3
ABI843_nonUDG	2623981	2623985		nifJ	4
ABI843_nonUDG	2629378	2629408		YPO_RS12675	30
ABI843_nonUDG	2629701	2629705		YPO_RS12675	4
ABI843_nonUDG	2630890	2630946		YPO_RS12680	56
ABI843_nonUDG	2631344	2631358		zntB	14
ABI843_nonUDG	2631694	2631695		zntB	1
ABI843_nonUDG	2631864	2631877		zntB	13
ABI843_nonUDG	2632548	2632562		YPO_RS12690	14
ABI843_nonUDG	2632828	2632852		YPO_RS12690	24
ABI843_nonUDG	2633182	2633184		YPO_RS12690	2
ABI843_nonUDG	2633290	2633306		YPO_RS12690	16
ABI843_nonUDG	2633376	2633379		YPO_RS12690	3
ABI843_nonUDG	2633525	2633526		YPO_RS12690	1
ABI843_nonUDG	2633686	2633693		YPO_RS12690	7
ABI843_nonUDG	2634747	2634748		mpaA	1
ABI843_nonUDG	2635942	2635945		ycjG	3
ABI843_nonUDG	2639260	2639267		tyrR	7
ABI843_nonUDG	2639954	2639963		YPO_RS12720	9
ABI843_nonUDG	2640502	2640504		YPO_RS12725	2
ABI843_nonUDG	2640604	2640612		YPO_RS12725	8
ABI843_nonUDG	2640843	2640862		YPO_RS12730	19
ABI843_nonUDG	2640948	2640953		YPO_RS12730	5
ABI843_nonUDG	2641865	2641866		YPO_RS12735	1
ABI843_nonUDG	2642162	2642165		YPO_RS12735	3
ABI843_nonUDG	2642759	2642763		YPO_RS12735	4
ABI843_nonUDG	2647687	2647700		sapA	13
ABI843_nonUDG	2647903	2647913		sapA	10
ABI843_nonUDG	2648329	2648408		sapA	79
ABI843_nonUDG	2648612	2648634		sapA	22
ABI843_nonUDG	2648790	2648794		sapA	4
ABI843_nonUDG	2648871	2648881		sapA	10
ABI843_nonUDG	2649173	2649209		sapB	36
ABI843_nonUDG	2649882	2649886		sapB	4
ABI843_nonUDG	2650037	2650058		sapB	21
ABI843_nonUDG	2650197	2650200		sapC	3
ABI843_nonUDG	2650947	2650950		sapC	3
ABI843_nonUDG	2651425	2651435		sapD	10
ABI843_nonUDG	2651719	2651725		sapD	6
ABI843_nonUDG	2652376	2652384		sapF	8
ABI843_nonUDG	2653467	2653475		YPO_RS12795	8
ABI843_nonUDG	2655188	2655221		dtpA	33
ABI843_nonUDG	2655756	2655765		dtpA	9
ABI843_nonUDG	2657072	2657105		YPO_RS12805	33
ABI843_nonUDG	2657361	2657363		YPO_RS12805	2
ABI843_nonUDG	2657881	2657884		YPO_RS12810	3
ABI843_nonUDG	2658100	2658104		YPO_RS12815	4
ABI843_nonUDG	2658379	2658409		YPO_RS12815	30
ABI843_nonUDG	2658738	2658749		YPO_RS12815	11
ABI843_nonUDG	2658798	2658799		YPO_RS12815	1
ABI843_nonUDG	2659079	2659081		YPO_RS12820	2
ABI843_nonUDG	2659140	2659151		YPO_RS12820	11
ABI843_nonUDG	2659196	2659215		YPO_RS12820	19
ABI843_nonUDG	2659465	2659509		YPO_RS12820	44
ABI843_nonUDG	2660396	2660402		gstA	6
ABI843_nonUDG	2662432	2662441		tyrS	9
ABI843_nonUDG	2663739	2663748		pdxH	9
ABI843_nonUDG	2664101	2664118		YPO_RS12845	17
ABI843_nonUDG	2664308	2664309		YPO_RS12845	1
ABI843_nonUDG	2664395	2664405		anmK	10
ABI843_nonUDG	2665350	2665355		anmK	5
ABI843_nonUDG	2665395	2665421		anmK	26
ABI843_nonUDG	2666274	2666301		YPO_RS12855	27
ABI843_nonUDG	2668651	2668658		YPO_RS12865	7
ABI843_nonUDG	2669115	2669124		YPO_RS12870	9
ABI843_nonUDG	2669994	2670012		eptA	18
ABI843_nonUDG	2670613	2670620		eptA	7
ABI843_nonUDG	2670890	2670904		eptA	14
ABI843_nonUDG	2671309	2671315		YPO_RS12880	6
ABI843_nonUDG	2673422	2673442		YPO_RS12890	20
ABI843_nonUDG	2673687	2673715		YPO_RS12890	28
ABI843_nonUDG	2673954	2673956		YPO_RS12890	2
ABI843_nonUDG	2675054	2675056		YPO_RS12890	2
ABI843_nonUDG	2675160	2675172		YPO_RS12890	12
ABI843_nonUDG	2675641	2675658		YPO_RS12890	17
ABI843_nonUDG	2675818	2675820		YPO_RS12890	2
ABI843_nonUDG	2678147	2678151		YPO_RS12910	4
ABI843_nonUDG	2680401	2680411		sodB	10
ABI843_nonUDG	2682149	2682153		YPO_RS12935	4
ABI843_nonUDG	2682544	2682555		YPO_RS12935	11
ABI843_nonUDG	2683619	2683652		YPO_RS12940	33
ABI843_nonUDG	2683818	2683820		YPO_RS12940	2
ABI843_nonUDG	2685415	2685420		cfa	5
ABI843_nonUDG	2687160	2687161		YPO_RS12960	1
ABI843_nonUDG	2687464	2687486		YPO_RS12960	22
ABI843_nonUDG	2687741	2687755		YPO_RS12960	14
ABI843_nonUDG	2687949	2687972		YPO_RS12960	23
ABI843_nonUDG	2688240	2688243		YPO_RS12960	3
ABI843_nonUDG	2690524	2690538		pykF	14
ABI843_nonUDG	2691962	2691965		YPO_RS12985	3
ABI843_nonUDG	2692138	2692157		YPO_RS12985	19
ABI843_nonUDG	2692847	2692851		YPO_RS12990	4
ABI843_nonUDG	2692943	2692957		YPO_RS12990	14
ABI843_nonUDG	2693157	2693167		YPO_RS12990	10
ABI843_nonUDG	2693469	2693490		YPO_RS12990	21
ABI843_nonUDG	2693981	2693997		YPO_RS12995	16
ABI843_nonUDG	2694106	2694166		YPO_RS12995	60
ABI843_nonUDG	2694556	2694565		YPO_RS12995	9
ABI843_nonUDG	2694619	2694642		YPO_RS13000	23
ABI843_nonUDG	2694970	2694973		YPO_RS13000	3
ABI843_nonUDG	2695036	2695045		YPO_RS13000	9
ABI843_nonUDG	2695211	2695229		YPO_RS13000	18
ABI843_nonUDG	2696320	2696321		sufE	1
ABI843_nonUDG	2696500	2696511		sufS	11
ABI843_nonUDG	2702548	2702551		YPO_RS13035	3
ABI843_nonUDG	2703784	2703805		YPO_RS13040	21
ABI843_nonUDG	2704312	2704316		YPO_RS13040	4
ABI843_nonUDG	2706674	2706686		ydiK	12
ABI843_nonUDG	2707239	2707255		ydiK	16
ABI843_nonUDG	2707519	2707533		ydiK	14
ABI843_nonUDG	2707976	2708030		rprA	54
ABI843_nonUDG	2709944	2709948		ppsA	4
ABI843_nonUDG	2710421	2710422		ppsA	1
ABI843_nonUDG	2712494	2712506		YPO_RS13065	12
ABI843_nonUDG	2714818	2714820		YPO_RS13075	2
ABI843_nonUDG	2715322	2715352		YPO_RS13075	30
ABI843_nonUDG	2715939	2715949		YPO_RS13080	10
ABI843_nonUDG	2716945	2716961		arnF	16
ABI843_nonUDG	2717103	2717106		arnE	3
ABI843_nonUDG	2717294	2717296		arnE	2
ABI843_nonUDG	2717914	2717923		arnT	9
ABI843_nonUDG	2719448	2719461		YPO_RS13105	13
ABI843_nonUDG	2720171	2720195		arnA	24
ABI843_nonUDG	2720509	2720510		arnA	1
ABI843_nonUDG	2720554	2720560		arnA	6
ABI843_nonUDG	2722186	2722189		arnC	3
ABI843_nonUDG	2722846	2722852		arnC	6
ABI843_nonUDG	2722846	2722860		arnB	14
ABI843_nonUDG	2725061	2725063		btuD	2
ABI843_nonUDG	2725341	2725409		YPO_RS13130	68
ABI843_nonUDG	2725591	2725594		YPO_RS13130	3
ABI843_nonUDG	2725780	2725818		btuC	38
ABI843_nonUDG	2726538	2726542		btuC	4
ABI843_nonUDG	2727008	2727021		YPO_RS13140	13
ABI843_nonUDG	2728675	2728686		pheT	11
ABI843_nonUDG	2728841	2728860		pheT	19
ABI843_nonUDG	2729657	2729659		pheT	2
ABI843_nonUDG	2729873	2729878		pheT	5
ABI843_nonUDG	2730032	2730048		pheT	16
ABI843_nonUDG	2730174	2730178		pheT	4
ABI843_nonUDG	2730611	2730627		pheS	16
ABI843_nonUDG	2730993	2730998		pheS	5
ABI843_nonUDG	2732902	2732904		infC	2
ABI843_nonUDG	2733912	2733919		thrS	7
ABI843_nonUDG	2734608	2734611		thrS	3
ABI843_nonUDG	2735085	2735089		thrS	4
ABI843_nonUDG	2737161	2737169		YPO_RS13195	8
ABI843_nonUDG	2737267	2737268		YPO_RS13195	1
ABI843_nonUDG	2739740	2739750		yfeB	10
ABI843_nonUDG	2740958	2740983		yfeC	25
ABI843_nonUDG	2742217	2742223		yfeD	6
ABI843_nonUDG	2746100	2746122		YPO_RS13245	22
ABI843_nonUDG	2746367	2746416		YPO_RS13245	49
ABI843_nonUDG	2746684	2746726		YPO_RS13245	42
ABI843_nonUDG	2747464	2747466		solA	2
ABI843_nonUDG	2748688	2748690		YPO_RS13255	2
ABI843_nonUDG	2749105	2749126		YPO_RS13255	21
ABI843_nonUDG	2749470	2749486		YPO_RS13260	16
ABI843_nonUDG	2751499	2751508		YPO_RS13270	9
ABI843_nonUDG	2751569	2751587		YPO_RS13270	18
ABI843_nonUDG	2753038	2753061		YPO_RS13280	23
ABI843_nonUDG	2754490	2754491		YPO_RS13285	1
ABI843_nonUDG	2755154	2755181		YPO_RS13290	27
ABI843_nonUDG	2755343	2755358		YPO_RS13290	15
ABI843_nonUDG	2756105	2756111		YPO_RS13295	6
ABI843_nonUDG	2756191	2756197		YPO_RS13295	6
ABI843_nonUDG	2756706	2756717		YPO_RS13295	11
ABI843_nonUDG	2757729	2757745		YPO_RS13305	16
ABI843_nonUDG	2758356	2758359		YPO_RS13305	3
ABI843_nonUDG	2759552	2759568		YPO_RS13315	16
ABI843_nonUDG	2759631	2759653		YPO_RS13315	22
ABI843_nonUDG	2760137	2760142		YPO_RS13315	5
ABI843_nonUDG	2760427	2760428		cas6f	1
ABI843_nonUDG	2760947	2760954		csy3	7
ABI843_nonUDG	2761585	2761588		csy3	3
ABI843_nonUDG	2763621	2763629		csy1	8
ABI843_nonUDG	2763979	2763995		csy1	16
ABI843_nonUDG	2765071	2765072		cas3f	1
ABI843_nonUDG	2765196	2765198		cas3f	2
ABI843_nonUDG	2766353	2766365		cas3f	12
ABI843_nonUDG	2767276	2767304		cas3f	28
ABI843_nonUDG	2767526	2767547		cas3f	21
ABI843_nonUDG	2768764	2768789		cas1f	25
ABI843_nonUDG	2770207	2770218		YPO_RS13350	11
ABI843_nonUDG	2770681	2770688		YPO_RS13350	7
ABI843_nonUDG	2770824	2770831		YPO_RS13350	7
ABI843_nonUDG	2771086	2771087		YPO_RS13350	1
ABI843_nonUDG	2771143	2771148		YPO_RS13350	5
ABI843_nonUDG	2772358	2772363		YPO_RS13355	5
ABI843_nonUDG	2772895	2772901		YPO_RS13355	6
ABI843_nonUDG	2774370	2774372		YPO_RS13360	2
ABI843_nonUDG	2775559	2775565		YPO_RS13370	6
ABI843_nonUDG	2775744	2775746		YPO_RS13370	2
ABI843_nonUDG	2776190	2776233		YPO_RS13370	43
ABI843_nonUDG	2783241	2783247		ugpC	6
ABI843_nonUDG	2784229	2784238		YPO_RS13405	9
ABI843_nonUDG	2784363	2784367		YPO_RS13405	4
ABI843_nonUDG	2785331	2785340		YPO_RS13415	9
ABI843_nonUDG	2785520	2785525		YPO_RS13415	5
ABI843_nonUDG	2785600	2785621		YPO_RS13415	21
ABI843_nonUDG	2786299	2786304		YPO_RS13425	5
ABI843_nonUDG	2786821	2786849		YPO_RS13430	28
ABI843_nonUDG	2786940	2786949		YPO_RS13430	9
ABI843_nonUDG	2787032	2787036		YPO_RS13430	4
ABI843_nonUDG	2787254	2787257		YPO_RS13430	3
ABI843_nonUDG	2787643	2787645		YPO_RS13430	2
ABI843_nonUDG	2787895	2787906		YPO_RS13430	11
ABI843_nonUDG	2787974	2788006		YPO_RS13430	32
ABI843_nonUDG	2788720	2788730		YPO_RS13435	10
ABI843_nonUDG	2788924	2788927		YPO_RS13435	3
ABI843_nonUDG	2789163	2789199		YPO_RS13440	36
ABI843_nonUDG	2789357	2789360		YPO_RS13440	3
ABI843_nonUDG	2789706	2789723		YPO_RS13445	17
ABI843_nonUDG	2790067	2790078		YPO_RS13445	11
ABI843_nonUDG	2791166	2791178		cdiA	12
ABI843_nonUDG	2791372	2791382		cdiA	10
ABI843_nonUDG	2791889	2791899		cdiA	10
ABI843_nonUDG	2792056	2792058		cdiA	2
ABI843_nonUDG	2792121	2792133		cdiA	12
ABI843_nonUDG	2792430	2792441		cdiA	11
ABI843_nonUDG	2792510	2792515		cdiA	5
ABI843_nonUDG	2792567	2792573		cdiA	6
ABI843_nonUDG	2792796	2792837		cdiA	41
ABI843_nonUDG	2793126	2793161		cdiA	35
ABI843_nonUDG	2793227	2793231		cdiA	4
ABI843_nonUDG	2794800	2794802		cdiA	2
ABI843_nonUDG	2795483	2795489		cdiA	6
ABI843_nonUDG	2795986	2796004		cdiA	18
ABI843_nonUDG	2797426	2797427		cdiA	1
ABI843_nonUDG	2797540	2797545		cdiA	5
ABI843_nonUDG	2797591	2797592		cdiA	1
ABI843_nonUDG	2798222	2798227		YPO_RS13455	5
ABI843_nonUDG	2800417	2800424		YPO_RS13460	7
ABI843_nonUDG	2800577	2800593		YPO_RS13460	16
ABI843_nonUDG	2800884	2800885		YPO_RS13460	1
ABI843_nonUDG	2801315	2801358		YPO_RS13465	43
ABI843_nonUDG	2802071	2802076		YPO_RS13465	5
ABI843_nonUDG	2802789	2802801		YPO_RS13470	12
ABI843_nonUDG	2803455	2803459		YPO_RS13470	4
ABI843_nonUDG	2803848	2803849		YPO_RS13470	1
ABI843_nonUDG	2805027	2805033		YPO_RS13475	6
ABI843_nonUDG	2805512	2805516		YPO_RS13475	4
ABI843_nonUDG	2805803	2805813		YPO_RS13475	10
ABI843_nonUDG	2807356	2807380		YPO_RS13485	24
ABI843_nonUDG	2807449	2807452		YPO_RS13485	3
ABI843_nonUDG	2807761	2807762		YPO_RS13485	1
ABI843_nonUDG	2808007	2808052		YPO_RS13485	45
ABI843_nonUDG	2808588	2808597		YPO_RS13490	9
ABI843_nonUDG	2812058	2812068		YPO_RS13505	10
ABI843_nonUDG	2812324	2812327		YPO_RS13505	3
ABI843_nonUDG	2812388	2812391		YPO_RS13505	3
ABI843_nonUDG	2812463	2812478		YPO_RS13505	15
ABI843_nonUDG	2814098	2814101		YPO_RS13510	3
ABI843_nonUDG	2814362	2814366		YPO_RS13510	4
ABI843_nonUDG	2814589	2814621		YPO_RS13515	32
ABI843_nonUDG	2815399	2815428		YPO_RS13520	29
ABI843_nonUDG	2815693	2815712		YPO_RS13520	19
ABI843_nonUDG	2815761	2815763		YPO_RS13520	2
ABI843_nonUDG	2816742	2816743		ompX	1
ABI843_nonUDG	2816946	2816958		ompX	12
ABI843_nonUDG	2817937	2817968		rhtA	31
ABI843_nonUDG	2818389	2818407		rhtA	18
ABI843_nonUDG	2818732	2818736		YPO_RS13535	4
ABI843_nonUDG	2821115	2821137		YPO_RS13550	22
ABI843_nonUDG	2823528	2823540		glnP	12
ABI843_nonUDG	2823758	2823777		glnP	19
ABI843_nonUDG	2823880	2823885		glnP	5
ABI843_nonUDG	2824076	2824078		glnQ	2
ABI843_nonUDG	2824507	2824509		glnQ	2
ABI843_nonUDG	2824992	2825014		YPO_RS13570	22
ABI843_nonUDG	2825905	2825911		YPO_RS13570	6
ABI843_nonUDG	2826179	2826206		YPO_RS13570	27
ABI843_nonUDG	2826671	2826681		YPO_RS13575	10
ABI843_nonUDG	2826747	2826752		YPO_RS13575	5
ABI843_nonUDG	2826861	2826880		YPO_RS13575	19
ABI843_nonUDG	2826926	2826981		YPO_RS13575	55
ABI843_nonUDG	2827185	2827194		YPO_RS13575	9
ABI843_nonUDG	2827275	2827282		YPO_RS13575	7
ABI843_nonUDG	2827460	2827462		YPO_RS13580	2
ABI843_nonUDG	2827565	2827622		YPO_RS13580	57
ABI843_nonUDG	2827771	2827785		YPO_RS13580	14
ABI843_nonUDG	2827934	2827989		YPO_RS13580	55
ABI843_nonUDG	2829345	2829355		rlmF	10
ABI843_nonUDG	2830464	2830470		YPO_RS13595	6
ABI843_nonUDG	2832150	2832151		menE	1
ABI843_nonUDG	2832862	2832898		menE	36
ABI843_nonUDG	2833891	2833894		menC	3
ABI843_nonUDG	2835615	2835619		menH	4
ABI843_nonUDG	2835977	2835987		menD	10
ABI843_nonUDG	2836055	2836071		menD	16
ABI843_nonUDG	2837125	2837144		menD	19
ABI843_nonUDG	2837463	2837465		menD	2
ABI843_nonUDG	2839913	2839916		YPO_RS13635	3
ABI843_nonUDG	2842493	2842513		YPO_RS13645	20
ABI843_nonUDG	2842698	2842708		YPO_RS13645	10
ABI843_nonUDG	2843725	2843746		YPO_RS13645	21
ABI843_nonUDG	2845213	2845216		YPO_RS13655	3
ABI843_nonUDG	2845380	2845418		YPO_RS13655	38
ABI843_nonUDG	2845639	2845656		YPO_RS13655	17
ABI843_nonUDG	2845946	2845954		YPO_RS13655	8
ABI843_nonUDG	2847055	2847057		YPO_RS13660	2
ABI843_nonUDG	2848345	2848353		YPO_RS13665	8
ABI843_nonUDG	2850276	2850304		YPO_RS13670	28
ABI843_nonUDG	2851657	2851674		idnO	17
ABI843_nonUDG	2852014	2852027		idnO	13
ABI843_nonUDG	2852099	2852101		idnO	2
ABI843_nonUDG	2853023	2853042		YPO_RS13685	19
ABI843_nonUDG	2853658	2853680		YPO_RS13690	22
ABI843_nonUDG	2853950	2853962		YPO_RS13690	12
ABI843_nonUDG	2854323	2854381		YPO_RS13690	58
ABI843_nonUDG	2854531	2854534		YPO_RS13690	3
ABI843_nonUDG	2855085	2855089		nuoN	4
ABI843_nonUDG	2855665	2855669		nuoN	4
ABI843_nonUDG	2856275	2856279		nuoN	4
ABI843_nonUDG	2856642	2856678		nuoM	36
ABI843_nonUDG	2857614	2857636		nuoM	22
ABI843_nonUDG	2857932	2857938		nuoM	6
ABI843_nonUDG	2858816	2858839		nuoL	23
ABI843_nonUDG	2859123	2859126		nuoL	3
ABI843_nonUDG	2859284	2859286		nuoL	2
ABI843_nonUDG	2860015	2860033		nuoK	18
ABI843_nonUDG	2860462	2860489		nuoJ	27
ABI843_nonUDG	2861159	2861167		nuoI	8
ABI843_nonUDG	2861606	2861610		nuoH	4
ABI843_nonUDG	2862845	2862861		nuoG	16
ABI843_nonUDG	2863792	2863807		nuoG	15
ABI843_nonUDG	2863958	2863959		nuoG	1
ABI843_nonUDG	2865811	2865816		nuoF	5
ABI843_nonUDG	2866239	2866240		nuoF	1
ABI843_nonUDG	2866611	2866626		nuoE	15
ABI843_nonUDG	2868472	2868485		nuoC	13
ABI843_nonUDG	2868769	2868770		nuoC	1
ABI843_nonUDG	2869210	2869215		YPO_RS13750	5
ABI843_nonUDG	2869591	2869597		YPO_RS13750	6
ABI843_nonUDG	2870063	2870098		YPO_RS13755	35
ABI843_nonUDG	2871105	2871108		lrhA	3
ABI843_nonUDG	2871655	2871678		lrhA	23
ABI843_nonUDG	2876793	2876802		YPO_RS13775	9
ABI843_nonUDG	2877445	2877450		YPO_RS13780	5
ABI843_nonUDG	2877637	2877647		YPO_RS13780	10
ABI843_nonUDG	2878133	2878135		YPO_RS13785	2
ABI843_nonUDG	2878332	2878340		YPO_RS13785	8
ABI843_nonUDG	2878913	2878917		YPO_RS13790	4
ABI843_nonUDG	2879014	2879017		YPO_RS13790	3
ABI843_nonUDG	2880097	2880114		ackA	17
ABI843_nonUDG	2880208	2880212		ackA	4
ABI843_nonUDG	2880481	2880563		ackA	82
ABI843_nonUDG	2880844	2880849		ackA	5
ABI843_nonUDG	2881777	2881791		pta	14
ABI843_nonUDG	2882397	2882438		pta	41
ABI843_nonUDG	2885077	2885100		YPO_RS13810	23
ABI843_nonUDG	2885196	2885224		YPO_RS13810	28
ABI843_nonUDG	2885606	2885634		YPO_RS13815	28
ABI843_nonUDG	2885902	2885904		YPO_RS13820	2
ABI843_nonUDG	2886459	2886474		YPO_RS13820	15
ABI843_nonUDG	2886688	2886694		YPO_RS13820	6
ABI843_nonUDG	2887085	2887086		YPO_RS13825	1
ABI843_nonUDG	2887090	2887091		YPO_RS13825	1
ABI843_nonUDG	2888164	2888165		YPO_RS13830	1
ABI843_nonUDG	2888761	2888779		YPO_RS13830	18
ABI843_nonUDG	2889074	2889091		YPO_RS13830	17
ABI843_nonUDG	2889270	2889275		YPO_RS13830	5
ABI843_nonUDG	2889678	2889685		YPO_RS13830	7
ABI843_nonUDG	2891360	2891368		YPO_RS13830	8
ABI843_nonUDG	2891539	2891584		YPO_RS13830	45
ABI843_nonUDG	2892436	2892442		YPO_RS13830	6
ABI843_nonUDG	2893050	2893051		YPO_RS13830	1
ABI843_nonUDG	2893489	2893525		YPO_RS13830	36
ABI843_nonUDG	2893898	2893910		YPO_RS13830	12
ABI843_nonUDG	2894489	2894490		YPO_RS13835	1
ABI843_nonUDG	2894704	2894724		YPO_RS13835	20
ABI843_nonUDG	2894881	2894885		YPO_RS13835	4
ABI843_nonUDG	2898345	2898357		iolD	12
ABI843_nonUDG	2898416	2898417		iolD	1
ABI843_nonUDG	2898755	2898758		iolD	3
ABI843_nonUDG	2899639	2899648		iolD	9
ABI843_nonUDG	2902178	2902184		YPO_RS13860	6
ABI843_nonUDG	2902934	2902938		YPO_RS13865	4
ABI843_nonUDG	2903576	2903599		YPO_RS13865	23
ABI843_nonUDG	2903689	2903691		YPO_RS13865	2
ABI843_nonUDG	2905185	2905187		YPO_RS13870	2
ABI843_nonUDG	2905710	2905718		YPO_RS13875	8
ABI843_nonUDG	2905759	2905776		YPO_RS13875	17
ABI843_nonUDG	2905878	2905882		YPO_RS13875	4
ABI843_nonUDG	2906046	2906057		YPO_RS13875	11
ABI843_nonUDG	2907265	2907266		iolC	1
ABI843_nonUDG	2909127	2909139		iolE	12
ABI843_nonUDG	2909561	2909563		iolB	2
ABI843_nonUDG	2910957	2911005		YPO_RS13900	48
ABI843_nonUDG	2911413	2911416		YPO_RS13900	3
ABI843_nonUDG	2911586	2911587		YPO_RS13900	1
ABI843_nonUDG	2913559	2913590		YPO_RS13910	31
ABI843_nonUDG	2913608	2913611		YPO_RS13915	3
ABI843_nonUDG	2914506	2914513		YPO_RS13920	7
ABI843_nonUDG	2917937	2917945		crcB	8
ABI843_nonUDG	2918636	2918643		tatA	7
ABI843_nonUDG	2919252	2919253		lipA	1
ABI843_nonUDG	2919627	2919654		lipA	27
ABI843_nonUDG	2919767	2919782		lipA	15
ABI843_nonUDG	2920708	2920724		lipB	16
ABI843_nonUDG	2921213	2921223		YPO_RS13960	10
ABI843_nonUDG	2922801	2922808		dacA	7
ABI843_nonUDG	2923313	2923330		rlpA	17
ABI843_nonUDG	2924101	2924105		rlpA	4
ABI843_nonUDG	2924446	2924456		mrdB	10
ABI843_nonUDG	2924790	2924793		mrdB	3
ABI843_nonUDG	2925223	2925245		mrdB	22
ABI843_nonUDG	2925688	2925689		mrdA	1
ABI843_nonUDG	2926052	2926069		mrdA	17
ABI843_nonUDG	2927390	2927397		mrdA	7
ABI843_nonUDG	2927729	2927753		rlmH	24
ABI843_nonUDG	2928275	2928283		rsfS	8
ABI843_nonUDG	2928748	2928759		nadD	11
ABI843_nonUDG	2928957	2928980		nadD	23
ABI843_nonUDG	2929190	2929195		nadD	5
ABI843_nonUDG	2929755	2929761		holA	6
ABI843_nonUDG	2930184	2930232		holA	48
ABI843_nonUDG	2931101	2931104		leuS	3
ABI843_nonUDG	2931166	2931208		leuS	42
ABI843_nonUDG	2931776	2931779		leuS	3
ABI843_nonUDG	2931930	2931933		leuS	3
ABI843_nonUDG	2933011	2933031		leuS	20
ABI843_nonUDG	2933114	2933118		leuS	4
ABI843_nonUDG	2933756	2933761		YPO_RS14015	5
ABI843_nonUDG	2933981	2933990		YPO_RS14015	9
ABI843_nonUDG	2934565	2934574		YPO_RS14020	9
ABI843_nonUDG	2934711	2934714		YPO_RS14020	3
ABI843_nonUDG	2935028	2935039		YPO_RS14020	11
ABI843_nonUDG	2935342	2935344		gltK	2
ABI843_nonUDG	2935531	2935535		gltK	4
ABI843_nonUDG	2937545	2937566		YPO_RS14035	21
ABI843_nonUDG	2938808	2938814		lnt	6
ABI843_nonUDG	2939369	2939410		lnt	41
ABI843_nonUDG	2940055	2940064		corC	9
ABI843_nonUDG	2940990	2940993		ybeY	3
ABI843_nonUDG	2941196	2941197		ybeY	1
ABI843_nonUDG	2943036	2943073		miaB	37
ABI843_nonUDG	2945515	2945523		ubiF	8
ABI843_nonUDG	2947215	2947226		asnB	11
ABI843_nonUDG	2949675	2949679		YPO_RS14100	4
ABI843_nonUDG	2950117	2950122		YPO_RS14105	5
ABI843_nonUDG	2950254	2950260		YPO_RS14105	6
ABI843_nonUDG	2950516	2950520		YPO_RS14105	4
ABI843_nonUDG	2950704	2950705		YPO_RS14105	1
ABI843_nonUDG	2952456	2952457		nagB	1
ABI843_nonUDG	2952584	2952587		nagB	3
ABI843_nonUDG	2953998	2953999		YPO_RS14120	1
ABI843_nonUDG	2956040	2956044		YPO_RS14125	4
ABI843_nonUDG	2957038	2957041		glnS	3
ABI843_nonUDG	2959239	2959241		YPO_RS14135	2
ABI843_nonUDG	2959335	2959336		YPO_RS14135	1
ABI843_nonUDG	2959714	2959726		YPO_RS14135	12
ABI843_nonUDG	2960037	2960043		YPO_RS14135	6
ABI843_nonUDG	2963674	2963677		fur	3
ABI843_nonUDG	2966657	2966663		ybfF	6
ABI843_nonUDG	2967853	2967866		YPO_RS14170	13
ABI843_nonUDG	2969008	2969021		YPO_RS14185	13
ABI843_nonUDG	2969143	2969157		YPO_RS14185	14
ABI843_nonUDG	2969341	2969355		YPO_RS14185	14
ABI843_nonUDG	2969538	2969539		YPO_RS14185	1
ABI843_nonUDG	2970011	2970083		YPO_RS14190	72
ABI843_nonUDG	2970345	2970347		YPO_RS14190	2
ABI843_nonUDG	2970554	2970566		YPO_RS14190	12
ABI843_nonUDG	2972212	2972230		proX	18
ABI843_nonUDG	2973723	2973727		proW	4
ABI843_nonUDG	2974248	2974249		proV	1
ABI843_nonUDG	2974905	2974960		proV	55
ABI843_nonUDG	2977011	2977015		nrdE	4
ABI843_nonUDG	2977211	2977215		nrdE	4
ABI843_nonUDG	2978227	2978231		nrdE	4
ABI843_nonUDG	2978453	2978463		nrdE	10
ABI843_nonUDG	2978691	2978701		nrdE	10
ABI843_nonUDG	2978864	2978866		nrdE	2
ABI843_nonUDG	2979333	2979336		nrdI	3
ABI843_nonUDG	2982436	2982447		YPO_RS14250	11
ABI843_nonUDG	2983458	2983470		YPO_RS14250	12
ABI843_nonUDG	2986212	2986229		YPO_RS14265	17
ABI843_nonUDG	2986646	2986668		YPO_RS14265	22
ABI843_nonUDG	2986806	2986826		YPO_RS14265	20
ABI843_nonUDG	2987906	2987916		YPO_RS14270	10
ABI843_nonUDG	2989731	2989734		YPO_RS14285	3
ABI843_nonUDG	2989820	2989821		YPO_RS14285	1
ABI843_nonUDG	2992110	2992122		YPO_RS14295	12
ABI843_nonUDG	2993720	2993732		YPO_RS14300	12
ABI843_nonUDG	2994543	2994548		ureE	5
ABI843_nonUDG	2994943	2994984		ureE	41
ABI843_nonUDG	2996215	2996220		ureG	5
ABI843_nonUDG	2997813	2997815		yut	2
ABI843_nonUDG	2997941	2997968		yut	27
ABI843_nonUDG	2998428	2998432		yut	4
ABI843_nonUDG	2998554	2998561		yut	7
ABI843_nonUDG	2999740	2999746		YPO_RS14330	6
ABI843_nonUDG	2999789	2999793		YPO_RS14330	4
ABI843_nonUDG	3000180	3000188		hdeB	8
ABI843_nonUDG	3001191	3001220		kch	29
ABI843_nonUDG	3004227	3004232		YPO_RS14360	5
ABI843_nonUDG	3005011	3005048		chbC	37
ABI843_nonUDG	3007698	3007700		chbG	2
ABI843_nonUDG	3009416	3009420		seqA	4
ABI843_nonUDG	3009582	3009594		seqA	12
ABI843_nonUDG	3010429	3010433		pgm	4
ABI843_nonUDG	3011904	3011929		YPO_RS14400	25
ABI843_nonUDG	3012184	3012220		YPO_RS14405	36
ABI843_nonUDG	3014443	3014445		kdbD	2
ABI843_nonUDG	3014531	3014533		kdbD	2
ABI843_nonUDG	3015200	3015201		kdbD	1
ABI843_nonUDG	3015492	3015495		kdbD	3
ABI843_nonUDG	3016583	3016585		kdpC	2
ABI843_nonUDG	3016682	3016685		kdpC	3
ABI843_nonUDG	3017502	3017506		kdpB	4
ABI843_nonUDG	3018923	3018936		kdpB	13
ABI843_nonUDG	3020087	3020111		kdpA	24
ABI843_nonUDG	3021592	3021595		YPO_RS14445	3
ABI843_nonUDG	3024279	3024294		YPO_RS14460	15
ABI843_nonUDG	3024382	3024386		YPO_RS14460	4
ABI843_nonUDG	3024644	3024666		YPO_RS14460	22
ABI843_nonUDG	3024862	3024895		YPO_RS14460	33
ABI843_nonUDG	3026199	3026220		YPO_RS14470	21
ABI843_nonUDG	3027669	3027671		YPO_RS14480	2
ABI843_nonUDG	3028496	3028500		pxpA	4
ABI843_nonUDG	3028555	3028568		pxpA	13
ABI843_nonUDG	3028838	3028844		pxpA	6
ABI843_nonUDG	3029103	3029111		YPO_RS14490	8
ABI843_nonUDG	3029174	3029181		YPO_RS14490	7
ABI843_nonUDG	3029969	3029990		YPO_RS14495	21
ABI843_nonUDG	3030259	3030265		YPO_RS14495	6
ABI843_nonUDG	3030456	3030464		YPO_RS14495	8
ABI843_nonUDG	3031942	3031944		ung	2
ABI843_nonUDG	3032728	3032750		grcA	22
ABI843_nonUDG	3034580	3034591		YPO_RS14520	11
ABI843_nonUDG	3034713	3034728		YPO_RS14520	15
ABI843_nonUDG	3035173	3035178		srmB	5
ABI843_nonUDG	3035383	3035387		srmB	4
ABI843_nonUDG	3035993	3036004		srmB	11
ABI843_nonUDG	3038345	3038352		nadB	7
ABI843_nonUDG	3038774	3038822		nadB	48
ABI843_nonUDG	3041315	3041316		rseB	1
ABI843_nonUDG	3042284	3042296		YPO_RS14560	12
ABI843_nonUDG	3043571	3043572		lepA	1
ABI843_nonUDG	3045723	3045729		lepB	6
ABI843_nonUDG	3046062	3046065		lepB	3
ABI843_nonUDG	3048653	3048658		recO	5
ABI843_nonUDG	3049092	3049094		YPO_RS14590	2
ABI843_nonUDG	3049152	3049190		YPO_RS14590	38
ABI843_nonUDG	3049486	3049508		YPO_RS14590	22
ABI843_nonUDG	3049696	3049709		YPO_RS14590	13
ABI843_nonUDG	3049757	3049760		YPO_RS14590	3
ABI843_nonUDG	3049952	3049957		YPO_RS14590	5
ABI843_nonUDG	3050354	3050369		YPO_RS14595	15
ABI843_nonUDG	3050511	3050520		YPO_RS14595	9
ABI843_nonUDG	3050667	3050672		YPO_RS14595	5
ABI843_nonUDG	3050729	3050737		YPO_RS14595	8
ABI843_nonUDG	3050878	3050890		tssL	12
ABI843_nonUDG	3051610	3051615		tssL	5
ABI843_nonUDG	3052411	3052417		tssM	6
ABI843_nonUDG	3054023	3054038		tssM	15
ABI843_nonUDG	3055160	3055200		tssM	40
ABI843_nonUDG	3055859	3055870		YPO_RS14610	11
ABI843_nonUDG	3056099	3056100		YPO_RS14610	1
ABI843_nonUDG	3056438	3056441		YPO_RS14610	3
ABI843_nonUDG	3057132	3057142		YPO_RS14610	10
ABI843_nonUDG	3057624	3057631		YPO_RS14610	7
ABI843_nonUDG	3057920	3057952		YPO_RS14610	32
ABI843_nonUDG	3060083	3060093		YPO_RS14625	10
ABI843_nonUDG	3060866	3060867		YPO_RS14630	1
ABI843_nonUDG	3061097	3061099		YPO_RS14630	2
ABI843_nonUDG	3062805	3062812		YPO_RS14645	7
ABI843_nonUDG	3063036	3063044		YPO_RS14645	8
ABI843_nonUDG	3063407	3063410		YPO_RS14645	3
ABI843_nonUDG	3065227	3065271		YPO_RS14655	44
ABI843_nonUDG	3067323	3067366		ccmB	43
ABI843_nonUDG	3067884	3067929		YPO_RS14675	45
ABI843_nonUDG	3068728	3068748		ccmD	20
ABI843_nonUDG	3068885	3068886		ccmE	1
ABI843_nonUDG	3069138	3069160		ccmE	22
ABI843_nonUDG	3070397	3070410		YPO_RS14690	13
ABI843_nonUDG	3070629	3070639		YPO_RS14690	10
ABI843_nonUDG	3070769	3070799		YPO_RS14690	30
ABI843_nonUDG	3071504	3071529		YPO_RS14695	25
ABI843_nonUDG	3071749	3071762		YPO_RS14695	13
ABI843_nonUDG	3071830	3071837		YPO_RS14695	7
ABI843_nonUDG	3072985	3072986		ccmI	1
ABI843_nonUDG	3073763	3073764		mlaA	1
ABI843_nonUDG	3074032	3074058		mlaA	26
ABI843_nonUDG	3076747	3076754		fadI	7
ABI843_nonUDG	3078074	3078079		fadJ	5
ABI843_nonUDG	3078220	3078233		fadJ	13
ABI843_nonUDG	3078706	3078709		fadJ	3
ABI843_nonUDG	3079422	3079427		fadJ	5
ABI843_nonUDG	3080029	3080039		fadJ	10
ABI843_nonUDG	3080087	3080092		fadJ	5
ABI843_nonUDG	3083026	3083041		prmB	15
ABI843_nonUDG	3083233	3083241		prmB	8
ABI843_nonUDG	3084840	3084865		mepA	25
ABI843_nonUDG	3085507	3085513		mepA	6
ABI843_nonUDG	3088179	3088188		mnmC	9
ABI843_nonUDG	3088484	3088489		mnmC	5
ABI843_nonUDG	3089189	3089190		mnmC	1
ABI843_nonUDG	3090757	3090762		fabB	5
ABI843_nonUDG	3091622	3091623		YPO_RS14785	1
ABI843_nonUDG	3094373	3094391		YPO_RS14795	18
ABI843_nonUDG	3095483	3095498		YPO_RS14800	15
ABI843_nonUDG	3097260	3097274		pdxB	14
ABI843_nonUDG	3099299	3099304		YPO_RS14820	5
ABI843_nonUDG	3101697	3101738		YPO_RS14830	41
ABI843_nonUDG	3102244	3102253		accD	9
ABI843_nonUDG	3103275	3103279		folC	4
ABI843_nonUDG	3103698	3103709		folC	11
ABI843_nonUDG	3104488	3104552		folC	64
ABI843_nonUDG	3106770	3106772		purF	2
ABI843_nonUDG	3107109	3107111		purF	2
ABI843_nonUDG	3107470	3107471		purF	1
ABI843_nonUDG	3108064	3108065		YPO_RS14860	1
ABI843_nonUDG	3108256	3108263		YPO_RS14860	7
ABI843_nonUDG	3109605	3109607		hisJ	2
ABI843_nonUDG	3109729	3109746		hisJ	17
ABI843_nonUDG	3110635	3110668		YPO_RS14870	33
ABI843_nonUDG	3110665	3110679		YPO_RS14875	14
ABI843_nonUDG	3110872	3110874		YPO_RS14875	2
ABI843_nonUDG	3112773	3112775		YPO_RS14885	2
ABI843_nonUDG	3113578	3113609		YPO_RS14890	31
ABI843_nonUDG	3114215	3114229		YPO_RS14890	14
ABI843_nonUDG	3114550	3114556		yfcE	6
ABI843_nonUDG	3114645	3114655		yfcE	10
ABI843_nonUDG	3114788	3114802		yfcE	14
ABI843_nonUDG	3114999	3115002		yfcE	3
ABI843_nonUDG	3115290	3115292		yfcD	2
ABI843_nonUDG	3117963	3117990		YPO_RS14910	27
ABI843_nonUDG	3118328	3118335		YPO_RS14910	7
ABI843_nonUDG	3120400	3120401		YPO_RS14920	1
ABI843_nonUDG	3121671	3121684		YPO_RS14925	13
ABI843_nonUDG	3122333	3122348		YPO_RS14930	15
ABI843_nonUDG	3123099	3123115		YPO_RS14935	16
ABI843_nonUDG	3123343	3123360		YPO_RS14940	17
ABI843_nonUDG	3123505	3123507		YPO_RS14940	2
ABI843_nonUDG	3123700	3123701		YPO_RS14940	1
ABI843_nonUDG	3127188	3127189		YPO_RS14960	1
ABI843_nonUDG	3127581	3127584		YPO_RS14965	3
ABI843_nonUDG	3127864	3127872		YPO_RS14965	8
ABI843_nonUDG	3128598	3128607		YPO_RS14975	9
ABI843_nonUDG	3128893	3128929		YPO_RS14975	36
ABI843_nonUDG	3128988	3128989		YPO_RS14975	1
ABI843_nonUDG	3129162	3129163		YPO_RS14975	1
ABI843_nonUDG	3129304	3129307		YPO_RS14975	3
ABI843_nonUDG	3131543	3131551		YPO_RS14980	8
ABI843_nonUDG	3132284	3132289		YPO_RS14980	5
ABI843_nonUDG	3133293	3133301		YPO_RS14990	8
ABI843_nonUDG	3133346	3133349		YPO_RS14990	3
ABI843_nonUDG	3133534	3133551		YPO_RS14990	17
ABI843_nonUDG	3133742	3133744		YPO_RS14990	2
ABI843_nonUDG	3134236	3134246		YPO_RS14990	10
ABI843_nonUDG	3135311	3135322		YPO_RS14990	11
ABI843_nonUDG	3136079	3136095		YPO_RS14995	16
ABI843_nonUDG	3136892	3136905		YPO_RS14995	13
ABI843_nonUDG	3137637	3137647		YPO_RS15000	10
ABI843_nonUDG	3138340	3138348		YPO_RS15000	8
ABI843_nonUDG	3139455	3139466		YPO_RS15005	11
ABI843_nonUDG	3140143	3140144		YPO_RS15010	1
ABI843_nonUDG	3140299	3140302		YPO_RS15010	3
ABI843_nonUDG	3140681	3140682		YPO_RS15015	1
ABI843_nonUDG	3140784	3140789		YPO_RS15015	5
ABI843_nonUDG	3141002	3141033		YPO_RS15015	31
ABI843_nonUDG	3141218	3141254		YPO_RS15015	36
ABI843_nonUDG	3141874	3141889		YPO_RS15020	15
ABI843_nonUDG	3141928	3141953		YPO_RS15020	25
ABI843_nonUDG	3142056	3142063		YPO_RS15020	7
ABI843_nonUDG	3142684	3142697		YPO_RS15025	13
ABI843_nonUDG	3142782	3142793		YPO_RS15025	11
ABI843_nonUDG	3143735	3143736		YPO_RS15035	1
ABI843_nonUDG	3144031	3144037		YPO_RS15035	6
ABI843_nonUDG	3144748	3144751		YPO_RS15035	3
ABI843_nonUDG	3145671	3145677		YPO_RS15040	6
ABI843_nonUDG	3146702	3146712		YPO_RS15045	10
ABI843_nonUDG	3147392	3147435		YPO_RS15050	43
ABI843_nonUDG	3147761	3147772		YPO_RS15050	11
ABI843_nonUDG	3150413	3150434		YPO_RS15075	21
ABI843_nonUDG	3150543	3150552		YPO_RS15075	9
ABI843_nonUDG	3151157	3151171		YPO_RS15080	14
ABI843_nonUDG	3152736	3152737		folD	1
ABI843_nonUDG	3152887	3152899		ybcJ	12
ABI843_nonUDG	3153323	3153332		YPO_RS15105	9
ABI843_nonUDG	3155103	3155112		purM	9
ABI843_nonUDG	3157008	3157035		speG	27
ABI843_nonUDG	3157347	3157350		speG	3
ABI843_nonUDG	3159115	3159128		pstB	13
ABI843_nonUDG	3160958	3160961		pstA	3
ABI843_nonUDG	3161030	3161034		pstA	4
ABI843_nonUDG	3161602	3161612		YPO_RS15145	10
ABI843_nonUDG	3161925	3161958		YPO_RS15145	33
ABI843_nonUDG	3163617	3163642		YPO_RS15145	25
ABI843_nonUDG	3164411	3164414		ppk1	3
ABI843_nonUDG	3165012	3165030		ppk1	18
ABI843_nonUDG	3166470	3166474		ppx	4
ABI843_nonUDG	3168931	3168978		mgtE	47
ABI843_nonUDG	3169345	3169360		mgtE	15
ABI843_nonUDG	3170432	3170439		yegD	7
ABI843_nonUDG	3170966	3170975		yegD	9
ABI843_nonUDG	3172781	3172782		YPO_RS15180	1
ABI843_nonUDG	3173003	3173045		YPO_RS15180	42
ABI843_nonUDG	3173206	3173214		YPO_RS15180	8
ABI843_nonUDG	3173612	3173624		YPO_RS15185	12
ABI843_nonUDG	3173755	3173758		YPO_RS15185	3
ABI843_nonUDG	3173825	3173835		YPO_RS15185	10
ABI843_nonUDG	3174888	3174921		YPO_RS15190	33
ABI843_nonUDG	3175627	3175634		YPO_RS15190	7
ABI843_nonUDG	3176352	3176370		YPO_RS15195	18
ABI843_nonUDG	3176737	3176745		YPO_RS15195	8
ABI843_nonUDG	3177047	3177070		YPO_RS15195	23
ABI843_nonUDG	3178124	3178148		YPO_RS15200	24
ABI843_nonUDG	3178472	3178476		YPO_RS15200	4
ABI843_nonUDG	3179450	3179463		YPO_RS15205	13
ABI843_nonUDG	3179510	3179521		YPO_RS15205	11
ABI843_nonUDG	3179659	3179664		YPO_RS15205	5
ABI843_nonUDG	3180203	3180235		YPO_RS15205	32
ABI843_nonUDG	3182967	3182976		YPO_RS15210	9
ABI843_nonUDG	3183901	3183912		mdtC	11
ABI843_nonUDG	3184275	3184281		mdtC	6
ABI843_nonUDG	3185291	3185294		mdtC	3
ABI843_nonUDG	3185413	3185436		mdtC	23
ABI843_nonUDG	3185478	3185480		mdtC	2
ABI843_nonUDG	3187279	3187292		YPO_RS15220	13
ABI843_nonUDG	3187653	3187668		YPO_RS15220	15
ABI843_nonUDG	3188021	3188027		YPO_RS15220	6
ABI843_nonUDG	3188087	3188096		YPO_RS15220	9
ABI843_nonUDG	3188194	3188206		YPO_RS15220	12
ABI843_nonUDG	3190182	3190185		baeR	3
ABI843_nonUDG	3192408	3192462		YPO_RS15240	54
ABI843_nonUDG	3193396	3193404		yegS	8
ABI843_nonUDG	3193667	3193668		yegS	1
ABI843_nonUDG	3193961	3193981		yegS	20
ABI843_nonUDG	3194830	3194862		YPO_RS15250	32
ABI843_nonUDG	3197737	3197739		YPO_RS15265	2
ABI843_nonUDG	3198046	3198080		YPO_RS15270	34
ABI843_nonUDG	3198119	3198120		YPO_RS15270	1
ABI843_nonUDG	3198157	3198159		YPO_RS15270	2
ABI843_nonUDG	3198224	3198249		YPO_RS15270	25
ABI843_nonUDG	3198261	3198262		YPO_RS15275	1
ABI843_nonUDG	3198921	3198923		YPO_RS15275	2
ABI843_nonUDG	3199156	3199157		YPO_RS15275	1
ABI843_nonUDG	3199308	3199314		YPO_RS15275	6
ABI843_nonUDG	3199974	3199987		YPO_RS15280	13
ABI843_nonUDG	3200083	3200093		YPO_RS15280	10
ABI843_nonUDG	3200220	3200246		YPO_RS15285	26
ABI843_nonUDG	3200395	3200403		YPO_RS15285	8
ABI843_nonUDG	3200569	3200577		YPO_RS15285	8
ABI843_nonUDG	3200908	3200910		YPO_RS15290	2
ABI843_nonUDG	3202256	3202260		YPO_RS15305	4
ABI843_nonUDG	3202371	3202375		YPO_RS15305	4
ABI843_nonUDG	3202667	3202692		YPO_RS15310	25
ABI843_nonUDG	3203659	3203660		guaA	1
ABI843_nonUDG	3204330	3204332		guaA	2
ABI843_nonUDG	3206359	3206380		guaB	21
ABI843_nonUDG	3207274	3207279		xseA	5
ABI843_nonUDG	3207378	3207381		xseA	3
ABI843_nonUDG	3208058	3208062		xseA	4
ABI843_nonUDG	3208505	3208516		YPO_RS15330	11
ABI843_nonUDG	3208941	3208945		YPO_RS15335	4
ABI843_nonUDG	3210739	3210755		der	16
ABI843_nonUDG	3211277	3211291		der	14
ABI843_nonUDG	3212772	3212818		YPO_RS15350	46
ABI843_nonUDG	3213837	3213843		hisS	6
ABI843_nonUDG	3216024	3216026		ispG	2
ABI843_nonUDG	3217512	3217564		pilW	52
ABI843_nonUDG	3218306	3218326		trmG/rlmN	20
ABI843_nonUDG	3218637	3218673		trmG/rlmN	36
ABI843_nonUDG	3221281	3221291		YPO_RS15385	10
ABI843_nonUDG	3221365	3221377		YPO_RS15385	12
ABI843_nonUDG	3221529	3221535		YPO_RS15385	6
ABI843_nonUDG	3222628	3222651		YPO_RS15385	23
ABI843_nonUDG	3223363	3223364		yapA	1
ABI843_nonUDG	3223370	3223373		yapA	3
ABI843_nonUDG	3224030	3224049		yapA	19
ABI843_nonUDG	3224974	3225010		yapA	36
ABI843_nonUDG	3225449	3225450		yapA	1
ABI843_nonUDG	3226146	3226160		yapA	14
ABI843_nonUDG	3227439	3227447		yapA	8
ABI843_nonUDG	3229140	3229141		YPO_RS15395	1
ABI843_nonUDG	3229913	3229924		YPO_RS15395	11
ABI843_nonUDG	3231103	3231108		YPO_RS15395	5
ABI843_nonUDG	3231268	3231273		YPO_RS15395	5
ABI843_nonUDG	3232251	3232272		sseB	21
ABI843_nonUDG	3232973	3232990		sseB	17
ABI843_nonUDG	3234802	3234821		fdx	19
ABI843_nonUDG	3236224	3236232		hscA	8
ABI843_nonUDG	3236832	3236859		hscA	27
ABI843_nonUDG	3238838	3238844		iscU	6
ABI843_nonUDG	3239049	3239075		YPO_RS15450	26
ABI843_nonUDG	3239232	3239244		YPO_RS15450	12
ABI843_nonUDG	3239399	3239445		YPO_RS15450	46
ABI843_nonUDG	3240685	3240689		iscR	4
ABI843_nonUDG	3241917	3241920		suhB	3
ABI843_nonUDG	3244473	3244480		YPO_RS15480	7
ABI843_nonUDG	3244680	3244690		YPO_RS15480	10
ABI843_nonUDG	3244758	3244761		YPO_RS15480	3
ABI843_nonUDG	3245950	3245969		csiE	19
ABI843_nonUDG	3246291	3246292		csiE	1
ABI843_nonUDG	3246449	3246461		csiE	12
ABI843_nonUDG	3247231	3247244		YPO_RS15490	13
ABI843_nonUDG	3248152	3248155		ail	3
ABI843_nonUDG	3248255	3248303		ail	48
ABI843_nonUDG	3249888	3249896		YPO_RS15505	8
ABI843_nonUDG	3251011	3251018		hmpA	7
ABI843_nonUDG	3251705	3251706		hmpA	1
ABI843_nonUDG	3254301	3254308		YPO_RS15525	7
ABI843_nonUDG	3254551	3254558		YPO_RS15525	7
ABI843_nonUDG	3255304	3255308		YPO_RS15525	4
ABI843_nonUDG	3256521	3256539		glrR	18
ABI843_nonUDG	3257715	3257738		qseG	23
ABI843_nonUDG	3258331	3258336		YPO_RS15540	5
ABI843_nonUDG	3258393	3258399		YPO_RS15540	6
ABI843_nonUDG	3258657	3258668		YPO_RS15540	11
ABI843_nonUDG	3259211	3259220		YPO_RS15540	9
ABI843_nonUDG	3262449	3262493		YPO_RS15560	44
ABI843_nonUDG	3262735	3262740		YPO_RS15560	5
ABI843_nonUDG	3263359	3263370		purL	11
ABI843_nonUDG	3264480	3264487		purL	7
ABI843_nonUDG	3265663	3265680		purL	17
ABI843_nonUDG	3265996	3266005		purL	9
ABI843_nonUDG	3266329	3266351		purL	22
ABI843_nonUDG	3266450	3266494		purL	44
ABI843_nonUDG	3266961	3266980		purL	19
ABI843_nonUDG	3267527	3267538		mltF	11
ABI843_nonUDG	3267772	3267775		mltF	3
ABI843_nonUDG	3267973	3268011		mltF	38
ABI843_nonUDG	3268484	3268485		mltF	1
ABI843_nonUDG	3268778	3268809		mltF	31
ABI843_nonUDG	3270224	3270268		yfhb	44
ABI843_nonUDG	3271274	3271314		murQ	40
ABI843_nonUDG	3271775	3271783		YPO_RS15595	8
ABI843_nonUDG	3273016	3273024		YPO_RS15600	8
ABI843_nonUDG	3273192	3273203		YPO_RS15605	11
ABI843_nonUDG	3273399	3273417		YPO_RS15605	18
ABI843_nonUDG	3275243	3275254		YPO_RS15620	11
ABI843_nonUDG	3275432	3275449		YPO_RS15620	17
ABI843_nonUDG	3275541	3275546		YPO_RS15620	5
ABI843_nonUDG	3275597	3275614		YPO_RS15620	17
ABI843_nonUDG	3275677	3275678		YPO_RS15620	1
ABI843_nonUDG	3275849	3275858		YPO_RS15620	9
ABI843_nonUDG	3275942	3275949		YPO_RS15625	7
ABI843_nonUDG	3276047	3276065		YPO_RS15625	18
ABI843_nonUDG	3276214	3276294		YPO_RS15625	80
ABI843_nonUDG	3276325	3276348		YPO_RS15625	23
ABI843_nonUDG	3276450	3276515		YPO_RS15625	65
ABI843_nonUDG	3276658	3276668		YPO_RS15625	10
ABI843_nonUDG	3276783	3276784		YPO_RS15625	1
ABI843_nonUDG	3278088	3278109		tssK	21
ABI843_nonUDG	3278413	3278414		tssK	1
ABI843_nonUDG	3279464	3279470		tssJ	6
ABI843_nonUDG	3279799	3279804		YPO_RS15645	5
ABI843_nonUDG	3279884	3279886		YPO_RS15645	2
ABI843_nonUDG	3280145	3280148		YPO_RS15645	3
ABI843_nonUDG	3280709	3280717		tssC	8
ABI843_nonUDG	3280804	3280832		tssC	28
ABI843_nonUDG	3281337	3281338		tssC	1
ABI843_nonUDG	3281791	3281794		tssC	3
ABI843_nonUDG	3282240	3282249		tssB	9
ABI843_nonUDG	3282536	3282539		tssB	3
ABI843_nonUDG	3282805	3282823		YPO_RS15660	18
ABI843_nonUDG	3283205	3283214		YPO_RS15660	9
ABI843_nonUDG	3283451	3283479		YPO_RS15665	28
ABI843_nonUDG	3284112	3284129		YPO_RS15665	17
ABI843_nonUDG	3284488	3284497		YPO_RS15665	9
ABI843_nonUDG	3284652	3284664		YPO_RS15670	12
ABI843_nonUDG	3284996	3285012		YPO_RS15670	16
ABI843_nonUDG	3285336	3285366		YPO_RS15670	30
ABI843_nonUDG	3285806	3285848		YPO_RS15675	42
ABI843_nonUDG	3286073	3286074		YPO_RS15675	1
ABI843_nonUDG	3286595	3286612		YPO_RS15675	17
ABI843_nonUDG	3286892	3286898		YPO_RS15675	6
ABI843_nonUDG	3287090	3287103		YPO_RS15675	13
ABI843_nonUDG	3287141	3287148		YPO_RS15675	7
ABI843_nonUDG	3287330	3287340		YPO_RS15675	10
ABI843_nonUDG	3288177	3288179		YPO_RS15680	2
ABI843_nonUDG	3288494	3288501		YPO_RS15685	7
ABI843_nonUDG	3288788	3288789		YPO_RS15685	1
ABI843_nonUDG	3289553	3289564		tssH	11
ABI843_nonUDG	3289878	3289896		tssH	18
ABI843_nonUDG	3291077	3291078		tssH	1
ABI843_nonUDG	3291487	3291517		tssH	30
ABI843_nonUDG	3292737	3292747		tssF	10
ABI843_nonUDG	3293348	3293351		tssF	3
ABI843_nonUDG	3294283	3294287		tssF	4
ABI843_nonUDG	3295021	3295022		tssG	1
ABI843_nonUDG	3295305	3295315		tssG	10
ABI843_nonUDG	3296153	3296199		YPO_RS15705	46
ABI843_nonUDG	3296597	3296598		YPO_RS15705	1
ABI843_nonUDG	3297412	3297422		YPO_RS15710	10
ABI843_nonUDG	3298135	3298151		YPO_RS15715	16
ABI843_nonUDG	3299164	3299171		YPO_RS15715	7
ABI843_nonUDG	3299242	3299263		YPO_RS15720	21
ABI843_nonUDG	3299454	3299460		YPO_RS15720	6
ABI843_nonUDG	3301073	3301096		YPO_RS15725	23
ABI843_nonUDG	3301612	3301627		YPO_RS15730	15
ABI843_nonUDG	3306853	3306924		YPO_RS15750	71
ABI843_nonUDG	3306989	3306991		YPO_RS15750	2
ABI843_nonUDG	3307340	3307344		YPO_RS15750	4
ABI843_nonUDG	3307789	3307802		YPO_RS15750	13
ABI843_nonUDG	3308390	3308398		YPO_RS15755	8
ABI843_nonUDG	3309574	3309581		YPO_RS15760	7
ABI843_nonUDG	3309846	3309854		YPO_RS15760	8
ABI843_nonUDG	3310454	3310470		YPO_RS15765	16
ABI843_nonUDG	3310514	3310548		YPO_RS15765	34
ABI843_nonUDG	3310669	3310670		YPO_RS15765	1
ABI843_nonUDG	3310917	3310933		YPO_RS15765	16
ABI843_nonUDG	3311469	3311503		YPO_RS15770	34
ABI843_nonUDG	3311538	3311558		YPO_RS15770	20
ABI843_nonUDG	3311666	3311672		YPO_RS15770	6
ABI843_nonUDG	3314443	3314462		YPO_RS15775	19
ABI843_nonUDG	3315660	3315662		dmsB	2
ABI843_nonUDG	3316063	3316072		YPO_RS15785	9
ABI843_nonUDG	3317536	3317540		YPO_RS15790	4
ABI843_nonUDG	3318711	3318722		YPO_RS15800	11
ABI843_nonUDG	3319177	3319178		YPO_RS15800	1
ABI843_nonUDG	3321624	3321625		YPO_RS15820	1
ABI843_nonUDG	3321822	3321837		YPO_RS15820	15
ABI843_nonUDG	3323020	3323021		alaC	1
ABI843_nonUDG	3324665	3324707		YPO_RS15830	42
ABI843_nonUDG	3325024	3325034		glk	10
ABI843_nonUDG	3326482	3326485		YPO_RS15840	3
ABI843_nonUDG	3326818	3326824		YPO_RS15845	6
ABI843_nonUDG	3327314	3327340		YPO_RS15845	26
ABI843_nonUDG	3328288	3328300		YPO_RS15850	12
ABI843_nonUDG	3329129	3329130		YPO_RS15855	1
ABI843_nonUDG	3329180	3329185		YPO_RS15855	5
ABI843_nonUDG	3329405	3329410		YPO_RS15860	5
ABI843_nonUDG	3330224	3330232		YPO_RS15860	8
ABI843_nonUDG	3330392	3330396		YPO_RS15860	4
ABI843_nonUDG	3330426	3330451		YPO_RS15860	25
ABI843_nonUDG	3330563	3330576		YPO_RS15860	13
ABI843_nonUDG	3332206	3332208		YPO_RS15865	2
ABI843_nonUDG	3334463	3334485		gltX	22
ABI843_nonUDG	3335405	3335425		YPO_RS15905	20
ABI843_nonUDG	3336324	3336328		YPO_RS15920	4
ABI843_nonUDG	3336405	3336447		YPO_RS15920	42
ABI843_nonUDG	3336497	3336505		YPO_RS15920	8
ABI843_nonUDG	3336636	3336646		YPO_RS15920	10
ABI843_nonUDG	3336854	3336856		YPO_RS15920	2
ABI843_nonUDG	3337029	3337047		YPO_RS15925	18
ABI843_nonUDG	3337472	3337474		YPO_RS15930	2
ABI843_nonUDG	3340541	3340564		zipA	23
ABI843_nonUDG	3341347	3341356		cysZ	9
ABI843_nonUDG	3341535	3341540		cysZ	5
ABI843_nonUDG	3343689	3343711		ptsI	22
ABI843_nonUDG	3345197	3345222		ptsI	25
ABI843_nonUDG	3348228	3348245		YPO_RS15980	17
ABI843_nonUDG	3349091	3349116		YPO_RS15985	25
ABI843_nonUDG	3350147	3350148		YPO_RS15985	1
ABI843_nonUDG	3350765	3350771		macB	6
ABI843_nonUDG	3350883	3350893		macB	10
ABI843_nonUDG	3351193	3351200		macB	7
ABI843_nonUDG	3351952	3351957		macB	5
ABI843_nonUDG	3352101	3352107		macB	6
ABI843_nonUDG	3352644	3352647		YPO_RS15995	3
ABI843_nonUDG	3352690	3352697		YPO_RS15995	7
ABI843_nonUDG	3352803	3352831		YPO_RS15995	28
ABI843_nonUDG	3354176	3354185		YPO_RS15995	9
ABI843_nonUDG	3354292	3354300		YPO_RS16000	8
ABI843_nonUDG	3354745	3354761		YPO_RS16000	16
ABI843_nonUDG	3355111	3355132		YPO_RS16000	21
ABI843_nonUDG	3355433	3355435		YPO_RS16000	2
ABI843_nonUDG	3355623	3355634		YPO_RS16000	11
ABI843_nonUDG	3356280	3356286		YPO_RS16010	6
ABI843_nonUDG	3357219	3357221		YPO_RS16015	2
ABI843_nonUDG	3357296	3357302		YPO_RS16015	6
ABI843_nonUDG	3357682	3357718		YPO_RS16020	36
ABI843_nonUDG	3358157	3358167		YPO_RS16020	10
ABI843_nonUDG	3359739	3359752		YPO_RS16025	13
ABI843_nonUDG	3361272	3361278		YPO_RS16030	6
ABI843_nonUDG	3361622	3361659		YPO_RS16030	37
ABI843_nonUDG	3362686	3362693		YPO_RS16035	7
ABI843_nonUDG	3362977	3362984		YPO_RS16035	7
ABI843_nonUDG	3364088	3364113		YPO_RS16040	25
ABI843_nonUDG	3364523	3364572		YPO_RS16040	49
ABI843_nonUDG	3365336	3365339		cysM	3
ABI843_nonUDG	3366469	3366484		cysA	15
ABI843_nonUDG	3367056	3367067		cysA	11
ABI843_nonUDG	3370393	3370398		YPO_RS16070	5
ABI843_nonUDG	3371591	3371596		YPO_RS16070	5
ABI843_nonUDG	3372599	3372604		YPO_RS16075	5
ABI843_nonUDG	3372635	3372644		YPO_RS16075	9
ABI843_nonUDG	3373378	3373396		YPO_RS16080	18
ABI843_nonUDG	3373554	3373570		YPO_RS16080	16
ABI843_nonUDG	3374043	3374045		YPO_RS16085	2
ABI843_nonUDG	3377399	3377404		YPO_RS16100	5
ABI843_nonUDG	3377560	3377591		YPO_RS16100	31
ABI843_nonUDG	3377965	3377978		YPO_RS16100	13
ABI843_nonUDG	3378750	3378778		YPO_RS16105	28
ABI843_nonUDG	3378893	3378896		YPO_RS16105	3
ABI843_nonUDG	3379680	3379701		YPO_RS16110	21
ABI843_nonUDG	3380369	3380371		YPO_RS16115	2
ABI843_nonUDG	3381278	3381291		yapL	13
ABI843_nonUDG	3383698	3383709		YPO_RS16125	11
ABI843_nonUDG	3383818	3383844		YPO_RS16125	26
ABI843_nonUDG	3385503	3385510		hemF	7
ABI843_nonUDG	3387198	3387211		maeB	13
ABI843_nonUDG	3388403	3388406		maeB	3
ABI843_nonUDG	3388708	3388712		maeB	4
ABI843_nonUDG	3390920	3390922		napB	2
ABI843_nonUDG	3391190	3391191		napA	1
ABI843_nonUDG	3391381	3391383		napA	2
ABI843_nonUDG	3391741	3391744		napA	3
ABI843_nonUDG	3392126	3392133		napA	7
ABI843_nonUDG	3392407	3392414		napA	7
ABI843_nonUDG	3393460	3393468		napA	8
ABI843_nonUDG	3395158	3395170		YPO_RS16180	12
ABI843_nonUDG	3395342	3395343		YPO_RS16180	1
ABI843_nonUDG	3396687	3396710		acrD	23
ABI843_nonUDG	3396760	3396775		acrD	15
ABI843_nonUDG	3397494	3397495		acrD	1
ABI843_nonUDG	3397588	3397599		acrD	11
ABI843_nonUDG	3397941	3397968		acrD	27
ABI843_nonUDG	3403165	3403167		YPO_RS16205	2
ABI843_nonUDG	3403418	3403458		YPO_RS16210	40
ABI843_nonUDG	3403590	3403594		YPO_RS16210	4
ABI843_nonUDG	3403852	3403858		YPO_RS16210	6
ABI843_nonUDG	3403909	3403912		YPO_RS16210	3
ABI843_nonUDG	3404143	3404145		YPO_RS16210	2
ABI843_nonUDG	3404629	3404637		YPO_RS16210	8
ABI843_nonUDG	3404687	3404703		YPO_RS16210	16
ABI843_nonUDG	3406250	3406251		YPO_RS16220	1
ABI843_nonUDG	3406803	3406809		YPO_RS16225	6
ABI843_nonUDG	3407192	3407221		YPO_RS16225	29
ABI843_nonUDG	3407326	3407329		YPO_RS16225	3
ABI843_nonUDG	3407493	3407494		YPO_RS16225	1
ABI843_nonUDG	3407636	3407661		YPO_RS16225	25
ABI843_nonUDG	3407707	3407728		YPO_RS16225	21
ABI843_nonUDG	3408079	3408090		YPO_RS16225	11
ABI843_nonUDG	3410987	3411019		dapE	32
ABI843_nonUDG	3411152	3411164		dapE	12
ABI843_nonUDG	3412614	3412635		YPO_RS16255	21
ABI843_nonUDG	3413739	3413743		YPO_RS16260	4
ABI843_nonUDG	3415220	3415229		YPO_RS16265	9
ABI843_nonUDG	3415464	3415468		YPO_RS16265	4
ABI843_nonUDG	3415690	3415697		YPO_RS16270	7
ABI843_nonUDG	3416014	3416025		YPO_RS16270	11
ABI843_nonUDG	3416420	3416438		YPO_RS16270	18
ABI843_nonUDG	3417667	3417703		YPO_RS16280	36
ABI843_nonUDG	3419190	3419194		bamC	4
ABI843_nonUDG	3419376	3419381		dapA	5
ABI843_nonUDG	3420399	3420403		YPO_RS16295	4
ABI843_nonUDG	3421050	3421053		bcp	3
ABI843_nonUDG	3421289	3421294		bcp	5
ABI843_nonUDG	3421352	3421355		bcp	3
ABI843_nonUDG	3423638	3423639		YPO_RS16310	1
ABI843_nonUDG	3423881	3423885		YPO_RS16310	4
ABI843_nonUDG	3424384	3424388		YPO_RS16310	4
ABI843_nonUDG	3427286	3427298		hda	12
ABI843_nonUDG	3427500	3427503		hda	3
ABI843_nonUDG	3427827	3427848		YPO_RS16330	21
ABI843_nonUDG	3428769	3428772		cysS	3
ABI843_nonUDG	3429919	3429932		cysS	13
ABI843_nonUDG	3431360	3431374		YPO_RS16345	14
ABI843_nonUDG	3432675	3432679		purK	4
ABI843_nonUDG	3433451	3433457		YPO_RS16360	6
ABI843_nonUDG	3433566	3433573		YPO_RS16360	7
ABI843_nonUDG	3433705	3433760		YPO_RS16360	55
ABI843_nonUDG	3434074	3434077		YPO_RS16360	3
ABI843_nonUDG	3434379	3434381		YPO_RS16360	2
ABI843_nonUDG	3435135	3435137		YPO_RS16360	2
ABI843_nonUDG	3437801	3437812		YPO_RS16375	11
ABI843_nonUDG	3438169	3438171		YPO_RS16375	2
ABI843_nonUDG	3438876	3438882		YPO_RS16380	6
ABI843_nonUDG	3439400	3439403		YPO_RS16385	3
ABI843_nonUDG	3443202	3443204		copA	2
ABI843_nonUDG	3445568	3445571		YPO_RS16405	3
ABI843_nonUDG	3445969	3445976		ybaK	7
ABI843_nonUDG	3446787	3446807		YPO_RS16415	20
ABI843_nonUDG	3446902	3446905		YPO_RS16415	3
ABI843_nonUDG	3449145	3449175		YPO_RS16425	30
ABI843_nonUDG	3451634	3451637		YPO_RS16430	3
ABI843_nonUDG	3451977	3451986		YPO_RS16430	9
ABI843_nonUDG	3452760	3452764		YPO_RS16435	4
ABI843_nonUDG	3453047	3453053		YPO_RS16435	6
ABI843_nonUDG	3454439	3454440		fepE	1
ABI843_nonUDG	3454917	3454945		fepE	28
ABI843_nonUDG	3455598	3455610		cpsG	12
ABI843_nonUDG	3456249	3456250		cpsG	1
ABI843_nonUDG	3456536	3456546		YPO_RS16450	10
ABI843_nonUDG	3456914	3456928		YPO_RS16450	14
ABI843_nonUDG	3457373	3457410		YPO_RS16455	37
ABI843_nonUDG	3457666	3457667		YPO_RS16455	1
ABI843_nonUDG	3458386	3458403		YPO_RS16455	17
ABI843_nonUDG	3458516	3458517		YPO_RS16455	1
ABI843_nonUDG	3461364	3461377		YPO_RS16470	13
ABI843_nonUDG	3461653	3461661		YPO_RS16470	8
ABI843_nonUDG	3463606	3463615		YPO_RS16480	9
ABI843_nonUDG	3463781	3463793		YPO_RS16480	12
ABI843_nonUDG	3464185	3464205		YPO_RS16480	20
ABI843_nonUDG	3464843	3464873		YPO_RS16485	30
ABI843_nonUDG	3464966	3464971		YPO_RS16485	5
ABI843_nonUDG	3465176	3465182		YPO_RS16485	6
ABI843_nonUDG	3465240	3465244		YPO_RS16485	4
ABI843_nonUDG	3465567	3465570		YPO_RS16490	3
ABI843_nonUDG	3465869	3465882		YPO_RS16490	13
ABI843_nonUDG	3465969	3465975		YPO_RS16490	6
ABI843_nonUDG	3466852	3466864		YPO_RS16490	12
ABI843_nonUDG	3466984	3467004		YPO_RS16495	20
ABI843_nonUDG	3467497	3467498		YPO_RS16495	1
ABI843_nonUDG	3467961	3467962		YPO_RS16495	1
ABI843_nonUDG	3468957	3468977		YPO_RS16500	20
ABI843_nonUDG	3469798	3469804		rfbH	6
ABI843_nonUDG	3469916	3469918		rfbH	2
ABI843_nonUDG	3470982	3470994		rfbG	12
ABI843_nonUDG	3472607	3472615		YPO_RS16520	8
ABI843_nonUDG	3473091	3473095		YPO_RS16520	4
ABI843_nonUDG	3474010	3474015		hemH	5
ABI843_nonUDG	3477335	3477347		htpG	12
ABI843_nonUDG	3478193	3478196		recR	3
ABI843_nonUDG	3479759	3479763		dnaX	4
ABI843_nonUDG	3480919	3480920		dnaX	1
ABI843_nonUDG	3481798	3481810		apt	12
ABI843_nonUDG	3483241	3483248		YPO_RS16560	7
ABI843_nonUDG	3487080	3487087		mscK	7
ABI843_nonUDG	3487323	3487325		mscK	2
ABI843_nonUDG	3488038	3488045		mscK	7
ABI843_nonUDG	3488191	3488219		mscK	28
ABI843_nonUDG	3488457	3488458		mscK	1
ABI843_nonUDG	3490968	3490979		YPO_RS16600	11
ABI843_nonUDG	3491562	3491592		YPO_RS16600	30
ABI843_nonUDG	3491749	3491753		YPO_RS16600	4
ABI843_nonUDG	3492667	3492669		YPO_RS16605	2
ABI843_nonUDG	3493364	3493382		YPO_RS16605	18
ABI843_nonUDG	3493643	3493665		YPO_RS16605	22
ABI843_nonUDG	3493860	3493881		YPO_RS16605	21
ABI843_nonUDG	3494322	3494327		YPO_RS16605	5
ABI843_nonUDG	3494482	3494520		YPO_RS16605	38
ABI843_nonUDG	3494645	3494655		YPO_RS16605	10
ABI843_nonUDG	3495099	3495115		YPO_RS16605	16
ABI843_nonUDG	3495163	3495180		YPO_RS16605	17
ABI843_nonUDG	3497018	3497030		YPO_RS16620	12
ABI843_nonUDG	3500684	3500688		tesB	4
ABI843_nonUDG	3500966	3500971		tesB	5
ABI843_nonUDG	3501554	3501558		amtB	4
ABI843_nonUDG	3502025	3502031		amtB	6
ABI843_nonUDG	3503324	3503353		YPO_RS16665	29
ABI843_nonUDG	3503749	3503752		YPO_RS16665	3
ABI843_nonUDG	3503796	3503817		YPO_RS16665	21
ABI843_nonUDG	3504140	3504141		YPO_RS16665	1
ABI843_nonUDG	3504847	3504848		YPO_RS16665	1
ABI843_nonUDG	3505814	3505815		YPO_RS16670	1
ABI843_nonUDG	3505937	3505939		YPO_RS16670	2
ABI843_nonUDG	3506087	3506110		YPO_RS16670	23
ABI843_nonUDG	3508188	3508199		YPO_RS16680	11
ABI843_nonUDG	3510083	3510084		YPO_RS16690	1
ABI843_nonUDG	3510651	3510654		YPO_RS16690	3
ABI843_nonUDG	3513342	3513357		YPO_RS16705	15
ABI843_nonUDG	3513880	3513884		ppiD	4
ABI843_nonUDG	3514429	3514465		ppiD	36
ABI843_nonUDG	3514637	3514638		ppiD	1
ABI843_nonUDG	3515430	3515435		ppiD	5
ABI843_nonUDG	3515470	3515480		ppiD	10
ABI843_nonUDG	3515671	3515677		ppiD	6
ABI843_nonUDG	3516616	3516620		lon	4
ABI843_nonUDG	3516826	3516832		lon	6
ABI843_nonUDG	3517077	3517097		lon	20
ABI843_nonUDG	3517278	3517290		lon	12
ABI843_nonUDG	3517415	3517428		lon	13
ABI843_nonUDG	3517900	3517902		lon	2
ABI843_nonUDG	3519174	3519198		clpX	24
ABI843_nonUDG	3520588	3520593		clpP	5
ABI843_nonUDG	3520869	3520901		clpP	32
ABI843_nonUDG	3522025	3522026		tig	1
ABI843_nonUDG	3522359	3522371		tig	12
ABI843_nonUDG	3524094	3524096		YPO_RS16745	2
ABI843_nonUDG	3525157	3525174		ampG	17
ABI843_nonUDG	3525859	3525860		ampG	1
ABI843_nonUDG	3526840	3526841		YPO_RS16755	1
ABI843_nonUDG	3526964	3526969		YPO_RS16755	5
ABI843_nonUDG	3527193	3527194		YPO_RS16755	1
ABI843_nonUDG	3528156	3528166		cyoA	10
ABI843_nonUDG	3528783	3528794		cyoB	11
ABI843_nonUDG	3529371	3529402		cyoB	31
ABI843_nonUDG	3529536	3529537		cyoB	1
ABI843_nonUDG	3529663	3529673		cyoB	10
ABI843_nonUDG	3530075	3530097		cyoB	22
ABI843_nonUDG	3530605	3530632		YPO_RS16770	27
ABI843_nonUDG	3530855	3530870		YPO_RS16770	15
ABI843_nonUDG	3531010	3531017		YPO_RS16770	7
ABI843_nonUDG	3533070	3533087		YPO_RS16785	17
ABI843_nonUDG	3535403	3535404		panE	1
ABI843_nonUDG	3535440	3535441		panE	1
ABI843_nonUDG	3535774	3535783		panE	9
ABI843_nonUDG	3535829	3535842		panE	13
ABI843_nonUDG	3536692	3536709		thiI	17
ABI843_nonUDG	3536833	3536834		thiI	1
ABI843_nonUDG	3537211	3537213		thiI	2
ABI843_nonUDG	3537436	3537442		thiI	6
ABI843_nonUDG	3540301	3540312		dxs	11
ABI843_nonUDG	3541168	3541184		dxs	16
ABI843_nonUDG	3541828	3541862		YPO_RS16825	34
ABI843_nonUDG	3542089	3542093		YPO_RS16825	4
ABI843_nonUDG	3542731	3542744		pgpA	13
ABI843_nonUDG	3542885	3542901		pgpA	16
ABI843_nonUDG	3542962	3542965		pgpA	3
ABI843_nonUDG	3543089	3543103		thiL	14
ABI843_nonUDG	3543581	3543603		thiL	22
ABI843_nonUDG	3544328	3544329		nusB	1
ABI843_nonUDG	3544431	3544435		nusB	4
ABI843_nonUDG	3545422	3545456		ribD	34
ABI843_nonUDG	3545993	3545997		ribD	4
ABI843_nonUDG	3546083	3546093		ribD	10
ABI843_nonUDG	3546806	3546822		nrdR	16
ABI843_nonUDG	3548132	3548150		YPO_RS16865	18
ABI843_nonUDG	3548294	3548300		YPO_RS16865	6
ABI843_nonUDG	3548869	3548901		YPO_RS16870	32
ABI843_nonUDG	3549642	3549643		secF	1
ABI843_nonUDG	3549749	3549752		secF	3
ABI843_nonUDG	3550744	3550759		secD	15
ABI843_nonUDG	3551632	3551644		secD	12
ABI843_nonUDG	3551861	3551870		secD	9
ABI843_nonUDG	3552234	3552235		yajC	1
ABI843_nonUDG	3552301	3552304		yajC	3
ABI843_nonUDG	3552427	3552464		yajC	37
ABI843_nonUDG	3552824	3552834		tgt	10
ABI843_nonUDG	3553008	3553011		tgt	3
ABI843_nonUDG	3553320	3553323		tgt	3
ABI843_nonUDG	3553585	3553602		tgt	17
ABI843_nonUDG	3553652	3553672		tgt	20
ABI843_nonUDG	3554430	3554470		queA	40
ABI843_nonUDG	3554553	3554559		queA	6
ABI843_nonUDG	3560285	3560317		YPO_RS16920	32
ABI843_nonUDG	3560316	3560317		YPO_RS16925	1
ABI843_nonUDG	3561355	3561357		malZ	2
ABI843_nonUDG	3561389	3561391		malZ	2
ABI843_nonUDG	3561679	3561682		malZ	3
ABI843_nonUDG	3561722	3561756		malZ	34
ABI843_nonUDG	3562168	3562173		malZ	5
ABI843_nonUDG	3562932	3562962		proY	30
ABI843_nonUDG	3563890	3563932		proY	42
ABI843_nonUDG	3564089	3564092		proY	3
ABI843_nonUDG	3564719	3564738		brnQ	19
ABI843_nonUDG	3565063	3565084		brnQ	21
ABI843_nonUDG	3565558	3565559		brnQ	1
ABI843_nonUDG	3565635	3565641		brnQ	6
ABI843_nonUDG	3567779	3567789		phoR	10
ABI843_nonUDG	3568178	3568182		phoR	4
ABI843_nonUDG	3568221	3568229		phoR	8
ABI843_nonUDG	3568705	3568771		phoB	66
ABI843_nonUDG	3569235	3569260		phoB	25
ABI843_nonUDG	3569762	3569780		sbcD	18
ABI843_nonUDG	3570565	3570569		sbcD	4
ABI843_nonUDG	3570781	3570788		YPO_RS16965	7
ABI843_nonUDG	3571563	3571581		YPO_RS16965	18
ABI843_nonUDG	3571748	3571763		YPO_RS16965	15
ABI843_nonUDG	3572021	3572028		YPO_RS16965	7
ABI843_nonUDG	3572748	3572752		YPO_RS16965	4
ABI843_nonUDG	3572918	3572930		YPO_RS16965	12
ABI843_nonUDG	3574071	3574098		YPO_RS16965	27
ABI843_nonUDG	3574266	3574267		YPO_RS16965	1
ABI843_nonUDG	3574495	3574504		YPO_RS16970	9
ABI843_nonUDG	3574571	3574598		YPO_RS16970	27
ABI843_nonUDG	3574849	3574854		YPO_RS16970	5
ABI843_nonUDG	3574899	3574918		YPO_RS16970	19
ABI843_nonUDG	3574966	3575002		YPO_RS16970	36
ABI843_nonUDG	3575144	3575163		YPO_RS16970	19
ABI843_nonUDG	3575292	3575301		YPO_RS16975	9
ABI843_nonUDG	3575384	3575404		YPO_RS16975	20
ABI843_nonUDG	3575462	3575469		YPO_RS16975	7
ABI843_nonUDG	3575548	3575568		YPO_RS16975	20
ABI843_nonUDG	3575634	3575649		YPO_RS16975	15
ABI843_nonUDG	3575808	3575814		YPO_RS16975	6
ABI843_nonUDG	3575897	3575901		YPO_RS16975	4
ABI843_nonUDG	3577145	3577196		mak	51
ABI843_nonUDG	3577747	3577752		mak	5
ABI843_nonUDG	3577893	3577904		mak	11
ABI843_nonUDG	3579577	3579585		ppnP	8
ABI843_nonUDG	3581054	3581086		YPO_RS17000	32
ABI843_nonUDG	3582249	3582282		YPO_RS17005	33
ABI843_nonUDG	3583249	3583254		YPO_RS17010	5
ABI843_nonUDG	3584865	3584876		proA	11
ABI843_nonUDG	3585138	3585150		proA	12
ABI843_nonUDG	3585441	3585458		proA	17
ABI843_nonUDG	3587657	3587659		frsA	2
ABI843_nonUDG	3588116	3588120		frsA	4
ABI843_nonUDG	3588496	3588509		frsA	13
ABI843_nonUDG	3590039	3590050		YPO_RS17045	11
ABI843_nonUDG	3590378	3590402		YPO_RS17050	24
ABI843_nonUDG	3591062	3591079		YPO_RS17050	17
ABI843_nonUDG	3592579	3592615		YPO_RS17055	36
ABI843_nonUDG	3592664	3592734		YPO_RS17055	70
ABI843_nonUDG	3595248	3595249		pepD	1
ABI843_nonUDG	3596174	3596194		pepD	20
ABI843_nonUDG	3596505	3596507		pepD	2
ABI843_nonUDG	3596601	3596604		pepD	3
ABI843_nonUDG	3599594	3599595		YPO_RS17080	1
ABI843_nonUDG	3599747	3599749		YPO_RS17080	2
ABI843_nonUDG	3600202	3600207		YPO_RS17080	5
ABI843_nonUDG	3600832	3600836		nqrF	4
ABI843_nonUDG	3601161	3601184		nqrF	23
ABI843_nonUDG	3601619	3601620		nqrF	1
ABI843_nonUDG	3601759	3601775		nqrF	16
ABI843_nonUDG	3602568	3602594		YPO_RS17095	26
ABI843_nonUDG	3602989	3602998		YPO_RS17095	9
ABI843_nonUDG	3603253	3603264		YPO_RS17100	11
ABI843_nonUDG	3603471	3603480		YPO_RS17100	9
ABI843_nonUDG	3603881	3603886		YPO_RS17100	5
ABI843_nonUDG	3605005	3605028		YPO_RS17105	23
ABI843_nonUDG	3606444	3606446		YPO_RS17110	2
ABI843_nonUDG	3608910	3608922		lpcA	12
ABI843_nonUDG	3610638	3610643		YPO_RS17130	5
ABI843_nonUDG	3610972	3610980		YPO_RS17130	8
ABI843_nonUDG	3611012	3611013		YPO_RS17130	1
ABI843_nonUDG	3611615	3611642		YPO_RS17130	27
ABI843_nonUDG	3612292	3612303		YPO_RS17135	11
ABI843_nonUDG	3613105	3613117		YPO_RS17140	12
ABI843_nonUDG	3613600	3613620		YPO_RS17140	20
ABI843_nonUDG	3614088	3614092		YPO_RS17140	4
ABI843_nonUDG	3615183	3615207		YPO_RS17145	24
ABI843_nonUDG	3615514	3615543		YPO_RS17145	29
ABI843_nonUDG	3615765	3615772		YPO_RS17145	7
ABI843_nonUDG	3616015	3616021		YPO_RS17145	6
ABI843_nonUDG	3616517	3616520		YPO_RS17145	3
ABI843_nonUDG	3617301	3617306		YPO_RS17145	5
ABI843_nonUDG	3617423	3617439		YPO_RS17145	16
ABI843_nonUDG	3617932	3617939		YPO_RS17145	7
ABI843_nonUDG	3619055	3619078		YPO_RS17145	23
ABI843_nonUDG	3619615	3619635		YPO_RS17145	20
ABI843_nonUDG	3619747	3619752		YPO_RS17145	5
ABI843_nonUDG	3619841	3619844		YPO_RS17145	3
ABI843_nonUDG	3619918	3619920		YPO_RS17145	2
ABI843_nonUDG	3622092	3622093		YPO_RS17150	1
ABI843_nonUDG	3624497	3624498		YPO_RS17160	1
ABI843_nonUDG	3625030	3625032		YPO_RS17165	2
ABI843_nonUDG	3625228	3625274		YPO_RS17165	46
ABI843_nonUDG	3625503	3625509		YPO_RS17170	6
ABI843_nonUDG	3625630	3625638		YPO_RS17170	8
ABI843_nonUDG	3625786	3625792		YPO_RS17170	6
ABI843_nonUDG	3625846	3625951		YPO_RS17170	105
ABI843_nonUDG	3626061	3626065		YPO_RS17170	4
ABI843_nonUDG	3626456	3626537		YPO_RS17175	81
ABI843_nonUDG	3626873	3626877		YPO_RS17175	4
ABI843_nonUDG	3627043	3627045		YPO_RS17175	2
ABI843_nonUDG	3627196	3627230		YPO_RS17180	34
ABI843_nonUDG	3627351	3627355		YPO_RS17180	4
ABI843_nonUDG	3627659	3627662		YPO_RS17180	3
ABI843_nonUDG	3627954	3627976		YPO_RS17180	22
ABI843_nonUDG	3629267	3629276		YPO_RS17190	9
ABI843_nonUDG	3630958	3630960		YPO_RS17200	2
ABI843_nonUDG	3631685	3631694		YPO_RS17205	9
ABI843_nonUDG	3633600	3633606		YPO_RS17215	6
ABI843_nonUDG	3634046	3634065		YPO_RS17215	19
ABI843_nonUDG	3634551	3634561		hpxZ	10
ABI843_nonUDG	3634800	3634808		YPO_RS17225	8
ABI843_nonUDG	3635326	3635328		YPO_RS17225	2
ABI843_nonUDG	3635921	3635923		YPO_RS17225	2
ABI843_nonUDG	3636936	3636996		ygaH	60
ABI843_nonUDG	3638950	3638967		emrA	17
ABI843_nonUDG	3639024	3639046		emrA	22
ABI843_nonUDG	3639882	3639885		emrB	3
ABI843_nonUDG	3640172	3640182		emrB	10
ABI843_nonUDG	3640760	3640792		emrB	32
ABI843_nonUDG	3641306	3641310		YPO_RS17255	4
ABI843_nonUDG	3642131	3642150		YPO_RS17255	19
ABI843_nonUDG	3642181	3642186		YPO_RS17255	5
ABI843_nonUDG	3643390	3643391		YPO_RS17265	1
ABI843_nonUDG	3643731	3643757		YPO_RS17265	26
ABI843_nonUDG	3645056	3645061		YPO_RS17270	5
ABI843_nonUDG	3645454	3645493		YPO_RS17270	39
ABI843_nonUDG	3645623	3645648		YPO_RS17270	25
ABI843_nonUDG	3646248	3646257		YPO_RS17270	9
ABI843_nonUDG	3646525	3646529		YPO_RS17270	4
ABI843_nonUDG	3647232	3647233		pssA	1
ABI843_nonUDG	3647910	3647933		pssA	23
ABI843_nonUDG	3649067	3649068		rrf	1
ABI843_nonUDG	3649925	3649946		YPO_RS17290	21
ABI843_nonUDG	3651241	3651244		YPO_RS17290	3
ABI843_nonUDG	3655125	3655129		clpB	4
ABI843_nonUDG	3655182	3655196		clpB	14
ABI843_nonUDG	3655297	3655306		clpB	9
ABI843_nonUDG	3656321	3656334		clpB	13
ABI843_nonUDG	3658581	3658587		rluD	6
ABI843_nonUDG	3659400	3659404		bamD	4
ABI843_nonUDG	3661020	3661035		YPO_RS17340	15
ABI843_nonUDG	3661133	3661138		YPO_RS17340	5
ABI843_nonUDG	3662245	3662259		pheA	14
ABI843_nonUDG	3662693	3662695		pheA	2
ABI843_nonUDG	3662966	3662990		YPO_RS17350	24
ABI843_nonUDG	3663146	3663159		YPO_RS17350	13
ABI843_nonUDG	3663229	3663241		YPO_RS17350	12
ABI843_nonUDG	3663381	3663387		YPO_RS17350	6
ABI843_nonUDG	3663464	3663497		YPO_RS17350	33
ABI843_nonUDG	3663749	3663767		YPO_RS17350	18
ABI843_nonUDG	3663804	3663807		YPO_RS17355	3
ABI843_nonUDG	3663960	3663973		YPO_RS17355	13
ABI843_nonUDG	3664104	3664112		YPO_RS17355	8
ABI843_nonUDG	3664277	3664288		YPO_RS17355	11
ABI843_nonUDG	3664560	3664561		YPO_RS17355	1
ABI843_nonUDG	3665103	3665106		tyrA	3
ABI843_nonUDG	3665655	3665656		tyrA	1
ABI843_nonUDG	3665751	3665755		tyrA	4
ABI843_nonUDG	3666665	3666671		YPO_RS17370	6
ABI843_nonUDG	3667813	3667821		yehT	8
ABI843_nonUDG	3670771	3670809		YPO_RS17385	38
ABI843_nonUDG	3671301	3671366		YPO_RS17390	65
ABI843_nonUDG	3671418	3671433		YPO_RS17390	15
ABI843_nonUDG	3672950	3672965		trmD	15
ABI843_nonUDG	3674226	3674227		ffh	1
ABI843_nonUDG	3676281	3676298		YPO_RS17420	17
ABI843_nonUDG	3677001	3677016		YPO_RS17425	15
ABI843_nonUDG	3679174	3679179		luxS	5
ABI843_nonUDG	3680043	3680058		gshA	15
ABI843_nonUDG	3680804	3680818		gshA	14
ABI843_nonUDG	3681215	3681219		YPO_RS17445	4
ABI843_nonUDG	3681529	3681538		yqaB	9
ABI843_nonUDG	3681909	3681929		yqaB	20
ABI843_nonUDG	3681964	3681974		yqaB	10
ABI843_nonUDG	3682640	3682655		YPO_RS17465	15
ABI843_nonUDG	3682868	3682875		YPO_RS17475	7
ABI843_nonUDG	3684009	3684023		alaS	14
ABI843_nonUDG	3684584	3684593		alaS	9
ABI843_nonUDG	3685334	3685349		alaS	15
ABI843_nonUDG	3685759	3685760		alaS	1
ABI843_nonUDG	3686581	3686594		recX	13
ABI843_nonUDG	3688118	3688122		recA	4
ABI843_nonUDG	3688761	3688762		pncC	1
ABI843_nonUDG	3689301	3689305		YPO_RS17505	4
ABI843_nonUDG	3692619	3692621		YPO_RS17515	2
ABI843_nonUDG	3693186	3693188		YPO_RS17515	2
ABI843_nonUDG	3693740	3693756		YPO_RS17520	16
ABI843_nonUDG	3693933	3693979		YPO_RS17520	46
ABI843_nonUDG	3694052	3694064		YPO_RS17520	12
ABI843_nonUDG	3694990	3694999		YPO_RS17525	9
ABI843_nonUDG	3695934	3695935		YPO_RS17530	1
ABI843_nonUDG	3696243	3696268		YPO_RS17530	25
ABI843_nonUDG	3697420	3697422		YPO_RS17535	2
ABI843_nonUDG	3697458	3697465		YPO_RS17535	7
ABI843_nonUDG	3697561	3697573		YPO_RS17535	12
ABI843_nonUDG	3697655	3697659		YPO_RS17535	4
ABI843_nonUDG	3698661	3698663		YPO_RS17540	2
ABI843_nonUDG	3698739	3698747		YPO_RS17540	8
ABI843_nonUDG	3700455	3700461		YPO_RS17550	6
ABI843_nonUDG	3702213	3702219		katG	6
ABI843_nonUDG	3704272	3704279		cybC	7
ABI843_nonUDG	3704394	3704397		cybC	3
ABI843_nonUDG	3704735	3704807		cybB	72
ABI843_nonUDG	3704911	3704916		cybB	5
ABI843_nonUDG	3705403	3705420		dmsD	17
ABI843_nonUDG	3705502	3705506		dmsD	4
ABI843_nonUDG	3706224	3706248		YPO_RS17575	24
ABI843_nonUDG	3706607	3706627		YPO_RS17575	20
ABI843_nonUDG	3707008	3707012		YPO_RS17575	4
ABI843_nonUDG	3707057	3707060		YPO_RS17575	3
ABI843_nonUDG	3707062	3707074		dmsB	12
ABI843_nonUDG	3707810	3707812		dmsA	2
ABI843_nonUDG	3708810	3708811		dmsA	1
ABI843_nonUDG	3709611	3709615		dmsA	4
ABI843_nonUDG	3710737	3710751		YPO_RS17590	14
ABI843_nonUDG	3711138	3711157		YPO_RS17590	19
ABI843_nonUDG	3712224	3712230		YPO_RS17595	6
ABI843_nonUDG	3712723	3712733		YPO_RS17595	10
ABI843_nonUDG	3712994	3712995		YPO_RS17600	1
ABI843_nonUDG	3713704	3713708		YPO_RS17600	4
ABI843_nonUDG	3713832	3713842		YPO_RS17600	10
ABI843_nonUDG	3713911	3713913		YPO_RS17600	2
ABI843_nonUDG	3715127	3715128		YPO_RS17610	1
ABI843_nonUDG	3715796	3715813		YPO_RS17610	17
ABI843_nonUDG	3716175	3716187		YPO_RS17610	12
ABI843_nonUDG	3716579	3716583		YPO_RS17615	4
ABI843_nonUDG	3716713	3716725		YPO_RS17615	12
ABI843_nonUDG	3717057	3717089		YPO_RS17615	32
ABI843_nonUDG	3717185	3717194		YPO_RS17615	9
ABI843_nonUDG	3719628	3719653		YPO_RS17630	25
ABI843_nonUDG	3720327	3720369		YPO_RS17630	42
ABI843_nonUDG	3724891	3724894		YPO_RS17650	3
ABI843_nonUDG	3725053	3725074		YPO_RS17650	21
ABI843_nonUDG	3725289	3725293		YPO_RS17650	4
ABI843_nonUDG	3725619	3725634		YPO_RS17650	15
ABI843_nonUDG	3728586	3728592		YPO_RS17660	6
ABI843_nonUDG	3729540	3729541		YPO_RS17665	1
ABI843_nonUDG	3730701	3730709		YPO_RS17670	8
ABI843_nonUDG	3730858	3730868		YPO_RS17670	10
ABI843_nonUDG	3730938	3730950		YPO_RS17670	12
ABI843_nonUDG	3733208	3733218		arsB	10
ABI843_nonUDG	3733492	3733494		arsB	2
ABI843_nonUDG	3734090	3734091		arsB	1
ABI843_nonUDG	3735607	3735612		YPO_RS17695	5
ABI843_nonUDG	3736161	3736176		dhaL	15
ABI843_nonUDG	3736412	3736443		dhaL	31
ABI843_nonUDG	3736491	3736536		dhaL	45
ABI843_nonUDG	3736988	3736993		YPO_RS17705	5
ABI843_nonUDG	3737668	3737673		YPO_RS17710	5
ABI843_nonUDG	3738420	3738423		YPO_RS17710	3
ABI843_nonUDG	3739411	3739419		YPO_RS17715	8
ABI843_nonUDG	3739561	3739565		YPO_RS17715	4
ABI843_nonUDG	3742736	3742754		mutS	18
ABI843_nonUDG	3743120	3743124		mutS	4
ABI843_nonUDG	3744440	3744454		rpoS	14
ABI843_nonUDG	3744575	3744576		rpoS	1
ABI843_nonUDG	3746161	3746180		nlpD	19
ABI843_nonUDG	3747453	3747470		surE	17
ABI843_nonUDG	3748907	3748927		ispF	20
ABI843_nonUDG	3749557	3749588		ispD	31
ABI843_nonUDG	3750974	3750984		YPO_RS17770	10
ABI843_nonUDG	3751943	3751944		cysC	1
ABI843_nonUDG	3751946	3751962		cysN	16
ABI843_nonUDG	3754052	3754072		cysD	20
ABI843_nonUDG	3754791	3754805		cobA	14
ABI843_nonUDG	3756532	3756541		YPO_RS17800	9
ABI843_nonUDG	3759559	3759575		cysI	16
ABI843_nonUDG	3761054	3761059		cysJ	5
ABI843_nonUDG	3763513	3763515		YPO_RS17840	2
ABI843_nonUDG	3763712	3763719		YPO_RS17840	7
ABI843_nonUDG	3763917	3763959		YPO_RS17840	42
ABI843_nonUDG	3766944	3766946		pyrG	2
ABI843_nonUDG	3767326	3767331		pyrG	5
ABI843_nonUDG	3770233	3770246		relA	13
ABI843_nonUDG	3772048	3772063		barA	15
ABI843_nonUDG	3773070	3773073		barA	3
ABI843_nonUDG	3773204	3773220		barA	16
ABI843_nonUDG	3773775	3773789		barA	14
ABI843_nonUDG	3774681	3774686		degP	5
ABI843_nonUDG	3774765	3774767		degP	2
ABI843_nonUDG	3774849	3774859		degP	10
ABI843_nonUDG	3775224	3775228		degP	4
ABI843_nonUDG	3775682	3775689		degP	7
ABI843_nonUDG	3776627	3776630		dgt	3
ABI843_nonUDG	3777416	3777428		dgt	12
ABI843_nonUDG	3778009	3778019		mtnN	10
ABI843_nonUDG	3779153	3779156		btuF	3
ABI843_nonUDG	3779462	3779497		YPO_RS17900	35
ABI843_nonUDG	3781508	3781535		clcA	27
ABI843_nonUDG	3781718	3781720		clcA	2
ABI843_nonUDG	3783640	3783643		hemL	3
ABI843_nonUDG	3784571	3784575		fhuB	4
ABI843_nonUDG	3784808	3784835		fhuB	27
ABI843_nonUDG	3784697	3784708		fhuB	11
ABI843_nonUDG	3786888	3786894		fhuD	6
ABI843_nonUDG	3786925	3786933		fhuD	8
ABI843_nonUDG	3788435	3788450		mrcB	15
ABI843_nonUDG	3790443	3790464		mrcB	21
ABI843_nonUDG	3791293	3791297		hrpB	4
ABI843_nonUDG	3793534	3793540		hrpB	6
ABI843_nonUDG	3796808	3796823		gluQRS	15
ABI843_nonUDG	3797062	3797063		pcnB	1
ABI843_nonUDG	3798100	3798104		pcnB	4
ABI843_nonUDG	3798146	3798153		pcnB	7
ABI843_nonUDG	3799644	3799656		panB	12
ABI843_nonUDG	3799836	3799858		panB	22
ABI843_nonUDG	3803613	3803628		YPO_RS17995	15
ABI843_nonUDG	3803965	3803976		YPO_RS17995	11
ABI843_nonUDG	3804159	3804163		YPO_RS17995	4
ABI843_nonUDG	3805873	3805874		can	1
ABI843_nonUDG	3806433	3806470		hpt	37
ABI843_nonUDG	3806557	3806575		hpt	18
ABI843_nonUDG	3807348	3807358		cueO	10
ABI843_nonUDG	3809833	3809834		speE	1
ABI843_nonUDG	3811570	3811578		YPO_RS18035	8
ABI843_nonUDG	3811610	3811634		YPO_RS18035	24
ABI843_nonUDG	3812177	3812207		YPO_RS18035	30
ABI843_nonUDG	3812502	3812521		YPO_RS18040	19
ABI843_nonUDG	3813233	3813244		acnB	11
ABI843_nonUDG	3813544	3813551		acnB	7
ABI843_nonUDG	3813618	3813622		acnB	4
ABI843_nonUDG	3814096	3814130		acnB	34
ABI843_nonUDG	3814402	3814411		acnB	9
ABI843_nonUDG	3816441	3816447		YPO_RS18050	6
ABI843_nonUDG	3816549	3816550		YPO_RS18050	1
ABI843_nonUDG	3817830	3817843		lpdA	13
ABI843_nonUDG	3817894	3817905		lpdA	11
ABI843_nonUDG	3818131	3818148		lpdA	17
ABI843_nonUDG	3820256	3820285		aceF	29
ABI843_nonUDG	3820682	3820692		aceE	10
ABI843_nonUDG	3821173	3821174		aceE	1
ABI843_nonUDG	3822430	3822451		aceE	21
ABI843_nonUDG	3822536	3822541		aceE	5
ABI843_nonUDG	3823885	3823887		pdhR	2
ABI843_nonUDG	3825566	3825567		YPO_RS18075	1
ABI843_nonUDG	3825837	3825840		YPO_RS18075	3
ABI843_nonUDG	3826818	3826823		ampE	5
ABI843_nonUDG	3827814	3827816		ampD	2
ABI843_nonUDG	3827926	3827937		ampD	11
ABI843_nonUDG	3828873	3828890		nadC	17
ABI843_nonUDG	3830356	3830361		gspE	5
ABI843_nonUDG	3830764	3830779		gspE	15
ABI843_nonUDG	3831080	3831086		gspE	6
ABI843_nonUDG	3831222	3831225		gspE	3
ABI843_nonUDG	3831613	3831628		hofC	15
ABI843_nonUDG	3832101	3832108		hofC	7
ABI843_nonUDG	3833140	3833144		YPO_RS18110	4
ABI843_nonUDG	3834736	3834745		coaE	9
ABI843_nonUDG	3835649	3835650		zapD	1
ABI843_nonUDG	3836459	3836466		YPO_RS18130	7
ABI843_nonUDG	3836881	3836887		YPO_RS18130	6
ABI843_nonUDG	3837080	3837091		YPO_RS18135	11
ABI843_nonUDG	3837561	3837584		YPO_RS18135	23
ABI843_nonUDG	3837660	3837717		YPO_RS18135	57
ABI843_nonUDG	3837967	3838020		YPO_RS18135	53
ABI843_nonUDG	3838020	3838027		YPO_RS18140	7
ABI843_nonUDG	3838150	3838159		YPO_RS18140	9
ABI843_nonUDG	3838850	3838861		YPO_RS18145	11
ABI843_nonUDG	3838924	3838930		YPO_RS18145	6
ABI843_nonUDG	3839352	3839357		YPO_RS18145	5
ABI843_nonUDG	3839489	3839516		YPO_RS18145	27
ABI843_nonUDG	3842321	3842332		YPO_RS18155	11
ABI843_nonUDG	3842617	3842623		YPO_RS18155	6
ABI843_nonUDG	3843014	3843017		YPO_RS18155	3
ABI843_nonUDG	3844689	3844739		lptG	50
ABI843_nonUDG	3844739	3844747		lptF	8
ABI843_nonUDG	3844847	3844848		lptF	1
ABI843_nonUDG	3844928	3844931		lptF	3
ABI843_nonUDG	3845137	3845140		lptF	3
ABI843_nonUDG	3845466	3845469		lptF	3
ABI843_nonUDG	3846389	3846402		pepA	13
ABI843_nonUDG	3846635	3846636		pepA	1
ABI843_nonUDG	3846897	3846901		pepA	4
ABI843_nonUDG	3849145	3849149		YPO_RS18185	4
ABI843_nonUDG	3849963	3849975		YPO_RS18185	12
ABI843_nonUDG	3851406	3851413		YPO_RS18190	7
ABI843_nonUDG	3851465	3851467		YPO_RS18190	2
ABI843_nonUDG	3852287	3852311		rraB	24
ABI843_nonUDG	3852382	3852387		rraB	5
ABI843_nonUDG	3853203	3853223		argF	20
ABI843_nonUDG	3854573	3854592		YPO_RS18205	19
ABI843_nonUDG	3858120	3858129		YPO_RS18220	9
ABI843_nonUDG	3858633	3858635		YPO_RS18220	2
ABI843_nonUDG	3858758	3858761		YPO_RS18220	3
ABI843_nonUDG	3859224	3859253		YPO_RS18225	29
ABI843_nonUDG	3863231	3863257		nrdG	26
ABI843_nonUDG	3863499	3863502		nrdG	3
ABI843_nonUDG	3865820	3865851		phnH	31
ABI843_nonUDG	3865851	3865855		YPO_RS18260	4
ABI843_nonUDG	3866098	3866102		YPO_RS18260	4
ABI843_nonUDG	3866994	3867029		YPO_RS18260	35
ABI843_nonUDG	3867022	3867045		YPO_RS18265	23
ABI843_nonUDG	3867539	3867546		YPO_RS18265	7
ABI843_nonUDG	3868571	3868576		phnK	5
ABI843_nonUDG	3869147	3869154		phnL	7
ABI843_nonUDG	3870245	3870250		phnM	5
ABI843_nonUDG	3870678	3870679		phnM	1
ABI843_nonUDG	3871429	3871441		phnN	12
ABI843_nonUDG	3871741	3871750		phnP	9
ABI843_nonUDG	3872031	3872039		phnP	8
ABI843_nonUDG	3874012	3874017		YPO_RS18305	5
ABI843_nonUDG	3874696	3874699		YPO_RS18305	3
ABI843_nonUDG	3875421	3875424		ugpC	3
ABI843_nonUDG	3876294	3876300		YPO_RS18315	6
ABI843_nonUDG	3876488	3876505		YPO_RS18315	17
ABI843_nonUDG	3877524	3877541		YPO_RS18320	17
ABI843_nonUDG	3877645	3877647		YPO_RS18325	2
ABI843_nonUDG	3878570	3878574		YPO_RS18325	4
ABI843_nonUDG	3879705	3879708		YPO_RS18330	3
ABI843_nonUDG	3881237	3881241		YPO_RS18335	4
ABI843_nonUDG	3881603	3881605		YPO_RS18335	2
ABI843_nonUDG	3881837	3881839		YPO_RS18335	2
ABI843_nonUDG	3882434	3882455		YPO_RS18335	21
ABI843_nonUDG	3884396	3884401		YPO_RS18350	5
ABI843_nonUDG	3886858	3886869		YPO_RS18365	11
ABI843_nonUDG	3887870	3887883		YPO_RS18365	13
ABI843_nonUDG	3888698	3888731		YPO_RS18370	33
ABI843_nonUDG	3889133	3889134		YPO_RS18370	1
ABI843_nonUDG	3890953	3890984		YPO_RS18370	31
ABI843_nonUDG	3892259	3892266		YPO_RS18375	7
ABI843_nonUDG	3893842	3893851		YPO_RS18380	9
ABI843_nonUDG	3894567	3894582		YPO_RS18390	15
ABI843_nonUDG	3894789	3894797		YPO_RS18395	8
ABI843_nonUDG	3897292	3897296		yrbN	4
ABI843_nonUDG	3899892	3899897		pnp	5
ABI843_nonUDG	3900375	3900386		pnp	11
ABI843_nonUDG	3901151	3901155		YPO_RS18420	4
ABI843_nonUDG	3901407	3901415		YPO_RS18420	8
ABI843_nonUDG	3901866	3901879		YPO_RS18420	13
ABI843_nonUDG	3905128	3905142		infB	14
ABI843_nonUDG	3905817	3905831		infB	14
ABI843_nonUDG	3906732	3906745		infB	13
ABI843_nonUDG	3907014	3907020		nusA	6
ABI843_nonUDG	3907235	3907257		nusA	22
ABI843_nonUDG	3907860	3907903		nusA	43
ABI843_nonUDG	3908639	3908645		rimP	6
ABI843_nonUDG	3909940	3909946		glmM	6
ABI843_nonUDG	3910337	3910353		glmM	16
ABI843_nonUDG	3910478	3910497		glmM	19
ABI843_nonUDG	3911548	3911589		folP	41
ABI843_nonUDG	3913535	3913537		ftsH	2
ABI843_nonUDG	3914170	3914171		rlmE	1
ABI843_nonUDG	3914611	3914627		rlmE	16
ABI843_nonUDG	3917414	3917419		dacB	5
ABI843_nonUDG	3918850	3918853		pmrB	3
ABI843_nonUDG	3920199	3920214		cgtA	15
ABI843_nonUDG	3921202	3921225		YPO_RS18520	23
ABI843_nonUDG	3921261	3921263		YPO_RS18520	2
ABI843_nonUDG	3923207	3923211		ispB	4
ABI843_nonUDG	3924337	3924343		YPO_RS18545	6
ABI843_nonUDG	3925353	3925365		mdh	12
ABI843_nonUDG	3925464	3925468		mdh	4
ABI843_nonUDG	3926441	3926480		argR	39
ABI843_nonUDG	3927283	3927289		yhcN	6
ABI843_nonUDG	3928694	3928716		mpl	22
ABI843_nonUDG	3928942	3928960		mpl	18
ABI843_nonUDG	3929847	3929870		fbp	23
ABI843_nonUDG	3930384	3930388		ppa	4
ABI843_nonUDG	3930582	3930594		ppa	12
ABI843_nonUDG	3931278	3931293		YPO_RS18580	15
ABI843_nonUDG	3931633	3931644		YPO_RS18585	11
ABI843_nonUDG	3932474	3932484		YPO_RS18585	10
ABI843_nonUDG	3933104	3933121		YPO_RS18585	17
ABI843_nonUDG	3933839	3933848		YPO_RS18585	9
ABI843_nonUDG	3934349	3934366		YPO_RS18585	17
ABI843_nonUDG	3934559	3934562		YPO_RS18585	3
ABI843_nonUDG	3934598	3934608		YPO_RS18585	10
ABI843_nonUDG	3934902	3934926		YPO_RS18585	24
ABI843_nonUDG	3934975	3935016		YPO_RS18585	41
ABI843_nonUDG	3935222	3935233		YPO_RS18585	11
ABI843_nonUDG	3935399	3935405		YPO_RS18590	6
ABI843_nonUDG	3937603	3937604		msrA	1
ABI843_nonUDG	3937698	3937720		msrA	22
ABI843_nonUDG	3938346	3938350		YPO_RS18600	4
ABI843_nonUDG	3938710	3938717		YPO_RS18600	7
ABI843_nonUDG	3938969	3938975		YPO_RS18600	6
ABI843_nonUDG	3940197	3940253		YPO_RS18610	56
ABI843_nonUDG	3942061	3942063		YPO_RS18620	2
ABI843_nonUDG	3942596	3942598		YPO_RS18620	2
ABI843_nonUDG	3944961	3944973		YPO_RS18630	12
ABI843_nonUDG	3945101	3945102		YPO_RS18630	1
ABI843_nonUDG	3946230	3946235		YPO_RS18635	5
ABI843_nonUDG	3946332	3946338		YPO_RS18635	6
ABI843_nonUDG	3947279	3947302		YPO_RS18645	23
ABI843_nonUDG	3947358	3947371		YPO_RS18645	13
ABI843_nonUDG	3948747	3948784		priB	37
ABI843_nonUDG	3949249	3949257		rpsF	8
ABI843_nonUDG	3949719	3949743		yjfP	24
ABI843_nonUDG	3950382	3950410		yjfP	28
ABI843_nonUDG	3950626	3950630		YPO_RS18675	4
ABI843_nonUDG	3951083	3951086		YPO_RS18675	3
ABI843_nonUDG	3951128	3951176		YPO_RS18675	48
ABI843_nonUDG	3951320	3951322		YPO_RS18675	2
ABI843_nonUDG	3951812	3951846		YPO_RS18680	34
ABI843_nonUDG	3951958	3951964		YPO_RS18680	6
ABI843_nonUDG	3952213	3952268		YPO_RS18680	55
ABI843_nonUDG	3953859	3953863		YPO_RS18690	4
ABI843_nonUDG	3954210	3954211		YPO_RS18690	1
ABI843_nonUDG	3956319	3956343		rsmI	24
ABI843_nonUDG	3956464	3956488		rsmI	24
ABI843_nonUDG	3958517	3958520		YPO_RS18710	3
ABI843_nonUDG	3958683	3958685		YPO_RS18710	2
ABI843_nonUDG	3958988	3958990		YPO_RS18710	2
ABI843_nonUDG	3960557	3960559		yraP	2
ABI843_nonUDG	3960750	3960763		yraP	13
ABI843_nonUDG	3962318	3962327		elbB	9
ABI843_nonUDG	3962511	3962512		elbB	1
ABI843_nonUDG	3963428	3963430		arcB	2
ABI843_nonUDG	3965088	3965113		arcB	25
ABI843_nonUDG	3965683	3965692		YPO_RS18745	9
ABI843_nonUDG	3969850	3969877		gltB	27
ABI843_nonUDG	3970573	3970579		gltB	6
ABI843_nonUDG	3971041	3971043		gltB	2
ABI843_nonUDG	3971234	3971240		gltB	6
ABI843_nonUDG	3972450	3972465		YPO_RS18755	15
ABI843_nonUDG	3974529	3974538		sspB	9
ABI843_nonUDG	3974946	3974981		sspA	35
ABI843_nonUDG	3975121	3975124		sspA	3
ABI843_nonUDG	3975186	3975190		sspA	4
ABI843_nonUDG	3975600	3975618		YPO_RS18775	18
ABI843_nonUDG	3976804	3976817		YPO_RS18790	13
ABI843_nonUDG	3977104	3977116		YPO_RS18790	12
ABI843_nonUDG	3977679	3977701		YPO_RS18790	22
ABI843_nonUDG	3978144	3978173		YPO_RS18795	29
ABI843_nonUDG	3979097	3979116		degQ	19
ABI843_nonUDG	3979906	3979924		degQ	18
ABI843_nonUDG	3980353	3980362		YPO_RS18805	9
ABI843_nonUDG	3980736	3980761		YPO_RS18805	25
ABI843_nonUDG	3981239	3981246		degS	7
ABI843_nonUDG	3982015	3982018		degS	3
ABI843_nonUDG	3983402	3983406		murA	4
ABI843_nonUDG	3983905	3983907		ibaG	2
ABI843_nonUDG	3986881	3986883		mlaF	2
ABI843_nonUDG	3987768	3987780		YPO_RS18850	12
ABI843_nonUDG	3987843	3987853		YPO_RS18850	10
ABI843_nonUDG	3987936	3987941		YPO_RS18850	5
ABI843_nonUDG	3988199	3988217		YPO_RS18850	18
ABI843_nonUDG	3989214	3989221		kdsD	7
ABI843_nonUDG	3990017	3990025		kdsC	8
ABI843_nonUDG	3990310	3990349		kdsC	39
ABI843_nonUDG	3990833	3990855		lptC	22
ABI843_nonUDG	3991265	3991288		lptA	23
ABI843_nonUDG	3997221	3997238		pyrB	17
ABI843_nonUDG	3997469	3997481		pyrB	12
ABI843_nonUDG	3999011	3999036		YPO_RS18920	25
ABI843_nonUDG	3999173	3999180		YPO_RS18920	7
ABI843_nonUDG	3999552	3999577		YPO_RS18920	25
ABI843_nonUDG	3999660	3999664		YPO_RS18920	4
ABI843_nonUDG	3999820	3999825		YPO_RS18920	5
ABI843_nonUDG	4000056	4000059		YPO_RS18925	3
ABI843_nonUDG	4001289	4001290		YPO_RS18935	1
ABI843_nonUDG	4001687	4001697		YPO_RS18935	10
ABI843_nonUDG	4001687	4001697		tssG	10
ABI843_nonUDG	4001857	4001860		tssG	3
ABI843_nonUDG	4002179	4002194		tssG	15
ABI843_nonUDG	4003507	4003512		tagH	5
ABI843_nonUDG	4004986	4005010		tssK	24
ABI843_nonUDG	4005199	4005206		tssK	7
ABI843_nonUDG	4006238	4006240		YPO_RS18960	2
ABI843_nonUDG	4006423	4006432		YPO_RS18960	9
ABI843_nonUDG	4006504	4006507		YPO_RS18960	3
ABI843_nonUDG	4006695	4006704		YPO_RS18960	9
ABI843_nonUDG	4007027	4007046		tssH	19
ABI843_nonUDG	4008470	4008475		tssH	5
ABI843_nonUDG	4008870	4008871		tssH	1
ABI843_nonUDG	4008928	4008931		tssH	3
ABI843_nonUDG	4009076	4009101		tssH	25
ABI843_nonUDG	4011101	4011103		tssA	2
ABI843_nonUDG	4012823	4012835		tssM	12
ABI843_nonUDG	4012967	4012983		tssM	16
ABI843_nonUDG	4013798	4013804		tssM	6
ABI843_nonUDG	4013849	4013851		tssM	2
ABI843_nonUDG	4014398	4014402		tssM	4
ABI843_nonUDG	4014692	4014693		tssM	1
ABI843_nonUDG	4015262	4015272		tssM	10
ABI843_nonUDG	4016895	4016896		YPO_RS18995	1
ABI843_nonUDG	4018156	4018173		YPO_RS19000	17
ABI843_nonUDG	4018238	4018242		YPO_RS19000	4
ABI843_nonUDG	4018785	4018793		YPO_RS19000	8
ABI843_nonUDG	4020390	4020423		YPO_RS19010	33
ABI843_nonUDG	4020574	4020581		YPO_RS19010	7
ABI843_nonUDG	4021582	4021594		YPO_RS19010	12
ABI843_nonUDG	4021725	4021728		YPO_RS19010	3
ABI843_nonUDG	4021828	4021832		YPO_RS19010	4
ABI843_nonUDG	4022967	4022970		YPO_RS19010	3
ABI843_nonUDG	4023993	4024055		YPO_RS19015	62
ABI843_nonUDG	4024242	4024252		YPO_RS19015	10
ABI843_nonUDG	4024873	4024878		YPO_RS19020	5
ABI843_nonUDG	4026892	4026896		YPO_RS19045	4
ABI843_nonUDG	4028064	4028076		YPO_RS19045	12
ABI843_nonUDG	4028798	4028804		YPO_RS19050	6
ABI843_nonUDG	4028894	4028898		YPO_RS19050	4
ABI843_nonUDG	4030136	4030138		YPO_RS19055	2
ABI843_nonUDG	4030274	4030275		YPO_RS19055	1
ABI843_nonUDG	4032225	4032266		YPO_RS19055	41
ABI843_nonUDG	4032924	4032931		YPO_RS19055	7
ABI843_nonUDG	4033310	4033328		YPO_RS19055	18
ABI843_nonUDG	4033386	4033407		YPO_RS19055	21
ABI843_nonUDG	4033585	4033587		YPO_RS19055	2
ABI843_nonUDG	4030423	4030469		YPO_RS19055	46
ABI843_nonUDG	4033596	4033625		YPO_RS19060	29
ABI843_nonUDG	4033686	4033709		YPO_RS19060	23
ABI843_nonUDG	4034144	4034146		YPO_RS19060	2
ABI843_nonUDG	4034329	4034332		YPO_RS19060	3
ABI843_nonUDG	4034555	4034559		YPO_RS19065	4
ABI843_nonUDG	4034807	4034809		YPO_RS19070	2
ABI843_nonUDG	4035437	4035481		YPO_RS19070	44
ABI843_nonUDG	4038751	4038755		YPO_RS19090	4
ABI843_nonUDG	4040228	4040234		deoC	6
ABI843_nonUDG	4042051	4042085		YPO_RS19105	34
ABI843_nonUDG	4044400	4044403		ssuC	3
ABI843_nonUDG	4044517	4044518		ssuC	1
ABI843_nonUDG	4044517	4044519		ssuB	2
ABI843_nonUDG	4044730	4044731		ssuB	1
ABI843_nonUDG	4046966	4046967		YPO_RS19135	1
ABI843_nonUDG	4047401	4047406		YPO_RS19135	5
ABI843_nonUDG	4049525	4049535		YPO_RS19140	10
ABI843_nonUDG	4049690	4049720		YPO_RS19140	30
ABI843_nonUDG	4050910	4050917		YPO_RS19145	7
ABI843_nonUDG	4053255	4053268		YPO_RS19155	13
ABI843_nonUDG	4053954	4053958		YPO_RS19155	4
ABI843_nonUDG	4054021	4054026		YPO_RS19155	5
ABI843_nonUDG	4055051	4055054		YPO_RS19160	3
ABI843_nonUDG	4055263	4055271		YPO_RS19160	8
ABI843_nonUDG	4055424	4055457		YPO_RS19160	33
ABI843_nonUDG	4056455	4056469		YPO_RS19165	14
ABI843_nonUDG	4056572	4056595		YPO_RS19165	23
ABI843_nonUDG	4057076	4057128		YPO_RS19170	52
ABI843_nonUDG	4057513	4057526		YPO_RS19170	13
ABI843_nonUDG	4057793	4057816		YPO_RS19170	23
ABI843_nonUDG	4058354	4058359		YPO_RS19175	5
ABI843_nonUDG	4058453	4058457		YPO_RS19175	4
ABI843_nonUDG	4058675	4058676		YPO_RS19175	1
ABI843_nonUDG	4059945	4059959		YPO_RS19180	14
ABI843_nonUDG	4060693	4060695		yghU	2
ABI843_nonUDG	4062647	4062652		YPO_RS19190	5
ABI843_nonUDG	4062862	4062870		YPO_RS19195	8
ABI843_nonUDG	4064624	4064627		YPO_RS19200	3
ABI843_nonUDG	4064673	4064683		YPO_RS19200	10
ABI843_nonUDG	4067243	4067244		YPO_RS19220	1
ABI843_nonUDG	4067615	4067635		YPO_RS19220	20
ABI843_nonUDG	4067780	4067800		YPO_RS19220	20
ABI843_nonUDG	4067968	4067973		YPO_RS19220	5
ABI843_nonUDG	4068035	4068037		YPO_RS19220	2
ABI843_nonUDG	4068312	4068326		YPO_RS19225	14
ABI843_nonUDG	4070854	4070874		YPO_RS19235	20
ABI843_nonUDG	4075024	4075038		prmA	14
ABI843_nonUDG	4075470	4075479		prmA	9
ABI843_nonUDG	4077405	4077428		panF	23
ABI843_nonUDG	4077425	4077428		YPO_RS19280	3
ABI843_nonUDG	4078651	4078657		YPO_RS19285	6
ABI843_nonUDG	4079455	4079470		accC	15
ABI843_nonUDG	4079856	4079862		accC	6
ABI843_nonUDG	4079979	4079983		accC	4
ABI843_nonUDG	4080574	4080578		accB	4
ABI843_nonUDG	4081857	4081858		msrQ	1
ABI843_nonUDG	4083260	4083285		msrP	25
ABI843_nonUDG	4085093	4085095		csrD	2
ABI843_nonUDG	4085286	4085295		csrD	9
ABI843_nonUDG	4086703	4086724		csrD	21
ABI843_nonUDG	4087344	4087350		YPO_RS19325	6
ABI843_nonUDG	4087469	4087481		YPO_RS19325	12
ABI843_nonUDG	4088022	4088034		YPO_RS19325	12
ABI843_nonUDG	4088668	4088684		mreC	16
ABI843_nonUDG	4088922	4088931		mreC	9
ABI843_nonUDG	4089346	4089359		mreC	13
ABI843_nonUDG	4089438	4089439		mreC	1
ABI843_nonUDG	4089672	4089675		mreD	3
ABI843_nonUDG	4090947	4090957		rng	10
ABI843_nonUDG	4092465	4092475		YPO_RS19350	10
ABI843_nonUDG	4095004	4095032		YPO_RS19350	28
ABI843_nonUDG	4095803	4095807		YPO_RS19350	4
ABI843_nonUDG	4096289	4096300		YPO_RS19355	11
ABI843_nonUDG	4096542	4096543		YPO_RS19355	1
ABI843_nonUDG	4097930	4097949		tldD	19
ABI843_nonUDG	4098633	4098649		YPO_RS19365	16
ABI843_nonUDG	4098793	4098853		YPO_RS19365	60
ABI843_nonUDG	4099342	4099345		YPO_RS19365	3
ABI843_nonUDG	4099472	4099479		YPO_RS19365	7
ABI843_nonUDG	4101419	4101424		YPO_RS19365	5
ABI843_nonUDG	4101977	4102005		YPO_RS19370	28
ABI843_nonUDG	4102660	4102670		YPO_RS19370	10
ABI843_nonUDG	4103859	4103862		YPO_RS19370	3
ABI843_nonUDG	4107209	4107215		YPO_RS19390	6
ABI843_nonUDG	4107368	4107372		YPO_RS19390	4
ABI843_nonUDG	4108864	4108866		YPO_RS19390	2
ABI843_nonUDG	4110587	4110591		YPO_RS19395	4
ABI843_nonUDG	4110679	4110691		YPO_RS19395	12
ABI843_nonUDG	4110908	4110926		YPO_RS19395	18
ABI843_nonUDG	4112672	4112685		YPO_RS19400	13
ABI843_nonUDG	4112907	4112916		YPO_RS19400	9
ABI843_nonUDG	4113524	4113533		YPO_RS19400	9
ABI843_nonUDG	4113881	4113884		YPO_RS19400	3
ABI843_nonUDG	4114288	4114291		YPO_RS19405	3
ABI843_nonUDG	4114411	4114426		YPO_RS19405	15
ABI843_nonUDG	4114693	4114716		YPO_RS19405	23
ABI843_nonUDG	4115059	4115104		YPO_RS19405	45
ABI843_nonUDG	4115518	4115532		YPO_RS19405	14
ABI843_nonUDG	4116047	4116050		YPO_RS19405	3
ABI843_nonUDG	4116721	4116753		YPO_RS19410	32
ABI843_nonUDG	4117991	4117993		aaeR	2
ABI843_nonUDG	4120070	4120090		aaeA	20
ABI843_nonUDG	4120272	4120278		aaeB	6
ABI843_nonUDG	4120393	4120397		aaeB	4
ABI843_nonUDG	4124092	4124100		YPO_RS19440	8
ABI843_nonUDG	4124507	4124518		YPO_RS19440	11
ABI843_nonUDG	4124523	4124530		YPO_RS19445	7
ABI843_nonUDG	4125819	4125867		pmbA	48
ABI843_nonUDG	4125939	4125942		pmbA	3
ABI843_nonUDG	4126158	4126168		pmbA	10
ABI843_nonUDG	4126610	4126635		pmbA	25
ABI843_nonUDG	4126904	4126911		pmbA	7
ABI843_nonUDG	4128464	4128466		cybC	2
ABI843_nonUDG	4130047	4130074		treC	27
ABI843_nonUDG	4131544	4131551		treB	7
ABI843_nonUDG	4132063	4132064		treB	1
ABI843_nonUDG	4132240	4132266		treB	26
ABI843_nonUDG	4134421	4134427		YPO_RS19490	6
ABI843_nonUDG	4134826	4134854		YPO_RS19495	28
ABI843_nonUDG	4135256	4135257		YPO_RS19495	1
ABI843_nonUDG	4135487	4135513		YPO_RS19495	26
ABI843_nonUDG	4135569	4135580		YPO_RS19495	11
ABI843_nonUDG	4135693	4135709		YPO_RS19500	16
ABI843_nonUDG	4135824	4135833		YPO_RS19500	9
ABI843_nonUDG	4135906	4135907		YPO_RS19500	1
ABI843_nonUDG	4136026	4136047		YPO_RS19500	21
ABI843_nonUDG	4136336	4136354		YPO_RS19500	18
ABI843_nonUDG	4139030	4139051		tssE	21
ABI843_nonUDG	4139354	4139365		tssE	11
ABI843_nonUDG	4140688	4140702		tssC	14
ABI843_nonUDG	4142781	4142801		YPO_RS19535	20
ABI843_nonUDG	4143675	4143677		malM	2
ABI843_nonUDG	4144316	4144322		malM	6
ABI843_nonUDG	4144636	4144660		YPO_RS19545	24
ABI843_nonUDG	4144797	4144803		YPO_RS19545	6
ABI843_nonUDG	4145083	4145084		YPO_RS19545	1
ABI843_nonUDG	4145691	4145692		YPO_RS19545	1
ABI843_nonUDG	4146005	4146024		malK	19
ABI843_nonUDG	4146769	4146774		malK	5
ABI843_nonUDG	4147015	4147022		malK	7
ABI843_nonUDG	4147026	4147028		YPO_RS19555	2
ABI843_nonUDG	4147243	4147262		YPO_RS19555	19
ABI843_nonUDG	4149323	4149326		malF	3
ABI843_nonUDG	4149827	4149830		malF	3
ABI843_nonUDG	4150425	4150428		malF	3
ABI843_nonUDG	4150618	4150643		malF	25
ABI843_nonUDG	4151011	4151041		malG	30
ABI843_nonUDG	4151102	4151108		malG	6
ABI843_nonUDG	4151232	4151250		malG	18
ABI843_nonUDG	4151404	4151415		malG	11
ABI843_nonUDG	4151867	4151871		psiE	4
ABI843_nonUDG	4152508	4152511		pgi	3
ABI843_nonUDG	4152562	4152569		pgi	7
ABI843_nonUDG	4153612	4153613		pgi	1
ABI843_nonUDG	4154946	4154953		lysC	7
ABI843_nonUDG	4155689	4155695		lysC	6
ABI843_nonUDG	4156395	4156405		YPO_RS19590	10
ABI843_nonUDG	4156556	4156601		YPO_RS19590	45
ABI843_nonUDG	4156739	4156742		YPO_RS19590	3
ABI843_nonUDG	4158673	4158699		YPO_RS19595	26
ABI843_nonUDG	4158748	4158757		YPO_RS19595	9
ABI843_nonUDG	4159238	4159270		YPO_RS19595	32
ABI843_nonUDG	4159710	4159712		YPO_RS19595	2
ABI843_nonUDG	4160808	4160818		YPO_RS19595	10
ABI843_nonUDG	4162084	4162091		YPO_RS19595	7
ABI843_nonUDG	4162194	4162200		YPO_RS19595	6
ABI843_nonUDG	4162502	4162524		YPO_RS19595	22
ABI843_nonUDG	4163395	4163404		metH	9
ABI843_nonUDG	4163733	4163740		metH	7
ABI843_nonUDG	4165347	4165351		metH	4
ABI843_nonUDG	4166368	4166369		metH	1
ABI843_nonUDG	4168628	4168650		aceK	22
ABI843_nonUDG	4168756	4168764		aceK	8
ABI843_nonUDG	4170846	4170850		aceA	4
ABI843_nonUDG	4170960	4170963		aceA	3
ABI843_nonUDG	4171509	4171510		aceB	1
ABI843_nonUDG	4172746	4172758		aceB	12
ABI843_nonUDG	4173550	4173551		metA	1
ABI843_nonUDG	4173611	4173649		metA	38
ABI843_nonUDG	4175493	4175518		YPO_RS19645	25
ABI843_nonUDG	4176214	4176230		YPO_RS19645	16
ABI843_nonUDG	4176657	4176663		YPO_RS19645	6
ABI843_nonUDG	4177167	4177185		YPO_RS19645	18
ABI843_nonUDG	4177512	4177520		YPO_RS19645	8
ABI843_nonUDG	4181241	4181245		purH	4
ABI843_nonUDG	4181573	4181595		purH	22
ABI843_nonUDG	4181706	4181722		purH	16
ABI843_nonUDG	4181851	4181857		purH	6
ABI843_nonUDG	4183287	4183300		purD	13
ABI843_nonUDG	4183473	4183487		purD	14
ABI843_nonUDG	4184393	4184403		YPO_RS19680	10
ABI843_nonUDG	4184850	4184854		YPO_RS19680	4
ABI843_nonUDG	4185716	4185750		YPO_RS19690	34
ABI843_nonUDG	4187201	4187210		hemE	9
ABI843_nonUDG	4188489	4188514		YPO_RS19705	25
ABI843_nonUDG	4188628	4188659		YPO_RS19705	31
ABI843_nonUDG	4188893	4188900		nudC	7
ABI843_nonUDG	4188935	4188952		nudC	17
ABI843_nonUDG	4189312	4189313		nudC	1
ABI843_nonUDG	4190606	4190613		thiC	7
ABI843_nonUDG	4190882	4190895		thiC	13
ABI843_nonUDG	4191214	4191219		thiC	5
ABI843_nonUDG	4191400	4191405		thiC	5
ABI843_nonUDG	4192321	4192322		thiC	1
ABI843_nonUDG	4192662	4192666		thiE	4
ABI843_nonUDG	4192701	4192706		thiE	5
ABI843_nonUDG	4193508	4193511		YPO_RS19730	3
ABI843_nonUDG	4193690	4193711		YPO_RS19730	21
ABI843_nonUDG	4194185	4194201		thiS	16
ABI843_nonUDG	4196910	4196914		YPO_RS19750	4
ABI843_nonUDG	4197059	4197074		YPO_RS19750	15
ABI843_nonUDG	4197932	4197944		rpoC	12
ABI843_nonUDG	4198999	4199002		rpoC	3
ABI843_nonUDG	4199384	4199397		rpoC	13
ABI843_nonUDG	4199956	4199959		rpoC	3
ABI843_nonUDG	4200398	4200409		rpoC	11
ABI843_nonUDG	4200493	4200502		rpoC	9
ABI843_nonUDG	4201939	4201960		rpoB	21
ABI843_nonUDG	4202387	4202420		rpoB	33
ABI843_nonUDG	4202513	4202516		rpoB	3
ABI843_nonUDG	4202993	4203009		rpoB	16
ABI843_nonUDG	4203339	4203342		rpoB	3
ABI843_nonUDG	4203528	4203545		rpoB	17
ABI843_nonUDG	4203841	4203871		rpoB	30
ABI843_nonUDG	4204987	4204993		rpoB	6
ABI843_nonUDG	4207290	4207301		rplA	11
ABI843_nonUDG	4207333	4207354		rplA	21
ABI843_nonUDG	4208367	4208368		rplK	1
ABI843_nonUDG	4209193	4209235		secE	42
ABI843_nonUDG	4212367	4212380		YPO_RS19820	13
ABI843_nonUDG	4212421	4212422		YPO_RS19820	1
ABI843_nonUDG	4212476	4212486		YPO_RS19820	10
ABI843_nonUDG	4212840	4212857		YPO_RS19825	17
ABI843_nonUDG	4212895	4212938		YPO_RS19825	43
ABI843_nonUDG	4213269	4213279		YPO_RS19825	10
ABI843_nonUDG	4213423	4213436		YPO_RS19825	13
ABI843_nonUDG	4213564	4213566		YPO_RS19825	2
ABI843_nonUDG	4214094	4214109		YPO_RS19830	15
ABI843_nonUDG	4214360	4214432		YPO_RS19830	72
ABI843_nonUDG	4215227	4215236		coaA	9
ABI843_nonUDG	4215306	4215340		coaA	34
ABI843_nonUDG	4215493	4215500		coaA	7
ABI843_nonUDG	4215692	4215695		birA	3
ABI843_nonUDG	4216382	4216394		birA	12
ABI843_nonUDG	4216460	4216461		birA	1
ABI843_nonUDG	4217373	4217374		murB	1
ABI843_nonUDG	4217584	4217590		murB	6
ABI843_nonUDG	4219137	4219139		YPO_RS19855	2
ABI843_nonUDG	4219845	4219851		YPO_RS19855	6
ABI843_nonUDG	4220064	4220091		YPO_RS19855	27
ABI843_nonUDG	4220573	4220575		YPO_RS19855	2
ABI843_nonUDG	4223132	4223160		YPO_RS19870	28
ABI843_nonUDG	4224845	4224853		trkH	8
ABI843_nonUDG	4225109	4225124		trkH	15
ABI843_nonUDG	4226470	4226471		YPO_RS19895	1
ABI843_nonUDG	4226846	4226851		YPO_RS19895	5
ABI843_nonUDG	4226972	4226995		YPO_RS19900	23
ABI843_nonUDG	4227063	4227078		YPO_RS19900	15
ABI843_nonUDG	4227235	4227258		pepQ	23
ABI843_nonUDG	4227915	4227921		pepQ	6
ABI843_nonUDG	4228315	4228325		pepQ	10
ABI843_nonUDG	4228823	4228829		fadB	6
ABI843_nonUDG	4230704	4230725		fadB	21
ABI843_nonUDG	4231091	4231114		fadA	23
ABI843_nonUDG	4231538	4231548		fadA	10
ABI843_nonUDG	4231614	4231618		fadA	4
ABI843_nonUDG	4233721	4233740		ubiD	19
ABI843_nonUDG	4234116	4234137		ubiD	21
ABI843_nonUDG	4235617	4235621		hemB	4
ABI843_nonUDG	4235789	4235791		hemB	2
ABI843_nonUDG	4236770	4236809		YPO_RS19940	39
ABI843_nonUDG	4236954	4236958		YPO_RS19945	4
ABI843_nonUDG	4237269	4237322		YPO_RS19945	53
ABI843_nonUDG	4237402	4237403		YPO_RS19945	1
ABI843_nonUDG	4237507	4237541		YPO_RS19945	34
ABI843_nonUDG	4237621	4237635		YPO_RS19945	14
ABI843_nonUDG	4237635	4237662		YPO_RS19950	27
ABI843_nonUDG	4237855	4237867		YPO_RS19950	12
ABI843_nonUDG	4237944	4237954		YPO_RS19950	10
ABI843_nonUDG	4238160	4238176		YPO_RS19950	16
ABI843_nonUDG	4240036	4240039		tatC	3
ABI843_nonUDG	4241555	4241558		ubiB	3
ABI843_nonUDG	4241742	4241767		ubiB	25
ABI843_nonUDG	4242385	4242388		ubiB	3
ABI843_nonUDG	4242456	4242458		ubiB	2
ABI843_nonUDG	4243421	4243423		YPO_RS19980	2
ABI843_nonUDG	4243659	4243669		ubiE	10
ABI843_nonUDG	4243908	4243935		ubiE	27
ABI843_nonUDG	4244095	4244104		ubiE	9
ABI843_nonUDG	4244705	4244708		rmuC	3
ABI843_nonUDG	4245122	4245125		rmuC	3
ABI843_nonUDG	4246546	4246555		YPO_RS19995	9
ABI843_nonUDG	4247185	4247187		YPO_RS20000	2
ABI843_nonUDG	4247244	4247252		YPO_RS20000	8
ABI843_nonUDG	4247438	4247459		YPO_RS20000	21
ABI843_nonUDG	4247919	4247921		YPO_RS20000	2
ABI843_nonUDG	4248027	4248051		YPO_RS20000	24
ABI843_nonUDG	4248175	4248210		YPO_RS20000	35
ABI843_nonUDG	4248570	4248585		YPO_RS20000	15
ABI843_nonUDG	4249439	4249442		YPO_RS20005	3
ABI843_nonUDG	4249750	4249801		YPO_RS20005	51
ABI843_nonUDG	4251345	4251346		YPO_RS20015	1
ABI843_nonUDG	4251785	4251789		YPO_RS20015	4
ABI843_nonUDG	4252946	4252960		metE	14
ABI843_nonUDG	4253478	4253480		metE	2
ABI843_nonUDG	4253969	4253986		metE	17
ABI843_nonUDG	4255582	4255586		YPO_RS20030	4
ABI843_nonUDG	4256877	4256888		YPO_RS20035	11
ABI843_nonUDG	4257139	4257144		YPO_RS20035	5
ABI843_nonUDG	4258149	4258191		ugpQ	42
ABI843_nonUDG	4258422	4258423		YPO_RS20045	1
ABI843_nonUDG	4258634	4258637		YPO_RS20045	3
ABI843_nonUDG	4258994	4258996		YPO_RS20045	2
ABI843_nonUDG	4259598	4259615		ugpE	17
ABI843_nonUDG	4262488	4262491		ugpB	3
ABI843_nonUDG	4263334	4263336		YPO_RS20065	2
ABI843_nonUDG	4263489	4263525		YPO_RS20065	36
ABI843_nonUDG	4264234	4264267		YPO_RS20070	33
ABI843_nonUDG	4264359	4264373		YPO_RS20070	14
ABI843_nonUDG	4265020	4265040		YPO_RS20070	20
ABI843_nonUDG	4265438	4265461		YPO_RS20070	23
ABI843_nonUDG	4266004	4266050		YPO_RS20070	46
ABI843_nonUDG	4267225	4267227		YPO_RS20080	2
ABI843_nonUDG	4267482	4267487		YPO_RS20080	5
ABI843_nonUDG	4267987	4267998		YPO_RS20085	11
ABI843_nonUDG	4268176	4268198		YPO_RS20085	22
ABI843_nonUDG	4269160	4269161		YPO_RS20090	1
ABI843_nonUDG	4269680	4269681		YPO_RS20095	1
ABI843_nonUDG	4270344	4270346		livF	2
ABI843_nonUDG	4270894	4270910		livF	16
ABI843_nonUDG	4271942	4271970		YPO_RS20110	28
ABI843_nonUDG	4272340	4272383		YPO_RS20110	43
ABI843_nonUDG	4272482	4272514		YPO_RS20110	32
ABI843_nonUDG	4273448	4273456		livH	8
ABI843_nonUDG	4273783	4273794		livH	11
ABI843_nonUDG	4276871	4276877		YPO_RS20130	6
ABI843_nonUDG	4284368	4284370		YPO_RS20175	2
ABI843_nonUDG	4285175	4285193		YPO_RS20180	18
ABI843_nonUDG	4285742	4285769		YPO_RS20180	27
ABI843_nonUDG	4285999	4286007		YPO_RS20180	8
ABI843_nonUDG	4286345	4286351		YPO_RS20180	6
ABI843_nonUDG	4286698	4286715		YPO_RS20180	17
ABI843_nonUDG	4286870	4286875		YPO_RS20180	5
ABI843_nonUDG	4287209	4287212		YPO_RS20180	3
ABI843_nonUDG	4288585	4288590		YPO_RS20190	5
ABI843_nonUDG	4289137	4289147		dcrB	10
ABI843_nonUDG	4290038	4290050		glpC	12
ABI843_nonUDG	4290142	4290165		glpC	23
ABI843_nonUDG	4291390	4291393		glpB	3
ABI843_nonUDG	4292822	4292837		glpA	15
ABI843_nonUDG	4293208	4293211		glpA	3
ABI843_nonUDG	4294655	4294711		glpQ	56
ABI843_nonUDG	4294981	4294985		glpQ	4
ABI843_nonUDG	4295189	4295215		glpQ	26
ABI843_nonUDG	4295458	4295480		glpQ	22
ABI843_nonUDG	4297753	4297754		yigL	1
ABI843_nonUDG	4299211	4299212		rhtB	1
ABI843_nonUDG	4299651	4299653		rhtB	2
ABI843_nonUDG	4300313	4300315		rhtC	2
ABI843_nonUDG	4300609	4300615		recQ	6
ABI843_nonUDG	4302385	4302386		recQ	1
ABI843_nonUDG	4303032	4303050		pldA	18
ABI843_nonUDG	4303943	4303959		YPO_RS20260	16
ABI843_nonUDG	4304698	4304702		rarD	4
ABI843_nonUDG	4304908	4304911		rarD	3
ABI843_nonUDG	4305949	4305968		corA	19
ABI843_nonUDG	4308794	4308819		YPO_RS20280	25
ABI843_nonUDG	4310961	4310972		uvrD	11
ABI843_nonUDG	4311521	4311525		uvrD	4
ABI843_nonUDG	4312629	4312640		yigB	11
ABI843_nonUDG	4312821	4312836		yigB	15
ABI843_nonUDG	4313099	4313113		xerC	14
ABI843_nonUDG	4315042	4315057		dapF	15
ABI843_nonUDG	4315746	4315754		YPO_RS20315	8
ABI843_nonUDG	4315853	4315854		YPO_RS20315	1
ABI843_nonUDG	4316225	4316226		cyaY	1
ABI843_nonUDG	4317662	4317672		YPO_RS20325	10
ABI843_nonUDG	4318522	4318525		YPO_RS20325	3
ABI843_nonUDG	4320021	4320050		hemC	29
ABI843_nonUDG	4320851	4320863		hemD	12
ABI843_nonUDG	4321277	4321293		hemD	16
ABI843_nonUDG	4321514	4321537		hemX	23
ABI843_nonUDG	4321993	4322004		hemX	11
ABI843_nonUDG	4322527	4322565		hemY	38
ABI843_nonUDG	4322603	4322612		hemY	9
ABI843_nonUDG	4323995	4323996		YPO_RS20355	1
ABI843_nonUDG	4325418	4325423		YPO_RS20365	5
ABI843_nonUDG	4325969	4326007		YPO_RS20380	38
ABI843_nonUDG	4326350	4326366		YPO_RS20380	16
ABI843_nonUDG	4326463	4326477		YPO_RS20380	14
ABI843_nonUDG	4327801	4327811		rffM	10
ABI843_nonUDG	4328848	4328883		wzyE	35
ABI843_nonUDG	4329345	4329350		wzyE	5
ABI843_nonUDG	4330151	4330156		YPO_RS20395	5
ABI843_nonUDG	4330277	4330289		YPO_RS20395	12
ABI843_nonUDG	4330963	4330977		YPO_RS20395	14
ABI843_nonUDG	4331527	4331528		wzxE	1
ABI843_nonUDG	4332438	4332446		rffA	8
ABI843_nonUDG	4333366	4333407		rffA	41
ABI843_nonUDG	4333445	4333453		rffC	8
ABI843_nonUDG	4333857	4333858		rffC	1
ABI843_nonUDG	4334000	4334006		rffC	6
ABI843_nonUDG	4334321	4334332		rfbA	11
ABI843_nonUDG	4336453	4336471		wecC	18
ABI843_nonUDG	4337880	4337883		wecB	3
ABI843_nonUDG	4337917	4337936		wecB	19
ABI843_nonUDG	4339997	4340013		wzzE	16
ABI843_nonUDG	4340523	4340536		wecA	13
ABI843_nonUDG	4340859	4340868		wecA	9
ABI843_nonUDG	4341083	4341088		wecA	5
ABI843_nonUDG	4342009	4342023		rho	14
ABI843_nonUDG	4344446	4344452		rhlB	6
ABI843_nonUDG	4344936	4344943		rhlB	7
ABI843_nonUDG	4347720	4347755		rep	35
ABI843_nonUDG	4348549	4348557		rep	8
ABI843_nonUDG	4348634	4348636		rep	2
ABI843_nonUDG	4351568	4351571		YPO_RS20485	3
ABI843_nonUDG	4351643	4351646		YPO_RS20485	3
ABI843_nonUDG	4353032	4353080		YPO_RS20490	48
ABI843_nonUDG	4354267	4354283		YPO_RS20500	16
ABI843_nonUDG	4354943	4354945		YPO_RS20500	2
ABI843_nonUDG	4354980	4354988		YPO_RS20500	8
ABI843_nonUDG	4356306	4356321		YPO_RS20500	15
ABI843_nonUDG	4356875	4356888		stbD	13
ABI843_nonUDG	4357877	4357891		stbD	14
ABI843_nonUDG	4357880	4357891		YPO_RS20510	11
ABI843_nonUDG	4358210	4358217		YPO_RS20510	7
ABI843_nonUDG	4358401	4358407		YPO_RS20510	6
ABI843_nonUDG	4359678	4359708		YPO_RS20520	30
ABI843_nonUDG	4360282	4360295		YPO_RS20525	13
ABI843_nonUDG	4360522	4360561		YPO_RS20530	39
ABI843_nonUDG	4363575	4363582		ilvC	7
ABI843_nonUDG	4363657	4363659		ilvC	2
ABI843_nonUDG	4365016	4365023		ilvY	7
ABI843_nonUDG	4365229	4365264		YPO_RS20550	35
ABI843_nonUDG	4366798	4366808		YPO_RS20560	10
ABI843_nonUDG	4367062	4367070		YPO_RS20565	8
ABI843_nonUDG	4367607	4367616		YPO_RS20570	9
ABI843_nonUDG	4367723	4367741		YPO_RS20570	18
ABI843_nonUDG	4369151	4369156		ilvA	5
ABI843_nonUDG	4369244	4369278		ilvA	34
ABI843_nonUDG	4371022	4371024		ilvD	2
ABI843_nonUDG	4371883	4371891		ilvD	8
ABI843_nonUDG	4372479	4372499		YPO_RS20590	20
ABI843_nonUDG	4372720	4372765		YPO_RS20590	45
ABI843_nonUDG	4373201	4373202		ilvM	1
ABI843_nonUDG	4374397	4374410		YPO_RS20600	13
ABI843_nonUDG	4376752	4376754		YPO_RS20610	2
ABI843_nonUDG	4378237	4378242		hdfR	5
ABI843_nonUDG	4378948	4378950		yjfF	2
ABI843_nonUDG	4379149	4379167		yjfF	18
ABI843_nonUDG	4379222	4379228		yjfF	6
ABI843_nonUDG	4379545	4379554		yjfF	9
ABI843_nonUDG	4380140	4380145		YPO_RS20630	5
ABI843_nonUDG	4380288	4380292		YPO_RS20630	4
ABI843_nonUDG	4381750	4381755		YPO_RS20635	5
ABI843_nonUDG	4382066	4382067		YPO_RS20635	1
ABI843_nonUDG	4382501	4382512		YPO_RS20640	11
ABI843_nonUDG	4383107	4383112		YPO_RS20640	5
ABI843_nonUDG	4383340	4383351		YPO_RS20640	11
ABI843_nonUDG	4384410	4384411		YPO_RS20645	1
ABI843_nonUDG	4384648	4384650		rrf	2
ABI843_nonUDG	4384855	4384870		YPO_RS20660	15
ABI843_nonUDG	4385525	4385537		YPO_RS20660	12
ABI843_nonUDG	4385622	4385643		YPO_RS20660	21
ABI843_nonUDG	4385880	4385889		YPO_RS20660	9
ABI843_nonUDG	4387062	4387067		YPO_RS20660	5
ABI843_nonUDG	4390301	4390303		murI	2
ABI843_nonUDG	4391275	4391278		btuB	3
ABI843_nonUDG	4391627	4391637		btuB	10
ABI843_nonUDG	4391743	4391749		btuB	6
ABI843_nonUDG	4391907	4391948		btuB	41
ABI843_nonUDG	4392074	4392075		btuB	1
ABI843_nonUDG	4392452	4392453		btuB	1
ABI843_nonUDG	4394305	4394309		trmA	4
ABI843_nonUDG	4396866	4396877		sthA	11
ABI843_nonUDG	4397587	4397616		oxyR	29
ABI843_nonUDG	4397905	4397906		oxyR	1
ABI843_nonUDG	4398732	4398733		YPO_RS20715	1
ABI843_nonUDG	4399532	4399539		YPO_RS20720	7
ABI843_nonUDG	4399648	4399666		YPO_RS20720	18
ABI843_nonUDG	4403119	4403123		YPO_RS20735	4
ABI843_nonUDG	4403243	4403254		YPO_RS20735	11
ABI843_nonUDG	4403712	4403714		YPO_RS20735	2
ABI843_nonUDG	4404021	4404035		YPO_RS20735	14
ABI843_nonUDG	4407768	4407791		YPO_RS20745	23
ABI843_nonUDG	4408128	4408192		YPO_RS20745	64
ABI843_nonUDG	4410699	4410727		argB	28
ABI843_nonUDG	4411768	4411788		argC	20
ABI843_nonUDG	4412910	4412968		argE	58
ABI843_nonUDG	4414650	4414656		ppc	6
ABI843_nonUDG	4415428	4415432		ppc	4
ABI843_nonUDG	4416373	4416379		ppc	6
ABI843_nonUDG	4418739	4418750		YPO_RS20775	11
ABI843_nonUDG	4421261	4421267		glpD	6
ABI843_nonUDG	4421326	4421327		glpD	1
ABI843_nonUDG	4421604	4421613		glpD	9
ABI843_nonUDG	4421704	4421707		glpD	3
ABI843_nonUDG	4421969	4421982		glpD	13
ABI843_nonUDG	4422577	4422584		glpD	7
ABI843_nonUDG	4424204	4424232		glgP	28
ABI843_nonUDG	4424733	4424739		glgP	6
ABI843_nonUDG	4425133	4425137		glgP	4
ABI843_nonUDG	4425272	4425289		glgP	17
ABI843_nonUDG	4425554	4425586		glgA	32
ABI843_nonUDG	4425743	4425746		glgA	3
ABI843_nonUDG	4426597	4426609		glgA	12
ABI843_nonUDG	4428539	4428555		glgX	16
ABI843_nonUDG	4428653	4428669		glgX	16
ABI843_nonUDG	4429436	4429442		glgX	6
ABI843_nonUDG	4429503	4429515		glgX	12
ABI843_nonUDG	4429724	4429731		glgX	7
ABI843_nonUDG	4430486	4430488		glgB	2
ABI843_nonUDG	4433388	4433396		YPO_RS20825	8
ABI843_nonUDG	4433632	4433637		YPO_RS20825	5
ABI843_nonUDG	4435121	4435153		YPO_RS20830	32
ABI843_nonUDG	4435240	4435243		YPO_RS20830	3
ABI843_nonUDG	4435444	4435449		YPO_RS20830	5
ABI843_nonUDG	4435595	4435596		YPO_RS20830	1
ABI843_nonUDG	4435669	4435683		YPO_RS20830	14
ABI843_nonUDG	4435911	4435916		YPO_RS20830	5
ABI843_nonUDG	4436002	4436005		YPO_RS20830	3
ABI843_nonUDG	4436943	4436952		YPO_RS20830	9
ABI843_nonUDG	4437246	4437262		YPO_RS20830	16
ABI843_nonUDG	4437798	4437815		YPO_RS20830	17
ABI843_nonUDG	4438042	4438048		YPO_RS20830	6
ABI843_nonUDG	4438177	4438195		YPO_RS20830	18
ABI843_nonUDG	4438335	4438363		YPO_RS20830	28
ABI843_nonUDG	4438662	4438669		YPO_RS20830	7
ABI843_nonUDG	4438946	4438953		YPO_RS20830	7
ABI843_nonUDG	4439081	4439119		YPO_RS20830	38
ABI843_nonUDG	4440142	4440163		YPO_RS20830	21
ABI843_nonUDG	4440388	4440390		YPO_RS20830	2
ABI843_nonUDG	4440650	4440662		YPO_RS20830	12
ABI843_nonUDG	4441106	4441110		YPO_RS20830	4
ABI843_nonUDG	4441227	4441249		YPO_RS20830	22
ABI843_nonUDG	4441819	4441841		YPO_RS20830	22
ABI843_nonUDG	4441988	4441992		YPO_RS20830	4
ABI843_nonUDG	4442185	4442218		YPO_RS20830	33
ABI843_nonUDG	4442503	4442514		YPO_RS20830	11
ABI843_nonUDG	4442895	4442897		YPO_RS20830	2
ABI843_nonUDG	4442936	4442942		YPO_RS20830	6
ABI843_nonUDG	4443052	4443054		YPO_RS20830	2
ABI843_nonUDG	4446401	4446413		YPO_RS20850	12
ABI843_nonUDG	4447546	4447566		asd	20
ABI843_nonUDG	4453537	4453539		gntR	2
ABI843_nonUDG	4454678	4454682		YPO_RS20900	4
ABI843_nonUDG	4458149	4458152		YPO_RS20920	3
ABI843_nonUDG	4458244	4458260		YPO_RS20920	16
ABI843_nonUDG	4458388	4458390		YPO_RS20920	2
ABI843_nonUDG	4459590	4459607		YPO_RS20925	17
ABI843_nonUDG	4459917	4459918		YPO_RS20930	1
ABI843_nonUDG	4460476	4460477		YPO_RS20930	1
ABI843_nonUDG	4460937	4460948		YPO_RS20935	11
ABI843_nonUDG	4461194	4461214		YPO_RS20935	20
ABI843_nonUDG	4461581	4461585		YPO_RS20935	4
ABI843_nonUDG	4462179	4462180		YPO_RS20935	1
ABI843_nonUDG	4462884	4462888		YPO_RS20940	4
ABI843_nonUDG	4463811	4463837		YPO_RS20940	26
ABI843_nonUDG	4464517	4464549		YPO_RS20940	32
ABI843_nonUDG	4464705	4464722		YPO_RS20940	17
ABI843_nonUDG	4464923	4464926		YPO_RS20940	3
ABI843_nonUDG	4468906	4468924		YPO_RS20955	18
ABI843_nonUDG	4471337	4471351		gdhA	14
ABI843_nonUDG	4472976	4472988		YPO_RS20975	12
ABI843_nonUDG	4473632	4473648		YPO_RS20975	16
ABI843_nonUDG	4474508	4474524		rsmJ	16
ABI843_nonUDG	4476345	4476366		prlC	21
ABI843_nonUDG	4478383	4478392		gorA	9
ABI843_nonUDG	4478882	4478895		gorA	13
ABI843_nonUDG	4480898	4480901		YPO_RS21010	3
ABI843_nonUDG	4481973	4481978		YPO_RS21010	5
ABI843_nonUDG	4482571	4482587		YPO_RS21015	16
ABI843_nonUDG	4483758	4483761		YPO_RS21020	3
ABI843_nonUDG	4484474	4484485		YPO_RS21025	11
ABI843_nonUDG	4484750	4484752		YPO_RS21030	2
ABI843_nonUDG	4484831	4484862		YPO_RS21030	31
ABI843_nonUDG	4485010	4485014		YPO_RS21030	4
ABI843_nonUDG	4485259	4485295		YPO_RS21030	36
ABI843_nonUDG	4486579	4486603		yapE	24
ABI843_nonUDG	4487119	4487130		yapE	11
ABI843_nonUDG	4487783	4487796		yapE	13
ABI843_nonUDG	4488684	4488690		yapE	6
ABI843_nonUDG	4490782	4490806		YPO_RS21045	24
ABI843_nonUDG	4491396	4491399		YPO_RS21050	3
ABI843_nonUDG	4491809	4491825		YPO_RS21050	16
ABI843_nonUDG	4492586	4492601		YPO_RS21050	15
ABI843_nonUDG	4494430	4494436		pdeH	6
ABI843_nonUDG	4495484	4495486		YPO_RS21065	2
ABI843_nonUDG	4496807	4496828		YPO_RS21070	21
ABI843_nonUDG	4497138	4497145		YPO_RS21070	7
ABI843_nonUDG	4498457	4498468		YPO_RS21075	11
ABI843_nonUDG	4501562	4501581		YPO_RS21085	19
ABI843_nonUDG	4502231	4502261		YPO_RS21085	30
ABI843_nonUDG	4502372	4502385		YPO_RS21085	13
ABI843_nonUDG	4502668	4502671		YPO_RS21090	3
ABI843_nonUDG	4504267	4504272		hmsP	5
ABI843_nonUDG	4504336	4504341		hmsP	5
ABI843_nonUDG	4504585	4504599		hmsP	14
ABI843_nonUDG	4505522	4505530		hmsP	8
ABI843_nonUDG	4506364	4506393		bcsZ	29
ABI843_nonUDG	4507017	4507029		bcsZ	12
ABI843_nonUDG	4507643	4507647		YPO_RS21110	4
ABI843_nonUDG	4508635	4508640		dppD	5
ABI843_nonUDG	4508786	4508793		dppD	7
ABI843_nonUDG	4509152	4509166		dppD	14
ABI843_nonUDG	4509600	4509606		dppD	6
ABI843_nonUDG	4509620	4509626		dppC	6
ABI843_nonUDG	4510605	4510616		dppB	11
ABI843_nonUDG	4510807	4510837		dppB	30
ABI843_nonUDG	4511097	4511133		dppB	36
ABI843_nonUDG	4511439	4511450		dppB	11
ABI843_nonUDG	4511834	4511847		YPO_RS21130	13
ABI843_nonUDG	4512561	4512565		YPO_RS21130	4
ABI843_nonUDG	4513016	4513017		YPO_RS21130	1
ABI843_nonUDG	4514623	4514630		YPO_RS21135	7
ABI843_nonUDG	4515009	4515021		YPO_RS21135	12
ABI843_nonUDG	4516049	4516071		YPO_RS21140	22
ABI843_nonUDG	4516120	4516135		YPO_RS21140	15
ABI843_nonUDG	4516215	4516238		YPO_RS21140	23
ABI843_nonUDG	4516335	4516366		YPO_RS21140	31
ABI843_nonUDG	4516573	4516576		YPO_RS21140	3
ABI843_nonUDG	4516697	4516745		YPO_RS21140	48
ABI843_nonUDG	4517181	4517191		YPO_RS21140	10
ABI843_nonUDG	4517262	4517265		YPO_RS21140	3
ABI843_nonUDG	4518756	4518757		YPO_RS21150	1
ABI843_nonUDG	4519028	4519045		YPO_RS21150	17
ABI843_nonUDG	4519142	4519151		YPO_RS21150	9
ABI843_nonUDG	4519561	4519566		YPO_RS21155	5
ABI843_nonUDG	4520121	4520135		YPO_RS21160	14
ABI843_nonUDG	4520537	4520553		YPO_RS21160	16
ABI843_nonUDG	4520649	4520684		YPO_RS21160	35
ABI843_nonUDG	4521399	4521439		YPO_RS21165	40
ABI843_nonUDG	4521644	4521649		YPO_RS21165	5
ABI843_nonUDG	4523154	4523164		uhpA	10
ABI843_nonUDG	4524392	4524398		eptB	6
ABI843_nonUDG	4524455	4524482		eptB	27
ABI843_nonUDG	4525871	4525872		YPO_RS21185	1
ABI843_nonUDG	4527094	4527121		YPO_RS21185	27
ABI843_nonUDG	4527773	4527786		YPO_RS21190	13
ABI843_nonUDG	4528309	4528339		YPO_RS21190	30
ABI843_nonUDG	4528674	4528678		YPO_RS21190	4
ABI843_nonUDG	4530918	4530921		hutH	3
ABI843_nonUDG	4531736	4531744		hutU	8
ABI843_nonUDG	4531995	4532025		hutU	30
ABI843_nonUDG	4533627	4533642		YPO_RS21205	15
ABI843_nonUDG	4534888	4534892		YPO_RS21210	4
ABI843_nonUDG	4535013	4535016		YPO_RS21215	3
ABI843_nonUDG	4535230	4535232		YPO_RS21215	2
ABI843_nonUDG	4535358	4535361		YPO_RS21215	3
ABI843_nonUDG	4536734	4536742		YPO_RS21220	8
ABI843_nonUDG	4537894	4537901		YPO_RS21225	7
ABI843_nonUDG	4538708	4538713		YPO_RS21230	5
ABI843_nonUDG	4540380	4540395		YPO_RS21235	15
ABI843_nonUDG	4540488	4540490		YPO_RS21235	2
ABI843_nonUDG	4540665	4540669		YPO_RS21240	4
ABI843_nonUDG	4544749	4544751		YPO_RS21275	2
ABI843_nonUDG	4544829	4544845		YPO_RS21275	16
ABI843_nonUDG	4545343	4545355		YPO_RS21280	12
ABI843_nonUDG	4545414	4545437		YPO_RS21280	23
ABI843_nonUDG	4545671	4545704		YPO_RS21280	33
ABI843_nonUDG	4546776	4546784		YPO_RS21285	8
ABI843_nonUDG	4547802	4547806		YPO_RS21285	4
ABI843_nonUDG	4549574	4549576		YPO_RS21300	2
ABI843_nonUDG	4550254	4550283		YPO_RS21300	29
ABI843_nonUDG	4551453	4551465		YPO_RS21305	12
ABI843_nonUDG	4551770	4551772		YPO_RS21305	2
ABI843_nonUDG	4552730	4552738		xylF	8
ABI843_nonUDG	4555288	4555297		xylB	9
ABI843_nonUDG	4555996	4556003		xylB	7
ABI843_nonUDG	4556611	4556624		xylB	13
ABI843_nonUDG	4557591	4557602		YPO_RS21325	11
ABI843_nonUDG	4558133	4558143		YPO_RS21330	10
ABI843_nonUDG	4558495	4558510		YPO_RS21330	15
ABI843_nonUDG	4561310	4561317		YPO_RS21340	7
ABI843_nonUDG	4562838	4562845		YPO_RS21345	7
ABI843_nonUDG	4563661	4563666		YPO_RS21345	5
ABI843_nonUDG	4564258	4564260		YPO_RS21355	2
ABI843_nonUDG	4564946	4565004		YPO_RS21355	58
ABI843_nonUDG	4565045	4565051		YPO_RS21355	6
ABI843_nonUDG	4565166	4565169		YPO_RS21355	3
ABI843_nonUDG	4566121	4566136		YPO_RS21360	15
ABI843_nonUDG	4566586	4566596		YPO_RS21360	10
ABI843_nonUDG	4566847	4566861		YPO_RS21360	14
ABI843_nonUDG	4567002	4567023		YPO_RS21360	21
ABI843_nonUDG	4567921	4567969		YPO_RS21375	48
ABI843_nonUDG	4568398	4568412		YPO_RS21375	14
ABI843_nonUDG	4570161	4570177		selB	16
ABI843_nonUDG	4570697	4570703		selB	6
ABI843_nonUDG	4570749	4570765		selB	16
ABI843_nonUDG	4570924	4570934		selB	10
ABI843_nonUDG	4571294	4571297		YPO_RS21395	3
ABI843_nonUDG	4574994	4574999		fdxH	5
ABI843_nonUDG	4575297	4575299		fdxH	2
ABI843_nonUDG	4575538	4575547		fdxH	9
ABI843_nonUDG	4575880	4575883		fdnG	3
ABI843_nonUDG	4576517	4576520		fdnG	3
ABI843_nonUDG	4581821	4581830		YPO_RS21435	9
ABI843_nonUDG	4581953	4581956		YPO_RS21435	3
ABI843_nonUDG	4587137	4587171		YPO_RS21460	34
ABI843_nonUDG	4587665	4587670		YPO_RS21465	5
ABI843_nonUDG	4587718	4587719		YPO_RS21465	1
ABI843_nonUDG	4587943	4587948		YPO_RS21465	5
ABI843_nonUDG	4590884	4590898		YPO_RS21475	14
ABI843_nonUDG	4592054	4592055		glyS	1
ABI843_nonUDG	4592212	4592216		glyS	4
ABI843_nonUDG	4596277	4596279		YPO_RS21500	2
ABI843_nonUDG	4598328	4598329		ghrB	1
ABI843_nonUDG	4598743	4598745		ghrB	2
ABI843_nonUDG	4599474	4599476		YPO_RS21515	2
ABI843_nonUDG	4601703	4601738		YPO_RS21520	35
ABI843_nonUDG	4601920	4601935		YPO_RS21520	15
ABI843_nonUDG	4603101	4603129		YPO_RS21525	28
ABI843_nonUDG	4605523	4605537		YPO_RS21530	14
ABI843_nonUDG	4606155	4606174		ibpB	19
ABI843_nonUDG	4606311	4606319		ibpB	8
ABI843_nonUDG	4607085	4607087		ibpA	2
ABI843_nonUDG	4608785	4608803		YPO_RS21555	18
ABI843_nonUDG	4608878	4608894		YPO_RS21555	16
ABI843_nonUDG	4609443	4609451		YPO_RS21555	8
ABI843_nonUDG	4611717	4611754		YPO_RS21565	37
ABI843_nonUDG	4611827	4611847		YPO_RS21565	20
ABI843_nonUDG	4611980	4612044		YPO_RS21565	64
ABI843_nonUDG	4614306	4614343		gyrB	37
ABI843_nonUDG	4615291	4615302		gyrB	11
ABI843_nonUDG	4616017	4616027		recF	10
ABI843_nonUDG	4617779	4617800		dnaN	21
ABI843_nonUDG	4618042	4618055		dnaN	13
ABI843_nonUDG	4619252	4619257		dnaA	5
ABI843_nonUDG	4619575	4619581		dnaA	6
ABI843_nonUDG	4620967	4620980		yidD	13
ABI843_nonUDG	4622611	4622644		yidC	33
ABI843_nonUDG	4624090	4624091		mnmE	1
ABI843_nonUDG	4625373	4625393		YPO_RS21620	20
ABI843_nonUDG	4625533	4625544		YPO_RS21620	11
ABI843_nonUDG	4626618	4626631		YPO_RS21635	13
ABI843_nonUDG	4626914	4626950		YPO_RS21635	36
ABI843_nonUDG	4626983	4626990		YPO_RS21635	7
ABI843_nonUDG	4629585	4629591		yieH	6
ABI843_nonUDG	4630877	4630889		YPO_RS21655	12
ABI843_nonUDG	4632282	4632301		YPO_RS21665	19
ABI843_nonUDG	4632528	4632549		YPO_RS21665	21
ABI843_nonUDG	4632656	4632663		YPO_RS21665	7
ABI843_nonUDG	4633222	4633228		YPO_RS21670	6
ABI843_nonUDG	4634121	4634127		phoU	6
ABI843_nonUDG	4634549	4634560		phoU	11
ABI843_nonUDG	4635072	4635075		pstB	3
ABI843_nonUDG	4635286	4635289		pstB	3
ABI843_nonUDG	4635750	4635755		pstA	5
ABI843_nonUDG	4636277	4636288		pstA	11
ABI843_nonUDG	4637203	4637223		pstC	20
ABI843_nonUDG	4639761	4639773		glmS	12
ABI843_nonUDG	4643403	4643411		atpC	8
ABI843_nonUDG	4643937	4643951		atpD	14
ABI843_nonUDG	4644124	4644143		atpD	19
ABI843_nonUDG	4644260	4644279		atpD	19
ABI843_nonUDG	4644600	4644605		atpD	5
ABI843_nonUDG	4645548	4645561		atpG	13
ABI843_nonUDG	4647516	4647518		atpA	2
ABI843_nonUDG	4648780	4648807		atpE	27
ABI843_nonUDG	4649443	4649445		atpB	2
ABI843_nonUDG	4649829	4649839		atpB	10
ABI843_nonUDG	4651131	4651155		rsmG	24
ABI843_nonUDG	4652327	4652338		mnmG	11
ABI843_nonUDG	4653426	4653434		mnmG	8
ABI843_nonUDG	4653516	4653525		mnmG	9
ABI910_6POST	535	536		mioC	1
ABI910_6POST	932	957		asnC	25
ABI910_6POST	1793	1814		YPO_RS01015	21
ABI910_6POST	2103	2109		YPO_RS01015	6
ABI910_6POST	2377	2393		YPO_RS01015	16
ABI910_6POST	2771	2794		viaA	23
ABI910_6POST	3170	3176		viaA	6
ABI910_6POST	3905	3924		viaA	19
ABI910_6POST	4088	4090		ravA	2
ABI910_6POST	5036	5053		ravA	17
ABI910_6POST	5326	5331		ravA	5
ABI910_6POST	6026	6034		kup	8
ABI910_6POST	6165	6199		kup	34
ABI910_6POST	6656	6670		kup	14
ABI910_6POST	6707	6716		kup	9
ABI910_6POST	6850	6871		kup	21
ABI910_6POST	7231	7237		kup	6
ABI910_6POST	7974	7983		rbsD	9
ABI910_6POST	8373	8389		rbsK	16
ABI910_6POST	8810	8820		rbsK	10
ABI910_6POST	9044	9066		rbsK	22
ABI910_6POST	9952	9961		YPO_RS01055	9
ABI910_6POST	10311	10316		YPO_RS01055	5
ABI910_6POST	10443	10489		YPO_RS01055	46
ABI910_6POST	12927	12935		YPO_RS01070	8
ABI910_6POST	13730	13736		YPO_RS01070	6
ABI910_6POST	14930	14944		YPO_RS01080	14
ABI910_6POST	15216	15219		YPO_RS01080	3
ABI910_6POST	17318	17324		rrf	6
ABI910_6POST	17931	17948		YPO_RS01090	17
ABI910_6POST	18167	18258		YPO_RS01090	91
ABI910_6POST	18363	18377		YPO_RS01090	14
ABI910_6POST	18457	18486		YPO_RS01090	29
ABI910_6POST	18693	18713		YPO_RS01090	20
ABI910_6POST	19006	19048		YPO_RS01090	42
ABI910_6POST	19915	19931		mobA	16
ABI910_6POST	19996	20025		mobA	29
ABI910_6POST	20055	20067		mobA	12
ABI910_6POST	20171	20173		mobA	2
ABI910_6POST	20643	20645		YPO_RS01105	2
ABI910_6POST	20991	20996		YPO_RS01110	5
ABI910_6POST	21618	21629		YPO_RS01110	11
ABI910_6POST	21746	21753		YPO_RS01110	7
ABI910_6POST	21817	21827		dsbA	10
ABI910_6POST	22153	22155		dsbA	2
ABI910_6POST	22968	22992		polA	24
ABI910_6POST	23322	23328		polA	6
ABI910_6POST	23723	23731		polA	8
ABI910_6POST	24012	24032		polA	20
ABI910_6POST	24921	24928		polA	7
ABI910_6POST	24979	25025		polA	46
ABI910_6POST	26129	26137		YPO_RS01125	8
ABI910_6POST	26216	26219		YPO_RS01125	3
ABI910_6POST	26445	26456		YPO_RS01125	11
ABI910_6POST	26550	26559		YPO_RS01125	9
ABI910_6POST	27235	27239		YPO_RS01130	4
ABI910_6POST	29307	29327		hemN	20
ABI910_6POST	29431	29432		hemN	1
ABI910_6POST	29911	29913		hemN	2
ABI910_6POST	29949	29966		hemN	17
ABI910_6POST	30285	30299		hemN	14
ABI910_6POST	31032	31046		glnG	14
ABI910_6POST	31141	31170		glnG	29
ABI910_6POST	31234	31235		glnG	1
ABI910_6POST	31463	31475		glnG	12
ABI910_6POST	31939	31972		glnL	33
ABI910_6POST	36193	36210		typA	17
ABI910_6POST	36334	36373		typA	39
ABI910_6POST	36718	36730		typA	12
ABI910_6POST	37700	37703		yihX	3
ABI910_6POST	38069	38080		YPO_RS01170	11
ABI910_6POST	38240	38257		YPO_RS01170	17
ABI910_6POST	38664	38670		YPO_RS01170	6
ABI910_6POST	38971	38982		dtd	11
ABI910_6POST	39189	39207		dtd	18
ABI910_6POST	39336	39357		YPO_RS01180	21
ABI910_6POST	39418	39429		YPO_RS01180	11
ABI910_6POST	39514	39521		YPO_RS01180	7
ABI910_6POST	39720	39783		YPO_RS01180	63
ABI910_6POST	39921	39922		YPO_RS01180	1
ABI910_6POST	40020	40055		YPO_RS01180	35
ABI910_6POST	40231	40237		YPO_RS01185	6
ABI910_6POST	40336	40352		YPO_RS01185	16
ABI910_6POST	40399	40477		YPO_RS01185	78
ABI910_6POST	40519	40548		YPO_RS01185	29
ABI910_6POST	40863	40878		YPO_RS01185	15
ABI910_6POST	40979	41050		YPO_RS01185	71
ABI910_6POST	41691	41706		fabY	15
ABI910_6POST	41930	41944		fabY	14
ABI910_6POST	42268	42275		fabY	7
ABI910_6POST	42495	42497		YPO_RS01195	2
ABI910_6POST	42557	42583		YPO_RS01195	26
ABI910_6POST	42726	42742		YPO_RS01195	16
ABI910_6POST	42805	42809		YPO_RS01195	4
ABI910_6POST	42866	42875		YPO_RS01195	9
ABI910_6POST	42989	42997		YPO_RS01195	8
ABI910_6POST	43069	43088		YPO_RS01195	19
ABI910_6POST	43613	43620		YPO_RS01195	7
ABI910_6POST	44044	44064		YPO_RS01195	20
ABI910_6POST	44451	44463		YPO_RS01200	12
ABI910_6POST	44602	44605		YPO_RS01200	3
ABI910_6POST	44730	44747		YPO_RS01200	17
ABI910_6POST	44819	44842		YPO_RS01200	23
ABI910_6POST	45086	45100		YPO_RS01200	14
ABI910_6POST	45222	45237		YPO_RS01200	15
ABI910_6POST	45615	45619		YPO_RS01200	4
ABI910_6POST	46300	46320		gltS	20
ABI910_6POST	46363	46371		gltS	8
ABI910_6POST	46938	46963		gltS	25
ABI910_6POST	48172	48177		recG	5
ABI910_6POST	48286	48299		recG	13
ABI910_6POST	48878	48889		recG	11
ABI910_6POST	49350	49352		recG	2
ABI910_6POST	49571	49581		recG	10
ABI910_6POST	49714	49733		trmH	19
ABI910_6POST	49955	49958		trmH	3
ABI910_6POST	50191	50199		trmH	8
ABI910_6POST	50648	50678		spoT	30
ABI910_6POST	51381	51389		spoT	8
ABI910_6POST	51570	51571		spoT	1
ABI910_6POST	52183	52185		spoT	2
ABI910_6POST	53787	53805		ligB	18
ABI910_6POST	53843	53875		ligB	32
ABI910_6POST	54391	54421		ligB	30
ABI910_6POST	54683	54704		ligB	21
ABI910_6POST	54928	54938		ligB	10
ABI910_6POST	55077	55090		ligB	13
ABI910_6POST	55436	55441		ligB	5
ABI910_6POST	56904	56926		YPO_RS01250	22
ABI910_6POST	57336	57346		YPO_RS01250	10
ABI910_6POST	57872	57899		rph	27
ABI910_6POST	58473	58480		pyrE	7
ABI910_6POST	58744	58771		pyrE	27
ABI910_6POST	59593	59598		slmA	5
ABI910_6POST	59645	59657		slmA	12
ABI910_6POST	60406	60411		coaBC	5
ABI910_6POST	60469	60474		coaBC	5
ABI910_6POST	61082	61101		coaBC	19
ABI910_6POST	61280	61288		coaBC	8
ABI910_6POST	63061	63076		rpmG	15
ABI910_6POST	63896	63911		mutM	15
ABI910_6POST	64161	64178		coaD	17
ABI910_6POST	67141	67160		rfaC	19
ABI910_6POST	68202	68203		rfaF	1
ABI910_6POST	68906	68908		rfaF	2
ABI910_6POST	69105	69117		rfaD	12
ABI910_6POST	69588	69605		rfaD	17
ABI910_6POST	69833	69837		rfaD	4
ABI910_6POST	70862	70867		YPO_RS01335	5
ABI910_6POST	71290	71293		YPO_RS01335	3
ABI910_6POST	71581	71585		tdh	4
ABI910_6POST	71688	71698		tdh	10
ABI910_6POST	71966	71972		tdh	6
ABI910_6POST	72031	72038		tdh	7
ABI910_6POST	73550	73553		envC	3
ABI910_6POST	73624	73629		envC	5
ABI910_6POST	73801	73803		envC	2
ABI910_6POST	74408	74414		envC	6
ABI910_6POST	75044	75073		gpmM	29
ABI910_6POST	76332	76364		gpmM	32
ABI910_6POST	77237	77238		YPO_RS01360	1
ABI910_6POST	77406	77407		grxC	1
ABI910_6POST	77552	77570		grxC	18
ABI910_6POST	77806	77812		secB	6
ABI910_6POST	78184	78197		secB	13
ABI910_6POST	78307	78325		gpsA	18
ABI910_6POST	78378	78379		gpsA	1
ABI910_6POST	78913	78917		gpsA	4
ABI910_6POST	79964	79970		cysE	6
ABI910_6POST	80173	80195		cysE	22
ABI910_6POST	81330	81334		ada	4
ABI910_6POST	81421	81423		ada	2
ABI910_6POST	81928	81933		ada	5
ABI910_6POST	82178	82186		ada	8
ABI910_6POST	82500	82514		cpxA	14
ABI910_6POST	82586	82598		cpxA	12
ABI910_6POST	82952	82954		cpxA	2
ABI910_6POST	85542	85588		YPO_RS01415	46
ABI910_6POST	85893	85897		YPO_RS01420	4
ABI910_6POST	87751	87759		fieF	8
ABI910_6POST	87993	88011		fieF	18
ABI910_6POST	88305	88324		pfkA	19
ABI910_6POST	88354	88359		pfkA	5
ABI910_6POST	89092	89108		pfkA	16
ABI910_6POST	89724	89755		YPO_RS01435	31
ABI910_6POST	91444	91456		YPO_RS01440	12
ABI910_6POST	91835	91848		YPO_RS01445	13
ABI910_6POST	92597	92599		YPO_RS01445	2
ABI910_6POST	92826	92834		YPO_RS01445	8
ABI910_6POST	93008	93024		YPO_RS01445	16
ABI910_6POST	94175	94190		YPO_RS01455	15
ABI910_6POST	94474	94495		YPO_RS01455	21
ABI910_6POST	95161	95162		YPO_RS01460	1
ABI910_6POST	95689	95700		YPO_RS01460	11
ABI910_6POST	95806	95833		YPO_RS01460	27
ABI910_6POST	96816	96818		tpiA	2
ABI910_6POST	97155	97169		YPO_RS01470	14
ABI910_6POST	97573	97582		YPO_RS01470	9
ABI910_6POST	97862	97863		YPO_RS01475	1
ABI910_6POST	98044	98087		YPO_RS01475	43
ABI910_6POST	98138	98141		YPO_RS01475	3
ABI910_6POST	98639	98640		fpr	1
ABI910_6POST	98953	98956		fpr	3
ABI910_6POST	99110	99124		fpr	14
ABI910_6POST	101725	101729		YPO_RS01495	4
ABI910_6POST	101777	101831		YPO_RS01495	54
ABI910_6POST	101882	101885		YPO_RS01495	3
ABI910_6POST	101993	101999		YPO_RS01495	6
ABI910_6POST	103075	103088		zapB	13
ABI910_6POST	103912	103913		YPO_RS01505	1
ABI910_6POST	105645	105667		YPO_RS01515	22
ABI910_6POST	105732	105755		YPO_RS01515	23
ABI910_6POST	106088	106107		YPO_RS01515	19
ABI910_6POST	106306	106348		YPO_RS01515	42
ABI910_6POST	106469	106480		YPO_RS01520	11
ABI910_6POST	106537	106545		YPO_RS01520	8
ABI910_6POST	106576	106586		YPO_RS01520	10
ABI910_6POST	106731	106779		YPO_RS01520	48
ABI910_6POST	106823	106845		YPO_RS01520	22
ABI910_6POST	107054	107062		YPO_RS01520	8
ABI910_6POST	108712	108730		YPO_RS01530	18
ABI910_6POST	109380	109385		YPO_RS01530	5
ABI910_6POST	110089	110097		YPO_RS01535	8
ABI910_6POST	110896	110898		YPO_RS01540	2
ABI910_6POST	111101	111105		YPO_RS01540	4
ABI910_6POST	111189	111211		YPO_RS01540	22
ABI910_6POST	111433	111463		rraA	30
ABI910_6POST	111875	111899		rraA	24
ABI910_6POST	112139	112151		YPO_RS01550	12
ABI910_6POST	112313	112315		YPO_RS01550	2
ABI910_6POST	112823	112835		YPO_RS01550	12
ABI910_6POST	113672	113698		hslU	26
ABI910_6POST	113974	113988		hslU	14
ABI910_6POST	115251	115261		ftsN	10
ABI910_6POST	115303	115323		ftsN	20
ABI910_6POST	115538	115553		ftsN	15
ABI910_6POST	115627	115657		ftsN	30
ABI910_6POST	115771	115785		ftsN	14
ABI910_6POST	116218	116231		cytR	13
ABI910_6POST	116301	116307		cytR	6
ABI910_6POST	117120	117124		cytR	4
ABI910_6POST	117737	117743		priA	6
ABI910_6POST	117826	117842		priA	16
ABI910_6POST	117886	117889		priA	3
ABI910_6POST	118427	118434		priA	7
ABI910_6POST	118486	118516		priA	30
ABI910_6POST	118971	118995		priA	24
ABI910_6POST	119430	119447		priA	17
ABI910_6POST	119580	119582		priA	2
ABI910_6POST	120087	120111		rpmE	24
ABI910_6POST	123422	123442		YPO_RS01600	20
ABI910_6POST	124207	124210		YPO_RS01600	3
ABI910_6POST	124599	124605		YPO_RS01600	6
ABI910_6POST	124700	124731		YPO_RS01600	31
ABI910_6POST	125799	125800		YPO_RS01600	1
ABI910_6POST	126597	126613		metF	16
ABI910_6POST	127413	127428		YPO_RS01610	15
ABI910_6POST	127547	127573		YPO_RS01610	26
ABI910_6POST	127631	127635		YPO_RS01610	4
ABI910_6POST	127671	127676		YPO_RS01610	5
ABI910_6POST	128358	128380		YPO_RS01610	22
ABI910_6POST	128471	128488		YPO_RS01610	17
ABI910_6POST	129172	129173		YPO_RS01615	1
ABI910_6POST	129380	129381		YPO_RS01615	1
ABI910_6POST	129637	129646		glpG	9
ABI910_6POST	129682	129696		glpG	14
ABI910_6POST	129772	129777		glpG	5
ABI910_6POST	129818	129859		glpG	41
ABI910_6POST	129921	129928		glpG	7
ABI910_6POST	129987	129991		glpG	4
ABI910_6POST	130246	130258		glpG	12
ABI910_6POST	130444	130456		glpE	12
ABI910_6POST	131178	131190		malT	12
ABI910_6POST	132152	132158		malT	6
ABI910_6POST	132230	132243		malT	13
ABI910_6POST	132538	132550		malT	12
ABI910_6POST	132653	132657		malT	4
ABI910_6POST	133100	133128		malT	28
ABI910_6POST	133264	133284		malT	20
ABI910_6POST	133357	133383		malT	26
ABI910_6POST	133678	133701		malT	23
ABI910_6POST	134606	134619		malP	13
ABI910_6POST	135235	135242		malP	7
ABI910_6POST	135793	135810		malP	17
ABI910_6POST	136149	136153		malP	4
ABI910_6POST	136643	136656		malQ	13
ABI910_6POST	136917	136941		malQ	24
ABI910_6POST	137091	137093		malQ	2
ABI910_6POST	137432	137445		malQ	13
ABI910_6POST	137693	137704		malQ	11
ABI910_6POST	138259	138266		malQ	7
ABI910_6POST	139012	139020		nfuA	8
ABI910_6POST	139576	139600		gntX	24
ABI910_6POST	139648	139672		gntX	24
ABI910_6POST	139860	139871		gntX	11
ABI910_6POST	139969	139978		gntX	9
ABI910_6POST	140139	140157		gntX	18
ABI910_6POST	140213	140221		gntX	8
ABI910_6POST	140388	140413		bioH	25
ABI910_6POST	140577	140584		bioH	7
ABI910_6POST	140841	140868		bioH	27
ABI910_6POST	141023	141041		bioH	18
ABI910_6POST	141393	141401		YPO_RS01665	8
ABI910_6POST	141841	141849		YPO_RS01670	8
ABI910_6POST	142285	142295		feoB	10
ABI910_6POST	142434	142448		feoB	14
ABI910_6POST	142804	142810		feoB	6
ABI910_6POST	143054	143063		feoB	9
ABI910_6POST	143729	143748		feoB	19
ABI910_6POST	144011	144023		feoB	12
ABI910_6POST	145177	145202		YPO_RS01685	25
ABI910_6POST	146810	146824		YPO_RS01685	14
ABI910_6POST	147100	147136		YPO_RS01685	36
ABI910_6POST	147230	147239		YPO_RS01685	9
ABI910_6POST	148306	148315		greB	9
ABI910_6POST	149898	149915		envZ	17
ABI910_6POST	150480	150485		envZ	5
ABI910_6POST	150592	150593		envZ	1
ABI910_6POST	151317	151349		pckA	32
ABI910_6POST	151409	151423		pckA	14
ABI910_6POST	151555	151556		pckA	1
ABI910_6POST	151663	151665		pckA	2
ABI910_6POST	151763	151776		pckA	13
ABI910_6POST	152957	152968		hslO	11
ABI910_6POST	153363	153383		hslO	20
ABI910_6POST	153495	153501		hslO	6
ABI910_6POST	153578	153579		hslO	1
ABI910_6POST	153917	153934		hslR	17
ABI910_6POST	154301	154304		yrfG	3
ABI910_6POST	154835	154840		yrfG	5
ABI910_6POST	155182	155183		YPO_RS01725	1
ABI910_6POST	155754	155762		YPO_RS01725	8
ABI910_6POST	155842	155857		YPO_RS01725	15
ABI910_6POST	155918	155943		YPO_RS01725	25
ABI910_6POST	156396	156413		YPO_RS01725	17
ABI910_6POST	156907	156930		YPO_RS01725	23
ABI910_6POST	157089	157090		YPO_RS01725	1
ABI910_6POST	157154	157157		YPO_RS01725	3
ABI910_6POST	158596	158617		mrcA	21
ABI910_6POST	158818	158830		mrcA	12
ABI910_6POST	159935	159940		mrcA	5
ABI910_6POST	160848	160859		mrcA	11
ABI910_6POST	161916	161933		YPO_RS01740	17
ABI910_6POST	162290	162292		YPO_RS01745	2
ABI910_6POST	162338	162339		YPO_RS01745	1
ABI910_6POST	162594	162604		YPO_RS01745	10
ABI910_6POST	162602	162604		YPO_RS01750	2
ABI910_6POST	162943	162944		YPO_RS01750	1
ABI910_6POST	163636	163655		hofQ	19
ABI910_6POST	163968	163970		hofQ	2
ABI910_6POST	165527	165532		aroK	5
ABI910_6POST	166092	166098		aroB	6
ABI910_6POST	166366	166371		aroB	5
ABI910_6POST	166802	166812		aroB	10
ABI910_6POST	166961	166973		aroB	12
ABI910_6POST	167462	167465		YPO_RS01775	3
ABI910_6POST	167695	167700		YPO_RS01775	5
ABI910_6POST	168266	168285		YPO_RS01775	19
ABI910_6POST	169624	169627		rpe	3
ABI910_6POST	169770	169774		rpe	4
ABI910_6POST	170693	170698		YPO_RS01790	5
ABI910_6POST	171067	171073		trpS	6
ABI910_6POST	171265	171314		trpS	49
ABI910_6POST	171418	171431		trpS	13
ABI910_6POST	171565	171570		trpS	5
ABI910_6POST	171656	171659		trpS	3
ABI910_6POST	171771	171773		trpS	2
ABI910_6POST	172555	172557		cobA	2
ABI910_6POST	172687	172694		cobA	7
ABI910_6POST	172819	172869		cobA	50
ABI910_6POST	172909	172956		cobA	47
ABI910_6POST	173107	173114		cobA	7
ABI910_6POST	173423	173443		cobA	20
ABI910_6POST	173689	173724		nirC	35
ABI910_6POST	174032	174033		nirC	1
ABI910_6POST	174277	174279		nirC	2
ABI910_6POST	174779	174805		nirD	26
ABI910_6POST	175270	175271		YPO_RS01815	1
ABI910_6POST	176299	176318		YPO_RS01815	19
ABI910_6POST	176511	176523		YPO_RS01815	12
ABI910_6POST	176715	176723		YPO_RS01815	8
ABI910_6POST	176927	176932		YPO_RS01815	5
ABI910_6POST	177179	177195		YPO_RS01815	16
ABI910_6POST	178363	178389		YPO_RS01820	26
ABI910_6POST	178630	178640		YPO_RS01820	10
ABI910_6POST	179373	179391		tsgA	18
ABI910_6POST	179913	179938		tsgA	25
ABI910_6POST	180299	180308		tsgA	9
ABI910_6POST	181121	181134		YPO_RS01830	13
ABI910_6POST	181661	181702		YPO_RS01830	41
ABI910_6POST	181900	181987		YPO_RS01830	87
ABI910_6POST	182400	182423		YPO_RS01830	23
ABI910_6POST	183206	183215		YPO_RS01835	9
ABI910_6POST	183566	183581		YPO_RS01835	15
ABI910_6POST	183641	183650		YPO_RS01835	9
ABI910_6POST	183842	183874		YPO_RS01835	32
ABI910_6POST	184334	184366		YPO_RS01840	32
ABI910_6POST	184488	184505		YPO_RS01840	17
ABI910_6POST	184923	184941		YPO_RS01840	18
ABI910_6POST	185008	185013		YPO_RS01840	5
ABI910_6POST	185493	185497		YPO_RS01840	4
ABI910_6POST	186163	186174		ppiA	11
ABI910_6POST	186469	186482		ppiA	13
ABI910_6POST	187144	187147		YPO_RS01850	3
ABI910_6POST	187241	187264		YPO_RS01850	23
ABI910_6POST	187991	188003		YPO_RS01850	12
ABI910_6POST	188382	188393		YPO_RS01850	11
ABI910_6POST	188857	188900		YPO_RS01855	43
ABI910_6POST	190225	190228		YPO_RS01865	3
ABI910_6POST	190395	190399		YPO_RS01865	4
ABI910_6POST	190488	190527		YPO_RS01865	39
ABI910_6POST	190714	190750		YPO_RS01865	36
ABI910_6POST	190810	190878		YPO_RS01865	68
ABI910_6POST	191030	191049		YPO_RS01865	19
ABI910_6POST	191321	191329		YPO_RS01870	8
ABI910_6POST	191359	191370		YPO_RS01870	11
ABI910_6POST	191491	191516		YPO_RS01870	25
ABI910_6POST	191546	191555		YPO_RS01870	9
ABI910_6POST	191644	191663		YPO_RS01870	19
ABI910_6POST	191782	191841		YPO_RS01870	59
ABI910_6POST	191907	191938		YPO_RS01870	31
ABI910_6POST	192965	192976		YPO_RS01880	11
ABI910_6POST	193043	193057		YPO_RS01880	14
ABI910_6POST	193155	193157		YPO_RS01880	2
ABI910_6POST	193280	193297		YPO_RS01880	17
ABI910_6POST	193435	193436		YPO_RS01880	1
ABI910_6POST	193773	193790		YPO_RS01880	17
ABI910_6POST	194072	194084		YPO_RS01880	12
ABI910_6POST	194630	194645		YPO_RS01880	15
ABI910_6POST	194719	194728		YPO_RS01880	9
ABI910_6POST	194906	194914		YPO_RS01880	8
ABI910_6POST	194961	194965		YPO_RS01880	4
ABI910_6POST	195038	195040		YPO_RS01880	2
ABI910_6POST	195499	195507		crp	8
ABI910_6POST	195605	195622		crp	17
ABI910_6POST	195710	195712		crp	2
ABI910_6POST	196794	196801		YPO_RS01895	7
ABI910_6POST	197248	197277		YPO_RS01900	29
ABI910_6POST	198279	198285		YPO_RS01905	6
ABI910_6POST	198996	199019		YPO_RS01910	23
ABI910_6POST	199379	199394		YPO_RS01910	15
ABI910_6POST	199672	199678		YPO_RS01915	6
ABI910_6POST	200018	200021		YPO_RS01915	3
ABI910_6POST	200842	200859		tauA	17
ABI910_6POST	200968	200986		tauA	18
ABI910_6POST	201479	201487		tauB	8
ABI910_6POST	201561	201562		tauB	1
ABI910_6POST	201624	201644		tauB	20
ABI910_6POST	202077	202082		tauB	5
ABI910_6POST	202471	202485		tauC	14
ABI910_6POST	202571	202578		tauC	7
ABI910_6POST	202789	202801		tauC	12
ABI910_6POST	203233	203235		tauD	2
ABI910_6POST	203342	203348		tauD	6
ABI910_6POST	203571	203587		tauD	16
ABI910_6POST	203944	203983		YPO_RS01940	39
ABI910_6POST	204103	204110		YPO_RS01940	7
ABI910_6POST	204159	204160		YPO_RS01940	1
ABI910_6POST	204229	204235		YPO_RS01940	6
ABI910_6POST	205092	205111		YPO_RS01945	19
ABI910_6POST	205327	205328		YPO_RS01945	1
ABI910_6POST	208331	208333		kefG	2
ABI910_6POST	208569	208573		kefG	4
ABI910_6POST	209457	209468		kefB	11
ABI910_6POST	209660	209687		kefB	27
ABI910_6POST	210760	210766		YPO_RS01965	6
ABI910_6POST	211195	211214		slyD	19
ABI910_6POST	211286	211290		slyD	4
ABI910_6POST	211392	211399		slyD	7
ABI910_6POST	213560	213569		YPO_RS01985	9
ABI910_6POST	215765	215819		rpsG	54
ABI910_6POST	217118	217129		fusA	11
ABI910_6POST	217264	217266		fusA	2
ABI910_6POST	217302	217331		fusA	29
ABI910_6POST	217852	217853		fusA	1
ABI910_6POST	218273	218276		fusA	3
ABI910_6POST	218505	218514		tuf	9
ABI910_6POST	218894	218899		tuf	5
ABI910_6POST	219852	219855		YPO_RS02025	3
ABI910_6POST	221743	221761		rpsJ	18
ABI910_6POST	222406	222408		rplC	2
ABI910_6POST	222487	222495		rplC	8
ABI910_6POST	222565	222584		rplC	19
ABI910_6POST	224841	224854		rplV	13
ABI910_6POST	227392	227393		rplX	1
ABI910_6POST	227974	227983		rplE	9
ABI910_6POST	228349	228363		rpsN	14
ABI910_6POST	228852	228853		rplF	1
ABI910_6POST	229441	229448		rplR	7
ABI910_6POST	229960	229969		rpsE	9
ABI910_6POST	232476	232495		rpsM	19
ABI910_6POST	232687	232702		rpsM	15
ABI910_6POST	232740	232760		rpsM	20
ABI910_6POST	234110	234112		rpoA	2
ABI910_6POST	234439	234450		rpoA	11
ABI910_6POST	234670	234673		rpoA	3
ABI910_6POST	234714	234737		rpoA	23
ABI910_6POST	235890	235894		zntR	4
ABI910_6POST	236354	236355		YPO_RS02185	1
ABI910_6POST	236867	236887		mscL	20
ABI910_6POST	237260	237271		trkA	11
ABI910_6POST	238346	238348		trkA	2
ABI910_6POST	238758	238764		rsmB	6
ABI910_6POST	238968	238971		rsmB	3
ABI910_6POST	239185	239192		rsmB	7
ABI910_6POST	239407	239432		rsmB	25
ABI910_6POST	240347	240364		fmt	17
ABI910_6POST	240755	240756		fmt	1
ABI910_6POST	241273	241274		def	1
ABI910_6POST	241440	241451		def	11
ABI910_6POST	241595	241608		dprA	13
ABI910_6POST	242003	242008		dprA	5
ABI910_6POST	242087	242110		dprA	23
ABI910_6POST	242336	242356		dprA	20
ABI910_6POST	242533	242553		dprA	20
ABI910_6POST	242817	242839		YPO_RS02220	22
ABI910_6POST	243084	243094		YPO_RS02220	10
ABI910_6POST	243153	243156		YPO_RS02220	3
ABI910_6POST	244286	244310		tsaC	24
ABI910_6POST	244475	244488		aroE	13
ABI910_6POST	244739	244766		aroE	27
ABI910_6POST	244916	244922		aroE	6
ABI910_6POST	245454	245455		YPO_RS02240	1
ABI910_6POST	245940	245952		YPO_RS02245	12
ABI910_6POST	246071	246100		YPO_RS02245	29
ABI910_6POST	246130	246137		YPO_RS02245	7
ABI910_6POST	246176	246212		YPO_RS02245	36
ABI910_6POST	246249	246252		YPO_RS02245	3
ABI910_6POST	246297	246341		YPO_RS02245	44
ABI910_6POST	246377	246385		YPO_RS02245	8
ABI910_6POST	246467	246531		YPO_RS02245	64
ABI910_6POST	246618	246628		YPO_RS02250	10
ABI910_6POST	246793	246799		YPO_RS02250	6
ABI910_6POST	246852	246924		YPO_RS02250	72
ABI910_6POST	247267	247284		YPO_RS02250	17
ABI910_6POST	247700	247725		YPO_RS02255	25
ABI910_6POST	247798	247800		YPO_RS02255	2
ABI910_6POST	248226	248239		YPO_RS02255	13
ABI910_6POST	248363	248365		YPO_RS02255	2
ABI910_6POST	248913	248928		actP	15
ABI910_6POST	249439	249450		actP	11
ABI910_6POST	249778	249812		actP	34
ABI910_6POST	249966	249967		actP	1
ABI910_6POST	250290	250316		actP	26
ABI910_6POST	250499	250511		YPO_RS02265	12
ABI910_6POST	251401	251407		acs	6
ABI910_6POST	251757	251783		acs	26
ABI910_6POST	251970	251986		acs	16
ABI910_6POST	252256	252273		acs	17
ABI910_6POST	252501	252523		acs	22
ABI910_6POST	253742	253745		gltP	3
ABI910_6POST	253953	253970		gltP	17
ABI910_6POST	254093	254097		gltP	4
ABI910_6POST	254648	254660		gltP	12
ABI910_6POST	254745	254759		gltP	14
ABI910_6POST	255244	255255		YPO_RS02280	11
ABI910_6POST	255489	255504		YPO_RS02280	15
ABI910_6POST	255586	255604		YPO_RS02280	18
ABI910_6POST	255732	255748		YPO_RS02285	16
ABI910_6POST	256042	256046		YPO_RS02285	4
ABI910_6POST	257061	257071		YPO_RS02285	10
ABI910_6POST	257566	257568		YPO_RS02285	2
ABI910_6POST	257608	257611		YPO_RS02285	3
ABI910_6POST	257976	257987		YPO_RS02285	11
ABI910_6POST	258071	258076		YPO_RS02285	5
ABI910_6POST	258764	258772		YPO_RS02290	8
ABI910_6POST	259029	259031		YPO_RS02290	2
ABI910_6POST	259188	259191		YPO_RS02290	3
ABI910_6POST	259982	259995		YPO_RS02290	13
ABI910_6POST	260154	260158		YPO_RS02290	4
ABI910_6POST	260364	260375		sctD	11
ABI910_6POST	260466	260481		sctD	15
ABI910_6POST	260744	260765		sctD	21
ABI910_6POST	261076	261085		sctD	9
ABI910_6POST	261164	261177		sctD	13
ABI910_6POST	263399	263412		YPO_RS02325	13
ABI910_6POST	263463	263500		YPO_RS02325	37
ABI910_6POST	264253	264306		YPO_RS02330	53
ABI910_6POST	264621	264636		YPO_RS02330	15
ABI910_6POST	264704	264746		YPO_RS02330	42
ABI910_6POST	265044	265050		sctL	6
ABI910_6POST	265258	265263		sctL	5
ABI910_6POST	265681	265713		YPO_RS02340	32
ABI910_6POST	266830	266834		YPO_RS02340	4
ABI910_6POST	266921	266940		YPO_RS02340	19
ABI910_6POST	267182	267245		YPO_RS02340	63
ABI910_6POST	267404	267405		YPO_RS02340	1
ABI910_6POST	267813	267821		YPO_RS02345	8
ABI910_6POST	268050	268075		YPO_RS02345	25
ABI910_6POST	268845	268864		YPO_RS02350	19
ABI910_6POST	269620	269629		YPO_RS02360	9
ABI910_6POST	269773	269776		YPO_RS02360	3
ABI910_6POST	269880	269898		YPO_RS02360	18
ABI910_6POST	269928	269936		YPO_RS02360	8
ABI910_6POST	271523	271539		YPO_RS02370	16
ABI910_6POST	271795	271838		sctT	43
ABI910_6POST	272080	272114		sctT	34
ABI910_6POST	272523	272559		YPO_RS02380	36
ABI910_6POST	273446	273457		YPO_RS02380	11
ABI910_6POST	273892	273899		yedE	7
ABI910_6POST	274335	274340		yedE	5
ABI910_6POST	274438	274440		yedE	2
ABI910_6POST	274928	274970		yedE	42
ABI910_6POST	275532	275534		YPO_RS02395	2
ABI910_6POST	275734	275746		YPO_RS02395	12
ABI910_6POST	275975	275981		YPO_RS02395	6
ABI910_6POST	276054	276073		YPO_RS02395	19
ABI910_6POST	276656	276686		YPO_RS02400	30
ABI910_6POST	276820	276860		YPO_RS02400	40
ABI910_6POST	277093	277101		YPO_RS02400	8
ABI910_6POST	277330	277334		YPO_RS02400	4
ABI910_6POST	277895	277900		metC	5
ABI910_6POST	278268	278270		metC	2
ABI910_6POST	278599	278605		metC	6
ABI910_6POST	278645	278658		metC	13
ABI910_6POST	278895	278910		metC	15
ABI910_6POST	279597	279606		YPO_RS02410	9
ABI910_6POST	279743	279745		YPO_RS02410	2
ABI910_6POST	279789	279800		YPO_RS02410	11
ABI910_6POST	280117	280146		YPO_RS02415	29
ABI910_6POST	280291	280292		YPO_RS02415	1
ABI910_6POST	280382	280383		YPO_RS02415	1
ABI910_6POST	281507	281511		YPO_RS02420	4
ABI910_6POST	282023	282032		YPO_RS02425	9
ABI910_6POST	282345	282369		YPO_RS02425	24
ABI910_6POST	282567	282585		YPO_RS02425	18
ABI910_6POST	283353	283379		YPO_RS02430	26
ABI910_6POST	283449	283462		YPO_RS02430	13
ABI910_6POST	283586	283590		YPO_RS02430	4
ABI910_6POST	283944	283953		YPO_RS02430	9
ABI910_6POST	284143	284146		YPO_RS02430	3
ABI910_6POST	284375	284380		YPO_RS02430	5
ABI910_6POST	284919	284933		YPO_RS02430	14
ABI910_6POST	286336	286339		hutX	3
ABI910_6POST	286725	286746		YPO_RS02450	21
ABI910_6POST	286950	286956		YPO_RS02450	6
ABI910_6POST	287193	287201		YPO_RS02450	8
ABI910_6POST	287476	287485		YPO_RS02450	9
ABI910_6POST	287631	287682		YPO_RS02450	51
ABI910_6POST	288790	288811		YPO_RS02455	21
ABI910_6POST	288906	288922		YPO_RS02455	16
ABI910_6POST	290911	290925		YPO_RS02465	14
ABI910_6POST	291196	291220		YPO_RS02465	24
ABI910_6POST	291293	291296		YPO_RS02470	3
ABI910_6POST	291411	291420		YPO_RS02470	9
ABI910_6POST	291817	291881		YPO_RS02470	64
ABI910_6POST	292354	292363		YPO_RS02475	9
ABI910_6POST	292895	292906		YPO_RS02475	11
ABI910_6POST	293296	293303		YPO_RS02480	7
ABI910_6POST	293473	293481		YPO_RS02480	8
ABI910_6POST	293621	293622		YPO_RS02480	1
ABI910_6POST	293851	293880		YPO_RS02480	29
ABI910_6POST	297036	297045		YPO_RS02495	9
ABI910_6POST	298114	298120		YPO_RS02505	6
ABI910_6POST	300030	300038		YPO_RS02515	8
ABI910_6POST	300323	300349		YPO_RS02515	26
ABI910_6POST	305412	305415		YPO_RS02535	3
ABI910_6POST	305919	305922		YPO_RS02540	3
ABI910_6POST	307661	307664		YPO_RS02550	3
ABI910_6POST	308088	308098		YPO_RS02550	10
ABI910_6POST	308163	308182		YPO_RS02550	19
ABI910_6POST	308487	308491		YPO_RS02550	4
ABI910_6POST	309789	309793		YPO_RS02555	4
ABI910_6POST	310076	310081		YPO_RS02555	5
ABI910_6POST	310117	310132		YPO_RS02555	15
ABI910_6POST	310233	310244		YPO_RS02555	11
ABI910_6POST	310434	310448		YPO_RS02555	14
ABI910_6POST	310530	310548		YPO_RS02555	18
ABI910_6POST	310683	310686		YPO_RS02555	3
ABI910_6POST	310926	310929		YPO_RS02555	3
ABI910_6POST	311240	311246		YPO_RS02555	6
ABI910_6POST	311282	311288		YPO_RS02555	6
ABI910_6POST	311325	311349		YPO_RS02555	24
ABI910_6POST	311688	311699		YPO_RS02555	11
ABI910_6POST	312083	312096		yapK	13
ABI910_6POST	312175	312196		yapK	21
ABI910_6POST	312537	312586		yapK	49
ABI910_6POST	312865	312945		yapK	80
ABI910_6POST	313063	313066		yapK	3
ABI910_6POST	313249	313255		yapK	6
ABI910_6POST	313804	313814		yapK	10
ABI910_6POST	314717	314729		yapK	12
ABI910_6POST	315528	315544		yapK	16
ABI910_6POST	317056	317082		ubiC	26
ABI910_6POST	317638	317656		ubiA	18
ABI910_6POST	317753	317755		ubiA	2
ABI910_6POST	318684	318686		plsB	2
ABI910_6POST	318751	318765		plsB	14
ABI910_6POST	319029	319046		plsB	17
ABI910_6POST	319229	319240		plsB	11
ABI910_6POST	319925	319933		plsB	8
ABI910_6POST	320093	320110		plsB	17
ABI910_6POST	320474	320478		plsB	4
ABI910_6POST	321563	321591		lexA	28
ABI910_6POST	321785	321837		lexA	52
ABI910_6POST	322136	322142		lexA	6
ABI910_6POST	322372	322376		zur	4
ABI910_6POST	323213	323217		dusA	4
ABI910_6POST	323303	323330		dusA	27
ABI910_6POST	323412	323418		dusA	6
ABI910_6POST	323756	323773		dusA	17
ABI910_6POST	324070	324076		dusA	6
ABI910_6POST	325395	325398		YPO_RS02605	3
ABI910_6POST	325643	325656		YPO_RS02605	13
ABI910_6POST	325975	325986		YPO_RS02605	11
ABI910_6POST	326069	326103		YPO_RS02605	34
ABI910_6POST	326937	326938		dnaB	1
ABI910_6POST	327157	327192		dnaB	35
ABI910_6POST	327487	327512		dnaB	25
ABI910_6POST	327898	327903		dnaB	5
ABI910_6POST	328824	328833		alr	9
ABI910_6POST	329827	329868		YPO_RS02620	41
ABI910_6POST	331025	331031		YPO_RS02625	6
ABI910_6POST	331543	331546		uvrA	3
ABI910_6POST	331826	331829		uvrA	3
ABI910_6POST	332163	332170		uvrA	7
ABI910_6POST	332431	332434		uvrA	3
ABI910_6POST	332492	332506		uvrA	14
ABI910_6POST	332992	332998		uvrA	6
ABI910_6POST	333144	333203		uvrA	59
ABI910_6POST	333971	333987		uvrA	16
ABI910_6POST	334839	334848		ssb1	9
ABI910_6POST	334927	334942		ssb1	15
ABI910_6POST	335134	335140		ssb1	6
ABI910_6POST	335980	335991		fucO	11
ABI910_6POST	336087	336094		fucO	7
ABI910_6POST	336346	336352		fucO	6
ABI910_6POST	336508	336512		fucO	4
ABI910_6POST	336641	336647		fucO	6
ABI910_6POST	336709	336728		fucO	19
ABI910_6POST	336806	336827		fucO	21
ABI910_6POST	337526	337572		rhaD	46
ABI910_6POST	338111	338117		YPO_RS02655	6
ABI910_6POST	338606	338610		YPO_RS02655	4
ABI910_6POST	338886	338891		YPO_RS02655	5
ABI910_6POST	339051	339086		YPO_RS02655	35
ABI910_6POST	339827	339838		rhaB	11
ABI910_6POST	339876	339884		rhaB	8
ABI910_6POST	340156	340179		rhaB	23
ABI910_6POST	340587	340591		rhaB	4
ABI910_6POST	340691	340713		YPO_RS02665	22
ABI910_6POST	341388	341396		rhaS	8
ABI910_6POST	342004	342021		rhaR	17
ABI910_6POST	342450	342455		rhaR	5
ABI910_6POST	342489	342502		rhaR	13
ABI910_6POST	342665	342668		rhaR	3
ABI910_6POST	342829	342854		rhaR	25
ABI910_6POST	343134	343139		rhaT	5
ABI910_6POST	343369	343372		rhaT	3
ABI910_6POST	343601	343635		rhaT	34
ABI910_6POST	343756	343814		rhaT	58
ABI910_6POST	345103	345111		YPO_RS02690	8
ABI910_6POST	345146	345155		YPO_RS02690	9
ABI910_6POST	346038	346064		YPO_RS02695	26
ABI910_6POST	346606	346616		YPO_RS02695	10
ABI910_6POST	346688	346697		YPO_RS02695	9
ABI910_6POST	347643	347644		YPO_RS02695	1
ABI910_6POST	348150	348153		YPO_RS02695	3
ABI910_6POST	349210	349220		YPO_RS02705	10
ABI910_6POST	349331	349350		YPO_RS02705	19
ABI910_6POST	350037	350051		aegA	14
ABI910_6POST	350383	350405		aegA	22
ABI910_6POST	350995	350996		aegA	1
ABI910_6POST	351236	351239		aegA	3
ABI910_6POST	351364	351398		aegA	34
ABI910_6POST	351720	351723		aegA	3
ABI910_6POST	351864	351877		aegA	13
ABI910_6POST	352088	352113		YPO_RS02715	25
ABI910_6POST	352686	352705		fdhF	19
ABI910_6POST	353257	353266		fdhF	9
ABI910_6POST	353468	353477		fdhF	9
ABI910_6POST	353935	353960		fdhF	25
ABI910_6POST	354061	354071		fdhF	10
ABI910_6POST	354194	354205		fdhF	11
ABI910_6POST	354548	354567		fdhF	19
ABI910_6POST	355088	355091		YPO_RS02725	3
ABI910_6POST	355480	355502		YPO_RS02725	22
ABI910_6POST	356000	356056		YPO_RS02725	56
ABI910_6POST	356532	356555		YPO_RS02725	23
ABI910_6POST	356613	356631		cutA	18
ABI910_6POST	357216	357245		YPO_RS02735	29
ABI910_6POST	357592	357597		YPO_RS02735	5
ABI910_6POST	358903	358908		aspA	5
ABI910_6POST	359631	359663		aspA	32
ABI910_6POST	360489	360547		fxsA	58
ABI910_6POST	360804	360810		fxsA	6
ABI910_6POST	361326	361331		YPO_RS02750	5
ABI910_6POST	362128	362132		groL	4
ABI910_6POST	362460	362480		groL	20
ABI910_6POST	363193	363198		groL	5
ABI910_6POST	363943	363966		YPO_RS02760	23
ABI910_6POST	366043	366074		efp	31
ABI910_6POST	366954	366957		YPO_RS02780	3
ABI910_6POST	367076	367085		YPO_RS02780	9
ABI910_6POST	367322	367325		YPO_RS02780	3
ABI910_6POST	367906	367920		frdD	14
ABI910_6POST	368395	368434		YPO_RS02795	39
ABI910_6POST	371754	371756		epmA	2
ABI910_6POST	373207	373224		mscM	17
ABI910_6POST	373641	373650		mscM	9
ABI910_6POST	374150	374166		mscM	16
ABI910_6POST	374452	374473		mscM	21
ABI910_6POST	374528	374565		mscM	37
ABI910_6POST	374885	374887		mscM	2
ABI910_6POST	374976	374987		mscM	11
ABI910_6POST	375546	375547		mscM	1
ABI910_6POST	376034	376057		psd	23
ABI910_6POST	376097	376128		psd	31
ABI910_6POST	376332	376337		psd	5
ABI910_6POST	376453	376466		psd	13
ABI910_6POST	378530	378532		orn	2
ABI910_6POST	378564	378566		orn	2
ABI910_6POST	380365	380366		queG	1
ABI910_6POST	380406	380425		queG	19
ABI910_6POST	381040	381056		queG	16
ABI910_6POST	381055	381069		nnr	14
ABI910_6POST	381796	381823		nnr	27
ABI910_6POST	381868	381895		nnr	27
ABI910_6POST	382311	382334		nnr	23
ABI910_6POST	383796	383800		amiB	4
ABI910_6POST	383885	383911		amiB	26
ABI910_6POST	384144	384173		amiB	29
ABI910_6POST	385440	385441		mutL	1
ABI910_6POST	386175	386182		mutL	7
ABI910_6POST	386404	386416		mutL	12
ABI910_6POST	386714	386715		mutL	1
ABI910_6POST	386836	386838		mutL	2
ABI910_6POST	387569	387579		miaA	10
ABI910_6POST	387945	387949		hfq	4
ABI910_6POST	389547	389550		hflX	3
ABI910_6POST	390061	390089		hflK	28
ABI910_6POST	390847	390855		hflK	8
ABI910_6POST	391057	391075		hflK	18
ABI910_6POST	391439	391451		hflC	12
ABI910_6POST	392407	392435		YPO_RS02890	28
ABI910_6POST	392645	392655		YPO_RS02895	10
ABI910_6POST	393331	393361		YPO_RS02895	30
ABI910_6POST	394343	394345		nsrR	2
ABI910_6POST	395431	395445		rnr	14
ABI910_6POST	395538	395540		rnr	2
ABI910_6POST	395717	395752		rnr	35
ABI910_6POST	395910	395934		rnr	24
ABI910_6POST	396416	396449		rnr	33
ABI910_6POST	397248	397255		rnr	7
ABI910_6POST	397924	397965		rlmB	41
ABI910_6POST	398139	398146		rlmB	7
ABI910_6POST	398254	398258		rlmB	4
ABI910_6POST	398864	398873		YPO_RS02915	9
ABI910_6POST	399011	399020		YPO_RS02915	9
ABI910_6POST	399380	399381		YPO_RS02915	1
ABI910_6POST	400482	400500		bsmA	18
ABI910_6POST	400606	400626		bsmA	20
ABI910_6POST	401136	401145		YPO_RS02930	9
ABI910_6POST	401287	401296		YPO_RS02930	9
ABI910_6POST	401522	401602		YPO_RS02930	80
ABI910_6POST	401676	401718		YPO_RS02930	42
ABI910_6POST	401791	401828		YPO_RS02930	37
ABI910_6POST	401942	401943		YPO_RS02935	1
ABI910_6POST	402049	402092		YPO_RS02935	43
ABI910_6POST	402172	402244		YPO_RS02935	72
ABI910_6POST	402293	402309		YPO_RS02935	16
ABI910_6POST	402461	402469		YPO_RS02935	8
ABI910_6POST	402519	402533		YPO_RS02935	14
ABI910_6POST	402594	402608		YPO_RS02935	14
ABI910_6POST	402651	402652		YPO_RS02935	1
ABI910_6POST	403049	403057		YPO_RS02940	8
ABI910_6POST	403094	403120		YPO_RS02940	26
ABI910_6POST	403318	403322		YPO_RS02940	4
ABI910_6POST	403734	403748		YPO_RS02940	14
ABI910_6POST	403813	403821		YPO_RS02940	8
ABI910_6POST	404218	404242		YPO_RS02940	24
ABI910_6POST	404714	404751		YPO_RS02940	37
ABI910_6POST	405005	405031		YPO_RS02940	26
ABI910_6POST	405723	405780		YPO_RS02945	57
ABI910_6POST	406097	406106		YPO_RS02945	9
ABI910_6POST	406228	406256		YPO_RS02945	28
ABI910_6POST	407903	407908		YPO_RS02955	5
ABI910_6POST	408383	408398		YPO_RS02955	15
ABI910_6POST	409546	409551		YPO_RS02965	5
ABI910_6POST	409928	409962		YPO_RS02965	34
ABI910_6POST	410581	410582		YPO_RS02965	1
ABI910_6POST	410645	410650		YPO_RS02965	5
ABI910_6POST	410709	410718		YPO_RS02965	9
ABI910_6POST	410862	410891		YPO_RS02965	29
ABI910_6POST	411477	411479		YPO_RS02970	2
ABI910_6POST	412748	412753		YPO_RS02980	5
ABI910_6POST	412967	412968		YPO_RS02980	1
ABI910_6POST	413089	413114		YPO_RS02980	25
ABI910_6POST	413607	413614		YPO_RS02985	7
ABI910_6POST	413716	413720		YPO_RS02985	4
ABI910_6POST	413820	413826		YPO_RS02985	6
ABI910_6POST	414424	414436		YPO_RS02985	12
ABI910_6POST	414913	414939		YPO_RS02990	26
ABI910_6POST	415202	415219		YPO_RS02990	17
ABI910_6POST	415859	415868		YPO_RS02990	9
ABI910_6POST	416094	416099		YPO_RS02995	5
ABI910_6POST	416205	416246		YPO_RS02995	41
ABI910_6POST	416639	416643		YPO_RS02995	4
ABI910_6POST	416836	416863		YPO_RS02995	27
ABI910_6POST	419713	419724		YPO_RS03015	11
ABI910_6POST	420439	420444		YPO_RS03020	5
ABI910_6POST	420608	420651		YPO_RS03020	43
ABI910_6POST	420863	420885		YPO_RS03020	22
ABI910_6POST	420944	420950		YPO_RS03020	6
ABI910_6POST	421105	421113		YPO_RS03020	8
ABI910_6POST	422094	422135		ptsP	41
ABI910_6POST	422237	422240		ptsP	3
ABI910_6POST	422309	422326		ptsP	17
ABI910_6POST	422365	422369		ptsP	4
ABI910_6POST	422415	422443		ptsP	28
ABI910_6POST	422776	422778		ptsP	2
ABI910_6POST	422825	422831		ptsP	6
ABI910_6POST	422986	422990		ptsP	4
ABI910_6POST	423285	423288		ptsP	3
ABI910_6POST	423335	423355		ptsP	20
ABI910_6POST	423678	423683		ptsP	5
ABI910_6POST	423931	423937		ptsP	6
ABI910_6POST	424549	424581		YPO_RS03030	32
ABI910_6POST	424648	424651		YPO_RS03030	3
ABI910_6POST	425664	425665		lsrF	1
ABI910_6POST	426219	426221		lsrF	2
ABI910_6POST	427430	427440		lsrB	10
ABI910_6POST	427540	427543		lsrD	3
ABI910_6POST	427696	427704		lsrD	8
ABI910_6POST	427754	427757		lsrD	3
ABI910_6POST	427893	427896		lsrD	3
ABI910_6POST	428189	428195		lsrD	6
ABI910_6POST	428359	428362		lsrD	3
ABI910_6POST	428517	428518		lsrD	1
ABI910_6POST	428562	428573		lsrC	11
ABI910_6POST	429132	429140		lsrC	8
ABI910_6POST	429379	429385		lsrC	6
ABI910_6POST	429771	429778		lsrA	7
ABI910_6POST	429952	429959		lsrA	7
ABI910_6POST	430196	430203		lsrA	7
ABI910_6POST	430247	430277		lsrA	30
ABI910_6POST	430611	430612		lsrA	1
ABI910_6POST	430740	430746		lsrA	6
ABI910_6POST	431044	431053		lsrA	9
ABI910_6POST	431151	431154		lsrA	3
ABI910_6POST	431280	431325		YPO_RS03065	45
ABI910_6POST	432692	432701		lsrK	9
ABI910_6POST	432731	432736		lsrK	5
ABI910_6POST	432968	432978		lsrK	10
ABI910_6POST	433115	433119		lsrK	4
ABI910_6POST	433243	433258		lsrK	15
ABI910_6POST	433486	433496		lsrK	10
ABI910_6POST	433706	433712		lsrK	6
ABI910_6POST	435352	435353		rfaQ	1
ABI910_6POST	435692	435696		rfaQ	4
ABI910_6POST	435901	435912		YPO_RS03085	11
ABI910_6POST	436254	436256		YPO_RS03085	2
ABI910_6POST	436730	436731		YPO_RS03085	1
ABI910_6POST	436777	436792		YPO_RS03085	15
ABI910_6POST	437029	437035		YPO_RS03085	6
ABI910_6POST	439758	439760		YPO_RS03100	2
ABI910_6POST	440274	440309		YPO_RS03100	35
ABI910_6POST	440339	440353		YPO_RS03100	14
ABI910_6POST	440448	440475		YPO_RS03100	27
ABI910_6POST	440739	440801		YPO_RS03100	62
ABI910_6POST	441009	441032		YPO_RS03100	23
ABI910_6POST	441267	441268		YPO_RS03100	1
ABI910_6POST	441401	441409		YPO_RS03100	8
ABI910_6POST	441491	441496		YPO_RS03100	5
ABI910_6POST	441898	441900		YPO_RS03100	2
ABI910_6POST	441998	442010		YPO_RS03100	12
ABI910_6POST	442133	442138		YPO_RS03100	5
ABI910_6POST	442273	442276		YPO_RS03100	3
ABI910_6POST	443157	443159		YPO_RS03110	2
ABI910_6POST	443197	443201		YPO_RS03110	4
ABI910_6POST	443819	443830		YPO_RS03115	11
ABI910_6POST	444524	444525		YPO_RS03115	1
ABI910_6POST	444571	444581		YPO_RS03115	10
ABI910_6POST	444630	444665		YPO_RS03115	35
ABI910_6POST	444800	444802		YPO_RS03115	2
ABI910_6POST	446191	446219		YPO_RS03120	28
ABI910_6POST	447859	447874		rsmC	15
ABI910_6POST	448128	448159		rsmC	31
ABI910_6POST	448419	448456		rsmC	37
ABI910_6POST	448604	448606		rsmC	2
ABI910_6POST	449478	449479		rimI	1
ABI910_6POST	449991	449993		prfC	2
ABI910_6POST	450215	450222		prfC	7
ABI910_6POST	450662	450674		prfC	12
ABI910_6POST	450975	450982		prfC	7
ABI910_6POST	451196	451206		prfC	10
ABI910_6POST	451874	451877		osmY	3
ABI910_6POST	452803	452808		YPO_RS03165	5
ABI910_6POST	452887	452895		YPO_RS03165	8
ABI910_6POST	452960	452982		YPO_RS03165	22
ABI910_6POST	453309	453352		YPO_RS03165	43
ABI910_6POST	453516	453531		YPO_RS03165	15
ABI910_6POST	453944	453984		YPO_RS03165	40
ABI910_6POST	454128	454134		YPO_RS03170	6
ABI910_6POST	454268	454311		YPO_RS03170	43
ABI910_6POST	454631	454645		YPO_RS03170	14
ABI910_6POST	456046	456054		YPO_RS03175	8
ABI910_6POST	456326	456330		YPO_RS03175	4
ABI910_6POST	456576	456591		YPO_RS03175	15
ABI910_6POST	457578	457584		deoC	6
ABI910_6POST	460354	460363		deoB	9
ABI910_6POST	460669	460724		deoB	55
ABI910_6POST	461050	461064		deoD	14
ABI910_6POST	461167	461203		deoD	36
ABI910_6POST	461473	461475		deoD	2
ABI910_6POST	461612	461622		deoD	10
ABI910_6POST	462152	462161		YPO_RS03200	9
ABI910_6POST	462221	462222		YPO_RS03200	1
ABI910_6POST	462391	462413		YPO_RS03200	22
ABI910_6POST	462959	462991		serB	32
ABI910_6POST	463262	463286		serB	24
ABI910_6POST	463368	463391		serB	23
ABI910_6POST	463490	463503		serB	13
ABI910_6POST	463896	463914		radA	18
ABI910_6POST	464376	464378		radA	2
ABI910_6POST	464467	464473		radA	6
ABI910_6POST	464932	464942		radA	10
ABI910_6POST	465708	465722		nadR	14
ABI910_6POST	466066	466082		nadR	16
ABI910_6POST	466405	466422		nadR	17
ABI910_6POST	466793	466808		YPO_RS03220	15
ABI910_6POST	467130	467131		YPO_RS03220	1
ABI910_6POST	467255	467262		YPO_RS03220	7
ABI910_6POST	470334	470345		YPO_RS03230	11
ABI910_6POST	470665	470674		YPO_RS03235	9
ABI910_6POST	471798	471799		YPO_RS03240	1
ABI910_6POST	472089	472094		YPO_RS03240	5
ABI910_6POST	472887	472892		YPO_RS03245	5
ABI910_6POST	473050	473060		YPO_RS03245	10
ABI910_6POST	473202	473212		YPO_RS03245	10
ABI910_6POST	473416	473427		YPO_RS03245	11
ABI910_6POST	473519	473552		YPO_RS03245	33
ABI910_6POST	474797	474804		YPO_RS03245	7
ABI910_6POST	476286	476291		sltY	5
ABI910_6POST	476398	476400		sltY	2
ABI910_6POST	476451	476473		sltY	22
ABI910_6POST	476962	476989		sltY	27
ABI910_6POST	477663	477664		sltY	1
ABI910_6POST	477750	477756		sltY	6
ABI910_6POST	479432	479461		gpmB	29
ABI910_6POST	479612	479674		gpmB	62
ABI910_6POST	480541	480549		robA	8
ABI910_6POST	481820	481823		arcA	3
ABI910_6POST	485450	485471		thrA	21
ABI910_6POST	486320	486332		thrB	12
ABI910_6POST	486368	486373		thrB	5
ABI910_6POST	486596	486608		thrB	12
ABI910_6POST	487199	487204		thrC	5
ABI910_6POST	489668	489672		yaaA	4
ABI910_6POST	490519	490526		tal	7
ABI910_6POST	492644	492649		YPO_RS03325	5
ABI910_6POST	492681	492684		YPO_RS03325	3
ABI910_6POST	492768	492780		YPO_RS03325	12
ABI910_6POST	493636	493708		YPO_RS03330	72
ABI910_6POST	493885	493896		YPO_RS03330	11
ABI910_6POST	494046	494057		YPO_RS03330	11
ABI910_6POST	494210	494222		YPO_RS03330	12
ABI910_6POST	494385	494387		YPO_RS03330	2
ABI910_6POST	494975	494978		YPO_RS03330	3
ABI910_6POST	495422	495430		YPO_RS03330	8
ABI910_6POST	496415	496419		satP	4
ABI910_6POST	496540	496558		satP	18
ABI910_6POST	496621	496623		satP	2
ABI910_6POST	497443	497462		dnaK	19
ABI910_6POST	497879	497881		dnaK	2
ABI910_6POST	498008	498014		dnaK	6
ABI910_6POST	498534	498562		dnaK	28
ABI910_6POST	498740	498744		dnaK	4
ABI910_6POST	499716	499743		dnaJ	27
ABI910_6POST	499873	499881		dnaJ	8
ABI910_6POST	500056	500080		dnaJ	24
ABI910_6POST	500843	500851		nhaA	8
ABI910_6POST	501050	501057		nhaA	7
ABI910_6POST	501100	501115		nhaA	15
ABI910_6POST	501172	501183		nhaA	11
ABI910_6POST	501281	501286		nhaA	5
ABI910_6POST	501866	501873		nhaA	7
ABI910_6POST	502222	502231		nhaR	9
ABI910_6POST	502337	502341		nhaR	4
ABI910_6POST	503155	503165		rpsT	10
ABI910_6POST	503885	503915		ribF	30
ABI910_6POST	504322	504330		ribF	8
ABI910_6POST	504426	504441		ribF	15
ABI910_6POST	506504	506519		ileS	15
ABI910_6POST	506889	506931		ileS	42
ABI910_6POST	507020	507032		ileS	12
ABI910_6POST	507502	507507		ileS	5
ABI910_6POST	507804	507811		lspA	7
ABI910_6POST	508281	508284		fkpB	3
ABI910_6POST	508678	508682		ispH	4
ABI910_6POST	508947	508962		ispH	15
ABI910_6POST	509355	509382		ispH	27
ABI910_6POST	510225	510316		YPO_RS03400	91
ABI910_6POST	510909	510943		dapB	34
ABI910_6POST	511312	511316		dapB	4
ABI910_6POST	511384	511399		dapB	15
ABI910_6POST	512391	512392		carA	1
ABI910_6POST	512611	512635		carA	24
ABI910_6POST	513842	513846		carB	4
ABI910_6POST	514133	514143		carB	10
ABI910_6POST	515126	515138		carB	12
ABI910_6POST	515210	515234		carB	24
ABI910_6POST	515413	515417		carB	4
ABI910_6POST	515970	515984		carB	14
ABI910_6POST	516153	516169		carB	16
ABI910_6POST	516765	516773		YPO_RS03420	8
ABI910_6POST	517127	517147		YPO_RS03420	20
ABI910_6POST	518322	518324		YPO_RS03425	2
ABI910_6POST	518570	518571		YPO_RS03430	1
ABI910_6POST	519224	519240		folA	16
ABI910_6POST	520115	520116		YPO_RS03440	1
ABI910_6POST	520884	520891		YPO_RS03445	7
ABI910_6POST	520986	521007		YPO_RS03445	21
ABI910_6POST	521264	521298		YPO_RS03450	34
ABI910_6POST	522376	522385		apaH	9
ABI910_6POST	523461	523470		rsmA	9
ABI910_6POST	523542	523552		rsmA	10
ABI910_6POST	523627	523628		rsmA	1
ABI910_6POST	523843	523864		pdxA	21
ABI910_6POST	523951	523964		pdxA	13
ABI910_6POST	524032	524070		pdxA	38
ABI910_6POST	524235	524258		pdxA	23
ABI910_6POST	524536	524542		pdxA	6
ABI910_6POST	524926	524929		surA	3
ABI910_6POST	526180	526182		lptD	2
ABI910_6POST	526330	526332		lptD	2
ABI910_6POST	526453	526461		lptD	8
ABI910_6POST	526986	526998		lptD	12
ABI910_6POST	527306	527331		lptD	25
ABI910_6POST	527423	527438		lptD	15
ABI910_6POST	527510	527515		lptD	5
ABI910_6POST	527595	527625		lptD	30
ABI910_6POST	528029	528050		lptD	21
ABI910_6POST	529044	529045		djlA	1
ABI910_6POST	529200	529201		djlA	1
ABI910_6POST	529232	529234		djlA	2
ABI910_6POST	529393	529399		djlA	6
ABI910_6POST	529900	529939		rluA	39
ABI910_6POST	529986	530003		rluA	17
ABI910_6POST	530403	530405		rluA	2
ABI910_6POST	532063	532075		YPO_RS03495	12
ABI910_6POST	533024	533033		YPO_RS03500	9
ABI910_6POST	533568	533575		YPO_RS03500	7
ABI910_6POST	534234	534240		tssB	6
ABI910_6POST	534910	534920		tssC	10
ABI910_6POST	535183	535198		tssC	15
ABI910_6POST	536006	536027		YPO_RS03515	21
ABI910_6POST	536083	536098		YPO_RS03515	15
ABI910_6POST	536430	536452		YPO_RS03515	22
ABI910_6POST	536906	536921		YPO_RS03520	15
ABI910_6POST	537908	537938		tssF	30
ABI910_6POST	537988	537994		tssF	6
ABI910_6POST	538040	538114		tssF	74
ABI910_6POST	538456	538457		tssF	1
ABI910_6POST	538687	538717		tssF	30
ABI910_6POST	538820	538823		tssF	3
ABI910_6POST	538966	538976		tssG	10
ABI910_6POST	539603	539632		tssG	29
ABI910_6POST	540306	540317		tssH	11
ABI910_6POST	540616	540624		tssH	8
ABI910_6POST	540823	540852		tssH	29
ABI910_6POST	541346	541361		tssH	15
ABI910_6POST	541493	541495		tssH	2
ABI910_6POST	541724	541747		tssH	23
ABI910_6POST	542882	542883		vgrG	1
ABI910_6POST	543288	543301		vgrG	13
ABI910_6POST	543331	543355		vgrG	24
ABI910_6POST	543466	543483		vgrG	17
ABI910_6POST	543513	543524		vgrG	11
ABI910_6POST	544034	544047		vgrG	13
ABI910_6POST	544296	544360		vgrG	64
ABI910_6POST	544442	544444		vgrG	2
ABI910_6POST	544512	544550		vgrG	38
ABI910_6POST	544581	544598		vgrG	17
ABI910_6POST	544640	544648		vgrG	8
ABI910_6POST	544692	544696		vgrG	4
ABI910_6POST	544775	544808		vgrG	33
ABI910_6POST	544858	544872		vgrG	14
ABI910_6POST	545182	545183		YPO_RS03545	1
ABI910_6POST	545281	545312		YPO_RS03545	31
ABI910_6POST	546031	546041		YPO_RS03550	10
ABI910_6POST	546699	546754		YPO_RS03550	55
ABI910_6POST	547454	547478		YPO_RS03555	24
ABI910_6POST	547891	547895		YPO_RS03555	4
ABI910_6POST	548228	548237		YPO_RS03555	9
ABI910_6POST	548350	548366		YPO_RS03560	16
ABI910_6POST	548477	548539		YPO_RS03560	62
ABI910_6POST	548662	548669		YPO_RS03560	7
ABI910_6POST	549003	549017		YPO_RS03565	14
ABI910_6POST	549105	549120		YPO_RS03565	15
ABI910_6POST	549298	549303		tssJ	5
ABI910_6POST	549443	549463		tssJ	20
ABI910_6POST	550097	550181		tssK	84
ABI910_6POST	550318	550321		tssK	3
ABI910_6POST	550420	550431		tssK	11
ABI910_6POST	550614	550627		tssK	13
ABI910_6POST	551796	551812		YPO_RS03580	16
ABI910_6POST	551895	551935		YPO_RS03580	40
ABI910_6POST	552325	552328		YPO_RS03580	3
ABI910_6POST	552460	552509		YPO_RS03580	49
ABI910_6POST	553356	553378		tssM	22
ABI910_6POST	553952	553969		tssM	17
ABI910_6POST	554075	554076		tssM	1
ABI910_6POST	554527	554533		tssM	6
ABI910_6POST	554886	554891		tssM	5
ABI910_6POST	555201	555222		tssM	21
ABI910_6POST	556049	556061		tssM	12
ABI910_6POST	556159	556192		tssM	33
ABI910_6POST	556954	556961		rapA	7
ABI910_6POST	557311	557334		rapA	23
ABI910_6POST	557426	557436		rapA	10
ABI910_6POST	557594	557603		rapA	9
ABI910_6POST	558586	558587		rapA	1
ABI910_6POST	558924	558925		rapA	1
ABI910_6POST	559219	559254		rapA	35
ABI910_6POST	559581	559609		rapA	28
ABI910_6POST	560313	560334		YPO_RS03600	21
ABI910_6POST	560470	560480		YPO_RS03600	10
ABI910_6POST	561306	561356		YPO_RS03600	50
ABI910_6POST	561403	561426		YPO_RS03600	23
ABI910_6POST	561468	561476		YPO_RS03600	8
ABI910_6POST	561678	561686		YPO_RS03600	8
ABI910_6POST	562011	562015		YPO_RS03600	4
ABI910_6POST	562153	562158		YPO_RS03600	5
ABI910_6POST	562289	562319		YPO_RS03600	30
ABI910_6POST	562417	562418		YPO_RS03600	1
ABI910_6POST	562573	562583		YPO_RS03600	10
ABI910_6POST	563219	563230		YPO_RS03605	11
ABI910_6POST	563410	563439		YPO_RS03605	29
ABI910_6POST	564205	564259		thiQ	54
ABI910_6POST	564526	564532		thiP	6
ABI910_6POST	565657	565663		thiP	6
ABI910_6POST	565733	565734		thiP	1
ABI910_6POST	565820	565822		thiP	2
ABI910_6POST	566644	566650		YPO_RS03620	6
ABI910_6POST	566882	566886		YPO_RS03620	4
ABI910_6POST	567985	568000		YPO_RS03625	15
ABI910_6POST	568063	568075		YPO_RS03625	12
ABI910_6POST	568444	568458		YPO_RS03625	14
ABI910_6POST	568672	568696		YPO_RS03625	24
ABI910_6POST	568786	568788		YPO_RS03625	2
ABI910_6POST	568929	568971		YPO_RS03625	42
ABI910_6POST	569055	569062		YPO_RS03625	7
ABI910_6POST	569199	569217		YPO_RS03625	18
ABI910_6POST	569325	569328		YPO_RS03625	3
ABI910_6POST	571403	571411		YPO_RS03635	8
ABI910_6POST	571549	571736		YPO_RS03635	187
ABI910_6POST	571836	571850		YPO_RS03635	14
ABI910_6POST	571912	571942		YPO_RS03635	30
ABI910_6POST	572074	572081		YPO_RS03640	7
ABI910_6POST	572144	572184		YPO_RS03640	40
ABI910_6POST	572320	572351		YPO_RS03640	31
ABI910_6POST	572422	572454		YPO_RS03640	32
ABI910_6POST	572656	572659		YPO_RS03640	3
ABI910_6POST	572869	572884		YPO_RS03640	15
ABI910_6POST	573140	573147		YPO_RS03645	7
ABI910_6POST	573703	573717		leuD	14
ABI910_6POST	574342	574347		leuC	5
ABI910_6POST	574530	574551		leuC	21
ABI910_6POST	574866	574874		leuC	8
ABI910_6POST	574946	574964		leuC	18
ABI910_6POST	575127	575128		leuC	1
ABI910_6POST	576505	576523		leuB	18
ABI910_6POST	576947	576958		leuA	11
ABI910_6POST	577444	577450		leuA	6
ABI910_6POST	577802	577830		leuA	28
ABI910_6POST	581821	581855		YPO_RS03685	34
ABI910_6POST	581903	581943		YPO_RS03685	40
ABI910_6POST	582028	582051		YPO_RS03685	23
ABI910_6POST	582241	582250		YPO_RS03685	9
ABI910_6POST	582351	582372		YPO_RS03685	21
ABI910_6POST	582647	582650		YPO_RS03685	3
ABI910_6POST	583181	583185		YPO_RS03685	4
ABI910_6POST	584026	584072		ilvI	46
ABI910_6POST	584116	584147		ilvI	31
ABI910_6POST	584658	584665		ilvI	7
ABI910_6POST	584784	584816		ilvI	32
ABI910_6POST	585193	585196		ilvI	3
ABI910_6POST	585432	585450		ilvI	18
ABI910_6POST	585557	585561		ilvI	4
ABI910_6POST	585799	585841		ilvN	42
ABI910_6POST	586113	586132		ilvN	19
ABI910_6POST	586763	586768		YPO_RS03700	5
ABI910_6POST	587469	587483		cra	14
ABI910_6POST	587875	587889		cra	14
ABI910_6POST	588411	588413		cra	2
ABI910_6POST	590950	590951		rsmH	1
ABI910_6POST	591348	591358		rsmH	10
ABI910_6POST	592057	592058		YPO_RS03735	1
ABI910_6POST	592819	592842		YPO_RS03735	23
ABI910_6POST	593072	593120		YPO_RS03735	48
ABI910_6POST	593316	593318		YPO_RS03735	2
ABI910_6POST	594060	594102		murE	42
ABI910_6POST	594622	594626		murE	4
ABI910_6POST	594794	594811		murE	17
ABI910_6POST	595346	595368		murF	22
ABI910_6POST	595967	595973		murF	6
ABI910_6POST	596061	596074		murF	13
ABI910_6POST	596198	596208		murF	10
ABI910_6POST	596310	596331		murF	21
ABI910_6POST	596807	596809		mraY	2
ABI910_6POST	597607	597614		murD	7
ABI910_6POST	597972	597987		murD	15
ABI910_6POST	598283	598309		murD	26
ABI910_6POST	598939	598943		ftsW	4
ABI910_6POST	599170	599182		ftsW	12
ABI910_6POST	599637	599659		ftsW	22
ABI910_6POST	599792	599798		ftsW	6
ABI910_6POST	599990	599995		ftsW	5
ABI910_6POST	600123	600146		murG	23
ABI910_6POST	600318	600322		murG	4
ABI910_6POST	600439	600454		murG	15
ABI910_6POST	600585	600604		murG	19
ABI910_6POST	600764	600779		murG	15
ABI910_6POST	600950	600951		murG	1
ABI910_6POST	601379	601400		murC	21
ABI910_6POST	601479	601482		murC	3
ABI910_6POST	601990	601997		murC	7
ABI910_6POST	602553	602561		murC	8
ABI910_6POST	603013	603019		YPO_RS03775	6
ABI910_6POST	603568	603578		YPO_RS03775	10
ABI910_6POST	603770	603779		ftsQ	9
ABI910_6POST	603983	603984		ftsQ	1
ABI910_6POST	604167	604170		ftsQ	3
ABI910_6POST	604367	604389		ftsQ	22
ABI910_6POST	604651	604674		ftsA	23
ABI910_6POST	605147	605173		ftsA	26
ABI910_6POST	605526	605537		ftsA	11
ABI910_6POST	605606	605627		ftsA	21
ABI910_6POST	606200	606208		ftsZ	8
ABI910_6POST	606956	606958		ftsZ	2
ABI910_6POST	608035	608045		lpxC	10
ABI910_6POST	608313	608327		YPO_RS03800	14
ABI910_6POST	610035	610074		secA	39
ABI910_6POST	610153	610157		secA	4
ABI910_6POST	610299	610304		secA	5
ABI910_6POST	610889	610903		secA	14
ABI910_6POST	611008	611014		secA	6
ABI910_6POST	612463	612468		mutT	5
ABI910_6POST	612767	612771		mutT	4
ABI910_6POST	613033	613055		YPO_RS03820	22
ABI910_6POST	613131	613136		YPO_RS03820	5
ABI910_6POST	613178	613193		YPO_RS03820	15
ABI910_6POST	613397	613400		YPO_RS03820	3
ABI910_6POST	613481	613491		YPO_RS03820	10
ABI910_6POST	613559	613571		YPO_RS03820	12
ABI910_6POST	613620	613626		YPO_RS03820	6
ABI910_6POST	613766	613788		YPO_RS03820	22
ABI910_6POST	613861	613866		YPO_RS03825	5
ABI910_6POST	613940	613941		YPO_RS03825	1
ABI910_6POST	614107	614140		YPO_RS03825	33
ABI910_6POST	614225	614242		YPO_RS03825	17
ABI910_6POST	614442	614458		YPO_RS03825	16
ABI910_6POST	614510	614511		YPO_RS03825	1
ABI910_6POST	614556	614597		YPO_RS03825	41
ABI910_6POST	614732	614741		YPO_RS03825	9
ABI910_6POST	615184	615185		YPO_RS03835	1
ABI910_6POST	616542	616552		YPO_RS03850	10
ABI910_6POST	617305	617311		YPO_RS03855	6
ABI910_6POST	617703	617707		mzrA	4
ABI910_6POST	617882	617883		mzrA	1
ABI910_6POST	618278	618283		YPO_RS03865	5
ABI910_6POST	618326	618341		YPO_RS03865	15
ABI910_6POST	618398	618409		YPO_RS03865	11
ABI910_6POST	618601	618604		YPO_RS03865	3
ABI910_6POST	620899	620923		YPO_RS03880	24
ABI910_6POST	621129	621134		YPO_RS03880	5
ABI910_6POST	621727	621737		YPO_RS03880	10
ABI910_6POST	621778	621783		YPO_RS03880	5
ABI910_6POST	621977	622008		YPO_RS03880	31
ABI910_6POST	623026	623027		uxaC	1
ABI910_6POST	623685	623688		uxaC	3
ABI910_6POST	623749	623754		uxaC	5
ABI910_6POST	624599	624635		YPO_RS03890	36
ABI910_6POST	624966	624990		YPO_RS03890	24
ABI910_6POST	625162	625173		YPO_RS03890	11
ABI910_6POST	625314	625318		YPO_RS03890	4
ABI910_6POST	625577	625580		YPO_RS03890	3
ABI910_6POST	625903	625946		YPO_RS03895	43
ABI910_6POST	626371	626386		YPO_RS03895	15
ABI910_6POST	626425	626467		YPO_RS03895	42
ABI910_6POST	626924	626927		YPO_RS03895	3
ABI910_6POST	627108	627140		YPO_RS03895	32
ABI910_6POST	627244	627248		YPO_RS03895	4
ABI910_6POST	627278	627288		YPO_RS03895	10
ABI910_6POST	627719	627721		YPO_RS03900	2
ABI910_6POST	627884	627885		YPO_RS03900	1
ABI910_6POST	628213	628224		YPO_RS03905	11
ABI910_6POST	628384	628385		YPO_RS03905	1
ABI910_6POST	629133	629174		sstT	41
ABI910_6POST	630791	630794		YPO_RS03915	3
ABI910_6POST	630937	630942		YPO_RS03915	5
ABI910_6POST	631289	631290		YPO_RS03915	1
ABI910_6POST	631860	631867		YPO_RS03920	7
ABI910_6POST	633069	633075		yapG	6
ABI910_6POST	633274	633288		yapG	14
ABI910_6POST	633386	633389		yapG	3
ABI910_6POST	633503	633510		yapG	7
ABI910_6POST	633620	633624		yapG	4
ABI910_6POST	633658	633659		yapG	1
ABI910_6POST	633801	633808		yapG	7
ABI910_6POST	633931	633942		yapG	11
ABI910_6POST	634173	634186		yapG	13
ABI910_6POST	634506	634511		yapG	5
ABI910_6POST	634794	634817		yapG	23
ABI910_6POST	635206	635241		yapG	35
ABI910_6POST	635314	635320		yapG	6
ABI910_6POST	636430	636441		rlmG	11
ABI910_6POST	636592	636598		rlmG	6
ABI910_6POST	637338	637357		YPO_RS03935	19
ABI910_6POST	637684	637719		YPO_RS03935	35
ABI910_6POST	637887	637910		YPO_RS03935	23
ABI910_6POST	638611	638619		YPO_RS03935	8
ABI910_6POST	638673	638677		YPO_RS03935	4
ABI910_6POST	639103	639148		YPO_RS03935	45
ABI910_6POST	639620	639630		YPO_RS03940	10
ABI910_6POST	639756	639766		YPO_RS03940	10
ABI910_6POST	639952	639956		YPO_RS03940	4
ABI910_6POST	640557	640562		YPO_RS03945	5
ABI910_6POST	640644	640647		YPO_RS03945	3
ABI910_6POST	641720	641721		YPO_RS03945	1
ABI910_6POST	642213	642229		YPO_RS03950	16
ABI910_6POST	642443	642471		YPO_RS03950	28
ABI910_6POST	642990	642992		YPO_RS03950	2
ABI910_6POST	643222	643227		YPO_RS03950	5
ABI910_6POST	643653	643658		YPO_RS03950	5
ABI910_6POST	643963	643979		YPO_RS03955	16
ABI910_6POST	644317	644322		YPO_RS03955	5
ABI910_6POST	646257	646269		YPO_RS03970	12
ABI910_6POST	646539	646548		YPO_RS03970	9
ABI910_6POST	646866	646871		YPO_RS03970	5
ABI910_6POST	647825	647831		YPO_RS03975	6
ABI910_6POST	648292	648320		YPO_RS03975	28
ABI910_6POST	648588	648594		YPO_RS03975	6
ABI910_6POST	649375	649382		cdiA	7
ABI910_6POST	649573	649578		cdiA	5
ABI910_6POST	649843	649859		cdiA	16
ABI910_6POST	650219	650265		cdiA	46
ABI910_6POST	650323	650356		cdiA	33
ABI910_6POST	650511	650588		cdiA	77
ABI910_6POST	650905	650910		cdiA	5
ABI910_6POST	650964	650978		cdiA	14
ABI910_6POST	651248	651249		cdiA	1
ABI910_6POST	651365	651373		cdiA	8
ABI910_6POST	651956	651974		cdiA	18
ABI910_6POST	652038	652066		cdiA	28
ABI910_6POST	653091	653097		cdiA	6
ABI910_6POST	653274	653299		cdiA	25
ABI910_6POST	653463	653465		cdiA	2
ABI910_6POST	653708	653718		cdiA	10
ABI910_6POST	653892	653895		cdiA	3
ABI910_6POST	654135	654169		cdiA	34
ABI910_6POST	654388	654430		cdiA	42
ABI910_6POST	654592	654604		cdiA	12
ABI910_6POST	654756	654790		cdiA	34
ABI910_6POST	654894	654935		cdiA	41
ABI910_6POST	655006	655008		cdiA	2
ABI910_6POST	655146	655148		cdiA	2
ABI910_6POST	655217	655230		cdiA	13
ABI910_6POST	655291	655303		cdiA	12
ABI910_6POST	655492	655526		cdiA	34
ABI910_6POST	655657	655671		cdiA	14
ABI910_6POST	656149	656156		cdiA	7
ABI910_6POST	656405	656453		cdiA	48
ABI910_6POST	656986	656996		cdiA	10
ABI910_6POST	657371	657380		cdiA	9
ABI910_6POST	657935	657940		cdiA	5
ABI910_6POST	658484	658496		cdiA	12
ABI910_6POST	658948	658962		cdiA	14
ABI910_6POST	659371	659393		cdiI	22
ABI910_6POST	659704	659711		YPO_RS03995	7
ABI910_6POST	660164	660191		YPO_RS04005	27
ABI910_6POST	660276	660281		YPO_RS04005	5
ABI910_6POST	660826	660852		YPO_RS04010	26
ABI910_6POST	660956	660981		YPO_RS04010	25
ABI910_6POST	661992	662061		yapF	69
ABI910_6POST	662184	662246		yapF	62
ABI910_6POST	662326	662343		yapF	17
ABI910_6POST	662374	662385		yapF	11
ABI910_6POST	662473	662482		yapF	9
ABI910_6POST	662516	662536		yapF	20
ABI910_6POST	662686	662690		yapF	4
ABI910_6POST	662764	662790		yapF	26
ABI910_6POST	663342	663359		yapF	17
ABI910_6POST	663505	663518		yapF	13
ABI910_6POST	663625	663664		yapF	39
ABI910_6POST	663876	663884		yapF	8
ABI910_6POST	663932	663947		yapF	15
ABI910_6POST	664228	664252		YPO_RS04025	24
ABI910_6POST	664727	664743		YPO_RS04025	16
ABI910_6POST	664976	665033		YPO_RS04025	57
ABI910_6POST	665824	665833		YPO_RS04030	9
ABI910_6POST	666280	666290		YPO_RS04030	10
ABI910_6POST	667347	667357		YPO_RS04035	10
ABI910_6POST	668457	668468		YPO_RS04040	11
ABI910_6POST	668847	668849		YPO_RS04040	2
ABI910_6POST	668941	668951		YPO_RS04040	10
ABI910_6POST	669211	669213		YPO_RS04040	2
ABI910_6POST	669599	669605		YPO_RS04040	6
ABI910_6POST	669692	669696		YPO_RS04040	4
ABI910_6POST	670317	670330		YPO_RS04040	13
ABI910_6POST	670999	671014		YPO_RS04040	15
ABI910_6POST	671576	671582		YPO_RS04045	6
ABI910_6POST	672212	672215		YPO_RS04045	3
ABI910_6POST	672504	672515		YPO_RS04045	11
ABI910_6POST	673179	673224		YPO_RS04050	45
ABI910_6POST	673458	673487		YPO_RS04050	29
ABI910_6POST	674618	674673		YPO_RS04055	55
ABI910_6POST	675099	675142		YPO_RS04060	43
ABI910_6POST	675228	675238		YPO_RS04060	10
ABI910_6POST	675424	675434		YPO_RS04060	10
ABI910_6POST	676168	676185		YPO_RS04070	17
ABI910_6POST	676490	676496		YPO_RS04070	6
ABI910_6POST	676775	676786		YPO_RS04070	11
ABI910_6POST	676829	676868		YPO_RS04070	39
ABI910_6POST	676913	676917		YPO_RS04070	4
ABI910_6POST	677132	677143		YPO_RS04070	11
ABI910_6POST	677191	677205		YPO_RS04070	14
ABI910_6POST	678089	678091		YPO_RS04070	2
ABI910_6POST	678565	678568		YPO_RS04075	3
ABI910_6POST	678665	678668		YPO_RS04075	3
ABI910_6POST	679119	679133		YPO_RS04075	14
ABI910_6POST	679382	679396		YPO_RS04075	14
ABI910_6POST	679762	679794		YPO_RS04075	32
ABI910_6POST	680395	680444		YPO_RS04080	49
ABI910_6POST	681367	681368		YPO_RS04080	1
ABI910_6POST	681711	681715		YPO_RS04080	4
ABI910_6POST	682003	682008		mdtN	5
ABI910_6POST	682731	682768		mdtN	37
ABI910_6POST	683038	683076		YPO_RS04090	38
ABI910_6POST	683364	683371		YPO_RS04095	7
ABI910_6POST	684238	684242		YPO_RS04100	4
ABI910_6POST	685708	685712		YPO_RS04105	4
ABI910_6POST	685895	685902		YPO_RS04105	7
ABI910_6POST	686220	686226		YPO_RS04105	6
ABI910_6POST	686570	686577		YPO_RS04105	7
ABI910_6POST	686730	686734		YPO_RS04105	4
ABI910_6POST	687702	687703		YPO_RS04115	1
ABI910_6POST	688170	688178		YPO_RS04120	8
ABI910_6POST	688825	688828		YPO_RS04125	3
ABI910_6POST	688877	688882		YPO_RS04125	5
ABI910_6POST	690230	690231		YPO_RS04135	1
ABI910_6POST	690272	690292		YPO_RS04135	20
ABI910_6POST	690534	690547		YPO_RS04135	13
ABI910_6POST	691575	691582		YPO_RS04140	7
ABI910_6POST	693632	693636		YPO_RS04155	4
ABI910_6POST	693873	693874		YPO_RS04160	1
ABI910_6POST	694049	694065		YPO_RS04160	16
ABI910_6POST	694099	694107		YPO_RS04160	8
ABI910_6POST	694405	694424		YPO_RS04160	19
ABI910_6POST	694478	694484		YPO_RS04160	6
ABI910_6POST	694534	694542		YPO_RS04160	8
ABI910_6POST	694677	694711		YPO_RS04160	34
ABI910_6POST	694757	694774		YPO_RS04160	17
ABI910_6POST	694804	694823		YPO_RS04160	19
ABI910_6POST	694823	694845		YPO_RS04165	22
ABI910_6POST	694918	694929		YPO_RS04165	11
ABI910_6POST	695112	695155		YPO_RS04165	43
ABI910_6POST	695296	695326		YPO_RS04165	30
ABI910_6POST	695583	695601		YPO_RS04165	18
ABI910_6POST	695780	695787		YPO_RS04170	7
ABI910_6POST	696003	696068		YPO_RS04170	65
ABI910_6POST	696301	696312		YPO_RS04170	11
ABI910_6POST	696354	696391		YPO_RS04170	37
ABI910_6POST	696713	696721		YPO_RS04170	8
ABI910_6POST	696781	696785		YPO_RS04170	4
ABI910_6POST	699729	699736		rpoD	7
ABI910_6POST	700803	700810		rpoD	7
ABI910_6POST	700970	701030		rpoD	60
ABI910_6POST	701450	701470		dnaG	20
ABI910_6POST	701748	701756		dnaG	8
ABI910_6POST	701858	701861		dnaG	3
ABI910_6POST	702392	702395		dnaG	3
ABI910_6POST	702629	702635		dnaG	6
ABI910_6POST	703300	703304		rpsU	4
ABI910_6POST	703841	703879		tsaD	38
ABI910_6POST	703945	703974		tsaD	29
ABI910_6POST	704218	704223		tsaD	5
ABI910_6POST	704718	704726		tsaD	8
ABI910_6POST	706733	706751		bacA	18
ABI910_6POST	707544	707549		YPO_RS04230	5
ABI910_6POST	707646	707653		YPO_RS04230	7
ABI910_6POST	707845	707856		YPO_RS04230	11
ABI910_6POST	707917	707926		YPO_RS04230	9
ABI910_6POST	708029	708042		YPO_RS04230	13
ABI910_6POST	708427	708431		YPO_RS04230	4
ABI910_6POST	708529	708586		YPO_RS04230	57
ABI910_6POST	709300	709327		YPO_RS04235	27
ABI910_6POST	711001	711008		YPO_RS04240	7
ABI910_6POST	711222	711234		glnE	12
ABI910_6POST	711923	711928		glnE	5
ABI910_6POST	712030	712031		glnE	1
ABI910_6POST	712286	712288		glnE	2
ABI910_6POST	712384	712391		glnE	7
ABI910_6POST	713311	713319		glnE	8
ABI910_6POST	714256	714268		hldE	12
ABI910_6POST	714519	714549		hldE	30
ABI910_6POST	714668	714681		hldE	13
ABI910_6POST	714917	714920		hldE	3
ABI910_6POST	715037	715045		hldE	8
ABI910_6POST	715273	715290		hldE	17
ABI910_6POST	716371	716393		yjeH	22
ABI910_6POST	718750	718751		ribB	1
ABI910_6POST	719444	719447		ygiD	3
ABI910_6POST	719498	719529		ygiD	31
ABI910_6POST	719595	719601		ygiD	6
ABI910_6POST	719739	719745		ygiD	6
ABI910_6POST	719901	719955		ygiD	54
ABI910_6POST	720490	720499		YPO_RS04275	9
ABI910_6POST	721463	721468		YPO_RS04275	5
ABI910_6POST	721729	721736		YPO_RS04280	7
ABI910_6POST	722808	722821		tolC	13
ABI910_6POST	723006	723017		tolC	11
ABI910_6POST	724755	724758		nudF	3
ABI910_6POST	725217	725235		YPO_RS04295	18
ABI910_6POST	725942	725950		cpdA	8
ABI910_6POST	726026	726032		cpdA	6
ABI910_6POST	726457	726469		yqiA	12
ABI910_6POST	726832	726835		yqiA	3
ABI910_6POST	727250	727279		parE	29
ABI910_6POST	728268	728275		parE	7
ABI910_6POST	728519	728521		parE	2
ABI910_6POST	728996	729007		YPO_RS04315	11
ABI910_6POST	730120	730124		YPO_RS04320	4
ABI910_6POST	730289	730291		YPO_RS04320	2
ABI910_6POST	731252	731259		parC	7
ABI910_6POST	731825	731833		parC	8
ABI910_6POST	733644	733661		YPO_RS04335	17
ABI910_6POST	733969	733976		YPO_RS04335	7
ABI910_6POST	734338	734375		ftsP	37
ABI910_6POST	734711	734721		ftsP	10
ABI910_6POST	734759	734769		ftsP	10
ABI910_6POST	734864	734876		ftsP	12
ABI910_6POST	735234	735242		ftsP	8
ABI910_6POST	735430	735440		ftsP	10
ABI910_6POST	738362	738372		dkgA	10
ABI910_6POST	738856	738879		dkgA	23
ABI910_6POST	739177	739183		dkgA	6
ABI910_6POST	739496	739510		YPO_RS04355	14
ABI910_6POST	739972	739987		yqhD	15
ABI910_6POST	740205	740206		yqhD	1
ABI910_6POST	740374	740381		yqhD	7
ABI910_6POST	740744	740755		yqhD	11
ABI910_6POST	742645	742651		YPO_RS04370	6
ABI910_6POST	743430	743457		metC	27
ABI910_6POST	743634	743654		metC	20
ABI910_6POST	743791	743803		metC	12
ABI910_6POST	744924	744936		exbB	12
ABI910_6POST	745049	745051		exbB	2
ABI910_6POST	745822	745829		exbD	7
ABI910_6POST	746127	746143		exbD	16
ABI910_6POST	746303	746317		YPO_RS04390	14
ABI910_6POST	746628	746640		YPO_RS04390	12
ABI910_6POST	747163	747164		YPO_RS04390	1
ABI910_6POST	747920	747962		YPO_RS04395	42
ABI910_6POST	748142	748145		YPO_RS04395	3
ABI910_6POST	749079	749095		YPO_RS04405	16
ABI910_6POST	749181	749200		YPO_RS04405	19
ABI910_6POST	749273	749276		YPO_RS04405	3
ABI910_6POST	749375	749405		YPO_RS04405	30
ABI910_6POST	749625	749627		YPO_RS04405	2
ABI910_6POST	750160	750178		YPO_RS04410	18
ABI910_6POST	750961	750969		YPO_RS04415	8
ABI910_6POST	751097	751111		YPO_RS04415	14
ABI910_6POST	751287	751303		YPO_RS04415	16
ABI910_6POST	751879	751897		YPO_RS04420	18
ABI910_6POST	751997	751999		YPO_RS04420	2
ABI910_6POST	752062	752068		YPO_RS04420	6
ABI910_6POST	752366	752368		YPO_RS04420	2
ABI910_6POST	753260	753292		YPO_RS04425	32
ABI910_6POST	753474	753488		YPO_RS04425	14
ABI910_6POST	753819	753830		YPO_RS04430	11
ABI910_6POST	754417	754459		YPO_RS04435	42
ABI910_6POST	754847	754855		YPO_RS04440	8
ABI910_6POST	755323	755372		YPO_RS04440	49
ABI910_6POST	755369	755375		YPO_RS04445	6
ABI910_6POST	755447	755450		YPO_RS04445	3
ABI910_6POST	756382	756403		YPO_RS04450	21
ABI910_6POST	756550	756564		YPO_RS04450	14
ABI910_6POST	757619	757621		YPO_RS04460	2
ABI910_6POST	757835	757844		YPO_RS04460	9
ABI910_6POST	758816	758835		YPO_RS04465	19
ABI910_6POST	758999	759003		YPO_RS04465	4
ABI910_6POST	759254	759262		YPO_RS04465	8
ABI910_6POST	759437	759447		YPO_RS04465	10
ABI910_6POST	760602	760646		YPO_RS04465	44
ABI910_6POST	760812	760837		YPO_RS04465	25
ABI910_6POST	761349	761361		YPO_RS04470	12
ABI910_6POST	761620	761625		YPO_RS04470	5
ABI910_6POST	761745	761756		YPO_RS04475	11
ABI910_6POST	761946	762009		YPO_RS04475	63
ABI910_6POST	762058	762083		YPO_RS04475	25
ABI910_6POST	762481	762485		YPO_RS04475	4
ABI910_6POST	763277	763292		fepB	15
ABI910_6POST	763397	763427		fepB	30
ABI910_6POST	763685	763729		fepB	44
ABI910_6POST	763784	763785		fepB	1
ABI910_6POST	763820	763826		fepB	6
ABI910_6POST	763887	763920		fepB	33
ABI910_6POST	765023	765025		YPO_RS04485	2
ABI910_6POST	765200	765203		YPO_RS04485	3
ABI910_6POST	765242	765252		YPO_RS04485	10
ABI910_6POST	765465	765493		YPO_RS04485	28
ABI910_6POST	765719	765721		YPO_RS04485	2
ABI910_6POST	765767	765783		YPO_RS04485	16
ABI910_6POST	766101	766108		YPO_RS04490	7
ABI910_6POST	766175	766182		YPO_RS04490	7
ABI910_6POST	766358	766377		YPO_RS04490	19
ABI910_6POST	768973	768979		flhB	6
ABI910_6POST	769344	769352		flhB	8
ABI910_6POST	769540	769543		flhB	3
ABI910_6POST	769663	769668		flhB	5
ABI910_6POST	769709	769711		flhB	2
ABI910_6POST	770106	770108		YPO_RS04505	2
ABI910_6POST	770463	770465		YPO_RS04505	2
ABI910_6POST	770755	770775		YPO_RS04505	20
ABI910_6POST	771275	771277		fliP	2
ABI910_6POST	771719	771750		fliP	31
ABI910_6POST	772203	772206		fliN	3
ABI910_6POST	772407	772416		YPO_RS04525	9
ABI910_6POST	772553	772555		YPO_RS04525	2
ABI910_6POST	773016	773038		YPO_RS04525	22
ABI910_6POST	773866	773867		YPO_RS04530	1
ABI910_6POST	775766	775797		fliF	31
ABI910_6POST	775918	775933		fliF	15
ABI910_6POST	776113	776118		fliF	5
ABI910_6POST	776324	776329		fliF	5
ABI910_6POST	776405	776407		fliF	2
ABI910_6POST	777180	777202		YPO_RS04545	22
ABI910_6POST	777832	777862		YPO_RS04550	30
ABI910_6POST	777923	777926		YPO_RS04550	3
ABI910_6POST	778094	778097		YPO_RS04550	3
ABI910_6POST	778529	778532		fliI	3
ABI910_6POST	778956	779006		fliI	50
ABI910_6POST	779277	779281		fliI	4
ABI910_6POST	779653	779663		fliI	10
ABI910_6POST	780706	780710		YPO_RS04565	4
ABI910_6POST	780933	780943		YPO_RS04565	10
ABI910_6POST	781160	781172		flgM	12
ABI910_6POST	781445	781491		flgA	46
ABI910_6POST	782255	782259		flgA	4
ABI910_6POST	782666	782676		flgB	10
ABI910_6POST	782938	782956		flgC	18
ABI910_6POST	783194	783199		flgC	5
ABI910_6POST	783261	783292		flgD	31
ABI910_6POST	783544	783546		flgD	2
ABI910_6POST	783738	783751		flgD	13
ABI910_6POST	784261	784277		flaE	16
ABI910_6POST	784309	784311		flaE	2
ABI910_6POST	784411	784415		flaE	4
ABI910_6POST	784742	784766		flaE	24
ABI910_6POST	784898	784900		flaE	2
ABI910_6POST	785076	785093		flaE	17
ABI910_6POST	785165	785177		flaE	12
ABI910_6POST	785429	785431		YPO_RS04605	2
ABI910_6POST	786029	786030		flgF	1
ABI910_6POST	786074	786093		flgF	19
ABI910_6POST	786143	786159		flgF	16
ABI910_6POST	786242	786266		flgF	24
ABI910_6POST	786308	786314		flgF	6
ABI910_6POST	786883	786884		flgG	1
ABI910_6POST	786962	786971		flgG	9
ABI910_6POST	787039	787095		flgG	56
ABI910_6POST	787384	787385		flgG	1
ABI910_6POST	787876	787877		flgH	1
ABI910_6POST	788003	788006		flgH	3
ABI910_6POST	788374	788398		YPO_RS04625	24
ABI910_6POST	788748	788753		YPO_RS04625	5
ABI910_6POST	789023	789025		YPO_RS04625	2
ABI910_6POST	789072	789075		YPO_RS04625	3
ABI910_6POST	789257	789263		YPO_RS04625	6
ABI910_6POST	789967	789997		flgK	30
ABI910_6POST	790550	790592		flgK	42
ABI910_6POST	790780	790796		flgK	16
ABI910_6POST	791187	791188		flgL	1
ABI910_6POST	791368	791375		flgL	7
ABI910_6POST	791838	791897		flgL	59
ABI910_6POST	792091	792093		flgL	2
ABI910_6POST	792105	792107		YPO_RS04645	2
ABI910_6POST	792154	792155		YPO_RS04645	1
ABI910_6POST	792421	792434		YPO_RS04645	13
ABI910_6POST	792940	792946		YPO_RS04645	6
ABI910_6POST	793110	793118		YPO_RS04645	8
ABI910_6POST	793426	793436		YPO_RS04650	10
ABI910_6POST	793534	793539		YPO_RS04650	5
ABI910_6POST	794211	794224		YPO_RS04655	13
ABI910_6POST	794667	794672		YPO_RS04655	5
ABI910_6POST	795913	795919		YPO_RS04660	6
ABI910_6POST	796035	796092		YPO_RS04660	57
ABI910_6POST	796155	796166		YPO_RS04660	11
ABI910_6POST	797737	797743		YPO_RS04665	6
ABI910_6POST	797799	797821		YPO_RS04665	22
ABI910_6POST	797878	797885		YPO_RS04665	7
ABI910_6POST	799581	799585		YPO_RS04670	4
ABI910_6POST	800506	800518		fliD	12
ABI910_6POST	800579	800587		fliD	8
ABI910_6POST	800858	800889		fliD	31
ABI910_6POST	801066	801070		fliD	4
ABI910_6POST	801210	801215		fliD	5
ABI910_6POST	801938	801959		YPO_RS04685	21
ABI910_6POST	802097	802105		YPO_RS04690	8
ABI910_6POST	802461	802470		YPO_RS04690	9
ABI910_6POST	802531	802652		YPO_RS04690	121
ABI910_6POST	802711	802724		YPO_RS04690	13
ABI910_6POST	803051	803075		YPO_RS04690	24
ABI910_6POST	804426	804469		motA	43
ABI910_6POST	804664	804670		motA	6
ABI910_6POST	804772	804785		motA	13
ABI910_6POST	804874	804885		motA	11
ABI910_6POST	804962	804968		motA	6
ABI910_6POST	805223	805226		motA	3
ABI910_6POST	805305	805315		lafU	10
ABI910_6POST	805421	805423		lafU	2
ABI910_6POST	806886	806888		YPO_RS04715	2
ABI910_6POST	807273	807283		YPO_RS04720	10
ABI910_6POST	807624	807649		YPO_RS04720	25
ABI910_6POST	808041	808055		YPO_RS04725	14
ABI910_6POST	809238	809241		YPO_RS04735	3
ABI910_6POST	809859	809876		YPO_RS04740	17
ABI910_6POST	809954	809960		YPO_RS04740	6
ABI910_6POST	810166	810171		YPO_RS04740	5
ABI910_6POST	810609	810612		YPO_RS04740	3
ABI910_6POST	810647	810656		YPO_RS04740	9
ABI910_6POST	810700	810736		YPO_RS04740	36
ABI910_6POST	810915	810918		YPO_RS04740	3
ABI910_6POST	810959	810961		YPO_RS04740	2
ABI910_6POST	811144	811149		YPO_RS04740	5
ABI910_6POST	811144	811149		YPO_RS04745	5
ABI910_6POST	811218	811225		YPO_RS04745	7
ABI910_6POST	811493	811505		YPO_RS04745	12
ABI910_6POST	811616	811619		YPO_RS04745	3
ABI910_6POST	811860	811861		YPO_RS04745	1
ABI910_6POST	812086	812089		YPO_RS04745	3
ABI910_6POST	812630	812632		YPO_RS04750	2
ABI910_6POST	814050	814071		YPO_RS04755	21
ABI910_6POST	814168	814169		YPO_RS04755	1
ABI910_6POST	814253	814255		YPO_RS04755	2
ABI910_6POST	814345	814364		YPO_RS04755	19
ABI910_6POST	815014	815036		YPO_RS04755	22
ABI910_6POST	815498	815506		YPO_RS04760	8
ABI910_6POST	815645	815656		YPO_RS04760	11
ABI910_6POST	815802	815807		YPO_RS04760	5
ABI910_6POST	816972	816996		YPO_RS04770	24
ABI910_6POST	817521	817522		YPO_RS04770	1
ABI910_6POST	817677	817736		YPO_RS04770	59
ABI910_6POST	817850	817862		YPO_RS04770	12
ABI910_6POST	818235	818244		YPO_RS04770	9
ABI910_6POST	818508	818510		YPO_RS04770	2
ABI910_6POST	818734	818766		YPO_RS04770	32
ABI910_6POST	818921	818923		YPO_RS04770	2
ABI910_6POST	819303	819311		YPO_RS04770	8
ABI910_6POST	819359	819360		YPO_RS04770	1
ABI910_6POST	819649	819651		YPO_RS04770	2
ABI910_6POST	820015	820027		YPO_RS04770	12
ABI910_6POST	820094	820101		YPO_RS04770	7
ABI910_6POST	820234	820255		YPO_RS04770	21
ABI910_6POST	820473	820511		YPO_RS04770	38
ABI910_6POST	820609	820620		YPO_RS04770	11
ABI910_6POST	820699	820718		YPO_RS04770	19
ABI910_6POST	821077	821111		YPO_RS04770	34
ABI910_6POST	821146	821156		YPO_RS04770	10
ABI910_6POST	822506	822509		YPO_RS04775	3
ABI910_6POST	822786	822793		vgrG	7
ABI910_6POST	823159	823172		vgrG	13
ABI910_6POST	823293	823311		vgrG	18
ABI910_6POST	823422	823424		vgrG	2
ABI910_6POST	823761	823772		vgrG	11
ABI910_6POST	823995	823998		vgrG	3
ABI910_6POST	824183	824195		vgrG	12
ABI910_6POST	824394	824399		vgrG	5
ABI910_6POST	824455	824484		vgrG	29
ABI910_6POST	824646	824666		vgrG	20
ABI910_6POST	830135	830144		gntP	9
ABI910_6POST	830266	830272		gntP	6
ABI910_6POST	830458	830464		gntP	6
ABI910_6POST	830575	830593		gntP	18
ABI910_6POST	830992	830999		gntP	7
ABI910_6POST	831058	831089		gntP	31
ABI910_6POST	831404	831441		gntP	37
ABI910_6POST	834021	834056		YPO_RS04800	35
ABI910_6POST	834320	834408		YPO_RS04800	88
ABI910_6POST	835366	835367		YPO_RS04805	1
ABI910_6POST	835397	835406		YPO_RS04805	9
ABI910_6POST	835987	836001		YPO_RS04805	14
ABI910_6POST	836093	836125		YPO_RS04805	32
ABI910_6POST	836433	836459		YPO_RS04805	26
ABI910_6POST	837138	837178		YPO_RS04810	40
ABI910_6POST	837346	837394		YPO_RS04810	48
ABI910_6POST	837448	837466		YPO_RS04810	18
ABI910_6POST	838640	838646		YPO_RS04815	6
ABI910_6POST	839115	839127		YPO_RS04815	12
ABI910_6POST	839252	839255		YPO_RS04815	3
ABI910_6POST	839438	839442		YPO_RS04815	4
ABI910_6POST	839590	839606		YPO_RS04815	16
ABI910_6POST	839686	839691		YPO_RS04815	5
ABI910_6POST	839756	839762		YPO_RS04815	6
ABI910_6POST	840174	840186		YPO_RS04820	12
ABI910_6POST	840339	840346		YPO_RS04820	7
ABI910_6POST	840879	840888		YPO_RS04825	9
ABI910_6POST	840967	841023		YPO_RS04825	56
ABI910_6POST	841120	841136		YPO_RS04825	16
ABI910_6POST	841214	841226		YPO_RS04825	12
ABI910_6POST	841550	841553		YPO_RS04825	3
ABI910_6POST	841990	842019		YPO_RS04830	29
ABI910_6POST	842069	842103		YPO_RS04830	34
ABI910_6POST	842266	842296		YPO_RS04830	30
ABI910_6POST	842372	842388		YPO_RS04830	16
ABI910_6POST	842688	842693		YPO_RS04830	5
ABI910_6POST	842767	842775		YPO_RS04830	8
ABI910_6POST	842965	842978		YPO_RS04835	13
ABI910_6POST	843468	843488		YPO_RS04835	20
ABI910_6POST	843590	843601		YPO_RS04835	11
ABI910_6POST	843634	843657		YPO_RS04835	23
ABI910_6POST	843836	843845		YPO_RS04835	9
ABI910_6POST	844140	844143		YPO_RS04835	3
ABI910_6POST	844455	844456		YPO_RS04835	1
ABI910_6POST	844530	844540		YPO_RS04835	10
ABI910_6POST	844887	844899		YPO_RS04835	12
ABI910_6POST	844941	844954		YPO_RS04835	13
ABI910_6POST	845520	845562		YPO_RS04835	42
ABI910_6POST	845899	845904		YPO_RS04835	5
ABI910_6POST	846396	846461		YPO_RS04835	65
ABI910_6POST	846500	846503		YPO_RS04835	3
ABI910_6POST	846539	846565		YPO_RS04835	26
ABI910_6POST	847070	847073		YPO_RS04835	3
ABI910_6POST	848479	848511		YPO_RS04835	32
ABI910_6POST	848767	848774		YPO_RS04840	7
ABI910_6POST	849076	849080		YPO_RS04840	4
ABI910_6POST	849278	849305		YPO_RS04840	27
ABI910_6POST	849354	849389		YPO_RS04840	35
ABI910_6POST	849541	849552		YPO_RS04840	11
ABI910_6POST	849616	849621		YPO_RS04840	5
ABI910_6POST	850181	850190		YPO_RS04840	9
ABI910_6POST	850286	850293		YPO_RS04840	7
ABI910_6POST	850357	850358		YPO_RS04845	1
ABI910_6POST	850416	850432		YPO_RS04845	16
ABI910_6POST	850474	850497		YPO_RS04845	23
ABI910_6POST	850731	850733		YPO_RS04845	2
ABI910_6POST	850879	850884		YPO_RS04845	5
ABI910_6POST	851306	851312		YPO_RS04845	6
ABI910_6POST	851762	851778		YPO_RS04845	16
ABI910_6POST	851869	851886		YPO_RS04845	17
ABI910_6POST	852019	852024		YPO_RS04845	5
ABI910_6POST	852273	852277		YPO_RS04845	4
ABI910_6POST	852604	852624		YPO_RS04845	20
ABI910_6POST	852799	852824		YPO_RS04845	25
ABI910_6POST	853695	853704		YPO_RS04845	9
ABI910_6POST	853772	853784		YPO_RS04845	12
ABI910_6POST	854306	854322		YPO_RS04845	16
ABI910_6POST	854515	854516		YPO_RS04845	1
ABI910_6POST	854596	854605		YPO_RS04845	9
ABI910_6POST	854968	854969		YPO_RS04845	1
ABI910_6POST	855389	855407		YPO_RS04845	18
ABI910_6POST	855841	855853		YPO_RS04845	12
ABI910_6POST	855896	855904		YPO_RS04845	8
ABI910_6POST	856408	856447		YPO_RS04845	39
ABI910_6POST	857082	857172		YPO_RS04850	90
ABI910_6POST	857268	857290		YPO_RS04850	22
ABI910_6POST	857364	857452		YPO_RS04850	88
ABI910_6POST	857683	857688		YPO_RS04850	5
ABI910_6POST	857821	857831		YPO_RS04855	10
ABI910_6POST	857937	857944		YPO_RS04855	7
ABI910_6POST	858015	858020		YPO_RS04855	5
ABI910_6POST	858070	858124		YPO_RS04855	54
ABI910_6POST	858167	858207		YPO_RS04855	40
ABI910_6POST	858406	858418		YPO_RS04855	12
ABI910_6POST	858474	858480		YPO_RS04855	6
ABI910_6POST	858582	858611		YPO_RS04855	29
ABI910_6POST	858697	858713		YPO_RS04855	16
ABI910_6POST	858880	858882		YPO_RS04860	2
ABI910_6POST	858927	858941		YPO_RS04860	14
ABI910_6POST	858999	859007		YPO_RS04860	8
ABI910_6POST	859154	859155		YPO_RS04860	1
ABI910_6POST	859539	859558		thyA	19
ABI910_6POST	859876	859882		thyA	6
ABI910_6POST	860155	860160		thyA	5
ABI910_6POST	860474	860491		lgt	17
ABI910_6POST	860582	860590		lgt	8
ABI910_6POST	861101	861113		lgt	12
ABI910_6POST	861643	861672		ptsP	29
ABI910_6POST	861917	861919		ptsP	2
ABI910_6POST	862035	862039		ptsP	4
ABI910_6POST	862308	862365		ptsP	57
ABI910_6POST	862582	862585		ptsP	3
ABI910_6POST	862652	862669		ptsP	17
ABI910_6POST	862791	862800		ptsP	9
ABI910_6POST	863312	863330		ptsP	18
ABI910_6POST	863520	863547		ptsP	27
ABI910_6POST	864028	864031		rppH	3
ABI910_6POST	864212	864216		rppH	4
ABI910_6POST	865232	865248		mutH	16
ABI910_6POST	866493	866503		YPO_RS04890	10
ABI910_6POST	866568	866576		YPO_RS04890	8
ABI910_6POST	866733	866773		YPO_RS04890	40
ABI910_6POST	866943	866962		YPO_RS04890	19
ABI910_6POST	867392	867393		YPO_RS04895	1
ABI910_6POST	867573	867574		YPO_RS04895	1
ABI910_6POST	868063	868071		lplT	8
ABI910_6POST	868462	868498		lplT	36
ABI910_6POST	869542	869554		aas	12
ABI910_6POST	869648	869679		aas	31
ABI910_6POST	869732	869735		aas	3
ABI910_6POST	869942	869948		aas	6
ABI910_6POST	870116	870134		aas	18
ABI910_6POST	870538	870545		aas	7
ABI910_6POST	870741	870756		aas	15
ABI910_6POST	871022	871036		aas	14
ABI910_6POST	871134	871171		aas	37
ABI910_6POST	871943	871982		YPO_RS04915	39
ABI910_6POST	872300	872311		YPO_RS04915	11
ABI910_6POST	872432	872463		YPO_RS04915	31
ABI910_6POST	872714	872732		YPO_RS04915	18
ABI910_6POST	872774	872807		YPO_RS04915	33
ABI910_6POST	872979	872991		YPO_RS04915	12
ABI910_6POST	873035	873050		YPO_RS04915	15
ABI910_6POST	874839	874846		galR	7
ABI910_6POST	875041	875051		galR	10
ABI910_6POST	875116	875140		galR	24
ABI910_6POST	875486	875512		lysA	26
ABI910_6POST	875562	875566		lysA	4
ABI910_6POST	875803	875804		lysA	1
ABI910_6POST	876526	876535		lysA	9
ABI910_6POST	877022	877030		YPO_RS04930	8
ABI910_6POST	877556	877618		YPO_RS04930	62
ABI910_6POST	877766	877769		YPO_RS04930	3
ABI910_6POST	877904	877972		YPO_RS04935	68
ABI910_6POST	878412	878422		YPO_RS04935	10
ABI910_6POST	878546	878549		YPO_RS04935	3
ABI910_6POST	879988	879989		YPO_RS04940	1
ABI910_6POST	880379	880385		YPO_RS04945	6
ABI910_6POST	880706	880721		YPO_RS04945	15
ABI910_6POST	880873	880917		YPO_RS04945	44
ABI910_6POST	881358	881369		YPO_RS04950	11
ABI910_6POST	881721	881740		YPO_RS04950	19
ABI910_6POST	882559	882581		YPO_RS04955	22
ABI910_6POST	882763	882769		YPO_RS04955	6
ABI910_6POST	882967	882969		YPO_RS04955	2
ABI910_6POST	883804	883834		YPO_RS04960	30
ABI910_6POST	883875	883876		YPO_RS04960	1
ABI910_6POST	883993	884006		YPO_RS04960	13
ABI910_6POST	884202	884217		YPO_RS04965	15
ABI910_6POST	884626	884636		YPO_RS04965	10
ABI910_6POST	884777	884779		YPO_RS04965	2
ABI910_6POST	885559	885573		YPO_RS04975	14
ABI910_6POST	885856	885872		YPO_RS04975	16
ABI910_6POST	886082	886099		YPO_RS04975	17
ABI910_6POST	886331	886352		YPO_RS04975	21
ABI910_6POST	886490	886502		YPO_RS04980	12
ABI910_6POST	886592	886628		YPO_RS04980	36
ABI910_6POST	887061	887064		gspL	3
ABI910_6POST	887175	887186		gspL	11
ABI910_6POST	887223	887242		gspL	19
ABI910_6POST	887463	887472		gspL	9
ABI910_6POST	888086	888106		YPO_RS04990	20
ABI910_6POST	888164	888174		YPO_RS04990	10
ABI910_6POST	889318	889329		gspJ	11
ABI910_6POST	890256	890262		YPO_RS05005	6
ABI910_6POST	890864	890897		gspG	33
ABI910_6POST	893197	893205		gspE	8
ABI910_6POST	893559	893561		gspE	2
ABI910_6POST	893717	893768		gspD	51
ABI910_6POST	893803	893842		gspD	39
ABI910_6POST	894057	894065		gspD	8
ABI910_6POST	894511	894512		gspD	1
ABI910_6POST	894667	894668		gspD	1
ABI910_6POST	895109	895123		gspD	14
ABI910_6POST	895695	895699		YPO_RS05030	4
ABI910_6POST	895761	895820		YPO_RS05030	59
ABI910_6POST	896611	896626		YPO_RS05035	15
ABI910_6POST	897704	897722		YPO_RS05040	18
ABI910_6POST	897955	897973		YPO_RS05040	18
ABI910_6POST	898715	898742		YPO_RS05045	27
ABI910_6POST	899818	899822		YPO_RS05050	4
ABI910_6POST	900050	900055		YPO_RS05050	5
ABI910_6POST	900174	900181		YPO_RS05050	7
ABI910_6POST	901031	901039		yapM	8
ABI910_6POST	901311	901328		yapM	17
ABI910_6POST	902416	902422		yapM	6
ABI910_6POST	902839	902842		YPO_RS05060	3
ABI910_6POST	903055	903078		YPO_RS05060	23
ABI910_6POST	903125	903133		YPO_RS05060	8
ABI910_6POST	903407	903416		YPO_RS05060	9
ABI910_6POST	903831	903835		YPO_RS05060	4
ABI910_6POST	903957	904020		YPO_RS05060	63
ABI910_6POST	904130	904166		YPO_RS05060	36
ABI910_6POST	904247	904249		YPO_RS05060	2
ABI910_6POST	904283	904290		YPO_RS05060	7
ABI910_6POST	904556	904567		YPO_RS05060	11
ABI910_6POST	904738	904739		YPO_RS05060	1
ABI910_6POST	905286	905316		YPO_RS05060	30
ABI910_6POST	905354	905382		YPO_RS05060	28
ABI910_6POST	906251	906258		YPO_RS05065	7
ABI910_6POST	906326	906333		YPO_RS05065	7
ABI910_6POST	906381	906417		YPO_RS05065	36
ABI910_6POST	906517	906530		YPO_RS05065	13
ABI910_6POST	906596	906705		YPO_RS05065	109
ABI910_6POST	906914	906929		YPO_RS05065	15
ABI910_6POST	907129	907142		YPO_RS05070	13
ABI910_6POST	907212	907230		YPO_RS05070	18
ABI910_6POST	907318	907343		YPO_RS05070	25
ABI910_6POST	907375	907388		YPO_RS05070	13
ABI910_6POST	907429	907466		YPO_RS05070	37
ABI910_6POST	907506	907512		YPO_RS05070	6
ABI910_6POST	907656	907659		YPO_RS05070	3
ABI910_6POST	907711	907718		YPO_RS05070	7
ABI910_6POST	908116	908125		tnpA	9
ABI910_6POST	909492	909496		YPO_RS05080	4
ABI910_6POST	910183	910190		YPO_RS05080	7
ABI910_6POST	910255	910272		YPO_RS05080	17
ABI910_6POST	910342	910350		YPO_RS05080	8
ABI910_6POST	910443	910457		YPO_RS05080	14
ABI910_6POST	912367	912379		kbaZ	12
ABI910_6POST	913024	913025		kbaZ	1
ABI910_6POST	913722	913763		YPO_RS05095	41
ABI910_6POST	913923	913949		YPO_RS05095	26
ABI910_6POST	914199	914237		YPO_RS05095	38
ABI910_6POST	914483	914503		YPO_RS05095	20
ABI910_6POST	915416	915447		YPO_RS05105	31
ABI910_6POST	916091	916098		YPO_RS05110	7
ABI910_6POST	916313	916324		YPO_RS05110	11
ABI910_6POST	916533	916564		YPO_RS05110	31
ABI910_6POST	916628	916630		YPO_RS05110	2
ABI910_6POST	916884	916892		YPO_RS05110	8
ABI910_6POST	917421	917422		nagA	1
ABI910_6POST	917580	917587		nagA	7
ABI910_6POST	917776	917781		nagA	5
ABI910_6POST	918111	918134		nagA	23
ABI910_6POST	918265	918276		nagA	11
ABI910_6POST	918383	918390		nagA	7
ABI910_6POST	918463	918471		nagA	8
ABI910_6POST	918975	918984		kduD	9
ABI910_6POST	919251	919257		kduD	6
ABI910_6POST	920035	920036		YPO_RS05130	1
ABI910_6POST	920192	920195		YPO_RS05130	3
ABI910_6POST	920418	920424		YPO_RS05130	6
ABI910_6POST	921898	921902		YPO_RS05135	4
ABI910_6POST	922221	922224		YPO_RS05140	3
ABI910_6POST	922280	922296		YPO_RS05140	16
ABI910_6POST	922498	922504		YPO_RS05140	6
ABI910_6POST	923133	923146		YPO_RS05140	13
ABI910_6POST	923296	923302		YPO_RS05140	6
ABI910_6POST	923572	923574		YPO_RS05140	2
ABI910_6POST	923833	923848		YPO_RS05145	15
ABI910_6POST	923896	923912		YPO_RS05145	16
ABI910_6POST	924258	924308		YPO_RS05145	50
ABI910_6POST	924592	924613		YPO_RS05145	21
ABI910_6POST	925195	925202		YPO_RS05145	7
ABI910_6POST	926110	926116		YPO_RS05150	6
ABI910_6POST	926708	926720		YPO_RS05155	12
ABI910_6POST	927140	927148		YPO_RS05160	8
ABI910_6POST	927192	927200		YPO_RS05160	8
ABI910_6POST	927363	927379		YPO_RS05160	16
ABI910_6POST	927544	927547		YPO_RS05160	3
ABI910_6POST	927970	927977		YPO_RS05160	7
ABI910_6POST	928161	928168		YPO_RS05160	7
ABI910_6POST	928602	928621		YPO_RS05165	19
ABI910_6POST	928891	928939		YPO_RS05165	48
ABI910_6POST	930342	930358		YPO_RS05170	16
ABI910_6POST	930436	930442		YPO_RS05170	6
ABI910_6POST	931486	931525		YPO_RS05170	39
ABI910_6POST	932079	932087		YPO_RS05170	8
ABI910_6POST	932256	932275		YPO_RS05170	19
ABI910_6POST	934483	934486		YPO_RS05180	3
ABI910_6POST	934964	934972		YPO_RS05180	8
ABI910_6POST	935785	935791		YPO_RS05185	6
ABI910_6POST	935902	935915		YPO_RS05185	13
ABI910_6POST	936226	936263		YPO_RS05190	37
ABI910_6POST	937034	937039		YPO_RS05190	5
ABI910_6POST	937212	937217		YPO_RS05190	5
ABI910_6POST	938184	938195		YPO_RS05190	11
ABI910_6POST	938440	938462		YPO_RS05195	22
ABI910_6POST	938680	938689		YPO_RS05195	9
ABI910_6POST	938970	938974		YPO_RS05195	4
ABI910_6POST	939368	939371		YPO_RS05195	3
ABI910_6POST	939414	939422		YPO_RS05195	8
ABI910_6POST	939582	939585		YPO_RS05200	3
ABI910_6POST	939888	939895		YPO_RS05200	7
ABI910_6POST	940059	940066		YPO_RS05200	7
ABI910_6POST	940103	940107		YPO_RS05200	4
ABI910_6POST	940149	940152		YPO_RS05200	3
ABI910_6POST	940693	940719		YPO_RS05205	26
ABI910_6POST	940905	940917		YPO_RS05205	12
ABI910_6POST	941561	941582		YPO_RS05205	21
ABI910_6POST	942221	942249		YPO_RS05210	28
ABI910_6POST	942410	942428		YPO_RS05210	18
ABI910_6POST	942590	942612		YPO_RS05210	22
ABI910_6POST	942674	942677		YPO_RS05210	3
ABI910_6POST	942767	942789		YPO_RS05210	22
ABI910_6POST	942922	942929		YPO_RS05210	7
ABI910_6POST	943701	943719		YPO_RS05215	18
ABI910_6POST	944217	944232		YPO_RS05215	15
ABI910_6POST	945348	945355		YPO_RS05220	7
ABI910_6POST	945848	945872		YPO_RS05220	24
ABI910_6POST	946308	946328		YPO_RS05220	20
ABI910_6POST	946407	946419		YPO_RS05220	12
ABI910_6POST	946639	946644		YPO_RS05225	5
ABI910_6POST	946975	946988		YPO_RS05225	13
ABI910_6POST	948914	948919		YPO_RS05230	5
ABI910_6POST	950127	950132		YPO_RS05235	5
ABI910_6POST	950781	950784		YPO_RS05240	3
ABI910_6POST	951015	951016		YPO_RS05240	1
ABI910_6POST	952623	952637		YPO_RS05245	14
ABI910_6POST	953152	953172		YPO_RS05255	20
ABI910_6POST	953855	953883		YPO_RS05260	28
ABI910_6POST	953959	953985		YPO_RS05260	26
ABI910_6POST	954289	954298		YPO_RS05260	9
ABI910_6POST	955760	955765		YPO_RS05265	5
ABI910_6POST	955760	955765		YPO_RS05270	5
ABI910_6POST	956001	956040		YPO_RS05270	39
ABI910_6POST	956544	956547		YPO_RS05270	3
ABI910_6POST	956726	956732		YPO_RS05270	6
ABI910_6POST	956821	956831		YPO_RS05270	10
ABI910_6POST	957374	957393		YPO_RS05270	19
ABI910_6POST	957451	957479		YPO_RS05270	28
ABI910_6POST	957863	957865		YPO_RS05270	2
ABI910_6POST	957902	957917		YPO_RS05270	15
ABI910_6POST	959598	959607		YPO_RS05290	9
ABI910_6POST	959653	959668		YPO_RS05290	15
ABI910_6POST	960396	960403		YPO_RS05290	7
ABI910_6POST	960497	960504		YPO_RS05290	7
ABI910_6POST	960640	960662		YPO_RS05290	22
ABI910_6POST	961809	961860		YPO_RS05295	51
ABI910_6POST	962227	962228		YPO_RS05295	1
ABI910_6POST	962278	962280		YPO_RS05295	2
ABI910_6POST	962364	962372		YPO_RS05295	8
ABI910_6POST	962577	962591		YPO_RS05295	14
ABI910_6POST	963059	963107		YPO_RS05300	48
ABI910_6POST	964124	964135		YPO_RS05315	11
ABI910_6POST	965354	965362		YPO_RS05330	8
ABI910_6POST	965526	965550		YPO_RS05330	24
ABI910_6POST	966019	966020		YPO_RS05330	1
ABI910_6POST	966491	966495		YPO_RS05330	4
ABI910_6POST	966585	966609		YPO_RS05330	24
ABI910_6POST	966759	966760		YPO_RS05330	1
ABI910_6POST	967234	967246		YPO_RS05330	12
ABI910_6POST	970382	970387		YPO_RS05360	5
ABI910_6POST	970581	970601		YPO_RS05360	20
ABI910_6POST	970990	971001		YPO_RS05360	11
ABI910_6POST	971813	971843		lysS	30
ABI910_6POST	972387	972394		lysS	7
ABI910_6POST	973025	973036		lysS	11
ABI910_6POST	973374	973389		prfB	15
ABI910_6POST	973626	973631		prfB	5
ABI910_6POST	974119	974123		prfB	4
ABI910_6POST	974749	974758		recJ	9
ABI910_6POST	974806	974812		recJ	6
ABI910_6POST	975353	975377		recJ	24
ABI910_6POST	976158	976188		recJ	30
ABI910_6POST	976220	976229		recJ	9
ABI910_6POST	976515	976526		dsbC	11
ABI910_6POST	976639	976663		dsbC	24
ABI910_6POST	976763	976766		dsbC	3
ABI910_6POST	976814	976815		dsbC	1
ABI910_6POST	976858	976872		dsbC	14
ABI910_6POST	977191	977199		xerD	8
ABI910_6POST	977296	977299		xerD	3
ABI910_6POST	977375	977380		xerD	5
ABI910_6POST	978137	978141		fldB	4
ABI910_6POST	978174	978178		fldB	4
ABI910_6POST	978826	978833		creD	7
ABI910_6POST	978992	979017		creD	25
ABI910_6POST	979236	979243		creD	7
ABI910_6POST	979582	979584		creD	2
ABI910_6POST	980942	980953		creC	11
ABI910_6POST	981255	981260		creC	5
ABI910_6POST	981362	981368		creC	6
ABI910_6POST	982257	982281		creB	24
ABI910_6POST	982508	982529		YPO_RS05415	21
ABI910_6POST	982667	982688		YPO_RS05415	21
ABI910_6POST	983397	983415		ygfZ	18
ABI910_6POST	983455	983463		ygfZ	8
ABI910_6POST	983526	983527		ygfZ	1
ABI910_6POST	983798	983806		ygfZ	8
ABI910_6POST	984098	984108		ygfZ	10
ABI910_6POST	985310	985314		YPO_RS05435	4
ABI910_6POST	985393	985398		YPO_RS05435	5
ABI910_6POST	985654	985684		YPO_RS05435	30
ABI910_6POST	985835	985840		YPO_RS05435	5
ABI910_6POST	986275	986291		YPO_RS05440	16
ABI910_6POST	986339	986352		YPO_RS05440	13
ABI910_6POST	986591	986601		YPO_RS05440	10
ABI910_6POST	986850	986884		YPO_RS05440	34
ABI910_6POST	986958	986965		YPO_RS05440	7
ABI910_6POST	990715	990724		YPO_RS05455	9
ABI910_6POST	990825	990826		YPO_RS05455	1
ABI910_6POST	991390	991397		gcvP	7
ABI910_6POST	992089	992096		gcvP	7
ABI910_6POST	992303	992310		gcvP	7
ABI910_6POST	993111	993164		gcvP	53
ABI910_6POST	993520	993529		gcvP	9
ABI910_6POST	993906	993919		gcvP	13
ABI910_6POST	994616	994651		gcvH	35
ABI910_6POST	995173	995181		gcvT	8
ABI910_6POST	995307	995311		gcvT	4
ABI910_6POST	996920	996923		ubiI	3
ABI910_6POST	997198	997201		ubiI	3
ABI910_6POST	997280	997288		ubiI	8
ABI910_6POST	998212	998241		ubiH	29
ABI910_6POST	998344	998348		ubiH	4
ABI910_6POST	998384	998395		ubiH	11
ABI910_6POST	998636	998650		ubiH	14
ABI910_6POST	998901	998909		ubiH	8
ABI910_6POST	999169	999181		ubiH	12
ABI910_6POST	999673	999689		pepP	16
ABI910_6POST	999904	999905		pepP	1
ABI910_6POST	999996	1000008		pepP	12
ABI910_6POST	1000518	1000553		pepP	35
ABI910_6POST	1000933	1000950		YPO_RS05490	17
ABI910_6POST	1002683	1002697		YPO_RS05505	14
ABI910_6POST	1004058	1004069		serA	11
ABI910_6POST	1004738	1004739		rpiA	1
ABI910_6POST	1005121	1005123		rpiA	2
ABI910_6POST	1005910	1005930		YPO_RS05520	20
ABI910_6POST	1006435	1006436		YPO_RS05520	1
ABI910_6POST	1006502	1006508		YPO_RS05520	6
ABI910_6POST	1006608	1006613		YPO_RS05520	5
ABI910_6POST	1006678	1006722		YPO_RS05525	44
ABI910_6POST	1006821	1006822		YPO_RS05525	1
ABI910_6POST	1007634	1007643		argO	9
ABI910_6POST	1007703	1007714		argO	11
ABI910_6POST	1007788	1007806		argO	18
ABI910_6POST	1007939	1007940		argO	1
ABI910_6POST	1007973	1007990		argO	17
ABI910_6POST	1008203	1008213		argO	10
ABI910_6POST	1008529	1008542		mscS	13
ABI910_6POST	1008702	1008706		mscS	4
ABI910_6POST	1008886	1008893		mscS	7
ABI910_6POST	1009071	1009086		mscS	15
ABI910_6POST	1010567	1010585		fbaA	18
ABI910_6POST	1010993	1010994		pgk	1
ABI910_6POST	1012547	1012560		epd	13
ABI910_6POST	1012992	1012999		epd	7
ABI910_6POST	1013661	1013692		YPO_RS05555	31
ABI910_6POST	1013725	1013758		YPO_RS05555	33
ABI910_6POST	1013847	1013886		YPO_RS05555	39
ABI910_6POST	1013943	1014040		YPO_RS05555	97
ABI910_6POST	1014109	1014116		YPO_RS05555	7
ABI910_6POST	1014355	1014358		YPO_RS05555	3
ABI910_6POST	1014358	1014359		YPO_RS05560	1
ABI910_6POST	1014393	1014420		YPO_RS05560	27
ABI910_6POST	1014596	1014604		YPO_RS05560	8
ABI910_6POST	1014637	1014661		YPO_RS05560	24
ABI910_6POST	1014711	1014714		YPO_RS05560	3
ABI910_6POST	1015112	1015118		YPO_RS05560	6
ABI910_6POST	1015212	1015230		YPO_RS05560	18
ABI910_6POST	1015291	1015307		YPO_RS05560	16
ABI910_6POST	1015932	1015935		YPO_RS05565	3
ABI910_6POST	1016014	1016015		YPO_RS05565	1
ABI910_6POST	1016887	1016900		tkt	13
ABI910_6POST	1017073	1017104		tkt	31
ABI910_6POST	1017875	1017906		tkt	31
ABI910_6POST	1019296	1019298		YPO_RS05575	2
ABI910_6POST	1019904	1019907		YPO_RS05585	3
ABI910_6POST	1019962	1019982		YPO_RS05585	20
ABI910_6POST	1020685	1020710		speA	25
ABI910_6POST	1020880	1020890		speA	10
ABI910_6POST	1021189	1021205		speA	16
ABI910_6POST	1023680	1023703		metK	23
ABI910_6POST	1023892	1023907		metK	15
ABI910_6POST	1025521	1025533		endA	12
ABI910_6POST	1025993	1026006		endA	13
ABI910_6POST	1026961	1027001		rsmE	40
ABI910_6POST	1027313	1027324		gshB	11
ABI910_6POST	1027420	1027434		gshB	14
ABI910_6POST	1027688	1027703		gshB	15
ABI910_6POST	1029682	1029683		aguB	1
ABI910_6POST	1029902	1029903		aguB	1
ABI910_6POST	1030013	1030033		aguB	20
ABI910_6POST	1030078	1030084		aguB	6
ABI910_6POST	1030805	1030807		aguA	2
ABI910_6POST	1030855	1030857		aguA	2
ABI910_6POST	1031548	1031560		YPO_RS05640	12
ABI910_6POST	1032322	1032346		YPO_RS05640	24
ABI910_6POST	1032470	1032503		YPO_RS05640	33
ABI910_6POST	1032624	1032636		YPO_RS05640	12
ABI910_6POST	1033144	1033187		YPO_RS05645	43
ABI910_6POST	1033287	1033301		YPO_RS05645	14
ABI910_6POST	1033665	1033688		YPO_RS05650	23
ABI910_6POST	1033882	1033903		YPO_RS05650	21
ABI910_6POST	1034854	1034877		YPO_RS05655	23
ABI910_6POST	1035599	1035606		YPO_RS05665	7
ABI910_6POST	1036059	1036064		YPO_RS05665	5
ABI910_6POST	1038466	1038477		YPO_RS05675	11
ABI910_6POST	1038688	1038698		YPO_RS05675	10
ABI910_6POST	1038762	1038780		YPO_RS05675	18
ABI910_6POST	1039447	1039467		YPO_RS05675	20
ABI910_6POST	1040134	1040148		YPO_RS05675	14
ABI910_6POST	1040293	1040307		YPO_RS05675	14
ABI910_6POST	1040595	1040597		YPO_RS05675	2
ABI910_6POST	1040804	1040810		YPO_RS05675	6
ABI910_6POST	1041042	1041057		YPO_RS05675	15
ABI910_6POST	1041198	1041206		YPO_RS05675	8
ABI910_6POST	1041637	1041670		YPO_RS05675	33
ABI910_6POST	1042107	1042108		YPO_RS05675	1
ABI910_6POST	1042175	1042176		YPO_RS05675	1
ABI910_6POST	1042620	1042621		YPO_RS05675	1
ABI910_6POST	1043027	1043029		YPO_RS05675	2
ABI910_6POST	1043159	1043171		YPO_RS05675	12
ABI910_6POST	1043957	1043979		YPO_RS05675	22
ABI910_6POST	1044040	1044053		YPO_RS05675	13
ABI910_6POST	1044134	1044149		YPO_RS05675	15
ABI910_6POST	1044550	1044561		YPO_RS05675	11
ABI910_6POST	1044642	1044675		YPO_RS05675	33
ABI910_6POST	1045159	1045160		YPO_RS05675	1
ABI910_6POST	1045829	1045831		YPO_RS05675	2
ABI910_6POST	1046176	1046177		YPO_RS05675	1
ABI910_6POST	1046455	1046496		YPO_RS05675	41
ABI910_6POST	1048363	1048376		glsB	13
ABI910_6POST	1048580	1048587		glsB	7
ABI910_6POST	1049078	1049081		glsB	3
ABI910_6POST	1049290	1049291		YPO_RS05690	1
ABI910_6POST	1049419	1049426		YPO_RS05690	7
ABI910_6POST	1049668	1049673		trmB	5
ABI910_6POST	1049891	1049893		trmB	2
ABI910_6POST	1049994	1050017		trmB	23
ABI910_6POST	1051318	1051333		mutY	15
ABI910_6POST	1051477	1051499		mutY	22
ABI910_6POST	1051559	1051577		mutY	18
ABI910_6POST	1051673	1051676		mutY	3
ABI910_6POST	1052355	1052360		mltC	5
ABI910_6POST	1052700	1052725		mltC	25
ABI910_6POST	1052852	1052859		mltC	7
ABI910_6POST	1053208	1053215		mltC	7
ABI910_6POST	1053318	1053326		mltC	8
ABI910_6POST	1053398	1053399		mltC	1
ABI910_6POST	1053838	1053862		YPO_RS05715	24
ABI910_6POST	1054282	1054285		YPO_RS05715	3
ABI910_6POST	1054950	1054957		YPO_RS05720	7
ABI910_6POST	1055014	1055017		YPO_RS05720	3
ABI910_6POST	1055861	1055888		YPO_RS05720	27
ABI910_6POST	1055995	1056041		YPO_RS05720	46
ABI910_6POST	1056199	1056208		YPO_RS05720	9
ABI910_6POST	1056266	1056274		YPO_RS05720	8
ABI910_6POST	1056465	1056473		YPO_RS05720	8
ABI910_6POST	1057067	1057086		YPO_RS05725	19
ABI910_6POST	1057251	1057277		YPO_RS05725	26
ABI910_6POST	1057473	1057477		YPO_RS05725	4
ABI910_6POST	1057658	1057660		YPO_RS05725	2
ABI910_6POST	1057694	1057723		YPO_RS05725	29
ABI910_6POST	1057856	1057859		YPO_RS05725	3
ABI910_6POST	1057971	1058001		YPO_RS05725	30
ABI910_6POST	1058241	1058249		YPO_RS05730	8
ABI910_6POST	1058335	1058363		YPO_RS05730	28
ABI910_6POST	1058551	1058556		YPO_RS05730	5
ABI910_6POST	1058731	1058775		YPO_RS05730	44
ABI910_6POST	1058986	1059021		YPO_RS05730	35
ABI910_6POST	1059508	1059534		YPO_RS05730	26
ABI910_6POST	1059631	1059635		YPO_RS05735	4
ABI910_6POST	1061298	1061303		speF	5
ABI910_6POST	1061533	1061537		speF	4
ABI910_6POST	1062159	1062163		speF	4
ABI910_6POST	1062857	1062862		speF	5
ABI910_6POST	1063029	1063035		speF	6
ABI910_6POST	1064602	1064612		YPO_RS05755	10
ABI910_6POST	1064687	1064689		YPO_RS05755	2
ABI910_6POST	1064924	1064928		YPO_RS05755	4
ABI910_6POST	1065200	1065221		YPO_RS05755	21
ABI910_6POST	1065835	1065836		YPO_RS05760	1
ABI910_6POST	1066036	1066042		YPO_RS05760	6
ABI910_6POST	1066653	1066660		YPO_RS05765	7
ABI910_6POST	1066708	1066709		YPO_RS05765	1
ABI910_6POST	1067038	1067054		YPO_RS05765	16
ABI910_6POST	1067306	1067370		YPO_RS05765	64
ABI910_6POST	1067876	1067916		YPO_RS05770	40
ABI910_6POST	1068397	1068406		YPO_RS05770	9
ABI910_6POST	1068445	1068453		YPO_RS05770	8
ABI910_6POST	1069479	1069495		YPO_RS05770	16
ABI910_6POST	1070314	1070324		YPO_RS05775	10
ABI910_6POST	1072140	1072143		YPO_RS05790	3
ABI910_6POST	1072656	1072683		YPO_RS05795	27
ABI910_6POST	1073103	1073120		YPO_RS05795	17
ABI910_6POST	1073157	1073158		YPO_RS05795	1
ABI910_6POST	1073681	1073700		YPO_RS05795	19
ABI910_6POST	1073989	1073993		YPO_RS05795	4
ABI910_6POST	1074489	1074492		YPO_RS05795	3
ABI910_6POST	1074784	1074789		YPO_RS05800	5
ABI910_6POST	1075384	1075389		YPO_RS05800	5
ABI910_6POST	1075562	1075583		YPO_RS05800	21
ABI910_6POST	1076187	1076192		YPO_RS05800	5
ABI910_6POST	1076401	1076402		YPO_RS05800	1
ABI910_6POST	1076713	1076720		YPO_RS05800	7
ABI910_6POST	1076992	1077008		tssH	16
ABI910_6POST	1077311	1077314		tssH	3
ABI910_6POST	1077405	1077411		tssH	6
ABI910_6POST	1077604	1077615		tssH	11
ABI910_6POST	1077959	1077975		tssH	16
ABI910_6POST	1078605	1078633		tssH	28
ABI910_6POST	1079197	1079214		tssH	17
ABI910_6POST	1079440	1079449		tssH	9
ABI910_6POST	1079550	1079561		tssH	11
ABI910_6POST	1080046	1080052		YPO_RS05810	6
ABI910_6POST	1080364	1080369		YPO_RS05810	5
ABI910_6POST	1080467	1080472		YPO_RS05810	5
ABI910_6POST	1080640	1080642		YPO_RS05815	2
ABI910_6POST	1081919	1081943		YPO_RS05815	24
ABI910_6POST	1081977	1081978		YPO_RS05815	1
ABI910_6POST	1082028	1082038		YPO_RS05815	10
ABI910_6POST	1082160	1082202		YPO_RS05815	42
ABI910_6POST	1082259	1082275		YPO_RS05815	16
ABI910_6POST	1082307	1082340		YPO_RS05820	33
ABI910_6POST	1082377	1082387		YPO_RS05820	10
ABI910_6POST	1082426	1082427		YPO_RS05820	1
ABI910_6POST	1082518	1082532		YPO_RS05820	14
ABI910_6POST	1082888	1082957		YPO_RS05820	69
ABI910_6POST	1083026	1083052		tssK	26
ABI910_6POST	1083580	1083583		tssK	3
ABI910_6POST	1083798	1083806		tssK	8
ABI910_6POST	1083845	1083861		tssK	16
ABI910_6POST	1084828	1084864		tssC	36
ABI910_6POST	1085208	1085220		tssC	12
ABI910_6POST	1085593	1085597		tssC	4
ABI910_6POST	1086029	1086045		tssB	16
ABI910_6POST	1086274	1086279		tssB	5
ABI910_6POST	1088936	1088937		YPO_RS05845	1
ABI910_6POST	1089066	1089067		YPO_RS05845	1
ABI910_6POST	1089611	1089613		YPO_RS05850	2
ABI910_6POST	1092560	1092574		YPO_RS05860	14
ABI910_6POST	1092637	1092668		YPO_RS05860	31
ABI910_6POST	1093348	1093363		YPO_RS05865	15
ABI910_6POST	1093508	1093549		YPO_RS05865	41
ABI910_6POST	1093959	1093973		YPO_RS05865	14
ABI910_6POST	1094571	1094576		YPO_RS05865	5
ABI910_6POST	1095396	1095397		YPO_RS05870	1
ABI910_6POST	1095480	1095492		YPO_RS05870	12
ABI910_6POST	1096509	1096520		YPO_RS05880	11
ABI910_6POST	1096692	1096703		YPO_RS05880	11
ABI910_6POST	1096771	1096812		YPO_RS05880	41
ABI910_6POST	1096846	1096865		YPO_RS05880	19
ABI910_6POST	1096969	1096988		YPO_RS05880	19
ABI910_6POST	1097066	1097076		YPO_RS05880	10
ABI910_6POST	1099583	1099646		YPO_RS05890	63
ABI910_6POST	1100401	1100406		iucC	5
ABI910_6POST	1100591	1100631		iucC	40
ABI910_6POST	1101064	1101077		iucC	13
ABI910_6POST	1101471	1101478		iucC	7
ABI910_6POST	1102799	1102815		YPO_RS05900	16
ABI910_6POST	1103258	1103273		YPO_RS05900	15
ABI910_6POST	1103416	1103448		YPO_RS05905	32
ABI910_6POST	1103788	1103804		YPO_RS05905	16
ABI910_6POST	1103970	1103982		YPO_RS05905	12
ABI910_6POST	1104180	1104194		YPO_RS05905	14
ABI910_6POST	1104591	1104604		YPO_RS05905	13
ABI910_6POST	1104747	1104759		YPO_RS05905	12
ABI910_6POST	1104810	1104814		YPO_RS05905	4
ABI910_6POST	1105046	1105088		YPO_RS05905	42
ABI910_6POST	1105246	1105270		YPO_RS05905	24
ABI910_6POST	1105328	1105342		YPO_RS05905	14
ABI910_6POST	1105504	1105557		YPO_RS05905	53
ABI910_6POST	1105836	1105844		YPO_RS05910	8
ABI910_6POST	1106588	1106600		YPO_RS05910	12
ABI910_6POST	1106653	1106654		YPO_RS05910	1
ABI910_6POST	1106797	1106844		YPO_RS05910	47
ABI910_6POST	1106976	1106980		YPO_RS05910	4
ABI910_6POST	1107605	1107680		YPO_RS05915	75
ABI910_6POST	1108119	1108135		YPO_RS05915	16
ABI910_6POST	1108326	1108335		YPO_RS05915	9
ABI910_6POST	1109135	1109149		YPO_RS05920	14
ABI910_6POST	1109719	1109752		YPO_RS05920	33
ABI910_6POST	1109873	1109874		YPO_RS05920	1
ABI910_6POST	1110020	1110032		YPO_RS05920	12
ABI910_6POST	1110878	1110896		YPO_RS05920	18
ABI910_6POST	1110963	1110978		YPO_RS05920	15
ABI910_6POST	1111037	1111057		YPO_RS05920	20
ABI910_6POST	1111275	1111291		YPO_RS05920	16
ABI910_6POST	1111332	1111338		YPO_RS05920	6
ABI910_6POST	1113146	1113167		YPO_RS05930	21
ABI910_6POST	1113244	1113277		YPO_RS05930	33
ABI910_6POST	1113414	1113425		YPO_RS05935	11
ABI910_6POST	1113622	1113647		YPO_RS05935	25
ABI910_6POST	1113774	1113812		YPO_RS05935	38
ABI910_6POST	1113852	1113869		YPO_RS05935	17
ABI910_6POST	1114202	1114213		YPO_RS05935	11
ABI910_6POST	1114422	1114429		YPO_RS05935	7
ABI910_6POST	1114687	1114721		YPO_RS05935	34
ABI910_6POST	1114993	1115013		YPO_RS05935	20
ABI910_6POST	1115044	1115053		YPO_RS05935	9
ABI910_6POST	1115851	1115858		YPO_RS05935	7
ABI910_6POST	1116065	1116083		YPO_RS05935	18
ABI910_6POST	1116387	1116399		YPO_RS05935	12
ABI910_6POST	1118056	1118068		YPO_RS05940	12
ABI910_6POST	1118434	1118467		YPO_RS05945	33
ABI910_6POST	1118625	1118635		YPO_RS05945	10
ABI910_6POST	1120130	1120132		yapH	2
ABI910_6POST	1120255	1120265		yapH	10
ABI910_6POST	1120403	1120411		yapH	8
ABI910_6POST	1120935	1120942		yapH	7
ABI910_6POST	1121539	1121551		yapH	12
ABI910_6POST	1121880	1121888		yapH	8
ABI910_6POST	1121943	1121947		yapH	4
ABI910_6POST	1122033	1122035		yapH	2
ABI910_6POST	1122190	1122225		yapH	35
ABI910_6POST	1122675	1122676		yapH	1
ABI910_6POST	1122762	1122796		yapH	34
ABI910_6POST	1122973	1122985		yapH	12
ABI910_6POST	1123582	1123586		yapH	4
ABI910_6POST	1123639	1123679		yapH	40
ABI910_6POST	1123815	1123832		yapH	17
ABI910_6POST	1123885	1123891		yapH	6
ABI910_6POST	1123943	1123962		yapH	19
ABI910_6POST	1124060	1124230		yapH	170
ABI910_6POST	1124278	1124294		yapH	16
ABI910_6POST	1124387	1124544		yapH	157
ABI910_6POST	1124596	1124626		yapH	30
ABI910_6POST	1124675	1124934		yapH	259
ABI910_6POST	1124985	1125011		yapH	26
ABI910_6POST	1125103	1125257		yapH	154
ABI910_6POST	1125288	1125401		yapH	113
ABI910_6POST	1125432	1125506		yapH	74
ABI910_6POST	1125542	1125681		yapH	139
ABI910_6POST	1125753	1125755		yapH	2
ABI910_6POST	1126416	1126426		yapH	10
ABI910_6POST	1127004	1127084		yapH	80
ABI910_6POST	1127122	1127137		yapH	15
ABI910_6POST	1127243	1127278		yapH	35
ABI910_6POST	1127475	1127481		yapH	6
ABI910_6POST	1127658	1127679		yapH	21
ABI910_6POST	1127851	1127852		yapH	1
ABI910_6POST	1127997	1128001		yapH	4
ABI910_6POST	1128247	1128253		yapH	6
ABI910_6POST	1128435	1128458		yapH	23
ABI910_6POST	1128542	1128548		yapH	6
ABI910_6POST	1128841	1128854		yapH	13
ABI910_6POST	1129672	1129706		yapH	34
ABI910_6POST	1129927	1129972		yapH	45
ABI910_6POST	1130313	1130323		yapH	10
ABI910_6POST	1130887	1130905		yapH	18
ABI910_6POST	1131090	1131093		YPO_RS05955	3
ABI910_6POST	1131136	1131146		YPO_RS05955	10
ABI910_6POST	1132012	1132047		YPO_RS05955	35
ABI910_6POST	1132823	1132846		YPO_RS05955	23
ABI910_6POST	1134782	1134796		YPO_RS05970	14
ABI910_6POST	1134945	1134949		YPO_RS05970	4
ABI910_6POST	1134993	1135023		YPO_RS05970	30
ABI910_6POST	1135492	1135500		YPO_RS05970	8
ABI910_6POST	1135574	1135579		YPO_RS05970	5
ABI910_6POST	1135629	1135633		YPO_RS05970	4
ABI910_6POST	1136132	1136134		YPO_RS05970	2
ABI910_6POST	1136206	1136212		YPO_RS05970	6
ABI910_6POST	1137279	1137293		YPO_RS05975	14
ABI910_6POST	1137329	1137342		YPO_RS05975	13
ABI910_6POST	1138665	1138667		YPO_RS05975	2
ABI910_6POST	1139415	1139429		pepT	14
ABI910_6POST	1139521	1139549		pepT	28
ABI910_6POST	1139709	1139710		pepT	1
ABI910_6POST	1140467	1140472		YPO_RS05985	5
ABI910_6POST	1141071	1141074		YPO_RS05985	3
ABI910_6POST	1141193	1141218		YPO_RS05985	25
ABI910_6POST	1141642	1141649		YPO_RS05985	7
ABI910_6POST	1141761	1141762		YPO_RS05985	1
ABI910_6POST	1142193	1142201		YPO_RS05985	8
ABI910_6POST	1142259	1142268		YPO_RS05985	9
ABI910_6POST	1142395	1142397		YPO_RS05985	2
ABI910_6POST	1146323	1146356		YPO_RS05995	33
ABI910_6POST	1146387	1146408		YPO_RS05995	21
ABI910_6POST	1146503	1146514		YPO_RS05995	11
ABI910_6POST	1146605	1146628		YPO_RS05995	23
ABI910_6POST	1146658	1146743		YPO_RS05995	85
ABI910_6POST	1146911	1146914		YPO_RS05995	3
ABI910_6POST	1146986	1147017		YPO_RS05995	31
ABI910_6POST	1147269	1147297		YPO_RS06000	28
ABI910_6POST	1147349	1147406		YPO_RS06000	57
ABI910_6POST	1147456	1147458		YPO_RS06000	2
ABI910_6POST	1147552	1147560		YPO_RS06000	8
ABI910_6POST	1147634	1147680		YPO_RS06000	46
ABI910_6POST	1147724	1147729		YPO_RS06000	5
ABI910_6POST	1147917	1147925		YPO_RS06005	8
ABI910_6POST	1147956	1147967		YPO_RS06005	11
ABI910_6POST	1148079	1148080		YPO_RS06010	1
ABI910_6POST	1148255	1148258		YPO_RS06010	3
ABI910_6POST	1148376	1148409		YPO_RS06010	33
ABI910_6POST	1149347	1149355		YPO_RS06020	8
ABI910_6POST	1149944	1149945		recC	1
ABI910_6POST	1150124	1150160		recC	36
ABI910_6POST	1150839	1150867		recC	28
ABI910_6POST	1150969	1150985		recC	16
ABI910_6POST	1151704	1151753		recC	49
ABI910_6POST	1151964	1151990		recC	26
ABI910_6POST	1152096	1152114		recC	18
ABI910_6POST	1152628	1152629		recC	1
ABI910_6POST	1153291	1153303		ptrA	12
ABI910_6POST	1153398	1153412		ptrA	14
ABI910_6POST	1153734	1153794		ptrA	60
ABI910_6POST	1153832	1153845		ptrA	13
ABI910_6POST	1153906	1153916		ptrA	10
ABI910_6POST	1154180	1154204		ptrA	24
ABI910_6POST	1154947	1154952		ptrA	5
ABI910_6POST	1155685	1155692		ptrA	7
ABI910_6POST	1155899	1155914		ptrA	15
ABI910_6POST	1156060	1156085		recB	25
ABI910_6POST	1156115	1156143		recB	28
ABI910_6POST	1157362	1157372		recB	10
ABI910_6POST	1157818	1157851		recB	33
ABI910_6POST	1159465	1159475		recB	10
ABI910_6POST	1159865	1159872		recD	7
ABI910_6POST	1160141	1160155		recD	14
ABI910_6POST	1160511	1160515		recD	4
ABI910_6POST	1160932	1160939		recD	7
ABI910_6POST	1161001	1161006		recD	5
ABI910_6POST	1161203	1161211		recD	8
ABI910_6POST	1161769	1161773		argA	4
ABI910_6POST	1162237	1162238		argA	1
ABI910_6POST	1162444	1162446		argA	2
ABI910_6POST	1162556	1162564		argA	8
ABI910_6POST	1162838	1162839		argA	1
ABI910_6POST	1163759	1163773		YPO_RS06050	14
ABI910_6POST	1163806	1163811		YPO_RS06050	5
ABI910_6POST	1164414	1164425		YPO_RS06050	11
ABI910_6POST	1164511	1164520		YPO_RS06050	9
ABI910_6POST	1165503	1165522		mltA	19
ABI910_6POST	1165878	1165923		mltA	45
ABI910_6POST	1166094	1166115		mltA	21
ABI910_6POST	1166180	1166187		mltA	7
ABI910_6POST	1166444	1166448		mltA	4
ABI910_6POST	1167568	1167580		csdE	12
ABI910_6POST	1167788	1167796		csdE	8
ABI910_6POST	1168731	1168738		csdA	7
ABI910_6POST	1169425	1169439		YPO_RS06085	14
ABI910_6POST	1170463	1170488		YPO_RS06090	25
ABI910_6POST	1170547	1170551		YPO_RS06090	4
ABI910_6POST	1170589	1170603		YPO_RS06090	14
ABI910_6POST	1171255	1171266		YPO_RS06095	11
ABI910_6POST	1171833	1171841		rlmM	8
ABI910_6POST	1173227	1173235		xni	8
ABI910_6POST	1173781	1173802		YPO_RS06110	21
ABI910_6POST	1173878	1173881		YPO_RS06110	3
ABI910_6POST	1174563	1174579		YPO_RS06110	16
ABI910_6POST	1175610	1175629		queF	19
ABI910_6POST	1176051	1176052		queF	1
ABI910_6POST	1176316	1176319		syd	3
ABI910_6POST	1176359	1176366		syd	7
ABI910_6POST	1176801	1176811		syd	10
ABI910_6POST	1178358	1178385		YPO_RS06130	27
ABI910_6POST	1179050	1179065		truC	15
ABI910_6POST	1179377	1179385		YPO_RS06140	8
ABI910_6POST	1179482	1179508		YPO_RS06140	26
ABI910_6POST	1180038	1180047		YPO_RS06145	9
ABI910_6POST	1180233	1180247		YPO_RS06145	14
ABI910_6POST	1182377	1182381		glnD	4
ABI910_6POST	1183062	1183069		glnD	7
ABI910_6POST	1183238	1183242		glnD	4
ABI910_6POST	1183365	1183436		glnD	71
ABI910_6POST	1183505	1183514		glnD	9
ABI910_6POST	1183753	1183772		glnD	19
ABI910_6POST	1184922	1184928		map	6
ABI910_6POST	1185646	1185658		rpsB	12
ABI910_6POST	1186327	1186329		tsf	2
ABI910_6POST	1187283	1187284		pyrH	1
ABI910_6POST	1187917	1187922		pyrH	5
ABI910_6POST	1188436	1188447		frr	11
ABI910_6POST	1191073	1191075		ispU	2
ABI910_6POST	1191368	1191395		cdsA	27
ABI910_6POST	1191700	1191726		cdsA	26
ABI910_6POST	1192841	1192842		rseP	1
ABI910_6POST	1193110	1193114		rseP	4
ABI910_6POST	1194142	1194143		bamA	1
ABI910_6POST	1194806	1194809		bamA	3
ABI910_6POST	1195114	1195118		bamA	4
ABI910_6POST	1195538	1195548		bamA	10
ABI910_6POST	1196320	1196328		skp	8
ABI910_6POST	1196663	1196674		lpxD	11
ABI910_6POST	1196786	1196787		lpxD	1
ABI910_6POST	1196942	1196949		lpxD	7
ABI910_6POST	1197302	1197304		lpxD	2
ABI910_6POST	1197888	1197911		fabZ	23
ABI910_6POST	1198239	1198250		lpxA	11
ABI910_6POST	1198399	1198405		lpxA	6
ABI910_6POST	1198463	1198468		lpxA	5
ABI910_6POST	1198566	1198574		lpxA	8
ABI910_6POST	1198660	1198689		lpxA	29
ABI910_6POST	1198790	1198801		lpxA	11
ABI910_6POST	1198975	1198979		lpxB	4
ABI910_6POST	1199263	1199273		lpxB	10
ABI910_6POST	1199460	1199480		lpxB	20
ABI910_6POST	1199556	1199577		lpxB	21
ABI910_6POST	1199813	1199828		lpxB	15
ABI910_6POST	1200084	1200085		lpxB	1
ABI910_6POST	1200188	1200190		rnhB	2
ABI910_6POST	1200410	1200413		rnhB	3
ABI910_6POST	1200493	1200501		rnhB	8
ABI910_6POST	1200970	1200993		dnaE	23
ABI910_6POST	1201290	1201293		dnaE	3
ABI910_6POST	1201497	1201500		dnaE	3
ABI910_6POST	1201713	1201731		dnaE	18
ABI910_6POST	1202232	1202256		dnaE	24
ABI910_6POST	1202436	1202439		dnaE	3
ABI910_6POST	1203297	1203313		dnaE	16
ABI910_6POST	1203382	1203396		dnaE	14
ABI910_6POST	1204980	1204985		accA	5
ABI910_6POST	1205021	1205025		accA	4
ABI910_6POST	1205127	1205128		accA	1
ABI910_6POST	1205605	1205612		YPO_RS06250	7
ABI910_6POST	1205932	1205941		tilS	9
ABI910_6POST	1206003	1206007		tilS	4
ABI910_6POST	1206207	1206213		tilS	6
ABI910_6POST	1206741	1206743		tilS	2
ABI910_6POST	1207024	1207040		tilS	16
ABI910_6POST	1207578	1207579		YPO_RS06260	1
ABI910_6POST	1207619	1207652		YPO_RS06260	33
ABI910_6POST	1208221	1208222		rof	1
ABI910_6POST	1209290	1209296		YPO_RS06275	6
ABI910_6POST	1211060	1211069		proS	9
ABI910_6POST	1211293	1211296		proS	3
ABI910_6POST	1211797	1211814		proS	17
ABI910_6POST	1212046	1212050		proS	4
ABI910_6POST	1213105	1213114		tsaA	9
ABI910_6POST	1213219	1213243		rcsF	24
ABI910_6POST	1213485	1213507		rcsF	22
ABI910_6POST	1214632	1214637		metI	5
ABI910_6POST	1214684	1214691		metI	7
ABI910_6POST	1215147	1215164		metI	17
ABI910_6POST	1215586	1215590		metN	4
ABI910_6POST	1215741	1215768		metN	27
ABI910_6POST	1215854	1215874		metN	20
ABI910_6POST	1216074	1216080		metN	6
ABI910_6POST	1217714	1217717		YPO_RS06330	3
ABI910_6POST	1218135	1218141		YPO_RS06330	6
ABI910_6POST	1218461	1218464		YPO_RS06330	3
ABI910_6POST	1220118	1220146		YPO_RS06340	28
ABI910_6POST	1220895	1220902		YPO_RS06340	7
ABI910_6POST	1221211	1221238		YPO_RS06340	27
ABI910_6POST	1221595	1221609		YPO_RS06340	14
ABI910_6POST	1222285	1222312		YPO_RS06340	27
ABI910_6POST	1222362	1222367		YPO_RS06340	5
ABI910_6POST	1223187	1223189		dkgB	2
ABI910_6POST	1223514	1223518		dkgB	4
ABI910_6POST	1223965	1223969		dkgB	4
ABI910_6POST	1225129	1225136		YPO_RS06365	7
ABI910_6POST	1225815	1225818		mltD	3
ABI910_6POST	1226655	1226670		mltD	15
ABI910_6POST	1227534	1227537		gloB	3
ABI910_6POST	1227717	1227732		gloB	15
ABI910_6POST	1228485	1228501		YPO_RS06380	16
ABI910_6POST	1228745	1228748		rnhA	3
ABI910_6POST	1228790	1228814		rnhA	24
ABI910_6POST	1229944	1229966		dnaQ	22
ABI910_6POST	1230389	1230397		YPO_RS06400	8
ABI910_6POST	1230485	1230487		YPO_RS06400	2
ABI910_6POST	1230646	1230663		YPO_RS06400	17
ABI910_6POST	1230748	1230759		YPO_RS06400	11
ABI910_6POST	1230907	1230915		YPO_RS06400	8
ABI910_6POST	1231360	1231362		YPO_RS06400	2
ABI910_6POST	1231521	1231525		YPO_RS06400	4
ABI910_6POST	1231678	1231687		YPO_RS06400	9
ABI910_6POST	1232114	1232146		YPO_RS06405	32
ABI910_6POST	1232227	1232232		YPO_RS06405	5
ABI910_6POST	1232262	1232298		YPO_RS06405	36
ABI910_6POST	1232350	1232351		YPO_RS06410	1
ABI910_6POST	1232372	1232373		YPO_RS06410	1
ABI910_6POST	1232442	1232459		YPO_RS06410	17
ABI910_6POST	1232505	1232542		YPO_RS06410	37
ABI910_6POST	1232768	1232770		YPO_RS06410	2
ABI910_6POST	1232926	1232940		YPO_RS06410	14
ABI910_6POST	1233024	1233067		YPO_RS06410	43
ABI910_6POST	1233421	1233444		YPO_RS06415	23
ABI910_6POST	1233515	1233541		YPO_RS06415	26
ABI910_6POST	1233633	1233661		YPO_RS06415	28
ABI910_6POST	1233737	1233768		YPO_RS06415	31
ABI910_6POST	1233993	1234009		YPO_RS06415	16
ABI910_6POST	1235199	1235220		YPO_RS06430	21
ABI910_6POST	1235328	1235349		YPO_RS06430	21
ABI910_6POST	1236295	1236296		YPO_RS06435	1
ABI910_6POST	1236618	1236629		YPO_RS06435	11
ABI910_6POST	1236736	1236756		YPO_RS06435	20
ABI910_6POST	1236880	1236891		YPO_RS06440	11
ABI910_6POST	1237088	1237096		YPO_RS06440	8
ABI910_6POST	1237291	1237297		YPO_RS06440	6
ABI910_6POST	1237328	1237337		YPO_RS06440	9
ABI910_6POST	1237497	1237513		YPO_RS06440	16
ABI910_6POST	1237995	1238033		YPO_RS06445	38
ABI910_6POST	1238166	1238167		YPO_RS06445	1
ABI910_6POST	1238568	1238576		YPO_RS06455	8
ABI910_6POST	1238812	1238822		YPO_RS06455	10
ABI910_6POST	1238959	1238970		YPO_RS06455	11
ABI910_6POST	1239020	1239059		YPO_RS06455	39
ABI910_6POST	1240340	1240367		YPO_RS06460	27
ABI910_6POST	1241401	1241410		YPO_RS06465	9
ABI910_6POST	1241742	1241752		YPO_RS06465	10
ABI910_6POST	1241877	1241883		YPO_RS06465	6
ABI910_6POST	1242011	1242020		YPO_RS06465	9
ABI910_6POST	1242162	1242186		YPO_RS06465	24
ABI910_6POST	1242664	1242675		YPO_RS06470	11
ABI910_6POST	1242866	1242883		YPO_RS06470	17
ABI910_6POST	1243632	1243655		YPO_RS06475	23
ABI910_6POST	1243882	1243883		YPO_RS06475	1
ABI910_6POST	1244033	1244045		YPO_RS06475	12
ABI910_6POST	1244318	1244319		YPO_RS06475	1
ABI910_6POST	1244485	1244491		YPO_RS06475	6
ABI910_6POST	1244647	1244675		YPO_RS06475	28
ABI910_6POST	1244929	1244931		YPO_RS06480	2
ABI910_6POST	1246740	1246762		YPO_RS06495	22
ABI910_6POST	1247159	1247172		YPO_RS06500	13
ABI910_6POST	1247542	1247555		bamE	13
ABI910_6POST	1247711	1247753		bamE	42
ABI910_6POST	1248203	1248215		recN	12
ABI910_6POST	1248334	1248362		recN	28
ABI910_6POST	1249230	1249238		recN	8
ABI910_6POST	1249826	1249852		nadK	26
ABI910_6POST	1250347	1250360		nadK	13
ABI910_6POST	1250843	1250845		grpE	2
ABI910_6POST	1252287	1252290		YPO_RS06525	3
ABI910_6POST	1252320	1252344		YPO_RS06525	24
ABI910_6POST	1254011	1254032		sdhD	21
ABI910_6POST	1254156	1254173		sdhA	17
ABI910_6POST	1254263	1254276		sdhA	13
ABI910_6POST	1254331	1254344		sdhA	13
ABI910_6POST	1254783	1254791		sdhA	8
ABI910_6POST	1255177	1255194		sdhA	17
ABI910_6POST	1255334	1255347		sdhA	13
ABI910_6POST	1256075	1256081		YPO_RS06545	6
ABI910_6POST	1257697	1257703		sucA	6
ABI910_6POST	1258544	1258546		sucA	2
ABI910_6POST	1258792	1258809		sucA	17
ABI910_6POST	1259133	1259169		sucA	36
ABI910_6POST	1259811	1259814		sucA	3
ABI910_6POST	1260024	1260057		odhB	33
ABI910_6POST	1260249	1260253		odhB	4
ABI910_6POST	1260337	1260348		odhB	11
ABI910_6POST	1260493	1260496		odhB	3
ABI910_6POST	1260645	1260653		odhB	8
ABI910_6POST	1261303	1261306		sucC	3
ABI910_6POST	1261724	1261739		sucC	15
ABI910_6POST	1261791	1261797		sucC	6
ABI910_6POST	1261977	1261987		sucC	10
ABI910_6POST	1262152	1262158		sucC	6
ABI910_6POST	1262335	1262340		sucC	5
ABI910_6POST	1262656	1262682		sucD	26
ABI910_6POST	1264582	1264589		cydA	7
ABI910_6POST	1264797	1264801		cydA	4
ABI910_6POST	1264989	1264999		cydA	10
ABI910_6POST	1265360	1265363		cydA	3
ABI910_6POST	1265652	1265685		cydB	33
ABI910_6POST	1265885	1265886		cydB	1
ABI910_6POST	1266017	1266045		cydB	28
ABI910_6POST	1267510	1267512		ybgC	2
ABI910_6POST	1267884	1267899		tolQ	15
ABI910_6POST	1268157	1268182		tolQ	25
ABI910_6POST	1268235	1268238		tolQ	3
ABI910_6POST	1268587	1268607		tolR	20
ABI910_6POST	1268765	1268768		tolR	3
ABI910_6POST	1269755	1269767		tolA	12
ABI910_6POST	1269800	1269821		tolA	21
ABI910_6POST	1271099	1271112		tolB	13
ABI910_6POST	1271223	1271235		tolB	12
ABI910_6POST	1271550	1271552		pal	2
ABI910_6POST	1271647	1271651		pal	4
ABI910_6POST	1272270	1272297		cpoB	27
ABI910_6POST	1272460	1272471		cpoB	11
ABI910_6POST	1272734	1272741		cpoB	7
ABI910_6POST	1273119	1273120		YPO_RS06625	1
ABI910_6POST	1273867	1273881		nadA	14
ABI910_6POST	1274277	1274283		nadA	6
ABI910_6POST	1274386	1274390		nadA	4
ABI910_6POST	1274626	1274643		nadA	17
ABI910_6POST	1275752	1275762		zitB	10
ABI910_6POST	1276321	1276326		zitB	5
ABI910_6POST	1277570	1277593		aroG	23
ABI910_6POST	1278061	1278078		aroG	17
ABI910_6POST	1278211	1278237		YPO_RS06660	26
ABI910_6POST	1278413	1278427		YPO_RS06660	14
ABI910_6POST	1278511	1278608		YPO_RS06660	97
ABI910_6POST	1278823	1278827		YPO_RS06660	4
ABI910_6POST	1278920	1278939		YPO_RS06665	19
ABI910_6POST	1279190	1279242		YPO_RS06665	52
ABI910_6POST	1279320	1279326		YPO_RS06665	6
ABI910_6POST	1279393	1279402		YPO_RS06665	9
ABI910_6POST	1279522	1279551		YPO_RS06665	29
ABI910_6POST	1279631	1279669		YPO_RS06665	38
ABI910_6POST	1279838	1279841		YPO_RS06665	3
ABI910_6POST	1279998	1280013		YPO_RS06670	15
ABI910_6POST	1280672	1280707		gpmA	35
ABI910_6POST	1280870	1280879		gpmA	9
ABI910_6POST	1281035	1281037		gpmA	2
ABI910_6POST	1281570	1281572		YPO_RS06680	2
ABI910_6POST	1282334	1282337		galM	3
ABI910_6POST	1282444	1282456		galM	12
ABI910_6POST	1282641	1282649		galM	8
ABI910_6POST	1282692	1282698		galM	6
ABI910_6POST	1283041	1283043		YPO_RS06690	2
ABI910_6POST	1283251	1283260		galK	9
ABI910_6POST	1283785	1283788		galK	3
ABI910_6POST	1284273	1284284		galT	11
ABI910_6POST	1284833	1284850		galT	17
ABI910_6POST	1285377	1285381		galE	4
ABI910_6POST	1286163	1286171		galE	8
ABI910_6POST	1286673	1286679		YPO_RS06710	6
ABI910_6POST	1286809	1286832		YPO_RS06710	23
ABI910_6POST	1287113	1287129		YPO_RS06710	16
ABI910_6POST	1287176	1287188		YPO_RS06710	12
ABI910_6POST	1287384	1287397		YPO_RS06710	13
ABI910_6POST	1287446	1287490		YPO_RS06710	44
ABI910_6POST	1287901	1287914		modF	13
ABI910_6POST	1288124	1288149		modF	25
ABI910_6POST	1288460	1288462		modF	2
ABI910_6POST	1288549	1288552		modF	3
ABI910_6POST	1288783	1288786		modF	3
ABI910_6POST	1288887	1288901		modF	14
ABI910_6POST	1289027	1289037		modF	10
ABI910_6POST	1289074	1289085		modF	11
ABI910_6POST	1289666	1289678		modE	12
ABI910_6POST	1290008	1290015		modE	7
ABI910_6POST	1290526	1290556		YPO_RS06725	30
ABI910_6POST	1291586	1291588		modB	2
ABI910_6POST	1291647	1291650		modB	3
ABI910_6POST	1291742	1291748		modB	6
ABI910_6POST	1292136	1292140		modB	4
ABI910_6POST	1292540	1292554		modC	14
ABI910_6POST	1292894	1292911		modC	17
ABI910_6POST	1293347	1293349		modC	2
ABI910_6POST	1293507	1293523		YPO_RS06745	16
ABI910_6POST	1293849	1293886		YPO_RS06745	37
ABI910_6POST	1294845	1294847		pgl	2
ABI910_6POST	1294991	1295021		pgl	30
ABI910_6POST	1295329	1295332		pgl	3
ABI910_6POST	1295439	1295450		pgl	11
ABI910_6POST	1295725	1295734		bioA	9
ABI910_6POST	1296803	1296814		bioA	11
ABI910_6POST	1296892	1296909		bioA	17
ABI910_6POST	1297186	1297192		bioB	6
ABI910_6POST	1297903	1297918		bioB	15
ABI910_6POST	1298066	1298094		bioB	28
ABI910_6POST	1298394	1298409		bioF	15
ABI910_6POST	1299278	1299293		bioC	15
ABI910_6POST	1299501	1299513		bioC	12
ABI910_6POST	1299585	1299592		bioC	7
ABI910_6POST	1300156	1300158		bioD	2
ABI910_6POST	1300503	1300509		bioD	6
ABI910_6POST	1305713	1305737		yvcK	24
ABI910_6POST	1305892	1305921		yvcK	29
ABI910_6POST	1306158	1306160		yvcK	2
ABI910_6POST	1306191	1306199		yvcK	8
ABI910_6POST	1307140	1307143		moaA	3
ABI910_6POST	1308219	1308277		moaC	58
ABI910_6POST	1308589	1308601		moaD	12
ABI910_6POST	1308635	1308654		moaD	19
ABI910_6POST	1308800	1308819		moaE	19
ABI910_6POST	1309483	1309487		YPO_RS06820	4
ABI910_6POST	1309641	1309646		YPO_RS06820	5
ABI910_6POST	1310427	1310441		YPO_RS06825	14
ABI910_6POST	1310579	1310581		YPO_RS06825	2
ABI910_6POST	1310910	1310918		betA	8
ABI910_6POST	1311685	1311699		betA	14
ABI910_6POST	1311911	1311925		betA	14
ABI910_6POST	1311979	1312030		betA	51
ABI910_6POST	1312337	1312352		betA	15
ABI910_6POST	1312956	1313023		betB	67
ABI910_6POST	1313790	1313796		betB	6
ABI910_6POST	1314383	1314398		betI	15
ABI910_6POST	1315270	1315276		YPO_RS06845	6
ABI910_6POST	1315903	1315932		YPO_RS06845	29
ABI910_6POST	1316278	1316314		YPO_RS06845	36
ABI910_6POST	1316694	1316709		YPO_RS06845	15
ABI910_6POST	1317703	1317780		YPO_RS06850	77
ABI910_6POST	1318200	1318204		YPO_RS06850	4
ABI910_6POST	1318854	1318857		YPO_RS06855	3
ABI910_6POST	1318932	1318937		YPO_RS06855	5
ABI910_6POST	1322780	1322787		YPO_RS06875	7
ABI910_6POST	1323475	1323481		dusC	6
ABI910_6POST	1323515	1323519		dusC	4
ABI910_6POST	1324418	1324430		YPO_RS06885	12
ABI910_6POST	1325635	1325638		pbpG	3
ABI910_6POST	1326544	1326547		dld	3
ABI910_6POST	1326666	1326684		dld	18
ABI910_6POST	1327235	1327237		dld	2
ABI910_6POST	1327488	1327489		dld	1
ABI910_6POST	1329125	1329132		YPO_RS06910	7
ABI910_6POST	1329168	1329183		YPO_RS06910	15
ABI910_6POST	1329938	1329949		YPO_RS06910	11
ABI910_6POST	1330020	1330065		YPO_RS06910	45
ABI910_6POST	1330472	1330495		YPO_RS06915	23
ABI910_6POST	1331044	1331056		phnC	12
ABI910_6POST	1331731	1331749		phnD	18
ABI910_6POST	1331942	1331949		phnD	7
ABI910_6POST	1332064	1332091		phnD	27
ABI910_6POST	1332270	1332289		phnD	19
ABI910_6POST	1332401	1332405		phnD	4
ABI910_6POST	1333063	1333069		phnE	6
ABI910_6POST	1333107	1333121		phnE	14
ABI910_6POST	1333453	1333483		phnE	30
ABI910_6POST	1334050	1334055		phnE	5
ABI910_6POST	1334318	1334329		phnE	11
ABI910_6POST	1334394	1334408		phnE	14
ABI910_6POST	1334961	1334968		YPO_RS06940	7
ABI910_6POST	1335172	1335176		YPO_RS06940	4
ABI910_6POST	1335702	1335707		urtA	5
ABI910_6POST	1337255	1337269		urtB	14
ABI910_6POST	1337824	1337835		urtB	11
ABI910_6POST	1337926	1337940		urtB	14
ABI910_6POST	1337977	1337987		urtB	10
ABI910_6POST	1338128	1338130		urtB	2
ABI910_6POST	1338166	1338188		urtB	22
ABI910_6POST	1338334	1338381		urtB	47
ABI910_6POST	1338820	1338830		urtC	10
ABI910_6POST	1339031	1339033		urtC	2
ABI910_6POST	1339140	1339141		urtC	1
ABI910_6POST	1339567	1339573		urtC	6
ABI910_6POST	1339692	1339705		urtC	13
ABI910_6POST	1339779	1339822		urtD	43
ABI910_6POST	1340475	1340477		urtD	2
ABI910_6POST	1340807	1340831		urtE	24
ABI910_6POST	1340868	1340888		urtE	20
ABI910_6POST	1341001	1341099		urtE	98
ABI910_6POST	1341136	1341151		urtE	15
ABI910_6POST	1341184	1341193		urtE	9
ABI910_6POST	1341679	1341681		YPO_RS06970	2
ABI910_6POST	1343291	1343305		YPO_RS06975	14
ABI910_6POST	1343616	1343636		YPO_RS06975	20
ABI910_6POST	1343962	1343965		sseA	3
ABI910_6POST	1344012	1344014		sseA	2
ABI910_6POST	1344135	1344257		sseA	122
ABI910_6POST	1344708	1344714		sseA	6
ABI910_6POST	1346166	1346182		YPO_RS06990	16
ABI910_6POST	1346740	1346756		YPO_RS06995	16
ABI910_6POST	1347687	1347711		YPO_RS06995	24
ABI910_6POST	1347940	1347947		YPO_RS07000	7
ABI910_6POST	1348321	1348328		YPO_RS07000	7
ABI910_6POST	1348640	1348642		YPO_RS07000	2
ABI910_6POST	1349041	1349060		YPO_RS07005	19
ABI910_6POST	1349297	1349316		YPO_RS07005	19
ABI910_6POST	1350114	1350121		adiC	7
ABI910_6POST	1350215	1350233		adiC	18
ABI910_6POST	1350292	1350304		adiC	12
ABI910_6POST	1350619	1350650		adiC	31
ABI910_6POST	1350877	1350904		adiC	27
ABI910_6POST	1351424	1351425		adiC	1
ABI910_6POST	1352109	1352115		YPO_RS07015	6
ABI910_6POST	1352181	1352190		YPO_RS07015	9
ABI910_6POST	1352471	1352496		YPO_RS07015	25
ABI910_6POST	1352790	1352797		YPO_RS07015	7
ABI910_6POST	1352848	1352869		YPO_RS07015	21
ABI910_6POST	1352925	1352927		YPO_RS07015	2
ABI910_6POST	1353338	1353362		YPO_RS07015	24
ABI910_6POST	1353549	1353583		YPO_RS07015	34
ABI910_6POST	1353658	1353669		YPO_RS07015	11
ABI910_6POST	1353781	1353801		YPO_RS07015	20
ABI910_6POST	1354384	1354390		yedA	6
ABI910_6POST	1354680	1354681		yedA	1
ABI910_6POST	1357186	1357200		dinG	14
ABI910_6POST	1359547	1359560		YPO_RS07040	13
ABI910_6POST	1361294	1361334		YPO_RS07045	40
ABI910_6POST	1361781	1361786		tyrP	5
ABI910_6POST	1362492	1362510		tyrP	18
ABI910_6POST	1362943	1362950		tyrP	7
ABI910_6POST	1363641	1363659		YPO_RS07055	18
ABI910_6POST	1363803	1363823		YPO_RS07055	20
ABI910_6POST	1363998	1364008		YPO_RS07055	10
ABI910_6POST	1364363	1364366		YPO_RS07055	3
ABI910_6POST	1364633	1364636		YPO_RS07055	3
ABI910_6POST	1365036	1365041		eco	5
ABI910_6POST	1365438	1365449		YPO_RS07065	11
ABI910_6POST	1365817	1365850		nrdB	33
ABI910_6POST	1366268	1366288		nrdB	20
ABI910_6POST	1367127	1367135		nrdA	8
ABI910_6POST	1367724	1367725		nrdA	1
ABI910_6POST	1367778	1367793		nrdA	15
ABI910_6POST	1368159	1368163		nrdA	4
ABI910_6POST	1368593	1368625		nrdA	32
ABI910_6POST	1369236	1369237		nrdA	1
ABI910_6POST	1370093	1370100		YPO_RS07080	7
ABI910_6POST	1370209	1370218		YPO_RS07080	9
ABI910_6POST	1370793	1370803		gyrA	10
ABI910_6POST	1371053	1371057		gyrA	4
ABI910_6POST	1371369	1371378		gyrA	9
ABI910_6POST	1372319	1372342		gyrA	23
ABI910_6POST	1372883	1372894		gyrA	11
ABI910_6POST	1373132	1373136		gyrA	4
ABI910_6POST	1373888	1373893		rcsC	5
ABI910_6POST	1374038	1374039		rcsC	1
ABI910_6POST	1374264	1374272		rcsC	8
ABI910_6POST	1374498	1374509		rcsC	11
ABI910_6POST	1374780	1374785		rcsC	5
ABI910_6POST	1375332	1375356		rcsC	24
ABI910_6POST	1375486	1375495		rcsC	9
ABI910_6POST	1375907	1375929		rcsC	22
ABI910_6POST	1376003	1376027		rcsC	24
ABI910_6POST	1376231	1376233		rcsC	2
ABI910_6POST	1377415	1377419		YPO_RS07100	4
ABI910_6POST	1378699	1378717		rcsD	18
ABI910_6POST	1379224	1379234		rcsD	10
ABI910_6POST	1379405	1379421		rcsD	16
ABI910_6POST	1382244	1382249		YPO_RS07115	5
ABI910_6POST	1382626	1382628		YPO_RS07115	2
ABI910_6POST	1382759	1382786		YPO_RS07115	27
ABI910_6POST	1383072	1383080		YPO_RS07115	8
ABI910_6POST	1383258	1383275		YPO_RS07115	17
ABI910_6POST	1384837	1384849		ampH	12
ABI910_6POST	1385129	1385140		ampH	11
ABI910_6POST	1385431	1385498		ampH	67
ABI910_6POST	1386235	1386257		YPO_RS07140	22
ABI910_6POST	1386632	1386652		YPO_RS07140	20
ABI910_6POST	1387047	1387070		YPO_RS07140	23
ABI910_6POST	1387138	1387145		YPO_RS07140	7
ABI910_6POST	1388357	1388361		YPO_RS07145	4
ABI910_6POST	1388873	1388886		YPO_RS07145	13
ABI910_6POST	1389075	1389092		YPO_RS07145	17
ABI910_6POST	1389435	1389438		YPO_RS07150	3
ABI910_6POST	1390002	1390013		YPO_RS07150	11
ABI910_6POST	1390214	1390233		YPO_RS07150	19
ABI910_6POST	1390373	1390374		YPO_RS07150	1
ABI910_6POST	1390421	1390426		YPO_RS07150	5
ABI910_6POST	1390490	1390529		YPO_RS07150	39
ABI910_6POST	1390689	1390713		YPO_RS07150	24
ABI910_6POST	1390795	1390797		YPO_RS07150	2
ABI910_6POST	1394702	1394761		YPO_RS07175	59
ABI910_6POST	1394833	1394838		YPO_RS07175	5
ABI910_6POST	1395063	1395073		YPO_RS07175	10
ABI910_6POST	1395159	1395164		YPO_RS07175	5
ABI910_6POST	1395278	1395305		YPO_RS07175	27
ABI910_6POST	1395469	1395478		YPO_RS07175	9
ABI910_6POST	1395585	1395595		YPO_RS07175	10
ABI910_6POST	1395741	1395749		YPO_RS07175	8
ABI910_6POST	1395838	1395866		YPO_RS07175	28
ABI910_6POST	1396915	1396916		YPO_RS07185	1
ABI910_6POST	1397906	1397909		YPO_RS07190	3
ABI910_6POST	1398064	1398065		YPO_RS07190	1
ABI910_6POST	1399096	1399103		YPO_RS07195	7
ABI910_6POST	1399283	1399287		YPO_RS07200	4
ABI910_6POST	1399584	1399594		YPO_RS07200	10
ABI910_6POST	1400095	1400121		YPO_RS07210	26
ABI910_6POST	1400458	1400461		YPO_RS07210	3
ABI910_6POST	1400568	1400589		YPO_RS07210	21
ABI910_6POST	1400645	1400667		YPO_RS07210	22
ABI910_6POST	1401294	1401304		YPO_RS07210	10
ABI910_6POST	1401710	1401712		YPO_RS07215	2
ABI910_6POST	1401809	1401815		YPO_RS07215	6
ABI910_6POST	1401935	1401966		YPO_RS07220	31
ABI910_6POST	1402316	1402327		YPO_RS07225	11
ABI910_6POST	1403158	1403172		YPO_RS07225	14
ABI910_6POST	1403646	1403677		YPO_RS07225	31
ABI910_6POST	1404079	1404087		YPO_RS07230	8
ABI910_6POST	1404290	1404310		YPO_RS07230	20
ABI910_6POST	1404365	1404376		YPO_RS07230	11
ABI910_6POST	1404544	1404559		YPO_RS07230	15
ABI910_6POST	1404655	1404662		YPO_RS07230	7
ABI910_6POST	1404845	1404852		YPO_RS07230	7
ABI910_6POST	1404927	1404928		YPO_RS07230	1
ABI910_6POST	1405196	1405202		YPO_RS07230	6
ABI910_6POST	1405275	1405284		YPO_RS07230	9
ABI910_6POST	1405462	1405481		YPO_RS07235	19
ABI910_6POST	1405683	1405684		YPO_RS07235	1
ABI910_6POST	1405844	1405902		YPO_RS07235	58
ABI910_6POST	1405937	1405973		YPO_RS07235	36
ABI910_6POST	1406447	1406498		YPO_RS07235	51
ABI910_6POST	1406726	1406802		YPO_RS07240	76
ABI910_6POST	1406855	1406893		YPO_RS07240	38
ABI910_6POST	1407188	1407198		YPO_RS07245	10
ABI910_6POST	1407361	1407367		YPO_RS07245	6
ABI910_6POST	1407457	1407493		YPO_RS07245	36
ABI910_6POST	1407697	1407733		YPO_RS07250	36
ABI910_6POST	1407800	1407810		YPO_RS07250	10
ABI910_6POST	1407910	1407917		YPO_RS07250	7
ABI910_6POST	1408354	1408374		YPO_RS07250	20
ABI910_6POST	1408599	1408613		YPO_RS07250	14
ABI910_6POST	1408783	1408793		YPO_RS07255	10
ABI910_6POST	1409099	1409114		YPO_RS07260	15
ABI910_6POST	1409484	1409501		YPO_RS07265	17
ABI910_6POST	1409742	1409746		YPO_RS07265	4
ABI910_6POST	1410897	1410929		YPO_RS07270	32
ABI910_6POST	1411105	1411138		YPO_RS07270	33
ABI910_6POST	1411541	1411548		YPO_RS07275	7
ABI910_6POST	1412134	1412136		YPO_RS07275	2
ABI910_6POST	1413094	1413096		YPO_RS07280	2
ABI910_6POST	1414215	1414218		YPO_RS07285	3
ABI910_6POST	1414253	1414256		YPO_RS07285	3
ABI910_6POST	1414485	1414502		YPO_RS07285	17
ABI910_6POST	1415154	1415163		YPO_RS07290	9
ABI910_6POST	1415637	1415641		YPO_RS07290	4
ABI910_6POST	1416182	1416191		YPO_RS07295	9
ABI910_6POST	1416347	1416354		YPO_RS07295	7
ABI910_6POST	1416819	1416849		YPO_RS07305	30
ABI910_6POST	1417123	1417145		YPO_RS07305	22
ABI910_6POST	1417379	1417400		YPO_RS07305	21
ABI910_6POST	1418249	1418254		YPO_RS07305	5
ABI910_6POST	1419075	1419077		yejK	2
ABI910_6POST	1419344	1419364		yejK	20
ABI910_6POST	1419663	1419670		yejK	7
ABI910_6POST	1419980	1419981		yejK	1
ABI910_6POST	1420419	1420430		YPO_RS07320	11
ABI910_6POST	1421040	1421041		rplY	1
ABI910_6POST	1421402	1421403		YPO_RS07330	1
ABI910_6POST	1421489	1421497		YPO_RS07330	8
ABI910_6POST	1421728	1421735		YPO_RS07330	7
ABI910_6POST	1422029	1422067		YPO_RS07330	38
ABI910_6POST	1422375	1422392		YPO_RS07330	17
ABI910_6POST	1423802	1423855		rsuA	53
ABI910_6POST	1424769	1424781		YPO_RS07340	12
ABI910_6POST	1424844	1424885		YPO_RS07340	41
ABI910_6POST	1426900	1426909		yejF	9
ABI910_6POST	1427369	1427435		yejF	66
ABI910_6POST	1427709	1427723		yejF	14
ABI910_6POST	1428117	1428124		yejF	7
ABI910_6POST	1428624	1428626		YPO_RS07355	2
ABI910_6POST	1428682	1428698		YPO_RS07355	16
ABI910_6POST	1428773	1428807		YPO_RS07355	34
ABI910_6POST	1428887	1428910		YPO_RS07355	23
ABI910_6POST	1429013	1429017		YPO_RS07355	4
ABI910_6POST	1429554	1429573		YPO_RS07360	19
ABI910_6POST	1429621	1429626		YPO_RS07360	5
ABI910_6POST	1429963	1429994		YPO_RS07360	31
ABI910_6POST	1430067	1430145		YPO_RS07360	78
ABI910_6POST	1430300	1430317		YPO_RS07360	17
ABI910_6POST	1430437	1430447		YPO_RS07360	10
ABI910_6POST	1430971	1430995		YPO_RS07365	24
ABI910_6POST	1431811	1431849		YPO_RS07365	38
ABI910_6POST	1431989	1432008		YPO_RS07365	19
ABI910_6POST	1432320	1432333		YPO_RS07365	13
ABI910_6POST	1433351	1433370		YPO_RS07370	19
ABI910_6POST	1434699	1434701		mepS	2
ABI910_6POST	1434806	1434808		mepS	2
ABI910_6POST	1435025	1435051		mepS	26
ABI910_6POST	1435210	1435213		mepS	3
ABI910_6POST	1436057	1436071		YPO_RS07380	14
ABI910_6POST	1436242	1436258		YPO_RS07380	16
ABI910_6POST	1436510	1436531		YPO_RS07385	21
ABI910_6POST	1438523	1438525		YPO_RS07390	2
ABI910_6POST	1438882	1438885		YPO_RS07390	3
ABI910_6POST	1439349	1439357		YPO_RS07395	8
ABI910_6POST	1439497	1439510		YPO_RS07395	13
ABI910_6POST	1439552	1439555		YPO_RS07395	3
ABI910_6POST	1440581	1440626		YPO_RS07395	45
ABI910_6POST	1441254	1441311		uxuA	57
ABI910_6POST	1441961	1441963		uxuA	2
ABI910_6POST	1443260	1443265		mtr	5
ABI910_6POST	1443604	1443613		mtr	9
ABI910_6POST	1443799	1443803		mtr	4
ABI910_6POST	1444149	1444162		mtr	13
ABI910_6POST	1444234	1444237		mtr	3
ABI910_6POST	1444307	1444325		mtr	18
ABI910_6POST	1445282	1445295		YPO_RS07420	13
ABI910_6POST	1445337	1445361		YPO_RS07420	24
ABI910_6POST	1445622	1445630		YPO_RS07420	8
ABI910_6POST	1445738	1445744		YPO_RS07420	6
ABI910_6POST	1445807	1445809		YPO_RS07420	2
ABI910_6POST	1445860	1445894		YPO_RS07420	34
ABI910_6POST	1445988	1446036		YPO_RS07425	48
ABI910_6POST	1446139	1446159		YPO_RS07425	20
ABI910_6POST	1446265	1446275		YPO_RS07425	10
ABI910_6POST	1446552	1446565		YPO_RS07425	13
ABI910_6POST	1446956	1446972		YPO_RS07430	16
ABI910_6POST	1447444	1447494		YPO_RS07430	50
ABI910_6POST	1447868	1447894		YPO_RS07430	26
ABI910_6POST	1448653	1448657		YPO_RS07435	4
ABI910_6POST	1448882	1448932		YPO_RS07435	50
ABI910_6POST	1449059	1449067		YPO_RS07435	8
ABI910_6POST	1449101	1449109		YPO_RS07435	8
ABI910_6POST	1449244	1449267		YPO_RS07435	23
ABI910_6POST	1449528	1449532		YPO_RS07435	4
ABI910_6POST	1449690	1449701		YPO_RS07435	11
ABI910_6POST	1449840	1449844		YPO_RS07435	4
ABI910_6POST	1449986	1449995		xylB	9
ABI910_6POST	1450167	1450189		xylB	22
ABI910_6POST	1450271	1450294		xylB	23
ABI910_6POST	1450805	1450827		xylB	22
ABI910_6POST	1450925	1450939		xylB	14
ABI910_6POST	1451103	1451109		xylB	6
ABI910_6POST	1451258	1451278		xylB	20
ABI910_6POST	1451726	1451731		rpiA	5
ABI910_6POST	1451976	1451988		rpiA	12
ABI910_6POST	1452097	1452103		rpiA	6
ABI910_6POST	1452406	1452438		YPO_RS07450	32
ABI910_6POST	1452628	1452641		YPO_RS07450	13
ABI910_6POST	1452817	1452822		YPO_RS07450	5
ABI910_6POST	1452931	1452938		YPO_RS07450	7
ABI910_6POST	1453226	1453228		YPO_RS07450	2
ABI910_6POST	1453610	1453613		YPO_RS07455	3
ABI910_6POST	1453958	1453961		YPO_RS07455	3
ABI910_6POST	1454011	1454022		YPO_RS07455	11
ABI910_6POST	1454333	1454370		YPO_RS07455	37
ABI910_6POST	1454671	1454683		YPO_RS07455	12
ABI910_6POST	1454733	1454741		YPO_RS07455	8
ABI910_6POST	1455384	1455390		YPO_RS07460	6
ABI910_6POST	1455624	1455630		YPO_RS07460	6
ABI910_6POST	1455694	1455695		YPO_RS07460	1
ABI910_6POST	1455741	1455773		YPO_RS07460	32
ABI910_6POST	1455993	1456045		YPO_RS07460	52
ABI910_6POST	1456450	1456454		YPO_RS07465	4
ABI910_6POST	1457201	1457220		YPO_RS07470	19
ABI910_6POST	1458277	1458278		fruK	1
ABI910_6POST	1458875	1458877		fruK	2
ABI910_6POST	1459137	1459139		fruA	2
ABI910_6POST	1459320	1459325		fruA	5
ABI910_6POST	1459800	1459813		fruA	13
ABI910_6POST	1460006	1460025		fruA	19
ABI910_6POST	1460289	1460290		fruA	1
ABI910_6POST	1460322	1460330		fruA	8
ABI910_6POST	1460462	1460584		fruA	122
ABI910_6POST	1460631	1460666		fruA	35
ABI910_6POST	1460700	1460722		fruA	22
ABI910_6POST	1460765	1460770		fruA	5
ABI910_6POST	1461371	1461412		YPO_RS07485	41
ABI910_6POST	1462009	1462024		YPO_RS07490	15
ABI910_6POST	1462830	1462840		psaA	10
ABI910_6POST	1463111	1463133		psaA	22
ABI910_6POST	1463554	1463587		YPO_RS07500	33
ABI910_6POST	1464352	1464362		psaC	10
ABI910_6POST	1464868	1464875		psaC	7
ABI910_6POST	1464964	1464979		psaC	15
ABI910_6POST	1465315	1465318		psaC	3
ABI910_6POST	1465445	1465462		psaC	17
ABI910_6POST	1465647	1465649		psaC	2
ABI910_6POST	1466252	1466261		psaC	9
ABI910_6POST	1466467	1466473		psaC	6
ABI910_6POST	1466626	1466653		psaC	27
ABI910_6POST	1467008	1467019		nfo	11
ABI910_6POST	1467934	1467936		YPO_RS07515	2
ABI910_6POST	1468515	1468517		YPO_RS07515	2
ABI910_6POST	1468582	1468609		YPO_RS07515	27
ABI910_6POST	1468720	1468749		YPO_RS07515	29
ABI910_6POST	1468898	1468921		YPO_RS07515	23
ABI910_6POST	1470108	1470134		YPO_RS07520	26
ABI910_6POST	1470406	1470420		YPO_RS07520	14
ABI910_6POST	1470887	1470905		YPO_RS07525	18
ABI910_6POST	1471610	1471639		YPO_RS07525	29
ABI910_6POST	1471863	1471871		YPO_RS07525	8
ABI910_6POST	1471923	1471944		YPO_RS07525	21
ABI910_6POST	1472028	1472030		YPO_RS07525	2
ABI910_6POST	1472156	1472171		YPO_RS07525	15
ABI910_6POST	1473200	1473203		YPO_RS07530	3
ABI910_6POST	1473634	1473639		YPO_RS07530	5
ABI910_6POST	1474565	1474580		YPO_RS07535	15
ABI910_6POST	1475524	1475536		YPO_RS07540	12
ABI910_6POST	1476150	1476163		YPO_RS07545	13
ABI910_6POST	1476274	1476286		YPO_RS07545	12
ABI910_6POST	1476779	1476786		YPO_RS07545	7
ABI910_6POST	1476843	1476850		YPO_RS07545	7
ABI910_6POST	1477041	1477051		YPO_RS07545	10
ABI910_6POST	1477289	1477307		YPO_RS07545	18
ABI910_6POST	1477585	1477664		YPO_RS07545	79
ABI910_6POST	1477967	1477974		YPO_RS07545	7
ABI910_6POST	1478889	1478890		YPO_RS07550	1
ABI910_6POST	1479044	1479050		YPO_RS07555	6
ABI910_6POST	1479190	1479204		YPO_RS07555	14
ABI910_6POST	1479626	1479646		YPO_RS07555	20
ABI910_6POST	1480181	1480200		YPO_RS07560	19
ABI910_6POST	1480572	1480601		YPO_RS07560	29
ABI910_6POST	1480804	1480808		YPO_RS07560	4
ABI910_6POST	1480997	1481000		YPO_RS07560	3
ABI910_6POST	1481723	1481734		YPO_RS07565	11
ABI910_6POST	1482086	1482088		YPO_RS07565	2
ABI910_6POST	1482329	1482359		YPO_RS07570	30
ABI910_6POST	1482751	1482765		YPO_RS07570	14
ABI910_6POST	1482855	1482866		YPO_RS07570	11
ABI910_6POST	1482945	1482967		YPO_RS07570	22
ABI910_6POST	1483439	1483441		YPO_RS07575	2
ABI910_6POST	1483521	1483567		YPO_RS07575	46
ABI910_6POST	1483668	1483689		YPO_RS07575	21
ABI910_6POST	1483736	1483748		YPO_RS07575	12
ABI910_6POST	1484359	1484361		YPO_RS07580	2
ABI910_6POST	1484798	1484802		YPO_RS07580	4
ABI910_6POST	1485413	1485419		YPO_RS07580	6
ABI910_6POST	1486391	1486399		YPO_RS07585	8
ABI910_6POST	1486573	1486621		YPO_RS07585	48
ABI910_6POST	1486835	1486859		YPO_RS07585	24
ABI910_6POST	1487217	1487225		YPO_RS07585	8
ABI910_6POST	1490380	1490385		ybjG	5
ABI910_6POST	1490471	1490472		ybjG	1
ABI910_6POST	1490631	1490636		ybjG	5
ABI910_6POST	1490716	1490730		ybjG	14
ABI910_6POST	1491013	1491030		YPO_RS07605	17
ABI910_6POST	1491151	1491194		YPO_RS07605	43
ABI910_6POST	1490928	1490945		YPO_RS07605	17
ABI910_6POST	1492018	1492027		YPO_RS07610	9
ABI910_6POST	1492162	1492169		YPO_RS07610	7
ABI910_6POST	1492407	1492442		YPO_RS07610	35
ABI910_6POST	1492656	1492658		YPO_RS07610	2
ABI910_6POST	1493415	1493417		YPO_RS07610	2
ABI910_6POST	1493560	1493569		YPO_RS07610	9
ABI910_6POST	1495009	1495012		YPO_RS07620	3
ABI910_6POST	1496291	1496292		potF	1
ABI910_6POST	1496773	1496777		potF	4
ABI910_6POST	1497818	1497835		potG	17
ABI910_6POST	1498787	1498790		potH	3
ABI910_6POST	1499003	1499025		potH	22
ABI910_6POST	1499182	1499192		potH	10
ABI910_6POST	1499323	1499327		potH	4
ABI910_6POST	1499738	1499744		potI	6
ABI910_6POST	1499824	1499832		potI	8
ABI910_6POST	1500008	1500011		potI	3
ABI910_6POST	1500063	1500074		potI	11
ABI910_6POST	1500307	1500308		potI	1
ABI910_6POST	1500951	1500958		YPO_RS07650	7
ABI910_6POST	1501113	1501125		YPO_RS07650	12
ABI910_6POST	1501800	1501814		rlmC	14
ABI910_6POST	1501908	1501929		rlmC	21
ABI910_6POST	1502034	1502038		rlmC	4
ABI910_6POST	1502302	1502305		rlmC	3
ABI910_6POST	1502915	1502927		YPO_RS07665	12
ABI910_6POST	1503094	1503112		YPO_RS07665	18
ABI910_6POST	1503209	1503223		YPO_RS07665	14
ABI910_6POST	1503312	1503316		YPO_RS07665	4
ABI910_6POST	1503422	1503430		YPO_RS07665	8
ABI910_6POST	1503463	1503512		YPO_RS07665	49
ABI910_6POST	1503715	1503735		YPO_RS07665	20
ABI910_6POST	1504217	1504263		YPO_RS07670	46
ABI910_6POST	1504329	1504342		YPO_RS07670	13
ABI910_6POST	1504459	1504464		YPO_RS07670	5
ABI910_6POST	1504525	1504530		YPO_RS07670	5
ABI910_6POST	1505517	1505518		YPO_RS07680	1
ABI910_6POST	1505617	1505634		YPO_RS07680	17
ABI910_6POST	1506525	1506535		YPO_RS07685	10
ABI910_6POST	1506724	1506726		YPO_RS07685	2
ABI910_6POST	1507522	1507564		YPO_RS07690	42
ABI910_6POST	1507745	1507783		YPO_RS07690	38
ABI910_6POST	1507935	1507945		YPO_RS07690	10
ABI910_6POST	1508033	1508039		YPO_RS07690	6
ABI910_6POST	1508133	1508149		YPO_RS07690	16
ABI910_6POST	1508817	1508823		YPO_RS07700	6
ABI910_6POST	1509033	1509068		YPO_RS07705	35
ABI910_6POST	1509340	1509362		YPO_RS07705	22
ABI910_6POST	1510849	1510856		YPO_RS07715	7
ABI910_6POST	1511100	1511118		YPO_RS07720	18
ABI910_6POST	1511460	1511462		YPO_RS07720	2
ABI910_6POST	1511619	1511666		YPO_RS07720	47
ABI910_6POST	1511727	1511751		YPO_RS07720	24
ABI910_6POST	1512054	1512055		YPO_RS07720	1
ABI910_6POST	1512315	1512318		YPO_RS07720	3
ABI910_6POST	1512826	1512832		YPO_RS07725	6
ABI910_6POST	1513074	1513098		YPO_RS07725	24
ABI910_6POST	1513166	1513189		YPO_RS07725	23
ABI910_6POST	1513326	1513328		YPO_RS07730	2
ABI910_6POST	1513804	1513821		artM	17
ABI910_6POST	1513910	1513935		artM	25
ABI910_6POST	1514065	1514089		artM	24
ABI910_6POST	1514668	1514673		artQ	5
ABI910_6POST	1514837	1514858		artJ	21
ABI910_6POST	1515018	1515034		artJ	16
ABI910_6POST	1515703	1515709		artP	6
ABI910_6POST	1516184	1516198		artP	14
ABI910_6POST	1517785	1517789		YPO_RS07760	4
ABI910_6POST	1517841	1517851		YPO_RS07760	10
ABI910_6POST	1518284	1518291		YPO_RS07765	7
ABI910_6POST	1518395	1518414		YPO_RS07765	19
ABI910_6POST	1519443	1519456		YPO_RS07770	13
ABI910_6POST	1520052	1520054		YPO_RS07770	2
ABI910_6POST	1520203	1520214		YPO_RS07770	11
ABI910_6POST	1520582	1520586		YPO_RS07770	4
ABI910_6POST	1522358	1522365		poxB	7
ABI910_6POST	1522534	1522536		poxB	2
ABI910_6POST	1522978	1522995		poxB	17
ABI910_6POST	1523028	1523032		poxB	4
ABI910_6POST	1523262	1523278		poxB	16
ABI910_6POST	1523463	1523478		poxB	15
ABI910_6POST	1523913	1523930		hcr	17
ABI910_6POST	1524160	1524164		hcr	4
ABI910_6POST	1524249	1524263		hcr	14
ABI910_6POST	1524624	1524643		hcr	19
ABI910_6POST	1525160	1525169		hcp	9
ABI910_6POST	1525388	1525393		hcp	5
ABI910_6POST	1525582	1525608		hcp	26
ABI910_6POST	1525841	1525842		hcp	1
ABI910_6POST	1526044	1526054		hcp	10
ABI910_6POST	1526488	1526499		hcp	11
ABI910_6POST	1527285	1527286		YPO_RS07795	1
ABI910_6POST	1528526	1528527		YPO_RS07800	1
ABI910_6POST	1529101	1529131		YPO_RS07800	30
ABI910_6POST	1529426	1529431		YPO_RS07800	5
ABI910_6POST	1529634	1529668		YPO_RS07800	34
ABI910_6POST	1529998	1530013		YPO_RS07805	15
ABI910_6POST	1530468	1530472		YPO_RS07805	4
ABI910_6POST	1531139	1531147		macA	8
ABI910_6POST	1531892	1531895		macA	3
ABI910_6POST	1531992	1532007		macA	15
ABI910_6POST	1532887	1532895		macB	8
ABI910_6POST	1533007	1533036		macB	29
ABI910_6POST	1533161	1533170		macB	9
ABI910_6POST	1533594	1533638		macB	44
ABI910_6POST	1533987	1534002		macB	15
ABI910_6POST	1534433	1534441		cspD	8
ABI910_6POST	1535729	1535733		clpA	4
ABI910_6POST	1536805	1536806		clpA	1
ABI910_6POST	1538800	1538814		infA	14
ABI910_6POST	1539720	1539743		aat	23
ABI910_6POST	1540175	1540180		cydC	5
ABI910_6POST	1540481	1540486		cydC	5
ABI910_6POST	1540581	1540618		cydC	37
ABI910_6POST	1540664	1540673		cydC	9
ABI910_6POST	1541049	1541050		cydC	1
ABI910_6POST	1541587	1541592		cydC	5
ABI910_6POST	1541919	1541932		cydD	13
ABI910_6POST	1542287	1542291		cydD	4
ABI910_6POST	1542930	1542934		cydD	4
ABI910_6POST	1543026	1543039		cydD	13
ABI910_6POST	1544067	1544087		trxB	20
ABI910_6POST	1544239	1544250		trxB	11
ABI910_6POST	1544321	1544373		trxB	52
ABI910_6POST	1544821	1544840		trxB	19
ABI910_6POST	1546517	1546518		YPO_RS07870	1
ABI910_6POST	1546701	1546705		YPO_RS07870	4
ABI910_6POST	1547197	1547207		YPO_RS07870	10
ABI910_6POST	1547850	1547851		YPO_RS07870	1
ABI910_6POST	1548148	1548165		YPO_RS07870	17
ABI910_6POST	1548248	1548260		YPO_RS07870	12
ABI910_6POST	1548382	1548397		YPO_RS07870	15
ABI910_6POST	1548761	1548769		YPO_RS07870	8
ABI910_6POST	1549598	1549603		YPO_RS07870	5
ABI910_6POST	1549663	1549675		YPO_RS07870	12
ABI910_6POST	1549757	1549769		YPO_RS07870	12
ABI910_6POST	1550617	1550642		lolA	25
ABI910_6POST	1551204	1551210		YPO_RS07880	6
ABI910_6POST	1551463	1551503		YPO_RS07880	40
ABI910_6POST	1552365	1552372		YPO_RS07880	7
ABI910_6POST	1552833	1552847		serS	14
ABI910_6POST	1553270	1553281		serS	11
ABI910_6POST	1553464	1553493		serS	29
ABI910_6POST	1553662	1553710		serS	48
ABI910_6POST	1555311	1555314		YPO_RS07890	3
ABI910_6POST	1555778	1555787		pflA	9
ABI910_6POST	1558075	1558098		pflB	23
ABI910_6POST	1558440	1558460		pflB	20
ABI910_6POST	1558826	1558828		pflB	2
ABI910_6POST	1558947	1558950		pflB	3
ABI910_6POST	1559609	1559610		pflB	1
ABI910_6POST	1560975	1560981		focA	6
ABI910_6POST	1561179	1561185		focA	6
ABI910_6POST	1562334	1562372		YPO_RS07915	38
ABI910_6POST	1562699	1562705		YPO_RS07915	6
ABI910_6POST	1563229	1563262		YPO_RS07915	33
ABI910_6POST	1563900	1563913		ansB	13
ABI910_6POST	1564187	1564194		ansB	7
ABI910_6POST	1564259	1564261		ansB	2
ABI910_6POST	1564446	1564479		ansB	33
ABI910_6POST	1564632	1564634		ansB	2
ABI910_6POST	1566351	1566383		YPO_RS07930	32
ABI910_6POST	1566880	1566885		YPO_RS07930	5
ABI910_6POST	1567157	1567167		YPO_RS07930	10
ABI910_6POST	1567283	1567292		YPO_RS07930	9
ABI910_6POST	1567551	1567558		YPO_RS07930	7
ABI910_6POST	1567714	1567781		YPO_RS07930	67
ABI910_6POST	1568882	1568887		serC	5
ABI910_6POST	1569057	1569060		serC	3
ABI910_6POST	1569511	1569513		serC	2
ABI910_6POST	1569578	1569582		serC	4
ABI910_6POST	1569811	1569815		aroA	4
ABI910_6POST	1569979	1569985		aroA	6
ABI910_6POST	1570218	1570232		aroA	14
ABI910_6POST	1570425	1570451		aroA	26
ABI910_6POST	1571469	1571471		cmk	2
ABI910_6POST	1571616	1571629		cmk	13
ABI910_6POST	1571739	1571743		cmk	4
ABI910_6POST	1573550	1573566		rpsA	16
ABI910_6POST	1572849	1572866		rpsA	17
ABI910_6POST	1574960	1574970		YPO_RS07960	10
ABI910_6POST	1575198	1575213		YPO_RS07960	15
ABI910_6POST	1575382	1575385		YPO_RS07960	3
ABI910_6POST	1575575	1575578		YPO_RS07960	3
ABI910_6POST	1575700	1575721		YPO_RS07960	21
ABI910_6POST	1576023	1576049		YPO_RS07960	26
ABI910_6POST	1576575	1576582		YPO_RS07960	7
ABI910_6POST	1576632	1576652		YPO_RS07960	20
ABI910_6POST	1576770	1576788		YPO_RS07960	18
ABI910_6POST	1577525	1577544		msbA	19
ABI910_6POST	1577696	1577704		msbA	8
ABI910_6POST	1578916	1578960		lpxK	44
ABI910_6POST	1579389	1579403		lpxK	14
ABI910_6POST	1579742	1579799		lpxK	57
ABI910_6POST	1579832	1579833		lpxK	1
ABI910_6POST	1580501	1580519		YPO_RS07975	18
ABI910_6POST	1580667	1580672		YPO_RS07975	5
ABI910_6POST	1580899	1580917		YPO_RS07975	18
ABI910_6POST	1581020	1581023		YPO_RS07975	3
ABI910_6POST	1581155	1581211		YPO_RS07975	56
ABI910_6POST	1582062	1582101		YPO_RS07980	39
ABI910_6POST	1582851	1582867		YPO_RS07985	16
ABI910_6POST	1583055	1583061		kdsB	6
ABI910_6POST	1584090	1584102		YPO_RS07995	12
ABI910_6POST	1586317	1586320		cmoM	3
ABI910_6POST	1587692	1587705		mukF	13
ABI910_6POST	1588676	1588691		mukB	15
ABI910_6POST	1588855	1588858		mukB	3
ABI910_6POST	1589046	1589053		mukB	7
ABI910_6POST	1589299	1589323		mukB	24
ABI910_6POST	1589357	1589365		mukB	8
ABI910_6POST	1589526	1589533		mukB	7
ABI910_6POST	1590674	1590693		mukB	19
ABI910_6POST	1591096	1591102		mukB	6
ABI910_6POST	1591134	1591135		mukB	1
ABI910_6POST	1591642	1591652		mukB	10
ABI910_6POST	1592299	1592302		mukB	3
ABI910_6POST	1592659	1592701		mukB	42
ABI910_6POST	1594375	1594386		ldtD	11
ABI910_6POST	1594492	1594505		ldtD	13
ABI910_6POST	1594972	1594976		ldtD	4
ABI910_6POST	1595316	1595317		ldtD	1
ABI910_6POST	1595405	1595417		ldtD	12
ABI910_6POST	1596388	1596400		YPO_RS08030	12
ABI910_6POST	1596693	1596720		YPO_RS08035	27
ABI910_6POST	1598023	1598030		YPO_RS08045	7
ABI910_6POST	1598101	1598113		YPO_RS08045	12
ABI910_6POST	1598279	1598288		YPO_RS08045	9
ABI910_6POST	1598330	1598347		YPO_RS08045	17
ABI910_6POST	1598704	1598705		YPO_RS08045	1
ABI910_6POST	1598858	1598861		YPO_RS08045	3
ABI910_6POST	1600155	1600197		ompF	42
ABI910_6POST	1601343	1601351		asnS	8
ABI910_6POST	1601599	1601612		asnS	13
ABI910_6POST	1603418	1603447		pncB	29
ABI910_6POST	1604670	1604673		pepN	3
ABI910_6POST	1604823	1604834		pepN	11
ABI910_6POST	1605335	1605339		pepN	4
ABI910_6POST	1605833	1605848		pepN	15
ABI910_6POST	1606081	1606087		pepN	6
ABI910_6POST	1606258	1606262		pepN	4
ABI910_6POST	1606633	1606658		pepN	25
ABI910_6POST	1606887	1606891		pepN	4
ABI910_6POST	1607831	1607834		pyrD	3
ABI910_6POST	1608098	1608117		pyrD	19
ABI910_6POST	1608192	1608195		pyrD	3
ABI910_6POST	1608294	1608313		pyrD	19
ABI910_6POST	1608442	1608470		pyrD	28
ABI910_6POST	1609082	1609093		YPO_RS08075	11
ABI910_6POST	1609300	1609318		YPO_RS08075	18
ABI910_6POST	1609625	1609651		YPO_RS08080	26
ABI910_6POST	1610659	1610680		rlmKL	21
ABI910_6POST	1610856	1610862		rlmKL	6
ABI910_6POST	1611193	1611201		rlmKL	8
ABI910_6POST	1611474	1611492		rlmKL	18
ABI910_6POST	1611955	1611980		rlmKL	25
ABI910_6POST	1612135	1612146		rlmKL	11
ABI910_6POST	1613081	1613096		YPO_RS08090	15
ABI910_6POST	1613242	1613246		YPO_RS08090	4
ABI910_6POST	1614110	1614126		YPO_RS08090	16
ABI910_6POST	1614540	1614559		YPO_RS08090	19
ABI910_6POST	1614811	1614824		pqiA	13
ABI910_6POST	1615475	1615484		pqiA	9
ABI910_6POST	1615861	1615899		pqiA	38
ABI910_6POST	1616481	1616488		pqiB	7
ABI910_6POST	1617143	1617156		pqiB	13
ABI910_6POST	1617498	1617521		pqiB	23
ABI910_6POST	1617747	1617756		pqiC	9
ABI910_6POST	1618102	1618131		pqiC	29
ABI910_6POST	1618863	1618869		YPO_RS08115	6
ABI910_6POST	1619256	1619273		YPO_RS08115	17
ABI910_6POST	1620498	1620504		YPO_RS08125	6
ABI910_6POST	1620628	1620637		YPO_RS08125	9
ABI910_6POST	1620910	1620942		YPO_RS08125	32
ABI910_6POST	1621178	1621190		YPO_RS08125	12
ABI910_6POST	1621286	1621301		YPO_RS08130	15
ABI910_6POST	1621366	1621399		YPO_RS08130	33
ABI910_6POST	1621454	1621455		YPO_RS08130	1
ABI910_6POST	1621572	1621610		YPO_RS08130	38
ABI910_6POST	1621769	1621797		YPO_RS08130	28
ABI910_6POST	1621872	1621886		YPO_RS08130	14
ABI910_6POST	1621959	1621967		YPO_RS08130	8
ABI910_6POST	1622120	1622124		YPO_RS08130	4
ABI910_6POST	1622013	1622024		YPO_RS08130	11
ABI910_6POST	1623007	1623018		YPO_RS08140	11
ABI910_6POST	1624193	1624217		YPO_RS08150	24
ABI910_6POST	1624860	1624916		YPO_RS08150	56
ABI910_6POST	1625118	1625123		YPO_RS08150	5
ABI910_6POST	1626250	1626262		matP	12
ABI910_6POST	1626761	1626769		YPO_RS08160	8
ABI910_6POST	1626910	1626912		YPO_RS08160	2
ABI910_6POST	1627486	1627497		ompA	11
ABI910_6POST	1627732	1627747		ompA	15
ABI910_6POST	1627780	1627807		ompA	27
ABI910_6POST	1627851	1627949		ompA	98
ABI910_6POST	1628028	1628045		ompA	17
ABI910_6POST	1628196	1628219		ompA	23
ABI910_6POST	1629085	1629088		sulA	3
ABI910_6POST	1630083	1630084		yccS	1
ABI910_6POST	1630141	1630144		yccS	3
ABI910_6POST	1630665	1630746		yccS	81
ABI910_6POST	1631274	1631291		yccS	17
ABI910_6POST	1631353	1631355		yccS	2
ABI910_6POST	1631596	1631625		yccS	29
ABI910_6POST	1631794	1631824		yccS	30
ABI910_6POST	1631904	1631908		yccS	4
ABI910_6POST	1632085	1632116		yccS	31
ABI910_6POST	1632384	1632413		YPO_RS08185	29
ABI910_6POST	1633145	1633152		helD	7
ABI910_6POST	1633713	1633717		helD	4
ABI910_6POST	1634239	1634244		helD	5
ABI910_6POST	1634705	1634719		helD	14
ABI910_6POST	1634780	1634788		helD	8
ABI910_6POST	1634979	1634993		YPO_RS08195	14
ABI910_6POST	1635062	1635078		YPO_RS08195	16
ABI910_6POST	1635153	1635154		YPO_RS08195	1
ABI910_6POST	1635207	1635214		YPO_RS08195	7
ABI910_6POST	1635745	1635749		YPO_RS08200	4
ABI910_6POST	1635762	1635763		YPO_RS08200	1
ABI910_6POST	1636839	1636889		YPO_RS08205	50
ABI910_6POST	1636926	1636937		YPO_RS08205	11
ABI910_6POST	1638120	1638138		rlmI	18
ABI910_6POST	1643292	1643301		YPO_RS08245	9
ABI910_6POST	1643379	1643397		YPO_RS08245	18
ABI910_6POST	1643695	1643706		YPO_RS08245	11
ABI910_6POST	1643808	1643817		YPO_RS08245	9
ABI910_6POST	1644620	1644623		YPO_RS08245	3
ABI910_6POST	1645049	1645052		YPO_RS08245	3
ABI910_6POST	1645943	1645952		YPO_RS08250	9
ABI910_6POST	1647841	1647848		YPO_RS08260	7
ABI910_6POST	1647996	1648002		YPO_RS08260	6
ABI910_6POST	1648175	1648179		YPO_RS08265	4
ABI910_6POST	1648244	1648248		YPO_RS08265	4
ABI910_6POST	1648622	1648639		YPO_RS08265	17
ABI910_6POST	1648785	1648803		YPO_RS08265	18
ABI910_6POST	1648975	1648978		YPO_RS08265	3
ABI910_6POST	1649165	1649174		YPO_RS08265	9
ABI910_6POST	1649410	1649435		YPO_RS08270	25
ABI910_6POST	1649586	1649592		YPO_RS08270	6
ABI910_6POST	1649605	1649606		YPO_RS08270	1
ABI910_6POST	1650319	1650339		YPO_RS08275	20
ABI910_6POST	1650618	1650629		YPO_RS08275	11
ABI910_6POST	1651127	1651132		YPO_RS08275	5
ABI910_6POST	1651400	1651405		YPO_RS08280	5
ABI910_6POST	1651493	1651529		YPO_RS08280	36
ABI910_6POST	1652093	1652100		YPO_RS08280	7
ABI910_6POST	1652102	1652103		YPO_RS08285	1
ABI910_6POST	1652413	1652437		YPO_RS08285	24
ABI910_6POST	1652659	1652661		YPO_RS08285	2
ABI910_6POST	1652785	1652797		YPO_RS08285	12
ABI910_6POST	1653165	1653189		YPO_RS08290	24
ABI910_6POST	1653221	1653222		YPO_RS08290	1
ABI910_6POST	1653294	1653306		YPO_RS08290	12
ABI910_6POST	1653524	1653542		YPO_RS08290	18
ABI910_6POST	1653804	1653844		YPO_RS08295	40
ABI910_6POST	1656449	1656455		tssB	6
ABI910_6POST	1656653	1656656		tssB	3
ABI910_6POST	1656747	1656764		tssB	17
ABI910_6POST	1656990	1657012		tssC	22
ABI910_6POST	1657117	1657127		tssC	10
ABI910_6POST	1657203	1657204		tssC	1
ABI910_6POST	1657280	1657286		tssC	6
ABI910_6POST	1657943	1657972		tssC	29
ABI910_6POST	1658251	1658265		tssC	14
ABI910_6POST	1658405	1658420		tssC	15
ABI910_6POST	1658556	1658568		tssK	12
ABI910_6POST	1658620	1658629		tssK	9
ABI910_6POST	1658706	1658741		tssK	35
ABI910_6POST	1658771	1658778		tssK	7
ABI910_6POST	1659078	1659095		tssK	17
ABI910_6POST	1659322	1659347		tssK	25
ABI910_6POST	1659430	1659458		tssK	28
ABI910_6POST	1659889	1659940		YPO_RS08325	51
ABI910_6POST	1660295	1660315		YPO_RS08325	20
ABI910_6POST	1660417	1660438		YPO_RS08325	21
ABI910_6POST	1660468	1660483		YPO_RS08325	15
ABI910_6POST	1660530	1660534		YPO_RS08325	4
ABI910_6POST	1660534	1660542		YPO_RS08330	8
ABI910_6POST	1660644	1660683		YPO_RS08330	39
ABI910_6POST	1660777	1660781		YPO_RS08330	4
ABI910_6POST	1660842	1660857		YPO_RS08330	15
ABI910_6POST	1660891	1660914		YPO_RS08330	23
ABI910_6POST	1661225	1661288		YPO_RS08330	63
ABI910_6POST	1661494	1661498		YPO_RS08330	4
ABI910_6POST	1661696	1661702		YPO_RS08330	6
ABI910_6POST	1661763	1661774		YPO_RS08330	11
ABI910_6POST	1661808	1661826		YPO_RS08330	18
ABI910_6POST	1661976	1661982		YPO_RS08330	6
ABI910_6POST	1662084	1662099		YPO_RS08330	15
ABI910_6POST	1662377	1662394		YPO_RS08335	17
ABI910_6POST	1663230	1663232		tssH	2
ABI910_6POST	1663338	1663380		tssH	42
ABI910_6POST	1663565	1663576		tssH	11
ABI910_6POST	1663902	1663923		tssH	21
ABI910_6POST	1664001	1664006		tssH	5
ABI910_6POST	1664191	1664204		tssH	13
ABI910_6POST	1664283	1664284		tssH	1
ABI910_6POST	1664825	1664838		tssH	13
ABI910_6POST	1664998	1665004		tssH	6
ABI910_6POST	1665406	1665411		tssH	5
ABI910_6POST	1665630	1665632		tssH	2
ABI910_6POST	1665853	1665875		YPO_RS08345	22
ABI910_6POST	1666061	1666074		YPO_RS08345	13
ABI910_6POST	1666147	1666150		YPO_RS08345	3
ABI910_6POST	1666290	1666300		YPO_RS08345	10
ABI910_6POST	1666547	1666557		YPO_RS08345	10
ABI910_6POST	1666770	1666777		YPO_RS08345	7
ABI910_6POST	1666840	1666856		YPO_RS08345	16
ABI910_6POST	1666964	1667005		YPO_RS08345	41
ABI910_6POST	1667106	1667140		YPO_RS08345	34
ABI910_6POST	1667480	1667508		YPO_RS08345	28
ABI910_6POST	1668009	1668019		YPO_RS08345	10
ABI910_6POST	1668114	1668123		YPO_RS08345	9
ABI910_6POST	1668234	1668264		YPO_RS08350	30
ABI910_6POST	1668339	1668340		YPO_RS08350	1
ABI910_6POST	1668958	1668974		YPO_RS08350	16
ABI910_6POST	1669083	1669097		YPO_RS08350	14
ABI910_6POST	1669230	1669269		YPO_RS08350	39
ABI910_6POST	1669629	1669630		YPO_RS08350	1
ABI910_6POST	1671205	1671211		YPO_RS08355	6
ABI910_6POST	1671401	1671417		YPO_RS08360	16
ABI910_6POST	1671576	1671628		YPO_RS08360	52
ABI910_6POST	1672004	1672009		YPO_RS08365	5
ABI910_6POST	1672069	1672070		YPO_RS08365	1
ABI910_6POST	1672593	1672610		YPO_RS08365	17
ABI910_6POST	1672993	1672997		YPO_RS08365	4
ABI910_6POST	1673086	1673099		YPO_RS08365	13
ABI910_6POST	1674065	1674093		YPO_RS08370	28
ABI910_6POST	1674220	1674229		YPO_RS08370	9
ABI910_6POST	1674303	1674306		YPO_RS08370	3
ABI910_6POST	1674398	1674402		YPO_RS08370	4
ABI910_6POST	1676718	1676723		YPO_RS08380	5
ABI910_6POST	1677177	1677182		YPO_RS08380	5
ABI910_6POST	1677483	1677568		YPO_RS08380	85
ABI910_6POST	1677667	1677671		YPO_RS08380	4
ABI910_6POST	1677841	1677848		YPO_RS08380	7
ABI910_6POST	1677990	1678028		YPO_RS08385	38
ABI910_6POST	1678212	1678231		YPO_RS08385	19
ABI910_6POST	1678336	1678340		YPO_RS08385	4
ABI910_6POST	1678553	1678596		YPO_RS08385	43
ABI910_6POST	1678910	1678937		YPO_RS08385	27
ABI910_6POST	1679141	1679147		YPO_RS08385	6
ABI910_6POST	1679257	1679270		YPO_RS08385	13
ABI910_6POST	1679473	1679481		YPO_RS08385	8
ABI910_6POST	1679607	1679621		YPO_RS08385	14
ABI910_6POST	1679871	1679876		YPO_RS08385	5
ABI910_6POST	1680830	1680860		YPO_RS08385	30
ABI910_6POST	1680968	1680987		YPO_RS08385	19
ABI910_6POST	1681057	1681063		YPO_RS08385	6
ABI910_6POST	1681195	1681200		YPO_RS08385	5
ABI910_6POST	1681677	1681690		tssA	13
ABI910_6POST	1681825	1681832		tssA	7
ABI910_6POST	1681972	1681991		tssA	19
ABI910_6POST	1682175	1682197		tssA	22
ABI910_6POST	1682419	1682427		tssA	8
ABI910_6POST	1682475	1682501		tssA	26
ABI910_6POST	1682662	1682699		tssA	37
ABI910_6POST	1682907	1682922		tssA	15
ABI910_6POST	1683353	1683374		YPO_RS08395	21
ABI910_6POST	1683823	1683828		YPO_RS08395	5
ABI910_6POST	1684117	1684139		YPO_RS08400	22
ABI910_6POST	1684226	1684259		YPO_RS08400	33
ABI910_6POST	1684360	1684387		YPO_RS08400	27
ABI910_6POST	1684946	1684967		tssF	21
ABI910_6POST	1685014	1685015		tssF	1
ABI910_6POST	1685134	1685150		tssF	16
ABI910_6POST	1685345	1685356		tssF	11
ABI910_6POST	1685416	1685417		tssF	1
ABI910_6POST	1685746	1685753		tssF	7
ABI910_6POST	1685833	1685849		tssF	16
ABI910_6POST	1685888	1685904		tssF	16
ABI910_6POST	1686074	1686079		tssF	5
ABI910_6POST	1686309	1686334		tssF	25
ABI910_6POST	1686580	1686582		tssG	2
ABI910_6POST	1686612	1686614		tssG	2
ABI910_6POST	1686905	1686941		tssG	36
ABI910_6POST	1687029	1687032		tssG	3
ABI910_6POST	1687598	1687603		tssJ	5
ABI910_6POST	1687691	1687709		tssJ	18
ABI910_6POST	1687878	1687899		tssJ	21
ABI910_6POST	1688021	1688039		tssJ	18
ABI910_6POST	1688267	1688268		tssE	1
ABI910_6POST	1688561	1688572		YPO_RS08425	11
ABI910_6POST	1688633	1688638		YPO_RS08425	5
ABI910_6POST	1689149	1689159		YPO_RS08425	10
ABI910_6POST	1689225	1689237		YPO_RS08425	12
ABI910_6POST	1689514	1689516		YPO_RS08425	2
ABI910_6POST	1690306	1690322		YPO_RS08430	16
ABI910_6POST	1690596	1690598		YPO_RS08430	2
ABI910_6POST	1690748	1690749		YPO_RS08430	1
ABI910_6POST	1691446	1691468		YPO_RS08435	22
ABI910_6POST	1691596	1691616		YPO_RS08435	20
ABI910_6POST	1691691	1691692		YPO_RS08435	1
ABI910_6POST	1691812	1691817		YPO_RS08435	5
ABI910_6POST	1692012	1692053		YPO_RS08435	41
ABI910_6POST	1692495	1692552		YPO_RS08435	57
ABI910_6POST	1693317	1693318		YPO_RS08440	1
ABI910_6POST	1693731	1693740		YPO_RS08440	9
ABI910_6POST	1694397	1694488		YPO_RS08445	91
ABI910_6POST	1694596	1694632		YPO_RS08445	36
ABI910_6POST	1694856	1694892		YPO_RS08445	36
ABI910_6POST	1695008	1695027		YPO_RS08445	19
ABI910_6POST	1695076	1695093		YPO_RS08445	17
ABI910_6POST	1695423	1695429		moeB	6
ABI910_6POST	1695482	1695528		moeB	46
ABI910_6POST	1695618	1695624		moeB	6
ABI910_6POST	1696870	1696877		moeA	7
ABI910_6POST	1697197	1697208		moeA	11
ABI910_6POST	1697947	1697948		darE	1
ABI910_6POST	1698579	1698583		darE	4
ABI910_6POST	1698925	1698941		darE	16
ABI910_6POST	1699181	1699201		darE	20
ABI910_6POST	1699752	1699768		darD	16
ABI910_6POST	1700042	1700048		darC	6
ABI910_6POST	1700412	1700418		darC	6
ABI910_6POST	1700553	1700580		darC	27
ABI910_6POST	1700893	1700907		darC	14
ABI910_6POST	1700976	1700986		darC	10
ABI910_6POST	1701329	1701378		darB	49
ABI910_6POST	1701609	1701631		darB	22
ABI910_6POST	1701720	1701730		darB	10
ABI910_6POST	1701777	1701781		darB	4
ABI910_6POST	1702227	1702231		darB	4
ABI910_6POST	1702651	1702663		darB	12
ABI910_6POST	1702783	1702835		darB	52
ABI910_6POST	1703425	1703435		darB	10
ABI910_6POST	1704105	1704114		fghA	9
ABI910_6POST	1704305	1704307		fghA	2
ABI910_6POST	1704348	1704353		fghA	5
ABI910_6POST	1704634	1704656		fghA	22
ABI910_6POST	1705348	1705349		YPO_RS08490	1
ABI910_6POST	1705429	1705430		YPO_RS08490	1
ABI910_6POST	1705489	1705534		YPO_RS08490	45
ABI910_6POST	1705802	1705815		YPO_RS08490	13
ABI910_6POST	1706450	1706507		YPO_RS08495	57
ABI910_6POST	1706681	1706687		YPO_RS08495	6
ABI910_6POST	1706759	1706777		YPO_RS08495	18
ABI910_6POST	1707563	1707605		YPO_RS08500	42
ABI910_6POST	1708230	1708231		YPO_RS08500	1
ABI910_6POST	1708410	1708419		YPO_RS08500	9
ABI910_6POST	1708851	1708867		folE	16
ABI910_6POST	1709539	1709565		YPO_RS08510	26
ABI910_6POST	1709914	1709919		YPO_RS08510	5
ABI910_6POST	1710143	1710144		YPO_RS08510	1
ABI910_6POST	1710270	1710295		YPO_RS08510	25
ABI910_6POST	1710423	1710426		YPO_RS08510	3
ABI910_6POST	1711340	1711350		mglB	10
ABI910_6POST	1711776	1711786		mglB	10
ABI910_6POST	1711863	1711882		mglB	19
ABI910_6POST	1712670	1712672		mglA	2
ABI910_6POST	1713211	1713253		mglA	42
ABI910_6POST	1713339	1713345		mglA	6
ABI910_6POST	1713752	1713777		mglA	25
ABI910_6POST	1713807	1713817		mglA	10
ABI910_6POST	1713969	1713970		mglA	1
ABI910_6POST	1714653	1714670		mglC	17
ABI910_6POST	1715593	1715602		sanA	9
ABI910_6POST	1715705	1715715		sanA	10
ABI910_6POST	1715957	1715970		sanA	13
ABI910_6POST	1716908	1716912		YPO_RS08535	4
ABI910_6POST	1718198	1718227		YPO_RS08535	29
ABI910_6POST	1718684	1718695		cdd	11
ABI910_6POST	1718767	1718773		cdd	6
ABI910_6POST	1719130	1719157		cdd	27
ABI910_6POST	1719212	1719216		cdd	4
ABI910_6POST	1719390	1719393		cdd	3
ABI910_6POST	1719854	1719871		YPO_RS08545	17
ABI910_6POST	1719953	1719977		YPO_RS08545	24
ABI910_6POST	1720200	1720202		YPO_RS08545	2
ABI910_6POST	1720379	1720429		YPO_RS08545	50
ABI910_6POST	1720606	1720612		YPO_RS08550	6
ABI910_6POST	1720662	1720686		YPO_RS08550	24
ABI910_6POST	1720797	1720812		YPO_RS08550	15
ABI910_6POST	1721179	1721182		YPO_RS08555	3
ABI910_6POST	1721310	1721319		YPO_RS08555	9
ABI910_6POST	1721441	1721450		YPO_RS08555	9
ABI910_6POST	1721628	1721691		YPO_RS08555	63
ABI910_6POST	1721868	1721904		YPO_RS08555	36
ABI910_6POST	1722165	1722169		YPO_RS08555	4
ABI910_6POST	1722857	1722876		YPO_RS08560	19
ABI910_6POST	1723135	1723149		YPO_RS08560	14
ABI910_6POST	1723227	1723229		YPO_RS08560	2
ABI910_6POST	1723437	1723444		YPO_RS08560	7
ABI910_6POST	1724012	1724016		YPO_RS08565	4
ABI910_6POST	1724055	1724062		YPO_RS08565	7
ABI910_6POST	1724117	1724129		YPO_RS08565	12
ABI910_6POST	1724900	1724907		YPO_RS08565	7
ABI910_6POST	1725943	1725947		YPO_RS08570	4
ABI910_6POST	1726316	1726317		YPO_RS08570	1
ABI910_6POST	1726810	1726815		YPO_RS08575	5
ABI910_6POST	1726846	1726858		YPO_RS08575	12
ABI910_6POST	1726931	1726952		YPO_RS08575	21
ABI910_6POST	1727030	1727032		YPO_RS08575	2
ABI910_6POST	1727222	1727245		YPO_RS08575	23
ABI910_6POST	1727306	1727338		YPO_RS08575	32
ABI910_6POST	1727537	1727575		YPO_RS08580	38
ABI910_6POST	1727706	1727741		YPO_RS08580	35
ABI910_6POST	1727773	1727853		YPO_RS08580	80
ABI910_6POST	1727927	1727951		YPO_RS08580	24
ABI910_6POST	1728045	1728067		YPO_RS08580	22
ABI910_6POST	1728276	1728279		YPO_RS08580	3
ABI910_6POST	1728558	1728561		YPO_RS08585	3
ABI910_6POST	1728648	1728649		YPO_RS08585	1
ABI910_6POST	1729235	1729254		metG	19
ABI910_6POST	1729319	1729327		metG	8
ABI910_6POST	1729535	1729545		metG	10
ABI910_6POST	1729661	1729665		metG	4
ABI910_6POST	1729918	1729921		metG	3
ABI910_6POST	1731027	1731035		metG	8
ABI910_6POST	1731527	1731556		apbC	29
ABI910_6POST	1731775	1731778		apbC	3
ABI910_6POST	1731840	1731862		apbC	22
ABI910_6POST	1732139	1732149		apbC	10
ABI910_6POST	1733656	1733667		dcd	11
ABI910_6POST	1734567	1734587		asmA	20
ABI910_6POST	1734683	1734687		asmA	4
ABI910_6POST	1735265	1735268		asmA	3
ABI910_6POST	1735467	1735491		asmA	24
ABI910_6POST	1736463	1736473		YPO_RS08615	10
ABI910_6POST	1736691	1736697		YPO_RS08615	6
ABI910_6POST	1737015	1737017		YPO_RS08615	2
ABI910_6POST	1737545	1737549		YPO_RS08615	4
ABI910_6POST	1738385	1738387		fhuF	2
ABI910_6POST	1738571	1738580		fhuF	9
ABI910_6POST	1738719	1738727		fhuF	8
ABI910_6POST	1739045	1739055		fhuF	10
ABI910_6POST	1739476	1739490		YPO_RS08625	14
ABI910_6POST	1739579	1739608		YPO_RS08625	29
ABI910_6POST	1739775	1739779		YPO_RS08625	4
ABI910_6POST	1740684	1740716		YPO_RS08625	32
ABI910_6POST	1740773	1740787		YPO_RS08625	14
ABI910_6POST	1741346	1741352		YPO_RS08630	6
ABI910_6POST	1741806	1741817		YPO_RS08630	11
ABI910_6POST	1742237	1742256		YPO_RS08635	19
ABI910_6POST	1742681	1742685		YPO_RS08635	4
ABI910_6POST	1743346	1743347		YPO_RS08640	1
ABI910_6POST	1744382	1744430		YPO_RS08640	48
ABI910_6POST	1745725	1745730		YPO_RS08650	5
ABI910_6POST	1745803	1745816		YPO_RS08650	13
ABI910_6POST	1745999	1746002		YPO_RS08650	3
ABI910_6POST	1746212	1746216		YPO_RS08650	4
ABI910_6POST	1746347	1746353		YPO_RS08650	6
ABI910_6POST	1746486	1746492		YPO_RS08650	6
ABI910_6POST	1746633	1746667		YPO_RS08655	34
ABI910_6POST	1746730	1746747		YPO_RS08655	17
ABI910_6POST	1746798	1746861		YPO_RS08655	63
ABI910_6POST	1746891	1746896		YPO_RS08655	5
ABI910_6POST	1747068	1747100		YPO_RS08655	32
ABI910_6POST	1747185	1747220		YPO_RS08655	35
ABI910_6POST	1747345	1747408		YPO_RS08655	63
ABI910_6POST	1748332	1748334		YPO_RS08660	2
ABI910_6POST	1748420	1748422		YPO_RS08660	2
ABI910_6POST	1748466	1748475		YPO_RS08660	9
ABI910_6POST	1748819	1748829		YPO_RS08665	10
ABI910_6POST	1748917	1748922		YPO_RS08665	5
ABI910_6POST	1749631	1749657		YPO_RS08665	26
ABI910_6POST	1749703	1749704		YPO_RS08665	1
ABI910_6POST	1749843	1749879		YPO_RS08665	36
ABI910_6POST	1749909	1749936		YPO_RS08665	27
ABI910_6POST	1750099	1750102		YPO_RS08665	3
ABI910_6POST	1750169	1750224		YPO_RS08665	55
ABI910_6POST	1750755	1750757		YPO_RS08665	2
ABI910_6POST	1751449	1751459		YPO_RS08670	10
ABI910_6POST	1751876	1751888		YPO_RS08670	12
ABI910_6POST	1751927	1751934		YPO_RS08670	7
ABI910_6POST	1752176	1752180		YPO_RS08670	4
ABI910_6POST	1754127	1754131		galU	4
ABI910_6POST	1755820	1755822		galU	2
ABI910_6POST	1757942	1757971		YPO_RS08690	29
ABI910_6POST	1758015	1758040		YPO_RS08690	25
ABI910_6POST	1758637	1758649		hisF	12
ABI910_6POST	1758752	1758774		hisF	22
ABI910_6POST	1758944	1758946		hisF	2
ABI910_6POST	1759477	1759493		hisA	16
ABI910_6POST	1759835	1759848		hisA	13
ABI910_6POST	1760149	1760155		hisH	6
ABI910_6POST	1760197	1760238		hisH	41
ABI910_6POST	1760278	1760281		hisH	3
ABI910_6POST	1760332	1760343		hisH	11
ABI910_6POST	1760726	1760773		hisB	47
ABI910_6POST	1760968	1760973		hisB	5
ABI910_6POST	1762541	1762545		hisC	4
ABI910_6POST	1762616	1762619		hisC	3
ABI910_6POST	1762925	1762935		hisD	10
ABI910_6POST	1763675	1763688		hisD	13
ABI910_6POST	1763993	1764004		hisD	11
ABI910_6POST	1764081	1764086		hisD	5
ABI910_6POST	1764245	1764270		hisG	25
ABI910_6POST	1764691	1764709		hisG	18
ABI910_6POST	1764746	1764753		hisG	7
ABI910_6POST	1765316	1765326		hisL	10
ABI910_6POST	1766267	1766275		YPO_RS08735	8
ABI910_6POST	1767428	1767438		YPO_RS08745	10
ABI910_6POST	1767983	1767998		YPO_RS08745	15
ABI910_6POST	1768162	1768165		YPO_RS08745	3
ABI910_6POST	1768714	1768718		YPO_RS08750	4
ABI910_6POST	1768883	1768903		YPO_RS08750	20
ABI910_6POST	1769244	1769260		YPO_RS08755	16
ABI910_6POST	1769771	1769788		YPO_RS08755	17
ABI910_6POST	1769821	1769836		YPO_RS08755	15
ABI910_6POST	1770514	1770584		YPO_RS08760	70
ABI910_6POST	1770752	1770771		YPO_RS08760	19
ABI910_6POST	1771096	1771098		YPO_RS08760	2
ABI910_6POST	1771588	1771652		YPO_RS08765	64
ABI910_6POST	1771992	1772000		YPO_RS08770	8
ABI910_6POST	1772102	1772112		YPO_RS08770	10
ABI910_6POST	1772268	1772320		YPO_RS08770	52
ABI910_6POST	1772790	1772844		YPO_RS08770	54
ABI910_6POST	1772987	1773015		YPO_RS08770	28
ABI910_6POST	1774599	1774619		sbcB	20
ABI910_6POST	1775116	1775123		sbcB	7
ABI910_6POST	1775665	1775723		YPO_RS08785	58
ABI910_6POST	1776195	1776200		YPO_RS08785	5
ABI910_6POST	1777865	1777868		YPO_RS08795	3
ABI910_6POST	1777977	1777979		YPO_RS08795	2
ABI910_6POST	1778114	1778146		YPO_RS08795	32
ABI910_6POST	1778613	1778647		YPO_RS08795	34
ABI910_6POST	1778842	1778854		YPO_RS08795	12
ABI910_6POST	1778974	1778988		YPO_RS08795	14
ABI910_6POST	1779040	1779050		YPO_RS08795	10
ABI910_6POST	1779040	1779050		YPO_RS08800	10
ABI910_6POST	1779608	1779618		YPO_RS08800	10
ABI910_6POST	1779683	1779690		YPO_RS08800	7
ABI910_6POST	1780204	1780238		YPO_RS08800	34
ABI910_6POST	1781064	1781088		YPO_RS08800	24
ABI910_6POST	1781236	1781256		YPO_RS08800	20
ABI910_6POST	1781525	1781527		YPO_RS08800	2
ABI910_6POST	1781851	1781863		YPO_RS08800	12
ABI910_6POST	1782017	1782035		YPO_RS08800	18
ABI910_6POST	1783217	1783232		YPO_RS08805	15
ABI910_6POST	1783485	1783498		YPO_RS08805	13
ABI910_6POST	1783776	1783783		YPO_RS08805	7
ABI910_6POST	1784334	1784338		YPO_RS08805	4
ABI910_6POST	1784917	1784922		YPO_RS08810	5
ABI910_6POST	1785403	1785410		YPO_RS08815	7
ABI910_6POST	1785749	1785777		YPO_RS08815	28
ABI910_6POST	1786196	1786215		YPO_RS08820	19
ABI910_6POST	1786529	1786539		YPO_RS08820	10
ABI910_6POST	1786602	1786658		YPO_RS08820	56
ABI910_6POST	1786777	1786781		YPO_RS08820	4
ABI910_6POST	1786871	1786889		YPO_RS08820	18
ABI910_6POST	1787141	1787144		YPO_RS08825	3
ABI910_6POST	1788117	1788130		YPO_RS08825	13
ABI910_6POST	1788914	1788947		lldD	33
ABI910_6POST	1789734	1789741		lldD	7
ABI910_6POST	1790310	1790315		argG	5
ABI910_6POST	1790713	1790723		argG	10
ABI910_6POST	1790930	1790943		argG	13
ABI910_6POST	1791761	1791769		YPO_RS08840	8
ABI910_6POST	1791815	1791821		YPO_RS08840	6
ABI910_6POST	1791865	1791868		YPO_RS08840	3
ABI910_6POST	1792038	1792069		YPO_RS08840	31
ABI910_6POST	1792391	1792399		YPO_RS08840	8
ABI910_6POST	1792584	1792596		YPO_RS08840	12
ABI910_6POST	1792849	1792870		YPO_RS08840	21
ABI910_6POST	1792943	1792974		YPO_RS08840	31
ABI910_6POST	1793067	1793068		YPO_RS08845	1
ABI910_6POST	1793212	1793216		YPO_RS08845	4
ABI910_6POST	1793366	1793381		YPO_RS08845	15
ABI910_6POST	1793633	1793647		YPO_RS08845	14
ABI910_6POST	1794710	1794721		YPO_RS08850	11
ABI910_6POST	1795008	1795012		YPO_RS08850	4
ABI910_6POST	1795050	1795051		YPO_RS08850	1
ABI910_6POST	1795234	1795267		YPO_RS08850	33
ABI910_6POST	1796119	1796138		YPO_RS08855	19
ABI910_6POST	1796289	1796296		YPO_RS08855	7
ABI910_6POST	1796874	1796875		YPO_RS08860	1
ABI910_6POST	1796976	1796980		YPO_RS08860	4
ABI910_6POST	1798411	1798442		YPO_RS08870	31
ABI910_6POST	1798560	1798565		YPO_RS08870	5
ABI910_6POST	1799038	1799050		YPO_RS08875	12
ABI910_6POST	1799245	1799279		YPO_RS08875	34
ABI910_6POST	1799608	1799625		YPO_RS08875	17
ABI910_6POST	1799915	1799935		YPO_RS08875	20
ABI910_6POST	1800359	1800365		YPO_RS08880	6
ABI910_6POST	1801072	1801080		YPO_RS08885	8
ABI910_6POST	1801231	1801244		YPO_RS08885	13
ABI910_6POST	1801355	1801364		YPO_RS08885	9
ABI910_6POST	1801433	1801462		YPO_RS08885	29
ABI910_6POST	1801531	1801546		YPO_RS08885	15
ABI910_6POST	1801791	1801815		YPO_RS08885	24
ABI910_6POST	1801845	1801851		YPO_RS08885	6
ABI910_6POST	1802475	1802487		YPO_RS08890	12
ABI910_6POST	1802626	1802643		YPO_RS08890	17
ABI910_6POST	1802743	1802755		YPO_RS08890	12
ABI910_6POST	1803535	1803542		YPO_RS08895	7
ABI910_6POST	1804069	1804079		YPO_RS08900	10
ABI910_6POST	1804312	1804314		YPO_RS08900	2
ABI910_6POST	1804501	1804507		YPO_RS08900	6
ABI910_6POST	1804611	1804626		YPO_RS08900	15
ABI910_6POST	1805902	1805932		YPO_RS08905	30
ABI910_6POST	1806053	1806069		YPO_RS08905	16
ABI910_6POST	1806953	1807006		YPO_RS08905	53
ABI910_6POST	1807098	1807102		YPO_RS08910	4
ABI910_6POST	1807614	1807618		YPO_RS08910	4
ABI910_6POST	1807697	1807722		YPO_RS08910	25
ABI910_6POST	1807773	1807777		YPO_RS08910	4
ABI910_6POST	1807824	1807845		YPO_RS08910	21
ABI910_6POST	1808051	1808066		YPO_RS08910	15
ABI910_6POST	1808172	1808216		YPO_RS08910	44
ABI910_6POST	1808273	1808277		YPO_RS08910	4
ABI910_6POST	1808273	1808314		bssS	41
ABI910_6POST	1808345	1808353		bssS	8
ABI910_6POST	1808453	1808461		bssS	8
ABI910_6POST	1808494	1808512		bssS	18
ABI910_6POST	1809132	1809139		dinI	7
ABI910_6POST	1810002	1810016		pyrC	14
ABI910_6POST	1810545	1810569		pyrC	24
ABI910_6POST	1811076	1811081		YPO_RS08930	5
ABI910_6POST	1811562	1811566		YPO_RS08940	4
ABI910_6POST	1812073	1812107		YPO_RS08940	34
ABI910_6POST	1812775	1812778		rne	3
ABI910_6POST	1812875	1812884		rne	9
ABI910_6POST	1813476	1813479		rne	3
ABI910_6POST	1813600	1813604		rne	4
ABI910_6POST	1813951	1813976		rne	25
ABI910_6POST	1814021	1814044		rne	23
ABI910_6POST	1814254	1814279		rne	25
ABI910_6POST	1815182	1815203		rne	21
ABI910_6POST	1817005	1817016		rluC	11
ABI910_6POST	1817181	1817230		rluC	49
ABI910_6POST	1817301	1817303		rluC	2
ABI910_6POST	1818864	1818868		YPO_RS08960	4
ABI910_6POST	1819139	1819141		YPO_RS08960	2
ABI910_6POST	1819632	1819634		yceD	2
ABI910_6POST	1820523	1820526		plsX	3
ABI910_6POST	1821651	1821655		YPO_RS08980	4
ABI910_6POST	1821786	1821801		YPO_RS08980	15
ABI910_6POST	1822054	1822089		YPO_RS08980	35
ABI910_6POST	1822319	1822332		fabD	13
ABI910_6POST	1822416	1822446		fabD	30
ABI910_6POST	1822675	1822692		fabD	17
ABI910_6POST	1822776	1822783		fabD	7
ABI910_6POST	1823089	1823098		fabD	9
ABI910_6POST	1823409	1823440		fabG	31
ABI910_6POST	1824702	1824717		fabF	15
ABI910_6POST	1824991	1825015		fabF	24
ABI910_6POST	1825222	1825259		fabF	37
ABI910_6POST	1825898	1825900		YPO_RS09005	2
ABI910_6POST	1826306	1826320		YPO_RS09005	14
ABI910_6POST	1826841	1826844		pabC	3
ABI910_6POST	1827239	1827242		pabC	3
ABI910_6POST	1827327	1827332		pabC	5
ABI910_6POST	1828171	1828177		mltG	6
ABI910_6POST	1828365	1828366		mltG	1
ABI910_6POST	1828601	1828602		mltG	1
ABI910_6POST	1828668	1828676		mltG	8
ABI910_6POST	1829051	1829054		YPO_RS09020	3
ABI910_6POST	1829158	1829213		YPO_RS09020	55
ABI910_6POST	1829836	1829843		holB	7
ABI910_6POST	1829895	1829899		holB	4
ABI910_6POST	1830165	1830168		holB	3
ABI910_6POST	1830472	1830514		holB	42
ABI910_6POST	1830580	1830585		YPO_RS09030	5
ABI910_6POST	1830804	1830812		YPO_RS09030	8
ABI910_6POST	1831238	1831262		YPO_RS09030	24
ABI910_6POST	1832416	1832430		ptsG	14
ABI910_6POST	1832735	1832745		ptsG	10
ABI910_6POST	1832851	1832856		ptsG	5
ABI910_6POST	1832910	1832932		ptsG	22
ABI910_6POST	1833295	1833299		YPO_RS09040	4
ABI910_6POST	1833522	1833528		YPO_RS09040	6
ABI910_6POST	1834255	1834272		YPO_RS09045	17
ABI910_6POST	1834576	1834580		YPO_RS09045	4
ABI910_6POST	1835385	1835389		hinT	4
ABI910_6POST	1836650	1836674		thiK	24
ABI910_6POST	1836977	1836986		thiK	9
ABI910_6POST	1837104	1837126		thiK	22
ABI910_6POST	1837357	1837361		thiK	4
ABI910_6POST	1838231	1838234		nagZ	3
ABI910_6POST	1838268	1838273		nagZ	5
ABI910_6POST	1838740	1838759		YPO_RS09075	19
ABI910_6POST	1839680	1839704		YPO_RS09080	24
ABI910_6POST	1839986	1839988		YPO_RS09080	2
ABI910_6POST	1840365	1840367		YPO_RS09080	2
ABI910_6POST	1840830	1840833		YPO_RS09080	3
ABI910_6POST	1841639	1841654		YPO_RS09085	15
ABI910_6POST	1842192	1842225		YPO_RS09090	33
ABI910_6POST	1842588	1842603		YPO_RS09095	15
ABI910_6POST	1842654	1842660		YPO_RS09095	6
ABI910_6POST	1842764	1842775		YPO_RS09095	11
ABI910_6POST	1842806	1842814		YPO_RS09095	8
ABI910_6POST	1842901	1842904		YPO_RS09095	3
ABI910_6POST	1843059	1843062		YPO_RS09095	3
ABI910_6POST	1843138	1843151		YPO_RS09095	13
ABI910_6POST	1843263	1843332		YPO_RS09095	69
ABI910_6POST	1843578	1843581		YPO_RS09095	3
ABI910_6POST	1843624	1843634		YPO_RS09095	10
ABI910_6POST	1844176	1844188		YPO_RS09100	12
ABI910_6POST	1844343	1844392		YPO_RS09100	49
ABI910_6POST	1844440	1844550		YPO_RS09100	110
ABI910_6POST	1844680	1844683		YPO_RS09100	3
ABI910_6POST	1844787	1844790		YPO_RS09100	3
ABI910_6POST	1844899	1844922		YPO_RS09105	23
ABI910_6POST	1844978	1845010		YPO_RS09105	32
ABI910_6POST	1845069	1845077		YPO_RS09105	8
ABI910_6POST	1845206	1845239		YPO_RS09105	33
ABI910_6POST	1845388	1845393		YPO_RS09105	5
ABI910_6POST	1845501	1845504		YPO_RS09105	3
ABI910_6POST	1845721	1845738		YPO_RS09105	17
ABI910_6POST	1846005	1846024		YPO_RS09110	19
ABI910_6POST	1846287	1846289		YPO_RS09110	2
ABI910_6POST	1846458	1846481		YPO_RS09110	23
ABI910_6POST	1846773	1846775		mfd	2
ABI910_6POST	1847243	1847247		mfd	4
ABI910_6POST	1847610	1847627		mfd	17
ABI910_6POST	1848237	1848267		mfd	30
ABI910_6POST	1848366	1848376		mfd	10
ABI910_6POST	1848610	1848618		mfd	8
ABI910_6POST	1848704	1848737		mfd	33
ABI910_6POST	1848873	1848877		mfd	4
ABI910_6POST	1849363	1849377		mfd	14
ABI910_6POST	1849439	1849459		mfd	20
ABI910_6POST	1850849	1850854		lolC	5
ABI910_6POST	1852188	1852194		lolD	6
ABI910_6POST	1852368	1852384		lolD	16
ABI910_6POST	1852514	1852518		lolE	4
ABI910_6POST	1852852	1852858		lolE	6
ABI910_6POST	1853033	1853051		lolE	18
ABI910_6POST	1853623	1853635		lolE	12
ABI910_6POST	1854771	1854780		cobB	9
ABI910_6POST	1854844	1854853		cobB	9
ABI910_6POST	1854970	1854988		cobB	18
ABI910_6POST	1855308	1855330		cobB	22
ABI910_6POST	1856314	1856317		pepT	3
ABI910_6POST	1856465	1856474		pepT	9
ABI910_6POST	1856815	1856826		pepT	11
ABI910_6POST	1857276	1857306		YPO_RS09150	30
ABI910_6POST	1858178	1858189		YPO_RS09150	11
ABI910_6POST	1858513	1858557		phoQ	44
ABI910_6POST	1859126	1859146		phoQ	20
ABI910_6POST	1859398	1859403		phoQ	5
ABI910_6POST	1859639	1859650		phoQ	11
ABI910_6POST	1860290	1860291		phoP	1
ABI910_6POST	1861060	1861087		YPO_RS09165	27
ABI910_6POST	1862314	1862330		purB	16
ABI910_6POST	1863231	1863236		hflD	5
ABI910_6POST	1863627	1863628		hflD	1
ABI910_6POST	1863875	1863885		mnmA	10
ABI910_6POST	1863923	1863931		mnmA	8
ABI910_6POST	1864073	1864081		mnmA	8
ABI910_6POST	1864139	1864194		mnmA	55
ABI910_6POST	1864627	1864639		mnmA	12
ABI910_6POST	1864756	1864772		mnmA	16
ABI910_6POST	1864839	1864840		mnmA	1
ABI910_6POST	1866541	1866550		icd	9
ABI910_6POST	1867217	1867218		icd	1
ABI910_6POST	1867663	1867700		YPO_RS09200	37
ABI910_6POST	1867787	1867807		YPO_RS09200	20
ABI910_6POST	1867971	1867973		YPO_RS09200	2
ABI910_6POST	1868018	1868021		YPO_RS09200	3
ABI910_6POST	1869613	1869619		YPO_RS09210	6
ABI910_6POST	1869838	1869846		YPO_RS09210	8
ABI910_6POST	1870457	1870464		YPO_RS09210	7
ABI910_6POST	1871949	1871969		YPO_RS09215	20
ABI910_6POST	1872360	1872373		YPO_RS09215	13
ABI910_6POST	1872937	1872947		YPO_RS09220	10
ABI910_6POST	1873145	1873147		YPO_RS09220	2
ABI910_6POST	1874007	1874014		YPO_RS09230	7
ABI910_6POST	1874067	1874075		YPO_RS09230	8
ABI910_6POST	1874149	1874157		YPO_RS09230	8
ABI910_6POST	1874213	1874221		YPO_RS09230	8
ABI910_6POST	1874443	1874452		YPO_RS09230	9
ABI910_6POST	1874658	1874698		YPO_RS09230	40
ABI910_6POST	1874824	1874840		YPO_RS09230	16
ABI910_6POST	1876047	1876050		YPO_RS09240	3
ABI910_6POST	1876130	1876158		YPO_RS09240	28
ABI910_6POST	1876449	1876458		YPO_RS09240	9
ABI910_6POST	1876694	1876699		YPO_RS09240	5
ABI910_6POST	1877268	1877269		YPO_RS09245	1
ABI910_6POST	1878751	1878756		YPO_RS09255	5
ABI910_6POST	1878977	1878991		YPO_RS09255	14
ABI910_6POST	1879448	1879452		YPO_RS09255	4
ABI910_6POST	1879560	1879574		YPO_RS09255	14
ABI910_6POST	1880143	1880154		YPO_RS09260	11
ABI910_6POST	1880219	1880221		YPO_RS09260	2
ABI910_6POST	1880808	1880821		YPO_RS09260	13
ABI910_6POST	1880944	1880961		YPO_RS09260	17
ABI910_6POST	1881137	1881146		YPO_RS09260	9
ABI910_6POST	1881185	1881186		YPO_RS09260	1
ABI910_6POST	1881555	1881580		YPO_RS09260	25
ABI910_6POST	1881987	1881992		YPO_RS09260	5
ABI910_6POST	1882119	1882132		YPO_RS09260	13
ABI910_6POST	1882450	1882454		YPO_RS09260	4
ABI910_6POST	1882659	1882690		YPO_RS09260	31
ABI910_6POST	1882733	1882738		YPO_RS09260	5
ABI910_6POST	1883010	1883012		YPO_RS09260	2
ABI910_6POST	1883207	1883211		YPO_RS09260	4
ABI910_6POST	1884113	1884154		dsrB	41
ABI910_6POST	1884257	1884289		dsrB	32
ABI910_6POST	1887529	1887540		YPO_RS09280	11
ABI910_6POST	1887584	1887600		YPO_RS09280	16
ABI910_6POST	1889284	1889301		mgtA	17
ABI910_6POST	1889435	1889437		mgtA	2
ABI910_6POST	1889698	1889712		mgtA	14
ABI910_6POST	1890165	1890173		mgtA	8
ABI910_6POST	1890945	1890947		mgtA	2
ABI910_6POST	1891050	1891061		mgtA	11
ABI910_6POST	1891108	1891118		mgtA	10
ABI910_6POST	1893314	1893322		flhC	8
ABI910_6POST	1893604	1893612		motA	8
ABI910_6POST	1894045	1894047		motA	2
ABI910_6POST	1894319	1894322		motA	3
ABI910_6POST	1894453	1894464		motB	11
ABI910_6POST	1894680	1894707		motB	27
ABI910_6POST	1895629	1895634		motB	5
ABI910_6POST	1895676	1895691		motB	15
ABI910_6POST	1896374	1896383		cheA	9
ABI910_6POST	1896612	1896637		cheA	25
ABI910_6POST	1897427	1897434		cheA	7
ABI910_6POST	1897724	1897736		cheA	12
ABI910_6POST	1897817	1897821		cheA	4
ABI910_6POST	1898232	1898235		cheW	3
ABI910_6POST	1899467	1899469		YPO_RS09320	2
ABI910_6POST	1899963	1899966		YPO_RS09320	3
ABI910_6POST	1900000	1900009		YPO_RS09320	9
ABI910_6POST	1900909	1900913		YPO_RS09330	4
ABI910_6POST	1900963	1900988		YPO_RS09330	25
ABI910_6POST	1901125	1901137		YPO_RS09330	12
ABI910_6POST	1901302	1901308		YPO_RS09330	6
ABI910_6POST	1901707	1901716		YPO_RS09335	9
ABI910_6POST	1902955	1902980		yapJ	25
ABI910_6POST	1903275	1903279		yapJ	4
ABI910_6POST	1903490	1903515		yapJ	25
ABI910_6POST	1903783	1903795		yapJ	12
ABI910_6POST	1903833	1903850		yapJ	17
ABI910_6POST	1903932	1903950		yapJ	18
ABI910_6POST	1904190	1904234		yapJ	44
ABI910_6POST	1904493	1904513		yapJ	20
ABI910_6POST	1904581	1904582		yapJ	1
ABI910_6POST	1904846	1904893		yapJ	47
ABI910_6POST	1904972	1904973		yapJ	1
ABI910_6POST	1905050	1905086		yapJ	36
ABI910_6POST	1905361	1905372		yapJ	11
ABI910_6POST	1905584	1905626		yapJ	42
ABI910_6POST	1905670	1905690		yapJ	20
ABI910_6POST	1905787	1905808		yapJ	21
ABI910_6POST	1906109	1906119		yapJ	10
ABI910_6POST	1906190	1906198		yapJ	8
ABI910_6POST	1906464	1906481		yapJ	17
ABI910_6POST	1906584	1906605		yapJ	21
ABI910_6POST	1907280	1907289		YPO_RS09345	9
ABI910_6POST	1907362	1907367		YPO_RS09345	5
ABI910_6POST	1907564	1907567		YPO_RS09345	3
ABI910_6POST	1907804	1907810		YPO_RS09345	6
ABI910_6POST	1908170	1908185		YPO_RS09345	15
ABI910_6POST	1908458	1908485		YPO_RS09345	27
ABI910_6POST	1909029	1909048		YPO_RS09345	19
ABI910_6POST	1909370	1909385		YPO_RS09345	15
ABI910_6POST	1909432	1909455		YPO_RS09345	23
ABI910_6POST	1909558	1909573		YPO_RS09345	15
ABI910_6POST	1909787	1909807		YPO_RS09345	20
ABI910_6POST	1909980	1909996		YPO_RS09345	16
ABI910_6POST	1910108	1910124		YPO_RS09350	16
ABI910_6POST	1911042	1911066		YPO_RS09355	24
ABI910_6POST	1911283	1911291		YPO_RS09355	8
ABI910_6POST	1911612	1911696		YPO_RS09355	84
ABI910_6POST	1912319	1912328		YPO_RS09355	9
ABI910_6POST	1914865	1914913		cheR	48
ABI910_6POST	1915007	1915015		cheR	8
ABI910_6POST	1915783	1915791		YPO_RS09370	8
ABI910_6POST	1916218	1916222		YPO_RS09370	4
ABI910_6POST	1916580	1916582		YPO_RS09370	2
ABI910_6POST	1917549	1917557		cheZ	8
ABI910_6POST	1918294	1918296		YPO_RS09385	2
ABI910_6POST	1918414	1918426		YPO_RS09385	12
ABI910_6POST	1918794	1918809		YPO_RS09385	15
ABI910_6POST	1918927	1918931		YPO_RS09385	4
ABI910_6POST	1918991	1919015		YPO_RS09385	24
ABI910_6POST	1920120	1920132		YPO_RS09390	12
ABI910_6POST	1920328	1920346		YPO_RS09390	18
ABI910_6POST	1920472	1920498		YPO_RS09390	26
ABI910_6POST	1920533	1920542		YPO_RS09390	9
ABI910_6POST	1920591	1920665		YPO_RS09390	74
ABI910_6POST	1920806	1920835		YPO_RS09390	29
ABI910_6POST	1920990	1921001		YPO_RS09390	11
ABI910_6POST	1921402	1921415		YPO_RS09390	13
ABI910_6POST	1921536	1921566		YPO_RS09390	30
ABI910_6POST	1921686	1921701		YPO_RS09395	15
ABI910_6POST	1921925	1921936		YPO_RS09395	11
ABI910_6POST	1922471	1922475		YPO_RS09400	4
ABI910_6POST	1924126	1924186		YPO_RS09405	60
ABI910_6POST	1924402	1924418		YPO_RS09405	16
ABI910_6POST	1927006	1927014		YPO_RS09420	8
ABI910_6POST	1927301	1927321		YPO_RS09420	20
ABI910_6POST	1927684	1927701		YPO_RS09420	17
ABI910_6POST	1927759	1927775		YPO_RS09420	16
ABI910_6POST	1927907	1927912		YPO_RS09420	5
ABI910_6POST	1927958	1927967		YPO_RS09420	9
ABI910_6POST	1929042	1929053		YPO_RS09430	11
ABI910_6POST	1929357	1929418		YPO_RS09430	61
ABI910_6POST	1929634	1929637		YPO_RS09430	3
ABI910_6POST	1929830	1929839		YPO_RS09435	9
ABI910_6POST	1929999	1930032		YPO_RS09435	33
ABI910_6POST	1930071	1930072		YPO_RS09435	1
ABI910_6POST	1930121	1930135		YPO_RS09435	14
ABI910_6POST	1930414	1930429		YPO_RS09435	15
ABI910_6POST	1930471	1930501		YPO_RS09435	30
ABI910_6POST	1930556	1930579		YPO_RS09435	23
ABI910_6POST	1931235	1931238		YPO_RS09440	3
ABI910_6POST	1931667	1931674		YPO_RS09445	7
ABI910_6POST	1932173	1932181		YPO_RS09450	8
ABI910_6POST	1932518	1932524		YPO_RS09450	6
ABI910_6POST	1932636	1932649		YPO_RS09450	13
ABI910_6POST	1932957	1932959		YPO_RS09450	2
ABI910_6POST	1933006	1933022		YPO_RS09450	16
ABI910_6POST	1933447	1933463		YPO_RS09455	16
ABI910_6POST	1933795	1933823		YPO_RS09455	28
ABI910_6POST	1933856	1933891		YPO_RS09455	35
ABI910_6POST	1934543	1934554		YPO_RS09455	11
ABI910_6POST	1934778	1934796		YPO_RS09455	18
ABI910_6POST	1935116	1935120		YPO_RS09455	4
ABI910_6POST	1935930	1935933		YPO_RS09460	3
ABI910_6POST	1936215	1936222		YPO_RS09460	7
ABI910_6POST	1936422	1936428		YPO_RS09460	6
ABI910_6POST	1936482	1936505		YPO_RS09460	23
ABI910_6POST	1936614	1936627		YPO_RS09460	13
ABI910_6POST	1936706	1936759		YPO_RS09465	53
ABI910_6POST	1936830	1936842		YPO_RS09465	12
ABI910_6POST	1936924	1936934		YPO_RS09465	10
ABI910_6POST	1937119	1937124		YPO_RS09465	5
ABI910_6POST	1937189	1937197		YPO_RS09465	8
ABI910_6POST	1937301	1937327		YPO_RS09470	26
ABI910_6POST	1937384	1937414		YPO_RS09470	30
ABI910_6POST	1937842	1937843		YPO_RS09475	1
ABI910_6POST	1938191	1938199		YPO_RS09475	8
ABI910_6POST	1939317	1939341		YPO_RS09480	24
ABI910_6POST	1939691	1939694		YPO_RS09480	3
ABI910_6POST	1939994	1940000		YPO_RS09480	6
ABI910_6POST	1940368	1940371		YPO_RS09480	3
ABI910_6POST	1940418	1940421		YPO_RS09480	3
ABI910_6POST	1940589	1940664		YPO_RS09480	75
ABI910_6POST	1940898	1940902		YPO_RS09480	4
ABI910_6POST	1941413	1941422		YPO_RS09480	9
ABI910_6POST	1941869	1941873		yebS	4
ABI910_6POST	1942154	1942181		yebS	27
ABI910_6POST	1942456	1942464		yebS	8
ABI910_6POST	1942497	1942503		yebS	6
ABI910_6POST	1943190	1943195		YPO_RS09490	5
ABI910_6POST	1943758	1943781		proQ	23
ABI910_6POST	1944382	1944386		prc	4
ABI910_6POST	1945205	1945208		prc	3
ABI910_6POST	1945425	1945437		prc	12
ABI910_6POST	1945576	1945634		prc	58
ABI910_6POST	1946209	1946234		prc	25
ABI910_6POST	1947006	1947013		htpX	7
ABI910_6POST	1947093	1947104		htpX	11
ABI910_6POST	1947166	1947194		htpX	28
ABI910_6POST	1947265	1947273		htpX	8
ABI910_6POST	1947409	1947428		htpX	19
ABI910_6POST	1948495	1948520		YPO_RS09510	25
ABI910_6POST	1949211	1949218		YPO_RS09515	7
ABI910_6POST	1949538	1949542		YPO_RS09515	4
ABI910_6POST	1950095	1950100		YPO_RS09520	5
ABI910_6POST	1950215	1950221		YPO_RS09520	6
ABI910_6POST	1950864	1950898		YPO_RS09520	34
ABI910_6POST	1951054	1951060		YPO_RS09520	6
ABI910_6POST	1951265	1951281		YPO_RS09520	16
ABI910_6POST	1951712	1951714		YPO_RS09520	2
ABI910_6POST	1951919	1951924		YPO_RS09520	5
ABI910_6POST	1951961	1951983		YPO_RS09520	22
ABI910_6POST	1952605	1952631		YPO_RS09525	26
ABI910_6POST	1952696	1952703		YPO_RS09525	7
ABI910_6POST	1952773	1952788		YPO_RS09525	15
ABI910_6POST	1952830	1952831		YPO_RS09525	1
ABI910_6POST	1953038	1953057		YPO_RS09525	19
ABI910_6POST	1953205	1953217		YPO_RS09525	12
ABI910_6POST	1953494	1953507		YPO_RS09525	13
ABI910_6POST	1953848	1953858		YPO_RS09530	10
ABI910_6POST	1954037	1954041		YPO_RS09530	4
ABI910_6POST	1954228	1954236		YPO_RS09530	8
ABI910_6POST	1954351	1954361		YPO_RS09530	10
ABI910_6POST	1954394	1954399		YPO_RS09530	5
ABI910_6POST	1954603	1954607		YPO_RS09535	4
ABI910_6POST	1954902	1954907		YPO_RS09535	5
ABI910_6POST	1954965	1954992		YPO_RS09535	27
ABI910_6POST	1957015	1957026		YPO_RS09540	11
ABI910_6POST	1957174	1957189		YPO_RS09540	15
ABI910_6POST	1958160	1958162		kdgR	2
ABI910_6POST	1958800	1958803		YPO_RS09550	3
ABI910_6POST	1958973	1958994		YPO_RS09550	21
ABI910_6POST	1960026	1960051		YPO_RS09555	25
ABI910_6POST	1960123	1960155		YPO_RS09555	32
ABI910_6POST	1960518	1960521		YPO_RS09555	3
ABI910_6POST	1960608	1960616		YPO_RS09555	8
ABI910_6POST	1960805	1960810		YPO_RS09555	5
ABI910_6POST	1961573	1961576		YPO_RS09560	3
ABI910_6POST	1962950	1962992		YPO_RS09565	42
ABI910_6POST	1963043	1963058		YPO_RS09565	15
ABI910_6POST	1963717	1963732		YPO_RS09570	15
ABI910_6POST	1963931	1963933		YPO_RS09570	2
ABI910_6POST	1964061	1964082		YPO_RS09570	21
ABI910_6POST	1964538	1964542		YPO_RS09570	4
ABI910_6POST	1964634	1964667		YPO_RS09570	33
ABI910_6POST	1964731	1964741		YPO_RS09570	10
ABI910_6POST	1965115	1965122		YPO_RS09575	7
ABI910_6POST	1965306	1965307		YPO_RS09575	1
ABI910_6POST	1965483	1965486		YPO_RS09575	3
ABI910_6POST	1966334	1966336		YPO_RS09580	2
ABI910_6POST	1966405	1966408		YPO_RS09580	3
ABI910_6POST	1966067	1966093		YPO_RS09580	26
ABI910_6POST	1966999	1967044		YPO_RS09585	45
ABI910_6POST	1967385	1967398		YPO_RS09585	13
ABI910_6POST	1968022	1968082		YPO_RS09590	60
ABI910_6POST	1968406	1968431		YPO_RS09590	25
ABI910_6POST	1968819	1968828		YPO_RS09590	9
ABI910_6POST	1968969	1968979		YPO_RS09590	10
ABI910_6POST	1970926	1970955		kduI	29
ABI910_6POST	1970991	1970997		kduI	6
ABI910_6POST	1971186	1971195		kduI	9
ABI910_6POST	1972203	1972209		YPO_RS09610	6
ABI910_6POST	1972375	1972380		YPO_RS09610	5
ABI910_6POST	1972476	1972483		YPO_RS09610	7
ABI910_6POST	1972561	1972565		YPO_RS09610	4
ABI910_6POST	1972661	1972671		YPO_RS09610	10
ABI910_6POST	1972728	1972749		YPO_RS09610	21
ABI910_6POST	1972795	1972798		YPO_RS09610	3
ABI910_6POST	1972877	1972907		YPO_RS09610	30
ABI910_6POST	1972961	1973010		YPO_RS09610	49
ABI910_6POST	1974912	1974941		YPO_RS09620	29
ABI910_6POST	1975019	1975024		YPO_RS09620	5
ABI910_6POST	1975150	1975168		YPO_RS09620	18
ABI910_6POST	1975248	1975277		YPO_RS09620	29
ABI910_6POST	1975362	1975385		YPO_RS09620	23
ABI910_6POST	1975471	1975488		YPO_RS09620	17
ABI910_6POST	1975686	1975692		YPO_RS09620	6
ABI910_6POST	1975747	1975771		YPO_RS09620	24
ABI910_6POST	1975974	1976001		YPO_RS09625	27
ABI910_6POST	1976100	1976177		YPO_RS09625	77
ABI910_6POST	1976284	1976286		YPO_RS09625	2
ABI910_6POST	1976382	1976458		YPO_RS09625	76
ABI910_6POST	1976708	1976811		YPO_RS09630	103
ABI910_6POST	1977372	1977381		mtfA	9
ABI910_6POST	1977546	1977570		mtfA	24
ABI910_6POST	1978690	1978696		YPO_RS09645	6
ABI910_6POST	1979915	1979937		YPO_RS09655	22
ABI910_6POST	1980061	1980062		YPO_RS09655	1
ABI910_6POST	1980443	1980481		YPO_RS09655	38
ABI910_6POST	1981050	1981069		YPO_RS09655	19
ABI910_6POST	1981157	1981162		YPO_RS09655	5
ABI910_6POST	1982704	1982712		YPO_RS09665	8
ABI910_6POST	1983841	1983872		YPO_RS09675	31
ABI910_6POST	1985261	1985272		YPO_RS09690	11
ABI910_6POST	1985803	1985814		YPO_RS09695	11
ABI910_6POST	1986614	1986640		YPO_RS09700	26
ABI910_6POST	1987257	1987263		YPO_RS09700	6
ABI910_6POST	1987337	1987377		YPO_RS09700	40
ABI910_6POST	1988026	1988038		YPO_RS09705	12
ABI910_6POST	1988091	1988112		YPO_RS09705	21
ABI910_6POST	1988219	1988227		YPO_RS09705	8
ABI910_6POST	1989422	1989425		YPO_RS09710	3
ABI910_6POST	1989821	1989840		pgeF	19
ABI910_6POST	1989950	1989969		pgeF	19
ABI910_6POST	1990228	1990233		pgeF	5
ABI910_6POST	1990339	1990352		pgeF	13
ABI910_6POST	1990939	1990956		rlmA	17
ABI910_6POST	1990987	1991017		rlmA	30
ABI910_6POST	1991047	1991056		rlmA	9
ABI910_6POST	1991320	1991332		rlmA	12
ABI910_6POST	1992818	1992828		YPO_RS09735	10
ABI910_6POST	1992906	1992909		YPO_RS09735	3
ABI910_6POST	1992956	1992973		YPO_RS09735	17
ABI910_6POST	1993025	1993039		YPO_RS09735	14
ABI910_6POST	1993138	1993170		YPO_RS09735	32
ABI910_6POST	1993230	1993264		YPO_RS09735	34
ABI910_6POST	1993350	1993418		YPO_RS09735	68
ABI910_6POST	1993527	1993541		YPO_RS09735	14
ABI910_6POST	1993611	1993620		YPO_RS09735	9
ABI910_6POST	1993662	1993668		YPO_RS09735	6
ABI910_6POST	1993668	1993670		YPO_RS09740	2
ABI910_6POST	1993734	1993754		YPO_RS09740	20
ABI910_6POST	1993862	1993873		YPO_RS09740	11
ABI910_6POST	1993988	1994017		YPO_RS09740	29
ABI910_6POST	1994073	1994170		YPO_RS09740	97
ABI910_6POST	1994252	1994299		YPO_RS09740	47
ABI910_6POST	1994345	1994365		YPO_RS09740	20
ABI910_6POST	1994498	1994509		YPO_RS09745	11
ABI910_6POST	1994570	1994574		YPO_RS09745	4
ABI910_6POST	1994925	1994929		YPO_RS09745	4
ABI910_6POST	1995086	1995092		YPO_RS09745	6
ABI910_6POST	1995561	1995573		YPO_RS09745	12
ABI910_6POST	1995673	1995683		YPO_RS09745	10
ABI910_6POST	1996069	1996074		YPO_RS09745	5
ABI910_6POST	1996440	1996449		YPO_RS09745	9
ABI910_6POST	1996941	1996949		YPO_RS09750	8
ABI910_6POST	1997104	1997106		YPO_RS09750	2
ABI910_6POST	1997136	1997148		YPO_RS09750	12
ABI910_6POST	1997720	1997738		YPO_RS09750	18
ABI910_6POST	1997801	1997826		YPO_RS09750	25
ABI910_6POST	1998089	1998092		YPO_RS09750	3
ABI910_6POST	1998359	1998395		YPO_RS09750	36
ABI910_6POST	1998466	1998467		YPO_RS09750	1
ABI910_6POST	1998772	1998779		YPO_RS09750	7
ABI910_6POST	1999419	1999443		mntP	24
ABI910_6POST	1999859	1999875		mntP	16
ABI910_6POST	2000576	2000588		YPO_RS09760	12
ABI910_6POST	2001215	2001221		YPO_RS09765	6
ABI910_6POST	2001361	2001362		YPO_RS09765	1
ABI910_6POST	2001418	2001422		YPO_RS09765	4
ABI910_6POST	2001514	2001521		YPO_RS09765	7
ABI910_6POST	2001945	2001952		YPO_RS09770	7
ABI910_6POST	2002147	2002164		YPO_RS09770	17
ABI910_6POST	2002341	2002351		YPO_RS09770	10
ABI910_6POST	2002567	2002571		YPO_RS09770	4
ABI910_6POST	2002631	2002644		YPO_RS09770	13
ABI910_6POST	2002684	2002686		YPO_RS09770	2
ABI910_6POST	2002958	2002995		manX	37
ABI910_6POST	2003555	2003559		manX	4
ABI910_6POST	2004532	2004538		YPO_RS09780	6
ABI910_6POST	2004585	2004589		YPO_RS09780	4
ABI910_6POST	2004644	2004665		YPO_RS09780	21
ABI910_6POST	2005404	2005429		YPO_RS09780	25
ABI910_6POST	2005515	2005526		YPO_RS09780	11
ABI910_6POST	2005570	2005577		YPO_RS09780	7
ABI910_6POST	2005687	2005691		YPO_RS09780	4
ABI910_6POST	2007949	2007958		YPO_RS09795	9
ABI910_6POST	2008182	2008237		YPO_RS09795	55
ABI910_6POST	2008657	2008660		YPO_RS09800	3
ABI910_6POST	2008776	2008788		YPO_RS09800	12
ABI910_6POST	2008820	2008858		YPO_RS09800	38
ABI910_6POST	2009272	2009277		YPO_RS09800	5
ABI910_6POST	2009309	2009323		YPO_RS09800	14
ABI910_6POST	2009785	2009791		hpaD	6
ABI910_6POST	2010056	2010062		hpaD	6
ABI910_6POST	2010525	2010534		hpaD	9
ABI910_6POST	2011211	2011216		hpaH	5
ABI910_6POST	2011566	2011568		hpaH	2
ABI910_6POST	2011619	2011631		hpaH	12
ABI910_6POST	2011713	2011715		hpaH	2
ABI910_6POST	2011826	2011844		hpaH	18
ABI910_6POST	2012207	2012210		hpaI	3
ABI910_6POST	2012353	2012361		hpaI	8
ABI910_6POST	2012758	2012772		hpaX	14
ABI910_6POST	2012844	2012850		hpaX	6
ABI910_6POST	2012977	2012978		hpaX	1
ABI910_6POST	2013013	2013023		hpaX	10
ABI910_6POST	2013319	2013333		hpaX	14
ABI910_6POST	2013486	2013498		hpaX	12
ABI910_6POST	2013724	2013725		hpaX	1
ABI910_6POST	2013881	2013887		hpaX	6
ABI910_6POST	2014049	2014056		hpaX	7
ABI910_6POST	2014289	2014310		hpaB	21
ABI910_6POST	2014410	2014418		hpaB	8
ABI910_6POST	2014613	2014615		hpaB	2
ABI910_6POST	2014771	2014785		hpaB	14
ABI910_6POST	2015283	2015290		hpaB	7
ABI910_6POST	2015400	2015426		hpaB	26
ABI910_6POST	2015844	2015864		hpaC	20
ABI910_6POST	2016077	2016094		hpaC	17
ABI910_6POST	2016692	2016718		YPO_RS09840	26
ABI910_6POST	2016991	2016993		YPO_RS09840	2
ABI910_6POST	2017077	2017107		YPO_RS09840	30
ABI910_6POST	2017632	2017652		YPO_RS09840	20
ABI910_6POST	2018913	2018915		YPO_RS09845	2
ABI910_6POST	2018952	2018956		YPO_RS09845	4
ABI910_6POST	2019143	2019146		YPO_RS09845	3
ABI910_6POST	2019405	2019419		pabB	14
ABI910_6POST	2019701	2019712		pabB	11
ABI910_6POST	2020216	2020225		pabB	9
ABI910_6POST	2020407	2020412		pabB	5
ABI910_6POST	2020483	2020487		pabB	4
ABI910_6POST	2021292	2021306		purT	14
ABI910_6POST	2022708	2022711		dbpA	3
ABI910_6POST	2023278	2023294		dbpA	16
ABI910_6POST	2023442	2023484		dbpA	42
ABI910_6POST	2024468	2024486		YPO_RS09875	18
ABI910_6POST	2024677	2024681		YPO_RS09875	4
ABI910_6POST	2025113	2025114		YPO_RS09880	1
ABI910_6POST	2025562	2025586		YPO_RS09885	24
ABI910_6POST	2025848	2025864		YPO_RS09885	16
ABI910_6POST	2026163	2026182		YPO_RS09885	19
ABI910_6POST	2026365	2026395		YPO_RS09885	30
ABI910_6POST	2026576	2026577		YPO_RS09885	1
ABI910_6POST	2026939	2026946		YPO_RS09885	7
ABI910_6POST	2027152	2027169		YPO_RS09885	17
ABI910_6POST	2027323	2027369		YPO_RS09885	46
ABI910_6POST	2028345	2028360		pip	15
ABI910_6POST	2029049	2029051		pip	2
ABI910_6POST	2030232	2030233		ftnA	1
ABI910_6POST	2030974	2030985		yobA	11
ABI910_6POST	2031500	2031504		copD	4
ABI910_6POST	2031866	2031870		copD	4
ABI910_6POST	2032356	2032359		YPO_RS09915	3
ABI910_6POST	2033318	2033323		YPO_RS09920	5
ABI910_6POST	2033437	2033457		YPO_RS09925	20
ABI910_6POST	2033522	2033523		YPO_RS09925	1
ABI910_6POST	2033586	2033603		YPO_RS09925	17
ABI910_6POST	2034678	2034689		flhB	11
ABI910_6POST	2034733	2034741		flhB	8
ABI910_6POST	2034873	2034889		flhB	16
ABI910_6POST	2035009	2035014		flhB	5
ABI910_6POST	2035422	2035429		flhB	7
ABI910_6POST	2035609	2035615		flhA	6
ABI910_6POST	2035965	2035969		flhA	4
ABI910_6POST	2036012	2036033		flhA	21
ABI910_6POST	2036227	2036254		flhA	27
ABI910_6POST	2036812	2036835		flhA	23
ABI910_6POST	2036868	2036890		flhA	22
ABI910_6POST	2037043	2037059		flhA	16
ABI910_6POST	2037387	2037426		flhA	39
ABI910_6POST	2037593	2037596		flhA	3
ABI910_6POST	2042554	2042584		YPO_RS09960	30
ABI910_6POST	2042650	2042683		YPO_RS09960	33
ABI910_6POST	2042850	2042864		YPO_RS09960	14
ABI910_6POST	2043476	2043505		flgA	29
ABI910_6POST	2043721	2043736		flgA	15
ABI910_6POST	2044674	2044681		flgB	7
ABI910_6POST	2044772	2044779		flgB	7
ABI910_6POST	2045227	2045228		flgD	1
ABI910_6POST	2045526	2045533		flgD	7
ABI910_6POST	2046992	2046994		YPO_RS09990	2
ABI910_6POST	2047361	2047367		YPO_RS09990	6
ABI910_6POST	2048015	2048025		flgG	10
ABI910_6POST	2048249	2048254		flgG	5
ABI910_6POST	2048289	2048290		flgG	1
ABI910_6POST	2048695	2048699		flgG	4
ABI910_6POST	2048962	2048973		flgH	11
ABI910_6POST	2049594	2049596		YPO_RS10010	2
ABI910_6POST	2049666	2049676		YPO_RS10010	10
ABI910_6POST	2049799	2049808		YPO_RS10010	9
ABI910_6POST	2049948	2049955		YPO_RS10010	7
ABI910_6POST	2050251	2050255		YPO_RS10010	4
ABI910_6POST	2050501	2050532		YPO_RS10010	31
ABI910_6POST	2051133	2051143		flgJ	10
ABI910_6POST	2051576	2051597		flgJ	21
ABI910_6POST	2052656	2052696		flgK	40
ABI910_6POST	2053235	2053242		flgK	7
ABI910_6POST	2053334	2053342		flgK	8
ABI910_6POST	2053487	2053492		flgK	5
ABI910_6POST	2053811	2053821		flgK	10
ABI910_6POST	2053946	2053968		flgK	22
ABI910_6POST	2054423	2054429		flgL	6
ABI910_6POST	2054919	2054943		flgL	24
ABI910_6POST	2055191	2055220		flgL	29
ABI910_6POST	2055501	2055517		YPO_RS10030	16
ABI910_6POST	2056582	2056597		YPO_RS10035	15
ABI910_6POST	2057112	2057146		YPO_RS10035	34
ABI910_6POST	2057841	2057914		YPO_RS10035	73
ABI910_6POST	2057986	2057987		YPO_RS10035	1
ABI910_6POST	2058280	2058299		YPO_RS10035	19
ABI910_6POST	2058841	2058856		YPO_RS10040	15
ABI910_6POST	2058956	2058971		YPO_RS10040	15
ABI910_6POST	2059028	2059049		YPO_RS10040	21
ABI910_6POST	2059125	2059140		YPO_RS10040	15
ABI910_6POST	2059518	2059526		YPO_RS10040	8
ABI910_6POST	2059579	2059582		YPO_RS10040	3
ABI910_6POST	2059886	2059894		YPO_RS10045	8
ABI910_6POST	2060007	2060027		YPO_RS10045	20
ABI910_6POST	2060119	2060126		YPO_RS10045	7
ABI910_6POST	2060328	2060331		YPO_RS10045	3
ABI910_6POST	2060718	2060740		YPO_RS10045	22
ABI910_6POST	2061324	2061340		YPO_RS10050	16
ABI910_6POST	2061416	2061428		YPO_RS10050	12
ABI910_6POST	2061722	2061744		YPO_RS10050	22
ABI910_6POST	2061839	2061843		YPO_RS10050	4
ABI910_6POST	2062229	2062241		YPO_RS10050	12
ABI910_6POST	2062477	2062481		YPO_RS10050	4
ABI910_6POST	2062927	2062946		YPO_RS10055	19
ABI910_6POST	2063020	2063025		YPO_RS10055	5
ABI910_6POST	2063186	2063199		YPO_RS10055	13
ABI910_6POST	2063336	2063389		YPO_RS10055	53
ABI910_6POST	2063790	2063795		YPO_RS10060	5
ABI910_6POST	2063953	2063971		YPO_RS10060	18
ABI910_6POST	2064466	2064482		YPO_RS10060	16
ABI910_6POST	2064974	2064981		YPO_RS10065	7
ABI910_6POST	2065399	2065410		YPO_RS10070	11
ABI910_6POST	2065700	2065727		fliR	27
ABI910_6POST	2065824	2065838		fliR	14
ABI910_6POST	2066331	2066332		fliR	1
ABI910_6POST	2066389	2066407		fliR	18
ABI910_6POST	2066410	2066412		fliQ	2
ABI910_6POST	2067180	2067192		fliP	12
ABI910_6POST	2067514	2067518		fliP	4
ABI910_6POST	2067698	2067715		fliO	17
ABI910_6POST	2067956	2067967		fliO	11
ABI910_6POST	2068025	2068062		fliO	37
ABI910_6POST	2068180	2068206		fliN	26
ABI910_6POST	2068663	2068669		fliM	6
ABI910_6POST	2068959	2068985		fliM	26
ABI910_6POST	2069351	2069360		fliM	9
ABI910_6POST	2069519	2069522		fliM	3
ABI910_6POST	2069928	2069967		fliL	39
ABI910_6POST	2070364	2070379		YPO_RS10110	15
ABI910_6POST	2070568	2070574		YPO_RS10110	6
ABI910_6POST	2070961	2070973		YPO_RS10110	12
ABI910_6POST	2071357	2071364		YPO_RS10110	7
ABI910_6POST	2071997	2072005		fliJ	8
ABI910_6POST	2072281	2072285		fliI	4
ABI910_6POST	2072317	2072327		fliI	10
ABI910_6POST	2072625	2072628		fliI	3
ABI910_6POST	2073306	2073322		fliI	16
ABI910_6POST	2074027	2074039		fliH	12
ABI910_6POST	2074303	2074321		fliH	18
ABI910_6POST	2074320	2074321		fliG	1
ABI910_6POST	2074813	2074821		fliG	8
ABI910_6POST	2075215	2075230		fliG	15
ABI910_6POST	2075576	2075593		fliF	17
ABI910_6POST	2075849	2075860		fliF	11
ABI910_6POST	2076015	2076021		fliF	6
ABI910_6POST	2076069	2076077		fliF	8
ABI910_6POST	2077403	2077414		fliE	11
ABI910_6POST	2077855	2077864		YPO_RS10145	9
ABI910_6POST	2078143	2078154		YPO_RS10150	11
ABI910_6POST	2078979	2078997		YPO_RS10160	18
ABI910_6POST	2079320	2079339		YPO_RS10160	19
ABI910_6POST	2079451	2079455		YPO_RS10160	4
ABI910_6POST	2079523	2079536		YPO_RS10160	13
ABI910_6POST	2080102	2080116		YPO_RS10165	14
ABI910_6POST	2080753	2080754		YPO_RS10170	1
ABI910_6POST	2080818	2080840		YPO_RS10170	22
ABI910_6POST	2081671	2081689		YPO_RS10170	18
ABI910_6POST	2082300	2082309		YPO_RS10170	9
ABI910_6POST	2082340	2082346		YPO_RS10170	6
ABI910_6POST	2082451	2082462		YPO_RS10170	11
ABI910_6POST	2082566	2082569		YPO_RS10170	3
ABI910_6POST	2083443	2083452		YPO_RS10175	9
ABI910_6POST	2084260	2084269		fliT	9
ABI910_6POST	2085131	2085133		fliD	2
ABI910_6POST	2085633	2085639		fliD	6
ABI910_6POST	2085672	2085673		fliD	1
ABI910_6POST	2085729	2085731		fliD	2
ABI910_6POST	2086077	2086103		fliD	26
ABI910_6POST	2086327	2086343		fliD	16
ABI910_6POST	2087041	2087044		YPO_RS10195	3
ABI910_6POST	2087343	2087367		YPO_RS10195	24
ABI910_6POST	2090149	2090172		YPO_RS10210	23
ABI910_6POST	2090319	2090322		YPO_RS10210	3
ABI910_6POST	2090543	2090546		YPO_RS10210	3
ABI910_6POST	2090641	2090676		YPO_RS10210	35
ABI910_6POST	2091226	2091249		tcyJ	23
ABI910_6POST	2091503	2091513		tcyJ	10
ABI910_6POST	2091798	2091812		tcyL	14
ABI910_6POST	2091870	2091881		tcyL	11
ABI910_6POST	2092499	2092505		yecC	6
ABI910_6POST	2093139	2093147		yecC	8
ABI910_6POST	2094049	2094057		YPO_RS10235	8
ABI910_6POST	2095073	2095075		putA	2
ABI910_6POST	2095122	2095124		putA	2
ABI910_6POST	2095557	2095570		putA	13
ABI910_6POST	2095664	2095675		putA	11
ABI910_6POST	2095920	2095930		putA	10
ABI910_6POST	2095964	2095979		putA	15
ABI910_6POST	2096537	2096542		putA	5
ABI910_6POST	2096635	2096637		putA	2
ABI910_6POST	2096693	2096704		putA	11
ABI910_6POST	2096893	2096897		putA	4
ABI910_6POST	2097468	2097479		putA	11
ABI910_6POST	2097532	2097549		putA	17
ABI910_6POST	2097767	2097769		putA	2
ABI910_6POST	2097907	2097918		putA	11
ABI910_6POST	2097992	2098010		putA	18
ABI910_6POST	2098099	2098100		putA	1
ABI910_6POST	2099002	2099015		YPO_RS10245	13
ABI910_6POST	2099417	2099422		putP	5
ABI910_6POST	2099530	2099531		putP	1
ABI910_6POST	2099599	2099615		putP	16
ABI910_6POST	2099826	2099839		putP	13
ABI910_6POST	2099909	2099935		putP	26
ABI910_6POST	2100045	2100046		putP	1
ABI910_6POST	2101142	2101161		YPO_RS10255	19
ABI910_6POST	2101471	2101488		YPO_RS10255	17
ABI910_6POST	2102114	2102126		YPO_RS10260	12
ABI910_6POST	2102681	2102693		YPO_RS10260	12
ABI910_6POST	2102946	2102952		YPO_RS10260	6
ABI910_6POST	2103129	2103157		efeB	28
ABI910_6POST	2103304	2103316		efeB	12
ABI910_6POST	2103606	2103614		efeB	8
ABI910_6POST	2103666	2103680		efeB	14
ABI910_6POST	2103882	2103883		efeB	1
ABI910_6POST	2104270	2104308		efeB	38
ABI910_6POST	2104552	2104561		wrbA	9
ABI910_6POST	2106217	2106226		YPO_RS10275	9
ABI910_6POST	2106256	2106259		YPO_RS10275	3
ABI910_6POST	2106389	2106418		YPO_RS10275	29
ABI910_6POST	2106494	2106503		YPO_RS10275	9
ABI910_6POST	2106553	2106559		YPO_RS10275	6
ABI910_6POST	2106829	2106860		cycA	31
ABI910_6POST	2106967	2106983		cycA	16
ABI910_6POST	2107442	2107443		cycA	1
ABI910_6POST	2107599	2107614		cycA	15
ABI910_6POST	2107780	2107804		cycA	24
ABI910_6POST	2109303	2109312		YPO_RS10290	9
ABI910_6POST	2109782	2109784		YPO_RS10290	2
ABI910_6POST	2110471	2110474		YPO_RS10300	3
ABI910_6POST	2112078	2112092		uvrY	14
ABI910_6POST	2112505	2112507		uvrC	2
ABI910_6POST	2112986	2112991		uvrC	5
ABI910_6POST	2113721	2113729		uvrC	8
ABI910_6POST	2113938	2113954		uvrC	16
ABI910_6POST	2114132	2114133		uvrC	1
ABI910_6POST	2115581	2115600		YPO_RS10340	19
ABI910_6POST	2117389	2117412		YPO_RS10350	23
ABI910_6POST	2117685	2117700		YPO_RS10355	15
ABI910_6POST	2118114	2118116		hcp	2
ABI910_6POST	2118664	2118755		YPO_RS10365	91
ABI910_6POST	2119022	2119026		YPO_RS10365	4
ABI910_6POST	2119122	2119124		YPO_RS10365	2
ABI910_6POST	2119416	2119420		YPO_RS10365	4
ABI910_6POST	2119915	2119930		YPO_RS10365	15
ABI910_6POST	2119989	2120008		YPO_RS10365	19
ABI910_6POST	2121837	2121842		YPO_RS10380	5
ABI910_6POST	2122249	2122265		YPO_RS10390	16
ABI910_6POST	2122301	2122303		YPO_RS10390	2
ABI910_6POST	2123750	2123766		YPO_RS10405	16
ABI910_6POST	2126299	2126310		YPO_RS10415	11
ABI910_6POST	2126926	2126943		YPO_RS10420	17
ABI910_6POST	2128048	2128062		YPO_RS10430	14
ABI910_6POST	2128606	2128621		YPO_RS10430	15
ABI910_6POST	2128684	2128691		YPO_RS10430	7
ABI910_6POST	2128761	2128762		YPO_RS10430	1
ABI910_6POST	2130339	2130363		YPO_RS10435	24
ABI910_6POST	2131028	2131029		YPO_RS10440	1
ABI910_6POST	2132233	2132237		YPO_RS10445	4
ABI910_6POST	2132710	2132725		YPO_RS10450	15
ABI910_6POST	2132838	2132846		YPO_RS10450	8
ABI910_6POST	2133034	2133047		YPO_RS10450	13
ABI910_6POST	2133367	2133370		YPO_RS10450	3
ABI910_6POST	2134080	2134081		YPO_RS10455	1
ABI910_6POST	2134129	2134135		YPO_RS10455	6
ABI910_6POST	2134333	2134341		YPO_RS10455	8
ABI910_6POST	2135808	2135812		YPO_RS10475	4
ABI910_6POST	2136019	2136048		YPO_RS10475	29
ABI910_6POST	2136078	2136105		YPO_RS10475	27
ABI910_6POST	2136210	2136287		YPO_RS10475	77
ABI910_6POST	2136438	2136439		YPO_RS10475	1
ABI910_6POST	2136510	2136516		YPO_RS10475	6
ABI910_6POST	2136553	2136561		YPO_RS10475	8
ABI910_6POST	2136860	2136870		YPO_RS10480	10
ABI910_6POST	2136974	2136975		YPO_RS10480	1
ABI910_6POST	2137051	2137078		YPO_RS10480	27
ABI910_6POST	2137163	2137177		YPO_RS10480	14
ABI910_6POST	2139040	2139041		YPO_RS10505	1
ABI910_6POST	2139183	2139186		YPO_RS10505	3
ABI910_6POST	2140906	2140923		fyuA	17
ABI910_6POST	2141354	2141361		fyuA	7
ABI910_6POST	2141401	2141402		fyuA	1
ABI910_6POST	2141538	2141554		fyuA	16
ABI910_6POST	2141841	2141845		fyuA	4
ABI910_6POST	2141975	2142036		fyuA	61
ABI910_6POST	2142095	2142104		fyuA	9
ABI910_6POST	2142277	2142301		fyuA	24
ABI910_6POST	2142520	2142529		fyuA	9
ABI910_6POST	2142807	2142816		fyuA	9
ABI910_6POST	2143135	2143168		ybtE	33
ABI910_6POST	2143215	2143224		ybtE	9
ABI910_6POST	2143397	2143399		ybtE	2
ABI910_6POST	2143642	2143644		ybtE	2
ABI910_6POST	2143964	2143974		ybtE	10
ABI910_6POST	2144377	2144394		ybtE	17
ABI910_6POST	2144487	2144511		ybtE	24
ABI910_6POST	2144718	2144734		ybtT	16
ABI910_6POST	2145079	2145087		ybtT	8
ABI910_6POST	2145179	2145182		ybtT	3
ABI910_6POST	2145621	2145651		ybtU	30
ABI910_6POST	2146366	2146386		ybtU	20
ABI910_6POST	2146547	2146556		irp1	9
ABI910_6POST	2146674	2146675		irp1	1
ABI910_6POST	2146852	2146868		irp1	16
ABI910_6POST	2146950	2146962		irp1	12
ABI910_6POST	2147031	2147041		irp1	10
ABI910_6POST	2147235	2147237		irp1	2
ABI910_6POST	2147336	2147345		irp1	9
ABI910_6POST	2147420	2147440		irp1	20
ABI910_6POST	2147766	2147774		irp1	8
ABI910_6POST	2148157	2148160		irp1	3
ABI910_6POST	2148620	2148636		irp1	16
ABI910_6POST	2148801	2148814		irp1	13
ABI910_6POST	2148958	2148959		irp1	1
ABI910_6POST	2149169	2149193		irp1	24
ABI910_6POST	2150184	2150188		irp1	4
ABI910_6POST	2150361	2150362		irp1	1
ABI910_6POST	2150677	2150690		irp1	13
ABI910_6POST	2151024	2151026		irp1	2
ABI910_6POST	2151368	2151374		irp1	6
ABI910_6POST	2151524	2151527		irp1	3
ABI910_6POST	2151875	2151877		irp1	2
ABI910_6POST	2151948	2151965		irp1	17
ABI910_6POST	2152131	2152147		irp1	16
ABI910_6POST	2152267	2152295		irp1	28
ABI910_6POST	2152638	2152656		irp1	18
ABI910_6POST	2153454	2153491		irp1	37
ABI910_6POST	2153574	2153584		irp1	10
ABI910_6POST	2154304	2154310		irp1	6
ABI910_6POST	2154975	2154987		irp1	12
ABI910_6POST	2155276	2155279		irp1	3
ABI910_6POST	2155342	2155350		irp1	8
ABI910_6POST	2155400	2155401		irp1	1
ABI910_6POST	2155509	2155532		irp1	23
ABI910_6POST	2155715	2155724		irp1	9
ABI910_6POST	2156133	2156151		irp2	18
ABI910_6POST	2156411	2156418		irp2	7
ABI910_6POST	2156922	2156934		irp2	12
ABI910_6POST	2156976	2156978		irp2	2
ABI910_6POST	2157243	2157260		irp2	17
ABI910_6POST	2157478	2157479		irp2	1
ABI910_6POST	2157626	2157639		irp2	13
ABI910_6POST	2157688	2157691		irp2	3
ABI910_6POST	2157909	2157926		irp2	17
ABI910_6POST	2157992	2158000		irp2	8
ABI910_6POST	2158105	2158107		irp2	2
ABI910_6POST	2158259	2158262		irp2	3
ABI910_6POST	2158365	2158398		irp2	33
ABI910_6POST	2158605	2158631		irp2	26
ABI910_6POST	2158836	2158843		irp2	7
ABI910_6POST	2159474	2159488		irp2	14
ABI910_6POST	2159731	2159742		irp2	11
ABI910_6POST	2159896	2159923		irp2	27
ABI910_6POST	2159998	2160041		irp2	43
ABI910_6POST	2160196	2160215		irp2	19
ABI910_6POST	2160649	2160653		irp2	4
ABI910_6POST	2161671	2161679		irp2	8
ABI910_6POST	2161807	2161821		irp2	14
ABI910_6POST	2161924	2161961		irp2	37
ABI910_6POST	2162603	2162611		ybtA	8
ABI910_6POST	2163597	2163605		ybtP	8
ABI910_6POST	2164189	2164190		ybtP	1
ABI910_6POST	2164257	2164264		ybtP	7
ABI910_6POST	2165463	2165479		ybtQ	16
ABI910_6POST	2165855	2165856		ybtQ	1
ABI910_6POST	2166012	2166022		ybtQ	10
ABI910_6POST	2166052	2166072		ybtQ	20
ABI910_6POST	2166440	2166443		ybtQ	3
ABI910_6POST	2166925	2166946		ybtQ	21
ABI910_6POST	2167152	2167170		ybtX	18
ABI910_6POST	2167643	2167678		ybtX	35
ABI910_6POST	2167805	2167833		ybtX	28
ABI910_6POST	2168481	2168487		ybtS	6
ABI910_6POST	2168637	2168643		ybtS	6
ABI910_6POST	2168824	2168835		ybtS	11
ABI910_6POST	2168874	2168892		ybtS	18
ABI910_6POST	2169072	2169074		ybtS	2
ABI910_6POST	2169568	2169579		ybtS	11
ABI910_6POST	2170462	2170463		YPO_RS10570	1
ABI910_6POST	2170607	2170634		YPO_RS10570	27
ABI910_6POST	2172184	2172185		YPO_RS10580	1
ABI910_6POST	2172524	2172563		YPO_RS10585	39
ABI910_6POST	2172783	2172828		YPO_RS10585	45
ABI910_6POST	2173062	2173093		YPO_RS10585	31
ABI910_6POST	2173169	2173176		YPO_RS10585	7
ABI910_6POST	2174150	2174151		YPO_RS10590	1
ABI910_6POST	2174250	2174309		YPO_RS10590	59
ABI910_6POST	2175216	2175229		YPO_RS10590	13
ABI910_6POST	2175324	2175347		YPO_RS10590	23
ABI910_6POST	2175526	2175538		YPO_RS10590	12
ABI910_6POST	2176585	2176675		YPO_RS10595	90
ABI910_6POST	2176980	2176994		YPO_RS10595	14
ABI910_6POST	2177144	2177169		YPO_RS10600	25
ABI910_6POST	2177525	2177551		YPO_RS10600	26
ABI910_6POST	2178263	2178283		YPO_RS10605	20
ABI910_6POST	2178315	2178326		YPO_RS10605	11
ABI910_6POST	2178548	2178586		YPO_RS10605	38
ABI910_6POST	2178912	2178913		YPO_RS10605	1
ABI910_6POST	2178988	2179010		YPO_RS10605	22
ABI910_6POST	2179227	2179231		YPO_RS10605	4
ABI910_6POST	2179496	2179498		YPO_RS10605	2
ABI910_6POST	2179916	2179923		YPO_RS10605	7
ABI910_6POST	2180158	2180162		YPO_RS10605	4
ABI910_6POST	2180309	2180318		YPO_RS10605	9
ABI910_6POST	2181031	2181079		YPO_RS10610	48
ABI910_6POST	2181334	2181354		YPO_RS10610	20
ABI910_6POST	2181588	2181597		YPO_RS10610	9
ABI910_6POST	2182609	2182632		YPO_RS10615	23
ABI910_6POST	2183574	2183590		YPO_RS10620	16
ABI910_6POST	2183730	2183758		YPO_RS10620	28
ABI910_6POST	2183821	2183871		YPO_RS10620	50
ABI910_6POST	2184126	2184146		YPO_RS10620	20
ABI910_6POST	2184273	2184276		YPO_RS10620	3
ABI910_6POST	2184547	2184551		YPO_RS10620	4
ABI910_6POST	2184647	2184661		YPO_RS10620	14
ABI910_6POST	2184745	2184748		YPO_RS10620	3
ABI910_6POST	2184944	2184951		YPO_RS10625	7
ABI910_6POST	2185078	2185085		YPO_RS10625	7
ABI910_6POST	2185186	2185204		YPO_RS10625	18
ABI910_6POST	2185425	2185434		YPO_RS10630	9
ABI910_6POST	2185543	2185553		YPO_RS10630	10
ABI910_6POST	2186170	2186187		YPO_RS10630	17
ABI910_6POST	2186239	2186243		YPO_RS10630	4
ABI910_6POST	2186825	2186842		YPO_RS10635	17
ABI910_6POST	2187185	2187187		YPO_RS10635	2
ABI910_6POST	2187663	2187669		YPO_RS10640	6
ABI910_6POST	2189005	2189019		YPO_RS10650	14
ABI910_6POST	2189080	2189082		YPO_RS10650	2
ABI910_6POST	2189240	2189275		YPO_RS10650	35
ABI910_6POST	2189447	2189460		YPO_RS10650	13
ABI910_6POST	2189649	2189667		YPO_RS10650	18
ABI910_6POST	2189884	2189902		YPO_RS10655	18
ABI910_6POST	2190358	2190373		YPO_RS10655	15
ABI910_6POST	2191426	2191451		YPO_RS10660	25
ABI910_6POST	2192552	2192578		nqrE	26
ABI910_6POST	2193557	2193558		YPO_RS10670	1
ABI910_6POST	2193662	2193665		YPO_RS10670	3
ABI910_6POST	2194612	2194614		ansP	2
ABI910_6POST	2194934	2194957		ansP	23
ABI910_6POST	2195539	2195547		ansP	8
ABI910_6POST	2195686	2195705		ansP	19
ABI910_6POST	2195788	2195805		ansP	17
ABI910_6POST	2198183	2198193		YPO_RS10685	10
ABI910_6POST	2198976	2199017		glsA	41
ABI910_6POST	2199439	2199443		glsA	4
ABI910_6POST	2200119	2200150		YPO_RS10695	31
ABI910_6POST	2200206	2200212		YPO_RS10695	6
ABI910_6POST	2200454	2200455		YPO_RS10695	1
ABI910_6POST	2200552	2200556		YPO_RS10695	4
ABI910_6POST	2200930	2200941		YPO_RS10695	11
ABI910_6POST	2201058	2201064		YPO_RS10695	6
ABI910_6POST	2202058	2202063		YPO_RS10700	5
ABI910_6POST	2203815	2203822		YPO_RS10700	7
ABI910_6POST	2204119	2204153		YPO_RS10705	34
ABI910_6POST	2204380	2204399		YPO_RS10705	19
ABI910_6POST	2204497	2204514		YPO_RS10705	17
ABI910_6POST	2205036	2205038		YPO_RS10710	2
ABI910_6POST	2205073	2205085		YPO_RS10710	12
ABI910_6POST	2205258	2205275		YPO_RS10710	17
ABI910_6POST	2205841	2205852		YPO_RS10710	11
ABI910_6POST	2206460	2206470		YPO_RS10715	10
ABI910_6POST	2207216	2207223		YPO_RS10715	7
ABI910_6POST	2207392	2207394		YPO_RS10715	2
ABI910_6POST	2207439	2207464		YPO_RS10715	25
ABI910_6POST	2207575	2207590		YPO_RS10715	15
ABI910_6POST	2207877	2207888		YPO_RS10720	11
ABI910_6POST	2207948	2207957		YPO_RS10720	9
ABI910_6POST	2208033	2208049		YPO_RS10720	16
ABI910_6POST	2208146	2208156		YPO_RS10720	10
ABI910_6POST	2208429	2208433		YPO_RS10720	4
ABI910_6POST	2208628	2208650		YPO_RS10720	22
ABI910_6POST	2209249	2209255		YPO_RS10725	6
ABI910_6POST	2209813	2209822		YPO_RS10730	9
ABI910_6POST	2210034	2210045		YPO_RS10735	11
ABI910_6POST	2210253	2210262		YPO_RS10735	9
ABI910_6POST	2210509	2210524		tehB	15
ABI910_6POST	2211026	2211036		tehB	10
ABI910_6POST	2211294	2211309		tehB	15
ABI910_6POST	2212137	2212153		YPO_RS10745	16
ABI910_6POST	2212385	2212410		YPO_RS10745	25
ABI910_6POST	2213821	2213836		pgaA	15
ABI910_6POST	2214768	2214779		pgaA	11
ABI910_6POST	2215082	2215101		pgaA	19
ABI910_6POST	2215286	2215328		pgaA	42
ABI910_6POST	2215926	2215951		pgaB	25
ABI910_6POST	2216221	2216238		pgaB	17
ABI910_6POST	2216441	2216442		pgaB	1
ABI910_6POST	2216957	2216972		pgaB	15
ABI910_6POST	2217095	2217125		pgaB	30
ABI910_6POST	2217158	2217174		pgaB	16
ABI910_6POST	2217313	2217314		pgaB	1
ABI910_6POST	2217930	2217937		YPO_RS10760	7
ABI910_6POST	2218038	2218039		YPO_RS10760	1
ABI910_6POST	2218048	2218099		YPO_RS10760	51
ABI910_6POST	2218150	2218161		YPO_RS10760	11
ABI910_6POST	2218335	2218336		YPO_RS10760	1
ABI910_6POST	2218887	2218891		YPO_RS10760	4
ABI910_6POST	2219199	2219215		YPO_RS10760	16
ABI910_6POST	2219334	2219351		pgaD	17
ABI910_6POST	2220636	2220642		YPO_RS10770	6
ABI910_6POST	2220785	2220807		YPO_RS10770	22
ABI910_6POST	2221526	2221538		YPO_RS10775	12
ABI910_6POST	2221819	2221838		phoH	19
ABI910_6POST	2222596	2222598		chaA	2
ABI910_6POST	2222724	2222739		chaA	15
ABI910_6POST	2222905	2222909		chaA	4
ABI910_6POST	2223330	2223334		chaA	4
ABI910_6POST	2223430	2223456		chaA	26
ABI910_6POST	2224417	2224433		narX	16
ABI910_6POST	2224957	2224972		narX	15
ABI910_6POST	2225574	2225580		narX	6
ABI910_6POST	2225663	2225669		narX	6
ABI910_6POST	2226119	2226126		YPO_RS10795	7
ABI910_6POST	2226460	2226463		YPO_RS10800	3
ABI910_6POST	2226518	2226527		YPO_RS10800	9
ABI910_6POST	2227592	2227604		YPO_RS10800	12
ABI910_6POST	2228472	2228479		YPO_RS10805	7
ABI910_6POST	2228637	2228650		YPO_RS10805	13
ABI910_6POST	2229150	2229156		YPO_RS10805	6
ABI910_6POST	2229281	2229282		YPO_RS10805	1
ABI910_6POST	2229805	2229838		astA	33
ABI910_6POST	2230017	2230029		astA	12
ABI910_6POST	2230367	2230375		astA	8
ABI910_6POST	2231099	2231106		astD	7
ABI910_6POST	2231428	2231439		astD	11
ABI910_6POST	2231604	2231605		astD	1
ABI910_6POST	2231684	2231706		astD	22
ABI910_6POST	2231893	2231904		astD	11
ABI910_6POST	2232066	2232095		astD	29
ABI910_6POST	2232199	2232205		astD	6
ABI910_6POST	2232594	2232606		astB	12
ABI910_6POST	2232762	2232821		astB	59
ABI910_6POST	2232942	2232949		astB	7
ABI910_6POST	2233263	2233265		astB	2
ABI910_6POST	2234543	2234557		astE	14
ABI910_6POST	2236666	2236686		YPO_RS10835	20
ABI910_6POST	2236943	2236954		YPO_RS10835	11
ABI910_6POST	2237010	2237070		YPO_RS10835	60
ABI910_6POST	2237236	2237259		YPO_RS10835	23
ABI910_6POST	2237354	2237397		YPO_RS10835	43
ABI910_6POST	2237397	2237420		YPO_RS10840	23
ABI910_6POST	2237677	2237781		YPO_RS10840	104
ABI910_6POST	2237858	2237873		YPO_RS10840	15
ABI910_6POST	2238737	2238758		hutG	21
ABI910_6POST	2238993	2239009		hutG	16
ABI910_6POST	2239255	2239279		hutG	24
ABI910_6POST	2239398	2239404		hutG	6
ABI910_6POST	2239487	2239494		hutG	7
ABI910_6POST	2239557	2239578		YPO_RS10855	21
ABI910_6POST	2239655	2239657		YPO_RS10855	2
ABI910_6POST	2239809	2239871		YPO_RS10855	62
ABI910_6POST	2240159	2240175		YPO_RS10855	16
ABI910_6POST	2240452	2240457		YPO_RS10855	5
ABI910_6POST	2242634	2242635		YPO_RS10865	1
ABI910_6POST	2242737	2242740		YPO_RS10865	3
ABI910_6POST	2243457	2243473		YPO_RS10870	16
ABI910_6POST	2243997	2244002		YPO_RS10875	5
ABI910_6POST	2244173	2244208		YPO_RS10875	35
ABI910_6POST	2244268	2244278		YPO_RS10875	10
ABI910_6POST	2244465	2244470		YPO_RS10875	5
ABI910_6POST	2244546	2244565		YPO_RS10875	19
ABI910_6POST	2245341	2245351		YPO_RS10875	10
ABI910_6POST	2247943	2247945		YPO_RS10885	2
ABI910_6POST	2248384	2248413		YPO_RS10885	29
ABI910_6POST	2248593	2248609		YPO_RS10885	16
ABI910_6POST	2248750	2248759		YPO_RS10890	9
ABI910_6POST	2248839	2248850		YPO_RS10890	11
ABI910_6POST	2249139	2249145		YPO_RS10890	6
ABI910_6POST	2249202	2249204		YPO_RS10890	2
ABI910_6POST	2249416	2249421		YPO_RS10890	5
ABI910_6POST	2249793	2249800		YPO_RS10895	7
ABI910_6POST	2250027	2250031		YPO_RS10895	4
ABI910_6POST	2250398	2250415		YPO_RS10895	17
ABI910_6POST	2251084	2251100		YPO_RS10900	16
ABI910_6POST	2251198	2251201		YPO_RS10900	3
ABI910_6POST	2251898	2251900		YPO_RS10905	2
ABI910_6POST	2252303	2252305		YPO_RS10905	2
ABI910_6POST	2252636	2252645		YPO_RS10905	9
ABI910_6POST	2252687	2252710		YPO_RS10905	23
ABI910_6POST	2252809	2252835		YPO_RS10905	26
ABI910_6POST	2253455	2253463		YPO_RS10910	8
ABI910_6POST	2254335	2254362		YPO_RS10915	27
ABI910_6POST	2254445	2254453		YPO_RS10915	8
ABI910_6POST	2254726	2254728		YPO_RS10915	2
ABI910_6POST	2255976	2255991		YPO_RS10925	15
ABI910_6POST	2256619	2256642		YPO_RS10925	23
ABI910_6POST	2257078	2257107		YPO_RS10925	29
ABI910_6POST	2257566	2257645		YPO_RS10930	79
ABI910_6POST	2257853	2257888		YPO_RS10930	35
ABI910_6POST	2257947	2257961		YPO_RS10930	14
ABI910_6POST	2258056	2258109		YPO_RS10930	53
ABI910_6POST	2258279	2258280		YPO_RS10930	1
ABI910_6POST	2258404	2258421		YPO_RS10930	17
ABI910_6POST	2258459	2258466		YPO_RS10930	7
ABI910_6POST	2259241	2259242		YPO_RS10935	1
ABI910_6POST	2259540	2259543		YPO_RS10935	3
ABI910_6POST	2259696	2259702		YPO_RS10935	6
ABI910_6POST	2260718	2260768		YPO_RS10935	50
ABI910_6POST	2261837	2261841		YPO_RS10940	4
ABI910_6POST	2262150	2262153		YPO_RS10940	3
ABI910_6POST	2262498	2262519		YPO_RS10940	21
ABI910_6POST	2262807	2262813		YPO_RS10940	6
ABI910_6POST	2263152	2263172		YPO_RS10940	20
ABI910_6POST	2263469	2263487		YPO_RS10940	18
ABI910_6POST	2263804	2263812		YPO_RS10945	8
ABI910_6POST	2263870	2263871		YPO_RS10945	1
ABI910_6POST	2264258	2264267		YPO_RS10945	9
ABI910_6POST	2265037	2265045		YPO_RS10950	8
ABI910_6POST	2265099	2265134		YPO_RS10950	35
ABI910_6POST	2265474	2265483		YPO_RS10955	9
ABI910_6POST	2265714	2265740		YPO_RS10955	26
ABI910_6POST	2266163	2266164		YPO_RS10960	1
ABI910_6POST	2266812	2266831		YPO_RS10965	19
ABI910_6POST	2268682	2268688		YPO_RS10975	6
ABI910_6POST	2269925	2269930		YPO_RS10980	5
ABI910_6POST	2270647	2270649		YPO_RS10980	2
ABI910_6POST	2270817	2270820		YPO_RS10980	3
ABI910_6POST	2271274	2271275		YPO_RS10985	1
ABI910_6POST	2271338	2271344		YPO_RS10985	6
ABI910_6POST	2271477	2271483		YPO_RS10985	6
ABI910_6POST	2271514	2271516		YPO_RS10985	2
ABI910_6POST	2271547	2271562		YPO_RS10985	15
ABI910_6POST	2271844	2271847		YPO_RS10990	3
ABI910_6POST	2272382	2272390		YPO_RS10995	8
ABI910_6POST	2272649	2272660		YPO_RS10995	11
ABI910_6POST	2272800	2272814		YPO_RS10995	14
ABI910_6POST	2273186	2273193		YPO_RS10995	7
ABI910_6POST	2273367	2273374		YPO_RS10995	7
ABI910_6POST	2273434	2273467		YPO_RS10995	33
ABI910_6POST	2274043	2274066		YPO_RS11000	23
ABI910_6POST	2274283	2274291		YPO_RS11000	8
ABI910_6POST	2274367	2274393		YPO_RS11000	26
ABI910_6POST	2274815	2274816		YPO_RS11005	1
ABI910_6POST	2274979	2274989		YPO_RS11005	10
ABI910_6POST	2275179	2275211		YPO_RS11005	32
ABI910_6POST	2275250	2275261		YPO_RS11005	11
ABI910_6POST	2275527	2275558		YPO_RS11005	31
ABI910_6POST	2275774	2275784		YPO_RS11005	10
ABI910_6POST	2276038	2276044		YPO_RS11010	6
ABI910_6POST	2276159	2276168		YPO_RS11010	9
ABI910_6POST	2276217	2276237		YPO_RS11010	20
ABI910_6POST	2276309	2276319		YPO_RS11010	10
ABI910_6POST	2276416	2276434		YPO_RS11010	18
ABI910_6POST	2277791	2277813		YPO_RS11020	22
ABI910_6POST	2278093	2278095		YPO_RS11020	2
ABI910_6POST	2279066	2279089		YPO_RS11025	23
ABI910_6POST	2279332	2279356		YPO_RS11025	24
ABI910_6POST	2279410	2279417		YPO_RS11025	7
ABI910_6POST	2279954	2279963		YPO_RS11030	9
ABI910_6POST	2280096	2280141		YPO_RS11030	45
ABI910_6POST	2280787	2280791		YPO_RS11035	4
ABI910_6POST	2282331	2282334		ychF	3
ABI910_6POST	2282571	2282578		ychF	7
ABI910_6POST	2282858	2282864		ychF	6
ABI910_6POST	2284560	2284564		ychH	4
ABI910_6POST	2285089	2285096		YPO_RS11060	7
ABI910_6POST	2285137	2285165		YPO_RS11060	28
ABI910_6POST	2286216	2286223		ispE	7
ABI910_6POST	2286461	2286471		ispE	10
ABI910_6POST	2287133	2287136		lolB	3
ABI910_6POST	2287180	2287183		lolB	3
ABI910_6POST	2287543	2287557		lolB	14
ABI910_6POST	2287622	2287634		lolB	12
ABI910_6POST	2288055	2288056		hemA	1
ABI910_6POST	2288105	2288111		hemA	6
ABI910_6POST	2288953	2288958		hemA	5
ABI910_6POST	2289504	2289530		prfA	26
ABI910_6POST	2291596	2291599		YPO_RS11090	3
ABI910_6POST	2291654	2291664		YPO_RS11095	10
ABI910_6POST	2292314	2292355		YPO_RS11095	41
ABI910_6POST	2292559	2292577		kdsA	18
ABI910_6POST	2292819	2292822		kdsA	3
ABI910_6POST	2293063	2293064		kdsA	1
ABI910_6POST	2293211	2293215		kdsA	4
ABI910_6POST	2294274	2294290		YPO_RS11105	16
ABI910_6POST	2294928	2294966		YPO_RS11115	38
ABI910_6POST	2295018	2295034		YPO_RS11115	16
ABI910_6POST	2295076	2295085		YPO_RS11115	9
ABI910_6POST	2295317	2295321		YPO_RS11115	4
ABI910_6POST	2295374	2295385		YPO_RS11115	11
ABI910_6POST	2295515	2295552		YPO_RS11115	37
ABI910_6POST	2295603	2295626		YPO_RS11115	23
ABI910_6POST	2295825	2295849		YPO_RS11120	24
ABI910_6POST	2295986	2296054		YPO_RS11120	68
ABI910_6POST	2296129	2296137		YPO_RS11120	8
ABI910_6POST	2296464	2296467		YPO_RS11120	3
ABI910_6POST	2296537	2296578		YPO_RS11120	41
ABI910_6POST	2300863	2300873		YPO_RS11140	10
ABI910_6POST	2301690	2301727		YPO_RS11145	37
ABI910_6POST	2301770	2301814		YPO_RS11145	44
ABI910_6POST	2302101	2302137		YPO_RS11145	36
ABI910_6POST	2302169	2302180		YPO_RS11145	11
ABI910_6POST	2302286	2302306		YPO_RS11150	20
ABI910_6POST	2302513	2302516		YPO_RS11150	3
ABI910_6POST	2302584	2302586		YPO_RS11150	2
ABI910_6POST	2303235	2303254		YPO_RS11155	19
ABI910_6POST	2303916	2303921		YPO_RS11155	5
ABI910_6POST	2305288	2305292		YPO_RS11170	4
ABI910_6POST	2305431	2305438		YPO_RS11170	7
ABI910_6POST	2305965	2305979		YPO_RS11175	14
ABI910_6POST	2306182	2306211		YPO_RS11175	29
ABI910_6POST	2306889	2306919		YPO_RS11175	30
ABI910_6POST	2307730	2307745		YPO_RS11185	15
ABI910_6POST	2308404	2308449		YPO_RS11185	45
ABI910_6POST	2308556	2308602		YPO_RS11190	46
ABI910_6POST	2308735	2308742		YPO_RS11190	7
ABI910_6POST	2310604	2310612		mdtH	8
ABI910_6POST	2311335	2311339		mdtH	4
ABI910_6POST	2311477	2311509		mdtH	32
ABI910_6POST	2312477	2312494		rimJ	17
ABI910_6POST	2312629	2312638		YPO_RS11210	9
ABI910_6POST	2313172	2313202		YPO_RS11210	30
ABI910_6POST	2313241	2313246		YPO_RS11210	5
ABI910_6POST	2313521	2313525		YPO_RS11210	4
ABI910_6POST	2313694	2313721		YPO_RS11210	27
ABI910_6POST	2315025	2315032		murJ	7
ABI910_6POST	2315288	2315299		murJ	11
ABI910_6POST	2315593	2315596		murJ	3
ABI910_6POST	2315805	2315822		murJ	17
ABI910_6POST	2315885	2315890		murJ	5
ABI910_6POST	2316441	2316473		YPO_RS11220	32
ABI910_6POST	2316998	2317017		YPO_RS11220	19
ABI910_6POST	2317507	2317515		YPO_RS11220	8
ABI910_6POST	2317886	2317922		YPO_RS11220	36
ABI910_6POST	2317975	2317995		YPO_RS11220	20
ABI910_6POST	2318079	2318084		YPO_RS11220	5
ABI910_6POST	2318132	2318133		YPO_RS11225	1
ABI910_6POST	2318170	2318176		YPO_RS11225	6
ABI910_6POST	2318333	2318371		YPO_RS11225	38
ABI910_6POST	2319103	2319111		YPO_RS11225	8
ABI910_6POST	2319541	2319552		YPO_RS11225	11
ABI910_6POST	2320427	2320432		YPO_RS11225	5
ABI910_6POST	2320529	2320531		YPO_RS11225	2
ABI910_6POST	2321339	2321356		YPO_RS11225	17
ABI910_6POST	2321734	2321742		YPO_RS11225	8
ABI910_6POST	2321952	2321964		YPO_RS11225	12
ABI910_6POST	2322184	2322186		YPO_RS11225	2
ABI910_6POST	2322595	2322599		YPO_RS11225	4
ABI910_6POST	2322814	2322850		YPO_RS11225	36
ABI910_6POST	2323255	2323260		argS	5
ABI910_6POST	2323874	2323882		argS	8
ABI910_6POST	2324259	2324271		argS	12
ABI910_6POST	2324334	2324339		argS	5
ABI910_6POST	2324604	2324605		argS	1
ABI910_6POST	2325477	2325483		YPO_RS11235	6
ABI910_6POST	2325854	2325863		YPO_RS11235	9
ABI910_6POST	2327832	2327837		cmoB	5
ABI910_6POST	2328898	2328908		cmoA	10
ABI910_6POST	2329197	2329198		YPO_RS11255	1
ABI910_6POST	2330482	2330484		YPO_RS11260	2
ABI910_6POST	2330519	2330520		YPO_RS11260	1
ABI910_6POST	2330550	2330555		YPO_RS11260	5
ABI910_6POST	2332231	2332252		aspS	21
ABI910_6POST	2332460	2332486		aspS	26
ABI910_6POST	2332578	2332584		aspS	6
ABI910_6POST	2332681	2332694		aspS	13
ABI910_6POST	2333006	2333037		aspS	31
ABI910_6POST	2333935	2333936		YPO_RS11275	1
ABI910_6POST	2334270	2334305		YPO_RS11275	35
ABI910_6POST	2335716	2335732		ruvA	16
ABI910_6POST	2336082	2336093		ruvA	11
ABI910_6POST	2336177	2336185		ruvA	8
ABI910_6POST	2336795	2336813		ruvB	18
ABI910_6POST	2336995	2337004		ruvB	9
ABI910_6POST	2337064	2337080		ruvB	16
ABI910_6POST	2337708	2337770		znuB	62
ABI910_6POST	2338022	2338034		znuB	12
ABI910_6POST	2339328	2339331		znuA	3
ABI910_6POST	2339583	2339593		znuA	10
ABI910_6POST	2340368	2340375		mepM	7
ABI910_6POST	2342034	2342036		lpxM	2
ABI910_6POST	2342121	2342133		lpxM	12
ABI910_6POST	2342202	2342241		lpxM	39
ABI910_6POST	2343486	2343491		pyk	5
ABI910_6POST	2343528	2343572		pyk	44
ABI910_6POST	2344924	2344931		YPO_RS11325	7
ABI910_6POST	2345060	2345062		YPO_RS11325	2
ABI910_6POST	2345985	2345994		zwf	9
ABI910_6POST	2346609	2346610		zwf	1
ABI910_6POST	2346642	2346667		zwf	25
ABI910_6POST	2346737	2346748		zwf	11
ABI910_6POST	2347146	2347154		zwf	8
ABI910_6POST	2347267	2347303		zwf	36
ABI910_6POST	2348064	2348074		YPO_RS11335	10
ABI910_6POST	2349447	2349474		mdtJ	27
ABI910_6POST	2349794	2349806		mdtI	12
ABI910_6POST	2350577	2350583		YPO_RS11355	6
ABI910_6POST	2351011	2351038		YPO_RS11355	27
ABI910_6POST	2351290	2351301		YPO_RS11355	11
ABI910_6POST	2351768	2351793		YPO_RS11355	25
ABI910_6POST	2352168	2352175		YPO_RS11355	7
ABI910_6POST	2352825	2352836		tsaB	11
ABI910_6POST	2353755	2353785		YPO_RS11365	30
ABI910_6POST	2354678	2354682		fadD	4
ABI910_6POST	2355401	2355409		fadD	8
ABI910_6POST	2355601	2355644		fadD	43
ABI910_6POST	2355694	2355695		fadD	1
ABI910_6POST	2356030	2356043		fadD	13
ABI910_6POST	2357165	2357168		rnd	3
ABI910_6POST	2358734	2358741		minD	7
ABI910_6POST	2358885	2358914		minC	29
ABI910_6POST	2359261	2359303		minC	42
ABI910_6POST	2360751	2360781		YPO_RS11405	30
ABI910_6POST	2361010	2361013		YPO_RS11405	3
ABI910_6POST	2361321	2361329		YPO_RS11405	8
ABI910_6POST	2361669	2361672		YPO_RS11405	3
ABI910_6POST	2361874	2361887		YPO_RS11410	13
ABI910_6POST	2362824	2362845		YPO_RS11415	21
ABI910_6POST	2362888	2362896		YPO_RS11415	8
ABI910_6POST	2363306	2363309		YPO_RS11420	3
ABI910_6POST	2363551	2363565		YPO_RS11420	14
ABI910_6POST	2364439	2364458		YPO_RS11425	19
ABI910_6POST	2364493	2364504		YPO_RS11425	11
ABI910_6POST	2364620	2364639		YPO_RS11425	19
ABI910_6POST	2364703	2364706		YPO_RS11425	3
ABI910_6POST	2364759	2364800		YPO_RS11425	41
ABI910_6POST	2364924	2364954		YPO_RS11425	30
ABI910_6POST	2364994	2365030		YPO_RS11425	36
ABI910_6POST	2365132	2365138		YPO_RS11425	6
ABI910_6POST	2365210	2365236		YPO_RS11425	26
ABI910_6POST	2365309	2365346		YPO_RS11425	37
ABI910_6POST	2365346	2365350		YPO_RS11430	4
ABI910_6POST	2365427	2365445		YPO_RS11430	18
ABI910_6POST	2365849	2365854		YPO_RS11430	5
ABI910_6POST	2367024	2367061		YPO_RS11440	37
ABI910_6POST	2368742	2368747		YPO_RS11455	5
ABI910_6POST	2369121	2369124		YPO_RS11460	3
ABI910_6POST	2370720	2370723		YPO_RS11475	3
ABI910_6POST	2371460	2371471		YPO_RS11485	11
ABI910_6POST	2372807	2372841		YPO_RS11495	34
ABI910_6POST	2375225	2375232		YPO_RS11510	7
ABI910_6POST	2375265	2375293		YPO_RS11510	28
ABI910_6POST	2375425	2375442		YPO_RS11510	17
ABI910_6POST	2375886	2375888		YPO_RS11515	2
ABI910_6POST	2376041	2376080		YPO_RS11515	39
ABI910_6POST	2376183	2376204		YPO_RS11515	21
ABI910_6POST	2376282	2376305		YPO_RS11515	23
ABI910_6POST	2376413	2376442		YPO_RS11515	29
ABI910_6POST	2376474	2376512		YPO_RS11515	38
ABI910_6POST	2376616	2376631		YPO_RS11515	15
ABI910_6POST	2376963	2376986		YPO_RS11520	23
ABI910_6POST	2377093	2377101		YPO_RS11520	8
ABI910_6POST	2377495	2377503		YPO_RS11520	8
ABI910_6POST	2377655	2377658		YPO_RS11520	3
ABI910_6POST	2377940	2377952		YPO_RS11525	12
ABI910_6POST	2378726	2378749		YPO_RS11530	23
ABI910_6POST	2378904	2378911		YPO_RS11530	7
ABI910_6POST	2380830	2380839		YPO_RS11540	9
ABI910_6POST	2381098	2381102		YPO_RS11540	4
ABI910_6POST	2381432	2381439		YPO_RS11545	7
ABI910_6POST	2381517	2381520		YPO_RS11545	3
ABI910_6POST	2381606	2381615		YPO_RS11545	9
ABI910_6POST	2381710	2381711		YPO_RS11545	1
ABI910_6POST	2381884	2381887		YPO_RS11545	3
ABI910_6POST	2381923	2381940		YPO_RS11545	17
ABI910_6POST	2382118	2382127		YPO_RS11545	9
ABI910_6POST	2382792	2382816		YPO_RS11550	24
ABI910_6POST	2382923	2382931		YPO_RS11550	8
ABI910_6POST	2384002	2384005		YPO_RS11565	3
ABI910_6POST	2384084	2384098		YPO_RS11565	14
ABI910_6POST	2384223	2384234		YPO_RS11565	11
ABI910_6POST	2384462	2384470		YPO_RS11570	8
ABI910_6POST	2384559	2384562		YPO_RS11570	3
ABI910_6POST	2384753	2384757		YPO_RS11575	4
ABI910_6POST	2384809	2384832		YPO_RS11575	23
ABI910_6POST	2384978	2384992		YPO_RS11575	14
ABI910_6POST	2385162	2385185		YPO_RS11575	23
ABI910_6POST	2385371	2385388		YPO_RS11575	17
ABI910_6POST	2385487	2385523		YPO_RS11575	36
ABI910_6POST	2385581	2385582		YPO_RS11575	1
ABI910_6POST	2385694	2385701		YPO_RS11580	7
ABI910_6POST	2385859	2385863		YPO_RS11580	4
ABI910_6POST	2386112	2386134		YPO_RS11585	22
ABI910_6POST	2386353	2386405		YPO_RS11590	52
ABI910_6POST	2387281	2387305		YPO_RS11590	24
ABI910_6POST	2388376	2388389		YPO_RS11590	13
ABI910_6POST	2388897	2388905		YPO_RS11590	8
ABI910_6POST	2388957	2388968		YPO_RS11590	11
ABI910_6POST	2389148	2389167		YPO_RS11590	19
ABI910_6POST	2389295	2389300		YPO_RS11590	5
ABI910_6POST	2389337	2389363		YPO_RS11590	26
ABI910_6POST	2389638	2389640		YPO_RS11590	2
ABI910_6POST	2390424	2390431		YPO_RS11600	7
ABI910_6POST	2391184	2391192		YPO_RS11605	8
ABI910_6POST	2391509	2391520		YPO_RS11605	11
ABI910_6POST	2391554	2391555		YPO_RS11605	1
ABI910_6POST	2391717	2391725		YPO_RS11605	8
ABI910_6POST	2391922	2391923		YPO_RS11610	1
ABI910_6POST	2392212	2392216		YPO_RS11610	4
ABI910_6POST	2392372	2392379		YPO_RS11610	7
ABI910_6POST	2392432	2392443		YPO_RS11610	11
ABI910_6POST	2393196	2393202		YPO_RS11615	6
ABI910_6POST	2394307	2394329		YPO_RS11630	22
ABI910_6POST	2394743	2394755		YPO_RS11630	12
ABI910_6POST	2394925	2394938		YPO_RS11630	13
ABI910_6POST	2395779	2395785		YPO_RS11635	6
ABI910_6POST	2396065	2396089		YPO_RS11640	24
ABI910_6POST	2397177	2397199		YPO_RS11655	22
ABI910_6POST	2397530	2397538		YPO_RS11660	8
ABI910_6POST	2397617	2397623		YPO_RS11660	6
ABI910_6POST	2398414	2398416		YPO_RS11660	2
ABI910_6POST	2398484	2398491		YPO_RS11660	7
ABI910_6POST	2398619	2398624		YPO_RS11660	5
ABI910_6POST	2398885	2398899		YPO_RS11660	14
ABI910_6POST	2398974	2398991		YPO_RS11660	17
ABI910_6POST	2399583	2399589		YPO_RS11660	6
ABI910_6POST	2399689	2399718		YPO_RS11660	29
ABI910_6POST	2399842	2399868		YPO_RS11660	26
ABI910_6POST	2400251	2400272		YPO_RS11660	21
ABI910_6POST	2400313	2400342		YPO_RS11660	29
ABI910_6POST	2400720	2400741		YPO_RS11665	21
ABI910_6POST	2400848	2400936		YPO_RS11665	88
ABI910_6POST	2401411	2401420		YPO_RS11665	9
ABI910_6POST	2401502	2401550		YPO_RS11665	48
ABI910_6POST	2401743	2401750		YPO_RS11670	7
ABI910_6POST	2401874	2401885		YPO_RS11670	11
ABI910_6POST	2402290	2402295		YPO_RS11670	5
ABI910_6POST	2403403	2403409		YPO_RS11680	6
ABI910_6POST	2403601	2403652		YPO_RS11680	51
ABI910_6POST	2403710	2403727		YPO_RS11680	17
ABI910_6POST	2403844	2403874		YPO_RS11680	30
ABI910_6POST	2403907	2403922		YPO_RS11680	15
ABI910_6POST	2404031	2404044		YPO_RS11680	13
ABI910_6POST	2404149	2404151		YPO_RS11680	2
ABI910_6POST	2404192	2404200		YPO_RS11680	8
ABI910_6POST	2404922	2404923		YPO_RS11685	1
ABI910_6POST	2404999	2405007		YPO_RS11685	8
ABI910_6POST	2405147	2405157		YPO_RS11685	10
ABI910_6POST	2405332	2405333		YPO_RS11685	1
ABI910_6POST	2405487	2405526		YPO_RS11685	39
ABI910_6POST	2405685	2405687		YPO_RS11685	2
ABI910_6POST	2405839	2405840		YPO_RS11685	1
ABI910_6POST	2406183	2406184		YPO_RS11690	1
ABI910_6POST	2406284	2406286		YPO_RS11690	2
ABI910_6POST	2406813	2406815		YPO_RS11690	2
ABI910_6POST	2407246	2407259		YPO_RS11695	13
ABI910_6POST	2410130	2410147		dsbB	17
ABI910_6POST	2410797	2410812		nhaB	15
ABI910_6POST	2411379	2411380		nhaB	1
ABI910_6POST	2411924	2411937		nhaB	13
ABI910_6POST	2414378	2414406		YPO_RS11720	28
ABI910_6POST	2414649	2414656		YPO_RS11720	7
ABI910_6POST	2415360	2415368		YPO_RS11725	8
ABI910_6POST	2415477	2415484		YPO_RS11725	7
ABI910_6POST	2415620	2415626		YPO_RS11725	6
ABI910_6POST	2415999	2416011		YPO_RS11725	12
ABI910_6POST	2416148	2416153		YPO_RS11725	5
ABI910_6POST	2416408	2416418		YPO_RS11725	10
ABI910_6POST	2416714	2416715		YPO_RS11730	1
ABI910_6POST	2416863	2416881		YPO_RS11730	18
ABI910_6POST	2417184	2417189		YPO_RS11730	5
ABI910_6POST	2417501	2417508		YPO_RS11730	7
ABI910_6POST	2418283	2418301		YPO_RS11735	18
ABI910_6POST	2418523	2418526		YPO_RS11735	3
ABI910_6POST	2419235	2419241		YPO_RS11740	6
ABI910_6POST	2419304	2419307		YPO_RS11740	3
ABI910_6POST	2419447	2419467		YPO_RS11740	20
ABI910_6POST	2419670	2419689		YPO_RS11740	19
ABI910_6POST	2420004	2420015		YPO_RS11740	11
ABI910_6POST	2420593	2420612		YPO_RS11745	19
ABI910_6POST	2421113	2421134		YPO_RS11745	21
ABI910_6POST	2421529	2421533		YPO_RS11750	4
ABI910_6POST	2422367	2422384		YPO_RS11750	17
ABI910_6POST	2423375	2423380		yeaG	5
ABI910_6POST	2424261	2424269		yeaG	8
ABI910_6POST	2424347	2424356		yeaG	9
ABI910_6POST	2425238	2425250		YPO_RS11760	12
ABI910_6POST	2425411	2425434		YPO_RS11760	23
ABI910_6POST	2425575	2425581		YPO_RS11760	6
ABI910_6POST	2428135	2428139		gapA	4
ABI910_6POST	2429145	2429148		YPO_RS11780	3
ABI910_6POST	2429590	2429606		pncA	16
ABI910_6POST	2429959	2429971		pncA	12
ABI910_6POST	2430209	2430233		ansA	24
ABI910_6POST	2430383	2430399		ansA	16
ABI910_6POST	2430514	2430521		ansA	7
ABI910_6POST	2430786	2430792		ansA	6
ABI910_6POST	2430838	2430855		ansA	17
ABI910_6POST	2430973	2430982		ansA	9
ABI910_6POST	2431822	2431835		sppA	13
ABI910_6POST	2432254	2432256		sppA	2
ABI910_6POST	2432503	2432512		sppA	9
ABI910_6POST	2432780	2432781		sppA	1
ABI910_6POST	2432835	2432858		sppA	23
ABI910_6POST	2433203	2433206		YPO_RS11800	3
ABI910_6POST	2433283	2433288		YPO_RS11800	5
ABI910_6POST	2433527	2433542		YPO_RS11800	15
ABI910_6POST	2433586	2433610		YPO_RS11800	24
ABI910_6POST	2434779	2434806		selD	27
ABI910_6POST	2435588	2435594		YPO_RS11810	6
ABI910_6POST	2435989	2436007		YPO_RS11810	18
ABI910_6POST	2436468	2436478		YPO_RS11810	10
ABI910_6POST	2437097	2437101		YPO_RS11815	4
ABI910_6POST	2437338	2437351		YPO_RS11820	13
ABI910_6POST	2438011	2438012		xthA	1
ABI910_6POST	2438152	2438163		xthA	11
ABI910_6POST	2438461	2438473		xthA	12
ABI910_6POST	2439677	2439682		YPO_RS11830	5
ABI910_6POST	2439891	2439896		YPO_RS11830	5
ABI910_6POST	2440229	2440231		YPO_RS11830	2
ABI910_6POST	2441334	2441354		YPO_RS11850	20
ABI910_6POST	2441432	2441444		YPO_RS11850	12
ABI910_6POST	2441474	2441479		YPO_RS11850	5
ABI910_6POST	2441528	2441534		YPO_RS11850	6
ABI910_6POST	2441579	2441631		YPO_RS11850	52
ABI910_6POST	2441671	2441690		YPO_RS11850	19
ABI910_6POST	2441825	2441842		YPO_RS11850	17
ABI910_6POST	2441883	2441918		YPO_RS11850	35
ABI910_6POST	2441214	2441220		YPO_RS11850	6
ABI910_6POST	2442365	2442376		purU	11
ABI910_6POST	2442437	2442442		purU	5
ABI910_6POST	2442639	2442643		purU	4
ABI910_6POST	2442721	2442745		purU	24
ABI910_6POST	2443165	2443171		purU	6
ABI910_6POST	2445723	2445745		rssB	22
ABI910_6POST	2445958	2445977		rssB	19
ABI910_6POST	2446667	2446705		YPO_RS11870	38
ABI910_6POST	2447210	2447237		YPO_RS11870	27
ABI910_6POST	2447360	2447372		YPO_RS11870	12
ABI910_6POST	2448281	2448286		hns	5
ABI910_6POST	2449892	2449895		YPO_RS11880	3
ABI910_6POST	2450351	2450356		YPO_RS11885	5
ABI910_6POST	2450540	2450565		YPO_RS11885	25
ABI910_6POST	2450634	2450673		YPO_RS11885	39
ABI910_6POST	2450725	2450726		YPO_RS11885	1
ABI910_6POST	2450781	2450785		YPO_RS11885	4
ABI910_6POST	2450883	2450885		YPO_RS11885	2
ABI910_6POST	2451037	2451043		YPO_RS11885	6
ABI910_6POST	2451043	2451058		YPO_RS11890	15
ABI910_6POST	2451138	2451174		YPO_RS11890	36
ABI910_6POST	2451342	2451371		YPO_RS11890	29
ABI910_6POST	2451405	2451423		YPO_RS11890	18
ABI910_6POST	2451670	2451682		YPO_RS11890	12
ABI910_6POST	2451990	2451992		YPO_RS11890	2
ABI910_6POST	2452744	2452768		adhE	24
ABI910_6POST	2453204	2453212		adhE	8
ABI910_6POST	2453457	2453485		adhE	28
ABI910_6POST	2454089	2454090		adhE	1
ABI910_6POST	2456447	2456459		YPO_RS11900	12
ABI910_6POST	2457694	2457722		oppA	28
ABI910_6POST	2457755	2457757		oppA	2
ABI910_6POST	2457808	2457812		oppA	4
ABI910_6POST	2457916	2457920		oppA	4
ABI910_6POST	2458455	2458457		oppA	2
ABI910_6POST	2458588	2458608		oppA	20
ABI910_6POST	2459772	2459786		oppB	14
ABI910_6POST	2459823	2459824		oppB	1
ABI910_6POST	2460418	2460438		oppC	20
ABI910_6POST	2460912	2460914		oppC	2
ABI910_6POST	2460978	2460996		oppC	18
ABI910_6POST	2461343	2461360		YPO_RS11920	17
ABI910_6POST	2461848	2461850		YPO_RS11920	2
ABI910_6POST	2461917	2461933		YPO_RS11920	16
ABI910_6POST	2461979	2461989		YPO_RS11920	10
ABI910_6POST	2462212	2462225		YPO_RS11925	13
ABI910_6POST	2462845	2462848		YPO_RS11925	3
ABI910_6POST	2462893	2462906		YPO_RS11925	13
ABI910_6POST	2464389	2464398		YPO_RS11935	9
ABI910_6POST	2464496	2464507		YPO_RS11935	11
ABI910_6POST	2464783	2464791		cls	8
ABI910_6POST	2464821	2464833		cls	12
ABI910_6POST	2465183	2465184		cls	1
ABI910_6POST	2465343	2465368		cls	25
ABI910_6POST	2465599	2465605		cls	6
ABI910_6POST	2467555	2467631		YPO_RS11950	76
ABI910_6POST	2469581	2469597		tonB	16
ABI910_6POST	2470389	2470424		YPO_RS11975	35
ABI910_6POST	2470636	2470652		YPO_RS11975	16
ABI910_6POST	2470715	2470722		YPO_RS11975	7
ABI910_6POST	2470838	2470871		YPO_RS11975	33
ABI910_6POST	2471026	2471029		YPO_RS11975	3
ABI910_6POST	2471146	2471156		YPO_RS11975	10
ABI910_6POST	2471277	2471287		YPO_RS11975	10
ABI910_6POST	2472952	2472993		YPO_RS11990	41
ABI910_6POST	2473129	2473133		YPO_RS11990	4
ABI910_6POST	2473289	2473290		YPO_RS11990	1
ABI910_6POST	2473393	2473463		YPO_RS11990	70
ABI910_6POST	2473559	2473595		YPO_RS11990	36
ABI910_6POST	2473729	2473734		YPO_RS11990	5
ABI910_6POST	2474046	2474049		YPO_RS11995	3
ABI910_6POST	2474292	2474318		YPO_RS11995	26
ABI910_6POST	2474834	2474837		YPO_RS12000	3
ABI910_6POST	2475090	2475094		YPO_RS12000	4
ABI910_6POST	2475401	2475420		YPO_RS12000	19
ABI910_6POST	2475768	2475796		YPO_RS12005	28
ABI910_6POST	2475834	2475845		YPO_RS12005	11
ABI910_6POST	2476010	2476027		ompW	17
ABI910_6POST	2476095	2476108		ompW	13
ABI910_6POST	2476332	2476340		ompW	8
ABI910_6POST	2476481	2476484		ompW	3
ABI910_6POST	2478085	2478091		trpA	6
ABI910_6POST	2478192	2478196		trpA	4
ABI910_6POST	2478491	2478493		trpB	2
ABI910_6POST	2479071	2479073		trpB	2
ABI910_6POST	2479674	2479688		trpCF	14
ABI910_6POST	2480020	2480027		trpCF	7
ABI910_6POST	2480174	2480177		trpCF	3
ABI910_6POST	2480593	2480599		trpCF	6
ABI910_6POST	2480684	2480708		trpCF	24
ABI910_6POST	2480739	2480747		trpCF	8
ABI910_6POST	2480848	2480851		trpCF	3
ABI910_6POST	2482237	2482243		YPO_RS12040	6
ABI910_6POST	2482405	2482406		YPO_RS12040	1
ABI910_6POST	2482604	2482605		YPO_RS12045	1
ABI910_6POST	2482790	2482796		YPO_RS12045	6
ABI910_6POST	2482886	2482898		YPO_RS12045	12
ABI910_6POST	2483472	2483488		YPO_RS12045	16
ABI910_6POST	2484056	2484067		YPO_RS12045	11
ABI910_6POST	2484288	2484291		trpL	3
ABI910_6POST	2484752	2484769		YPO_RS12055	17
ABI910_6POST	2484820	2484822		YPO_RS12055	2
ABI910_6POST	2484953	2484956		YPO_RS12055	3
ABI910_6POST	2485095	2485132		YPO_RS12055	37
ABI910_6POST	2485384	2485387		YPO_RS12055	3
ABI910_6POST	2486110	2486122		YPO_RS12060	12
ABI910_6POST	2487089	2487109		rluB	20
ABI910_6POST	2487803	2487806		cobO	3
ABI910_6POST	2487881	2487884		cobO	3
ABI910_6POST	2487927	2487963		cobO	36
ABI910_6POST	2488711	2488754		YPO_RS12075	43
ABI910_6POST	2488818	2488824		YPO_RS12075	6
ABI910_6POST	2488952	2488965		YPO_RS12075	13
ABI910_6POST	2489280	2489281		sohB	1
ABI910_6POST	2490760	2490793		YPO_RS12090	33
ABI910_6POST	2491783	2491785		topA	2
ABI910_6POST	2491901	2491909		topA	8
ABI910_6POST	2492157	2492166		topA	9
ABI910_6POST	2492857	2492861		topA	4
ABI910_6POST	2493207	2493239		topA	32
ABI910_6POST	2493494	2493504		topA	10
ABI910_6POST	2494620	2494635		cysB	15
ABI910_6POST	2494750	2494762		cysB	12
ABI910_6POST	2494941	2494948		cysB	7
ABI910_6POST	2495577	2495580		YPO_RS12105	3
ABI910_6POST	2495706	2495716		YPO_RS12105	10
ABI910_6POST	2495901	2495911		YPO_RS12105	10
ABI910_6POST	2496017	2496038		YPO_RS12105	21
ABI910_6POST	2496728	2496731		acnA	3
ABI910_6POST	2497205	2497216		acnA	11
ABI910_6POST	2497455	2497461		acnA	6
ABI910_6POST	2497529	2497551		acnA	22
ABI910_6POST	2497605	2497619		acnA	14
ABI910_6POST	2497671	2497674		acnA	3
ABI910_6POST	2497967	2497968		acnA	1
ABI910_6POST	2498288	2498326		acnA	38
ABI910_6POST	2498410	2498413		acnA	3
ABI910_6POST	2498446	2498454		acnA	8
ABI910_6POST	2499656	2499667		ribA	11
ABI910_6POST	2500666	2500667		pgpB	1
ABI910_6POST	2501780	2501791		lapB	11
ABI910_6POST	2502507	2502538		lapB	31
ABI910_6POST	2502829	2502834		lapB	5
ABI910_6POST	2502905	2502916		lapB	11
ABI910_6POST	2504172	2504174		pyrF	2
ABI910_6POST	2504298	2504300		pyrF	2
ABI910_6POST	2504421	2504427		pyrF	6
ABI910_6POST	2505170	2505198		osmB	28
ABI910_6POST	2505241	2505248		osmB	7
ABI910_6POST	2506131	2506134		araD	3
ABI910_6POST	2506313	2506352		araD	39
ABI910_6POST	2506429	2506431		araD	2
ABI910_6POST	2507157	2507181		fsa	24
ABI910_6POST	2507315	2507319		fsa	4
ABI910_6POST	2507541	2507567		fsa	26
ABI910_6POST	2507683	2507695		fsa	12
ABI910_6POST	2507742	2507758		fsa	16
ABI910_6POST	2508083	2508120		YPO_RS12170	37
ABI910_6POST	2508397	2508398		YPO_RS12175	1
ABI910_6POST	2508490	2508509		YPO_RS12175	19
ABI910_6POST	2508621	2508646		YPO_RS12175	25
ABI910_6POST	2508844	2508847		YPO_RS12175	3
ABI910_6POST	2509006	2509028		YPO_RS12175	22
ABI910_6POST	2509613	2509631		YPO_RS12175	18
ABI910_6POST	2511231	2511233		YPO_RS12180	2
ABI910_6POST	2512068	2512090		YPO_RS12180	22
ABI910_6POST	2512123	2512127		YPO_RS12180	4
ABI910_6POST	2512348	2512350		YPO_RS12180	2
ABI910_6POST	2513259	2513269		YPO_RS12185	10
ABI910_6POST	2513431	2513442		YPO_RS12185	11
ABI910_6POST	2513686	2513699		YPO_RS12185	13
ABI910_6POST	2513804	2513810		YPO_RS12185	6
ABI910_6POST	2514387	2514396		YPO_RS12185	9
ABI910_6POST	2514574	2514644		YPO_RS12190	70
ABI910_6POST	2515151	2515156		YPO_RS12190	5
ABI910_6POST	2515285	2515296		YPO_RS12190	11
ABI910_6POST	2515970	2515988		nth	18
ABI910_6POST	2516165	2516201		nth	36
ABI910_6POST	2516384	2516389		YPO_RS12200	5
ABI910_6POST	2516475	2516486		YPO_RS12200	11
ABI910_6POST	2516562	2516575		YPO_RS12200	13
ABI910_6POST	2516644	2516668		YPO_RS12200	24
ABI910_6POST	2517085	2517094		rsxG	9
ABI910_6POST	2517158	2517161		rsxG	3
ABI910_6POST	2517428	2517441		rsxG	13
ABI910_6POST	2517721	2517725		rsxD	4
ABI910_6POST	2517917	2517930		rsxD	13
ABI910_6POST	2518413	2518429		rsxD	16
ABI910_6POST	2518476	2518512		rsxD	36
ABI910_6POST	2519854	2519870		YPO_RS12215	16
ABI910_6POST	2520630	2520638		rsxC	8
ABI910_6POST	2521107	2521123		rsxC	16
ABI910_6POST	2521188	2521193		rsxC	5
ABI910_6POST	2521416	2521420		rsxC	4
ABI910_6POST	2521497	2521513		rsxC	16
ABI910_6POST	2521783	2521813		rsxC	30
ABI910_6POST	2521847	2521861		rsxC	14
ABI910_6POST	2521903	2521918		rsxC	15
ABI910_6POST	2521971	2521984		rsxC	13
ABI910_6POST	2522309	2522378		rsxB	69
ABI910_6POST	2522561	2522605		rsxB	44
ABI910_6POST	2522985	2522993		rsxA	8
ABI910_6POST	2523311	2523316		rsxA	5
ABI910_6POST	2526462	2526466		YPO_RS12245	4
ABI910_6POST	2526507	2526526		YPO_RS12245	19
ABI910_6POST	2526750	2526759		YPO_RS12245	9
ABI910_6POST	2526875	2526882		YPO_RS12245	7
ABI910_6POST	2526956	2526965		YPO_RS12245	9
ABI910_6POST	2527440	2527447		YPO_RS12245	7
ABI910_6POST	2527871	2527894		YPO_RS12255	23
ABI910_6POST	2528110	2528113		YPO_RS12255	3
ABI910_6POST	2528328	2528339		YPO_RS12255	11
ABI910_6POST	2528420	2528451		YPO_RS12255	31
ABI910_6POST	2528533	2528584		YPO_RS12255	51
ABI910_6POST	2528857	2528862		YPO_RS12255	5
ABI910_6POST	2529359	2529368		YPO_RS12255	9
ABI910_6POST	2529401	2529415		YPO_RS12255	14
ABI910_6POST	2529651	2529655		YPO_RS12255	4
ABI910_6POST	2530325	2530334		araA	9
ABI910_6POST	2530560	2530581		araA	21
ABI910_6POST	2530617	2530653		araA	36
ABI910_6POST	2530756	2530763		araA	7
ABI910_6POST	2530868	2530882		araA	14
ABI910_6POST	2531091	2531102		araA	11
ABI910_6POST	2531206	2531212		araA	6
ABI910_6POST	2531350	2531352		araA	2
ABI910_6POST	2531428	2531441		araA	13
ABI910_6POST	2531544	2531574		araA	30
ABI910_6POST	2531610	2531612		araA	2
ABI910_6POST	2532029	2532041		YPO_RS12265	12
ABI910_6POST	2532165	2532191		YPO_RS12265	26
ABI910_6POST	2532306	2532313		YPO_RS12265	7
ABI910_6POST	2532344	2532357		YPO_RS12265	13
ABI910_6POST	2532458	2532469		YPO_RS12265	11
ABI910_6POST	2532765	2532791		YPO_RS12265	26
ABI910_6POST	2532829	2532844		YPO_RS12265	15
ABI910_6POST	2533157	2533159		YPO_RS12265	2
ABI910_6POST	2533871	2533880		YPO_RS12270	9
ABI910_6POST	2534269	2534278		YPO_RS12270	9
ABI910_6POST	2534479	2534483		YPO_RS12270	4
ABI910_6POST	2534700	2534701		YPO_RS12270	1
ABI910_6POST	2534737	2534743		YPO_RS12270	6
ABI910_6POST	2535132	2535135		YPO_RS12275	3
ABI910_6POST	2535547	2535576		YPO_RS12275	29
ABI910_6POST	2535817	2535832		YPO_RS12275	15
ABI910_6POST	2536362	2536371		YPO_RS12275	9
ABI910_6POST	2536894	2536935		YPO_RS12280	41
ABI910_6POST	2537383	2537394		YPO_RS12280	11
ABI910_6POST	2537869	2537882		araC	13
ABI910_6POST	2538070	2538097		araC	27
ABI910_6POST	2538293	2538296		araC	3
ABI910_6POST	2538342	2538353		araC	11
ABI910_6POST	2538560	2538579		araC	19
ABI910_6POST	2539888	2539890		YPO_RS12290	2
ABI910_6POST	2540344	2540361		YPO_RS12295	17
ABI910_6POST	2540816	2540834		YPO_RS12295	18
ABI910_6POST	2541572	2541593		YPO_RS12300	21
ABI910_6POST	2541758	2541760		YPO_RS12300	2
ABI910_6POST	2542362	2542371		YPO_RS12305	9
ABI910_6POST	2542482	2542489		YPO_RS12305	7
ABI910_6POST	2543458	2543468		YPO_RS12305	10
ABI910_6POST	2544226	2544250		manA	24
ABI910_6POST	2544460	2544461		manA	1
ABI910_6POST	2545674	2545695		fumC	21
ABI910_6POST	2545878	2545905		fumC	27
ABI910_6POST	2546212	2546234		fumC	22
ABI910_6POST	2546891	2546902		YPO_RS12320	11
ABI910_6POST	2547153	2547161		YPO_RS12320	8
ABI910_6POST	2548297	2548312		YPO_RS12325	15
ABI910_6POST	2548518	2548541		YPO_RS12325	23
ABI910_6POST	2548823	2548827		YPO_RS12325	4
ABI910_6POST	2549017	2549045		YPO_RS12325	28
ABI910_6POST	2549138	2549140		YPO_RS12325	2
ABI910_6POST	2549913	2549914		YPO_RS12335	1
ABI910_6POST	2550209	2550221		YPO_RS12335	12
ABI910_6POST	2550563	2550569		YPO_RS12340	6
ABI910_6POST	2550918	2550924		YPO_RS12340	6
ABI910_6POST	2551190	2551208		YPO_RS12340	18
ABI910_6POST	2551319	2551322		YPO_RS12340	3
ABI910_6POST	2551421	2551426		YPO_RS12340	5
ABI910_6POST	2551932	2551939		bioD	7
ABI910_6POST	2552898	2552900		clcB	2
ABI910_6POST	2552970	2553022		clcB	52
ABI910_6POST	2553147	2553156		clcB	9
ABI910_6POST	2553345	2553353		clcB	8
ABI910_6POST	2553479	2553494		clcB	15
ABI910_6POST	2554373	2554633		YPO_RS12355	260
ABI910_6POST	2554658	2555065		YPO_RS12360	407
ABI910_6POST	2555162	2555608		YPO_RS12365	446
ABI910_6POST	2555780	2556832		YPO_RS12370	1052
ABI910_6POST	2556844	2557161		YPO_RS12375	317
ABI910_6POST	2557164	2557415		YPO_RS12380	251
ABI910_6POST	2557451	2557684		YPO_RS12385	233
ABI910_6POST	2557749	2559461		YPO_RS12390	1712
ABI910_6POST	2559474	2559761		YPO_RS12395	287
ABI910_6POST	2559765	2560790		YPO_RS12400	1025
ABI910_6POST	2560790	2562034		YPO_RS12405	1244
ABI910_6POST	2562123	2562371		YPO_RS12410	248
ABI910_6POST	2562568	2562765		YPO_RS12415	197
ABI910_6POST	2563325	2563349		YPO_RS12420	24
ABI910_6POST	2563498	2563501		YPO_RS12420	3
ABI910_6POST	2563660	2563711		YPO_RS12420	51
ABI910_6POST	2564426	2564429		YPO_RS12425	3
ABI910_6POST	2564819	2564828		YPO_RS12425	9
ABI910_6POST	2566093	2566095		YPO_RS12435	2
ABI910_6POST	2566233	2566258		YPO_RS12435	25
ABI910_6POST	2566386	2566391		YPO_RS12435	5
ABI910_6POST	2566466	2566473		YPO_RS12435	7
ABI910_6POST	2566944	2566954		YPO_RS12440	10
ABI910_6POST	2567435	2567437		YPO_RS12440	2
ABI910_6POST	2568162	2568166		YPO_RS12445	4
ABI910_6POST	2568877	2568878		YPO_RS12445	1
ABI910_6POST	2569062	2569063		YPO_RS12445	1
ABI910_6POST	2569434	2569443		YPO_RS12445	9
ABI910_6POST	2570075	2570079		YPO_RS12450	4
ABI910_6POST	2570409	2570445		YPO_RS12450	36
ABI910_6POST	2570541	2570563		YPO_RS12450	22
ABI910_6POST	2570641	2570668		YPO_RS12450	27
ABI910_6POST	2571535	2571539		YPO_RS12455	4
ABI910_6POST	2572244	2572257		YPO_RS12455	13
ABI910_6POST	2572849	2572850		YPO_RS12455	1
ABI910_6POST	2572967	2572971		YPO_RS12455	4
ABI910_6POST	2573809	2573814		YPO_RS12455	5
ABI910_6POST	2574260	2574269		YPO_RS12455	9
ABI910_6POST	2574349	2574401		YPO_RS12460	52
ABI910_6POST	2575152	2575161		YPO_RS12460	9
ABI910_6POST	2575529	2575537		YPO_RS12460	8
ABI910_6POST	2576148	2576158		YPO_RS12460	10
ABI910_6POST	2576235	2576240		YPO_RS12460	5
ABI910_6POST	2576594	2576649		YPO_RS12460	55
ABI910_6POST	2577151	2577186		YPO_RS12465	35
ABI910_6POST	2577535	2577547		YPO_RS12465	12
ABI910_6POST	2578267	2578269		ivbL	2
ABI910_6POST	2578942	2578952		ilvB	10
ABI910_6POST	2579129	2579152		ilvB	23
ABI910_6POST	2579267	2579287		ilvB	20
ABI910_6POST	2580076	2580077		ilvN	1
ABI910_6POST	2580249	2580298		ilvN	49
ABI910_6POST	2580514	2580518		yjjG	4
ABI910_6POST	2580568	2580577		yjjG	9
ABI910_6POST	2580922	2580935		yjjG	13
ABI910_6POST	2581606	2581622		YPO_RS12490	16
ABI910_6POST	2581731	2581738		YPO_RS12490	7
ABI910_6POST	2581772	2581789		YPO_RS12490	17
ABI910_6POST	2581895	2581911		YPO_RS12490	16
ABI910_6POST	2582447	2582497		YPO_RS12490	50
ABI910_6POST	2582575	2582592		YPO_RS12490	17
ABI910_6POST	2582644	2582670		YPO_RS12495	26
ABI910_6POST	2582792	2582810		YPO_RS12495	18
ABI910_6POST	2583209	2583212		YPO_RS12495	3
ABI910_6POST	2584527	2584533		phoA	6
ABI910_6POST	2584722	2584725		phoA	3
ABI910_6POST	2585263	2585276		phoA	13
ABI910_6POST	2586678	2586684		YPO_RS12510	6
ABI910_6POST	2587849	2587852		uspE	3
ABI910_6POST	2588267	2588289		uspE	22
ABI910_6POST	2590589	2590590		pntA	1
ABI910_6POST	2591400	2591414		pntA	14
ABI910_6POST	2592692	2592699		YPO_RS12530	7
ABI910_6POST	2592978	2593004		YPO_RS12530	26
ABI910_6POST	2593759	2593767		YPO_RS12535	8
ABI910_6POST	2593890	2593910		YPO_RS12535	20
ABI910_6POST	2593944	2593966		YPO_RS12535	22
ABI910_6POST	2594252	2594256		YPO_RS12535	4
ABI910_6POST	2594699	2594709		YPO_RS12535	10
ABI910_6POST	2595142	2595154		YPO_RS12540	12
ABI910_6POST	2596724	2596745		rstB	21
ABI910_6POST	2596853	2596887		rstB	34
ABI910_6POST	2598101	2598108		YPO_RS12555	7
ABI910_6POST	2598183	2598221		YPO_RS12555	38
ABI910_6POST	2598253	2598258		YPO_RS12555	5
ABI910_6POST	2598857	2598876		YPO_RS12555	19
ABI910_6POST	2598968	2598974		YPO_RS12555	6
ABI910_6POST	2599051	2599060		YPO_RS12555	9
ABI910_6POST	2604582	2604594		YPO_RS12575	12
ABI910_6POST	2605094	2605119		YPO_RS12580	25
ABI910_6POST	2605563	2605567		YPO_RS12580	4
ABI910_6POST	2606322	2606331		asr	9
ABI910_6POST	2608134	2608171		YPO_RS12600	37
ABI910_6POST	2608290	2608309		YPO_RS12600	19
ABI910_6POST	2608756	2608768		hrpA	12
ABI910_6POST	2608964	2608972		hrpA	8
ABI910_6POST	2609718	2609740		hrpA	22
ABI910_6POST	2609812	2609827		hrpA	15
ABI910_6POST	2609939	2609952		hrpA	13
ABI910_6POST	2610045	2610056		hrpA	11
ABI910_6POST	2610617	2610622		hrpA	5
ABI910_6POST	2610773	2610787		hrpA	14
ABI910_6POST	2611220	2611221		hrpA	1
ABI910_6POST	2611484	2611502		hrpA	18
ABI910_6POST	2611629	2611648		hrpA	19
ABI910_6POST	2611939	2611942		hrpA	3
ABI910_6POST	2612223	2612235		hrpA	12
ABI910_6POST	2613809	2613819		YPO_RS12615	10
ABI910_6POST	2614928	2614954		YPO_RS12620	26
ABI910_6POST	2615004	2615006		YPO_RS12620	2
ABI910_6POST	2615251	2615254		YPO_RS12620	3
ABI910_6POST	2615810	2615816		YPO_RS12620	6
ABI910_6POST	2616286	2616308		YPO_RS12620	22
ABI910_6POST	2617816	2617830		YPO_RS12635	14
ABI910_6POST	2618185	2618216		YPO_RS12635	31
ABI910_6POST	2618430	2618460		YPO_RS12635	30
ABI910_6POST	2618525	2618536		YPO_RS12635	11
ABI910_6POST	2618718	2618746		YPO_RS12635	28
ABI910_6POST	2618921	2618969		YPO_RS12635	48
ABI910_6POST	2619066	2619071		YPO_RS12635	5
ABI910_6POST	2619116	2619156		YPO_RS12635	40
ABI910_6POST	2619496	2619517		YPO_RS12635	21
ABI910_6POST	2620061	2620075		YPO_RS12640	14
ABI910_6POST	2621872	2621880		YPO_RS12650	8
ABI910_6POST	2622553	2622555		YPO_RS12655	2
ABI910_6POST	2622621	2622631		YPO_RS12655	10
ABI910_6POST	2622882	2622885		YPO_RS12655	3
ABI910_6POST	2622981	2622983		YPO_RS12660	2
ABI910_6POST	2623216	2623222		YPO_RS12660	6
ABI910_6POST	2623873	2623879		nifJ	6
ABI910_6POST	2623948	2623949		nifJ	1
ABI910_6POST	2624393	2624404		nifJ	11
ABI910_6POST	2624454	2624460		nifJ	6
ABI910_6POST	2624584	2624586		nifJ	2
ABI910_6POST	2624675	2624697		nifJ	22
ABI910_6POST	2624965	2624978		nifJ	13
ABI910_6POST	2625472	2625481		nifJ	9
ABI910_6POST	2625729	2625745		nifJ	16
ABI910_6POST	2625839	2625848		nifJ	9
ABI910_6POST	2626015	2626033		nifJ	18
ABI910_6POST	2626350	2626370		nifJ	20
ABI910_6POST	2626870	2626883		nifJ	13
ABI910_6POST	2627705	2627719		ttcA	14
ABI910_6POST	2627864	2627881		ttcA	17
ABI910_6POST	2627961	2627962		ttcA	1
ABI910_6POST	2628920	2628922		YPO_RS12675	2
ABI910_6POST	2628998	2629001		YPO_RS12675	3
ABI910_6POST	2631374	2631383		zntB	9
ABI910_6POST	2631415	2631420		zntB	5
ABI910_6POST	2631479	2631501		zntB	22
ABI910_6POST	2631591	2631596		zntB	5
ABI910_6POST	2631879	2631882		zntB	3
ABI910_6POST	2632546	2632568		YPO_RS12690	22
ABI910_6POST	2632640	2632641		YPO_RS12690	1
ABI910_6POST	2632888	2632898		YPO_RS12690	10
ABI910_6POST	2632997	2633021		YPO_RS12690	24
ABI910_6POST	2633958	2633961		YPO_RS12690	3
ABI910_6POST	2634852	2634870		mpaA	18
ABI910_6POST	2635364	2635380		ycjG	16
ABI910_6POST	2637433	2637451		YPO_RS12710	18
ABI910_6POST	2637484	2637486		YPO_RS12710	2
ABI910_6POST	2637675	2637684		YPO_RS12710	9
ABI910_6POST	2638105	2638112		tyrR	7
ABI910_6POST	2638979	2638993		tyrR	14
ABI910_6POST	2639237	2639242		tyrR	5
ABI910_6POST	2640270	2640281		YPO_RS12725	11
ABI910_6POST	2640340	2640350		YPO_RS12725	10
ABI910_6POST	2640388	2640399		YPO_RS12725	11
ABI910_6POST	2640947	2640968		YPO_RS12730	21
ABI910_6POST	2641460	2641463		YPO_RS12730	3
ABI910_6POST	2642408	2642414		YPO_RS12735	6
ABI910_6POST	2645557	2645573		pspF	16
ABI910_6POST	2645668	2645671		pspF	3
ABI910_6POST	2645784	2645793		pspF	9
ABI910_6POST	2645909	2645911		pspF	2
ABI910_6POST	2645963	2645976		pspF	13
ABI910_6POST	2646102	2646115		pspF	13
ABI910_6POST	2647685	2647715		sapA	30
ABI910_6POST	2647905	2647916		sapA	11
ABI910_6POST	2648281	2648285		sapA	4
ABI910_6POST	2648395	2648402		sapA	7
ABI910_6POST	2648520	2648528		sapA	8
ABI910_6POST	2649204	2649225		sapB	21
ABI910_6POST	2649421	2649426		sapB	5
ABI910_6POST	2649893	2649917		sapB	24
ABI910_6POST	2650132	2650151		sapC	19
ABI910_6POST	2650462	2650504		sapC	42
ABI910_6POST	2651317	2651323		sapD	6
ABI910_6POST	2651643	2651653		sapD	10
ABI910_6POST	2651698	2651717		sapD	19
ABI910_6POST	2652348	2652366		sapF	18
ABI910_6POST	2653192	2653196		YPO_RS12795	4
ABI910_6POST	2653344	2653353		YPO_RS12795	9
ABI910_6POST	2653466	2653472		YPO_RS12795	6
ABI910_6POST	2653553	2653609		YPO_RS12795	56
ABI910_6POST	2654205	2654206		YPO_RS12795	1
ABI910_6POST	2654342	2654349		YPO_RS12795	7
ABI910_6POST	2655465	2655477		dtpA	12
ABI910_6POST	2655509	2655553		dtpA	44
ABI910_6POST	2655591	2655593		dtpA	2
ABI910_6POST	2656054	2656098		dtpA	44
ABI910_6POST	2656307	2656320		dtpA	13
ABI910_6POST	2657290	2657299		YPO_RS12805	9
ABI910_6POST	2657365	2657382		YPO_RS12805	17
ABI910_6POST	2658196	2658202		YPO_RS12815	6
ABI910_6POST	2658240	2658261		YPO_RS12815	21
ABI910_6POST	2658366	2658373		YPO_RS12815	7
ABI910_6POST	2658529	2658554		YPO_RS12815	25
ABI910_6POST	2658660	2658668		YPO_RS12815	8
ABI910_6POST	2658778	2658781		YPO_RS12815	3
ABI910_6POST	2658834	2658871		YPO_RS12815	37
ABI910_6POST	2658871	2658877		YPO_RS12820	6
ABI910_6POST	2658917	2658925		YPO_RS12820	8
ABI910_6POST	2658980	2658994		YPO_RS12820	14
ABI910_6POST	2659149	2659223		YPO_RS12820	74
ABI910_6POST	2659576	2659589		YPO_RS12820	13
ABI910_6POST	2660337	2660349		gstA	12
ABI910_6POST	2660391	2660398		gstA	7
ABI910_6POST	2661316	2661329		pdxY	13
ABI910_6POST	2662449	2662457		tyrS	8
ABI910_6POST	2662793	2662796		tyrS	3
ABI910_6POST	2662871	2662882		tyrS	11
ABI910_6POST	2663339	2663361		pdxH	22
ABI910_6POST	2664127	2664138		YPO_RS12845	11
ABI910_6POST	2664412	2664416		anmK	4
ABI910_6POST	2664614	2664624		anmK	10
ABI910_6POST	2664936	2664948		anmK	12
ABI910_6POST	2665331	2665334		anmK	3
ABI910_6POST	2668154	2668167		YPO_RS12865	13
ABI910_6POST	2670183	2670203		eptA	20
ABI910_6POST	2670391	2670399		eptA	8
ABI910_6POST	2670488	2670526		eptA	38
ABI910_6POST	2670798	2670801		eptA	3
ABI910_6POST	2670893	2670915		eptA	22
ABI910_6POST	2672253	2672282		YPO_RS12885	29
ABI910_6POST	2673673	2673675		YPO_RS12890	2
ABI910_6POST	2674164	2674182		YPO_RS12890	18
ABI910_6POST	2674225	2674246		YPO_RS12890	21
ABI910_6POST	2674329	2674345		YPO_RS12890	16
ABI910_6POST	2674471	2674497		YPO_RS12890	26
ABI910_6POST	2674563	2674579		YPO_RS12890	16
ABI910_6POST	2674686	2674690		YPO_RS12890	4
ABI910_6POST	2674863	2674899		YPO_RS12890	36
ABI910_6POST	2674929	2674931		YPO_RS12890	2
ABI910_6POST	2675137	2675148		YPO_RS12890	11
ABI910_6POST	2675371	2675382		YPO_RS12890	11
ABI910_6POST	2675426	2675431		YPO_RS12890	5
ABI910_6POST	2675799	2675801		YPO_RS12890	2
ABI910_6POST	2675897	2675898		YPO_RS12890	1
ABI910_6POST	2675942	2675949		YPO_RS12890	7
ABI910_6POST	2676064	2676071		YPO_RS12890	7
ABI910_6POST	2677153	2677158		rnt	5
ABI910_6POST	2678810	2678825		YPO_RS12915	15
ABI910_6POST	2679410	2679419		YPO_RS12915	9
ABI910_6POST	2680137	2680162		sodB	25
ABI910_6POST	2680193	2680200		sodB	7
ABI910_6POST	2682358	2682366		YPO_RS12935	8
ABI910_6POST	2682620	2682622		YPO_RS12935	2
ABI910_6POST	2683549	2683559		YPO_RS12940	10
ABI910_6POST	2684214	2684226		YPO_RS12940	12
ABI910_6POST	2685225	2685234		cfa	9
ABI910_6POST	2685585	2685592		cfa	7
ABI910_6POST	2686377	2686385		YPO_RS12950	8
ABI910_6POST	2686809	2686810		YPO_RS12950	1
ABI910_6POST	2686881	2686906		YPO_RS12950	25
ABI910_6POST	2687745	2687765		YPO_RS12960	20
ABI910_6POST	2688098	2688115		YPO_RS12960	17
ABI910_6POST	2688283	2688287		YPO_RS12960	4
ABI910_6POST	2690158	2690168		pykF	10
ABI910_6POST	2690699	2690703		pykF	4
ABI910_6POST	2692154	2692156		YPO_RS12985	2
ABI910_6POST	2692846	2692865		YPO_RS12990	19
ABI910_6POST	2692942	2692946		YPO_RS12990	4
ABI910_6POST	2693019	2693027		YPO_RS12990	8
ABI910_6POST	2693152	2693155		YPO_RS12990	3
ABI910_6POST	2693359	2693505		YPO_RS12990	146
ABI910_6POST	2693615	2693620		YPO_RS12990	5
ABI910_6POST	2693661	2693663		YPO_RS12990	2
ABI910_6POST	2694116	2694217		YPO_RS12995	101
ABI910_6POST	2694266	2694277		YPO_RS12995	11
ABI910_6POST	2694371	2694413		YPO_RS12995	42
ABI910_6POST	2694457	2694478		YPO_RS12995	21
ABI910_6POST	2694556	2694565		YPO_RS12995	9
ABI910_6POST	2694634	2694635		YPO_RS13000	1
ABI910_6POST	2694997	2695069		YPO_RS13000	72
ABI910_6POST	2695203	2695221		YPO_RS13000	18
ABI910_6POST	2695281	2695286		YPO_RS13000	5
ABI910_6POST	2695345	2695367		YPO_RS13000	22
ABI910_6POST	2695436	2695439		YPO_RS13000	3
ABI910_6POST	2695561	2695575		YPO_RS13000	14
ABI910_6POST	2696468	2696471		sufS	3
ABI910_6POST	2696816	2696820		sufS	4
ABI910_6POST	2696870	2696886		sufS	16
ABI910_6POST	2697811	2697818		sufD	7
ABI910_6POST	2698420	2698444		sufD	24
ABI910_6POST	2698649	2698659		sufD	10
ABI910_6POST	2699008	2699009		sufC	1
ABI910_6POST	2699572	2699577		sufC	5
ABI910_6POST	2700344	2700348		sufB	4
ABI910_6POST	2700591	2700607		sufB	16
ABI910_6POST	2700905	2700918		sufB	13
ABI910_6POST	2701142	2701149		sufB	7
ABI910_6POST	2702449	2702450		YPO_RS13035	1
ABI910_6POST	2702537	2702541		YPO_RS13035	4
ABI910_6POST	2703286	2703291		YPO_RS13040	5
ABI910_6POST	2703361	2703364		YPO_RS13040	3
ABI910_6POST	2704566	2704576		YPO_RS13040	10
ABI910_6POST	2705444	2705485		YPO_RS13040	41
ABI910_6POST	2706843	2706857		ydiK	14
ABI910_6POST	2706998	2707018		ydiK	20
ABI910_6POST	2707237	2707260		ydiK	23
ABI910_6POST	2707291	2707301		ydiK	10
ABI910_6POST	2707360	2707377		ydiK	17
ABI910_6POST	2708723	2708741		ppsA	18
ABI910_6POST	2709280	2709281		ppsA	1
ABI910_6POST	2709613	2709616		ppsA	3
ABI910_6POST	2709684	2709690		ppsA	6
ABI910_6POST	2709885	2709895		ppsA	10
ABI910_6POST	2709955	2709959		ppsA	4
ABI910_6POST	2710552	2710559		ppsA	7
ABI910_6POST	2710626	2710632		ppsA	6
ABI910_6POST	2712439	2712470		YPO_RS13065	31
ABI910_6POST	2712638	2712643		YPO_RS13065	5
ABI910_6POST	2712750	2712758		YPO_RS13065	8
ABI910_6POST	2712963	2712971		YPO_RS13065	8
ABI910_6POST	2714921	2714928		YPO_RS13075	7
ABI910_6POST	2715328	2715342		YPO_RS13075	14
ABI910_6POST	2715486	2715489		YPO_RS13075	3
ABI910_6POST	2715957	2715982		YPO_RS13080	25
ABI910_6POST	2716032	2716051		YPO_RS13080	19
ABI910_6POST	2716170	2716178		YPO_RS13080	8
ABI910_6POST	2716582	2716618		arnF	36
ABI910_6POST	2716943	2716948		arnF	5
ABI910_6POST	2717137	2717140		arnE	3
ABI910_6POST	2717286	2717309		arnE	23
ABI910_6POST	2717306	2717326		arnT	20
ABI910_6POST	2717705	2717711		arnT	6
ABI910_6POST	2717876	2717886		arnT	10
ABI910_6POST	2717991	2717998		arnT	7
ABI910_6POST	2718055	2718061		arnT	6
ABI910_6POST	2718142	2718148		arnT	6
ABI910_6POST	2718562	2718572		arnT	10
ABI910_6POST	2718654	2718656		arnT	2
ABI910_6POST	2719327	2719344		YPO_RS13105	17
ABI910_6POST	2719416	2719427		YPO_RS13105	11
ABI910_6POST	2719547	2719561		YPO_RS13105	14
ABI910_6POST	2719832	2719847		YPO_RS13105	15
ABI910_6POST	2719894	2719895		arnA	1
ABI910_6POST	2720185	2720194		arnA	9
ABI910_6POST	2720904	2720912		arnA	8
ABI910_6POST	2721161	2721167		arnA	6
ABI910_6POST	2721432	2721489		arnA	57
ABI910_6POST	2721709	2721724		arnA	15
ABI910_6POST	2723419	2723428		arnB	9
ABI910_6POST	2723576	2723580		arnB	4
ABI910_6POST	2723908	2723910		arnB	2
ABI910_6POST	2724905	2724915		btuD	10
ABI910_6POST	2725163	2725173		YPO_RS13130	10
ABI910_6POST	2725342	2725371		YPO_RS13130	29
ABI910_6POST	2725403	2725407		YPO_RS13130	4
ABI910_6POST	2725446	2725469		YPO_RS13130	23
ABI910_6POST	2725598	2725604		YPO_RS13130	6
ABI910_6POST	2725674	2725680		YPO_RS13130	6
ABI910_6POST	2726411	2726417		btuC	6
ABI910_6POST	2726556	2726569		btuC	13
ABI910_6POST	2727004	2727007		YPO_RS13140	3
ABI910_6POST	2728916	2728917		pheT	1
ABI910_6POST	2729115	2729116		pheT	1
ABI910_6POST	2729768	2729784		pheT	16
ABI910_6POST	2729905	2729911		pheT	6
ABI910_6POST	2730090	2730117		pheT	27
ABI910_6POST	2730299	2730304		pheT	5
ABI910_6POST	2730666	2730671		pheS	5
ABI910_6POST	2732185	2732196		rplT	11
ABI910_6POST	2732496	2732505		rpmI	9
ABI910_6POST	2732658	2732670		infC	12
ABI910_6POST	2734362	2734374		thrS	12
ABI910_6POST	2735114	2735130		thrS	16
ABI910_6POST	2736493	2736495		YPO_RS13190	2
ABI910_6POST	2737674	2737686		YPO_RS13195	12
ABI910_6POST	2738476	2738479		YPO_RS13200	3
ABI910_6POST	2738808	2738812		yfeA	4
ABI910_6POST	2738953	2738965		yfeA	12
ABI910_6POST	2739721	2739782		yfeB	61
ABI910_6POST	2739961	2739968		yfeB	7
ABI910_6POST	2740447	2740450		yfeB	3
ABI910_6POST	2740544	2740548		yfeB	4
ABI910_6POST	2741619	2741635		yfeD	16
ABI910_6POST	2741819	2741821		yfeD	2
ABI910_6POST	2742873	2742905		YPO_RS13230	32
ABI910_6POST	2743354	2743363		YPO_RS13230	9
ABI910_6POST	2743908	2743913		YPO_RS13235	5
ABI910_6POST	2744081	2744104		YPO_RS13235	23
ABI910_6POST	2745977	2745979		YPO_RS13245	2
ABI910_6POST	2746115	2746143		YPO_RS13245	28
ABI910_6POST	2746434	2746438		YPO_RS13245	4
ABI910_6POST	2746603	2746606		YPO_RS13245	3
ABI910_6POST	2746679	2746689		YPO_RS13245	10
ABI910_6POST	2747663	2747738		solA	75
ABI910_6POST	2748025	2748027		solA	2
ABI910_6POST	2748579	2748588		YPO_RS13255	9
ABI910_6POST	2748625	2748627		YPO_RS13255	2
ABI910_6POST	2749120	2749126		YPO_RS13255	6
ABI910_6POST	2749907	2749925		YPO_RS13265	18
ABI910_6POST	2750016	2750022		YPO_RS13265	6
ABI910_6POST	2750271	2750285		YPO_RS13265	14
ABI910_6POST	2750327	2750350		YPO_RS13265	23
ABI910_6POST	2750523	2750534		YPO_RS13265	11
ABI910_6POST	2753042	2753064		YPO_RS13280	22
ABI910_6POST	2753171	2753199		YPO_RS13280	28
ABI910_6POST	2753233	2753244		YPO_RS13280	11
ABI910_6POST	2753605	2753627		YPO_RS13280	22
ABI910_6POST	2754265	2754280		YPO_RS13285	15
ABI910_6POST	2756227	2756251		YPO_RS13295	24
ABI910_6POST	2756433	2756436		YPO_RS13295	3
ABI910_6POST	2756691	2756723		YPO_RS13295	32
ABI910_6POST	2757517	2757576		YPO_RS13305	59
ABI910_6POST	2757664	2757674		YPO_RS13305	10
ABI910_6POST	2758485	2758493		YPO_RS13305	8
ABI910_6POST	2758533	2758544		YPO_RS13305	11
ABI910_6POST	2758587	2758591		YPO_RS13305	4
ABI910_6POST	2758810	2758824		fae	14
ABI910_6POST	2759472	2759479		YPO_RS13315	7
ABI910_6POST	2759537	2759549		YPO_RS13315	12
ABI910_6POST	2759758	2759778		YPO_RS13315	20
ABI910_6POST	2760794	2760822		cas6f	28
ABI910_6POST	2760921	2760924		cas6f	3
ABI910_6POST	2760957	2760985		csy3	28
ABI910_6POST	2761570	2761601		csy3	31
ABI910_6POST	2761631	2761634		csy3	3
ABI910_6POST	2762205	2762212		csy2	7
ABI910_6POST	2762572	2762592		csy2	20
ABI910_6POST	2762766	2762776		csy2	10
ABI910_6POST	2762992	2762998		csy1	6
ABI910_6POST	2763066	2763067		csy1	1
ABI910_6POST	2763113	2763120		csy1	7
ABI910_6POST	2763430	2763436		csy1	6
ABI910_6POST	2764991	2764997		cas3f	6
ABI910_6POST	2765460	2765461		cas3f	1
ABI910_6POST	2765491	2765520		cas3f	29
ABI910_6POST	2766045	2766052		cas3f	7
ABI910_6POST	2766257	2766291		cas3f	34
ABI910_6POST	2766356	2766388		cas3f	32
ABI910_6POST	2766520	2766544		cas3f	24
ABI910_6POST	2767274	2767278		cas3f	4
ABI910_6POST	2767360	2767366		cas3f	6
ABI910_6POST	2767530	2767532		cas3f	2
ABI910_6POST	2768189	2768208		cas1f	19
ABI910_6POST	2770171	2770222		YPO_RS13350	51
ABI910_6POST	2771014	2771016		YPO_RS13350	2
ABI910_6POST	2771086	2771097		YPO_RS13350	11
ABI910_6POST	2772527	2772539		YPO_RS13355	12
ABI910_6POST	2773238	2773241		YPO_RS13355	3
ABI910_6POST	2773409	2773426		YPO_RS13360	17
ABI910_6POST	2773730	2773741		YPO_RS13360	11
ABI910_6POST	2773779	2773799		YPO_RS13360	20
ABI910_6POST	2774089	2774104		YPO_RS13360	15
ABI910_6POST	2774742	2774745		YPO_RS13365	3
ABI910_6POST	2774990	2775007		YPO_RS13365	17
ABI910_6POST	2775451	2775456		YPO_RS13365	5
ABI910_6POST	2775548	2775553		YPO_RS13370	5
ABI910_6POST	2775682	2775697		YPO_RS13370	15
ABI910_6POST	2775829	2775840		YPO_RS13370	11
ABI910_6POST	2775873	2775875		YPO_RS13370	2
ABI910_6POST	2776060	2776081		YPO_RS13370	21
ABI910_6POST	2776230	2776239		YPO_RS13370	9
ABI910_6POST	2776318	2776340		YPO_RS13370	22
ABI910_6POST	2776685	2776686		YPO_RS13375	1
ABI910_6POST	2776768	2776772		YPO_RS13375	4
ABI910_6POST	2777429	2777432		YPO_RS13375	3
ABI910_6POST	2777660	2777665		YPO_RS13380	5
ABI910_6POST	2777736	2777746		YPO_RS13380	10
ABI910_6POST	2778937	2778952		YPO_RS13385	15
ABI910_6POST	2779319	2779325		YPO_RS13385	6
ABI910_6POST	2781287	2781295		YPO_RS13395	8
ABI910_6POST	2781568	2781576		YPO_RS13395	8
ABI910_6POST	2782006	2782021		YPO_RS13395	15
ABI910_6POST	2783173	2783182		ugpC	9
ABI910_6POST	2783414	2783447		ugpC	33
ABI910_6POST	2784046	2784066		YPO_RS13405	20
ABI910_6POST	2784935	2784942		YPO_RS13410	7
ABI910_6POST	2785607	2785631		YPO_RS13415	24
ABI910_6POST	2786361	2786365		YPO_RS13425	4
ABI910_6POST	2786822	2786825		YPO_RS13430	3
ABI910_6POST	2786935	2786940		YPO_RS13430	5
ABI910_6POST	2787019	2787026		YPO_RS13430	7
ABI910_6POST	2787272	2787274		YPO_RS13430	2
ABI910_6POST	2787345	2787348		YPO_RS13430	3
ABI910_6POST	2787565	2787571		YPO_RS13430	6
ABI910_6POST	2787608	2787610		YPO_RS13430	2
ABI910_6POST	2787809	2787836		YPO_RS13430	27
ABI910_6POST	2787928	2787933		YPO_RS13430	5
ABI910_6POST	2788082	2788097		YPO_RS13430	15
ABI910_6POST	2788201	2788203		YPO_RS13430	2
ABI910_6POST	2788257	2788288		YPO_RS13430	31
ABI910_6POST	2788351	2788365		YPO_RS13430	14
ABI910_6POST	2789209	2789215		YPO_RS13440	6
ABI910_6POST	2789691	2789722		YPO_RS13445	31
ABI910_6POST	2790711	2790714		cdiA	3
ABI910_6POST	2790809	2790832		cdiA	23
ABI910_6POST	2791352	2791382		cdiA	30
ABI910_6POST	2791881	2791901		cdiA	20
ABI910_6POST	2792181	2792202		cdiA	21
ABI910_6POST	2792253	2792298		cdiA	45
ABI910_6POST	2792509	2792515		cdiA	6
ABI910_6POST	2792575	2792579		cdiA	4
ABI910_6POST	2792755	2792800		cdiA	45
ABI910_6POST	2792841	2792852		cdiA	11
ABI910_6POST	2792909	2792915		cdiA	6
ABI910_6POST	2793466	2793482		cdiA	16
ABI910_6POST	2793905	2793914		cdiA	9
ABI910_6POST	2794031	2794034		cdiA	3
ABI910_6POST	2794199	2794211		cdiA	12
ABI910_6POST	2794452	2794477		cdiA	25
ABI910_6POST	2794709	2794718		cdiA	9
ABI910_6POST	2795107	2795120		cdiA	13
ABI910_6POST	2795441	2795480		cdiA	39
ABI910_6POST	2795585	2795603		cdiA	18
ABI910_6POST	2795822	2795824		cdiA	2
ABI910_6POST	2795966	2796011		cdiA	45
ABI910_6POST	2796200	2796202		cdiA	2
ABI910_6POST	2796343	2796376		cdiA	33
ABI910_6POST	2796566	2796573		cdiA	7
ABI910_6POST	2796608	2796610		cdiA	2
ABI910_6POST	2796642	2796673		cdiA	31
ABI910_6POST	2797058	2797062		cdiA	4
ABI910_6POST	2797196	2797209		cdiA	13
ABI910_6POST	2797278	2797291		cdiA	13
ABI910_6POST	2797470	2797509		cdiA	39
ABI910_6POST	2797617	2797619		cdiA	2
ABI910_6POST	2798094	2798098		YPO_RS13455	4
ABI910_6POST	2798239	2798245		YPO_RS13455	6
ABI910_6POST	2798376	2798388		YPO_RS13455	12
ABI910_6POST	2799436	2799440		YPO_RS13455	4
ABI910_6POST	2800230	2800233		YPO_RS13460	3
ABI910_6POST	2800411	2800422		YPO_RS13460	11
ABI910_6POST	2800743	2800758		YPO_RS13460	15
ABI910_6POST	2800852	2800859		YPO_RS13460	7
ABI910_6POST	2801034	2801038		YPO_RS13460	4
ABI910_6POST	2802645	2802661		YPO_RS13470	16
ABI910_6POST	2802758	2802782		YPO_RS13470	24
ABI910_6POST	2803025	2803030		YPO_RS13470	5
ABI910_6POST	2803189	2803194		YPO_RS13470	5
ABI910_6POST	2803313	2803328		YPO_RS13470	15
ABI910_6POST	2803592	2803643		YPO_RS13470	51
ABI910_6POST	2803845	2803851		YPO_RS13470	6
ABI910_6POST	2803900	2803920		YPO_RS13470	20
ABI910_6POST	2804779	2804784		YPO_RS13475	5
ABI910_6POST	2805792	2805807		YPO_RS13475	15
ABI910_6POST	2807962	2807970		YPO_RS13485	8
ABI910_6POST	2808415	2808421		YPO_RS13490	6
ABI910_6POST	2808807	2808826		YPO_RS13490	19
ABI910_6POST	2808985	2808993		YPO_RS13490	8
ABI910_6POST	2809153	2809178		YPO_RS13490	25
ABI910_6POST	2809290	2809297		YPO_RS13495	7
ABI910_6POST	2809362	2809363		YPO_RS13495	1
ABI910_6POST	2809492	2809495		YPO_RS13495	3
ABI910_6POST	2809801	2809807		YPO_RS13495	6
ABI910_6POST	2809877	2809902		YPO_RS13495	25
ABI910_6POST	2810013	2810021		YPO_RS13495	8
ABI910_6POST	2810063	2810069		YPO_RS13495	6
ABI910_6POST	2810358	2810359		YPO_RS13495	1
ABI910_6POST	2810720	2810726		YPO_RS13495	6
ABI910_6POST	2810910	2810913		YPO_RS13500	3
ABI910_6POST	2811072	2811073		YPO_RS13500	1
ABI910_6POST	2811538	2811540		YPO_RS13500	2
ABI910_6POST	2812059	2812070		YPO_RS13505	11
ABI910_6POST	2812392	2812406		YPO_RS13505	14
ABI910_6POST	2812472	2812493		YPO_RS13505	21
ABI910_6POST	2812653	2812665		YPO_RS13505	12
ABI910_6POST	2813945	2813956		YPO_RS13510	11
ABI910_6POST	2814177	2814210		YPO_RS13510	33
ABI910_6POST	2814865	2814873		YPO_RS13515	8
ABI910_6POST	2815013	2815015		YPO_RS13515	2
ABI910_6POST	2815694	2815720		YPO_RS13520	26
ABI910_6POST	2816113	2816129		YPO_RS13520	16
ABI910_6POST	2817770	2817784		rhtA	14
ABI910_6POST	2818016	2818018		rhtA	2
ABI910_6POST	2818048	2818066		rhtA	18
ABI910_6POST	2818328	2818385		rhtA	57
ABI910_6POST	2818417	2818426		rhtA	9
ABI910_6POST	2819330	2819348		tam	18
ABI910_6POST	2819589	2819605		tam	16
ABI910_6POST	2819736	2819737		tam	1
ABI910_6POST	2821144	2821151		YPO_RS13550	7
ABI910_6POST	2822860	2822865		glnH	5
ABI910_6POST	2822914	2822920		glnH	6
ABI910_6POST	2823104	2823110		glnH	6
ABI910_6POST	2823639	2823642		glnP	3
ABI910_6POST	2823728	2823750		glnP	22
ABI910_6POST	2824272	2824274		glnQ	2
ABI910_6POST	2824283	2824284		glnQ	1
ABI910_6POST	2824932	2824940		YPO_RS13570	8
ABI910_6POST	2824974	2825048		YPO_RS13570	74
ABI910_6POST	2825247	2825265		YPO_RS13570	18
ABI910_6POST	2825889	2825899		YPO_RS13570	10
ABI910_6POST	2826069	2826073		YPO_RS13570	4
ABI910_6POST	2826177	2826206		YPO_RS13570	29
ABI910_6POST	2826349	2826356		YPO_RS13575	7
ABI910_6POST	2826433	2826448		YPO_RS13575	15
ABI910_6POST	2826521	2826532		YPO_RS13575	11
ABI910_6POST	2826750	2826765		YPO_RS13575	15
ABI910_6POST	2826928	2826987		YPO_RS13575	59
ABI910_6POST	2827116	2827177		YPO_RS13575	61
ABI910_6POST	2827594	2827615		YPO_RS13580	21
ABI910_6POST	2827781	2827791		YPO_RS13580	10
ABI910_6POST	2827875	2827916		YPO_RS13580	41
ABI910_6POST	2827955	2827983		YPO_RS13580	28
ABI910_6POST	2828037	2828066		YPO_RS13580	29
ABI910_6POST	2828957	2828964		rlmF	7
ABI910_6POST	2829038	2829049		rlmF	11
ABI910_6POST	2829154	2829206		rlmF	52
ABI910_6POST	2831348	2831350		ybiB	2
ABI910_6POST	2831456	2831475		ybiB	19
ABI910_6POST	2831607	2831617		ybiB	10
ABI910_6POST	2832203	2832210		menE	7
ABI910_6POST	2832320	2832323		menE	3
ABI910_6POST	2832473	2832481		menE	8
ABI910_6POST	2832676	2832712		menE	36
ABI910_6POST	2832919	2832968		menE	49
ABI910_6POST	2833073	2833082		menE	9
ABI910_6POST	2833216	2833223		menE	7
ABI910_6POST	2833274	2833288		menE	14
ABI910_6POST	2833464	2833482		menC	18
ABI910_6POST	2833770	2833771		menC	1
ABI910_6POST	2833805	2833826		menC	21
ABI910_6POST	2833897	2833908		menC	11
ABI910_6POST	2834230	2834233		menC	3
ABI910_6POST	2834332	2834351		menB	19
ABI910_6POST	2834530	2834539		menB	9
ABI910_6POST	2834828	2834840		menB	12
ABI910_6POST	2835020	2835029		menB	9
ABI910_6POST	2835397	2835404		menH	7
ABI910_6POST	2835490	2835493		menH	3
ABI910_6POST	2835975	2835983		menD	8
ABI910_6POST	2836076	2836092		menD	16
ABI910_6POST	2836384	2836406		menD	22
ABI910_6POST	2836635	2836639		menD	4
ABI910_6POST	2836721	2836742		menD	21
ABI910_6POST	2836900	2836938		menD	38
ABI910_6POST	2837117	2837133		menD	16
ABI910_6POST	2837612	2837613		menD	1
ABI910_6POST	2838163	2838167		menF	4
ABI910_6POST	2838795	2838816		menF	21
ABI910_6POST	2839879	2839911		YPO_RS13635	32
ABI910_6POST	2840093	2840113		YPO_RS13635	20
ABI910_6POST	2840146	2840152		YPO_RS13635	6
ABI910_6POST	2840378	2840423		YPO_RS13635	45
ABI910_6POST	2841236	2841238		YPO_RS13640	2
ABI910_6POST	2842573	2842605		YPO_RS13645	32
ABI910_6POST	2843304	2843308		YPO_RS13645	4
ABI910_6POST	2843732	2843766		YPO_RS13645	34
ABI910_6POST	2843858	2843861		YPO_RS13645	3
ABI910_6POST	2844797	2844834		YPO_RS13655	37
ABI910_6POST	2845147	2845155		YPO_RS13655	8
ABI910_6POST	2845733	2845739		YPO_RS13655	6
ABI910_6POST	2846769	2846772		YPO_RS13660	3
ABI910_6POST	2846906	2846933		YPO_RS13660	27
ABI910_6POST	2849476	2849490		YPO_RS13670	14
ABI910_6POST	2850025	2850036		YPO_RS13670	11
ABI910_6POST	2850275	2850284		YPO_RS13670	9
ABI910_6POST	2851472	2851489		idnO	17
ABI910_6POST	2851669	2851681		idnO	12
ABI910_6POST	2851891	2851911		idnO	20
ABI910_6POST	2852265	2852284		YPO_RS13680	19
ABI910_6POST	2852628	2852638		YPO_RS13680	10
ABI910_6POST	2853169	2853181		YPO_RS13685	12
ABI910_6POST	2853245	2853285		YPO_RS13685	40
ABI910_6POST	2853651	2853657		YPO_RS13690	6
ABI910_6POST	2854060	2854076		YPO_RS13690	16
ABI910_6POST	2854453	2854466		YPO_RS13690	13
ABI910_6POST	2854594	2854598		YPO_RS13690	4
ABI910_6POST	2854704	2854709		YPO_RS13690	5
ABI910_6POST	2855271	2855321		nuoN	50
ABI910_6POST	2855988	2856024		nuoN	36
ABI910_6POST	2856061	2856067		nuoN	6
ABI910_6POST	2856336	2856339		nuoN	3
ABI910_6POST	2856548	2856589		nuoM	41
ABI910_6POST	2856639	2856681		nuoM	42
ABI910_6POST	2856859	2856892		nuoM	33
ABI910_6POST	2856928	2856947		nuoM	19
ABI910_6POST	2857006	2857019		nuoM	13
ABI910_6POST	2857329	2857330		nuoM	1
ABI910_6POST	2857786	2857809		nuoM	23
ABI910_6POST	2857889	2857894		nuoM	5
ABI910_6POST	2858068	2858079		nuoM	11
ABI910_6POST	2858180	2858195		nuoL	15
ABI910_6POST	2858319	2858358		nuoL	39
ABI910_6POST	2858465	2858467		nuoL	2
ABI910_6POST	2858537	2858608		nuoL	71
ABI910_6POST	2858793	2858794		nuoL	1
ABI910_6POST	2859163	2859165		nuoL	2
ABI910_6POST	2859276	2859281		nuoL	5
ABI910_6POST	2859655	2859658		nuoL	3
ABI910_6POST	2859839	2859850		nuoL	11
ABI910_6POST	2860099	2860114		nuoK	15
ABI910_6POST	2860456	2860464		nuoJ	8
ABI910_6POST	2860516	2860522		nuoJ	6
ABI910_6POST	2860893	2860895		nuoI	2
ABI910_6POST	2861716	2861718		nuoH	2
ABI910_6POST	2862087	2862109		nuoH	22
ABI910_6POST	2862377	2862388		nuoG	11
ABI910_6POST	2862537	2862558		nuoG	21
ABI910_6POST	2864022	2864057		nuoG	35
ABI910_6POST	2865179	2865182		nuoF	3
ABI910_6POST	2865315	2865320		nuoF	5
ABI910_6POST	2866670	2866693		nuoE	23
ABI910_6POST	2867211	2867212		nuoC	1
ABI910_6POST	2867262	2867274		nuoC	12
ABI910_6POST	2867625	2867637		nuoC	12
ABI910_6POST	2868001	2868007		nuoC	6
ABI910_6POST	2868133	2868150		nuoC	17
ABI910_6POST	2868248	2868259		nuoC	11
ABI910_6POST	2868403	2868408		nuoC	5
ABI910_6POST	2868503	2868504		nuoC	1
ABI910_6POST	2871100	2871109		lrhA	9
ABI910_6POST	2871248	2871254		lrhA	6
ABI910_6POST	2871385	2871386		lrhA	1
ABI910_6POST	2871619	2871659		lrhA	40
ABI910_6POST	2874357	2874359		yfbR	2
ABI910_6POST	2875407	2875410		YPO_RS13775	3
ABI910_6POST	2875582	2875594		YPO_RS13775	12
ABI910_6POST	2875865	2875874		YPO_RS13775	9
ABI910_6POST	2876709	2876729		YPO_RS13775	20
ABI910_6POST	2877615	2877641		YPO_RS13780	26
ABI910_6POST	2877832	2877841		YPO_RS13780	9
ABI910_6POST	2878174	2878185		YPO_RS13785	11
ABI910_6POST	2878237	2878238		YPO_RS13785	1
ABI910_6POST	2878963	2878964		YPO_RS13790	1
ABI910_6POST	2879123	2879134		YPO_RS13790	11
ABI910_6POST	2879299	2879300		YPO_RS13790	1
ABI910_6POST	2879741	2879749		ackA	8
ABI910_6POST	2879905	2879907		ackA	2
ABI910_6POST	2880107	2880114		ackA	7
ABI910_6POST	2880550	2880561		ackA	11
ABI910_6POST	2881916	2881928		pta	12
ABI910_6POST	2882217	2882218		pta	1
ABI910_6POST	2883072	2883082		pta	10
ABI910_6POST	2884082	2884097		YPO_RS13805	15
ABI910_6POST	2884924	2884926		YPO_RS13810	2
ABI910_6POST	2885124	2885132		YPO_RS13810	8
ABI910_6POST	2885170	2885180		YPO_RS13810	10
ABI910_6POST	2885774	2885782		YPO_RS13815	8
ABI910_6POST	2885900	2885922		YPO_RS13820	22
ABI910_6POST	2886220	2886257		YPO_RS13820	37
ABI910_6POST	2886320	2886326		YPO_RS13820	6
ABI910_6POST	2886715	2886729		YPO_RS13820	14
ABI910_6POST	2886802	2886805		YPO_RS13820	3
ABI910_6POST	2886848	2886868		YPO_RS13820	20
ABI910_6POST	2886899	2886931		YPO_RS13820	32
ABI910_6POST	2887091	2887932		YPO_RS13825	841
ABI910_6POST	2887989	2893967		YPO_RS13830	5978
ABI910_6POST	2894374	2894922		YPO_RS13835	548
ABI910_6POST	2895617	2896471		YPO_RS13840	854
ABI910_6POST	2896777	2898103		YPO_RS13845	1326
ABI910_6POST	2898135	2898303		YPO_RS13845	168
ABI910_6POST	2898338	2900263		iolD	1925
ABI910_6POST	2901988	2901989		YPO_RS13860	1
ABI910_6POST	2902114	2902130		YPO_RS13860	16
ABI910_6POST	2902725	2902735		YPO_RS13865	10
ABI910_6POST	2902799	2902816		YPO_RS13865	17
ABI910_6POST	2902907	2902924		YPO_RS13865	17
ABI910_6POST	2903048	2903059		YPO_RS13865	11
ABI910_6POST	2903384	2903386		YPO_RS13865	2
ABI910_6POST	2903433	2903441		YPO_RS13865	8
ABI910_6POST	2903475	2903480		YPO_RS13865	5
ABI910_6POST	2903679	2903715		YPO_RS13865	36
ABI910_6POST	2904375	2904379		YPO_RS13870	4
ABI910_6POST	2904529	2904532		YPO_RS13870	3
ABI910_6POST	2904604	2904611		YPO_RS13870	7
ABI910_6POST	2905177	2905191		YPO_RS13870	14
ABI910_6POST	2905284	2905324		YPO_RS13875	40
ABI910_6POST	2905727	2905737		YPO_RS13875	10
ABI910_6POST	2905788	2905814		YPO_RS13875	26
ABI910_6POST	2905857	2905866		YPO_RS13875	9
ABI910_6POST	2906526	2906540		iolC	14
ABI910_6POST	2906968	2907007		iolC	39
ABI910_6POST	2907155	2907158		iolC	3
ABI910_6POST	2907262	2907281		iolC	19
ABI910_6POST	2907335	2907337		iolC	2
ABI910_6POST	2907560	2907571		iolC	11
ABI910_6POST	2907697	2907735		iolC	38
ABI910_6POST	2907898	2907904		iolC	6
ABI910_6POST	2907973	2908020		iolC	47
ABI910_6POST	2908154	2908160		iolC	6
ABI910_6POST	2908565	2908575		iolE	10
ABI910_6POST	2909009	2909031		iolE	22
ABI910_6POST	2909408	2909416		iolE	8
ABI910_6POST	2910159	2910172		iolB	13
ABI910_6POST	2910599	2910610		YPO_RS13895	11
ABI910_6POST	2911697	2911728		YPO_RS13900	31
ABI910_6POST	2912388	2912397		YPO_RS13900	9
ABI910_6POST	2913772	2913776		YPO_RS13915	4
ABI910_6POST	2914770	2914775		YPO_RS13920	5
ABI910_6POST	2915419	2915427		YPO_RS13925	8
ABI910_6POST	2919141	2919147		lipA	6
ABI910_6POST	2919616	2919625		lipA	9
ABI910_6POST	2919704	2919705		lipA	1
ABI910_6POST	2920702	2920714		lipB	12
ABI910_6POST	2920873	2920882		lipB	9
ABI910_6POST	2921211	2921225		YPO_RS13960	14
ABI910_6POST	2921694	2921699		dacA	5
ABI910_6POST	2921789	2921795		dacA	6
ABI910_6POST	2921859	2921872		dacA	13
ABI910_6POST	2922514	2922519		dacA	5
ABI910_6POST	2923488	2923522		rlpA	34
ABI910_6POST	2923601	2923608		rlpA	7
ABI910_6POST	2923649	2923671		rlpA	22
ABI910_6POST	2923815	2923821		rlpA	6
ABI910_6POST	2924303	2924305		mrdB	2
ABI910_6POST	2924444	2924449		mrdB	5
ABI910_6POST	2924764	2924768		mrdB	4
ABI910_6POST	2925163	2925187		mrdB	24
ABI910_6POST	2925692	2925695		mrdA	3
ABI910_6POST	2925818	2925824		mrdA	6
ABI910_6POST	2925990	2925997		mrdA	7
ABI910_6POST	2926138	2926164		mrdA	26
ABI910_6POST	2926496	2926511		mrdA	15
ABI910_6POST	2927303	2927305		mrdA	2
ABI910_6POST	2927710	2927711		rlmH	1
ABI910_6POST	2927810	2927819		rlmH	9
ABI910_6POST	2927857	2927858		rlmH	1
ABI910_6POST	2928239	2928255		rsfS	16
ABI910_6POST	2928698	2928732		nadD	34
ABI910_6POST	2929617	2929640		holA	23
ABI910_6POST	2929693	2929703		holA	10
ABI910_6POST	2929849	2929850		holA	1
ABI910_6POST	2930217	2930240		holA	23
ABI910_6POST	2930836	2930846		lptE	10
ABI910_6POST	2931497	2931502		leuS	5
ABI910_6POST	2931945	2931962		leuS	17
ABI910_6POST	2932171	2932183		leuS	12
ABI910_6POST	2932742	2932754		leuS	12
ABI910_6POST	2932813	2932815		leuS	2
ABI910_6POST	2932847	2932858		leuS	11
ABI910_6POST	2932965	2932994		leuS	29
ABI910_6POST	2933214	2933216		leuS	2
ABI910_6POST	2933363	2933367		leuS	4
ABI910_6POST	2933761	2933773		YPO_RS14015	12
ABI910_6POST	2934089	2934094		YPO_RS14015	5
ABI910_6POST	2934539	2934553		YPO_RS14020	14
ABI910_6POST	2934824	2934828		YPO_RS14020	4
ABI910_6POST	2934901	2934902		YPO_RS14020	1
ABI910_6POST	2934966	2934971		YPO_RS14020	5
ABI910_6POST	2935047	2935053		YPO_RS14020	6
ABI910_6POST	2935272	2935287		gltK	15
ABI910_6POST	2935866	2935874		YPO_RS14030	8
ABI910_6POST	2936056	2936059		YPO_RS14030	3
ABI910_6POST	2936256	2936266		YPO_RS14030	10
ABI910_6POST	2936484	2936511		YPO_RS14030	27
ABI910_6POST	2938966	2939009		lnt	43
ABI910_6POST	2939235	2939238		lnt	3
ABI910_6POST	2939353	2939358		lnt	5
ABI910_6POST	2939740	2939741		lnt	1
ABI910_6POST	2940164	2940166		corC	2
ABI910_6POST	2941290	2941296		ybeY	6
ABI910_6POST	2941866	2941868		YPO_RS14055	2
ABI910_6POST	2942244	2942259		YPO_RS14055	15
ABI910_6POST	2942882	2942888		miaB	6
ABI910_6POST	2943913	2943929		miaB	16
ABI910_6POST	2944106	2944131		miaB	25
ABI910_6POST	2945087	2945089		ubiF	2
ABI910_6POST	2945611	2945612		ubiF	1
ABI910_6POST	2947062	2947072		asnB	10
ABI910_6POST	2947665	2947667		asnB	2
ABI910_6POST	2947794	2947799		asnB	5
ABI910_6POST	2947903	2947933		asnB	30
ABI910_6POST	2948166	2948190		asnB	24
ABI910_6POST	2948224	2948273		asnB	49
ABI910_6POST	2948411	2948440		asnB	29
ABI910_6POST	2949039	2949055		YPO_RS14100	16
ABI910_6POST	2950701	2950742		YPO_RS14105	41
ABI910_6POST	2951870	2951880		nagA	10
ABI910_6POST	2952587	2952588		nagB	1
ABI910_6POST	2954292	2954298		YPO_RS14120	6
ABI910_6POST	2954467	2954508		YPO_RS14120	41
ABI910_6POST	2954861	2954880		YPO_RS14120	19
ABI910_6POST	2954947	2954952		YPO_RS14120	5
ABI910_6POST	2955700	2955704		YPO_RS14125	4
ABI910_6POST	2956726	2956738		glnS	12
ABI910_6POST	2956859	2956868		glnS	9
ABI910_6POST	2956921	2956922		glnS	1
ABI910_6POST	2957204	2957214		glnS	10
ABI910_6POST	2959207	2959221		YPO_RS14135	14
ABI910_6POST	2959843	2959845		YPO_RS14135	2
ABI910_6POST	2960033	2960052		YPO_RS14135	19
ABI910_6POST	2965412	2965414		ybfE	2
ABI910_6POST	2965627	2965629		ybfE	2
ABI910_6POST	2966137	2966145		ybfF	8
ABI910_6POST	2966688	2966699		ybfF	11
ABI910_6POST	2967647	2967669		YPO_RS14165	22
ABI910_6POST	2968954	2968961		YPO_RS14185	7
ABI910_6POST	2969099	2969123		YPO_RS14185	24
ABI910_6POST	2969201	2969225		YPO_RS14185	24
ABI910_6POST	2969309	2969386		YPO_RS14185	77
ABI910_6POST	2969475	2969536		YPO_RS14185	61
ABI910_6POST	2969624	2969629		YPO_RS14185	5
ABI910_6POST	2969761	2969769		YPO_RS14190	8
ABI910_6POST	2969989	2970130		YPO_RS14190	141
ABI910_6POST	2970179	2970184		YPO_RS14190	5
ABI910_6POST	2970341	2970349		YPO_RS14190	8
ABI910_6POST	2970381	2970407		YPO_RS14190	26
ABI910_6POST	2970464	2970479		YPO_RS14190	15
ABI910_6POST	2972029	2972037		proX	8
ABI910_6POST	2972175	2972187		proX	12
ABI910_6POST	2972388	2972391		proX	3
ABI910_6POST	2972486	2972504		proX	18
ABI910_6POST	2972547	2972560		proX	13
ABI910_6POST	2972888	2972891		proW	3
ABI910_6POST	2973043	2973082		proW	39
ABI910_6POST	2973247	2973257		proW	10
ABI910_6POST	2973292	2973318		proW	26
ABI910_6POST	2973441	2973443		proW	2
ABI910_6POST	2973693	2973703		proW	10
ABI910_6POST	2974714	2974716		proV	2
ABI910_6POST	2974951	2974953		proV	2
ABI910_6POST	2976025	2976027		nrdF	2
ABI910_6POST	2976119	2976146		nrdF	27
ABI910_6POST	2976208	2976212		nrdF	4
ABI910_6POST	2976587	2976592		nrdF	5
ABI910_6POST	2977374	2977388		nrdE	14
ABI910_6POST	2978220	2978237		nrdE	17
ABI910_6POST	2978327	2978329		nrdE	2
ABI910_6POST	2978425	2978441		nrdE	16
ABI910_6POST	2979321	2979352		nrdI	31
ABI910_6POST	2979391	2979404		nrdI	13
ABI910_6POST	2980304	2980327		YPO_RS14235	23
ABI910_6POST	2980621	2980622		YPO_RS14235	1
ABI910_6POST	2981910	2981919		YPO_RS14245	9
ABI910_6POST	2982428	2982478		YPO_RS14250	50
ABI910_6POST	2982513	2982555		YPO_RS14250	42
ABI910_6POST	2982731	2982763		YPO_RS14250	32
ABI910_6POST	2982888	2982901		YPO_RS14250	13
ABI910_6POST	2982963	2982999		YPO_RS14250	36
ABI910_6POST	2983124	2983135		YPO_RS14250	11
ABI910_6POST	2983543	2983556		YPO_RS14250	13
ABI910_6POST	2985977	2985979		YPO_RS14265	2
ABI910_6POST	2986084	2986104		YPO_RS14265	20
ABI910_6POST	2986510	2986513		YPO_RS14265	3
ABI910_6POST	2986687	2986700		YPO_RS14265	13
ABI910_6POST	2987575	2987581		YPO_RS14270	6
ABI910_6POST	2987847	2987848		YPO_RS14270	1
ABI910_6POST	2988270	2988278		YPO_RS14275	8
ABI910_6POST	2988465	2988492		YPO_RS14275	27
ABI910_6POST	2988608	2988621		YPO_RS14275	13
ABI910_6POST	2989753	2989766		YPO_RS14285	13
ABI910_6POST	2992409	2992418		YPO_RS14300	9
ABI910_6POST	2992619	2992633		YPO_RS14300	14
ABI910_6POST	2992949	2992951		YPO_RS14300	2
ABI910_6POST	2993134	2993139		YPO_RS14300	5
ABI910_6POST	2993533	2993544		YPO_RS14300	11
ABI910_6POST	2993823	2993828		YPO_RS14300	5
ABI910_6POST	2993954	2993966		YPO_RS14300	12
ABI910_6POST	2994312	2994323		ureE	11
ABI910_6POST	2994831	2994873		ureE	42
ABI910_6POST	2994974	2994975		ureE	1
ABI910_6POST	2995429	2995441		YPO_RS14310	12
ABI910_6POST	2995878	2995880		ureG	2
ABI910_6POST	2996099	2996107		ureG	8
ABI910_6POST	2996200	2996202		ureG	2
ABI910_6POST	2997947	2997999		yut	52
ABI910_6POST	2998146	2998147		yut	1
ABI910_6POST	2998252	2998259		yut	7
ABI910_6POST	2998372	2998428		yut	56
ABI910_6POST	2999618	2999619		YPO_RS14330	1
ABI910_6POST	2999731	2999743		YPO_RS14330	12
ABI910_6POST	3001191	3001220		kch	29
ABI910_6POST	3001811	3001817		kch	6
ABI910_6POST	3002449	3002450		crcB	1
ABI910_6POST	3002790	3002803		crcB	13
ABI910_6POST	3006003	3006044		chbA	41
ABI910_6POST	3006192	3006207		chbA	15
ABI910_6POST	3006469	3006472		chbR	3
ABI910_6POST	3006579	3006585		chbR	6
ABI910_6POST	3007582	3007600		chbG	18
ABI910_6POST	3007782	3007801		chbG	19
ABI910_6POST	3007861	3007862		chbG	1
ABI910_6POST	3008449	3008462		YPO_RS14385	13
ABI910_6POST	3009358	3009364		seqA	6
ABI910_6POST	3009470	3009495		seqA	25
ABI910_6POST	3009811	3009812		pgm	1
ABI910_6POST	3009972	3009983		pgm	11
ABI910_6POST	3010184	3010186		pgm	2
ABI910_6POST	3010443	3010459		pgm	16
ABI910_6POST	3010762	3010765		pgm	3
ABI910_6POST	3012173	3012220		YPO_RS14405	47
ABI910_6POST	3012361	3012379		YPO_RS14405	18
ABI910_6POST	3012685	3012697		kdpE	12
ABI910_6POST	3013671	3013695		kdbD	24
ABI910_6POST	3013906	3013915		kdbD	9
ABI910_6POST	3014145	3014157		kdbD	12
ABI910_6POST	3014428	3014484		kdbD	56
ABI910_6POST	3014562	3014603		kdbD	41
ABI910_6POST	3015092	3015096		kdbD	4
ABI910_6POST	3015320	3015323		kdbD	3
ABI910_6POST	3015635	3015636		kdbD	1
ABI910_6POST	3015808	3015821		kdbD	13
ABI910_6POST	3016058	3016076		kdbD	18
ABI910_6POST	3016182	3016193		kdbD	11
ABI910_6POST	3016537	3016559		kdpC	22
ABI910_6POST	3016836	3016862		kdpC	26
ABI910_6POST	3016896	3016901		kdpC	5
ABI910_6POST	3017140	3017151		kdpB	11
ABI910_6POST	3017252	3017267		kdpB	15
ABI910_6POST	3017759	3017764		kdpB	5
ABI910_6POST	3018236	3018253		kdpB	17
ABI910_6POST	3018427	3018433		kdpB	6
ABI910_6POST	3018465	3018488		kdpB	23
ABI910_6POST	3018566	3018570		kdpB	4
ABI910_6POST	3018756	3018758		kdpB	2
ABI910_6POST	3018856	3018859		kdpB	3
ABI910_6POST	3018968	3018971		kdpB	3
ABI910_6POST	3019282	3019288		kdpA	6
ABI910_6POST	3019394	3019396		kdpA	2
ABI910_6POST	3019681	3019686		kdpA	5
ABI910_6POST	3020077	3020083		kdpA	6
ABI910_6POST	3020176	3020180		kdpA	4
ABI910_6POST	3022296	3022307		YPO_RS14450	11
ABI910_6POST	3023163	3023164		phrB	1
ABI910_6POST	3023282	3023294		phrB	12
ABI910_6POST	3023503	3023506		phrB	3
ABI910_6POST	3023779	3023781		phrB	2
ABI910_6POST	3023870	3023874		phrB	4
ABI910_6POST	3024235	3024240		YPO_RS14460	5
ABI910_6POST	3024515	3024520		YPO_RS14460	5
ABI910_6POST	3024685	3024702		YPO_RS14460	17
ABI910_6POST	3024939	3024956		YPO_RS14460	17
ABI910_6POST	3025344	3025367		YPO_RS14465	23
ABI910_6POST	3025734	3025766		YPO_RS14465	32
ABI910_6POST	3025962	3025970		YPO_RS14465	8
ABI910_6POST	3026146	3026154		YPO_RS14470	8
ABI910_6POST	3027927	3027949		YPO_RS14480	22
ABI910_6POST	3028086	3028095		YPO_RS14480	9
ABI910_6POST	3028170	3028197		YPO_RS14480	27
ABI910_6POST	3028196	3028197		pxpA	1
ABI910_6POST	3028349	3028351		pxpA	2
ABI910_6POST	3028497	3028513		pxpA	16
ABI910_6POST	3028644	3028656		pxpA	12
ABI910_6POST	3029357	3029370		YPO_RS14490	13
ABI910_6POST	3029782	3029794		YPO_RS14495	12
ABI910_6POST	3030357	3030363		YPO_RS14495	6
ABI910_6POST	3030425	3030452		YPO_RS14495	27
ABI910_6POST	3030794	3030805		pcp	11
ABI910_6POST	3030916	3030925		pcp	9
ABI910_6POST	3031079	3031092		pcp	13
ABI910_6POST	3031122	3031148		pcp	26
ABI910_6POST	3031197	3031204		pcp	7
ABI910_6POST	3031319	3031328		pcp	9
ABI910_6POST	3031921	3031997		ung	76
ABI910_6POST	3033875	3033890		YPO_RS14515	15
ABI910_6POST	3034580	3034595		YPO_RS14520	15
ABI910_6POST	3036643	3036647		YPO_RS14530	4
ABI910_6POST	3036733	3036739		YPO_RS14530	6
ABI910_6POST	3036948	3036952		YPO_RS14530	4
ABI910_6POST	3037089	3037099		YPO_RS14530	10
ABI910_6POST	3037217	3037263		YPO_RS14530	46
ABI910_6POST	3038063	3038070		nadB	7
ABI910_6POST	3038739	3038762		nadB	23
ABI910_6POST	3039840	3039851		rpoE	11
ABI910_6POST	3040617	3040620		rseA	3
ABI910_6POST	3041536	3041542		rseB	6
ABI910_6POST	3042157	3042166		YPO_RS14560	9
ABI910_6POST	3042579	3042590		YPO_RS14560	11
ABI910_6POST	3042811	3042830		YPO_RS14560	19
ABI910_6POST	3043449	3043485		lepA	36
ABI910_6POST	3043761	3043767		lepA	6
ABI910_6POST	3043943	3043955		lepA	12
ABI910_6POST	3044508	3044529		lepA	21
ABI910_6POST	3044632	3044644		lepA	12
ABI910_6POST	3044855	3044861		lepA	6
ABI910_6POST	3045685	3045698		lepB	13
ABI910_6POST	3045839	3045840		lepB	1
ABI910_6POST	3046012	3046015		lepB	3
ABI910_6POST	3046109	3046114		lepB	5
ABI910_6POST	3046979	3046980		rnc	1
ABI910_6POST	3047572	3047578		YPO_RS14580	6
ABI910_6POST	3048695	3048705		recO	10
ABI910_6POST	3048889	3048894		recO	5
ABI910_6POST	3049063	3049064		YPO_RS14590	1
ABI910_6POST	3049171	3049177		YPO_RS14590	6
ABI910_6POST	3049342	3049347		YPO_RS14590	5
ABI910_6POST	3049570	3049596		YPO_RS14590	26
ABI910_6POST	3049708	3049735		YPO_RS14590	27
ABI910_6POST	3049918	3049941		YPO_RS14590	23
ABI910_6POST	3050362	3050431		YPO_RS14595	69
ABI910_6POST	3050523	3050539		YPO_RS14595	16
ABI910_6POST	3050662	3050675		YPO_RS14595	13
ABI910_6POST	3050727	3050735		YPO_RS14595	8
ABI910_6POST	3050876	3050882		tssL	6
ABI910_6POST	3050946	3050949		tssL	3
ABI910_6POST	3051376	3051383		tssL	7
ABI910_6POST	3051958	3051977		tssM	19
ABI910_6POST	3052037	3052044		tssM	7
ABI910_6POST	3052803	3052808		tssM	5
ABI910_6POST	3053341	3053357		tssM	16
ABI910_6POST	3053947	3053956		tssM	9
ABI910_6POST	3054039	3054043		tssM	4
ABI910_6POST	3054120	3054133		tssM	13
ABI910_6POST	3054274	3054295		tssM	21
ABI910_6POST	3054663	3054688		tssM	25
ABI910_6POST	3055131	3055153		tssM	22
ABI910_6POST	3055848	3055860		YPO_RS14610	12
ABI910_6POST	3056758	3056760		YPO_RS14610	2
ABI910_6POST	3057127	3057131		YPO_RS14610	4
ABI910_6POST	3057193	3057195		YPO_RS14610	2
ABI910_6POST	3057663	3057680		YPO_RS14610	17
ABI910_6POST	3057737	3057742		YPO_RS14610	5
ABI910_6POST	3057942	3057945		YPO_RS14610	3
ABI910_6POST	3058153	3058180		YPO_RS14610	27
ABI910_6POST	3058699	3058710		YPO_RS14615	11
ABI910_6POST	3058787	3058806		YPO_RS14615	19
ABI910_6POST	3058922	3058928		YPO_RS14615	6
ABI910_6POST	3058934	3058964		YPO_RS14620	30
ABI910_6POST	3060022	3060026		YPO_RS14625	4
ABI910_6POST	3060072	3060083		YPO_RS14625	11
ABI910_6POST	3060439	3060441		YPO_RS14625	2
ABI910_6POST	3061363	3061366		YPO_RS14635	3
ABI910_6POST	3061414	3061422		YPO_RS14635	8
ABI910_6POST	3061807	3061818		YPO_RS14640	11
ABI910_6POST	3062708	3062730		YPO_RS14645	22
ABI910_6POST	3062941	3062951		YPO_RS14645	10
ABI910_6POST	3063842	3063851		YPO_RS14645	9
ABI910_6POST	3064242	3064245		YPO_RS14645	3
ABI910_6POST	3064870	3064878		YPO_RS14650	8
ABI910_6POST	3065588	3065601		YPO_RS14660	13
ABI910_6POST	3066967	3066974		ccmA	7
ABI910_6POST	3067360	3067368		ccmB	8
ABI910_6POST	3067706	3067723		ccmB	17
ABI910_6POST	3067828	3067829		YPO_RS14675	1
ABI910_6POST	3067900	3067921		YPO_RS14675	21
ABI910_6POST	3068765	3068766		ccmD	1
ABI910_6POST	3069002	3069011		ccmE	9
ABI910_6POST	3069381	3069382		YPO_RS14690	1
ABI910_6POST	3069602	3069621		YPO_RS14690	19
ABI910_6POST	3069681	3069691		YPO_RS14690	10
ABI910_6POST	3069822	3069832		YPO_RS14690	10
ABI910_6POST	3070420	3070439		YPO_RS14690	19
ABI910_6POST	3070522	3070541		YPO_RS14690	19
ABI910_6POST	3070783	3070801		YPO_RS14690	18
ABI910_6POST	3070941	3070947		YPO_RS14690	6
ABI910_6POST	3070997	3071015		YPO_RS14690	18
ABI910_6POST	3071069	3071087		YPO_RS14690	18
ABI910_6POST	3071224	3071228		YPO_RS14690	4
ABI910_6POST	3072077	3072116		YPO_RS14700	39
ABI910_6POST	3072385	3072398		ccmI	13
ABI910_6POST	3072651	3072666		ccmI	15
ABI910_6POST	3072763	3072813		ccmI	50
ABI910_6POST	3073092	3073095		ccmI	3
ABI910_6POST	3073291	3073300		ccmI	9
ABI910_6POST	3073423	3073428		ccmI	5
ABI910_6POST	3073679	3073706		mlaA	27
ABI910_6POST	3074037	3074067		mlaA	30
ABI910_6POST	3074648	3074667		fadL	19
ABI910_6POST	3074727	3074754		fadL	27
ABI910_6POST	3075012	3075027		fadL	15
ABI910_6POST	3075153	3075187		fadL	34
ABI910_6POST	3076249	3076267		YPO_RS14720	18
ABI910_6POST	3076828	3076829		fadI	1
ABI910_6POST	3077008	3077019		fadI	11
ABI910_6POST	3077297	3077313		fadI	16
ABI910_6POST	3077698	3077707		fadI	9
ABI910_6POST	3077896	3077903		fadI	7
ABI910_6POST	3078117	3078121		fadJ	4
ABI910_6POST	3078168	3078175		fadJ	7
ABI910_6POST	3078251	3078267		fadJ	16
ABI910_6POST	3078631	3078640		fadJ	9
ABI910_6POST	3078811	3078817		fadJ	6
ABI910_6POST	3079049	3079056		fadJ	7
ABI910_6POST	3079211	3079216		fadJ	5
ABI910_6POST	3079489	3079497		fadJ	8
ABI910_6POST	3079554	3079606		fadJ	52
ABI910_6POST	3079681	3079683		fadJ	2
ABI910_6POST	3079754	3079766		fadJ	12
ABI910_6POST	3080027	3080046		fadJ	19
ABI910_6POST	3080087	3080093		fadJ	6
ABI910_6POST	3080229	3080242		fadJ	13
ABI910_6POST	3081339	3081348		sixA	9
ABI910_6POST	3081870	3081874		smrB	4
ABI910_6POST	3081906	3081909		smrB	3
ABI910_6POST	3083818	3083831		aroC	13
ABI910_6POST	3084696	3084754		aroC	58
ABI910_6POST	3084872	3084879		mepA	7
ABI910_6POST	3085013	3085043		mepA	30
ABI910_6POST	3085527	3085536		mepA	9
ABI910_6POST	3085776	3085795		YPO_RS14760	19
ABI910_6POST	3086282	3086301		YPO_RS14760	19
ABI910_6POST	3086596	3086606		YPO_RS14765	10
ABI910_6POST	3087874	3087882		mnmC	8
ABI910_6POST	3088132	3088152		mnmC	20
ABI910_6POST	3088227	3088237		mnmC	10
ABI910_6POST	3088455	3088458		mnmC	3
ABI910_6POST	3088742	3088744		mnmC	2
ABI910_6POST	3089188	3089214		mnmC	26
ABI910_6POST	3089289	3089295		mnmC	6
ABI910_6POST	3090259	3090268		fabB	9
ABI910_6POST	3090427	3090445		fabB	18
ABI910_6POST	3090656	3090660		fabB	4
ABI910_6POST	3090757	3090779		fabB	22
ABI910_6POST	3091594	3091601		YPO_RS14785	7
ABI910_6POST	3094149	3094153		YPO_RS14795	4
ABI910_6POST	3094624	3094628		YPO_RS14795	4
ABI910_6POST	3094841	3094843		YPO_RS14795	2
ABI910_6POST	3096445	3096475		YPO_RS14805	30
ABI910_6POST	3096800	3096802		YPO_RS14805	2
ABI910_6POST	3097092	3097097		YPO_RS14805	5
ABI910_6POST	3097558	3097572		pdxB	14
ABI910_6POST	3097639	3097690		pdxB	51
ABI910_6POST	3097746	3097752		pdxB	6
ABI910_6POST	3098245	3098271		pdxB	26
ABI910_6POST	3098635	3098641		YPO_RS14815	6
ABI910_6POST	3099152	3099165		YPO_RS14820	13
ABI910_6POST	3099275	3099291		YPO_RS14820	16
ABI910_6POST	3100134	3100150		YPO_RS14820	16
ABI910_6POST	3100438	3100479		truA	41
ABI910_6POST	3100593	3100609		truA	16
ABI910_6POST	3101450	3101457		YPO_RS14830	7
ABI910_6POST	3101695	3101699		YPO_RS14830	4
ABI910_6POST	3102159	3102162		accD	3
ABI910_6POST	3102249	3102253		accD	4
ABI910_6POST	3102693	3102736		accD	43
ABI910_6POST	3103854	3103855		folC	1
ABI910_6POST	3104743	3104753		dedD	10
ABI910_6POST	3104880	3104893		dedD	13
ABI910_6POST	3105177	3105183		dedD	6
ABI910_6POST	3105400	3105402		dedD	2
ABI910_6POST	3106036	3106046		cvpA	10
ABI910_6POST	3106167	3106171		cvpA	4
ABI910_6POST	3106429	3106438		purF	9
ABI910_6POST	3108307	3108308		YPO_RS14860	1
ABI910_6POST	3108376	3108382		YPO_RS14860	6
ABI910_6POST	3109195	3109204		hisJ	9
ABI910_6POST	3109541	3109559		hisJ	18
ABI910_6POST	3109982	3109986		YPO_RS14870	4
ABI910_6POST	3110077	3110091		YPO_RS14870	14
ABI910_6POST	3110128	3110135		YPO_RS14870	7
ABI910_6POST	3110725	3110854		YPO_RS14875	129
ABI910_6POST	3111002	3111013		YPO_RS14875	11
ABI910_6POST	3111142	3111163		YPO_RS14875	21
ABI910_6POST	3112600	3112607		YPO_RS14885	7
ABI910_6POST	3113193	3113198		YPO_RS14885	5
ABI910_6POST	3114064	3114087		YPO_RS14890	23
ABI910_6POST	3114211	3114213		YPO_RS14890	2
ABI910_6POST	3114547	3114552		yfcE	5
ABI910_6POST	3114633	3114653		yfcE	20
ABI910_6POST	3114862	3114897		yfcE	35
ABI910_6POST	3116248	3116260		YPO_RS14905	12
ABI910_6POST	3116616	3116620		YPO_RS14905	4
ABI910_6POST	3117478	3117489		YPO_RS14910	11
ABI910_6POST	3117877	3117889		YPO_RS14910	12
ABI910_6POST	3118014	3118021		YPO_RS14910	7
ABI910_6POST	3118516	3118537		YPO_RS14910	21
ABI910_6POST	3120316	3120561		YPO_RS14920	245
ABI910_6POST	3121234	3121815		YPO_RS14925	581
ABI910_6POST	3122083	3122484		YPO_RS14930	401
ABI910_6POST	3122717	3123118		YPO_RS14935	401
ABI910_6POST	3123130	3123702		YPO_RS14940	572
ABI910_6POST	3123726	3123977		YPO_RS14945	251
ABI910_6POST	3124016	3124255		YPO_RS14950	239
ABI910_6POST	3125064	3126980		yapC	1916
ABI910_6POST	3127150	3127226		YPO_RS14960	76
ABI910_6POST	3127515	3128096		YPO_RS14965	581
ABI910_6POST	3128498	3128505		YPO_RS14975	7
ABI910_6POST	3128918	3128947		YPO_RS14975	29
ABI910_6POST	3129007	3129012		YPO_RS14975	5
ABI910_6POST	3129061	3129066		YPO_RS14975	5
ABI910_6POST	3129135	3129140		YPO_RS14975	5
ABI910_6POST	3129211	3129212		YPO_RS14975	1
ABI910_6POST	3129305	3129344		YPO_RS14975	39
ABI910_6POST	3129398	3129408		YPO_RS14975	10
ABI910_6POST	3129521	3129549		YPO_RS14975	28
ABI910_6POST	3130158	3132365		YPO_RS14980	2207
ABI910_6POST	3132358	3132888		YPO_RS14985	530
ABI910_6POST	3133047	3135428		YPO_RS14990	2381
ABI910_6POST	3135507	3137135		YPO_RS14995	1628
ABI910_6POST	3137608	3138459		YPO_RS15000	851
ABI910_6POST	3138485	3139474		YPO_RS15005	989
ABI910_6POST	3139529	3140422		YPO_RS15010	893
ABI910_6POST	3140596	3140608		YPO_RS15015	12
ABI910_6POST	3140682	3140699		YPO_RS15015	17
ABI910_6POST	3140836	3140846		YPO_RS15015	10
ABI910_6POST	3140877	3140907		YPO_RS15015	30
ABI910_6POST	3141062	3141063		YPO_RS15015	1
ABI910_6POST	3141106	3141123		YPO_RS15015	17
ABI910_6POST	3141410	3141431		YPO_RS15015	21
ABI910_6POST	3141497	3141502		YPO_RS15015	5
ABI910_6POST	3141723	3141726		YPO_RS15020	3
ABI910_6POST	3141760	3141761		YPO_RS15020	1
ABI910_6POST	3141851	3141857		YPO_RS15020	6
ABI910_6POST	3141922	3141934		YPO_RS15020	12
ABI910_6POST	3142029	3142034		YPO_RS15020	5
ABI910_6POST	3142156	3142168		YPO_RS15020	12
ABI910_6POST	3142203	3142232		YPO_RS15020	29
ABI910_6POST	3142684	3142989		YPO_RS15025	305
ABI910_6POST	3143086	3143487		YPO_RS15030	401
ABI910_6POST	3143469	3144179		YPO_RS15035	710
ABI910_6POST	3144332	3144348		YPO_RS15035	16
ABI910_6POST	3144963	3144999		YPO_RS15040	36
ABI910_6POST	3145242	3145253		YPO_RS15040	11
ABI910_6POST	3145648	3145650		YPO_RS15040	2
ABI910_6POST	3145843	3145860		YPO_RS15040	17
ABI910_6POST	3146701	3146724		YPO_RS15045	23
ABI910_6POST	3147583	3147586		YPO_RS15050	3
ABI910_6POST	3147803	3147817		YPO_RS15050	14
ABI910_6POST	3148116	3148122		YPO_RS15055	6
ABI910_6POST	3149231	3149240		YPO_RS15060	9
ABI910_6POST	3150526	3150529		YPO_RS15075	3
ABI910_6POST	3152051	3152052		folD	1
ABI910_6POST	3152168	3152183		folD	15
ABI910_6POST	3152504	3152509		folD	5
ABI910_6POST	3152651	3152668		folD	17
ABI910_6POST	3153037	3153053		ybcJ	16
ABI910_6POST	3153573	3153575		YPO_RS15105	2
ABI910_6POST	3153863	3153892		upp	29
ABI910_6POST	3154356	3154366		upp	10
ABI910_6POST	3154451	3154464		upp	13
ABI910_6POST	3155870	3155877		purM	7
ABI910_6POST	3157186	3157201		speG	15
ABI910_6POST	3157280	3157283		speG	3
ABI910_6POST	3157371	3157374		speG	3
ABI910_6POST	3159094	3159129		pstB	35
ABI910_6POST	3159544	3159548		pstB	4
ABI910_6POST	3160014	3160036		pstA	22
ABI910_6POST	3160211	3160216		pstA	5
ABI910_6POST	3160370	3160377		pstA	7
ABI910_6POST	3161048	3161069		pstA	21
ABI910_6POST	3161148	3161149		pstA	1
ABI910_6POST	3161728	3161735		YPO_RS15145	7
ABI910_6POST	3161927	3161937		YPO_RS15145	10
ABI910_6POST	3161992	3162026		YPO_RS15145	34
ABI910_6POST	3162162	3162176		YPO_RS15145	14
ABI910_6POST	3162408	3162411		YPO_RS15145	3
ABI910_6POST	3162814	3162816		YPO_RS15145	2
ABI910_6POST	3163126	3163138		YPO_RS15145	12
ABI910_6POST	3163413	3163426		YPO_RS15145	13
ABI910_6POST	3164272	3164280		ppk1	8
ABI910_6POST	3165021	3165047		ppk1	26
ABI910_6POST	3165228	3165231		ppk1	3
ABI910_6POST	3165619	3165620		ppk1	1
ABI910_6POST	3166246	3166260		ppx	14
ABI910_6POST	3166556	3166564		ppx	8
ABI910_6POST	3167614	3167617		ppx	3
ABI910_6POST	3168896	3168954		mgtE	58
ABI910_6POST	3169880	3169904		yegD	24
ABI910_6POST	3170362	3170378		yegD	16
ABI910_6POST	3170466	3170481		yegD	15
ABI910_6POST	3170778	3170787		yegD	9
ABI910_6POST	3170823	3170825		yegD	2
ABI910_6POST	3170889	3170915		yegD	26
ABI910_6POST	3170953	3170975		yegD	22
ABI910_6POST	3171646	3171659		YPO_RS15175	13
ABI910_6POST	3172197	3172221		YPO_RS15180	24
ABI910_6POST	3172399	3172412		YPO_RS15180	13
ABI910_6POST	3172502	3172518		YPO_RS15180	16
ABI910_6POST	3172550	3172558		YPO_RS15180	8
ABI910_6POST	3172894	3172901		YPO_RS15180	7
ABI910_6POST	3173795	3173855		YPO_RS15185	60
ABI910_6POST	3174283	3174288		YPO_RS15185	5
ABI910_6POST	3175253	3175286		YPO_RS15190	33
ABI910_6POST	3175595	3175611		YPO_RS15190	16
ABI910_6POST	3175694	3175704		YPO_RS15190	10
ABI910_6POST	3176052	3176055		YPO_RS15195	3
ABI910_6POST	3176279	3176280		YPO_RS15195	1
ABI910_6POST	3176326	3176364		YPO_RS15195	38
ABI910_6POST	3176409	3176416		YPO_RS15195	7
ABI910_6POST	3176709	3176727		YPO_RS15195	18
ABI910_6POST	3176833	3176843		YPO_RS15195	10
ABI910_6POST	3176980	3176983		YPO_RS15195	3
ABI910_6POST	3177045	3177107		YPO_RS15195	62
ABI910_6POST	3177362	3177372		YPO_RS15195	10
ABI910_6POST	3178010	3178027		YPO_RS15200	17
ABI910_6POST	3178073	3178078		YPO_RS15200	5
ABI910_6POST	3178164	3178173		YPO_RS15200	9
ABI910_6POST	3178325	3178326		YPO_RS15200	1
ABI910_6POST	3179453	3179525		YPO_RS15205	72
ABI910_6POST	3180281	3180286		YPO_RS15205	5
ABI910_6POST	3180515	3180556		YPO_RS15205	41
ABI910_6POST	3180856	3180875		YPO_RS15210	19
ABI910_6POST	3180951	3180979		YPO_RS15210	28
ABI910_6POST	3181083	3181089		YPO_RS15210	6
ABI910_6POST	3181584	3181585		YPO_RS15210	1
ABI910_6POST	3181672	3181687		YPO_RS15210	15
ABI910_6POST	3181888	3181907		YPO_RS15210	19
ABI910_6POST	3182061	3182068		YPO_RS15210	7
ABI910_6POST	3182759	3182768		YPO_RS15210	9
ABI910_6POST	3182972	3182977		YPO_RS15210	5
ABI910_6POST	3183677	3183749		YPO_RS15210	72
ABI910_6POST	3183894	3183927		mdtC	33
ABI910_6POST	3184191	3184199		mdtC	8
ABI910_6POST	3184372	3184409		mdtC	37
ABI910_6POST	3184452	3184465		mdtC	13
ABI910_6POST	3184579	3184603		mdtC	24
ABI910_6POST	3185024	3185067		mdtC	43
ABI910_6POST	3185106	3185160		mdtC	54
ABI910_6POST	3185525	3185545		mdtC	20
ABI910_6POST	3185821	3185828		mdtC	7
ABI910_6POST	3186733	3186783		mdtC	50
ABI910_6POST	3187017	3187045		YPO_RS15220	28
ABI910_6POST	3187275	3187289		YPO_RS15220	14
ABI910_6POST	3187747	3187749		YPO_RS15220	2
ABI910_6POST	3188109	3188120		YPO_RS15220	11
ABI910_6POST	3188153	3188155		YPO_RS15220	2
ABI910_6POST	3189896	3189904		baeR	8
ABI910_6POST	3190063	3190078		baeR	15
ABI910_6POST	3190234	3190253		baeR	19
ABI910_6POST	3190299	3190306		baeR	7
ABI910_6POST	3191296	3191312		YPO_RS15240	16
ABI910_6POST	3191918	3191930		YPO_RS15240	12
ABI910_6POST	3193611	3193621		yegS	10
ABI910_6POST	3193953	3193983		yegS	30
ABI910_6POST	3194050	3194119		yegS	69
ABI910_6POST	3196274	3196297		thiD	23
ABI910_6POST	3196410	3196442		thiD	32
ABI910_6POST	3196545	3196569		thiD	24
ABI910_6POST	3196789	3196806		thiD	17
ABI910_6POST	3197815	3197818		YPO_RS15265	3
ABI910_6POST	3198017	3198019		YPO_RS15270	2
ABI910_6POST	3198090	3198111		YPO_RS15270	21
ABI910_6POST	3198227	3198249		YPO_RS15270	22
ABI910_6POST	3198261	3198277		YPO_RS15275	16
ABI910_6POST	3198383	3198390		YPO_RS15275	7
ABI910_6POST	3198571	3198584		YPO_RS15275	13
ABI910_6POST	3198684	3198707		YPO_RS15275	23
ABI910_6POST	3198747	3198762		YPO_RS15275	15
ABI910_6POST	3198863	3198899		YPO_RS15275	36
ABI910_6POST	3199040	3199052		YPO_RS15275	12
ABI910_6POST	3199114	3199144		YPO_RS15275	30
ABI910_6POST	3199177	3199184		YPO_RS15275	7
ABI910_6POST	3199287	3199299		YPO_RS15275	12
ABI910_6POST	3199744	3199763		YPO_RS15280	19
ABI910_6POST	3200339	3200368		YPO_RS15285	29
ABI910_6POST	3200405	3200422		YPO_RS15285	17
ABI910_6POST	3200819	3200838		YPO_RS15290	19
ABI910_6POST	3201146	3201175		YPO_RS15295	29
ABI910_6POST	3201366	3201367		YPO_RS15295	1
ABI910_6POST	3201493	3201503		YPO_RS15295	10
ABI910_6POST	3202085	3202126		YPO_RS15305	41
ABI910_6POST	3202247	3202258		YPO_RS15305	11
ABI910_6POST	3202433	3202443		YPO_RS15305	10
ABI910_6POST	3202852	3202854		YPO_RS15310	2
ABI910_6POST	3203669	3203685		guaA	16
ABI910_6POST	3203832	3203844		guaA	12
ABI910_6POST	3204303	3204329		guaA	26
ABI910_6POST	3204557	3204563		guaA	6
ABI910_6POST	3204764	3204766		guaA	2
ABI910_6POST	3204806	3204810		guaA	4
ABI910_6POST	3205592	3205602		guaB	10
ABI910_6POST	3205934	3205942		guaB	8
ABI910_6POST	3206322	3206326		guaB	4
ABI910_6POST	3206371	3206375		guaB	4
ABI910_6POST	3207195	3207198		xseA	3
ABI910_6POST	3207303	3207328		xseA	25
ABI910_6POST	3207635	3207636		xseA	1
ABI910_6POST	3207935	3207948		xseA	13
ABI910_6POST	3208013	3208026		xseA	13
ABI910_6POST	3208733	3208787		YPO_RS15335	54
ABI910_6POST	3209175	3209216		YPO_RS15335	41
ABI910_6POST	3209384	3209389		YPO_RS15335	5
ABI910_6POST	3210161	3210164		der	3
ABI910_6POST	3210438	3210444		der	6
ABI910_6POST	3211574	3211579		bamB	5
ABI910_6POST	3212116	3212133		bamB	17
ABI910_6POST	3212253	3212263		bamB	10
ABI910_6POST	3212528	3212531		bamB	3
ABI910_6POST	3212591	3212599		bamB	8
ABI910_6POST	3212650	3212670		bamB	20
ABI910_6POST	3213193	3213196		YPO_RS15350	3
ABI910_6POST	3213232	3213252		YPO_RS15350	20
ABI910_6POST	3213671	3213694		hisS	23
ABI910_6POST	3213783	3213805		hisS	22
ABI910_6POST	3213837	3213839		hisS	2
ABI910_6POST	3213940	3213943		hisS	3
ABI910_6POST	3215563	3215581		ispG	18
ABI910_6POST	3216009	3216020		ispG	11
ABI910_6POST	3216400	3216413		rodZ	13
ABI910_6POST	3216584	3216594		rodZ	10
ABI910_6POST	3216727	3216743		rodZ	16
ABI910_6POST	3218625	3218646		trmG/rlmN	21
ABI910_6POST	3219013	3219019		trmG/rlmN	6
ABI910_6POST	3219149	3219153		trmG/rlmN	4
ABI910_6POST	3220347	3220354		YPO_RS15385	7
ABI910_6POST	3221288	3221298		YPO_RS15385	10
ABI910_6POST	3222639	3222651		YPO_RS15385	12
ABI910_6POST	3223349	3223350		yapA	1
ABI910_6POST	3223450	3223459		yapA	9
ABI910_6POST	3223545	3223551		yapA	6
ABI910_6POST	3223555	3223556		yapA	1
ABI910_6POST	3223669	3223680		yapA	11
ABI910_6POST	3224038	3224043		yapA	5
ABI910_6POST	3224622	3224629		yapA	7
ABI910_6POST	3225162	3225178		yapA	16
ABI910_6POST	3225243	3225249		yapA	6
ABI910_6POST	3225488	3225537		yapA	49
ABI910_6POST	3225584	3225681		yapA	97
ABI910_6POST	3225892	3225901		yapA	9
ABI910_6POST	3225993	3225999		yapA	6
ABI910_6POST	3226126	3226142		yapA	16
ABI910_6POST	3226325	3226328		yapA	3
ABI910_6POST	3226438	3226451		yapA	13
ABI910_6POST	3226957	3226967		yapA	10
ABI910_6POST	3227035	3227048		yapA	13
ABI910_6POST	3227097	3227110		yapA	13
ABI910_6POST	3227442	3227453		yapA	11
ABI910_6POST	3228369	3228371		YPO_RS15395	2
ABI910_6POST	3228722	3228745		YPO_RS15395	23
ABI910_6POST	3229455	3229465		YPO_RS15395	10
ABI910_6POST	3229538	3229543		YPO_RS15395	5
ABI910_6POST	3230319	3230363		YPO_RS15395	44
ABI910_6POST	3230879	3230892		YPO_RS15395	13
ABI910_6POST	3231027	3231040		YPO_RS15395	13
ABI910_6POST	3231506	3231521		YPO_RS15400	15
ABI910_6POST	3231705	3231711		YPO_RS15400	6
ABI910_6POST	3231856	3231866		YPO_RS15405	10
ABI910_6POST	3232150	3232164		sseB	14
ABI910_6POST	3232772	3232788		sseB	16
ABI910_6POST	3233165	3233183		pepB	18
ABI910_6POST	3233357	3233360		pepB	3
ABI910_6POST	3233835	3233837		pepB	2
ABI910_6POST	3234267	3234312		pepB	45
ABI910_6POST	3235371	3235381		hscA	10
ABI910_6POST	3235436	3235459		hscA	23
ABI910_6POST	3235794	3235796		hscA	2
ABI910_6POST	3236061	3236064		hscA	3
ABI910_6POST	3236325	3236335		hscA	10
ABI910_6POST	3236854	3236871		hscA	17
ABI910_6POST	3236971	3236995		hscA	24
ABI910_6POST	3237626	3237627		hscB	1
ABI910_6POST	3238833	3238838		iscU	5
ABI910_6POST	3239419	3239435		YPO_RS15450	16
ABI910_6POST	3239989	3239992		YPO_RS15450	3
ABI910_6POST	3240619	3240636		iscR	17
ABI910_6POST	3241145	3241168		trmJ	23
ABI910_6POST	3241225	3241233		trmJ	8
ABI910_6POST	3241482	3241488		trmJ	6
ABI910_6POST	3242779	3242780		YPO_RS15470	1
ABI910_6POST	3243012	3243017		YPO_RS15470	5
ABI910_6POST	3243549	3243554		YPO_RS15475	5
ABI910_6POST	3244185	3244188		YPO_RS15475	3
ABI910_6POST	3244866	3244888		YPO_RS15480	22
ABI910_6POST	3244960	3244979		YPO_RS15480	19
ABI910_6POST	3245948	3245970		csiE	22
ABI910_6POST	3246407	3246416		csiE	9
ABI910_6POST	3246458	3246470		csiE	12
ABI910_6POST	3247183	3247197		YPO_RS15490	14
ABI910_6POST	3247623	3247627		YPO_RS15490	4
ABI910_6POST	3248409	3248438		ail	29
ABI910_6POST	3248879	3248880		YPO_RS15500	1
ABI910_6POST	3249384	3249385		YPO_RS15505	1
ABI910_6POST	3249531	3249539		YPO_RS15505	8
ABI910_6POST	3251084	3251105		hmpA	21
ABI910_6POST	3251650	3251655		hmpA	5
ABI910_6POST	3251827	3251833		hmpA	6
ABI910_6POST	3254184	3254205		YPO_RS15525	21
ABI910_6POST	3254604	3254611		YPO_RS15525	7
ABI910_6POST	3254805	3254807		YPO_RS15525	2
ABI910_6POST	3254958	3254965		YPO_RS15525	7
ABI910_6POST	3255310	3255313		YPO_RS15525	3
ABI910_6POST	3256377	3256408		glrR	31
ABI910_6POST	3256541	3256557		glrR	16
ABI910_6POST	3256764	3256766		glrR	2
ABI910_6POST	3257145	3257149		qseG	4
ABI910_6POST	3257214	3257223		qseG	9
ABI910_6POST	3257521	3257523		qseG	2
ABI910_6POST	3257729	3257730		qseG	1
ABI910_6POST	3257836	3257840		qseG	4
ABI910_6POST	3258021	3258028		qseG	7
ABI910_6POST	3259183	3259189		YPO_RS15540	6
ABI910_6POST	3259767	3259785		YPO_RS15545	18
ABI910_6POST	3259883	3259887		YPO_RS15545	4
ABI910_6POST	3259993	3259995		YPO_RS15545	2
ABI910_6POST	3260212	3260222		YPO_RS15550	10
ABI910_6POST	3261496	3261499		YPO_RS15555	3
ABI910_6POST	3261679	3261692		YPO_RS15555	13
ABI910_6POST	3262449	3262451		YPO_RS15560	2
ABI910_6POST	3262709	3262712		YPO_RS15560	3
ABI910_6POST	3262838	3262849		YPO_RS15560	11
ABI910_6POST	3263447	3263455		purL	8
ABI910_6POST	3263881	3263900		purL	19
ABI910_6POST	3264650	3264657		purL	7
ABI910_6POST	3264901	3264916		purL	15
ABI910_6POST	3265986	3265994		purL	8
ABI910_6POST	3266028	3266037		purL	9
ABI910_6POST	3266457	3266458		purL	1
ABI910_6POST	3266723	3266745		purL	22
ABI910_6POST	3267639	3267655		mltF	16
ABI910_6POST	3267764	3267776		mltF	12
ABI910_6POST	3267969	3268002		mltF	33
ABI910_6POST	3268343	3268393		mltF	50
ABI910_6POST	3268465	3268538		mltF	73
ABI910_6POST	3269638	3269644		tadA	6
ABI910_6POST	3269845	3269857		yfhb	12
ABI910_6POST	3269944	3269952		yfhb	8
ABI910_6POST	3270232	3270260		yfhb	28
ABI910_6POST	3270404	3270407		yfhb	3
ABI910_6POST	3270932	3270939		murQ	7
ABI910_6POST	3271008	3271012		murQ	4
ABI910_6POST	3271305	3271309		murQ	4
ABI910_6POST	3271411	3271419		murQ	8
ABI910_6POST	3273465	3273467		YPO_RS15605	2
ABI910_6POST	3274409	3274417		pdxJ	8
ABI910_6POST	3275300	3275306		YPO_RS15620	6
ABI910_6POST	3275559	3275562		YPO_RS15620	3
ABI910_6POST	3275594	3275621		YPO_RS15620	27
ABI910_6POST	3275853	3275916		YPO_RS15620	63
ABI910_6POST	3276041	3276054		YPO_RS15625	13
ABI910_6POST	3276306	3276339		YPO_RS15625	33
ABI910_6POST	3276416	3276420		YPO_RS15625	4
ABI910_6POST	3276873	3276875		YPO_RS15625	2
ABI910_6POST	3276775	3276803		YPO_RS15625	28
ABI910_6POST	3277786	3277795		tssK	9
ABI910_6POST	3277893	3277905		tssK	12
ABI910_6POST	3278103	3278104		tssK	1
ABI910_6POST	3278702	3278731		tssK	29
ABI910_6POST	3279038	3279040		tssJ	2
ABI910_6POST	3279324	3279325		tssJ	1
ABI910_6POST	3279479	3279507		tssJ	28
ABI910_6POST	3279869	3279870		YPO_RS15645	1
ABI910_6POST	3280150	3280156		YPO_RS15645	6
ABI910_6POST	3280999	3281008		tssC	9
ABI910_6POST	3281599	3281605		tssC	6
ABI910_6POST	3281867	3281884		tssC	17
ABI910_6POST	3281987	3281997		tssC	10
ABI910_6POST	3282250	3282251		tssB	1
ABI910_6POST	3282524	3282543		tssB	19
ABI910_6POST	3282769	3282775		YPO_RS15660	6
ABI910_6POST	3283204	3283213		YPO_RS15660	9
ABI910_6POST	3283543	3283556		YPO_RS15665	13
ABI910_6POST	3283759	3283762		YPO_RS15665	3
ABI910_6POST	3283886	3283895		YPO_RS15665	9
ABI910_6POST	3283969	3283995		YPO_RS15665	26
ABI910_6POST	3284099	3284116		YPO_RS15665	17
ABI910_6POST	3284446	3284457		YPO_RS15665	11
ABI910_6POST	3284573	3284619		YPO_RS15670	46
ABI910_6POST	3284675	3284749		YPO_RS15670	74
ABI910_6POST	3284872	3284886		YPO_RS15670	14
ABI910_6POST	3284996	3284997		YPO_RS15670	1
ABI910_6POST	3285065	3285072		YPO_RS15670	7
ABI910_6POST	3285116	3285130		YPO_RS15670	14
ABI910_6POST	3285202	3285204		YPO_RS15670	2
ABI910_6POST	3285340	3285396		YPO_RS15670	56
ABI910_6POST	3285673	3285677		YPO_RS15670	4
ABI910_6POST	3285764	3285781		YPO_RS15670	17
ABI910_6POST	3285818	3285877		YPO_RS15675	59
ABI910_6POST	3285971	3286010		YPO_RS15675	39
ABI910_6POST	3286087	3286092		YPO_RS15675	5
ABI910_6POST	3286185	3286198		YPO_RS15675	13
ABI910_6POST	3286556	3286559		YPO_RS15675	3
ABI910_6POST	3286695	3286714		YPO_RS15675	19
ABI910_6POST	3286795	3286812		YPO_RS15675	17
ABI910_6POST	3287095	3287115		YPO_RS15675	20
ABI910_6POST	3287640	3287654		YPO_RS15680	14
ABI910_6POST	3287893	3287914		YPO_RS15680	21
ABI910_6POST	3288195	3288198		YPO_RS15680	3
ABI910_6POST	3288503	3288504		YPO_RS15685	1
ABI910_6POST	3288621	3288622		YPO_RS15685	1
ABI910_6POST	3288793	3288795		YPO_RS15685	2
ABI910_6POST	3289549	3289566		tssH	17
ABI910_6POST	3289713	3289728		tssH	15
ABI910_6POST	3289869	3289902		tssH	33
ABI910_6POST	3290047	3290062		tssH	15
ABI910_6POST	3290491	3290501		tssH	10
ABI910_6POST	3290659	3290661		tssH	2
ABI910_6POST	3290868	3290869		tssH	1
ABI910_6POST	3291048	3291080		tssH	32
ABI910_6POST	3291575	3291592		tssH	17
ABI910_6POST	3293295	3293307		tssF	12
ABI910_6POST	3293527	3293540		tssF	13
ABI910_6POST	3293626	3293643		tssF	17
ABI910_6POST	3294035	3294057		tssF	22
ABI910_6POST	3294165	3294168		tssF	3
ABI910_6POST	3294307	3294308		tssF	1
ABI910_6POST	3295017	3295032		tssG	15
ABI910_6POST	3295074	3295120		tssG	46
ABI910_6POST	3295288	3295301		tssG	13
ABI910_6POST	3295457	3295458		tssG	1
ABI910_6POST	3296112	3296124		YPO_RS15705	12
ABI910_6POST	3296574	3296604		YPO_RS15705	30
ABI910_6POST	3297319	3297342		YPO_RS15710	23
ABI910_6POST	3297422	3297430		YPO_RS15710	8
ABI910_6POST	3297533	3297539		YPO_RS15710	6
ABI910_6POST	3297872	3297881		YPO_RS15715	9
ABI910_6POST	3298071	3298084		YPO_RS15715	13
ABI910_6POST	3298132	3298143		YPO_RS15715	11
ABI910_6POST	3298441	3298468		YPO_RS15715	27
ABI910_6POST	3298569	3298625		YPO_RS15715	56
ABI910_6POST	3298767	3298771		YPO_RS15715	4
ABI910_6POST	3298994	3298998		YPO_RS15715	4
ABI910_6POST	3299242	3299251		YPO_RS15720	9
ABI910_6POST	3299452	3299456		YPO_RS15720	4
ABI910_6POST	3299759	3299765		YPO_RS15720	6
ABI910_6POST	3299927	3299944		YPO_RS15725	17
ABI910_6POST	3300629	3300669		YPO_RS15725	40
ABI910_6POST	3300883	3300933		YPO_RS15725	50
ABI910_6POST	3301218	3301222		YPO_RS15725	4
ABI910_6POST	3301435	3301447		YPO_RS15725	12
ABI910_6POST	3301523	3301525		YPO_RS15725	2
ABI910_6POST	3301589	3301592		YPO_RS15730	3
ABI910_6POST	3301829	3301844		YPO_RS15730	15
ABI910_6POST	3302737	3302753		YPO_RS15735	16
ABI910_6POST	3304260	3304263		mltB	3
ABI910_6POST	3304320	3304327		mltB	7
ABI910_6POST	3304475	3304484		mltB	9
ABI910_6POST	3304529	3304537		mltB	8
ABI910_6POST	3304924	3304930		mltB	6
ABI910_6POST	3305273	3305302		mltB	29
ABI910_6POST	3306161	3306181		YPO_RS15745	20
ABI910_6POST	3306248	3306251		YPO_RS15745	3
ABI910_6POST	3306821	3306825		YPO_RS15750	4
ABI910_6POST	3306866	3306887		YPO_RS15750	21
ABI910_6POST	3307098	3307152		YPO_RS15750	54
ABI910_6POST	3307533	3307534		YPO_RS15750	1
ABI910_6POST	3307627	3307663		YPO_RS15750	36
ABI910_6POST	3308095	3308096		YPO_RS15750	1
ABI910_6POST	3308532	3308561		YPO_RS15755	29
ABI910_6POST	3308787	3308798		YPO_RS15755	11
ABI910_6POST	3309067	3309103		YPO_RS15755	36
ABI910_6POST	3309360	3309364		YPO_RS15755	4
ABI910_6POST	3309860	3309867		YPO_RS15760	7
ABI910_6POST	3310559	3310573		YPO_RS15765	14
ABI910_6POST	3310662	3310672		YPO_RS15765	10
ABI910_6POST	3313660	3313667		YPO_RS15775	7
ABI910_6POST	3313791	3313796		YPO_RS15775	5
ABI910_6POST	3314284	3314293		YPO_RS15775	9
ABI910_6POST	3314802	3314803		YPO_RS15775	1
ABI910_6POST	3314865	3314894		YPO_RS15775	29
ABI910_6POST	3315094	3315121		YPO_RS15775	27
ABI910_6POST	3315961	3315970		YPO_RS15785	9
ABI910_6POST	3316070	3316093		YPO_RS15785	23
ABI910_6POST	3316149	3316150		YPO_RS15785	1
ABI910_6POST	3316417	3316419		YPO_RS15785	2
ABI910_6POST	3317472	3317496		YPO_RS15790	24
ABI910_6POST	3317588	3317592		YPO_RS15790	4
ABI910_6POST	3317909	3317921		YPO_RS15795	12
ABI910_6POST	3318066	3318073		YPO_RS15795	7
ABI910_6POST	3318161	3318177		YPO_RS15795	16
ABI910_6POST	3318214	3318245		YPO_RS15795	31
ABI910_6POST	3318315	3318319		YPO_RS15795	4
ABI910_6POST	3318770	3318771		YPO_RS15800	1
ABI910_6POST	3318889	3318899		YPO_RS15800	10
ABI910_6POST	3319010	3319011		YPO_RS15800	1
ABI910_6POST	3319505	3319514		YPO_RS15805	9
ABI910_6POST	3319769	3319771		YPO_RS15810	2
ABI910_6POST	3319915	3319923		YPO_RS15810	8
ABI910_6POST	3320265	3320268		YPO_RS15810	3
ABI910_6POST	3321033	3321047		YPO_RS15815	14
ABI910_6POST	3321081	3321087		YPO_RS15815	6
ABI910_6POST	3321627	3321638		YPO_RS15820	11
ABI910_6POST	3322339	3322342		alaC	3
ABI910_6POST	3323045	3323053		alaC	8
ABI910_6POST	3323356	3323365		alaC	9
ABI910_6POST	3324191	3324206		YPO_RS15830	15
ABI910_6POST	3324437	3324453		YPO_RS15830	16
ABI910_6POST	3324632	3324652		YPO_RS15830	20
ABI910_6POST	3325192	3325205		glk	13
ABI910_6POST	3325384	3325385		glk	1
ABI910_6POST	3325543	3325557		glk	14
ABI910_6POST	3325821	3325826		glk	5
ABI910_6POST	3326323	3326324		YPO_RS15840	1
ABI910_6POST	3326510	3326518		YPO_RS15840	8
ABI910_6POST	3327562	3327568		YPO_RS15845	6
ABI910_6POST	3327956	3327965		YPO_RS15850	9
ABI910_6POST	3328045	3328076		YPO_RS15850	31
ABI910_6POST	3329484	3329487		YPO_RS15860	3
ABI910_6POST	3329651	3329680		YPO_RS15860	29
ABI910_6POST	3330014	3330022		YPO_RS15860	8
ABI910_6POST	3330217	3330223		YPO_RS15860	6
ABI910_6POST	3330346	3330347		YPO_RS15860	1
ABI910_6POST	3330392	3330396		YPO_RS15860	4
ABI910_6POST	3330466	3330475		YPO_RS15860	9
ABI910_6POST	3331067	3331085		YPO_RS15865	18
ABI910_6POST	3331934	3331981		YPO_RS15865	47
ABI910_6POST	3332894	3332914		YPO_RS15885	20
ABI910_6POST	3332956	3332969		YPO_RS15885	13
ABI910_6POST	3333019	3333047		YPO_RS15890	28
ABI910_6POST	3333860	3333869		gltX	9
ABI910_6POST	3334025	3334073		gltX	48
ABI910_6POST	3334429	3334440		gltX	11
ABI910_6POST	3335084	3335089		YPO_RS15905	5
ABI910_6POST	3335476	3335482		YPO_RS15905	6
ABI910_6POST	3335522	3335530		YPO_RS15905	8
ABI910_6POST	3336620	3336643		YPO_RS15920	23
ABI910_6POST	3338167	3338176		ligA	9
ABI910_6POST	3338233	3338236		ligA	3
ABI910_6POST	3338688	3338690		ligA	2
ABI910_6POST	3339009	3339020		ligA	11
ABI910_6POST	3339206	3339231		ligA	25
ABI910_6POST	3339463	3339474		ligA	11
ABI910_6POST	3339611	3339625		ligA	14
ABI910_6POST	3340136	3340152		zipA	16
ABI910_6POST	3341143	3341148		cysZ	5
ABI910_6POST	3342171	3342173		cysK	2
ABI910_6POST	3342443	3342456		cysK	13
ABI910_6POST	3342523	3342531		cysK	8
ABI910_6POST	3343984	3343989		ptsI	5
ABI910_6POST	3344208	3344216		ptsI	8
ABI910_6POST	3344766	3344774		ptsI	8
ABI910_6POST	3345119	3345120		ptsI	1
ABI910_6POST	3346472	3346473		YPO_RS15970	1
ABI910_6POST	3347030	3347047		YPO_RS15975	17
ABI910_6POST	3347888	3347889		YPO_RS15975	1
ABI910_6POST	3348232	3348238		YPO_RS15980	6
ABI910_6POST	3348309	3348324		YPO_RS15980	15
ABI910_6POST	3348445	3348452		YPO_RS15980	7
ABI910_6POST	3349171	3349181		YPO_RS15985	10
ABI910_6POST	3349858	3349883		YPO_RS15985	25
ABI910_6POST	3350099	3350116		YPO_RS15985	17
ABI910_6POST	3350263	3350271		YPO_RS15985	8
ABI910_6POST	3350391	3350404		macB	13
ABI910_6POST	3350726	3350729		macB	3
ABI910_6POST	3350764	3350767		macB	3
ABI910_6POST	3350822	3350827		macB	5
ABI910_6POST	3351201	3351227		macB	26
ABI910_6POST	3351662	3351664		macB	2
ABI910_6POST	3352122	3352130		macB	8
ABI910_6POST	3352292	3352300		macB	8
ABI910_6POST	3352840	3352850		YPO_RS15995	10
ABI910_6POST	3353025	3353045		YPO_RS15995	20
ABI910_6POST	3353104	3353120		YPO_RS15995	16
ABI910_6POST	3353511	3353512		YPO_RS15995	1
ABI910_6POST	3353753	3353761		YPO_RS15995	8
ABI910_6POST	3353981	3353996		YPO_RS15995	15
ABI910_6POST	3354174	3354183		YPO_RS15995	9
ABI910_6POST	3354435	3354459		YPO_RS16000	24
ABI910_6POST	3354771	3354782		YPO_RS16000	11
ABI910_6POST	3355640	3355646		YPO_RS16000	6
ABI910_6POST	3355901	3355940		YPO_RS16005	39
ABI910_6POST	3356289	3356313		YPO_RS16010	24
ABI910_6POST	3356867	3356871		YPO_RS16010	4
ABI910_6POST	3357269	3357270		YPO_RS16015	1
ABI910_6POST	3357647	3357649		YPO_RS16020	2
ABI910_6POST	3358286	3358313		YPO_RS16020	27
ABI910_6POST	3359399	3359412		YPO_RS16025	13
ABI910_6POST	3359751	3359769		YPO_RS16025	18
ABI910_6POST	3361403	3361432		YPO_RS16030	29
ABI910_6POST	3361506	3361518		YPO_RS16030	12
ABI910_6POST	3361635	3361662		YPO_RS16030	27
ABI910_6POST	3361807	3361834		YPO_RS16030	27
ABI910_6POST	3362253	3362271		YPO_RS16030	18
ABI910_6POST	3362349	3362362		YPO_RS16030	13
ABI910_6POST	3362396	3362404		YPO_RS16030	8
ABI910_6POST	3362901	3362923		YPO_RS16035	22
ABI910_6POST	3363681	3363692		YPO_RS16040	11
ABI910_6POST	3363789	3363831		YPO_RS16040	42
ABI910_6POST	3364139	3364158		YPO_RS16040	19
ABI910_6POST	3364279	3364294		YPO_RS16040	15
ABI910_6POST	3364512	3364520		YPO_RS16040	8
ABI910_6POST	3364708	3364710		YPO_RS16040	2
ABI910_6POST	3366142	3366150		cysA	8
ABI910_6POST	3366306	3366312		cysA	6
ABI910_6POST	3367201	3367227		cysW	26
ABI910_6POST	3367275	3367279		cysW	4
ABI910_6POST	3367310	3367311		cysW	1
ABI910_6POST	3367475	3367484		cysW	9
ABI910_6POST	3367737	3367738		cysW	1
ABI910_6POST	3367874	3367891		cysW	17
ABI910_6POST	3369349	3369358		YPO_RS16065	9
ABI910_6POST	3369747	3369770		YPO_RS16065	23
ABI910_6POST	3370306	3370314		YPO_RS16070	8
ABI910_6POST	3370729	3370744		YPO_RS16070	15
ABI910_6POST	3370900	3370906		YPO_RS16070	6
ABI910_6POST	3371007	3371015		YPO_RS16070	8
ABI910_6POST	3371330	3371371		YPO_RS16070	41
ABI910_6POST	3371422	3371434		YPO_RS16070	12
ABI910_6POST	3373409	3373423		YPO_RS16080	14
ABI910_6POST	3373968	3373997		YPO_RS16085	29
ABI910_6POST	3374033	3374078		YPO_RS16085	45
ABI910_6POST	3374316	3374345		YPO_RS16085	29
ABI910_6POST	3376455	3376465		YPO_RS16095	10
ABI910_6POST	3376535	3376537		YPO_RS16095	2
ABI910_6POST	3376635	3376641		YPO_RS16095	6
ABI910_6POST	3376933	3376941		YPO_RS16095	8
ABI910_6POST	3377219	3377229		YPO_RS16100	10
ABI910_6POST	3377296	3377300		YPO_RS16100	4
ABI910_6POST	3378238	3378248		YPO_RS16105	10
ABI910_6POST	3378329	3378338		YPO_RS16105	9
ABI910_6POST	3378436	3378442		YPO_RS16105	6
ABI910_6POST	3378971	3378976		YPO_RS16105	5
ABI910_6POST	3379675	3379729		YPO_RS16110	54
ABI910_6POST	3379771	3379801		YPO_RS16110	30
ABI910_6POST	3380347	3380364		YPO_RS16115	17
ABI910_6POST	3381435	3381446		yapL	11
ABI910_6POST	3381893	3381902		yapL	9
ABI910_6POST	3382039	3382040		yapL	1
ABI910_6POST	3382161	3382170		yapL	9
ABI910_6POST	3382608	3382615		yapL	7
ABI910_6POST	3382734	3382746		yapL	12
ABI910_6POST	3383136	3383141		yapL	5
ABI910_6POST	3384604	3384617		YPO_RS16130	13
ABI910_6POST	3384712	3384720		YPO_RS16130	8
ABI910_6POST	3385073	3385095		hemF	22
ABI910_6POST	3385185	3385209		hemF	24
ABI910_6POST	3386774	3386782		maeB	8
ABI910_6POST	3387210	3387221		maeB	11
ABI910_6POST	3387478	3387498		maeB	20
ABI910_6POST	3387884	3387886		maeB	2
ABI910_6POST	3388393	3388406		maeB	13
ABI910_6POST	3388659	3388683		maeB	24
ABI910_6POST	3389240	3389254		nudK	14
ABI910_6POST	3389878	3389885		napC	7
ABI910_6POST	3390180	3390202		napC	22
ABI910_6POST	3390239	3390260		napC	21
ABI910_6POST	3390567	3390576		napB	9
ABI910_6POST	3390765	3390772		napB	7
ABI910_6POST	3391342	3391343		napA	1
ABI910_6POST	3391741	3391765		napA	24
ABI910_6POST	3391873	3391892		napA	19
ABI910_6POST	3392001	3392017		napA	16
ABI910_6POST	3392187	3392206		napA	19
ABI910_6POST	3393857	3393863		napF	6
ABI910_6POST	3394198	3394206		napF	8
ABI910_6POST	3396579	3396596		acrD	17
ABI910_6POST	3396770	3396771		acrD	1
ABI910_6POST	3397176	3397195		acrD	19
ABI910_6POST	3397328	3397334		acrD	6
ABI910_6POST	3397582	3397596		acrD	14
ABI910_6POST	3397917	3397936		acrD	19
ABI910_6POST	3398140	3398143		acrD	3
ABI910_6POST	3398284	3398299		acrD	15
ABI910_6POST	3398462	3398473		acrD	11
ABI910_6POST	3401125	3401145		YPO_RS16200	20
ABI910_6POST	3402126	3402144		YPO_RS16205	18
ABI910_6POST	3402185	3402188		YPO_RS16205	3
ABI910_6POST	3402247	3402254		YPO_RS16205	7
ABI910_6POST	3402816	3402822		YPO_RS16205	6
ABI910_6POST	3403144	3403147		YPO_RS16205	3
ABI910_6POST	3403357	3403360		YPO_RS16210	3
ABI910_6POST	3403443	3403455		YPO_RS16210	12
ABI910_6POST	3403783	3403786		YPO_RS16210	3
ABI910_6POST	3403936	3403937		YPO_RS16210	1
ABI910_6POST	3404628	3404629		YPO_RS16210	1
ABI910_6POST	3404846	3404848		YPO_RS16210	2
ABI910_6POST	3405326	3405329		YPO_RS16215	3
ABI910_6POST	3405472	3405532		YPO_RS16220	60
ABI910_6POST	3405624	3405661		YPO_RS16220	37
ABI910_6POST	3406085	3406092		YPO_RS16220	7
ABI910_6POST	3406202	3406237		YPO_RS16220	35
ABI910_6POST	3406390	3406399		YPO_RS16220	9
ABI910_6POST	3406542	3406548		YPO_RS16225	6
ABI910_6POST	3406667	3406680		YPO_RS16225	13
ABI910_6POST	3406761	3406809		YPO_RS16225	48
ABI910_6POST	3407091	3407104		YPO_RS16225	13
ABI910_6POST	3407169	3407218		YPO_RS16225	49
ABI910_6POST	3407311	3407338		YPO_RS16225	27
ABI910_6POST	3407421	3407429		YPO_RS16225	8
ABI910_6POST	3407834	3407860		YPO_RS16225	26
ABI910_6POST	3408075	3408093		YPO_RS16225	18
ABI910_6POST	3408361	3408377		YPO_RS16230	16
ABI910_6POST	3408496	3408498		YPO_RS16230	2
ABI910_6POST	3408627	3408651		YPO_RS16230	24
ABI910_6POST	3408768	3408802		YPO_RS16230	34
ABI910_6POST	3409289	3409295		YPO_RS16230	6
ABI910_6POST	3409896	3409910		YPO_RS16235	14
ABI910_6POST	3409944	3409956		YPO_RS16235	12
ABI910_6POST	3410050	3410056		YPO_RS16235	6
ABI910_6POST	3410107	3410133		YPO_RS16235	26
ABI910_6POST	3410488	3410498		YPO_RS16240	10
ABI910_6POST	3410619	3410634		YPO_RS16240	15
ABI910_6POST	3410723	3410742		YPO_RS16240	19
ABI910_6POST	3410957	3410962		dapE	5
ABI910_6POST	3411693	3411707		dapE	14
ABI910_6POST	3412225	3412232		YPO_RS16250	7
ABI910_6POST	3413021	3413034		YPO_RS16260	13
ABI910_6POST	3414457	3414460		YPO_RS16260	3
ABI910_6POST	3415208	3415218		YPO_RS16265	10
ABI910_6POST	3415707	3415708		YPO_RS16270	1
ABI910_6POST	3416117	3416125		YPO_RS16270	8
ABI910_6POST	3416354	3416375		YPO_RS16270	21
ABI910_6POST	3416424	3416439		YPO_RS16270	15
ABI910_6POST	3417062	3417068		purC	6
ABI910_6POST	3417313	3417332		purC	19
ABI910_6POST	3417606	3417620		YPO_RS16280	14
ABI910_6POST	3417666	3417677		YPO_RS16280	11
ABI910_6POST	3418363	3418370		bamC	7
ABI910_6POST	3418864	3418914		bamC	50
ABI910_6POST	3419630	3419676		dapA	46
ABI910_6POST	3419908	3419913		dapA	5
ABI910_6POST	3420060	3420074		dapA	14
ABI910_6POST	3420408	3420437		YPO_RS16295	29
ABI910_6POST	3421055	3421065		bcp	10
ABI910_6POST	3421120	3421148		bcp	28
ABI910_6POST	3421277	3421295		bcp	18
ABI910_6POST	3422273	3422286		YPO_RS16305	13
ABI910_6POST	3422510	3422530		YPO_RS16305	20
ABI910_6POST	3423555	3423559		YPO_RS16310	4
ABI910_6POST	3423820	3423836		YPO_RS16310	16
ABI910_6POST	3424366	3424429		YPO_RS16310	63
ABI910_6POST	3425055	3425067		YPO_RS16315	12
ABI910_6POST	3425774	3425781		YPO_RS16315	7
ABI910_6POST	3425905	3425956		YPO_RS16315	51
ABI910_6POST	3426174	3426177		YPO_RS16315	3
ABI910_6POST	3426649	3426681		arsC	32
ABI910_6POST	3427947	3427949		YPO_RS16330	2
ABI910_6POST	3429256	3429259		cysS	3
ABI910_6POST	3429387	3429411		cysS	24
ABI910_6POST	3429912	3429938		cysS	26
ABI910_6POST	3430927	3430935		YPO_RS16345	8
ABI910_6POST	3431338	3431379		YPO_RS16345	41
ABI910_6POST	3431739	3431741		purE	2
ABI910_6POST	3431949	3431966		purE	17
ABI910_6POST	3432691	3432692		purK	1
ABI910_6POST	3433072	3433081		purK	9
ABI910_6POST	3433526	3433567		YPO_RS16360	41
ABI910_6POST	3433641	3433653		YPO_RS16360	12
ABI910_6POST	3433762	3433763		YPO_RS16360	1
ABI910_6POST	3434287	3434299		YPO_RS16360	12
ABI910_6POST	3434761	3434800		YPO_RS16360	39
ABI910_6POST	3434901	3434911		YPO_RS16360	10
ABI910_6POST	3434984	3435004		YPO_RS16360	20
ABI910_6POST	3436291	3436294		YPO_RS16365	3
ABI910_6POST	3436659	3436661		tesA	2
ABI910_6POST	3436876	3436883		tesA	7
ABI910_6POST	3436996	3436999		tesA	3
ABI910_6POST	3437076	3437084		tesA	8
ABI910_6POST	3437947	3437950		YPO_RS16375	3
ABI910_6POST	3438009	3438016		YPO_RS16375	7
ABI910_6POST	3438180	3438245		YPO_RS16375	65
ABI910_6POST	3440245	3440279		YPO_RS16385	34
ABI910_6POST	3441659	3441679		copA	20
ABI910_6POST	3442094	3442102		copA	8
ABI910_6POST	3442150	3442165		copA	15
ABI910_6POST	3442457	3442466		copA	9
ABI910_6POST	3442639	3442651		copA	12
ABI910_6POST	3442915	3442927		copA	12
ABI910_6POST	3443469	3443483		copA	14
ABI910_6POST	3443689	3443693		copA	4
ABI910_6POST	3444078	3444103		copA	25
ABI910_6POST	3445235	3445239		YPO_RS16405	4
ABI910_6POST	3445452	3445473		YPO_RS16405	21
ABI910_6POST	3445639	3445668		YPO_RS16405	29
ABI910_6POST	3446160	3446178		ybaK	18
ABI910_6POST	3449070	3449085		YPO_RS16425	15
ABI910_6POST	3449380	3449400		YPO_RS16425	20
ABI910_6POST	3449582	3449599		YPO_RS16425	17
ABI910_6POST	3449754	3449801		YPO_RS16425	47
ABI910_6POST	3450008	3450018		YPO_RS16425	10
ABI910_6POST	3450144	3450186		YPO_RS16425	42
ABI910_6POST	3450523	3450536		YPO_RS16430	13
ABI910_6POST	3450615	3450654		YPO_RS16430	39
ABI910_6POST	3450867	3450901		YPO_RS16430	34
ABI910_6POST	3451307	3451308		YPO_RS16430	1
ABI910_6POST	3452412	3452423		YPO_RS16435	11
ABI910_6POST	3453028	3453044		YPO_RS16435	16
ABI910_6POST	3453189	3453206		YPO_RS16435	17
ABI910_6POST	3453833	3453841		fepE	8
ABI910_6POST	3454360	3454372		fepE	12
ABI910_6POST	3454421	3454462		fepE	41
ABI910_6POST	3454764	3454771		fepE	7
ABI910_6POST	3455905	3455950		cpsG	45
ABI910_6POST	3456176	3456190		cpsG	14
ABI910_6POST	3456554	3456564		YPO_RS16450	10
ABI910_6POST	3456938	3456944		YPO_RS16450	6
ABI910_6POST	3457002	3457020		YPO_RS16450	18
ABI910_6POST	3457102	3457130		YPO_RS16450	28
ABI910_6POST	3457133	3457148		YPO_RS16455	15
ABI910_6POST	3457195	3457207		YPO_RS16455	12
ABI910_6POST	3457414	3457416		YPO_RS16455	2
ABI910_6POST	3457665	3457683		YPO_RS16455	18
ABI910_6POST	3458537	3458539		YPO_RS16455	2
ABI910_6POST	3461016	3461042		YPO_RS16470	26
ABI910_6POST	3461112	3461122		YPO_RS16470	10
ABI910_6POST	3461361	3461397		YPO_RS16470	36
ABI910_6POST	3461648	3461652		YPO_RS16470	4
ABI910_6POST	3461801	3461811		YPO_RS16470	10
ABI910_6POST	3463404	3463412		YPO_RS16480	8
ABI910_6POST	3463785	3463802		YPO_RS16480	17
ABI910_6POST	3464172	3464183		YPO_RS16480	11
ABI910_6POST	3464315	3464322		YPO_RS16480	7
ABI910_6POST	3464843	3464875		YPO_RS16485	32
ABI910_6POST	3464967	3464990		YPO_RS16485	23
ABI910_6POST	3465059	3465096		YPO_RS16485	37
ABI910_6POST	3465141	3465149		YPO_RS16485	8
ABI910_6POST	3465329	3465335		YPO_RS16485	6
ABI910_6POST	3465498	3465545		YPO_RS16485	47
ABI910_6POST	3466038	3466039		YPO_RS16490	1
ABI910_6POST	3466165	3466176		YPO_RS16490	11
ABI910_6POST	3466260	3466263		YPO_RS16490	3
ABI910_6POST	3466324	3466337		YPO_RS16490	13
ABI910_6POST	3466446	3466449		YPO_RS16490	3
ABI910_6POST	3466513	3466534		YPO_RS16490	21
ABI910_6POST	3466577	3466585		YPO_RS16490	8
ABI910_6POST	3466805	3466828		YPO_RS16490	23
ABI910_6POST	3466984	3467005		YPO_RS16495	21
ABI910_6POST	3468189	3468220		YPO_RS16495	31
ABI910_6POST	3468403	3468404		YPO_RS16500	1
ABI910_6POST	3468971	3468977		YPO_RS16500	6
ABI910_6POST	3469085	3469091		YPO_RS16500	6
ABI910_6POST	3469351	3469357		rfbH	6
ABI910_6POST	3470404	3470411		rfbH	7
ABI910_6POST	3470678	3470719		rfbG	41
ABI910_6POST	3471589	3471600		rfbF	11
ABI910_6POST	3471713	3471738		rfbF	25
ABI910_6POST	3471876	3471893		rfbF	17
ABI910_6POST	3472128	3472129		rfbF	1
ABI910_6POST	3472530	3472574		YPO_RS16520	44
ABI910_6POST	3474181	3474191		hemH	10
ABI910_6POST	3474285	3474289		hemH	4
ABI910_6POST	3474472	3474474		hemH	2
ABI910_6POST	3474574	3474590		hemH	16
ABI910_6POST	3474823	3474827		hemH	4
ABI910_6POST	3477320	3477333		htpG	13
ABI910_6POST	3478201	3478234		recR	33
ABI910_6POST	3478354	3478356		recR	2
ABI910_6POST	3479289	3479298		dnaX	9
ABI910_6POST	3479766	3479774		dnaX	8
ABI910_6POST	3480586	3480601		dnaX	15
ABI910_6POST	3480917	3480918		dnaX	1
ABI910_6POST	3481702	3481704		apt	2
ABI910_6POST	3481805	3481827		apt	22
ABI910_6POST	3481895	3481910		apt	15
ABI910_6POST	3481971	3481981		apt	10
ABI910_6POST	3482650	3482668		YPO_RS16560	18
ABI910_6POST	3482755	3482760		YPO_RS16560	5
ABI910_6POST	3482851	3482855		YPO_RS16560	4
ABI910_6POST	3482928	3482965		YPO_RS16560	37
ABI910_6POST	3483004	3483013		YPO_RS16560	9
ABI910_6POST	3483144	3483169		YPO_RS16560	25
ABI910_6POST	3486402	3486403		mscK	1
ABI910_6POST	3486474	3486498		mscK	24
ABI910_6POST	3486647	3486672		mscK	25
ABI910_6POST	3486902	3486920		mscK	18
ABI910_6POST	3487027	3487028		mscK	1
ABI910_6POST	3487078	3487080		mscK	2
ABI910_6POST	3487400	3487404		mscK	4
ABI910_6POST	3487695	3487710		mscK	15
ABI910_6POST	3489169	3489173		mscK	4
ABI910_6POST	3489835	3489859		YPO_RS16590	24
ABI910_6POST	3489963	3489980		YPO_RS16590	17
ABI910_6POST	3490087	3490093		YPO_RS16590	6
ABI910_6POST	3490650	3490652		acrR	2
ABI910_6POST	3491211	3491234		YPO_RS16600	23
ABI910_6POST	3491354	3491395		YPO_RS16600	41
ABI910_6POST	3491478	3491481		YPO_RS16600	3
ABI910_6POST	3491725	3491746		YPO_RS16600	21
ABI910_6POST	3492003	3492015		YPO_RS16600	12
ABI910_6POST	3492275	3492282		YPO_RS16605	7
ABI910_6POST	3492395	3492401		YPO_RS16605	6
ABI910_6POST	3492647	3492664		YPO_RS16605	17
ABI910_6POST	3492814	3492823		YPO_RS16605	9
ABI910_6POST	3493188	3493219		YPO_RS16605	31
ABI910_6POST	3493555	3493595		YPO_RS16605	40
ABI910_6POST	3493859	3493899		YPO_RS16605	40
ABI910_6POST	3494224	3494242		YPO_RS16605	18
ABI910_6POST	3494309	3494317		YPO_RS16605	8
ABI910_6POST	3494557	3494565		YPO_RS16605	8
ABI910_6POST	3494659	3494697		YPO_RS16605	38
ABI910_6POST	3494767	3494774		YPO_RS16605	7
ABI910_6POST	3495106	3495117		YPO_RS16605	11
ABI910_6POST	3495515	3495552		YPO_RS16610	37
ABI910_6POST	3496918	3496930		YPO_RS16620	12
ABI910_6POST	3497414	3497416		tomB	2
ABI910_6POST	3499776	3499786		YPO_RS16645	10
ABI910_6POST	3500937	3500964		tesB	27
ABI910_6POST	3501420	3501421		amtB	1
ABI910_6POST	3502021	3502024		amtB	3
ABI910_6POST	3502360	3502376		amtB	16
ABI910_6POST	3503365	3503366		YPO_RS16665	1
ABI910_6POST	3504279	3504345		YPO_RS16665	66
ABI910_6POST	3504558	3504564		YPO_RS16665	6
ABI910_6POST	3504769	3504777		YPO_RS16665	8
ABI910_6POST	3504939	3504951		YPO_RS16665	12
ABI910_6POST	3504997	3505047		YPO_RS16665	50
ABI910_6POST	3505256	3505263		YPO_RS16670	7
ABI910_6POST	3505779	3505828		YPO_RS16670	49
ABI910_6POST	3506082	3506107		YPO_RS16670	25
ABI910_6POST	3506447	3506492		YPO_RS16670	45
ABI910_6POST	3506620	3506642		YPO_RS16670	22
ABI910_6POST	3507850	3507853		YPO_RS16680	3
ABI910_6POST	3508122	3508193		YPO_RS16680	71
ABI910_6POST	3508268	3508272		YPO_RS16680	4
ABI910_6POST	3509420	3509423		cof	3
ABI910_6POST	3509456	3509463		cof	7
ABI910_6POST	3510072	3510085		YPO_RS16690	13
ABI910_6POST	3510886	3510889		YPO_RS16690	3
ABI910_6POST	3511057	3511072		YPO_RS16690	15
ABI910_6POST	3511364	3511369		YPO_RS16690	5
ABI910_6POST	3511753	3511756		queC	3
ABI910_6POST	3512289	3512299		queC	10
ABI910_6POST	3512790	3512800		YPO_RS16700	10
ABI910_6POST	3512910	3512916		YPO_RS16700	6
ABI910_6POST	3514753	3514766		ppiD	13
ABI910_6POST	3515085	3515088		ppiD	3
ABI910_6POST	3515121	3515127		ppiD	6
ABI910_6POST	3516272	3516280		hupB	8
ABI910_6POST	3516534	3516536		lon	2
ABI910_6POST	3516779	3516817		lon	38
ABI910_6POST	3517797	3517801		lon	4
ABI910_6POST	3518383	3518406		lon	23
ABI910_6POST	3519678	3519686		clpX	8
ABI910_6POST	3520041	3520049		clpX	8
ABI910_6POST	3520868	3520877		clpP	9
ABI910_6POST	3520934	3520942		clpP	8
ABI910_6POST	3521027	3521029		clpP	2
ABI910_6POST	3521644	3521645		tig	1
ABI910_6POST	3522525	3522526		tig	1
ABI910_6POST	3522883	3522905		tig	22
ABI910_6POST	3523367	3523379		bolA	12
ABI910_6POST	3524447	3524456		YPO_RS16745	9
ABI910_6POST	3525158	3525168		ampG	10
ABI910_6POST	3525919	3525931		ampG	12
ABI910_6POST	3526029	3526056		ampG	27
ABI910_6POST	3526101	3526110		ampG	9
ABI910_6POST	3527262	3527267		YPO_RS16755	5
ABI910_6POST	3527779	3527780		cyoA	1
ABI910_6POST	3527870	3527873		cyoA	3
ABI910_6POST	3528013	3528018		cyoA	5
ABI910_6POST	3528258	3528274		cyoA	16
ABI910_6POST	3528469	3528489		cyoA	20
ABI910_6POST	3528885	3528891		cyoB	6
ABI910_6POST	3529109	3529198		cyoB	89
ABI910_6POST	3529393	3529412		cyoB	19
ABI910_6POST	3530074	3530093		cyoB	19
ABI910_6POST	3530188	3530222		cyoB	34
ABI910_6POST	3530370	3530377		cyoB	7
ABI910_6POST	3530615	3530627		YPO_RS16770	12
ABI910_6POST	3530738	3530739		YPO_RS16770	1
ABI910_6POST	3530824	3530828		YPO_RS16770	4
ABI910_6POST	3530960	3530966		YPO_RS16770	6
ABI910_6POST	3531104	3531106		YPO_RS16770	2
ABI910_6POST	3531301	3531323		YPO_RS16775	22
ABI910_6POST	3531634	3531650		cyoE	16
ABI910_6POST	3531802	3531827		cyoE	25
ABI910_6POST	3533014	3533022		YPO_RS16785	8
ABI910_6POST	3533125	3533141		YPO_RS16785	16
ABI910_6POST	3533362	3533374		YPO_RS16785	12
ABI910_6POST	3533590	3533593		YPO_RS16785	3
ABI910_6POST	3533757	3533770		YPO_RS16785	13
ABI910_6POST	3534080	3534086		YPO_RS16785	6
ABI910_6POST	3536318	3536319		yajL	1
ABI910_6POST	3536398	3536403		yajL	5
ABI910_6POST	3537207	3537236		thiI	29
ABI910_6POST	3537426	3537436		thiI	10
ABI910_6POST	3537568	3537577		thiI	9
ABI910_6POST	3537889	3537897		thiI	8
ABI910_6POST	3538590	3538593		xseB	3
ABI910_6POST	3538689	3538708		xseB	19
ABI910_6POST	3538713	3538727		ispA	14
ABI910_6POST	3539127	3539136		ispA	9
ABI910_6POST	3539461	3539474		ispA	13
ABI910_6POST	3540462	3540487		dxs	25
ABI910_6POST	3540934	3540949		dxs	15
ABI910_6POST	3541469	3541488		dxs	19
ABI910_6POST	3542204	3542208		YPO_RS16825	4
ABI910_6POST	3542773	3542788		pgpA	15
ABI910_6POST	3543081	3543117		thiL	36
ABI910_6POST	3543607	3543612		thiL	5
ABI910_6POST	3543732	3543738		thiL	6
ABI910_6POST	3545616	3545621		ribD	5
ABI910_6POST	3547055	3547067		YPO_RS16860	12
ABI910_6POST	3547434	3547435		YPO_RS16860	1
ABI910_6POST	3547441	3547444		YPO_RS16860	3
ABI910_6POST	3547480	3547502		YPO_RS16860	22
ABI910_6POST	3547675	3547678		YPO_RS16865	3
ABI910_6POST	3548032	3548042		YPO_RS16865	10
ABI910_6POST	3548121	3548142		YPO_RS16865	21
ABI910_6POST	3549417	3549450		secF	33
ABI910_6POST	3549742	3549749		secF	7
ABI910_6POST	3550132	3550138		secF	6
ABI910_6POST	3550381	3550389		secD	8
ABI910_6POST	3550423	3550432		secD	9
ABI910_6POST	3550491	3550507		secD	16
ABI910_6POST	3550653	3550659		secD	6
ABI910_6POST	3551724	3551761		secD	37
ABI910_6POST	3552430	3552468		yajC	38
ABI910_6POST	3553574	3553584		tgt	10
ABI910_6POST	3553985	3554000		queA	15
ABI910_6POST	3554615	3554633		queA	18
ABI910_6POST	3554719	3554728		queA	9
ABI910_6POST	3555298	3555305		YPO_RS16900	7
ABI910_6POST	3555358	3555373		YPO_RS16900	15
ABI910_6POST	3555572	3555607		YPO_RS16900	35
ABI910_6POST	3556801	3556803		YPO_RS16910	2
ABI910_6POST	3556888	3556891		YPO_RS16910	3
ABI910_6POST	3557257	3557259		YPO_RS16910	2
ABI910_6POST	3559829	3559834		YPO_RS16920	5
ABI910_6POST	3560552	3560557		malZ	5
ABI910_6POST	3560885	3560888		malZ	3
ABI910_6POST	3560969	3560978		malZ	9
ABI910_6POST	3561047	3561054		malZ	7
ABI910_6POST	3562120	3562121		malZ	1
ABI910_6POST	3562164	3562176		malZ	12
ABI910_6POST	3563555	3563556		proY	1
ABI910_6POST	3563686	3563777		proY	91
ABI910_6POST	3563896	3563903		proY	7
ABI910_6POST	3564423	3564458		brnQ	35
ABI910_6POST	3564664	3564672		brnQ	8
ABI910_6POST	3564721	3564723		brnQ	2
ABI910_6POST	3564911	3564928		brnQ	17
ABI910_6POST	3565077	3565086		brnQ	9
ABI910_6POST	3566301	3566306		YPO_RS16945	5
ABI910_6POST	3566714	3566721		YPO_RS16945	7
ABI910_6POST	3566764	3566773		YPO_RS16945	9
ABI910_6POST	3567054	3567079		YPO_RS16945	25
ABI910_6POST	3567301	3567311		phoR	10
ABI910_6POST	3567567	3567570		phoR	3
ABI910_6POST	3568313	3568320		phoR	7
ABI910_6POST	3568700	3568701		phoB	1
ABI910_6POST	3568831	3568835		phoB	4
ABI910_6POST	3569016	3569023		phoB	7
ABI910_6POST	3569079	3569104		phoB	25
ABI910_6POST	3569241	3569249		phoB	8
ABI910_6POST	3569759	3569768		sbcD	9
ABI910_6POST	3569951	3569955		sbcD	4
ABI910_6POST	3570095	3570108		sbcD	13
ABI910_6POST	3570735	3570742		sbcD	7
ABI910_6POST	3571217	3571235		YPO_RS16965	18
ABI910_6POST	3571535	3571605		YPO_RS16965	70
ABI910_6POST	3571843	3571852		YPO_RS16965	9
ABI910_6POST	3571983	3572008		YPO_RS16965	25
ABI910_6POST	3572567	3572582		YPO_RS16965	15
ABI910_6POST	3573124	3573135		YPO_RS16965	11
ABI910_6POST	3573205	3573208		YPO_RS16965	3
ABI910_6POST	3574352	3574381		YPO_RS16965	29
ABI910_6POST	3574422	3574460		YPO_RS16965	38
ABI910_6POST	3574638	3574643		YPO_RS16970	5
ABI910_6POST	3574764	3574778		YPO_RS16970	14
ABI910_6POST	3574888	3574972		YPO_RS16970	84
ABI910_6POST	3575313	3575322		YPO_RS16975	9
ABI910_6POST	3575387	3575394		YPO_RS16975	7
ABI910_6POST	3575574	3575617		YPO_RS16975	43
ABI910_6POST	3576020	3576034		YPO_RS16975	14
ABI910_6POST	3576135	3576144		YPO_RS16975	9
ABI910_6POST	3577123	3577133		mak	10
ABI910_6POST	3577510	3577513		mak	3
ABI910_6POST	3579172	3579178		rdgC	6
ABI910_6POST	3579597	3579599		ppnP	2
ABI910_6POST	3580467	3580520		aroL	53
ABI910_6POST	3581417	3581419		YPO_RS17000	2
ABI910_6POST	3582599	3582601		YPO_RS17005	2
ABI910_6POST	3583721	3583722		YPO_RS17015	1
ABI910_6POST	3584618	3584631		proA	13
ABI910_6POST	3584869	3584879		proA	10
ABI910_6POST	3584917	3584936		proA	19
ABI910_6POST	3585146	3585147		proA	1
ABI910_6POST	3586288	3586298		proB	10
ABI910_6POST	3586400	3586432		proB	32
ABI910_6POST	3588191	3588198		frsA	7
ABI910_6POST	3588359	3588362		frsA	3
ABI910_6POST	3588544	3588560		frsA	16
ABI910_6POST	3589102	3589116		gpt	14
ABI910_6POST	3589201	3589228		gpt	27
ABI910_6POST	3589285	3589298		gpt	13
ABI910_6POST	3589903	3589916		YPO_RS17045	13
ABI910_6POST	3590025	3590036		YPO_RS17045	11
ABI910_6POST	3590390	3590397		YPO_RS17050	7
ABI910_6POST	3591061	3591078		YPO_RS17050	17
ABI910_6POST	3591570	3591576		YPO_RS17050	6
ABI910_6POST	3592526	3592538		YPO_RS17055	12
ABI910_6POST	3592754	3592759		YPO_RS17055	5
ABI910_6POST	3592805	3592809		YPO_RS17055	4
ABI910_6POST	3593283	3593288		YPO_RS17055	5
ABI910_6POST	3595461	3595463		pepD	2
ABI910_6POST	3595929	3595933		pepD	4
ABI910_6POST	3598224	3598235		YPO_RS17070	11
ABI910_6POST	3598487	3598516		YPO_RS17070	29
ABI910_6POST	3598796	3598834		YPO_RS17070	38
ABI910_6POST	3599453	3599469		nqrM	16
ABI910_6POST	3599990	3600017		YPO_RS17080	27
ABI910_6POST	3600330	3600331		YPO_RS17080	1
ABI910_6POST	3600556	3600576		YPO_RS17080	20
ABI910_6POST	3600823	3600851		nqrF	28
ABI910_6POST	3601410	3601435		nqrF	25
ABI910_6POST	3602535	3602556		YPO_RS17095	21
ABI910_6POST	3602708	3602714		YPO_RS17095	6
ABI910_6POST	3602865	3602875		YPO_RS17095	10
ABI910_6POST	3603328	3603344		YPO_RS17100	16
ABI910_6POST	3603436	3603443		YPO_RS17100	7
ABI910_6POST	3603525	3603527		YPO_RS17100	2
ABI910_6POST	3604092	3604104		YPO_RS17105	12
ABI910_6POST	3604353	3604370		YPO_RS17105	17
ABI910_6POST	3604425	3604432		YPO_RS17105	7
ABI910_6POST	3604604	3604640		YPO_RS17105	36
ABI910_6POST	3604824	3604847		YPO_RS17105	23
ABI910_6POST	3605350	3605376		YPO_RS17110	26
ABI910_6POST	3605535	3605590		YPO_RS17110	55
ABI910_6POST	3606402	3606414		YPO_RS17110	12
ABI910_6POST	3607070	3607082		YPO_RS17115	12
ABI910_6POST	3607620	3607623		YPO_RS17115	3
ABI910_6POST	3607791	3607812		YPO_RS17120	21
ABI910_6POST	3607932	3607941		YPO_RS17120	9
ABI910_6POST	3608159	3608182		YPO_RS17120	23
ABI910_6POST	3608381	3608393		YPO_RS17120	12
ABI910_6POST	3608686	3608701		lpcA	15
ABI910_6POST	3609001	3609010		lpcA	9
ABI910_6POST	3609103	3609106		lpcA	3
ABI910_6POST	3610260	3610264		YPO_RS17130	4
ABI910_6POST	3610427	3610457		YPO_RS17130	30
ABI910_6POST	3611178	3611185		YPO_RS17130	7
ABI910_6POST	3611256	3611267		YPO_RS17130	11
ABI910_6POST	3611423	3611439		YPO_RS17130	16
ABI910_6POST	3611891	3611905		YPO_RS17130	14
ABI910_6POST	3612514	3612521		YPO_RS17135	7
ABI910_6POST	3612607	3612609		YPO_RS17135	2
ABI910_6POST	3612864	3612867		YPO_RS17140	3
ABI910_6POST	3613291	3613317		YPO_RS17140	26
ABI910_6POST	3613393	3613399		YPO_RS17140	6
ABI910_6POST	3613500	3613508		YPO_RS17140	8
ABI910_6POST	3613622	3613632		YPO_RS17140	10
ABI910_6POST	3614122	3614133		YPO_RS17140	11
ABI910_6POST	3614586	3614596		YPO_RS17140	10
ABI910_6POST	3614685	3614688		YPO_RS17140	3
ABI910_6POST	3614883	3614890		YPO_RS17145	7
ABI910_6POST	3615169	3615194		YPO_RS17145	25
ABI910_6POST	3615514	3615516		YPO_RS17145	2
ABI910_6POST	3615647	3615665		YPO_RS17145	18
ABI910_6POST	3615832	3615842		YPO_RS17145	10
ABI910_6POST	3615916	3615935		YPO_RS17145	19
ABI910_6POST	3616076	3616123		YPO_RS17145	47
ABI910_6POST	3616209	3616211		YPO_RS17145	2
ABI910_6POST	3616275	3616296		YPO_RS17145	21
ABI910_6POST	3616559	3616577		YPO_RS17145	18
ABI910_6POST	3616761	3616780		YPO_RS17145	19
ABI910_6POST	3617457	3617466		YPO_RS17145	9
ABI910_6POST	3617958	3617983		YPO_RS17145	25
ABI910_6POST	3618911	3618914		YPO_RS17145	3
ABI910_6POST	3619208	3619216		YPO_RS17145	8
ABI910_6POST	3619334	3619346		YPO_RS17145	12
ABI910_6POST	3619469	3619507		YPO_RS17145	38
ABI910_6POST	3619912	3619918		YPO_RS17145	6
ABI910_6POST	3620153	3620184		YPO_RS17145	31
ABI910_6POST	3621395	3621398		YPO_RS17150	3
ABI910_6POST	3621578	3621583		YPO_RS17150	5
ABI910_6POST	3621735	3621736		YPO_RS17150	1
ABI910_6POST	3621843	3621845		YPO_RS17150	2
ABI910_6POST	3622177	3622209		YPO_RS17150	32
ABI910_6POST	3622311	3622326		YPO_RS17150	15
ABI910_6POST	3623589	3623600		YPO_RS17160	11
ABI910_6POST	3624103	3624111		YPO_RS17160	8
ABI910_6POST	3624570	3624587		YPO_RS17160	17
ABI910_6POST	3624855	3624889		YPO_RS17165	34
ABI910_6POST	3625077	3625081		YPO_RS17165	4
ABI910_6POST	3625196	3625213		YPO_RS17165	17
ABI910_6POST	3625248	3625256		YPO_RS17165	8
ABI910_6POST	3625515	3625520		YPO_RS17170	5
ABI910_6POST	3625723	3625733		YPO_RS17170	10
ABI910_6POST	3625775	3625792		YPO_RS17170	17
ABI910_6POST	3625943	3625945		YPO_RS17170	2
ABI910_6POST	3626039	3626089		YPO_RS17170	50
ABI910_6POST	3626195	3626251		YPO_RS17170	56
ABI910_6POST	3626315	3626316		YPO_RS17170	1
ABI910_6POST	3626434	3626446		YPO_RS17175	12
ABI910_6POST	3626688	3626807		YPO_RS17175	119
ABI910_6POST	3626976	3626992		YPO_RS17175	16
ABI910_6POST	3627036	3627051		YPO_RS17175	15
ABI910_6POST	3627113	3627116		YPO_RS17175	3
ABI910_6POST	3627409	3627424		YPO_RS17180	15
ABI910_6POST	3628070	3628074		YPO_RS17180	4
ABI910_6POST	3628153	3628158		YPO_RS17185	5
ABI910_6POST	3628249	3628259		YPO_RS17185	10
ABI910_6POST	3628535	3628543		YPO_RS17185	8
ABI910_6POST	3629292	3629293		YPO_RS17190	1
ABI910_6POST	3629845	3629866		YPO_RS17195	21
ABI910_6POST	3630209	3630219		YPO_RS17200	10
ABI910_6POST	3630752	3630757		YPO_RS17200	5
ABI910_6POST	3630808	3630830		YPO_RS17200	22
ABI910_6POST	3630955	3630960		YPO_RS17200	5
ABI910_6POST	3631474	3631489		YPO_RS17205	15
ABI910_6POST	3631709	3631710		YPO_RS17205	1
ABI910_6POST	3632051	3632062		YPO_RS17205	11
ABI910_6POST	3632111	3632113		YPO_RS17205	2
ABI910_6POST	3632473	3632474		hpxX	1
ABI910_6POST	3632539	3632544		hpxX	5
ABI910_6POST	3632670	3632671		hpxX	1
ABI910_6POST	3632670	3632676		YPO_RS17215	6
ABI910_6POST	3633008	3633026		YPO_RS17215	18
ABI910_6POST	3633085	3633096		YPO_RS17215	11
ABI910_6POST	3633163	3633173		YPO_RS17215	10
ABI910_6POST	3633274	3633281		YPO_RS17215	7
ABI910_6POST	3633428	3633450		YPO_RS17215	22
ABI910_6POST	3633508	3633511		YPO_RS17215	3
ABI910_6POST	3633672	3633706		YPO_RS17215	34
ABI910_6POST	3633785	3633796		YPO_RS17215	11
ABI910_6POST	3633869	3633896		YPO_RS17215	27
ABI910_6POST	3634184	3634212		hpxZ	28
ABI910_6POST	3634254	3634261		hpxZ	7
ABI910_6POST	3634367	3634394		hpxZ	27
ABI910_6POST	3634876	3634885		YPO_RS17225	9
ABI910_6POST	3635171	3635176		YPO_RS17225	5
ABI910_6POST	3635223	3635227		YPO_RS17225	4
ABI910_6POST	3635899	3635902		YPO_RS17225	3
ABI910_6POST	3636154	3636170		YPO_RS17230	16
ABI910_6POST	3636355	3636368		YPO_RS17230	13
ABI910_6POST	3636403	3636411		YPO_RS17230	8
ABI910_6POST	3636669	3636675		YPO_RS17230	6
ABI910_6POST	3637870	3637872		mprA	2
ABI910_6POST	3638454	3638461		emrA	7
ABI910_6POST	3638765	3638783		emrA	18
ABI910_6POST	3639016	3639043		emrA	27
ABI910_6POST	3639681	3639685		emrB	4
ABI910_6POST	3639785	3639789		emrB	4
ABI910_6POST	3640083	3640090		emrB	7
ABI910_6POST	3640144	3640169		emrB	25
ABI910_6POST	3640416	3640465		emrB	49
ABI910_6POST	3640944	3640947		emrB	3
ABI910_6POST	3641046	3641048		emrB	2
ABI910_6POST	3641613	3641622		YPO_RS17255	9
ABI910_6POST	3642045	3642055		YPO_RS17255	10
ABI910_6POST	3642911	3642917		trxC	6
ABI910_6POST	3643225	3643231		YPO_RS17265	6
ABI910_6POST	3643728	3643749		YPO_RS17265	21
ABI910_6POST	3644013	3644014		YPO_RS17270	1
ABI910_6POST	3644214	3644218		YPO_RS17270	4
ABI910_6POST	3644399	3644415		YPO_RS17270	16
ABI910_6POST	3644486	3644493		YPO_RS17270	7
ABI910_6POST	3644757	3644762		YPO_RS17270	5
ABI910_6POST	3644802	3644814		YPO_RS17270	12
ABI910_6POST	3644901	3644916		YPO_RS17270	15
ABI910_6POST	3645039	3645044		YPO_RS17270	5
ABI910_6POST	3645279	3645288		YPO_RS17270	9
ABI910_6POST	3645325	3645328		YPO_RS17270	3
ABI910_6POST	3645461	3645472		YPO_RS17270	11
ABI910_6POST	3646077	3646079		YPO_RS17270	2
ABI910_6POST	3646374	3646397		YPO_RS17270	23
ABI910_6POST	3647437	3647466		pssA	29
ABI910_6POST	3647639	3647649		pssA	10
ABI910_6POST	3647703	3647710		pssA	7
ABI910_6POST	3648051	3648054		pssA	3
ABI910_6POST	3648303	3648312		YPO_RS17280	9
ABI910_6POST	3649299	3649305		YPO_RS17290	6
ABI910_6POST	3649744	3649750		YPO_RS17290	6
ABI910_6POST	3649926	3649937		YPO_RS17290	11
ABI910_6POST	3653505	3653511		YPO_RS17305	6
ABI910_6POST	3653925	3653926		YPO_RS17305	1
ABI910_6POST	3654002	3654018		YPO_RS17305	16
ABI910_6POST	3654244	3654259		YPO_RS17310	15
ABI910_6POST	3655021	3655035		clpB	14
ABI910_6POST	3655111	3655140		clpB	29
ABI910_6POST	3655297	3655306		clpB	9
ABI910_6POST	3656150	3656191		clpB	41
ABI910_6POST	3656388	3656398		clpB	10
ABI910_6POST	3656803	3656805		clpB	2
ABI910_6POST	3656877	3656879		clpB	2
ABI910_6POST	3657400	3657425		pgeF	25
ABI910_6POST	3657792	3657804		pgeF	12
ABI910_6POST	3657892	3657894		pgeF	2
ABI910_6POST	3658230	3658247		rluD	17
ABI910_6POST	3658348	3658370		rluD	22
ABI910_6POST	3658438	3658450		rluD	12
ABI910_6POST	3658505	3658511		rluD	6
ABI910_6POST	3661044	3661045		YPO_RS17340	1
ABI910_6POST	3661150	3661154		YPO_RS17340	4
ABI910_6POST	3662106	3662109		pheA	3
ABI910_6POST	3662223	3662249		pheA	26
ABI910_6POST	3662692	3662699		pheA	7
ABI910_6POST	3663098	3663118		YPO_RS17350	20
ABI910_6POST	3663153	3663170		YPO_RS17350	17
ABI910_6POST	3663368	3663378		YPO_RS17350	10
ABI910_6POST	3663450	3663508		YPO_RS17350	58
ABI910_6POST	3663567	3663583		YPO_RS17350	16
ABI910_6POST	3663738	3663755		YPO_RS17350	17
ABI910_6POST	3663878	3663888		YPO_RS17355	10
ABI910_6POST	3664123	3664172		YPO_RS17355	49
ABI910_6POST	3664386	3664418		YPO_RS17355	32
ABI910_6POST	3665406	3665420		tyrA	14
ABI910_6POST	3665509	3665548		tyrA	39
ABI910_6POST	3665930	3665933		tyrA	3
ABI910_6POST	3666117	3666119		YPO_RS17370	2
ABI910_6POST	3666610	3666616		YPO_RS17370	6
ABI910_6POST	3666690	3666696		YPO_RS17370	6
ABI910_6POST	3666776	3666783		YPO_RS17370	7
ABI910_6POST	3666853	3666867		YPO_RS17370	14
ABI910_6POST	3667887	3667903		yehT	16
ABI910_6POST	3670289	3670306		YPO_RS17385	17
ABI910_6POST	3670658	3670679		YPO_RS17385	21
ABI910_6POST	3671517	3671520		YPO_RS17390	3
ABI910_6POST	3671750	3671759		YPO_RS17390	9
ABI910_6POST	3672993	3672999		trmD	6
ABI910_6POST	3673404	3673422		rimM	18
ABI910_6POST	3673938	3673939		rpsP	1
ABI910_6POST	3674358	3674367		ffh	9
ABI910_6POST	3676614	3676619		YPO_RS17425	5
ABI910_6POST	3676710	3676724		YPO_RS17425	14
ABI910_6POST	3677206	3677213		YPO_RS17425	7
ABI910_6POST	3677824	3677835		YPO_RS17425	11
ABI910_6POST	3678050	3678056		YPO_RS17430	6
ABI910_6POST	3678155	3678175		YPO_RS17430	20
ABI910_6POST	3678248	3678259		YPO_RS17430	11
ABI910_6POST	3678289	3678306		YPO_RS17430	17
ABI910_6POST	3678489	3678490		YPO_RS17430	1
ABI910_6POST	3678814	3678831		luxS	17
ABI910_6POST	3678924	3678942		luxS	18
ABI910_6POST	3679564	3679567		gshA	3
ABI910_6POST	3679750	3679763		gshA	13
ABI910_6POST	3680057	3680060		gshA	3
ABI910_6POST	3680160	3680173		gshA	13
ABI910_6POST	3680774	3680778		gshA	4
ABI910_6POST	3681141	3681146		YPO_RS17445	5
ABI910_6POST	3681212	3681215		YPO_RS17445	3
ABI910_6POST	3681727	3681741		yqaB	14
ABI910_6POST	3681909	3681913		yqaB	4
ABI910_6POST	3681986	3681997		yqaB	11
ABI910_6POST	3682383	3682386		YPO_RS17455	3
ABI910_6POST	3682460	3682461		YPO_RS17460	1
ABI910_6POST	3682487	3682492		YPO_RS17460	5
ABI910_6POST	3682626	3682641		YPO_RS17465	15
ABI910_6POST	3682880	3682889		YPO_RS17475	9
ABI910_6POST	3683744	3683747		alaS	3
ABI910_6POST	3683799	3683802		alaS	3
ABI910_6POST	3683883	3683928		alaS	45
ABI910_6POST	3685620	3685639		alaS	19
ABI910_6POST	3685759	3685764		alaS	5
ABI910_6POST	3686248	3686256		alaS	8
ABI910_6POST	3686697	3686713		recX	16
ABI910_6POST	3687008	3687021		recX	13
ABI910_6POST	3688673	3688677		pncC	4
ABI910_6POST	3688762	3688766		pncC	4
ABI910_6POST	3689248	3689255		YPO_RS17505	7
ABI910_6POST	3689587	3689625		YPO_RS17505	38
ABI910_6POST	3690010	3690018		YPO_RS17505	8
ABI910_6POST	3691258	3691269		YPO_RS17510	11
ABI910_6POST	3691541	3691550		YPO_RS17510	9
ABI910_6POST	3692147	3692161		YPO_RS17515	14
ABI910_6POST	3692220	3692256		YPO_RS17515	36
ABI910_6POST	3692619	3692624		YPO_RS17515	5
ABI910_6POST	3692977	3693015		YPO_RS17515	38
ABI910_6POST	3693938	3693941		YPO_RS17520	3
ABI910_6POST	3694045	3694059		YPO_RS17520	14
ABI910_6POST	3694136	3694149		YPO_RS17520	13
ABI910_6POST	3694665	3694683		YPO_RS17520	18
ABI910_6POST	3694750	3694762		YPO_RS17520	12
ABI910_6POST	3694993	3695007		YPO_RS17525	14
ABI910_6POST	3695364	3695368		YPO_RS17525	4
ABI910_6POST	3695593	3695610		YPO_RS17525	17
ABI910_6POST	3695849	3695854		YPO_RS17530	5
ABI910_6POST	3696526	3696541		YPO_RS17530	15
ABI910_6POST	3697424	3697434		YPO_RS17535	10
ABI910_6POST	3697547	3697568		YPO_RS17535	21
ABI910_6POST	3697675	3697693		YPO_RS17535	18
ABI910_6POST	3698573	3698575		YPO_RS17540	2
ABI910_6POST	3698646	3698654		YPO_RS17540	8
ABI910_6POST	3699523	3699531		YPO_RS17540	8
ABI910_6POST	3699599	3699602		YPO_RS17545	3
ABI910_6POST	3699717	3699719		YPO_RS17545	2
ABI910_6POST	3699870	3699877		YPO_RS17545	7
ABI910_6POST	3700028	3700036		YPO_RS17545	8
ABI910_6POST	3700463	3700495		YPO_RS17550	32
ABI910_6POST	3700754	3700765		YPO_RS17550	11
ABI910_6POST	3701083	3701124		YPO_RS17550	41
ABI910_6POST	3701802	3701814		katG	12
ABI910_6POST	3702310	3702326		katG	16
ABI910_6POST	3702407	3702423		katG	16
ABI910_6POST	3702646	3702656		katG	10
ABI910_6POST	3702845	3702849		katG	4
ABI910_6POST	3702996	3703015		katG	19
ABI910_6POST	3703758	3703763		katG	5
ABI910_6POST	3704118	3704120		cybC	2
ABI910_6POST	3704389	3704409		cybC	20
ABI910_6POST	3704733	3704748		cybB	15
ABI910_6POST	3704956	3704959		cybB	3
ABI910_6POST	3705344	3705376		dmsD	32
ABI910_6POST	3705702	3705754		dmsD	52
ABI910_6POST	3706200	3706231		YPO_RS17575	31
ABI910_6POST	3706479	3706486		YPO_RS17575	7
ABI910_6POST	3706569	3706576		YPO_RS17575	7
ABI910_6POST	3707099	3707123		dmsB	24
ABI910_6POST	3707465	3707492		dmsB	27
ABI910_6POST	3707778	3707839		dmsA	61
ABI910_6POST	3708000	3708002		dmsA	2
ABI910_6POST	3708353	3708359		dmsA	6
ABI910_6POST	3708423	3708424		dmsA	1
ABI910_6POST	3709320	3709337		dmsA	17
ABI910_6POST	3709375	3709391		dmsA	16
ABI910_6POST	3709425	3709483		dmsA	58
ABI910_6POST	3709822	3709833		dmsA	11
ABI910_6POST	3713093	3713103		YPO_RS17600	10
ABI910_6POST	3713153	3713154		YPO_RS17600	1
ABI910_6POST	3713337	3713345		YPO_RS17600	8
ABI910_6POST	3713415	3713427		YPO_RS17600	12
ABI910_6POST	3713716	3713731		YPO_RS17600	15
ABI910_6POST	3714227	3714229		YPO_RS17605	2
ABI910_6POST	3715288	3715294		YPO_RS17610	6
ABI910_6POST	3715554	3715563		YPO_RS17610	9
ABI910_6POST	3715750	3715756		YPO_RS17610	6
ABI910_6POST	3716193	3716201		YPO_RS17610	8
ABI910_6POST	3716520	3716536		YPO_RS17615	16
ABI910_6POST	3716690	3716737		YPO_RS17615	47
ABI910_6POST	3717009	3717026		YPO_RS17615	17
ABI910_6POST	3717068	3717094		YPO_RS17615	26
ABI910_6POST	3717151	3717182		YPO_RS17615	31
ABI910_6POST	3717832	3717841		YPO_RS17620	9
ABI910_6POST	3717906	3717908		YPO_RS17620	2
ABI910_6POST	3718001	3718010		YPO_RS17620	9
ABI910_6POST	3718159	3718170		YPO_RS17620	11
ABI910_6POST	3718219	3718221		YPO_RS17620	2
ABI910_6POST	3718620	3718640		YPO_RS17625	20
ABI910_6POST	3718755	3718767		YPO_RS17625	12
ABI910_6POST	3719641	3719655		YPO_RS17630	14
ABI910_6POST	3719768	3719775		YPO_RS17630	7
ABI910_6POST	3720149	3720152		YPO_RS17630	3
ABI910_6POST	3720229	3720241		YPO_RS17630	12
ABI910_6POST	3720281	3720355		YPO_RS17630	74
ABI910_6POST	3720543	3720591		YPO_RS17630	48
ABI910_6POST	3720801	3720828		YPO_RS17630	27
ABI910_6POST	3720863	3720882		YPO_RS17630	19
ABI910_6POST	3721843	3721868		YPO_RS17635	25
ABI910_6POST	3722201	3722211		YPO_RS17635	10
ABI910_6POST	3722292	3722319		YPO_RS17635	27
ABI910_6POST	3722733	3722748		YPO_RS17635	15
ABI910_6POST	3723200	3723208		YPO_RS17640	8
ABI910_6POST	3723750	3723766		map	16
ABI910_6POST	3723871	3723874		map	3
ABI910_6POST	3724185	3724219		map	34
ABI910_6POST	3725183	3725190		YPO_RS17650	7
ABI910_6POST	3725281	3725284		YPO_RS17650	3
ABI910_6POST	3725457	3725485		YPO_RS17650	28
ABI910_6POST	3725661	3725664		YPO_RS17650	3
ABI910_6POST	3725769	3725772		YPO_RS17650	3
ABI910_6POST	3729046	3729062		YPO_RS17665	16
ABI910_6POST	3729464	3729518		YPO_RS17665	54
ABI910_6POST	3730030	3730046		YPO_RS17665	16
ABI910_6POST	3731095	3731100		YPO_RS17670	5
ABI910_6POST	3731687	3731689		YPO_RS17675	2
ABI910_6POST	3731733	3731752		YPO_RS17675	19
ABI910_6POST	3732972	3732978		arsB	6
ABI910_6POST	3733209	3733218		arsB	9
ABI910_6POST	3733646	3733653		arsB	7
ABI910_6POST	3734185	3734194		arsB	9
ABI910_6POST	3734811	3734812		YPO_RS17695	1
ABI910_6POST	3735603	3735615		YPO_RS17695	12
ABI910_6POST	3736164	3736165		dhaL	1
ABI910_6POST	3736511	3736517		dhaL	6
ABI910_6POST	3736589	3736599		YPO_RS17705	10
ABI910_6POST	3736694	3736696		YPO_RS17705	2
ABI910_6POST	3737149	3737165		YPO_RS17705	16
ABI910_6POST	3737404	3737427		YPO_RS17705	23
ABI910_6POST	3737531	3737545		YPO_RS17705	14
ABI910_6POST	3737664	3737677		YPO_RS17710	13
ABI910_6POST	3737910	3737924		YPO_RS17710	14
ABI910_6POST	3737954	3737955		YPO_RS17710	1
ABI910_6POST	3738303	3738304		YPO_RS17710	1
ABI910_6POST	3738656	3738665		YPO_RS17715	9
ABI910_6POST	3739297	3739299		YPO_RS17715	2
ABI910_6POST	3739411	3739443		YPO_RS17715	32
ABI910_6POST	3739560	3739573		YPO_RS17715	13
ABI910_6POST	3741377	3741395		mutS	18
ABI910_6POST	3741771	3741779		mutS	8
ABI910_6POST	3741961	3741966		mutS	5
ABI910_6POST	3742055	3742061		mutS	6
ABI910_6POST	3742617	3742620		mutS	3
ABI910_6POST	3743268	3743273		mutS	5
ABI910_6POST	3744584	3744587		rpoS	3
ABI910_6POST	3744849	3744850		rpoS	1
ABI910_6POST	3745896	3745912		nlpD	16
ABI910_6POST	3746051	3746058		nlpD	7
ABI910_6POST	3746185	3746200		nlpD	15
ABI910_6POST	3747433	3747461		surE	28
ABI910_6POST	3748289	3748318		truD	29
ABI910_6POST	3748563	3748575		truD	12
ABI910_6POST	3749560	3749580		ispD	20
ABI910_6POST	3749859	3749862		ispD	3
ABI910_6POST	3750910	3750921		YPO_RS17770	11
ABI910_6POST	3751854	3751878		cysC	24
ABI910_6POST	3751947	3751963		cysN	16
ABI910_6POST	3752015	3752019		cysN	4
ABI910_6POST	3752278	3752298		cysN	20
ABI910_6POST	3752558	3752562		cysN	4
ABI910_6POST	3752648	3752654		cysN	6
ABI910_6POST	3753141	3753160		cysN	19
ABI910_6POST	3754500	3754501		cobA	1
ABI910_6POST	3754610	3754611		cobA	1
ABI910_6POST	3754820	3754842		cobA	22
ABI910_6POST	3755334	3755351		cobA	17
ABI910_6POST	3756778	3756788		YPO_RS17805	10
ABI910_6POST	3757138	3757139		YPO_RS17805	1
ABI910_6POST	3758205	3758213		cysI	8
ABI910_6POST	3758331	3758333		cysI	2
ABI910_6POST	3758539	3758550		cysI	11
ABI910_6POST	3758745	3758750		cysI	5
ABI910_6POST	3758836	3758839		cysI	3
ABI910_6POST	3758925	3758953		cysI	28
ABI910_6POST	3759118	3759128		cysI	10
ABI910_6POST	3759257	3759260		cysI	3
ABI910_6POST	3759546	3759564		cysI	18
ABI910_6POST	3759692	3759711		cysI	19
ABI910_6POST	3760242	3760243		cysJ	1
ABI910_6POST	3760419	3760430		cysJ	11
ABI910_6POST	3760863	3760872		cysJ	9
ABI910_6POST	3761357	3761363		cysJ	6
ABI910_6POST	3761522	3761528		cysJ	6
ABI910_6POST	3763246	3763247		queE	1
ABI910_6POST	3763709	3763744		YPO_RS17840	35
ABI910_6POST	3764670	3764671		eno	1
ABI910_6POST	3765156	3765163		eno	7
ABI910_6POST	3767732	3767738		mazG	6
ABI910_6POST	3767955	3767980		mazG	25
ABI910_6POST	3768766	3768793		relA	27
ABI910_6POST	3769209	3769213		relA	4
ABI910_6POST	3769298	3769305		relA	7
ABI910_6POST	3769578	3769584		relA	6
ABI910_6POST	3770790	3770791		relA	1
ABI910_6POST	3770952	3770972		YPO_RS17865	20
ABI910_6POST	3771003	3771021		YPO_RS17865	18
ABI910_6POST	3771239	3771240		YPO_RS17870	1
ABI910_6POST	3771459	3771470		barA	11
ABI910_6POST	3771518	3771522		barA	4
ABI910_6POST	3771831	3771862		barA	31
ABI910_6POST	3771990	3771997		barA	7
ABI910_6POST	3772568	3772575		barA	7
ABI910_6POST	3773718	3773730		barA	12
ABI910_6POST	3773782	3773783		barA	1
ABI910_6POST	3773835	3773847		barA	12
ABI910_6POST	3774021	3774027		barA	6
ABI910_6POST	3774353	3774360		degP	7
ABI910_6POST	3774571	3774591		degP	20
ABI910_6POST	3774991	3775010		degP	19
ABI910_6POST	3775146	3775178		degP	32
ABI910_6POST	3775399	3775404		degP	5
ABI910_6POST	3775481	3775490		degP	9
ABI910_6POST	3775604	3775622		degP	18
ABI910_6POST	3776288	3776292		dgt	4
ABI910_6POST	3776607	3776629		dgt	22
ABI910_6POST	3777027	3777059		dgt	32
ABI910_6POST	3778534	3778545		btuF	11
ABI910_6POST	3778916	3778918		btuF	2
ABI910_6POST	3779234	3779237		btuF	3
ABI910_6POST	3779475	3779502		YPO_RS17900	27
ABI910_6POST	3779564	3779577		YPO_RS17900	13
ABI910_6POST	3779729	3779745		YPO_RS17900	16
ABI910_6POST	3780428	3780452		erpA	24
ABI910_6POST	3780845	3780854		clcA	9
ABI910_6POST	3781403	3781412		clcA	9
ABI910_6POST	3782070	3782078		clcA	8
ABI910_6POST	3782572	3782579		hemL	7
ABI910_6POST	3782618	3782644		hemL	26
ABI910_6POST	3782691	3782698		hemL	7
ABI910_6POST	3783327	3783332		hemL	5
ABI910_6POST	3783724	3783727		hemL	3
ABI910_6POST	3784206	3784209		fhuB	3
ABI910_6POST	3784572	3784594		fhuB	22
ABI910_6POST	3784700	3784701		fhuB	1
ABI910_6POST	3784793	3784803		fhuB	10
ABI910_6POST	3785331	3785341		fhuB	10
ABI910_6POST	3785491	3785503		fhuB	12
ABI910_6POST	3785609	3785624		fhuB	15
ABI910_6POST	3785868	3785906		fhuB	38
ABI910_6POST	3786059	3786076		fhuB	17
ABI910_6POST	3786198	3786199		fhuB	1
ABI910_6POST	3786198	3786199		fhuD	1
ABI910_6POST	3786697	3786713		fhuD	16
ABI910_6POST	3786873	3786880		fhuD	7
ABI910_6POST	3786981	3787019		fhuD	38
ABI910_6POST	3787190	3787204		fhuD	14
ABI910_6POST	3787525	3787600		fhuC	75
ABI910_6POST	3788070	3788079		fhuC	9
ABI910_6POST	3789272	3789273		mrcB	1
ABI910_6POST	3789954	3789991		mrcB	37
ABI910_6POST	3790167	3790169		mrcB	2
ABI910_6POST	3791088	3791099		hrpB	11
ABI910_6POST	3791172	3791187		hrpB	15
ABI910_6POST	3791218	3791249		hrpB	31
ABI910_6POST	3791494	3791501		hrpB	7
ABI910_6POST	3791875	3791879		hrpB	4
ABI910_6POST	3792193	3792219		hrpB	26
ABI910_6POST	3792265	3792272		hrpB	7
ABI910_6POST	3792430	3792441		hrpB	11
ABI910_6POST	3793401	3793407		hrpB	6
ABI910_6POST	3793890	3793920		thpR	30
ABI910_6POST	3794469	3794495		sfsA	26
ABI910_6POST	3796267	3796279		gluQRS	12
ABI910_6POST	3797292	3797315		pcnB	23
ABI910_6POST	3798217	3798252		pcnB	35
ABI910_6POST	3798502	3798506		folK	4
ABI910_6POST	3799708	3799709		panB	1
ABI910_6POST	3799744	3799753		panB	9
ABI910_6POST	3799957	3799974		panB	17
ABI910_6POST	3800161	3800188		panC	27
ABI910_6POST	3800587	3800596		panC	9
ABI910_6POST	3801353	3801363		panD	10
ABI910_6POST	3801646	3801649		panD	3
ABI910_6POST	3801719	3801731		panD	12
ABI910_6POST	3801959	3801961		YPO_RS17990	2
ABI910_6POST	3802545	3802583		YPO_RS17990	38
ABI910_6POST	3802631	3802710		YPO_RS17990	79
ABI910_6POST	3803557	3803558		YPO_RS17995	1
ABI910_6POST	3803619	3803621		YPO_RS17995	2
ABI910_6POST	3804068	3804079		YPO_RS17995	11
ABI910_6POST	3804153	3804162		YPO_RS17995	9
ABI910_6POST	3804337	3804340		YPO_RS18000	3
ABI910_6POST	3804773	3804786		YPO_RS18000	13
ABI910_6POST	3805646	3805650		can	4
ABI910_6POST	3807136	3807140		cueO	4
ABI910_6POST	3807298	3807348		cueO	50
ABI910_6POST	3807572	3807588		cueO	16
ABI910_6POST	3807845	3807866		cueO	21
ABI910_6POST	3809107	3809110		YPO_RS18020	3
ABI910_6POST	3812176	3812193		YPO_RS18035	17
ABI910_6POST	3813220	3813242		acnB	22
ABI910_6POST	3813404	3813411		acnB	7
ABI910_6POST	3814968	3814970		acnB	2
ABI910_6POST	3815021	3815032		acnB	11
ABI910_6POST	3815309	3815310		acnB	1
ABI910_6POST	3815586	3815606		acnB	20
ABI910_6POST	3816542	3816553		YPO_RS18050	11
ABI910_6POST	3817188	3817191		lpdA	3
ABI910_6POST	3817424	3817429		lpdA	5
ABI910_6POST	3817751	3817753		lpdA	2
ABI910_6POST	3817809	3817815		lpdA	6
ABI910_6POST	3818140	3818151		lpdA	11
ABI910_6POST	3818387	3818411		lpdA	24
ABI910_6POST	3818442	3818452		lpdA	10
ABI910_6POST	3819385	3819392		aceF	7
ABI910_6POST	3819512	3819521		aceF	9
ABI910_6POST	3820267	3820280		aceF	13
ABI910_6POST	3821788	3821802		aceE	14
ABI910_6POST	3822044	3822047		aceE	3
ABI910_6POST	3822090	3822091		aceE	1
ABI910_6POST	3822300	3822305		aceE	5
ABI910_6POST	3822362	3822373		aceE	11
ABI910_6POST	3822935	3822964		aceE	29
ABI910_6POST	3823578	3823582		pdhR	4
ABI910_6POST	3824833	3824878		YPO_RS18075	45
ABI910_6POST	3825040	3825043		YPO_RS18075	3
ABI910_6POST	3825091	3825092		YPO_RS18075	1
ABI910_6POST	3825557	3825570		YPO_RS18075	13
ABI910_6POST	3826101	3826103		YPO_RS18075	2
ABI910_6POST	3826687	3826693		ampE	6
ABI910_6POST	3826892	3826899		ampE	7
ABI910_6POST	3826980	3827021		ampE	41
ABI910_6POST	3827085	3827088		ampE	3
ABI910_6POST	3827841	3827855		ampD	14
ABI910_6POST	3827914	3827918		ampD	4
ABI910_6POST	3828243	3828245		ampD	2
ABI910_6POST	3828519	3828527		nadC	8
ABI910_6POST	3828909	3828920		nadC	11
ABI910_6POST	3829082	3829096		nadC	14
ABI910_6POST	3829663	3829683		ppdD	20
ABI910_6POST	3830438	3830442		gspE	4
ABI910_6POST	3832268	3832276		hofC	8
ABI910_6POST	3832345	3832353		hofC	8
ABI910_6POST	3832433	3832449		hofC	16
ABI910_6POST	3834016	3834034		YPO_RS18110	18
ABI910_6POST	3834139	3834147		YPO_RS18110	8
ABI910_6POST	3834897	3834917		coaE	20
ABI910_6POST	3835373	3835379		zapD	6
ABI910_6POST	3835575	3835610		zapD	35
ABI910_6POST	3836645	3836658		YPO_RS18130	13
ABI910_6POST	3836885	3836887		YPO_RS18130	2
ABI910_6POST	3837384	3837418		YPO_RS18135	34
ABI910_6POST	3837519	3837520		YPO_RS18135	1
ABI910_6POST	3837690	3837726		YPO_RS18135	36
ABI910_6POST	3837894	3837903		YPO_RS18135	9
ABI910_6POST	3838001	3838007		YPO_RS18135	6
ABI910_6POST	3838075	3838088		YPO_RS18140	13
ABI910_6POST	3838333	3838407		YPO_RS18140	74
ABI910_6POST	3838517	3838543		YPO_RS18140	26
ABI910_6POST	3838619	3838630		YPO_RS18140	11
ABI910_6POST	3838688	3838704		YPO_RS18140	16
ABI910_6POST	3838791	3838799		YPO_RS18140	8
ABI910_6POST	3838850	3838869		YPO_RS18145	19
ABI910_6POST	3839103	3839104		YPO_RS18145	1
ABI910_6POST	3839478	3839484		YPO_RS18145	6
ABI910_6POST	3839771	3839801		YPO_RS18145	30
ABI910_6POST	3840218	3840220		YPO_RS18150	2
ABI910_6POST	3840614	3840615		YPO_RS18150	1
ABI910_6POST	3841047	3841068		YPO_RS18150	21
ABI910_6POST	3841568	3841569		YPO_RS18150	1
ABI910_6POST	3841803	3841826		YPO_RS18150	23
ABI910_6POST	3842417	3842421		YPO_RS18155	4
ABI910_6POST	3842683	3842710		YPO_RS18155	27
ABI910_6POST	3844577	3844586		lptG	9
ABI910_6POST	3844684	3844693		lptG	9
ABI910_6POST	3844954	3844955		lptF	1
ABI910_6POST	3845125	3845132		lptF	7
ABI910_6POST	3845499	3845504		lptF	5
ABI910_6POST	3845728	3845739		lptF	11
ABI910_6POST	3846787	3846811		pepA	24
ABI910_6POST	3847060	3847080		pepA	20
ABI910_6POST	3848499	3848515		YPO_RS18185	16
ABI910_6POST	3849023	3849098		YPO_RS18185	75
ABI910_6POST	3849131	3849138		YPO_RS18185	7
ABI910_6POST	3849564	3849578		YPO_RS18185	14
ABI910_6POST	3849900	3849909		YPO_RS18185	9
ABI910_6POST	3850372	3850379		YPO_RS18185	7
ABI910_6POST	3850730	3850735		YPO_RS18185	5
ABI910_6POST	3850860	3850896		YPO_RS18185	36
ABI910_6POST	3852499	3852504		rraB	5
ABI910_6POST	3852975	3852980		argF	5
ABI910_6POST	3853567	3853574		argF	7
ABI910_6POST	3857019	3857021		YPO_RS18215	2
ABI910_6POST	3857068	3857069		YPO_RS18215	1
ABI910_6POST	3857193	3857200		YPO_RS18215	7
ABI910_6POST	3857627	3857630		YPO_RS18215	3
ABI910_6POST	3857910	3857914		YPO_RS18215	4
ABI910_6POST	3858117	3858124		YPO_RS18220	7
ABI910_6POST	3858519	3858525		YPO_RS18220	6
ABI910_6POST	3858623	3858649		YPO_RS18220	26
ABI910_6POST	3858750	3858763		YPO_RS18220	13
ABI910_6POST	3858846	3858854		YPO_RS18220	8
ABI910_6POST	3859114	3859124		YPO_RS18225	10
ABI910_6POST	3859681	3859707		YPO_RS18225	26
ABI910_6POST	3861812	3861817		nrdD	5
ABI910_6POST	3862259	3862269		nrdD	10
ABI910_6POST	3862602	3862620		nrdD	18
ABI910_6POST	3863234	3863244		nrdG	10
ABI910_6POST	3863322	3863334		nrdG	12
ABI910_6POST	3863688	3863694		nrdG	6
ABI910_6POST	3864137	3864149		phnF	12
ABI910_6POST	3864440	3864469		phnF	29
ABI910_6POST	3864736	3864738		phnF	2
ABI910_6POST	3865467	3865471		phnH	4
ABI910_6POST	3865537	3865544		phnH	7
ABI910_6POST	3865616	3865621		phnH	5
ABI910_6POST	3866093	3866111		YPO_RS18260	18
ABI910_6POST	3866188	3866216		YPO_RS18260	28
ABI910_6POST	3866273	3866281		YPO_RS18260	8
ABI910_6POST	3866645	3866646		YPO_RS18260	1
ABI910_6POST	3866713	3866723		YPO_RS18260	10
ABI910_6POST	3867372	3867375		YPO_RS18265	3
ABI910_6POST	3867895	3867903		YPO_RS18265	8
ABI910_6POST	3867903	3867929		phnK	26
ABI910_6POST	3868093	3868108		phnK	15
ABI910_6POST	3868206	3868208		phnK	2
ABI910_6POST	3868372	3868375		phnK	3
ABI910_6POST	3868581	3868591		phnK	10
ABI910_6POST	3868653	3868658		phnK	5
ABI910_6POST	3869092	3869103		phnL	11
ABI910_6POST	3869478	3869510		phnL	32
ABI910_6POST	3870042	3870054		phnM	12
ABI910_6POST	3870105	3870106		phnM	1
ABI910_6POST	3870652	3870654		phnM	2
ABI910_6POST	3871206	3871207		phnN	1
ABI910_6POST	3871466	3871471		phnN	5
ABI910_6POST	3871825	3871831		phnP	6
ABI910_6POST	3872165	3872168		phnP	3
ABI910_6POST	3872414	3872415		YPO_RS18295	1
ABI910_6POST	3872699	3872701		YPO_RS18295	2
ABI910_6POST	3872885	3872893		YPO_RS18295	8
ABI910_6POST	3873154	3873179		YPO_RS18300	25
ABI910_6POST	3873684	3873690		YPO_RS18305	6
ABI910_6POST	3874011	3874018		YPO_RS18305	7
ABI910_6POST	3874050	3874052		YPO_RS18305	2
ABI910_6POST	3874398	3874420		YPO_RS18305	22
ABI910_6POST	3874667	3874683		YPO_RS18305	16
ABI910_6POST	3874819	3874829		ugpC	10
ABI910_6POST	3876088	3876091		YPO_RS18315	3
ABI910_6POST	3876292	3876304		YPO_RS18315	12
ABI910_6POST	3876350	3876355		YPO_RS18315	5
ABI910_6POST	3876776	3876778		YPO_RS18320	2
ABI910_6POST	3876913	3876920		YPO_RS18320	7
ABI910_6POST	3877223	3877232		YPO_RS18320	9
ABI910_6POST	3877780	3877784		YPO_RS18325	4
ABI910_6POST	3877990	3878018		YPO_RS18325	28
ABI910_6POST	3878333	3878340		YPO_RS18325	7
ABI910_6POST	3878882	3878887		YPO_RS18325	5
ABI910_6POST	3880421	3880426		YPO_RS18330	5
ABI910_6POST	3881162	3881171		YPO_RS18335	9
ABI910_6POST	3881603	3881608		YPO_RS18335	5
ABI910_6POST	3881811	3881827		YPO_RS18335	16
ABI910_6POST	3882224	3882227		YPO_RS18335	3
ABI910_6POST	3882461	3882497		YPO_RS18335	36
ABI910_6POST	3882593	3882606		YPO_RS18335	13
ABI910_6POST	3883069	3883073		YPO_RS18340	4
ABI910_6POST	3883759	3883768		YPO_RS18345	9
ABI910_6POST	3884810	3884818		YPO_RS18355	8
ABI910_6POST	3885025	3885027		YPO_RS18355	2
ABI910_6POST	3885080	3885084		YPO_RS18355	4
ABI910_6POST	3885172	3885174		YPO_RS18355	2
ABI910_6POST	3885403	3885409		YPO_RS18355	6
ABI910_6POST	3886628	3886670		YPO_RS18360	42
ABI910_6POST	3887224	3887255		YPO_RS18365	31
ABI910_6POST	3887295	3887298		YPO_RS18365	3
ABI910_6POST	3887538	3887543		YPO_RS18365	5
ABI910_6POST	3887880	3887887		YPO_RS18365	7
ABI910_6POST	3888392	3888406		YPO_RS18370	14
ABI910_6POST	3888888	3888898		YPO_RS18370	10
ABI910_6POST	3889624	3889664		YPO_RS18370	40
ABI910_6POST	3889808	3889819		YPO_RS18370	11
ABI910_6POST	3889999	3890006		YPO_RS18370	7
ABI910_6POST	3890182	3890189		YPO_RS18370	7
ABI910_6POST	3890481	3890484		YPO_RS18370	3
ABI910_6POST	3890832	3890865		YPO_RS18370	33
ABI910_6POST	3891264	3891268		YPO_RS18370	4
ABI910_6POST	3891645	3891656		YPO_RS18375	11
ABI910_6POST	3891863	3891867		YPO_RS18375	4
ABI910_6POST	3892409	3892463		YPO_RS18375	54
ABI910_6POST	3893352	3893377		YPO_RS18380	25
ABI910_6POST	3894546	3894554		YPO_RS18390	8
ABI910_6POST	3894704	3894710		YPO_RS18395	6
ABI910_6POST	3895325	3895344		YPO_RS18400	19
ABI910_6POST	3895515	3895516		YPO_RS18400	1
ABI910_6POST	3896284	3896302		YPO_RS18400	18
ABI910_6POST	3897289	3897295		yrbN	6
ABI910_6POST	3898318	3898322		nlpI	4
ABI910_6POST	3898601	3898602		pnp	1
ABI910_6POST	3898883	3898918		pnp	35
ABI910_6POST	3899591	3899592		pnp	1
ABI910_6POST	3900040	3900058		pnp	18
ABI910_6POST	3901014	3901029		YPO_RS18420	15
ABI910_6POST	3901282	3901314		YPO_RS18420	32
ABI910_6POST	3901386	3901416		YPO_RS18420	30
ABI910_6POST	3901573	3901585		YPO_RS18420	12
ABI910_6POST	3901621	3901622		YPO_RS18420	1
ABI910_6POST	3901878	3901903		YPO_RS18420	25
ABI910_6POST	3902091	3902097		YPO_RS18420	6
ABI910_6POST	3903404	3903405		truB	1
ABI910_6POST	3904497	3904503		infB	6
ABI910_6POST	3904774	3904782		infB	8
ABI910_6POST	3904902	3904904		infB	2
ABI910_6POST	3905063	3905066		infB	3
ABI910_6POST	3905254	3905257		infB	3
ABI910_6POST	3906132	3906135		infB	3
ABI910_6POST	3906591	3906599		infB	8
ABI910_6POST	3907313	3907320		nusA	7
ABI910_6POST	3907887	3907903		nusA	16
ABI910_6POST	3908588	3908625		rimP	37
ABI910_6POST	3909219	3909225		YPO_RS18460	6
ABI910_6POST	3909586	3909591		secG	5
ABI910_6POST	3909876	3909885		glmM	9
ABI910_6POST	3910132	3910160		glmM	28
ABI910_6POST	3911238	3911246		folP	8
ABI910_6POST	3911631	3911639		folP	8
ABI910_6POST	3914387	3914412		rlmE	25
ABI910_6POST	3914544	3914549		rlmE	5
ABI910_6POST	3914592	3914594		rlmE	2
ABI910_6POST	3915821	3915828		greA	7
ABI910_6POST	3916970	3916982		dacB	12
ABI910_6POST	3917156	3917169		dacB	13
ABI910_6POST	3917769	3917771		pmrA	2
ABI910_6POST	3918814	3918825		pmrB	11
ABI910_6POST	3918858	3918860		pmrB	2
ABI910_6POST	3918944	3918958		pmrB	14
ABI910_6POST	3919143	3919148		pmrB	5
ABI910_6POST	3919248	3919272		pmrB	24
ABI910_6POST	3920660	3920680		YPO_RS18520	20
ABI910_6POST	3921006	3921008		YPO_RS18520	2
ABI910_6POST	3921912	3921917		rplU	5
ABI910_6POST	3922184	3922191		rplU	7
ABI910_6POST	3922639	3922651		ispB	12
ABI910_6POST	3922920	3922924		ispB	4
ABI910_6POST	3922968	3922969		ispB	1
ABI910_6POST	3923311	3923318		ispB	7
ABI910_6POST	3923644	3923652		YPO_RS18540	8
ABI910_6POST	3925566	3925574		mdh	8
ABI910_6POST	3926426	3926441		argR	15
ABI910_6POST	3927748	3927774		mpl	26
ABI910_6POST	3928544	3928552		mpl	8
ABI910_6POST	3928678	3928689		mpl	11
ABI910_6POST	3928896	3928945		mpl	49
ABI910_6POST	3929656	3929683		fbp	27
ABI910_6POST	3930392	3930425		ppa	33
ABI910_6POST	3931543	3931548		YPO_RS18585	5
ABI910_6POST	3931654	3931671		YPO_RS18585	17
ABI910_6POST	3932385	3932395		YPO_RS18585	10
ABI910_6POST	3932824	3932843		YPO_RS18585	19
ABI910_6POST	3932970	3932975		YPO_RS18585	5
ABI910_6POST	3933717	3933729		YPO_RS18585	12
ABI910_6POST	3933848	3933854		YPO_RS18585	6
ABI910_6POST	3934245	3934259		YPO_RS18585	14
ABI910_6POST	3934535	3934554		YPO_RS18585	19
ABI910_6POST	3934604	3934626		YPO_RS18585	22
ABI910_6POST	3934806	3934857		YPO_RS18585	51
ABI910_6POST	3934919	3934920		YPO_RS18585	1
ABI910_6POST	3935100	3935152		YPO_RS18585	52
ABI910_6POST	3935197	3935223		YPO_RS18585	26
ABI910_6POST	3935758	3935760		YPO_RS18590	2
ABI910_6POST	3935805	3935819		YPO_RS18590	14
ABI910_6POST	3935868	3935886		YPO_RS18590	18
ABI910_6POST	3936025	3936044		YPO_RS18590	19
ABI910_6POST	3936199	3936207		YPO_RS18590	8
ABI910_6POST	3937406	3937421		msrA	15
ABI910_6POST	3937603	3937616		msrA	13
ABI910_6POST	3937713	3937727		msrA	14
ABI910_6POST	3938321	3938335		YPO_RS18600	14
ABI910_6POST	3938489	3938491		YPO_RS18600	2
ABI910_6POST	3938947	3938955		YPO_RS18600	8
ABI910_6POST	3939064	3939071		YPO_RS18600	7
ABI910_6POST	3939193	3939199		YPO_RS18600	6
ABI910_6POST	3939463	3939471		YPO_RS18600	8
ABI910_6POST	3940223	3940259		YPO_RS18610	36
ABI910_6POST	3940325	3940327		YPO_RS18610	2
ABI910_6POST	3941156	3941167		cysQ	11
ABI910_6POST	3942437	3942446		YPO_RS18620	9
ABI910_6POST	3942703	3942704		YPO_RS18620	1
ABI910_6POST	3942994	3943004		YPO_RS18620	10
ABI910_6POST	3943072	3943073		YPO_RS18620	1
ABI910_6POST	3943621	3943627		YPO_RS18620	6
ABI910_6POST	3944606	3944608		ytfE	2
ABI910_6POST	3944948	3944981		YPO_RS18630	33
ABI910_6POST	3945040	3945049		YPO_RS18630	9
ABI910_6POST	3945362	3945365		YPO_RS18630	3
ABI910_6POST	3945433	3945439		YPO_RS18630	6
ABI910_6POST	3945913	3945940		YPO_RS18635	27
ABI910_6POST	3946820	3946825		YPO_RS18640	5
ABI910_6POST	3946975	3946980		YPO_RS18640	5
ABI910_6POST	3947071	3947084		YPO_RS18640	13
ABI910_6POST	3947697	3947704		YPO_RS18645	7
ABI910_6POST	3949748	3949808		yjfP	60
ABI910_6POST	3950375	3950379		yjfP	4
ABI910_6POST	3950644	3950648		YPO_RS18675	4
ABI910_6POST	3950764	3950807		YPO_RS18675	43
ABI910_6POST	3950845	3950851		YPO_RS18675	6
ABI910_6POST	3951009	3951040		YPO_RS18675	31
ABI910_6POST	3951091	3951104		YPO_RS18675	13
ABI910_6POST	3951142	3951187		YPO_RS18675	45
ABI910_6POST	3951363	3951373		YPO_RS18675	10
ABI910_6POST	3951433	3951455		YPO_RS18675	22
ABI910_6POST	3951499	3951513		YPO_RS18680	14
ABI910_6POST	3951580	3951592		YPO_RS18680	12
ABI910_6POST	3951660	3951680		YPO_RS18680	20
ABI910_6POST	3951792	3951903		YPO_RS18680	111
ABI910_6POST	3951975	3951993		YPO_RS18680	18
ABI910_6POST	3952082	3952115		YPO_RS18680	33
ABI910_6POST	3953945	3953946		YPO_RS18690	1
ABI910_6POST	3954114	3954129		YPO_RS18690	15
ABI910_6POST	3954793	3954794		YPO_RS18695	1
ABI910_6POST	3956021	3956034		rnpB	13
ABI910_6POST	3956458	3956459		rsmI	1
ABI910_6POST	3956786	3956788		rsmI	2
ABI910_6POST	3956964	3956997		rsmI	33
ABI910_6POST	3958043	3958057		YPO_RS18710	14
ABI910_6POST	3958581	3958610		YPO_RS18710	29
ABI910_6POST	3958762	3958764		YPO_RS18710	2
ABI910_6POST	3958981	3959011		YPO_RS18710	30
ABI910_6POST	3960544	3960545		yraP	1
ABI910_6POST	3960749	3960755		yraP	6
ABI910_6POST	3961850	3961856		mtgA	6
ABI910_6POST	3962040	3962049		elbB	9
ABI910_6POST	3962305	3962324		elbB	19
ABI910_6POST	3962520	3962528		elbB	8
ABI910_6POST	3963537	3963545		arcB	8
ABI910_6POST	3965682	3965702		YPO_RS18745	20
ABI910_6POST	3965740	3965749		YPO_RS18745	9
ABI910_6POST	3967195	3967197		gltB	2
ABI910_6POST	3967375	3967390		gltB	15
ABI910_6POST	3968427	3968430		gltB	3
ABI910_6POST	3968676	3968679		gltB	3
ABI910_6POST	3968941	3968956		gltB	15
ABI910_6POST	3969007	3969016		gltB	9
ABI910_6POST	3969251	3969262		gltB	11
ABI910_6POST	3969730	3969747		gltB	17
ABI910_6POST	3969841	3969856		gltB	15
ABI910_6POST	3970210	3970245		gltB	35
ABI910_6POST	3970731	3970733		gltB	2
ABI910_6POST	3970922	3970936		gltB	14
ABI910_6POST	3971118	3971142		gltB	24
ABI910_6POST	3971282	3971292		gltB	10
ABI910_6POST	3971376	3971381		gltB	5
ABI910_6POST	3971551	3971553		gltB	2
ABI910_6POST	3971758	3971773		YPO_RS18755	15
ABI910_6POST	3971813	3971816		YPO_RS18755	3
ABI910_6POST	3972042	3972069		YPO_RS18755	27
ABI910_6POST	3972293	3972298		YPO_RS18755	5
ABI910_6POST	3972330	3972356		YPO_RS18755	26
ABI910_6POST	3972489	3972494		YPO_RS18755	5
ABI910_6POST	3973776	3973787		YPO_RS18760	11
ABI910_6POST	3973908	3973916		YPO_RS18760	8
ABI910_6POST	3974628	3974636		sspA	8
ABI910_6POST	3975089	3975102		sspA	13
ABI910_6POST	3975588	3975604		YPO_RS18775	16
ABI910_6POST	3975758	3975767		rpsI	9
ABI910_6POST	3975847	3975849		rpsI	2
ABI910_6POST	3976125	3976148		rplM	23
ABI910_6POST	3976792	3976836		YPO_RS18790	44
ABI910_6POST	3977106	3977118		YPO_RS18790	12
ABI910_6POST	3977666	3977670		YPO_RS18790	4
ABI910_6POST	3977808	3977840		YPO_RS18790	32
ABI910_6POST	3979302	3979312		degQ	10
ABI910_6POST	3979385	3979390		degQ	5
ABI910_6POST	3979700	3979711		degQ	11
ABI910_6POST	3979993	3979995		degQ	2
ABI910_6POST	3980539	3980543		YPO_RS18805	4
ABI910_6POST	3980761	3980763		YPO_RS18805	2
ABI910_6POST	3981233	3981261		degS	28
ABI910_6POST	3981778	3981786		degS	8
ABI910_6POST	3981936	3981954		degS	18
ABI910_6POST	3981985	3981986		degS	1
ABI910_6POST	3982839	3982874		murA	35
ABI910_6POST	3983006	3983010		murA	4
ABI910_6POST	3983505	3983508		murA	3
ABI910_6POST	3984331	3984345		mlaB	14
ABI910_6POST	3984479	3984483		mlaC	4
ABI910_6POST	3984552	3984555		mlaC	3
ABI910_6POST	3984605	3984612		mlaC	7
ABI910_6POST	3984803	3984818		mlaC	15
ABI910_6POST	3985131	3985156		mlaD	25
ABI910_6POST	3985774	3985777		mlaE	3
ABI910_6POST	3986674	3986678		mlaF	4
ABI910_6POST	3986736	3986744		mlaF	8
ABI910_6POST	3986865	3986886		mlaF	21
ABI910_6POST	3987235	3987250		mlaF	15
ABI910_6POST	3988184	3988235		YPO_RS18850	51
ABI910_6POST	3988545	3988547		YPO_RS18850	2
ABI910_6POST	3989392	3989395		kdsD	3
ABI910_6POST	3989626	3989642		kdsD	16
ABI910_6POST	3990123	3990129		kdsC	6
ABI910_6POST	3991282	3991290		lptA	8
ABI910_6POST	3992245	3992260		lptB	15
ABI910_6POST	3992816	3992826		rpoN	10
ABI910_6POST	3993236	3993243		rpoN	7
ABI910_6POST	3995842	3995858		rapZ	16
ABI910_6POST	3996088	3996090		npr	2
ABI910_6POST	3997222	3997236		pyrB	14
ABI910_6POST	3997417	3997426		pyrB	9
ABI910_6POST	3997837	3997848		YPO_RS18910	11
ABI910_6POST	3999114	3999161		YPO_RS18920	47
ABI910_6POST	3999230	3999240		YPO_RS18920	10
ABI910_6POST	3999337	3999347		YPO_RS18920	10
ABI910_6POST	3999442	3999466		YPO_RS18920	24
ABI910_6POST	3999523	3999572		YPO_RS18920	49
ABI910_6POST	3999655	3999664		YPO_RS18920	9
ABI910_6POST	3999737	3999740		YPO_RS18920	3
ABI910_6POST	3999804	3999830		YPO_RS18920	26
ABI910_6POST	3999927	3999969		YPO_RS18925	42
ABI910_6POST	4000067	4000078		YPO_RS18925	11
ABI910_6POST	4000202	4000207		YPO_RS18925	5
ABI910_6POST	4000277	4000290		YPO_RS18925	13
ABI910_6POST	4000356	4000377		YPO_RS18925	21
ABI910_6POST	4000455	4000482		YPO_RS18925	27
ABI910_6POST	4000549	4000568		YPO_RS18925	19
ABI910_6POST	4001001	4001005		YPO_RS18935	4
ABI910_6POST	4001293	4001351		YPO_RS18935	58
ABI910_6POST	4001768	4001774		tssG	6
ABI910_6POST	4001863	4001869		tssG	6
ABI910_6POST	4002214	4002219		tssG	5
ABI910_6POST	4002390	4002395		tssG	5
ABI910_6POST	4003007	4003014		tagH	7
ABI910_6POST	4003189	4003206		tagH	17
ABI910_6POST	4003247	4003293		tagH	46
ABI910_6POST	4003433	4003471		tagH	38
ABI910_6POST	4003507	4003547		tagH	40
ABI910_6POST	4004252	4004256		tssJ	4
ABI910_6POST	4004319	4004351		tssJ	32
ABI910_6POST	4004389	4004390		tssJ	1
ABI910_6POST	4004610	4004623		tssJ	13
ABI910_6POST	4004970	4005022		tssK	52
ABI910_6POST	4005074	4005079		tssK	5
ABI910_6POST	4005195	4005265		tssK	70
ABI910_6POST	4006119	4006120		YPO_RS18960	1
ABI910_6POST	4006158	4006171		YPO_RS18960	13
ABI910_6POST	4006241	4006323		YPO_RS18960	82
ABI910_6POST	4006542	4006546		YPO_RS18960	4
ABI910_6POST	4007002	4007003		tssH	1
ABI910_6POST	4007290	4007300		tssH	10
ABI910_6POST	4007548	4007565		tssH	17
ABI910_6POST	4007773	4007817		tssH	44
ABI910_6POST	4008040	4008048		tssH	8
ABI910_6POST	4008487	4008494		tssH	7
ABI910_6POST	4008907	4008918		tssH	11
ABI910_6POST	4009435	4009464		tssH	29
ABI910_6POST	4010379	4010399		tagO	20
ABI910_6POST	4010433	4010439		tagO	6
ABI910_6POST	4010601	4010609		tagO	8
ABI910_6POST	4011006	4011007		tssA	1
ABI910_6POST	4011037	4011041		tssA	4
ABI910_6POST	4011136	4011146		tssA	10
ABI910_6POST	4011213	4011229		tssA	16
ABI910_6POST	4011280	4011281		tssA	1
ABI910_6POST	4012113	4012115		tssA	2
ABI910_6POST	4012271	4012280		tssA	9
ABI910_6POST	4012455	4012471		tssM	16
ABI910_6POST	4012772	4012788		tssM	16
ABI910_6POST	4013028	4013035		tssM	7
ABI910_6POST	4013205	4013208		tssM	3
ABI910_6POST	4013776	4013788		tssM	12
ABI910_6POST	4014862	4014874		tssM	12
ABI910_6POST	4014911	4014934		tssM	23
ABI910_6POST	4015269	4015286		tssM	17
ABI910_6POST	4015559	4015565		tssM	6
ABI910_6POST	4015799	4015800		tssM	1
ABI910_6POST	4016081	4016098		YPO_RS18990	17
ABI910_6POST	4016545	4016552		YPO_RS18990	7
ABI910_6POST	4016696	4016713		YPO_RS18990	17
ABI910_6POST	4016982	4016987		YPO_RS18995	5
ABI910_6POST	4017814	4017833		YPO_RS19000	19
ABI910_6POST	4019227	4019235		YPO_RS19000	8
ABI910_6POST	4020092	4020110		YPO_RS19005	18
ABI910_6POST	4020408	4020439		YPO_RS19010	31
ABI910_6POST	4020716	4020722		YPO_RS19010	6
ABI910_6POST	4021500	4021505		YPO_RS19010	5
ABI910_6POST	4021543	4021547		YPO_RS19010	4
ABI910_6POST	4021678	4021750		YPO_RS19010	72
ABI910_6POST	4021997	4022022		YPO_RS19010	25
ABI910_6POST	4022087	4022105		YPO_RS19010	18
ABI910_6POST	4022240	4022242		YPO_RS19010	2
ABI910_6POST	4022306	4022309		YPO_RS19010	3
ABI910_6POST	4022610	4022620		YPO_RS19010	10
ABI910_6POST	4022724	4022741		YPO_RS19010	17
ABI910_6POST	4022956	4022982		YPO_RS19010	26
ABI910_6POST	4023042	4023054		YPO_RS19010	12
ABI910_6POST	4023135	4023162		YPO_RS19015	27
ABI910_6POST	4023379	4023383		YPO_RS19015	4
ABI910_6POST	4023689	4023707		YPO_RS19015	18
ABI910_6POST	4023789	4023817		YPO_RS19015	28
ABI910_6POST	4023861	4023866		YPO_RS19015	5
ABI910_6POST	4023992	4024017		YPO_RS19015	25
ABI910_6POST	4024120	4024124		YPO_RS19015	4
ABI910_6POST	4024170	4024175		YPO_RS19015	5
ABI910_6POST	4024275	4024303		YPO_RS19015	28
ABI910_6POST	4024493	4024496		YPO_RS19015	3
ABI910_6POST	4024629	4024637		YPO_RS19020	8
ABI910_6POST	4025360	4025367		YPO_RS19030	7
ABI910_6POST	4026528	4026547		YPO_RS19045	19
ABI910_6POST	4026945	4026986		YPO_RS19045	41
ABI910_6POST	4027325	4027327		YPO_RS19045	2
ABI910_6POST	4027370	4027373		YPO_RS19045	3
ABI910_6POST	4027508	4027518		YPO_RS19045	10
ABI910_6POST	4027549	4027563		YPO_RS19045	14
ABI910_6POST	4027630	4027643		YPO_RS19045	13
ABI910_6POST	4027820	4027824		YPO_RS19045	4
ABI910_6POST	4028059	4028066		YPO_RS19045	7
ABI910_6POST	4028880	4028884		YPO_RS19050	4
ABI910_6POST	4028920	4028922		YPO_RS19050	2
ABI910_6POST	4029214	4029216		YPO_RS19055	2
ABI910_6POST	4029403	4029463		YPO_RS19055	60
ABI910_6POST	4029764	4029775		YPO_RS19055	11
ABI910_6POST	4030051	4030058		YPO_RS19055	7
ABI910_6POST	4030448	4030449		YPO_RS19055	1
ABI910_6POST	4030617	4030684		YPO_RS19055	67
ABI910_6POST	4030769	4030794		YPO_RS19055	25
ABI910_6POST	4031180	4031183		YPO_RS19055	3
ABI910_6POST	4031435	4031445		YPO_RS19055	10
ABI910_6POST	4031559	4031566		YPO_RS19055	7
ABI910_6POST	4031662	4031665		YPO_RS19055	3
ABI910_6POST	4031935	4031954		YPO_RS19055	19
ABI910_6POST	4031986	4032025		YPO_RS19055	39
ABI910_6POST	4032261	4032265		YPO_RS19055	4
ABI910_6POST	4032434	4032441		YPO_RS19055	7
ABI910_6POST	4032636	4032655		YPO_RS19055	19
ABI910_6POST	4032944	4032953		YPO_RS19055	9
ABI910_6POST	4033101	4033137		YPO_RS19055	36
ABI910_6POST	4033585	4033587		YPO_RS19055	2
ABI910_6POST	4034033	4034040		YPO_RS19060	7
ABI910_6POST	4034239	4034276		YPO_RS19060	37
ABI910_6POST	4035560	4035567		YPO_RS19070	7
ABI910_6POST	4036028	4036042		YPO_RS19075	14
ABI910_6POST	4037454	4037467		YPO_RS19080	13
ABI910_6POST	4037763	4037793		YPO_RS19080	30
ABI910_6POST	4037862	4037864		YPO_RS19080	2
ABI910_6POST	4038552	4038562		rbsD	10
ABI910_6POST	4039003	4039006		YPO_RS19090	3
ABI910_6POST	4039330	4039400		YPO_RS19090	70
ABI910_6POST	4039495	4039497		YPO_RS19090	2
ABI910_6POST	4039978	4039982		deoC	4
ABI910_6POST	4040038	4040044		deoC	6
ABI910_6POST	4040161	4040178		deoC	17
ABI910_6POST	4041476	4041484		YPO_RS19105	8
ABI910_6POST	4041710	4041729		YPO_RS19105	19
ABI910_6POST	4042146	4042162		YPO_RS19105	16
ABI910_6POST	4042612	4042626		ssuD	14
ABI910_6POST	4043461	4043464		ssuD	3
ABI910_6POST	4043897	4043911		ssuC	14
ABI910_6POST	4044182	4044187		ssuC	5
ABI910_6POST	4044704	4044731		ssuB	27
ABI910_6POST	4045137	4045142		ssuB	5
ABI910_6POST	4045249	4045260		ssuB	11
ABI910_6POST	4046753	4046761		YPO_RS19135	8
ABI910_6POST	4047218	4047220		YPO_RS19135	2
ABI910_6POST	4047289	4047294		YPO_RS19135	5
ABI910_6POST	4047516	4047525		YPO_RS19135	9
ABI910_6POST	4047791	4047797		YPO_RS19135	6
ABI910_6POST	4048703	4048732		YPO_RS19140	29
ABI910_6POST	4049068	4049079		YPO_RS19140	11
ABI910_6POST	4049183	4049185		YPO_RS19140	2
ABI910_6POST	4049358	4049365		YPO_RS19140	7
ABI910_6POST	4050180	4050185		YPO_RS19145	5
ABI910_6POST	4050674	4050676		YPO_RS19145	2
ABI910_6POST	4050974	4050997		YPO_RS19145	23
ABI910_6POST	4051056	4051069		YPO_RS19145	13
ABI910_6POST	4051320	4051329		YPO_RS19145	9
ABI910_6POST	4051876	4051883		lpxP	7
ABI910_6POST	4051991	4052016		lpxP	25
ABI910_6POST	4053344	4053354		YPO_RS19155	10
ABI910_6POST	4053674	4053694		YPO_RS19155	20
ABI910_6POST	4054938	4054951		YPO_RS19160	13
ABI910_6POST	4055255	4055259		YPO_RS19160	4
ABI910_6POST	4055568	4055581		YPO_RS19160	13
ABI910_6POST	4055807	4055820		YPO_RS19160	13
ABI910_6POST	4055941	4055951		YPO_RS19165	10
ABI910_6POST	4056101	4056104		YPO_RS19165	3
ABI910_6POST	4056231	4056232		YPO_RS19165	1
ABI910_6POST	4056469	4056498		YPO_RS19165	29
ABI910_6POST	4056605	4056617		YPO_RS19165	12
ABI910_6POST	4056712	4056729		YPO_RS19165	17
ABI910_6POST	4057077	4057087		YPO_RS19170	10
ABI910_6POST	4057233	4057242		YPO_RS19170	9
ABI910_6POST	4057554	4057570		YPO_RS19170	16
ABI910_6POST	4057788	4057795		YPO_RS19170	7
ABI910_6POST	4058225	4058251		YPO_RS19175	26
ABI910_6POST	4058442	4058454		YPO_RS19175	12
ABI910_6POST	4058544	4058559		YPO_RS19175	15
ABI910_6POST	4059321	4059331		YPO_RS19175	10
ABI910_6POST	4059427	4059449		YPO_RS19175	22
ABI910_6POST	4059497	4059512		YPO_RS19175	15
ABI910_6POST	4059509	4059514		YPO_RS19180	5
ABI910_6POST	4060099	4060108		YPO_RS19180	9
ABI910_6POST	4060692	4060701		yghU	9
ABI910_6POST	4061455	4061482		YPO_RS19190	27
ABI910_6POST	4061726	4061740		YPO_RS19190	14
ABI910_6POST	4063831	4063846		YPO_RS19195	15
ABI910_6POST	4064513	4064516		YPO_RS19200	3
ABI910_6POST	4064621	4064630		YPO_RS19200	9
ABI910_6POST	4066481	4066487		YPO_RS19215	6
ABI910_6POST	4066549	4066563		YPO_RS19215	14
ABI910_6POST	4066673	4066676		YPO_RS19215	3
ABI910_6POST	4067319	4067328		YPO_RS19220	9
ABI910_6POST	4067425	4067435		YPO_RS19220	10
ABI910_6POST	4067962	4067972		YPO_RS19220	10
ABI910_6POST	4068019	4068045		YPO_RS19220	26
ABI910_6POST	4068544	4068566		YPO_RS19225	22
ABI910_6POST	4068620	4068631		YPO_RS19225	11
ABI910_6POST	4069188	4069190		YPO_RS19230	2
ABI910_6POST	4069874	4069882		YPO_RS19235	8
ABI910_6POST	4070236	4070244		YPO_RS19235	8
ABI910_6POST	4070665	4070668		YPO_RS19235	3
ABI910_6POST	4070850	4070859		YPO_RS19235	9
ABI910_6POST	4071818	4071830		YPO_RS19240	12
ABI910_6POST	4073573	4073579		dusB	6
ABI910_6POST	4074140	4074141		dusB	1
ABI910_6POST	4075472	4075495		prmA	23
ABI910_6POST	4075697	4075710		prmA	13
ABI910_6POST	4075775	4075778		prmA	3
ABI910_6POST	4076103	4076107		panF	4
ABI910_6POST	4076481	4076494		panF	13
ABI910_6POST	4076532	4076554		panF	22
ABI910_6POST	4076594	4076599		panF	5
ABI910_6POST	4076746	4076747		panF	1
ABI910_6POST	4076864	4076876		panF	12
ABI910_6POST	4077096	4077100		panF	4
ABI910_6POST	4077258	4077293		panF	35
ABI910_6POST	4077500	4077502		YPO_RS19280	2
ABI910_6POST	4078669	4078712		YPO_RS19285	43
ABI910_6POST	4079629	4079634		accC	5
ABI910_6POST	4079702	4079723		accC	21
ABI910_6POST	4080589	4080608		accB	19
ABI910_6POST	4081859	4081865		msrQ	6
ABI910_6POST	4082011	4082050		msrQ	39
ABI910_6POST	4082564	4082565		msrP	1
ABI910_6POST	4082724	4082732		msrP	8
ABI910_6POST	4083124	4083138		msrP	14
ABI910_6POST	4083260	4083262		msrP	2
ABI910_6POST	4083420	4083430		msrP	10
ABI910_6POST	4084156	4084184		YPO_RS19315	28
ABI910_6POST	4084242	4084246		YPO_RS19315	4
ABI910_6POST	4084311	4084321		YPO_RS19315	10
ABI910_6POST	4084383	4084386		YPO_RS19315	3
ABI910_6POST	4085250	4085280		csrD	30
ABI910_6POST	4085418	4085420		csrD	2
ABI910_6POST	4085928	4085940		csrD	12
ABI910_6POST	4086217	4086221		csrD	4
ABI910_6POST	4086343	4086344		csrD	1
ABI910_6POST	4086375	4086390		csrD	15
ABI910_6POST	4087364	4087383		YPO_RS19325	19
ABI910_6POST	4087645	4087646		YPO_RS19325	1
ABI910_6POST	4088025	4088031		YPO_RS19325	6
ABI910_6POST	4089356	4089365		mreC	9
ABI910_6POST	4089680	4089700		mreD	20
ABI910_6POST	4089738	4089754		mreD	16
ABI910_6POST	4090107	4090109		YPO_RS19340	2
ABI910_6POST	4090929	4090943		rng	14
ABI910_6POST	4091822	4091828		rng	6
ABI910_6POST	4092051	4092065		rng	14
ABI910_6POST	4092325	4092339		YPO_RS19350	14
ABI910_6POST	4093130	4093148		YPO_RS19350	18
ABI910_6POST	4093298	4093315		YPO_RS19350	17
ABI910_6POST	4093681	4093684		YPO_RS19350	3
ABI910_6POST	4093799	4093812		YPO_RS19350	13
ABI910_6POST	4093864	4093869		YPO_RS19350	5
ABI910_6POST	4094169	4094177		YPO_RS19350	8
ABI910_6POST	4094277	4094282		YPO_RS19350	5
ABI910_6POST	4094858	4094861		YPO_RS19350	3
ABI910_6POST	4095007	4095030		YPO_RS19350	23
ABI910_6POST	4095114	4095135		YPO_RS19350	21
ABI910_6POST	4095796	4095809		YPO_RS19350	13
ABI910_6POST	4095916	4095944		YPO_RS19350	28
ABI910_6POST	4096355	4096397		YPO_RS19355	42
ABI910_6POST	4096484	4096490		YPO_RS19355	6
ABI910_6POST	4096729	4096764		YPO_RS19355	35
ABI910_6POST	4097723	4097732		tldD	9
ABI910_6POST	4097982	4098019		tldD	37
ABI910_6POST	4098064	4098068		tldD	4
ABI910_6POST	4098344	4098357		tldD	13
ABI910_6POST	4098633	4098663		YPO_RS19365	30
ABI910_6POST	4099550	4099552		YPO_RS19365	2
ABI910_6POST	4099799	4099813		YPO_RS19365	14
ABI910_6POST	4100115	4100125		YPO_RS19365	10
ABI910_6POST	4100617	4100658		YPO_RS19365	41
ABI910_6POST	4100688	4100697		YPO_RS19365	9
ABI910_6POST	4100846	4100855		YPO_RS19365	9
ABI910_6POST	4100946	4101082		YPO_RS19365	136
ABI910_6POST	4101159	4101181		YPO_RS19365	22
ABI910_6POST	4101215	4101247		YPO_RS19365	32
ABI910_6POST	4101279	4101319		YPO_RS19365	40
ABI910_6POST	4101364	4101491		YPO_RS19365	127
ABI910_6POST	4101516	4102553		YPO_RS19370	1037
ABI910_6POST	4102683	4103053		YPO_RS19370	370
ABI910_6POST	4103088	4103262		YPO_RS19370	174
ABI910_6POST	4103411	4103468		YPO_RS19370	57
ABI910_6POST	4103529	4103570		YPO_RS19370	41
ABI910_6POST	4103685	4103703		YPO_RS19370	18
ABI910_6POST	4104833	4104837		YPO_RS19375	4
ABI910_6POST	4104896	4104903		YPO_RS19375	7
ABI910_6POST	4104981	4104986		YPO_RS19380	5
ABI910_6POST	4105890	4105894		YPO_RS19390	4
ABI910_6POST	4106900	4106907		YPO_RS19390	7
ABI910_6POST	4107091	4107102		YPO_RS19390	11
ABI910_6POST	4107182	4107185		YPO_RS19390	3
ABI910_6POST	4108012	4108014		YPO_RS19390	2
ABI910_6POST	4108159	4108165		YPO_RS19390	6
ABI910_6POST	4108569	4108606		YPO_RS19390	37
ABI910_6POST	4108790	4108831		YPO_RS19390	41
ABI910_6POST	4109262	4109281		YPO_RS19390	19
ABI910_6POST	4109341	4109350		YPO_RS19390	9
ABI910_6POST	4110093	4110176		YPO_RS19390	83
ABI910_6POST	4110306	4110315		YPO_RS19395	9
ABI910_6POST	4110672	4110688		YPO_RS19395	16
ABI910_6POST	4111024	4111027		YPO_RS19395	3
ABI910_6POST	4111107	4111117		YPO_RS19395	10
ABI910_6POST	4111310	4111322		YPO_RS19395	12
ABI910_6POST	4111369	4111370		YPO_RS19395	1
ABI910_6POST	4111764	4111766		YPO_RS19395	2
ABI910_6POST	4111828	4111841		YPO_RS19395	13
ABI910_6POST	4112302	4112309		YPO_RS19395	7
ABI910_6POST	4112670	4112684		YPO_RS19400	14
ABI910_6POST	4112881	4112891		YPO_RS19400	10
ABI910_6POST	4112999	4113030		YPO_RS19400	31
ABI910_6POST	4113366	4113367		YPO_RS19400	1
ABI910_6POST	4113606	4113607		YPO_RS19400	1
ABI910_6POST	4114228	4114238		YPO_RS19405	10
ABI910_6POST	4114409	4114410		YPO_RS19405	1
ABI910_6POST	4115059	4115099		YPO_RS19405	40
ABI910_6POST	4115151	4115163		YPO_RS19405	12
ABI910_6POST	4115626	4115630		YPO_RS19405	4
ABI910_6POST	4116789	4116800		YPO_RS19410	11
ABI910_6POST	4117246	4117263		YPO_RS19410	17
ABI910_6POST	4117536	4117537		YPO_RS19410	1
ABI910_6POST	4117987	4117995		aaeR	8
ABI910_6POST	4119727	4119736		aaeA	9
ABI910_6POST	4119864	4119866		aaeA	2
ABI910_6POST	4119926	4119941		aaeA	15
ABI910_6POST	4120278	4120285		aaeB	7
ABI910_6POST	4120379	4120401		aaeB	22
ABI910_6POST	4121068	4121079		aaeB	11
ABI910_6POST	4121318	4121330		aaeB	12
ABI910_6POST	4121466	4121486		aaeB	20
ABI910_6POST	4121536	4121550		aaeB	14
ABI910_6POST	4124064	4124095		YPO_RS19440	31
ABI910_6POST	4124129	4124134		YPO_RS19440	5
ABI910_6POST	4125061	4125078		YPO_RS19450	17
ABI910_6POST	4126129	4126141		pmbA	12
ABI910_6POST	4128449	4128452		cybC	3
ABI910_6POST	4129653	4129672		treC	19
ABI910_6POST	4129731	4129745		treC	14
ABI910_6POST	4130666	4130670		treC	4
ABI910_6POST	4131042	4131049		treC	7
ABI910_6POST	4131496	4131504		treB	8
ABI910_6POST	4131563	4131576		treB	13
ABI910_6POST	4131934	4131948		treB	14
ABI910_6POST	4132578	4132587		treB	9
ABI910_6POST	4133215	4133226		treR	11
ABI910_6POST	4133301	4133313		treR	12
ABI910_6POST	4133565	4133573		treR	8
ABI910_6POST	4133756	4133758		treR	2
ABI910_6POST	4133858	4133874		treR	16
ABI910_6POST	4134382	4134383		YPO_RS19490	1
ABI910_6POST	4134912	4134951		YPO_RS19495	39
ABI910_6POST	4134987	4134995		YPO_RS19495	8
ABI910_6POST	4135099	4135118		YPO_RS19495	19
ABI910_6POST	4135172	4135176		YPO_RS19495	4
ABI910_6POST	4135210	4135240		YPO_RS19495	30
ABI910_6POST	4135397	4135408		YPO_RS19495	11
ABI910_6POST	4135581	4135585		YPO_RS19495	4
ABI910_6POST	4135638	4135655		YPO_RS19500	17
ABI910_6POST	4135748	4135755		YPO_RS19500	7
ABI910_6POST	4135878	4135931		YPO_RS19500	53
ABI910_6POST	4136236	4136245		YPO_RS19500	9
ABI910_6POST	4139466	4139484		tssC	18
ABI910_6POST	4139522	4139529		tssC	7
ABI910_6POST	4139868	4139871		tssC	3
ABI910_6POST	4139918	4139921		tssC	3
ABI910_6POST	4140752	4140768		tssC	16
ABI910_6POST	4141082	4141104		tssB	22
ABI910_6POST	4142699	4142706		YPO_RS19535	7
ABI910_6POST	4143920	4143939		malM	19
ABI910_6POST	4144261	4144293		malM	32
ABI910_6POST	4144672	4144683		YPO_RS19545	11
ABI910_6POST	4145035	4145057		YPO_RS19545	22
ABI910_6POST	4146370	4146384		malK	14
ABI910_6POST	4146743	4146752		malK	9
ABI910_6POST	4147111	4147127		YPO_RS19555	16
ABI910_6POST	4147168	4147174		YPO_RS19555	6
ABI910_6POST	4147241	4147246		YPO_RS19555	5
ABI910_6POST	4148596	4148611		malE	15
ABI910_6POST	4148789	4148802		malE	13
ABI910_6POST	4148943	4148993		malE	50
ABI910_6POST	4149809	4149825		malF	16
ABI910_6POST	4149889	4149904		malF	15
ABI910_6POST	4149956	4149973		malF	17
ABI910_6POST	4150146	4150160		malF	14
ABI910_6POST	4150226	4150243		malF	17
ABI910_6POST	4150600	4150614		malF	14
ABI910_6POST	4150893	4150917		malG	24
ABI910_6POST	4151023	4151038		malG	15
ABI910_6POST	4151112	4151134		malG	22
ABI910_6POST	4151420	4151435		malG	15
ABI910_6POST	4151567	4151585		malG	18
ABI910_6POST	4152515	4152518		pgi	3
ABI910_6POST	4153067	4153086		pgi	19
ABI910_6POST	4153555	4153574		pgi	19
ABI910_6POST	4153730	4153734		pgi	4
ABI910_6POST	4155032	4155055		lysC	23
ABI910_6POST	4155303	4155319		lysC	16
ABI910_6POST	4155481	4155488		lysC	7
ABI910_6POST	4155603	4155606		lysC	3
ABI910_6POST	4155727	4155740		lysC	13
ABI910_6POST	4156572	4156608		YPO_RS19590	36
ABI910_6POST	4156844	4156855		YPO_RS19590	11
ABI910_6POST	4158419	4158423		YPO_RS19595	4
ABI910_6POST	4158705	4158727		YPO_RS19595	22
ABI910_6POST	4159041	4159052		YPO_RS19595	11
ABI910_6POST	4159115	4159126		YPO_RS19595	11
ABI910_6POST	4159686	4159697		YPO_RS19595	11
ABI910_6POST	4159994	4160013		YPO_RS19595	19
ABI910_6POST	4160354	4160366		YPO_RS19595	12
ABI910_6POST	4160552	4160572		YPO_RS19595	20
ABI910_6POST	4161947	4161951		YPO_RS19595	4
ABI910_6POST	4162813	4162816		YPO_RS19595	3
ABI910_6POST	4163386	4163408		metH	22
ABI910_6POST	4163990	4164016		metH	26
ABI910_6POST	4164485	4164491		metH	6
ABI910_6POST	4164564	4164617		metH	53
ABI910_6POST	4164708	4164716		metH	8
ABI910_6POST	4165512	4165513		metH	1
ABI910_6POST	4165864	4165877		metH	13
ABI910_6POST	4166367	4166380		metH	13
ABI910_6POST	4166719	4166729		metH	10
ABI910_6POST	4168056	4168069		aceK	13
ABI910_6POST	4168467	4168479		aceK	12
ABI910_6POST	4168611	4168635		aceK	24
ABI910_6POST	4169083	4169084		aceK	1
ABI910_6POST	4169451	4169455		aceK	4
ABI910_6POST	4170089	4170106		aceA	17
ABI910_6POST	4170154	4170165		aceA	11
ABI910_6POST	4170830	4170842		aceA	12
ABI910_6POST	4170990	4170999		aceA	9
ABI910_6POST	4172247	4172259		aceB	12
ABI910_6POST	4172628	4172632		aceB	4
ABI910_6POST	4173428	4173431		metA	3
ABI910_6POST	4175561	4175571		YPO_RS19645	10
ABI910_6POST	4176207	4176220		YPO_RS19645	13
ABI910_6POST	4177044	4177052		YPO_RS19645	8
ABI910_6POST	4178359	4178360		YPO_RS19645	1
ABI910_6POST	4180206	4180210		YPO_RS19660	4
ABI910_6POST	4182159	4182165		purH	6
ABI910_6POST	4182265	4182272		purH	7
ABI910_6POST	4182443	4182445		purH	2
ABI910_6POST	4182767	4182769		purD	2
ABI910_6POST	4182876	4182882		purD	6
ABI910_6POST	4183304	4183314		purD	10
ABI910_6POST	4183455	4183461		purD	6
ABI910_6POST	4183982	4183993		purD	11
ABI910_6POST	4184676	4184686		YPO_RS19680	10
ABI910_6POST	4184790	4184822		YPO_RS19680	32
ABI910_6POST	4185411	4185412		YPO_RS19690	1
ABI910_6POST	4185678	4185681		YPO_RS19690	3
ABI910_6POST	4186140	4186146		nfi	6
ABI910_6POST	4186196	4186205		nfi	9
ABI910_6POST	4186903	4186916		hemE	13
ABI910_6POST	4186949	4186967		hemE	18
ABI910_6POST	4187195	4187217		hemE	22
ABI910_6POST	4187381	4187386		hemE	5
ABI910_6POST	4188562	4188581		YPO_RS19705	19
ABI910_6POST	4189371	4189375		nudC	4
ABI910_6POST	4189964	4189973		rsd	9
ABI910_6POST	4190101	4190113		rsd	12
ABI910_6POST	4190711	4190720		thiC	9
ABI910_6POST	4190870	4190871		thiC	1
ABI910_6POST	4190977	4190988		thiC	11
ABI910_6POST	4191526	4191532		thiC	6
ABI910_6POST	4191815	4191820		thiC	5
ABI910_6POST	4191931	4191945		thiC	14
ABI910_6POST	4192036	4192046		thiC	10
ABI910_6POST	4192480	4192500		thiC	20
ABI910_6POST	4193398	4193401		YPO_RS19730	3
ABI910_6POST	4193786	4193791		YPO_RS19730	5
ABI910_6POST	4193924	4193930		YPO_RS19730	6
ABI910_6POST	4194758	4194781		YPO_RS19740	23
ABI910_6POST	4194858	4194888		YPO_RS19740	30
ABI910_6POST	4195058	4195060		YPO_RS19740	2
ABI910_6POST	4195692	4195712		thiH	20
ABI910_6POST	4195992	4195993		thiH	1
ABI910_6POST	4197019	4197022		YPO_RS19750	3
ABI910_6POST	4197396	4197415		rpoC	19
ABI910_6POST	4197675	4197679		rpoC	4
ABI910_6POST	4197946	4197955		rpoC	9
ABI910_6POST	4198079	4198090		rpoC	11
ABI910_6POST	4200205	4200233		rpoC	28
ABI910_6POST	4200694	4200697		rpoC	3
ABI910_6POST	4201051	4201054		rpoC	3
ABI910_6POST	4202280	4202281		rpoB	1
ABI910_6POST	4202510	4202516		rpoB	6
ABI910_6POST	4202987	4203021		rpoB	34
ABI910_6POST	4203507	4203532		rpoB	25
ABI910_6POST	4204168	4204175		rpoB	7
ABI910_6POST	4204569	4204608		rpoB	39
ABI910_6POST	4205218	4205240		rpoB	22
ABI910_6POST	4205440	4205441		rpoB	1
ABI910_6POST	4205629	4205641		rpoB	12
ABI910_6POST	4207700	4207703		rplA	3
ABI910_6POST	4208104	4208125		rplK	21
ABI910_6POST	4208321	4208377		rplK	56
ABI910_6POST	4208864	4208892		nusG	28
ABI910_6POST	4209049	4209055		nusG	6
ABI910_6POST	4209359	4209379		secE	20
ABI910_6POST	4210286	4210288		tuf	2
ABI910_6POST	4210903	4210912		tuf	9
ABI910_6POST	4212139	4212140		YPO_RS19820	1
ABI910_6POST	4212182	4212185		YPO_RS19820	3
ABI910_6POST	4212299	4212322		YPO_RS19820	23
ABI910_6POST	4212386	4212405		YPO_RS19820	19
ABI910_6POST	4212439	4212446		YPO_RS19820	7
ABI910_6POST	4212478	4212487		YPO_RS19820	9
ABI910_6POST	4212794	4212809		YPO_RS19820	15
ABI910_6POST	4212809	4212823		YPO_RS19825	14
ABI910_6POST	4212858	4212862		YPO_RS19825	4
ABI910_6POST	4212925	4212934		YPO_RS19825	9
ABI910_6POST	4213051	4213053		YPO_RS19825	2
ABI910_6POST	4213117	4213161		YPO_RS19825	44
ABI910_6POST	4213231	4213236		YPO_RS19825	5
ABI910_6POST	4213331	4213345		YPO_RS19825	14
ABI910_6POST	4213392	4213404		YPO_RS19825	12
ABI910_6POST	4213436	4213438		YPO_RS19825	2
ABI910_6POST	4213486	4213503		YPO_RS19825	17
ABI910_6POST	4213660	4213707		YPO_RS19825	47
ABI910_6POST	4214208	4214230		YPO_RS19830	22
ABI910_6POST	4215863	4215864		birA	1
ABI910_6POST	4216370	4216397		birA	27
ABI910_6POST	4216451	4216460		birA	9
ABI910_6POST	4217049	4217059		murB	10
ABI910_6POST	4217208	4217213		murB	5
ABI910_6POST	4217609	4217625		murB	16
ABI910_6POST	4219432	4219435		YPO_RS19855	3
ABI910_6POST	4219926	4219930		YPO_RS19855	4
ABI910_6POST	4220043	4220054		YPO_RS19855	11
ABI910_6POST	4223063	4223145		YPO_RS19870	82
ABI910_6POST	4224743	4224755		trkH	12
ABI910_6POST	4225115	4225125		trkH	10
ABI910_6POST	4225191	4225195		trkH	4
ABI910_6POST	4225463	4225472		trkH	9
ABI910_6POST	4225546	4225564		trkH	18
ABI910_6POST	4226843	4226851		YPO_RS19895	8
ABI910_6POST	4227147	4227159		YPO_RS19900	12
ABI910_6POST	4227237	4227245		pepQ	8
ABI910_6POST	4227521	4227525		pepQ	4
ABI910_6POST	4227730	4227731		pepQ	1
ABI910_6POST	4227890	4227902		pepQ	12
ABI910_6POST	4228014	4228016		pepQ	2
ABI910_6POST	4228315	4228316		pepQ	1
ABI910_6POST	4229061	4229062		fadB	1
ABI910_6POST	4230446	4230464		fadB	18
ABI910_6POST	4230800	4230803		fadB	3
ABI910_6POST	4231860	4231864		fadA	4
ABI910_6POST	4232175	4232183		fadA	8
ABI910_6POST	4232490	4232533		fre	43
ABI910_6POST	4232612	4232622		fre	10
ABI910_6POST	4232840	4232852		fre	12
ABI910_6POST	4233034	4233035		fre	1
ABI910_6POST	4233220	4233228		ubiD	8
ABI910_6POST	4233344	4233348		ubiD	4
ABI910_6POST	4233584	4233601		ubiD	17
ABI910_6POST	4233762	4233764		ubiD	2
ABI910_6POST	4234128	4234136		ubiD	8
ABI910_6POST	4234247	4234251		ubiD	4
ABI910_6POST	4236791	4236801		YPO_RS19940	10
ABI910_6POST	4236864	4236886		YPO_RS19945	22
ABI910_6POST	4237135	4237159		YPO_RS19945	24
ABI910_6POST	4237469	4237477		YPO_RS19945	8
ABI910_6POST	4237628	4237635		YPO_RS19945	7
ABI910_6POST	4237635	4237688		YPO_RS19950	53
ABI910_6POST	4237796	4237799		YPO_RS19950	3
ABI910_6POST	4237915	4237969		YPO_RS19950	54
ABI910_6POST	4238056	4238061		YPO_RS19950	5
ABI910_6POST	4238369	4238382		YPO_RS19950	13
ABI910_6POST	4238474	4238488		YPO_RS19950	14
ABI910_6POST	4239529	4239541		tatC	12
ABI910_6POST	4240016	4240046		tatC	30
ABI910_6POST	4241306	4241308		ubiB	2
ABI910_6POST	4241752	4241761		ubiB	9
ABI910_6POST	4242041	4242056		ubiB	15
ABI910_6POST	4242890	4242898		YPO_RS19980	8
ABI910_6POST	4243014	4243015		YPO_RS19980	1
ABI910_6POST	4243747	4243748		ubiE	1
ABI910_6POST	4243872	4243879		ubiE	7
ABI910_6POST	4244019	4244021		ubiE	2
ABI910_6POST	4244661	4244663		rmuC	2
ABI910_6POST	4245774	4245776		rmuC	2
ABI910_6POST	4246026	4246034		YPO_RS19995	8
ABI910_6POST	4246437	4246441		YPO_RS19995	4
ABI910_6POST	4246539	4246542		YPO_RS19995	3
ABI910_6POST	4246827	4246848		YPO_RS20000	21
ABI910_6POST	4247173	4247191		YPO_RS20000	18
ABI910_6POST	4248047	4248077		YPO_RS20000	30
ABI910_6POST	4248252	4248277		YPO_RS20000	25
ABI910_6POST	4248571	4248574		YPO_RS20000	3
ABI910_6POST	4249329	4249370		YPO_RS20005	41
ABI910_6POST	4249800	4249802		YPO_RS20005	2
ABI910_6POST	4250057	4250061		udp	4
ABI910_6POST	4251282	4251303		YPO_RS20015	21
ABI910_6POST	4251338	4251340		YPO_RS20015	2
ABI910_6POST	4251766	4251779		YPO_RS20015	13
ABI910_6POST	4253966	4253985		metE	19
ABI910_6POST	4255132	4255155		metR	23
ABI910_6POST	4255541	4255547		YPO_RS20030	6
ABI910_6POST	4256113	4256124		YPO_RS20030	11
ABI910_6POST	4256666	4256708		YPO_RS20035	42
ABI910_6POST	4256743	4256748		YPO_RS20035	5
ABI910_6POST	4256875	4256886		YPO_RS20035	11
ABI910_6POST	4256969	4256973		YPO_RS20035	4
ABI910_6POST	4257137	4257153		YPO_RS20035	16
ABI910_6POST	4257647	4257655		ugpQ	8
ABI910_6POST	4257908	4257925		ugpQ	17
ABI910_6POST	4258142	4258163		ugpQ	21
ABI910_6POST	4258327	4258333		ugpQ	6
ABI910_6POST	4258833	4258849		YPO_RS20045	16
ABI910_6POST	4258988	4258999		YPO_RS20045	11
ABI910_6POST	4259246	4259247		YPO_RS20045	1
ABI910_6POST	4259416	4259419		YPO_RS20045	3
ABI910_6POST	4259679	4259707		ugpE	28
ABI910_6POST	4260091	4260102		ugpE	11
ABI910_6POST	4260201	4260206		ugpE	5
ABI910_6POST	4259838	4259845		ugpE	7
ABI910_6POST	4262072	4262090		ugpB	18
ABI910_6POST	4262490	4262497		ugpB	7
ABI910_6POST	4262530	4262553		ugpB	23
ABI910_6POST	4263484	4263505		YPO_RS20065	21
ABI910_6POST	4264233	4264239		YPO_RS20070	6
ABI910_6POST	4264505	4264508		YPO_RS20070	3
ABI910_6POST	4264694	4264716		YPO_RS20070	22
ABI910_6POST	4264852	4264853		YPO_RS20070	1
ABI910_6POST	4265019	4265036		YPO_RS20070	17
ABI910_6POST	4265328	4265331		YPO_RS20070	3
ABI910_6POST	4265555	4265560		YPO_RS20070	5
ABI910_6POST	4265863	4265873		YPO_RS20070	10
ABI910_6POST	4266008	4266012		YPO_RS20070	4
ABI910_6POST	4266496	4266497		YPO_RS20075	1
ABI910_6POST	4266540	4266544		YPO_RS20075	4
ABI910_6POST	4266773	4266775		YPO_RS20075	2
ABI910_6POST	4267300	4267320		YPO_RS20080	20
ABI910_6POST	4267593	4267600		YPO_RS20080	7
ABI910_6POST	4267961	4267976		YPO_RS20085	15
ABI910_6POST	4268187	4268218		YPO_RS20085	31
ABI910_6POST	4268320	4268321		YPO_RS20085	1
ABI910_6POST	4268926	4268930		YPO_RS20090	4
ABI910_6POST	4270017	4270035		YPO_RS20095	18
ABI910_6POST	4270643	4270648		livF	5
ABI910_6POST	4270988	4270989		livF	1
ABI910_6POST	4271112	4271118		YPO_RS20105	6
ABI910_6POST	4271404	4271439		YPO_RS20105	35
ABI910_6POST	4271680	4271683		YPO_RS20105	3
ABI910_6POST	4272712	4272729		YPO_RS20110	17
ABI910_6POST	4272934	4272941		YPO_RS20110	7
ABI910_6POST	4273065	4273071		YPO_RS20110	6
ABI910_6POST	4273302	4273322		livH	20
ABI910_6POST	4273777	4273786		livH	9
ABI910_6POST	4275002	4275015		YPO_RS20120	13
ABI910_6POST	4275080	4275082		YPO_RS20120	2
ABI910_6POST	4275176	4275178		YPO_RS20120	2
ABI910_6POST	4275253	4275261		YPO_RS20120	8
ABI910_6POST	4276689	4276694		YPO_RS20130	5
ABI910_6POST	4276785	4276786		YPO_RS20130	1
ABI910_6POST	4276867	4276875		YPO_RS20130	8
ABI910_6POST	4277643	4277658		rpoH	15
ABI910_6POST	4278353	4278360		ftsX	7
ABI910_6POST	4279978	4279980		ftsY	2
ABI910_6POST	4280506	4280508		ftsY	2
ABI910_6POST	4280711	4280727		ftsY	16
ABI910_6POST	4281031	4281035		ftsY	4
ABI910_6POST	4281429	4281438		ftsY	9
ABI910_6POST	4281972	4281979		rsmD	7
ABI910_6POST	4283525	4283531		YPO_RS20170	6
ABI910_6POST	4284211	4284221		YPO_RS20175	10
ABI910_6POST	4284482	4284493		YPO_RS20175	11
ABI910_6POST	4284646	4284658		YPO_RS20175	12
ABI910_6POST	4285200	4285205		YPO_RS20180	5
ABI910_6POST	4285516	4285528		YPO_RS20180	12
ABI910_6POST	4286077	4286098		YPO_RS20180	21
ABI910_6POST	4286352	4286358		YPO_RS20180	6
ABI910_6POST	4286641	4286649		YPO_RS20180	8
ABI910_6POST	4286721	4286764		YPO_RS20180	43
ABI910_6POST	4287660	4287677		tusA	17
ABI910_6POST	4288590	4288601		YPO_RS20190	11
ABI910_6POST	4290906	4290926		glpC	20
ABI910_6POST	4291020	4291029		glpB	9
ABI910_6POST	4291265	4291270		glpB	5
ABI910_6POST	4291321	4291335		glpB	14
ABI910_6POST	4291836	4291837		glpB	1
ABI910_6POST	4292257	4292303		glpA	46
ABI910_6POST	4292727	4292729		glpA	2
ABI910_6POST	4292891	4292894		glpA	3
ABI910_6POST	4293013	4293018		glpA	5
ABI910_6POST	4293133	4293150		glpA	17
ABI910_6POST	4294913	4294936		glpQ	23
ABI910_6POST	4295004	4295022		glpQ	18
ABI910_6POST	4297886	4297892		yigL	6
ABI910_6POST	4298102	4298103		pldB	1
ABI910_6POST	4298479	4298483		pldB	4
ABI910_6POST	4298763	4298768		pldB	5
ABI910_6POST	4298813	4298845		pldB	32
ABI910_6POST	4299276	4299320		rhtB	44
ABI910_6POST	4300594	4300604		recQ	10
ABI910_6POST	4300847	4300851		recQ	4
ABI910_6POST	4301128	4301129		recQ	1
ABI910_6POST	4301805	4301810		recQ	5
ABI910_6POST	4302086	4302094		recQ	8
ABI910_6POST	4302519	4302569		pldA	50
ABI910_6POST	4303344	4303346		pldA	2
ABI910_6POST	4304715	4304717		rarD	2
ABI910_6POST	4304786	4304844		rarD	58
ABI910_6POST	4307006	4307028		YPO_RS20275	22
ABI910_6POST	4307764	4307788		YPO_RS20280	24
ABI910_6POST	4308080	4308106		YPO_RS20280	26
ABI910_6POST	4308242	4308251		YPO_RS20280	9
ABI910_6POST	4308603	4308612		YPO_RS20280	9
ABI910_6POST	4308712	4308713		YPO_RS20280	1
ABI910_6POST	4310298	4310299		uvrD	1
ABI910_6POST	4310640	4310641		uvrD	1
ABI910_6POST	4311342	4311344		uvrD	2
ABI910_6POST	4311710	4311712		uvrD	2
ABI910_6POST	4311771	4311775		uvrD	4
ABI910_6POST	4312616	4312636		yigB	20
ABI910_6POST	4313137	4313146		xerC	9
ABI910_6POST	4313217	4313236		xerC	19
ABI910_6POST	4313561	4313583		xerC	22
ABI910_6POST	4313626	4313646		xerC	20
ABI910_6POST	4313965	4313988		YPO_RS20305	23
ABI910_6POST	4314476	4314498		YPO_RS20305	22
ABI910_6POST	4314732	4314777		dapF	45
ABI910_6POST	4315262	4315288		dapF	26
ABI910_6POST	4315740	4315743		YPO_RS20315	3
ABI910_6POST	4315839	4315845		YPO_RS20315	6
ABI910_6POST	4317398	4317404		YPO_RS20325	6
ABI910_6POST	4317801	4317804		YPO_RS20325	3
ABI910_6POST	4318674	4318676		YPO_RS20325	2
ABI910_6POST	4318830	4318833		YPO_RS20325	3
ABI910_6POST	4319784	4319793		hemC	9
ABI910_6POST	4319936	4319939		hemC	3
ABI910_6POST	4320461	4320462		hemC	1
ABI910_6POST	4320518	4320519		hemC	1
ABI910_6POST	4320627	4320630		hemD	3
ABI910_6POST	4320988	4321022		hemD	34
ABI910_6POST	4321414	4321424		hemX	10
ABI910_6POST	4322202	4322215		hemX	13
ABI910_6POST	4322832	4322850		hemY	18
ABI910_6POST	4325968	4325982		YPO_RS20380	14
ABI910_6POST	4326057	4326068		YPO_RS20380	11
ABI910_6POST	4326161	4326174		YPO_RS20380	13
ABI910_6POST	4326232	4326283		YPO_RS20380	51
ABI910_6POST	4326354	4326384		YPO_RS20380	30
ABI910_6POST	4326459	4326488		YPO_RS20380	29
ABI910_6POST	4326880	4326899		YPO_RS20380	19
ABI910_6POST	4327896	4327904		rffM	8
ABI910_6POST	4327975	4327985		rffM	10
ABI910_6POST	4328862	4328887		wzyE	25
ABI910_6POST	4329224	4329236		wzyE	12
ABI910_6POST	4329541	4329569		wzyE	28
ABI910_6POST	4329717	4329737		wzyE	20
ABI910_6POST	4330150	4330169		YPO_RS20395	19
ABI910_6POST	4330405	4330423		YPO_RS20395	18
ABI910_6POST	4331754	4331758		wzxE	4
ABI910_6POST	4331793	4331803		wzxE	10
ABI910_6POST	4332834	4332846		rffA	12
ABI910_6POST	4333104	4333108		rffA	4
ABI910_6POST	4333431	4333438		rffC	7
ABI910_6POST	4333661	4333664		rffC	3
ABI910_6POST	4333857	4333876		rffC	19
ABI910_6POST	4334914	4334962		rfbA	48
ABI910_6POST	4336292	4336329		rffG	37
ABI910_6POST	4336554	4336564		wecC	10
ABI910_6POST	4336829	4336831		wecC	2
ABI910_6POST	4337245	4337247		wecC	2
ABI910_6POST	4337669	4337679		wecB	10
ABI910_6POST	4337871	4337892		wecB	21
ABI910_6POST	4337946	4337952		wecB	6
ABI910_6POST	4338241	4338244		wecB	3
ABI910_6POST	4339034	4339036		wzzE	2
ABI910_6POST	4339083	4339104		wzzE	21
ABI910_6POST	4339877	4339881		wzzE	4
ABI910_6POST	4339993	4339994		wzzE	1
ABI910_6POST	4341052	4341084		wecA	32
ABI910_6POST	4343990	4344011		rhlB	21
ABI910_6POST	4344991	4344997		rhlB	6
ABI910_6POST	4345128	4345157		rhlB	29
ABI910_6POST	4347207	4347239		rep	32
ABI910_6POST	4347583	4347594		rep	11
ABI910_6POST	4348269	4348290		rep	21
ABI910_6POST	4348439	4348458		rep	19
ABI910_6POST	4348547	4348552		rep	5
ABI910_6POST	4349379	4349380		YPO_RS20475	1
ABI910_6POST	4349795	4349809		YPO_RS20480	14
ABI910_6POST	4350062	4350082		YPO_RS20480	20
ABI910_6POST	4350550	4350561		YPO_RS20485	11
ABI910_6POST	4350652	4350692		YPO_RS20485	40
ABI910_6POST	4350796	4350812		YPO_RS20485	16
ABI910_6POST	4351016	4351017		YPO_RS20485	1
ABI910_6POST	4351060	4351077		YPO_RS20485	17
ABI910_6POST	4351235	4351240		YPO_RS20485	5
ABI910_6POST	4351341	4351352		YPO_RS20485	11
ABI910_6POST	4351517	4351542		YPO_RS20485	25
ABI910_6POST	4351630	4351656		YPO_RS20485	26
ABI910_6POST	4351689	4351690		YPO_RS20485	1
ABI910_6POST	4352856	4352875		YPO_RS20490	19
ABI910_6POST	4353018	4353067		YPO_RS20490	49
ABI910_6POST	4353362	4353394		YPO_RS20495	32
ABI910_6POST	4353545	4353547		YPO_RS20495	2
ABI910_6POST	4353965	4353967		YPO_RS20500	2
ABI910_6POST	4354258	4354283		YPO_RS20500	25
ABI910_6POST	4354434	4354446		YPO_RS20500	12
ABI910_6POST	4356665	4356711		stbD	46
ABI910_6POST	4356946	4356970		stbD	24
ABI910_6POST	4357206	4357215		stbD	9
ABI910_6POST	4357332	4357336		stbD	4
ABI910_6POST	4357658	4357685		stbD	27
ABI910_6POST	4357730	4357754		stbD	24
ABI910_6POST	4358089	4358096		YPO_RS20510	7
ABI910_6POST	4358211	4358266		YPO_RS20510	55
ABI910_6POST	4358514	4358534		YPO_RS20510	20
ABI910_6POST	4359436	4359442		YPO_RS20515	6
ABI910_6POST	4359502	4359515		YPO_RS20515	13
ABI910_6POST	4360525	4360526		YPO_RS20530	1
ABI910_6POST	4360678	4360681		YPO_RS20530	3
ABI910_6POST	4360962	4360992		YPO_RS20530	30
ABI910_6POST	4361129	4361130		YPO_RS20530	1
ABI910_6POST	4361215	4361219		YPO_RS20530	4
ABI910_6POST	4362010	4362013		YPO_RS20535	3
ABI910_6POST	4363125	4363132		ilvC	7
ABI910_6POST	4363186	4363207		ilvC	21
ABI910_6POST	4363490	4363503		ilvC	13
ABI910_6POST	4365147	4365164		YPO_RS20550	17
ABI910_6POST	4366313	4366320		YPO_RS20560	7
ABI910_6POST	4367058	4367078		YPO_RS20565	20
ABI910_6POST	4367236	4367250		YPO_RS20565	14
ABI910_6POST	4367607	4367616		YPO_RS20570	9
ABI910_6POST	4367781	4367794		YPO_RS20570	13
ABI910_6POST	4368098	4368103		YPO_RS20575	5
ABI910_6POST	4368519	4368523		ilvA	4
ABI910_6POST	4369977	4369981		ilvA	4
ABI910_6POST	4370178	4370180		ilvD	2
ABI910_6POST	4370453	4370478		ilvD	25
ABI910_6POST	4370662	4370665		ilvD	3
ABI910_6POST	4370921	4370927		ilvD	6
ABI910_6POST	4371015	4371020		ilvD	5
ABI910_6POST	4371323	4371324		ilvD	1
ABI910_6POST	4371482	4371484		ilvD	2
ABI910_6POST	4371646	4371648		ilvD	2
ABI910_6POST	4371876	4371896		ilvD	20
ABI910_6POST	4372577	4372578		YPO_RS20590	1
ABI910_6POST	4372795	4372796		YPO_RS20590	1
ABI910_6POST	4373455	4373462		YPO_RS20600	7
ABI910_6POST	4373864	4373880		YPO_RS20600	16
ABI910_6POST	4374028	4374042		YPO_RS20600	14
ABI910_6POST	4374106	4374111		YPO_RS20600	5
ABI910_6POST	4374745	4374750		YPO_RS20600	5
ABI910_6POST	4374785	4374791		YPO_RS20600	6
ABI910_6POST	4374951	4374978		YPO_RS20600	27
ABI910_6POST	4376241	4376260		YPO_RS20610	19
ABI910_6POST	4377212	4377215		YPO_RS20610	3
ABI910_6POST	4378022	4378025		hdfR	3
ABI910_6POST	4378991	4379005		yjfF	14
ABI910_6POST	4379121	4379122		yjfF	1
ABI910_6POST	4379194	4379201		yjfF	7
ABI910_6POST	4380089	4380099		YPO_RS20630	10
ABI910_6POST	4380156	4380171		YPO_RS20630	15
ABI910_6POST	4380245	4380276		YPO_RS20630	31
ABI910_6POST	4380475	4380509		YPO_RS20630	34
ABI910_6POST	4381390	4381402		YPO_RS20635	12
ABI910_6POST	4381502	4381513		YPO_RS20635	11
ABI910_6POST	4381748	4381760		YPO_RS20635	12
ABI910_6POST	4382074	4382122		YPO_RS20635	48
ABI910_6POST	4382919	4382924		YPO_RS20640	5
ABI910_6POST	4383101	4383105		YPO_RS20640	4
ABI910_6POST	4383344	4383349		YPO_RS20640	5
ABI910_6POST	4385879	4385880		YPO_RS20660	1
ABI910_6POST	4386263	4386265		YPO_RS20660	2
ABI910_6POST	4387096	4387110		YPO_RS20660	14
ABI910_6POST	4387154	4387156		YPO_RS20660	2
ABI910_6POST	4388484	4388509		YPO_RS20670	25
ABI910_6POST	4388630	4388636		YPO_RS20670	6
ABI910_6POST	4389730	4389736		YPO_RS20670	6
ABI910_6POST	4390774	4390780		murI	6
ABI910_6POST	4390994	4390999		murI	5
ABI910_6POST	4391244	4391256		btuB	12
ABI910_6POST	4391350	4391354		btuB	4
ABI910_6POST	4392089	4392108		btuB	19
ABI910_6POST	4392292	4392297		btuB	5
ABI910_6POST	4392438	4392447		btuB	9
ABI910_6POST	4392753	4392765		btuB	12
ABI910_6POST	4394814	4394818		YPO_RS20695	4
ABI910_6POST	4394896	4394902		YPO_RS20695	6
ABI910_6POST	4395494	4395495		fabR	1
ABI910_6POST	4397150	4397163		sthA	13
ABI910_6POST	4397216	4397253		sthA	37
ABI910_6POST	4397495	4397500		oxyR	5
ABI910_6POST	4397757	4397766		oxyR	9
ABI910_6POST	4398011	4398018		oxyR	7
ABI910_6POST	4398107	4398111		oxyR	4
ABI910_6POST	4398800	4398813		YPO_RS20715	13
ABI910_6POST	4399268	4399272		YPO_RS20720	4
ABI910_6POST	4399303	4399309		YPO_RS20720	6
ABI910_6POST	4399525	4399538		YPO_RS20720	13
ABI910_6POST	4399760	4399765		YPO_RS20720	5
ABI910_6POST	4400129	4400147		YPO_RS20720	18
ABI910_6POST	4400439	4400454		YPO_RS20720	15
ABI910_6POST	4400875	4400891		YPO_RS20725	16
ABI910_6POST	4401409	4401440		YPO_RS20725	31
ABI910_6POST	4401471	4401480		YPO_RS20725	9
ABI910_6POST	4401779	4401791		YPO_RS20730	12
ABI910_6POST	4402014	4402016		YPO_RS20730	2
ABI910_6POST	4402696	4402716		YPO_RS20730	20
ABI910_6POST	4402802	4402810		YPO_RS20730	8
ABI910_6POST	4403021	4403022		YPO_RS20735	1
ABI910_6POST	4403426	4403440		YPO_RS20735	14
ABI910_6POST	4403515	4403522		YPO_RS20735	7
ABI910_6POST	4404619	4404636		YPO_RS20735	17
ABI910_6POST	4406077	4406080		YPO_RS20745	3
ABI910_6POST	4406442	4406450		YPO_RS20745	8
ABI910_6POST	4406498	4406504		YPO_RS20745	6
ABI910_6POST	4406632	4406642		YPO_RS20745	10
ABI910_6POST	4407044	4407067		YPO_RS20745	23
ABI910_6POST	4407561	4407571		YPO_RS20745	10
ABI910_6POST	4411764	4411773		argC	9
ABI910_6POST	4412212	4412239		argC	27
ABI910_6POST	4412326	4412344		argC	18
ABI910_6POST	4412724	4412726		argE	2
ABI910_6POST	4414591	4414610		ppc	19
ABI910_6POST	4416122	4416141		ppc	19
ABI910_6POST	4416378	4416382		ppc	4
ABI910_6POST	4416419	4416454		ppc	35
ABI910_6POST	4416611	4416618		ppc	7
ABI910_6POST	4418145	4418149		YPO_RS20775	4
ABI910_6POST	4418429	4418457		YPO_RS20775	28
ABI910_6POST	4418631	4418634		YPO_RS20775	3
ABI910_6POST	4419312	4419318		YPO_RS20780	6
ABI910_6POST	4419975	4419978		YPO_RS20785	3
ABI910_6POST	4421451	4421458		glpD	7
ABI910_6POST	4421776	4421781		glpD	5
ABI910_6POST	4421877	4421880		glpD	3
ABI910_6POST	4421945	4421978		glpD	33
ABI910_6POST	4422284	4422286		glpD	2
ABI910_6POST	4422426	4422430		glpD	4
ABI910_6POST	4425048	4425049		glgP	1
ABI910_6POST	4425133	4425137		glgP	4
ABI910_6POST	4425253	4425254		glgP	1
ABI910_6POST	4425901	4425911		glgA	10
ABI910_6POST	4426139	4426148		glgA	9
ABI910_6POST	4426386	4426400		glgA	14
ABI910_6POST	4426693	4426701		glgA	8
ABI910_6POST	4426768	4426769		glgA	1
ABI910_6POST	4428508	4428529		glgX	21
ABI910_6POST	4428741	4428771		glgX	30
ABI910_6POST	4429148	4429162		glgX	14
ABI910_6POST	4429740	4429747		glgX	7
ABI910_6POST	4430356	4430375		glgX	19
ABI910_6POST	4431311	4431324		glgB	13
ABI910_6POST	4433195	4433201		YPO_RS20825	6
ABI910_6POST	4433353	4433377		YPO_RS20825	24
ABI910_6POST	4433872	4433927		YPO_RS20825	55
ABI910_6POST	4434041	4434053		YPO_RS20825	12
ABI910_6POST	4435124	4435144		YPO_RS20830	20
ABI910_6POST	4435351	4435356		YPO_RS20830	5
ABI910_6POST	4435450	4435465		YPO_RS20830	15
ABI910_6POST	4435717	4435734		YPO_RS20830	17
ABI910_6POST	4436111	4436113		YPO_RS20830	2
ABI910_6POST	4436228	4436238		YPO_RS20830	10
ABI910_6POST	4436374	4436378		YPO_RS20830	4
ABI910_6POST	4436601	4436609		YPO_RS20830	8
ABI910_6POST	4436788	4436824		YPO_RS20830	36
ABI910_6POST	4436877	4436884		YPO_RS20830	7
ABI910_6POST	4436922	4436948		YPO_RS20830	26
ABI910_6POST	4437201	4437203		YPO_RS20830	2
ABI910_6POST	4437281	4437298		YPO_RS20830	17
ABI910_6POST	4437329	4437348		YPO_RS20830	19
ABI910_6POST	4437823	4437839		YPO_RS20830	16
ABI910_6POST	4437952	4437965		YPO_RS20830	13
ABI910_6POST	4438030	4438031		YPO_RS20830	1
ABI910_6POST	4438100	4438102		YPO_RS20830	2
ABI910_6POST	4438132	4438164		YPO_RS20830	32
ABI910_6POST	4438642	4438693		YPO_RS20830	51
ABI910_6POST	4439185	4439191		YPO_RS20830	6
ABI910_6POST	4439227	4439258		YPO_RS20830	31
ABI910_6POST	4439544	4439577		YPO_RS20830	33
ABI910_6POST	4439868	4439873		YPO_RS20830	5
ABI910_6POST	4440107	4440122		YPO_RS20830	15
ABI910_6POST	4440312	4440320		YPO_RS20830	8
ABI910_6POST	4440430	4440435		YPO_RS20830	5
ABI910_6POST	4441016	4441030		YPO_RS20830	14
ABI910_6POST	4441093	4441110		YPO_RS20830	17
ABI910_6POST	4441200	4441202		YPO_RS20830	2
ABI910_6POST	4441251	4441268		YPO_RS20830	17
ABI910_6POST	4441625	4441646		YPO_RS20830	21
ABI910_6POST	4441694	4441704		YPO_RS20830	10
ABI910_6POST	4441849	4441853		YPO_RS20830	4
ABI910_6POST	4442174	4442175		YPO_RS20830	1
ABI910_6POST	4442509	4442517		YPO_RS20830	8
ABI910_6POST	4442556	4442567		YPO_RS20830	11
ABI910_6POST	4442644	4442647		YPO_RS20830	3
ABI910_6POST	4442736	4442737		YPO_RS20830	1
ABI910_6POST	4442877	4442888		YPO_RS20830	11
ABI910_6POST	4442985	4443002		YPO_RS20830	17
ABI910_6POST	4443244	4443257		YPO_RS20830	13
ABI910_6POST	4443335	4443341		YPO_RS20830	6
ABI910_6POST	4443815	4443818		YPO_RS20830	3
ABI910_6POST	4443947	4443960		YPO_RS20830	13
ABI910_6POST	4445806	4445816		YPO_RS20840	10
ABI910_6POST	4446323	4446328		YPO_RS20845	5
ABI910_6POST	4447243	4447245		asd	2
ABI910_6POST	4447804	4447817		asd	13
ABI910_6POST	4448991	4448998		YPO_RS20865	7
ABI910_6POST	4449082	4449091		YPO_RS20865	9
ABI910_6POST	4450628	4450643		YPO_RS20880	15
ABI910_6POST	4450927	4450928		YPO_RS20880	1
ABI910_6POST	4450985	4450989		YPO_RS20880	4
ABI910_6POST	4451435	4451444		gntT	9
ABI910_6POST	4451493	4451504		gntT	11
ABI910_6POST	4451621	4451636		gntT	15
ABI910_6POST	4451731	4451732		gntT	1
ABI910_6POST	4451782	4451806		gntT	24
ABI910_6POST	4452438	4452452		gntT	14
ABI910_6POST	4452887	4452898		gntR	11
ABI910_6POST	4454042	4454052		YPO_RS20895	10
ABI910_6POST	4454135	4454137		YPO_RS20895	2
ABI910_6POST	4454282	4454293		YPO_RS20895	11
ABI910_6POST	4454698	4454702		YPO_RS20900	4
ABI910_6POST	4455443	4455447		YPO_RS20905	4
ABI910_6POST	4456011	4456013		YPO_RS20905	2
ABI910_6POST	4456478	4456503		YPO_RS20910	25
ABI910_6POST	4456752	4456778		YPO_RS20910	26
ABI910_6POST	4456908	4456912		YPO_RS20910	4
ABI910_6POST	4457494	4457496		YPO_RS20915	2
ABI910_6POST	4457726	4457749		YPO_RS20915	23
ABI910_6POST	4458274	4458325		YPO_RS20920	51
ABI910_6POST	4458375	4458394		YPO_RS20920	19
ABI910_6POST	4458716	4458720		YPO_RS20920	4
ABI910_6POST	4458780	4458791		YPO_RS20920	11
ABI910_6POST	4458987	4458990		YPO_RS20925	3
ABI910_6POST	4459410	4459416		YPO_RS20925	6
ABI910_6POST	4459904	4459931		YPO_RS20930	27
ABI910_6POST	4459985	4459994		YPO_RS20930	9
ABI910_6POST	4460172	4460176		YPO_RS20930	4
ABI910_6POST	4460297	4460315		YPO_RS20930	18
ABI910_6POST	4460702	4460706		YPO_RS20930	4
ABI910_6POST	4460878	4460879		YPO_RS20935	1
ABI910_6POST	4461297	4461310		YPO_RS20935	13
ABI910_6POST	4461495	4461516		YPO_RS20935	21
ABI910_6POST	4462645	4462651		YPO_RS20940	6
ABI910_6POST	4463103	4463129		YPO_RS20940	26
ABI910_6POST	4463213	4463218		YPO_RS20940	5
ABI910_6POST	4463266	4463279		YPO_RS20940	13
ABI910_6POST	4463765	4463793		YPO_RS20940	28
ABI910_6POST	4463823	4463842		YPO_RS20940	19
ABI910_6POST	4464555	4464596		YPO_RS20940	41
ABI910_6POST	4464702	4464715		YPO_RS20940	13
ABI910_6POST	4465410	4465452		YPO_RS20945	42
ABI910_6POST	4467009	4467029		pitA	20
ABI910_6POST	4467183	4467188		pitA	5
ABI910_6POST	4467302	4467313		pitA	11
ABI910_6POST	4467411	4467420		pitA	9
ABI910_6POST	4467635	4467644		pitA	9
ABI910_6POST	4468222	4468227		pitA	5
ABI910_6POST	4471135	4471152		gdhA	17
ABI910_6POST	4471342	4471347		gdhA	5
ABI910_6POST	4471648	4471660		gdhA	12
ABI910_6POST	4471867	4471872		gdhA	5
ABI910_6POST	4471977	4471984		gdhA	7
ABI910_6POST	4472528	4472529		YPO_RS20975	1
ABI910_6POST	4472751	4472762		YPO_RS20975	11
ABI910_6POST	4472938	4472944		YPO_RS20975	6
ABI910_6POST	4472977	4472987		YPO_RS20975	10
ABI910_6POST	4473109	4473129		YPO_RS20975	20
ABI910_6POST	4473470	4473491		YPO_RS20975	21
ABI910_6POST	4473646	4473648		YPO_RS20975	2
ABI910_6POST	4473740	4473745		YPO_RS20975	5
ABI910_6POST	4474084	4474111		rsmJ	27
ABI910_6POST	4474511	4474534		rsmJ	23
ABI910_6POST	4474815	4474826		prlC	11
ABI910_6POST	4474905	4474906		prlC	1
ABI910_6POST	4475062	4475065		prlC	3
ABI910_6POST	4476139	4476147		prlC	8
ABI910_6POST	4477136	4477145		YPO_RS20990	9
ABI910_6POST	4479334	4479337		gorA	3
ABI910_6POST	4480173	4480174		YPO_RS21000	1
ABI910_6POST	4480316	4480336		YPO_RS21000	20
ABI910_6POST	4480793	4480797		YPO_RS21005	4
ABI910_6POST	4480883	4480907		YPO_RS21010	24
ABI910_6POST	4481607	4481609		YPO_RS21010	2
ABI910_6POST	4481804	4481830		YPO_RS21010	26
ABI910_6POST	4482884	4482904		YPO_RS21015	20
ABI910_6POST	4483112	4483135		YPO_RS21015	23
ABI910_6POST	4483888	4483893		YPO_RS21020	5
ABI910_6POST	4484151	4484192		YPO_RS21025	41
ABI910_6POST	4484559	4484570		YPO_RS21025	11
ABI910_6POST	4484809	4484822		YPO_RS21030	13
ABI910_6POST	4484947	4484961		YPO_RS21030	14
ABI910_6POST	4485257	4485276		YPO_RS21030	19
ABI910_6POST	4485433	4485438		YPO_RS21030	5
ABI910_6POST	4485663	4485669		yapE	6
ABI910_6POST	4485727	4485728		yapE	1
ABI910_6POST	4485836	4485850		yapE	14
ABI910_6POST	4485974	4485981		yapE	7
ABI910_6POST	4486084	4486090		yapE	6
ABI910_6POST	4486205	4486211		yapE	6
ABI910_6POST	4486600	4486653		yapE	53
ABI910_6POST	4486847	4486859		yapE	12
ABI910_6POST	4487783	4487800		yapE	17
ABI910_6POST	4487864	4487930		yapE	66
ABI910_6POST	4488023	4488061		yapE	38
ABI910_6POST	4488672	4488694		yapE	22
ABI910_6POST	4490038	4490040		yhjD	2
ABI910_6POST	4490765	4490787		YPO_RS21045	22
ABI910_6POST	4491277	4491305		YPO_RS21045	28
ABI910_6POST	4491388	4491407		YPO_RS21050	19
ABI910_6POST	4491437	4491439		YPO_RS21050	2
ABI910_6POST	4491496	4491512		YPO_RS21050	16
ABI910_6POST	4491612	4491628		YPO_RS21050	16
ABI910_6POST	4491883	4491884		YPO_RS21050	1
ABI910_6POST	4492075	4492105		YPO_RS21050	30
ABI910_6POST	4492353	4492373		YPO_RS21050	20
ABI910_6POST	4492538	4492564		YPO_RS21050	26
ABI910_6POST	4492679	4492731		YPO_RS21050	52
ABI910_6POST	4493976	4493979		pdeH	3
ABI910_6POST	4495533	4495539		YPO_RS21065	6
ABI910_6POST	4497048	4497055		YPO_RS21070	7
ABI910_6POST	4497127	4497149		YPO_RS21070	22
ABI910_6POST	4497589	4497596		YPO_RS21070	7
ABI910_6POST	4497644	4497651		YPO_RS21070	7
ABI910_6POST	4497980	4497985		YPO_RS21070	5
ABI910_6POST	4498725	4498771		YPO_RS21075	46
ABI910_6POST	4498812	4498827		YPO_RS21075	15
ABI910_6POST	4500698	4500700		YPO_RS21085	2
ABI910_6POST	4500797	4500819		YPO_RS21085	22
ABI910_6POST	4500985	4500991		YPO_RS21085	6
ABI910_6POST	4501416	4501438		YPO_RS21085	22
ABI910_6POST	4501927	4501940		YPO_RS21085	13
ABI910_6POST	4502102	4502109		YPO_RS21085	7
ABI910_6POST	4502734	4502760		YPO_RS21090	26
ABI910_6POST	4502930	4502958		YPO_RS21090	28
ABI910_6POST	4504269	4504283		hmsP	14
ABI910_6POST	4504574	4504603		hmsP	29
ABI910_6POST	4504653	4504655		hmsP	2
ABI910_6POST	4505104	4505112		hmsP	8
ABI910_6POST	4505611	4505612		hmsP	1
ABI910_6POST	4505779	4505780		hmsP	1
ABI910_6POST	4505843	4505853		hmsP	10
ABI910_6POST	4506347	4506364		bcsZ	17
ABI910_6POST	4507307	4507313		YPO_RS21105	6
ABI910_6POST	4508086	4508091		YPO_RS21110	5
ABI910_6POST	4508519	4508531		YPO_RS21110	12
ABI910_6POST	4508782	4508784		dppD	2
ABI910_6POST	4508976	4508978		dppD	2
ABI910_6POST	4509123	4509164		dppD	41
ABI910_6POST	4509704	4509724		dppC	20
ABI910_6POST	4510371	4510372		dppC	1
ABI910_6POST	4510624	4510646		dppB	22
ABI910_6POST	4510736	4510745		dppB	9
ABI910_6POST	4511079	4511101		dppB	22
ABI910_6POST	4511169	4511175		dppB	6
ABI910_6POST	4511346	4511413		dppB	67
ABI910_6POST	4511919	4511938		YPO_RS21130	19
ABI910_6POST	4512192	4512204		YPO_RS21130	12
ABI910_6POST	4512402	4512413		YPO_RS21130	11
ABI910_6POST	4512531	4512532		YPO_RS21130	1
ABI910_6POST	4512789	4512798		YPO_RS21130	9
ABI910_6POST	4512997	4513008		YPO_RS21130	11
ABI910_6POST	4513152	4513182		YPO_RS21130	30
ABI910_6POST	4514641	4514648		YPO_RS21135	7
ABI910_6POST	4514805	4514813		YPO_RS21135	8
ABI910_6POST	4514939	4514976		YPO_RS21135	37
ABI910_6POST	4515308	4515316		YPO_RS21135	8
ABI910_6POST	4516441	4516446		YPO_RS21140	5
ABI910_6POST	4517337	4517347		YPO_RS21140	10
ABI910_6POST	4518410	4518430		YPO_RS21150	20
ABI910_6POST	4518566	4518584		YPO_RS21150	18
ABI910_6POST	4518983	4519039		YPO_RS21150	56
ABI910_6POST	4520386	4520411		YPO_RS21160	25
ABI910_6POST	4520548	4520571		YPO_RS21160	23
ABI910_6POST	4520785	4520798		YPO_RS21160	13
ABI910_6POST	4520901	4520909		YPO_RS21165	8
ABI910_6POST	4521001	4521031		YPO_RS21165	30
ABI910_6POST	4521188	4521236		YPO_RS21165	48
ABI910_6POST	4521432	4521446		YPO_RS21165	14
ABI910_6POST	4521748	4521777		YPO_RS21165	29
ABI910_6POST	4522926	4522941		uhpA	15
ABI910_6POST	4523043	4523053		uhpA	10
ABI910_6POST	4523549	4523560		eptB	11
ABI910_6POST	4523961	4523964		eptB	3
ABI910_6POST	4524262	4524275		eptB	13
ABI910_6POST	4524372	4524400		eptB	28
ABI910_6POST	4525072	4525075		eptB	3
ABI910_6POST	4526879	4526882		YPO_RS21185	3
ABI910_6POST	4527092	4527112		YPO_RS21185	20
ABI910_6POST	4527716	4527719		YPO_RS21190	3
ABI910_6POST	4527901	4527919		YPO_RS21190	18
ABI910_6POST	4528117	4528137		YPO_RS21190	20
ABI910_6POST	4528233	4528251		YPO_RS21190	18
ABI910_6POST	4528670	4528697		YPO_RS21190	27
ABI910_6POST	4528781	4528823		YPO_RS21190	42
ABI910_6POST	4528965	4528993		YPO_RS21190	28
ABI910_6POST	4530030	4530036		hutH	6
ABI910_6POST	4530414	4530457		hutH	43
ABI910_6POST	4530499	4530516		hutH	17
ABI910_6POST	4531622	4531623		hutU	1
ABI910_6POST	4531712	4531716		hutU	4
ABI910_6POST	4531747	4531753		hutU	6
ABI910_6POST	4531907	4531919		hutU	12
ABI910_6POST	4533415	4533423		YPO_RS21205	8
ABI910_6POST	4533456	4533457		YPO_RS21205	1
ABI910_6POST	4533611	4533627		YPO_RS21205	16
ABI910_6POST	4533763	4533770		YPO_RS21205	7
ABI910_6POST	4534081	4534103		YPO_RS21205	22
ABI910_6POST	4534667	4534704		YPO_RS21210	37
ABI910_6POST	4534735	4534743		YPO_RS21210	8
ABI910_6POST	4534885	4534904		YPO_RS21210	19
ABI910_6POST	4535139	4535143		YPO_RS21215	4
ABI910_6POST	4536003	4536007		YPO_RS21220	4
ABI910_6POST	4536401	4536412		YPO_RS21220	11
ABI910_6POST	4538444	4538450		YPO_RS21225	6
ABI910_6POST	4538487	4538489		YPO_RS21225	2
ABI910_6POST	4538585	4538586		YPO_RS21225	1
ABI910_6POST	4538951	4538969		YPO_RS21230	18
ABI910_6POST	4539345	4539360		YPO_RS21230	15
ABI910_6POST	4539470	4539477		YPO_RS21230	7
ABI910_6POST	4539813	4539821		YPO_RS21235	8
ABI910_6POST	4539972	4539976		YPO_RS21235	4
ABI910_6POST	4540382	4540384		YPO_RS21235	2
ABI910_6POST	4540458	4540472		YPO_RS21235	14
ABI910_6POST	4541005	4541008		YPO_RS21240	3
ABI910_6POST	4541051	4541073		YPO_RS21240	22
ABI910_6POST	4541602	4541603		YPO_RS21245	1
ABI910_6POST	4541656	4541658		YPO_RS21245	2
ABI910_6POST	4542375	4542408		YPO_RS21255	33
ABI910_6POST	4544926	4544932		YPO_RS21275	6
ABI910_6POST	4545273	4545276		YPO_RS21280	3
ABI910_6POST	4545356	4545361		YPO_RS21280	5
ABI910_6POST	4545881	4545887		YPO_RS21280	6
ABI910_6POST	4546150	4546171		YPO_RS21280	21
ABI910_6POST	4547171	4547176		YPO_RS21285	5
ABI910_6POST	4547219	4547229		YPO_RS21285	10
ABI910_6POST	4547697	4547706		YPO_RS21285	9
ABI910_6POST	4547968	4548017		YPO_RS21290	49
ABI910_6POST	4548525	4548529		YPO_RS21295	4
ABI910_6POST	4549557	4549563		YPO_RS21300	6
ABI910_6POST	4549920	4549940		YPO_RS21300	20
ABI910_6POST	4550016	4550020		YPO_RS21300	4
ABI910_6POST	4550293	4550300		YPO_RS21300	7
ABI910_6POST	4550360	4550389		YPO_RS21300	29
ABI910_6POST	4550447	4550450		YPO_RS21300	3
ABI910_6POST	4551229	4551265		YPO_RS21305	36
ABI910_6POST	4551681	4551694		YPO_RS21305	13
ABI910_6POST	4551767	4551789		YPO_RS21305	22
ABI910_6POST	4552016	4552025		YPO_RS21305	9
ABI910_6POST	4552425	4552434		xylF	9
ABI910_6POST	4553127	4553144		xylF	17
ABI910_6POST	4554292	4554299		xylA	7
ABI910_6POST	4554396	4554399		xylA	3
ABI910_6POST	4555611	4555616		xylB	5
ABI910_6POST	4556293	4556331		xylB	38
ABI910_6POST	4557471	4557480		YPO_RS21325	9
ABI910_6POST	4558116	4558143		YPO_RS21330	27
ABI910_6POST	4558313	4558368		YPO_RS21330	55
ABI910_6POST	4561591	4561603		YPO_RS21340	12
ABI910_6POST	4562800	4562826		YPO_RS21345	26
ABI910_6POST	4563357	4563359		YPO_RS21345	2
ABI910_6POST	4563650	4563673		YPO_RS21345	23
ABI910_6POST	4564202	4564238		YPO_RS21355	36
ABI910_6POST	4564440	4564453		YPO_RS21355	13
ABI910_6POST	4564611	4564637		YPO_RS21355	26
ABI910_6POST	4564920	4564928		YPO_RS21355	8
ABI910_6POST	4564960	4564994		YPO_RS21355	34
ABI910_6POST	4565322	4565329		YPO_RS21355	7
ABI910_6POST	4566077	4566111		YPO_RS21360	34
ABI910_6POST	4566169	4566173		YPO_RS21360	4
ABI910_6POST	4567038	4567048		YPO_RS21360	10
ABI910_6POST	4567083	4567095		YPO_RS21360	12
ABI910_6POST	4567990	4567993		YPO_RS21375	3
ABI910_6POST	4570111	4570140		selB	29
ABI910_6POST	4570180	4570188		selB	8
ABI910_6POST	4570456	4570465		selB	9
ABI910_6POST	4570636	4570654		selB	18
ABI910_6POST	4570822	4570825		selB	3
ABI910_6POST	4570928	4570938		selB	10
ABI910_6POST	4571283	4571302		YPO_RS21395	19
ABI910_6POST	4571364	4571367		YPO_RS21395	3
ABI910_6POST	4571643	4571644		YPO_RS21400	1
ABI910_6POST	4572782	4572786		YPO_RS21400	4
ABI910_6POST	4573393	4573447		fdhE	54
ABI910_6POST	4573624	4573626		fdhE	2
ABI910_6POST	4573730	4573743		fdhE	13
ABI910_6POST	4574069	4574074		fdoI	5
ABI910_6POST	4574106	4574136		fdoI	30
ABI910_6POST	4574309	4574318		fdoI	9
ABI910_6POST	4574740	4574759		fdxH	19
ABI910_6POST	4574813	4574832		fdxH	19
ABI910_6POST	4574976	4575001		fdxH	25
ABI910_6POST	4575239	4575250		fdxH	11
ABI910_6POST	4575441	4575442		fdxH	1
ABI910_6POST	4576501	4576510		fdnG	9
ABI910_6POST	4577248	4577262		fdnG	14
ABI910_6POST	4577397	4577420		fdnG	23
ABI910_6POST	4579043	4579057		fdhD	14
ABI910_6POST	4580274	4580284		sodA	10
ABI910_6POST	4580672	4580686		sodA	14
ABI910_6POST	4581479	4581482		YPO_RS21435	3
ABI910_6POST	4581806	4581808		YPO_RS21435	2
ABI910_6POST	4581874	4581895		YPO_RS21435	21
ABI910_6POST	4582427	4582444		YPO_RS21435	17
ABI910_6POST	4585685	4585706		YPO_RS21455	21
ABI910_6POST	4586939	4586945		YPO_RS21460	6
ABI910_6POST	4586983	4587001		YPO_RS21460	18
ABI910_6POST	4588085	4588089		YPO_RS21465	4
ABI910_6POST	4588202	4588222		YPO_RS21465	20
ABI910_6POST	4588866	4588894		YPO_RS21465	28
ABI910_6POST	4589053	4589060		YPO_RS21465	7
ABI910_6POST	4589107	4589124		YPO_RS21465	17
ABI910_6POST	4590961	4590965		YPO_RS21475	4
ABI910_6POST	4591658	4591659		glyS	1
ABI910_6POST	4592048	4592062		glyS	14
ABI910_6POST	4592436	4592463		glyS	27
ABI910_6POST	4593666	4593673		glyQ	7
ABI910_6POST	4593755	4593761		glyQ	6
ABI910_6POST	4594179	4594181		glyQ	2
ABI910_6POST	4594610	4594613		YPO_RS21490	3
ABI910_6POST	4594932	4594939		YPO_RS21490	7
ABI910_6POST	4595175	4595185		YPO_RS21495	10
ABI910_6POST	4595412	4595423		YPO_RS21495	11
ABI910_6POST	4596051	4596056		YPO_RS21500	5
ABI910_6POST	4596369	4596372		YPO_RS21500	3
ABI910_6POST	4596484	4596489		YPO_RS21500	5
ABI910_6POST	4596975	4596976		YPO_RS21505	1
ABI910_6POST	4597338	4597343		YPO_RS21505	5
ABI910_6POST	4597993	4598003		ghrB	10
ABI910_6POST	4598410	4598423		ghrB	13
ABI910_6POST	4598706	4598714		ghrB	8
ABI910_6POST	4599438	4599482		YPO_RS21515	44
ABI910_6POST	4599638	4599672		YPO_RS21515	34
ABI910_6POST	4600072	4600074		YPO_RS21515	2
ABI910_6POST	4600281	4600283		YPO_RS21515	2
ABI910_6POST	4600433	4600442		YPO_RS21515	9
ABI910_6POST	4600646	4600667		YPO_RS21515	21
ABI910_6POST	4600771	4600773		YPO_RS21515	2
ABI910_6POST	4600993	4600994		YPO_RS21515	1
ABI910_6POST	4601687	4601716		YPO_RS21520	29
ABI910_6POST	4602679	4602691		YPO_RS21525	12
ABI910_6POST	4602918	4602920		YPO_RS21525	2
ABI910_6POST	4603578	4603595		YPO_RS21525	17
ABI910_6POST	4604140	4604142		YPO_RS21530	2
ABI910_6POST	4604312	4604351		YPO_RS21530	39
ABI910_6POST	4604421	4604443		YPO_RS21530	22
ABI910_6POST	4605182	4605190		YPO_RS21530	8
ABI910_6POST	4605331	4605338		YPO_RS21530	7
ABI910_6POST	4608895	4608896		YPO_RS21555	1
ABI910_6POST	4609313	4609318		YPO_RS21555	5
ABI910_6POST	4609492	4609501		YPO_RS21555	9
ABI910_6POST	4609572	4609573		YPO_RS21555	1
ABI910_6POST	4609755	4609765		YPO_RS21560	10
ABI910_6POST	4610555	4610565		YPO_RS21560	10
ABI910_6POST	4610871	4610900		YPO_RS21565	29
ABI910_6POST	4611090	4611104		YPO_RS21565	14
ABI910_6POST	4611367	4611372		YPO_RS21565	5
ABI910_6POST	4611573	4611595		YPO_RS21565	22
ABI910_6POST	4611634	4611660		YPO_RS21565	26
ABI910_6POST	4611696	4611699		YPO_RS21565	3
ABI910_6POST	4612643	4612651		yidA	8
ABI910_6POST	4613318	4613326		yidA	8
ABI910_6POST	4614230	4614243		gyrB	13
ABI910_6POST	4615076	4615077		gyrB	1
ABI910_6POST	4615119	4615128		gyrB	9
ABI910_6POST	4615201	4615232		gyrB	31
ABI910_6POST	4615680	4615685		gyrB	5
ABI910_6POST	4615921	4615932		gyrB	11
ABI910_6POST	4616025	4616029		recF	4
ABI910_6POST	4617258	4617259		dnaN	1
ABI910_6POST	4618132	4618139		dnaN	7
ABI910_6POST	4618295	4618323		dnaN	28
ABI910_6POST	4619271	4619279		dnaA	8
ABI910_6POST	4619418	4619425		dnaA	7
ABI910_6POST	4619652	4619662		dnaA	10
ABI910_6POST	4620493	4620500		rpmH	7
ABI910_6POST	4620962	4620982		yidD	20
ABI910_6POST	4621401	4621417		yidC	16
ABI910_6POST	4622093	4622098		yidC	5
ABI910_6POST	4622543	4622555		yidC	12
ABI910_6POST	4622587	4622606		yidC	19
ABI910_6POST	4622654	4622665		yidC	11
ABI910_6POST	4622721	4622734		yidC	13
ABI910_6POST	4623332	4623341		mnmE	9
ABI910_6POST	4623741	4623757		mnmE	16
ABI910_6POST	4624323	4624328		mnmE	5
ABI910_6POST	4624907	4624923		YPO_RS21620	16
ABI910_6POST	4625083	4625100		YPO_RS21620	17
ABI910_6POST	4625445	4625453		YPO_RS21620	8
ABI910_6POST	4626325	4626343		YPO_RS21630	18
ABI910_6POST	4626374	4626383		YPO_RS21630	9
ABI910_6POST	4626533	4626535		YPO_RS21635	2
ABI910_6POST	4626613	4626621		YPO_RS21635	8
ABI910_6POST	4626830	4626834		YPO_RS21635	4
ABI910_6POST	4627724	4627737		YPO_RS21640	13
ABI910_6POST	4628097	4628116		YPO_RS21640	19
ABI910_6POST	4628465	4628502		YPO_RS21640	37
ABI910_6POST	4628577	4628590		YPO_RS21640	13
ABI910_6POST	4630676	4630701		YPO_RS21655	25
ABI910_6POST	4630844	4630873		YPO_RS21655	29
ABI910_6POST	4631414	4631428		YPO_RS21660	14
ABI910_6POST	4631534	4631545		YPO_RS21660	11
ABI910_6POST	4632524	4632525		YPO_RS21665	1
ABI910_6POST	4632680	4632681		YPO_RS21665	1
ABI910_6POST	4633361	4633371		YPO_RS21670	10
ABI910_6POST	4633563	4633583		YPO_RS21670	20
ABI910_6POST	4633971	4633987		phoU	16
ABI910_6POST	4634232	4634260		phoU	28
ABI910_6POST	4634383	4634391		phoU	8
ABI910_6POST	4634566	4634572		phoU	6
ABI910_6POST	4634926	4634937		pstB	11
ABI910_6POST	4635503	4635504		pstB	1
ABI910_6POST	4635656	4635657		pstA	1
ABI910_6POST	4635749	4635756		pstA	7
ABI910_6POST	4636229	4636235		pstA	6
ABI910_6POST	4636754	4636764		pstC	10
ABI910_6POST	4637057	4637059		pstC	2
ABI910_6POST	4636668	4636699		pstC	31
ABI910_6POST	4638116	4638132		pstS	16
ABI910_6POST	4638594	4638597		pstS	3
ABI910_6POST	4639266	4639286		glmS	20
ABI910_6POST	4639487	4639503		glmS	16
ABI910_6POST	4639767	4639784		glmS	17
ABI910_6POST	4640492	4640497		glmS	5
ABI910_6POST	4640550	4640555		glmS	5
ABI910_6POST	4640770	4640803		glmS	33
ABI910_6POST	4640874	4640885		glmS	11
ABI910_6POST	4641373	4641382		glmU	9
ABI910_6POST	4641422	4641436		glmU	14
ABI910_6POST	4641760	4641761		glmU	1
ABI910_6POST	4642350	4642369		glmU	19
ABI910_6POST	4642435	4642444		glmU	9
ABI910_6POST	4642481	4642537		glmU	56
ABI910_6POST	4643713	4643722		atpD	9
ABI910_6POST	4643921	4643944		atpD	23
ABI910_6POST	4644032	4644037		atpD	5
ABI910_6POST	4644467	4644490		atpD	23
ABI910_6POST	4644580	4644584		atpD	4
ABI910_6POST	4644616	4644618		atpD	2
ABI910_6POST	4645425	4645427		atpG	2
ABI910_6POST	4645564	4645583		atpG	19
ABI910_6POST	4645625	4645633		atpG	8
ABI910_6POST	4646528	4646540		atpA	12
ABI910_6POST	4646720	4646742		atpA	22
ABI910_6POST	4646984	4647003		atpA	19
ABI910_6POST	4647139	4647146		atpA	7
ABI910_6POST	4647259	4647265		atpA	6
ABI910_6POST	4647499	4647524		atpA	25
ABI910_6POST	4647927	4647941		atpH	14
ABI910_6POST	4648778	4648787		atpE	9
ABI910_6POST	4648967	4648976		atpE	9
ABI910_6POST	4649111	4649112		atpB	1
ABI910_6POST	4649446	4649460		atpB	14
ABI910_6POST	4649770	4649785		atpB	15
ABI910_6POST	4649816	4649850		atpB	34
ABI910_6POST	4650147	4650171		atpI	24
ABI910_6POST	4651342	4651347		rsmG	5
ABI910_6POST	4651492	4651496		rsmG	4
ABI910_6POST	4652322	4652326		mnmG	4
ABI910_6POST	4653361	4653389		mnmG	28
ABI933_1343UNTA85	6027	6034		kup	7
ABI933_1343UNTA85	12515	12520		YPO_RS01070	5
ABI933_1343UNTA85	14916	14932		YPO_RS01080	16
ABI933_1343UNTA85	24904	24909		polA	5
ABI933_1343UNTA85	36205	36220		typA	15
ABI933_1343UNTA85	44834	44835		YPO_RS01200	1
ABI933_1343UNTA85	106580	106593		YPO_RS01520	13
ABI933_1343UNTA85	106699	106723		YPO_RS01520	24
ABI933_1343UNTA85	106764	106766		YPO_RS01520	2
ABI933_1343UNTA85	111207	111208		YPO_RS01540	1
ABI933_1343UNTA85	128373	128378		YPO_RS01610	5
ABI933_1343UNTA85	171565	171569		trpS	4
ABI933_1343UNTA85	176709	176723		YPO_RS01815	14
ABI933_1343UNTA85	177992	177993		YPO_RS01820	1
ABI933_1343UNTA85	187386	187387		YPO_RS01850	1
ABI933_1343UNTA85	195720	195721		crp	1
ABI933_1343UNTA85	196809	196815		YPO_RS01895	6
ABI933_1343UNTA85	202078	202094		tauB	16
ABI933_1343UNTA85	215766	215768		rpsG	2
ABI933_1343UNTA85	228411	228420		rpsH	9
ABI933_1343UNTA85	235877	235882		zntR	5
ABI933_1343UNTA85	243395	243397		YPO_RS02225	2
ABI933_1343UNTA85	245955	245966		YPO_RS02245	11
ABI933_1343UNTA85	246467	246477		YPO_RS02245	10
ABI933_1343UNTA85	247200	247217		YPO_RS02250	17
ABI933_1343UNTA85	307601	307602		YPO_RS02550	1
ABI933_1343UNTA85	319950	319963		plsB	13
ABI933_1343UNTA85	325641	325644		YPO_RS02605	3
ABI933_1343UNTA85	329825	329837		YPO_RS02620	12
ABI933_1343UNTA85	383903	383906		amiB	3
ABI933_1343UNTA85	401048	401049		YPO_RS02925	1
ABI933_1343UNTA85	401282	401293		YPO_RS02930	11
ABI933_1343UNTA85	409208	409212		YPO_RS02960	4
ABI933_1343UNTA85	423955	423959		ptsP	4
ABI933_1343UNTA85	426563	426571		lsrB	8
ABI933_1343UNTA85	453967	453971		YPO_RS03165	4
ABI933_1343UNTA85	460099	460101		deoB	2
ABI933_1343UNTA85	508677	508678		ispH	1
ABI933_1343UNTA85	524666	524668		pdxA	2
ABI933_1343UNTA85	536451	536452		YPO_RS03515	1
ABI933_1343UNTA85	546716	546728		YPO_RS03550	12
ABI933_1343UNTA85	548813	548823		YPO_RS03560	10
ABI933_1343UNTA85	553948	553957		tssM	9
ABI933_1343UNTA85	554067	554068		tssM	1
ABI933_1343UNTA85	558602	558608		rapA	6
ABI933_1343UNTA85	571842	571847		YPO_RS03635	5
ABI933_1343UNTA85	572147	572151		YPO_RS03640	4
ABI933_1343UNTA85	572331	572345		YPO_RS03640	14
ABI933_1343UNTA85	605607	605611		ftsA	4
ABI933_1343UNTA85	610070	610074		secA	4
ABI933_1343UNTA85	613924	613931		YPO_RS03825	7
ABI933_1343UNTA85	631291	631295		YPO_RS03915	4
ABI933_1343UNTA85	635094	635096		yapG	2
ABI933_1343UNTA85	642140	642143		YPO_RS03950	3
ABI933_1343UNTA85	656396	656397		cdiA	1
ABI933_1343UNTA85	668456	668461		YPO_RS04040	5
ABI933_1343UNTA85	694402	694404		YPO_RS04160	2
ABI933_1343UNTA85	694494	694499		YPO_RS04160	5
ABI933_1343UNTA85	695204	695212		YPO_RS04165	8
ABI933_1343UNTA85	702629	702634		dnaG	5
ABI933_1343UNTA85	704722	704726		tsaD	4
ABI933_1343UNTA85	708138	708145		YPO_RS04230	7
ABI933_1343UNTA85	712555	712558		glnE	3
ABI933_1343UNTA85	713303	713321		glnE	18
ABI933_1343UNTA85	732964	732969		parC	5
ABI933_1343UNTA85	738368	738373		dkgA	5
ABI933_1343UNTA85	740154	740165		yqhD	11
ABI933_1343UNTA85	779661	779663		fliI	2
ABI933_1343UNTA85	785295	785297		YPO_RS04600	2
ABI933_1343UNTA85	796061	796062		YPO_RS04660	1
ABI933_1343UNTA85	802571	802604		YPO_RS04690	33
ABI933_1343UNTA85	809962	809967		YPO_RS04740	5
ABI933_1343UNTA85	816715	816729		YPO_RS04765	14
ABI933_1343UNTA85	836456	836460		YPO_RS04805	4
ABI933_1343UNTA85	845550	845554		YPO_RS04835	4
ABI933_1343UNTA85	850357	850358		YPO_RS04845	1
ABI933_1343UNTA85	854912	854914		YPO_RS04845	2
ABI933_1343UNTA85	856074	856082		YPO_RS04845	8
ABI933_1343UNTA85	858880	858881		YPO_RS04860	1
ABI933_1343UNTA85	861838	861842		ptsP	4
ABI933_1343UNTA85	882753	882762		YPO_RS04955	9
ABI933_1343UNTA85	883905	883909		YPO_RS04960	4
ABI933_1343UNTA85	883996	883998		YPO_RS04960	2
ABI933_1343UNTA85	884749	884751		YPO_RS04965	2
ABI933_1343UNTA85	913749	913750		YPO_RS05095	1
ABI933_1343UNTA85	917574	917583		nagA	9
ABI933_1343UNTA85	924743	924747		YPO_RS05145	4
ABI933_1343UNTA85	938430	938435		YPO_RS05195	5
ABI933_1343UNTA85	953152	953157		YPO_RS05255	5
ABI933_1343UNTA85	954289	954304		YPO_RS05260	15
ABI933_1343UNTA85	961516	961524		YPO_RS05295	8
ABI933_1343UNTA85	976812	976821		dsbC	9
ABI933_1343UNTA85	1032328	1032335		YPO_RS05640	7
ABI933_1343UNTA85	1048583	1048584		glsB	1
ABI933_1343UNTA85	1076166	1076174		YPO_RS05800	8
ABI933_1343UNTA85	1076208	1076209		YPO_RS05800	1
ABI933_1343UNTA85	1108410	1108440		YPO_RS05915	30
ABI933_1343UNTA85	1124072	1124105		yapH	33
ABI933_1343UNTA85	1124164	1124227		yapH	63
ABI933_1343UNTA85	1124266	1124284		yapH	18
ABI933_1343UNTA85	1124366	1124413		yapH	47
ABI933_1343UNTA85	1124475	1124498		yapH	23
ABI933_1343UNTA85	1124534	1124542		yapH	8
ABI933_1343UNTA85	1124606	1124621		yapH	15
ABI933_1343UNTA85	1124692	1124887		yapH	195
ABI933_1343UNTA85	1124923	1124935		yapH	12
ABI933_1343UNTA85	1124994	1125011		yapH	17
ABI933_1343UNTA85	1125093	1125403		yapH	310
ABI933_1343UNTA85	1125444	1125483		yapH	39
ABI933_1343UNTA85	1125531	1125603		yapH	72
ABI933_1343UNTA85	1125659	1125679		yapH	20
ABI933_1343UNTA85	1137594	1137603		YPO_RS05975	9
ABI933_1343UNTA85	1141197	1141202		YPO_RS05985	5
ABI933_1343UNTA85	1146734	1146738		YPO_RS05995	4
ABI933_1343UNTA85	1201500	1201504		dnaE	4
ABI933_1343UNTA85	1202234	1202248		dnaE	14
ABI933_1343UNTA85	1220120	1220127		YPO_RS06340	7
ABI933_1343UNTA85	1221219	1221225		YPO_RS06340	6
ABI933_1343UNTA85	1221595	1221602		YPO_RS06340	7
ABI933_1343UNTA85	1233444	1233490		YPO_RS06415	46
ABI933_1343UNTA85	1244034	1244037		YPO_RS06475	3
ABI933_1343UNTA85	1245809	1245822		ssrA	13
ABI933_1343UNTA85	1252287	1252288		YPO_RS06525	1
ABI933_1343UNTA85	1256075	1256076		YPO_RS06545	1
ABI933_1343UNTA85	1280004	1280027		YPO_RS06670	23
ABI933_1343UNTA85	1311911	1311913		betA	2
ABI933_1343UNTA85	1323564	1323570		dusC	6
ABI933_1343UNTA85	1334969	1334973		YPO_RS06940	4
ABI933_1343UNTA85	1338770	1338771		urtC	1
ABI933_1343UNTA85	1356225	1356227		ompF2	2
ABI933_1343UNTA85	1357198	1357202		dinG	4
ABI933_1343UNTA85	1399816	1399818		YPO_RS07205	2
ABI933_1343UNTA85	1400449	1400456		YPO_RS07210	7
ABI933_1343UNTA85	1429558	1429559		YPO_RS07360	1
ABI933_1343UNTA85	1439352	1439353		YPO_RS07395	1
ABI933_1343UNTA85	1444327	1444338		mtr	11
ABI933_1343UNTA85	1454359	1454368		YPO_RS07455	9
ABI933_1343UNTA85	1460515	1460528		fruA	13
ABI933_1343UNTA85	1470107	1470123		YPO_RS07520	16
ABI933_1343UNTA85	1497818	1497825		potG	7
ABI933_1343UNTA85	1503516	1503545		YPO_RS07665	29
ABI933_1343UNTA85	1504442	1504454		YPO_RS07670	12
ABI933_1343UNTA85	1510204	1510205		YPO_RS07710	1
ABI933_1343UNTA85	1518431	1518434		YPO_RS07765	3
ABI933_1343UNTA85	1566092	1566093		YPO_RS07925	1
ABI933_1343UNTA85	1578920	1578935		lpxK	15
ABI933_1343UNTA85	1582070	1582075		YPO_RS07980	5
ABI933_1343UNTA85	1624979	1624980		YPO_RS08150	1
ABI933_1343UNTA85	1644609	1644614		YPO_RS08245	5
ABI933_1343UNTA85	1651491	1651505		YPO_RS08280	14
ABI933_1343UNTA85	1658263	1658266		tssC	3
ABI933_1343UNTA85	1658412	1658415		tssC	3
ABI933_1343UNTA85	1666067	1666070		YPO_RS08345	3
ABI933_1343UNTA85	1666142	1666154		YPO_RS08345	12
ABI933_1343UNTA85	1668225	1668238		YPO_RS08350	13
ABI933_1343UNTA85	1677549	1677557		YPO_RS08380	8
ABI933_1343UNTA85	1679748	1679750		YPO_RS08385	2
ABI933_1343UNTA85	1726823	1726829		YPO_RS08575	6
ABI933_1343UNTA85	1727098	1727105		YPO_RS08575	7
ABI933_1343UNTA85	1727749	1727751		YPO_RS08580	2
ABI933_1343UNTA85	1746848	1746855		YPO_RS08655	7
ABI933_1343UNTA85	1749058	1749060		YPO_RS08665	2
ABI933_1343UNTA85	1760737	1760757		hisB	20
ABI933_1343UNTA85	1778253	1778254		YPO_RS08795	1
ABI933_1343UNTA85	1808288	1808317		bssS	29
ABI933_1343UNTA85	1811445	1811451		YPO_RS08940	6
ABI933_1343UNTA85	1812070	1812079		YPO_RS08940	9
ABI933_1343UNTA85	1822673	1822677		fabD	4
ABI933_1343UNTA85	1848232	1848235		mfd	3
ABI933_1343UNTA85	1888083	1888084		YPO_RS09280	1
ABI933_1343UNTA85	1899968	1899977		YPO_RS09320	9
ABI933_1343UNTA85	1900962	1900965		YPO_RS09330	3
ABI933_1343UNTA85	1904870	1904874		yapJ	4
ABI933_1343UNTA85	1905600	1905608		yapJ	8
ABI933_1343UNTA85	1914890	1914900		cheR	10
ABI933_1343UNTA85	1914995	1915012		cheR	17
ABI933_1343UNTA85	1929116	1929133		YPO_RS09430	17
ABI933_1343UNTA85	1929812	1929815		YPO_RS09435	3
ABI933_1343UNTA85	1957022	1957023		YPO_RS09540	1
ABI933_1343UNTA85	1963048	1963049		YPO_RS09565	1
ABI933_1343UNTA85	1973314	1973320		YPO_RS09610	6
ABI933_1343UNTA85	1975097	1975104		YPO_RS09620	7
ABI933_1343UNTA85	1975442	1975455		YPO_RS09620	13
ABI933_1343UNTA85	1975485	1975493		YPO_RS09620	8
ABI933_1343UNTA85	1993549	1993552		YPO_RS09735	3
ABI933_1343UNTA85	1993950	1993955		YPO_RS09740	5
ABI933_1343UNTA85	1994267	1994277		YPO_RS09740	10
ABI933_1343UNTA85	1999853	1999874		mntP	21
ABI933_1343UNTA85	2008775	2008779		YPO_RS09800	4
ABI933_1343UNTA85	2010797	2010801		YPO_RS09810	4
ABI933_1343UNTA85	2034958	2034959		flhB	1
ABI933_1343UNTA85	2036822	2036828		flhA	6
ABI933_1343UNTA85	2046491	2046492		YPO_RS09990	1
ABI933_1343UNTA85	2059996	2060024		YPO_RS10045	28
ABI933_1343UNTA85	2064256	2064262		YPO_RS10060	6
ABI933_1343UNTA85	2081672	2081680		YPO_RS10170	8
ABI933_1343UNTA85	2086281	2086285		fliD	4
ABI933_1343UNTA85	2119946	2119951		YPO_RS10365	5
ABI933_1343UNTA85	2128692	2128695		YPO_RS10430	3
ABI933_1343UNTA85	2136516	2136518		YPO_RS10475	2
ABI933_1343UNTA85	2137168	2137173		YPO_RS10480	5
ABI933_1343UNTA85	2160486	2160487		irp2	1
ABI933_1343UNTA85	2163659	2163660		ybtP	1
ABI933_1343UNTA85	2166394	2166399		ybtQ	5
ABI933_1343UNTA85	2176670	2176676		YPO_RS10595	6
ABI933_1343UNTA85	2177160	2177174		YPO_RS10600	14
ABI933_1343UNTA85	2178346	2178355		YPO_RS10605	9
ABI933_1343UNTA85	2186185	2186191		YPO_RS10630	6
ABI933_1343UNTA85	2189614	2189615		YPO_RS10650	1
ABI933_1343UNTA85	2205838	2205840		YPO_RS10710	2
ABI933_1343UNTA85	2206337	2206338		YPO_RS10710	1
ABI933_1343UNTA85	2216963	2216965		pgaB	2
ABI933_1343UNTA85	2226679	2226681		YPO_RS10800	2
ABI933_1343UNTA85	2237045	2237057		YPO_RS10835	12
ABI933_1343UNTA85	2237354	2237383		YPO_RS10835	29
ABI933_1343UNTA85	2269923	2269931		YPO_RS10980	8
ABI933_1343UNTA85	2295226	2295228		YPO_RS11115	2
ABI933_1343UNTA85	2296030	2296034		YPO_RS11120	4
ABI933_1343UNTA85	2296456	2296473		YPO_RS11120	17
ABI933_1343UNTA85	2305972	2305976		YPO_RS11175	4
ABI933_1343UNTA85	2317393	2317400		YPO_RS11220	7
ABI933_1343UNTA85	2324265	2324272		argS	7
ABI933_1343UNTA85	2334524	2334525		YPO_RS11275	1
ABI933_1343UNTA85	2339330	2339331		znuA	1
ABI933_1343UNTA85	2340895	2340896		mepM	1
ABI933_1343UNTA85	2342231	2342232		lpxM	1
ABI933_1343UNTA85	2348071	2348073		YPO_RS11335	2
ABI933_1343UNTA85	2355602	2355605		fadD	3
ABI933_1343UNTA85	2365035	2365037		YPO_RS11425	2
ABI933_1343UNTA85	2365832	2365846		YPO_RS11430	14
ABI933_1343UNTA85	2383965	2383969		YPO_RS11565	4
ABI933_1343UNTA85	2393686	2393689		YPO_RS11620	3
ABI933_1343UNTA85	2399843	2399871		YPO_RS11660	28
ABI933_1343UNTA85	2427162	2427172		gapA	10
ABI933_1343UNTA85	2442366	2442374		purU	8
ABI933_1343UNTA85	2451388	2451411		YPO_RS11890	23
ABI933_1343UNTA85	2459451	2459457		oppB	6
ABI933_1343UNTA85	2471254	2471261		YPO_RS11975	7
ABI933_1343UNTA85	2478594	2478621		trpB	27
ABI933_1343UNTA85	2488681	2488686		YPO_RS12075	5
ABI933_1343UNTA85	2495997	2496003		YPO_RS12105	6
ABI933_1343UNTA85	2521939	2521945		rsxC	6
ABI933_1343UNTA85	2549511	2549512		YPO_RS12330	1
ABI933_1343UNTA85	2552984	2552988		clcB	4
ABI933_1343UNTA85	2554373	2554633		YPO_RS12355	260
ABI933_1343UNTA85	2554658	2555065		YPO_RS12360	407
ABI933_1343UNTA85	2555162	2555608		YPO_RS12365	446
ABI933_1343UNTA85	2555780	2556832		YPO_RS12370	1052
ABI933_1343UNTA85	2556844	2557161		YPO_RS12375	317
ABI933_1343UNTA85	2557164	2557415		YPO_RS12380	251
ABI933_1343UNTA85	2557451	2557684		YPO_RS12385	233
ABI933_1343UNTA85	2557749	2559461		YPO_RS12390	1712
ABI933_1343UNTA85	2559474	2559761		YPO_RS12395	287
ABI933_1343UNTA85	2559765	2560790		YPO_RS12400	1025
ABI933_1343UNTA85	2560790	2562034		YPO_RS12405	1244
ABI933_1343UNTA85	2562123	2562371		YPO_RS12410	248
ABI933_1343UNTA85	2562568	2562765		YPO_RS12415	197
ABI933_1343UNTA85	2589612	2589613		pntB	1
ABI933_1343UNTA85	2609105	2609110		hrpA	5
ABI933_1343UNTA85	2643816	2643820		pspC	4
ABI933_1343UNTA85	2659174	2659215		YPO_RS12820	41
ABI933_1343UNTA85	2668781	2668787		YPO_RS12865	6
ABI933_1343UNTA85	2675943	2675945		YPO_RS12890	2
ABI933_1343UNTA85	2692844	2692855		YPO_RS12990	11
ABI933_1343UNTA85	2693486	2693507		YPO_RS12990	21
ABI933_1343UNTA85	2694073	2694076		YPO_RS12995	3
ABI933_1343UNTA85	2694262	2694266		YPO_RS12995	4
ABI933_1343UNTA85	2694623	2694629		YPO_RS13000	6
ABI933_1343UNTA85	2745683	2745691		YPO_RS13245	8
ABI933_1343UNTA85	2753040	2753046		YPO_RS13280	6
ABI933_1343UNTA85	2787822	2787827		YPO_RS13430	5
ABI933_1343UNTA85	2794471	2794496		cdiA	25
ABI933_1343UNTA85	2796117	2796134		cdiA	17
ABI933_1343UNTA85	2803579	2803596		YPO_RS13470	17
ABI933_1343UNTA85	2811249	2811265		YPO_RS13500	16
ABI933_1343UNTA85	2818056	2818059		rhtA	3
ABI933_1343UNTA85	2826345	2826354		YPO_RS13575	9
ABI933_1343UNTA85	2827382	2827383		YPO_RS13580	1
ABI933_1343UNTA85	2859704	2859705		nuoL	1
ABI933_1343UNTA85	2865921	2865923		nuoF	2
ABI933_1343UNTA85	2879190	2879192		YPO_RS13790	2
ABI933_1343UNTA85	2885777	2885788		YPO_RS13815	11
ABI933_1343UNTA85	2886712	2886714		YPO_RS13820	2
ABI933_1343UNTA85	2887086	2887932		YPO_RS13825	846
ABI933_1343UNTA85	2887989	2893967		YPO_RS13830	5978
ABI933_1343UNTA85	2894374	2894922		YPO_RS13835	548
ABI933_1343UNTA85	2895617	2896471		YPO_RS13840	854
ABI933_1343UNTA85	2896777	2897245		YPO_RS13845	468
ABI933_1343UNTA85	2897288	2898096		YPO_RS13845	808
ABI933_1343UNTA85	2898132	2898303		YPO_RS13845	171
ABI933_1343UNTA85	2898338	2900263		iolD	1925
ABI933_1343UNTA85	2914075	2914076		YPO_RS13920	1
ABI933_1343UNTA85	2925693	2925695		mrdA	2
ABI933_1343UNTA85	2954496	2954508		YPO_RS14120	12
ABI933_1343UNTA85	2969520	2969531		YPO_RS14185	11
ABI933_1343UNTA85	2970004	2970039		YPO_RS14190	35
ABI933_1343UNTA85	2970468	2970470		YPO_RS14190	2
ABI933_1343UNTA85	2976482	2976483		nrdF	1
ABI933_1343UNTA85	2979453	2979455		nrdI	2
ABI933_1343UNTA85	2983502	2983511		YPO_RS14250	9
ABI933_1343UNTA85	2997962	2997965		yut	3
ABI933_1343UNTA85	3011156	3011168		pgm	12
ABI933_1343UNTA85	3012183	3012232		YPO_RS14405	49
ABI933_1343UNTA85	3043471	3043480		lepA	9
ABI933_1343UNTA85	3049721	3049734		YPO_RS14590	13
ABI933_1343UNTA85	3052538	3052544		tssM	6
ABI933_1343UNTA85	3060019	3060022		YPO_RS14625	3
ABI933_1343UNTA85	3070681	3070683		YPO_RS14690	2
ABI933_1343UNTA85	3073295	3073297		ccmI	2
ABI933_1343UNTA85	3080197	3080202		fadJ	5
ABI933_1343UNTA85	3109193	3109203		hisJ	10
ABI933_1343UNTA85	3112604	3112614		YPO_RS14885	10
ABI933_1343UNTA85	3114644	3114649		yfcE	5
ABI933_1343UNTA85	3120316	3120561		YPO_RS14920	245
ABI933_1343UNTA85	3121234	3121815		YPO_RS14925	581
ABI933_1343UNTA85	3122083	3122484		YPO_RS14930	401
ABI933_1343UNTA85	3122717	3123118		YPO_RS14935	401
ABI933_1343UNTA85	3123130	3123702		YPO_RS14940	572
ABI933_1343UNTA85	3123726	3123977		YPO_RS14945	251
ABI933_1343UNTA85	3124016	3124255		YPO_RS14950	239
ABI933_1343UNTA85	3125064	3126980		yapC	1916
ABI933_1343UNTA85	3127149	3127226		YPO_RS14960	77
ABI933_1343UNTA85	3127515	3128096		YPO_RS14965	581
ABI933_1343UNTA85	3129396	3129403		YPO_RS14975	7
ABI933_1343UNTA85	3130158	3132365		YPO_RS14980	2207
ABI933_1343UNTA85	3132358	3132888		YPO_RS14985	530
ABI933_1343UNTA85	3133047	3135428		YPO_RS14990	2381
ABI933_1343UNTA85	3135507	3137135		YPO_RS14995	1628
ABI933_1343UNTA85	3137608	3138459		YPO_RS15000	851
ABI933_1343UNTA85	3138485	3139474		YPO_RS15005	989
ABI933_1343UNTA85	3139529	3140422		YPO_RS15010	893
ABI933_1343UNTA85	3141424	3141427		YPO_RS15015	3
ABI933_1343UNTA85	3142124	3142145		YPO_RS15020	21
ABI933_1343UNTA85	3142684	3142989		YPO_RS15025	305
ABI933_1343UNTA85	3143086	3143487		YPO_RS15030	401
ABI933_1343UNTA85	3143469	3144178		YPO_RS15035	709
ABI933_1343UNTA85	3145847	3145856		YPO_RS15040	9
ABI933_1343UNTA85	3170455	3170474		yegD	19
ABI933_1343UNTA85	3172295	3172304		YPO_RS15180	9
ABI933_1343UNTA85	3176611	3176614		YPO_RS15195	3
ABI933_1343UNTA85	3178973	3178983		YPO_RS15200	10
ABI933_1343UNTA85	3198228	3198249		YPO_RS15270	21
ABI933_1343UNTA85	3220347	3220351		YPO_RS15385	4
ABI933_1343UNTA85	3222119	3222123		YPO_RS15385	4
ABI933_1343UNTA85	3225494	3225534		yapA	40
ABI933_1343UNTA85	3225585	3225627		yapA	42
ABI933_1343UNTA85	3229838	3229841		YPO_RS15395	3
ABI933_1343UNTA85	3240424	3240429		iscR	5
ABI933_1343UNTA85	3276264	3276265		YPO_RS15625	1
ABI933_1343UNTA85	3281868	3281885		tssC	17
ABI933_1343UNTA85	3284865	3284869		YPO_RS15670	4
ABI933_1343UNTA85	3285807	3285813		YPO_RS15675	6
ABI933_1343UNTA85	3296120	3296135		YPO_RS15705	15
ABI933_1343UNTA85	3310564	3310567		YPO_RS15765	3
ABI933_1343UNTA85	3310669	3310670		YPO_RS15765	1
ABI933_1343UNTA85	3321021	3321023		YPO_RS15815	2
ABI933_1343UNTA85	3351414	3351416		macB	2
ABI933_1343UNTA85	3358314	3358318		YPO_RS16020	4
ABI933_1343UNTA85	3359409	3359411		YPO_RS16025	2
ABI933_1343UNTA85	3364158	3364161		YPO_RS16040	3
ABI933_1343UNTA85	3379682	3379687		YPO_RS16110	5
ABI933_1343UNTA85	3391870	3391874		napA	4
ABI933_1343UNTA85	3436034	3436055		YPO_RS16365	21
ABI933_1343UNTA85	3437068	3437075		tesA	7
ABI933_1343UNTA85	3451626	3451638		YPO_RS16430	12
ABI933_1343UNTA85	3464312	3464318		YPO_RS16480	6
ABI933_1343UNTA85	3471097	3471101		rfbG	4
ABI933_1343UNTA85	3472129	3472135		rfbF	6
ABI933_1343UNTA85	3473124	3473126		YPO_RS16520	2
ABI933_1343UNTA85	3486479	3486501		mscK	22
ABI933_1343UNTA85	3530179	3530189		cyoB	10
ABI933_1343UNTA85	3540953	3540961		dxs	8
ABI933_1343UNTA85	3554451	3554457		queA	6
ABI933_1343UNTA85	3574374	3574375		YPO_RS16965	1
ABI933_1343UNTA85	3574423	3574435		YPO_RS16965	12
ABI933_1343UNTA85	3575789	3575791		YPO_RS16975	2
ABI933_1343UNTA85	3599880	3599885		YPO_RS17080	5
ABI933_1343UNTA85	3600509	3600520		YPO_RS17080	11
ABI933_1343UNTA85	3601429	3601430		nqrF	1
ABI933_1343UNTA85	3619336	3619339		YPO_RS17145	3
ABI933_1343UNTA85	3619468	3619470		YPO_RS17145	2
ABI933_1343UNTA85	3625257	3625258		YPO_RS17165	1
ABI933_1343UNTA85	3625725	3625728		YPO_RS17170	3
ABI933_1343UNTA85	3629874	3629881		YPO_RS17195	7
ABI933_1343UNTA85	3646453	3646466		YPO_RS17270	13
ABI933_1343UNTA85	3649957	3649964		YPO_RS17290	7
ABI933_1343UNTA85	3662688	3662693		pheA	5
ABI933_1343UNTA85	3663032	3663033		YPO_RS17350	1
ABI933_1343UNTA85	3663993	3663995		YPO_RS17355	2
ABI933_1343UNTA85	3682299	3682309		YPO_RS17455	10
ABI933_1343UNTA85	3682385	3682386		YPO_RS17455	1
ABI933_1343UNTA85	3709447	3709451		dmsA	4
ABI933_1343UNTA85	3789949	3789953		mrcB	4
ABI933_1343UNTA85	3822931	3822932		aceE	1
ABI933_1343UNTA85	3837709	3837720		YPO_RS18135	11
ABI933_1343UNTA85	3914624	3914625		rlmE	1
ABI933_1343UNTA85	3926398	3926400		argR	2
ABI933_1343UNTA85	3931546	3931556		YPO_RS18585	10
ABI933_1343UNTA85	3950379	3950380		yjfP	1
ABI933_1343UNTA85	3952076	3952078		YPO_RS18680	2
ABI933_1343UNTA85	3958077	3958080		YPO_RS18710	3
ABI933_1343UNTA85	3974628	3974635		sspA	7
ABI933_1343UNTA85	3977689	3977697		YPO_RS18790	8
ABI933_1343UNTA85	3982856	3982859		murA	3
ABI933_1343UNTA85	4010003	4010011		YPO_RS18970	8
ABI933_1343UNTA85	4030648	4030649		YPO_RS19055	1
ABI933_1343UNTA85	4033290	4033291		YPO_RS19055	1
ABI933_1343UNTA85	4036027	4036036		YPO_RS19075	9
ABI933_1343UNTA85	4059431	4059454		YPO_RS19175	23
ABI933_1343UNTA85	4099529	4099532		YPO_RS19365	3
ABI933_1343UNTA85	4110192	4110193		YPO_RS19390	1
ABI933_1343UNTA85	4136341	4136366		YPO_RS19500	25
ABI933_1343UNTA85	4139903	4139908		tssC	5
ABI933_1343UNTA85	4166349	4166356		metH	7
ABI933_1343UNTA85	4176210	4176221		YPO_RS19645	11
ABI933_1343UNTA85	4197843	4197850		rpoC	7
ABI933_1343UNTA85	4200694	4200698		rpoC	4
ABI933_1343UNTA85	4208862	4208863		nusG	1
ABI933_1343UNTA85	4212457	4212458		YPO_RS19820	1
ABI933_1343UNTA85	4213921	4213922		YPO_RS19830	1
ABI933_1343UNTA85	4223139	4223150		YPO_RS19870	11
ABI933_1343UNTA85	4226983	4226992		YPO_RS19900	9
ABI933_1343UNTA85	4227999	4228000		pepQ	1
ABI933_1343UNTA85	4237936	4237938		YPO_RS19950	2
ABI933_1343UNTA85	4238483	4238489		YPO_RS19950	6
ABI933_1343UNTA85	4268936	4268941		YPO_RS20090	5
ABI933_1343UNTA85	4330970	4330974		YPO_RS20395	4
ABI933_1343UNTA85	4356371	4356374		YPO_RS20500	3
ABI933_1343UNTA85	4359439	4359442		YPO_RS20515	3
ABI933_1343UNTA85	4361319	4361327		YPO_RS20530	8
ABI933_1343UNTA85	4363203	4363208		ilvC	5
ABI933_1343UNTA85	4417691	4417694		YPO_RS20775	3
ABI933_1343UNTA85	4430747	4430758		glgB	11
ABI933_1343UNTA85	4437952	4437955		YPO_RS20830	3
ABI933_1343UNTA85	4438051	4438052		YPO_RS20830	1
ABI933_1343UNTA85	4456767	4456779		YPO_RS20910	12
ABI933_1343UNTA85	4459409	4459418		YPO_RS20925	9
ABI933_1343UNTA85	4484956	4484957		YPO_RS21030	1
ABI933_1343UNTA85	4491391	4491399		YPO_RS21050	8
ABI933_1343UNTA85	4504673	4504674		hmsP	1
ABI933_1343UNTA85	4506754	4506755		bcsZ	1
ABI933_1343UNTA85	4511125	4511130		dppB	5
ABI933_1343UNTA85	4516053	4516056		YPO_RS21140	3
ABI933_1343UNTA85	4551123	4551126		YPO_RS21305	3
ABI933_1343UNTA85	4553127	4553134		xylF	7
ABI933_1343UNTA85	4558348	4558352		YPO_RS21330	4
ABI933_1343UNTA85	4566085	4566096		YPO_RS21360	11
ABI933_1343UNTA85	4570822	4570828		selB	6
ABI933_1343UNTA85	4610892	4610895		YPO_RS21565	3
ABI933_1343UNTA85	4641379	4641383		glmU	4
ARS007ss_ds.merged.samereadgroup.cleaned	947	959		asnC	12
ARS007ss_ds.merged.samereadgroup.cleaned	1435	1436		YPO_RS01015	1
ARS007ss_ds.merged.samereadgroup.cleaned	1709	1711		YPO_RS01015	2
ARS007ss_ds.merged.samereadgroup.cleaned	2310	2313		YPO_RS01015	3
ARS007ss_ds.merged.samereadgroup.cleaned	3934	3936		viaA	2
ARS007ss_ds.merged.samereadgroup.cleaned	4066	4095		ravA	29
ARS007ss_ds.merged.samereadgroup.cleaned	5165	5184		ravA	19
ARS007ss_ds.merged.samereadgroup.cleaned	9174	9178		rbsK	4
ARS007ss_ds.merged.samereadgroup.cleaned	11127	11135		YPO_RS01060	8
ARS007ss_ds.merged.samereadgroup.cleaned	21823	21826		dsbA	3
ARS007ss_ds.merged.samereadgroup.cleaned	22192	22195		dsbA	3
ARS007ss_ds.merged.samereadgroup.cleaned	22202	22203		dsbA	1
ARS007ss_ds.merged.samereadgroup.cleaned	24905	24916		polA	11
ARS007ss_ds.merged.samereadgroup.cleaned	25367	25371		polA	4
ARS007ss_ds.merged.samereadgroup.cleaned	29310	29329		hemN	19
ARS007ss_ds.merged.samereadgroup.cleaned	30469	30470		glnG	1
ARS007ss_ds.merged.samereadgroup.cleaned	31235	31266		glnG	31
ARS007ss_ds.merged.samereadgroup.cleaned	33885	33899		glnA	14
ARS007ss_ds.merged.samereadgroup.cleaned	35601	35610		typA	9
ARS007ss_ds.merged.samereadgroup.cleaned	36479	36503		typA	24
ARS007ss_ds.merged.samereadgroup.cleaned	38438	38440		YPO_RS01170	2
ARS007ss_ds.merged.samereadgroup.cleaned	38906	38908		dtd	2
ARS007ss_ds.merged.samereadgroup.cleaned	39060	39118		dtd	58
ARS007ss_ds.merged.samereadgroup.cleaned	43712	43724		YPO_RS01195	12
ARS007ss_ds.merged.samereadgroup.cleaned	44025	44039		YPO_RS01195	14
ARS007ss_ds.merged.samereadgroup.cleaned	44719	44720		YPO_RS01200	1
ARS007ss_ds.merged.samereadgroup.cleaned	44804	44805		YPO_RS01200	1
ARS007ss_ds.merged.samereadgroup.cleaned	45362	45371		YPO_RS01200	9
ARS007ss_ds.merged.samereadgroup.cleaned	46470	46471		gltS	1
ARS007ss_ds.merged.samereadgroup.cleaned	46610	46613		gltS	3
ARS007ss_ds.merged.samereadgroup.cleaned	48426	48441		recG	15
ARS007ss_ds.merged.samereadgroup.cleaned	49283	49284		recG	1
ARS007ss_ds.merged.samereadgroup.cleaned	49714	49728		trmH	14
ARS007ss_ds.merged.samereadgroup.cleaned	51492	51502		spoT	10
ARS007ss_ds.merged.samereadgroup.cleaned	51563	51570		spoT	7
ARS007ss_ds.merged.samereadgroup.cleaned	52173	52176		spoT	3
ARS007ss_ds.merged.samereadgroup.cleaned	53350	53353		gmk	3
ARS007ss_ds.merged.samereadgroup.cleaned	53813	53831		ligB	18
ARS007ss_ds.merged.samereadgroup.cleaned	54496	54499		ligB	3
ARS007ss_ds.merged.samereadgroup.cleaned	54530	54531		ligB	1
ARS007ss_ds.merged.samereadgroup.cleaned	55085	55086		ligB	1
ARS007ss_ds.merged.samereadgroup.cleaned	56056	56061		YPO_RS01245	5
ARS007ss_ds.merged.samereadgroup.cleaned	57632	57636		rph	4
ARS007ss_ds.merged.samereadgroup.cleaned	58474	58482		pyrE	8
ARS007ss_ds.merged.samereadgroup.cleaned	59047	59049		pyrE	2
ARS007ss_ds.merged.samereadgroup.cleaned	60071	60075		dut	4
ARS007ss_ds.merged.samereadgroup.cleaned	61277	61288		coaBC	11
ARS007ss_ds.merged.samereadgroup.cleaned	61937	61938		YPO_RS01280	1
ARS007ss_ds.merged.samereadgroup.cleaned	62174	62179		YPO_RS01280	5
ARS007ss_ds.merged.samereadgroup.cleaned	63377	63393		mutM	16
ARS007ss_ds.merged.samereadgroup.cleaned	64825	64839		YPO_RS01310	14
ARS007ss_ds.merged.samereadgroup.cleaned	68559	68563		rfaF	4
ARS007ss_ds.merged.samereadgroup.cleaned	71695	71720		tdh	25
ARS007ss_ds.merged.samereadgroup.cleaned	73618	73628		envC	10
ARS007ss_ds.merged.samereadgroup.cleaned	73906	73914		envC	8
ARS007ss_ds.merged.samereadgroup.cleaned	75031	75057		gpmM	26
ARS007ss_ds.merged.samereadgroup.cleaned	78789	78799		gpsA	10
ARS007ss_ds.merged.samereadgroup.cleaned	78932	78948		gpsA	16
ARS007ss_ds.merged.samereadgroup.cleaned	79030	79035		gpsA	5
ARS007ss_ds.merged.samereadgroup.cleaned	80494	80497		trmL	3
ARS007ss_ds.merged.samereadgroup.cleaned	81414	81424		ada	10
ARS007ss_ds.merged.samereadgroup.cleaned	81513	81525		ada	12
ARS007ss_ds.merged.samereadgroup.cleaned	81764	81770		ada	6
ARS007ss_ds.merged.samereadgroup.cleaned	81881	81898		ada	17
ARS007ss_ds.merged.samereadgroup.cleaned	82310	82313		cpxA	3
ARS007ss_ds.merged.samereadgroup.cleaned	82445	82460		cpxA	15
ARS007ss_ds.merged.samereadgroup.cleaned	83079	83090		cpxA	11
ARS007ss_ds.merged.samereadgroup.cleaned	85549	85572		YPO_RS01415	23
ARS007ss_ds.merged.samereadgroup.cleaned	86048	86062		YPO_RS01420	14
ARS007ss_ds.merged.samereadgroup.cleaned	88683	88693		pfkA	10
ARS007ss_ds.merged.samereadgroup.cleaned	89502	89507		YPO_RS01435	5
ARS007ss_ds.merged.samereadgroup.cleaned	89739	89740		YPO_RS01435	1
ARS007ss_ds.merged.samereadgroup.cleaned	91832	91847		YPO_RS01445	15
ARS007ss_ds.merged.samereadgroup.cleaned	93029	93030		YPO_RS01445	1
ARS007ss_ds.merged.samereadgroup.cleaned	94015	94028		YPO_RS01455	13
ARS007ss_ds.merged.samereadgroup.cleaned	95163	95171		YPO_RS01460	8
ARS007ss_ds.merged.samereadgroup.cleaned	95571	95615		YPO_RS01460	44
ARS007ss_ds.merged.samereadgroup.cleaned	95823	95826		YPO_RS01460	3
ARS007ss_ds.merged.samereadgroup.cleaned	96813	96815		tpiA	2
ARS007ss_ds.merged.samereadgroup.cleaned	97595	97597		YPO_RS01470	2
ARS007ss_ds.merged.samereadgroup.cleaned	101989	101991		YPO_RS01495	2
ARS007ss_ds.merged.samereadgroup.cleaned	106558	106560		YPO_RS01520	2
ARS007ss_ds.merged.samereadgroup.cleaned	108631	108638		YPO_RS01530	7
ARS007ss_ds.merged.samereadgroup.cleaned	108809	108816		YPO_RS01530	7
ARS007ss_ds.merged.samereadgroup.cleaned	109101	109108		YPO_RS01530	7
ARS007ss_ds.merged.samereadgroup.cleaned	109484	109524		YPO_RS01530	40
ARS007ss_ds.merged.samereadgroup.cleaned	110096	110102		YPO_RS01535	6
ARS007ss_ds.merged.samereadgroup.cleaned	111204	111205		YPO_RS01540	1
ARS007ss_ds.merged.samereadgroup.cleaned	111302	111316		YPO_RS01540	14
ARS007ss_ds.merged.samereadgroup.cleaned	112072	112075		YPO_RS01550	3
ARS007ss_ds.merged.samereadgroup.cleaned	113710	113717		hslU	7
ARS007ss_ds.merged.samereadgroup.cleaned	113977	114005		hslU	28
ARS007ss_ds.merged.samereadgroup.cleaned	114754	114757		hslV	3
ARS007ss_ds.merged.samereadgroup.cleaned	115463	115543		ftsN	80
ARS007ss_ds.merged.samereadgroup.cleaned	115624	115627		ftsN	3
ARS007ss_ds.merged.samereadgroup.cleaned	115777	115785		ftsN	8
ARS007ss_ds.merged.samereadgroup.cleaned	115898	115900		ftsN	2
ARS007ss_ds.merged.samereadgroup.cleaned	116437	116459		cytR	22
ARS007ss_ds.merged.samereadgroup.cleaned	117590	117591		priA	1
ARS007ss_ds.merged.samereadgroup.cleaned	117830	117834		priA	4
ARS007ss_ds.merged.samereadgroup.cleaned	118510	118513		priA	3
ARS007ss_ds.merged.samereadgroup.cleaned	119639	119650		priA	11
ARS007ss_ds.merged.samereadgroup.cleaned	124507	124516		YPO_RS01600	9
ARS007ss_ds.merged.samereadgroup.cleaned	124693	124705		YPO_RS01600	12
ARS007ss_ds.merged.samereadgroup.cleaned	125783	125803		YPO_RS01600	20
ARS007ss_ds.merged.samereadgroup.cleaned	128922	128932		YPO_RS01615	10
ARS007ss_ds.merged.samereadgroup.cleaned	129837	129842		glpG	5
ARS007ss_ds.merged.samereadgroup.cleaned	129958	129964		glpG	6
ARS007ss_ds.merged.samereadgroup.cleaned	131746	131757		malT	11
ARS007ss_ds.merged.samereadgroup.cleaned	131976	131986		malT	10
ARS007ss_ds.merged.samereadgroup.cleaned	132953	132963		malT	10
ARS007ss_ds.merged.samereadgroup.cleaned	133140	133143		malT	3
ARS007ss_ds.merged.samereadgroup.cleaned	133370	133384		malT	14
ARS007ss_ds.merged.samereadgroup.cleaned	135599	135601		malP	2
ARS007ss_ds.merged.samereadgroup.cleaned	136150	136152		malP	2
ARS007ss_ds.merged.samereadgroup.cleaned	136280	136283		malP	3
ARS007ss_ds.merged.samereadgroup.cleaned	136528	136531		malQ	3
ARS007ss_ds.merged.samereadgroup.cleaned	137048	137054		malQ	6
ARS007ss_ds.merged.samereadgroup.cleaned	137433	137453		malQ	20
ARS007ss_ds.merged.samereadgroup.cleaned	137716	137726		malQ	10
ARS007ss_ds.merged.samereadgroup.cleaned	138445	138461		malQ	16
ARS007ss_ds.merged.samereadgroup.cleaned	139633	139636		gntX	3
ARS007ss_ds.merged.samereadgroup.cleaned	139740	139751		gntX	11
ARS007ss_ds.merged.samereadgroup.cleaned	141026	141038		bioH	12
ARS007ss_ds.merged.samereadgroup.cleaned	141277	141287		YPO_RS01665	10
ARS007ss_ds.merged.samereadgroup.cleaned	142041	142048		feoB	7
ARS007ss_ds.merged.samereadgroup.cleaned	142803	142810		feoB	7
ARS007ss_ds.merged.samereadgroup.cleaned	143062	143063		feoB	1
ARS007ss_ds.merged.samereadgroup.cleaned	143229	143254		feoB	25
ARS007ss_ds.merged.samereadgroup.cleaned	143498	143504		feoB	6
ARS007ss_ds.merged.samereadgroup.cleaned	144386	144391		feoA	5
ARS007ss_ds.merged.samereadgroup.cleaned	146817	146829		YPO_RS01685	12
ARS007ss_ds.merged.samereadgroup.cleaned	149210	149220		ompR	10
ARS007ss_ds.merged.samereadgroup.cleaned	150593	150605		envZ	12
ARS007ss_ds.merged.samereadgroup.cleaned	150937	150944		pckA	7
ARS007ss_ds.merged.samereadgroup.cleaned	151664	151674		pckA	10
ARS007ss_ds.merged.samereadgroup.cleaned	152347	152350		pckA	3
ARS007ss_ds.merged.samereadgroup.cleaned	153232	153254		hslO	22
ARS007ss_ds.merged.samereadgroup.cleaned	155762	155771		YPO_RS01725	9
ARS007ss_ds.merged.samereadgroup.cleaned	155842	155852		YPO_RS01725	10
ARS007ss_ds.merged.samereadgroup.cleaned	155924	155929		YPO_RS01725	5
ARS007ss_ds.merged.samereadgroup.cleaned	156698	156710		YPO_RS01725	12
ARS007ss_ds.merged.samereadgroup.cleaned	158003	158009		nudE	6
ARS007ss_ds.merged.samereadgroup.cleaned	159687	159688		mrcA	1
ARS007ss_ds.merged.samereadgroup.cleaned	161910	161919		YPO_RS01740	9
ARS007ss_ds.merged.samereadgroup.cleaned	162089	162120		YPO_RS01745	31
ARS007ss_ds.merged.samereadgroup.cleaned	162347	162358		YPO_RS01745	11
ARS007ss_ds.merged.samereadgroup.cleaned	162814	162828		YPO_RS01750	14
ARS007ss_ds.merged.samereadgroup.cleaned	163012	163013		YPO_RS01750	1
ARS007ss_ds.merged.samereadgroup.cleaned	163626	163629		hofQ	3
ARS007ss_ds.merged.samereadgroup.cleaned	163798	163803		hofQ	5
ARS007ss_ds.merged.samereadgroup.cleaned	163954	163959		hofQ	5
ARS007ss_ds.merged.samereadgroup.cleaned	164044	164047		hofQ	3
ARS007ss_ds.merged.samereadgroup.cleaned	164739	164745		hofQ	6
ARS007ss_ds.merged.samereadgroup.cleaned	166878	166879		aroB	1
ARS007ss_ds.merged.samereadgroup.cleaned	167100	167104		aroB	4
ARS007ss_ds.merged.samereadgroup.cleaned	167923	167930		YPO_RS01775	7
ARS007ss_ds.merged.samereadgroup.cleaned	170633	170660		YPO_RS01790	27
ARS007ss_ds.merged.samereadgroup.cleaned	173398	173410		cobA	12
ARS007ss_ds.merged.samereadgroup.cleaned	173713	173715		nirC	2
ARS007ss_ds.merged.samereadgroup.cleaned	174048	174058		nirC	10
ARS007ss_ds.merged.samereadgroup.cleaned	174135	174150		nirC	15
ARS007ss_ds.merged.samereadgroup.cleaned	174204	174212		nirC	8
ARS007ss_ds.merged.samereadgroup.cleaned	175223	175251		YPO_RS01815	28
ARS007ss_ds.merged.samereadgroup.cleaned	176299	176302		YPO_RS01815	3
ARS007ss_ds.merged.samereadgroup.cleaned	176524	176539		YPO_RS01815	15
ARS007ss_ds.merged.samereadgroup.cleaned	177049	177063		YPO_RS01815	14
ARS007ss_ds.merged.samereadgroup.cleaned	177190	177194		YPO_RS01815	4
ARS007ss_ds.merged.samereadgroup.cleaned	177296	177297		YPO_RS01815	1
ARS007ss_ds.merged.samereadgroup.cleaned	177527	177531		YPO_RS01815	4
ARS007ss_ds.merged.samereadgroup.cleaned	178410	178411		YPO_RS01820	1
ARS007ss_ds.merged.samereadgroup.cleaned	178626	178629		YPO_RS01820	3
ARS007ss_ds.merged.samereadgroup.cleaned	181119	181143		YPO_RS01830	24
ARS007ss_ds.merged.samereadgroup.cleaned	181410	181414		YPO_RS01830	4
ARS007ss_ds.merged.samereadgroup.cleaned	182537	182549		YPO_RS01830	12
ARS007ss_ds.merged.samereadgroup.cleaned	182581	182588		YPO_RS01830	7
ARS007ss_ds.merged.samereadgroup.cleaned	183900	183908		YPO_RS01835	8
ARS007ss_ds.merged.samereadgroup.cleaned	184016	184025		YPO_RS01835	9
ARS007ss_ds.merged.samereadgroup.cleaned	184345	184351		YPO_RS01840	6
ARS007ss_ds.merged.samereadgroup.cleaned	184482	184500		YPO_RS01840	18
ARS007ss_ds.merged.samereadgroup.cleaned	185567	185568		YPO_RS01840	1
ARS007ss_ds.merged.samereadgroup.cleaned	186187	186202		ppiA	15
ARS007ss_ds.merged.samereadgroup.cleaned	187509	187511		YPO_RS01850	2
ARS007ss_ds.merged.samereadgroup.cleaned	187603	187620		YPO_RS01850	17
ARS007ss_ds.merged.samereadgroup.cleaned	188352	188355		YPO_RS01850	3
ARS007ss_ds.merged.samereadgroup.cleaned	188395	188402		YPO_RS01850	7
ARS007ss_ds.merged.samereadgroup.cleaned	188551	188567		YPO_RS01850	16
ARS007ss_ds.merged.samereadgroup.cleaned	193919	193926		YPO_RS01880	7
ARS007ss_ds.merged.samereadgroup.cleaned	194071	194083		YPO_RS01880	12
ARS007ss_ds.merged.samereadgroup.cleaned	194173	194180		YPO_RS01880	7
ARS007ss_ds.merged.samereadgroup.cleaned	196674	196687		YPO_RS01895	13
ARS007ss_ds.merged.samereadgroup.cleaned	196755	196816		YPO_RS01895	61
ARS007ss_ds.merged.samereadgroup.cleaned	197415	197417		YPO_RS01900	2
ARS007ss_ds.merged.samereadgroup.cleaned	197492	197493		YPO_RS01900	1
ARS007ss_ds.merged.samereadgroup.cleaned	198005	198007		YPO_RS01900	2
ARS007ss_ds.merged.samereadgroup.cleaned	198989	199009		YPO_RS01910	20
ARS007ss_ds.merged.samereadgroup.cleaned	199589	199595		YPO_RS01915	6
ARS007ss_ds.merged.samereadgroup.cleaned	200418	200424		tauA	6
ARS007ss_ds.merged.samereadgroup.cleaned	200944	200945		tauA	1
ARS007ss_ds.merged.samereadgroup.cleaned	200979	200981		tauA	2
ARS007ss_ds.merged.samereadgroup.cleaned	201779	201795		tauB	16
ARS007ss_ds.merged.samereadgroup.cleaned	202339	202366		tauC	27
ARS007ss_ds.merged.samereadgroup.cleaned	205201	205215		YPO_RS01945	14
ARS007ss_ds.merged.samereadgroup.cleaned	205707	205713		YPO_RS01945	6
ARS007ss_ds.merged.samereadgroup.cleaned	208542	208548		kefG	6
ARS007ss_ds.merged.samereadgroup.cleaned	208787	208803		kefB	16
ARS007ss_ds.merged.samereadgroup.cleaned	208875	208876		kefB	1
ARS007ss_ds.merged.samereadgroup.cleaned	210951	210952		slyD	1
ARS007ss_ds.merged.samereadgroup.cleaned	211463	211481		slyD	18
ARS007ss_ds.merged.samereadgroup.cleaned	219534	219538		tuf	4
ARS007ss_ds.merged.samereadgroup.cleaned	222396	222398		rplC	2
ARS007ss_ds.merged.samereadgroup.cleaned	222573	222574		rplC	1
ARS007ss_ds.merged.samereadgroup.cleaned	227298	227299		rplX	1
ARS007ss_ds.merged.samereadgroup.cleaned	229428	229431		rplR	3
ARS007ss_ds.merged.samereadgroup.cleaned	229962	229967		rpsE	5
ARS007ss_ds.merged.samereadgroup.cleaned	236480	236482		YPO_RS02185	2
ARS007ss_ds.merged.samereadgroup.cleaned	238441	238448		trkA	7
ARS007ss_ds.merged.samereadgroup.cleaned	238769	238775		rsmB	6
ARS007ss_ds.merged.samereadgroup.cleaned	239103	239104		rsmB	1
ARS007ss_ds.merged.samereadgroup.cleaned	239271	239275		rsmB	4
ARS007ss_ds.merged.samereadgroup.cleaned	239690	239699		rsmB	9
ARS007ss_ds.merged.samereadgroup.cleaned	239867	239869		rsmB	2
ARS007ss_ds.merged.samereadgroup.cleaned	240341	240365		fmt	24
ARS007ss_ds.merged.samereadgroup.cleaned	240641	240655		fmt	14
ARS007ss_ds.merged.samereadgroup.cleaned	240767	240776		fmt	9
ARS007ss_ds.merged.samereadgroup.cleaned	244746	244757		aroE	11
ARS007ss_ds.merged.samereadgroup.cleaned	247679	247683		YPO_RS02255	4
ARS007ss_ds.merged.samereadgroup.cleaned	247836	247841		YPO_RS02255	5
ARS007ss_ds.merged.samereadgroup.cleaned	249128	249129		actP	1
ARS007ss_ds.merged.samereadgroup.cleaned	249525	249557		actP	32
ARS007ss_ds.merged.samereadgroup.cleaned	249743	249744		actP	1
ARS007ss_ds.merged.samereadgroup.cleaned	250504	250505		YPO_RS02265	1
ARS007ss_ds.merged.samereadgroup.cleaned	251021	251022		acs	1
ARS007ss_ds.merged.samereadgroup.cleaned	252507	252511		acs	4
ARS007ss_ds.merged.samereadgroup.cleaned	254858	254860		gltP	2
ARS007ss_ds.merged.samereadgroup.cleaned	255177	255194		YPO_RS02280	17
ARS007ss_ds.merged.samereadgroup.cleaned	255266	255281		YPO_RS02280	15
ARS007ss_ds.merged.samereadgroup.cleaned	255702	255703		YPO_RS02285	1
ARS007ss_ds.merged.samereadgroup.cleaned	255734	255745		YPO_RS02285	11
ARS007ss_ds.merged.samereadgroup.cleaned	256174	256198		YPO_RS02285	24
ARS007ss_ds.merged.samereadgroup.cleaned	256586	256598		YPO_RS02285	12
ARS007ss_ds.merged.samereadgroup.cleaned	258170	258223		YPO_RS02285	53
ARS007ss_ds.merged.samereadgroup.cleaned	259172	259204		YPO_RS02290	32
ARS007ss_ds.merged.samereadgroup.cleaned	259389	259392		YPO_RS02290	3
ARS007ss_ds.merged.samereadgroup.cleaned	260155	260164		YPO_RS02290	9
ARS007ss_ds.merged.samereadgroup.cleaned	260912	260918		sctD	6
ARS007ss_ds.merged.samereadgroup.cleaned	261042	261043		sctD	1
ARS007ss_ds.merged.samereadgroup.cleaned	261171	261172		sctD	1
ARS007ss_ds.merged.samereadgroup.cleaned	263400	263407		YPO_RS02325	7
ARS007ss_ds.merged.samereadgroup.cleaned	263590	263591		YPO_RS02325	1
ARS007ss_ds.merged.samereadgroup.cleaned	263671	263680		YPO_RS02325	9
ARS007ss_ds.merged.samereadgroup.cleaned	265552	265554		YPO_RS02340	2
ARS007ss_ds.merged.samereadgroup.cleaned	266815	266832		YPO_RS02340	17
ARS007ss_ds.merged.samereadgroup.cleaned	266926	266935		YPO_RS02340	9
ARS007ss_ds.merged.samereadgroup.cleaned	267255	267257		YPO_RS02340	2
ARS007ss_ds.merged.samereadgroup.cleaned	267844	267855		YPO_RS02345	11
ARS007ss_ds.merged.samereadgroup.cleaned	269883	269890		YPO_RS02360	7
ARS007ss_ds.merged.samereadgroup.cleaned	271670	271672		sctT	2
ARS007ss_ds.merged.samereadgroup.cleaned	272305	272308		sctT	3
ARS007ss_ds.merged.samereadgroup.cleaned	272380	272381		sctT	1
ARS007ss_ds.merged.samereadgroup.cleaned	272844	272868		YPO_RS02380	24
ARS007ss_ds.merged.samereadgroup.cleaned	273979	273991		yedE	12
ARS007ss_ds.merged.samereadgroup.cleaned	274860	274862		yedE	2
ARS007ss_ds.merged.samereadgroup.cleaned	275508	275533		YPO_RS02395	25
ARS007ss_ds.merged.samereadgroup.cleaned	275937	275955		YPO_RS02395	18
ARS007ss_ds.merged.samereadgroup.cleaned	276061	276074		YPO_RS02395	13
ARS007ss_ds.merged.samereadgroup.cleaned	277507	277520		YPO_RS02400	13
ARS007ss_ds.merged.samereadgroup.cleaned	278054	278055		metC	1
ARS007ss_ds.merged.samereadgroup.cleaned	278646	278649		metC	3
ARS007ss_ds.merged.samereadgroup.cleaned	278896	278908		metC	12
ARS007ss_ds.merged.samereadgroup.cleaned	279665	279670		YPO_RS02410	5
ARS007ss_ds.merged.samereadgroup.cleaned	279946	279947		YPO_RS02410	1
ARS007ss_ds.merged.samereadgroup.cleaned	280142	280144		YPO_RS02415	2
ARS007ss_ds.merged.samereadgroup.cleaned	281665	281666		YPO_RS02420	1
ARS007ss_ds.merged.samereadgroup.cleaned	283447	283460		YPO_RS02430	13
ARS007ss_ds.merged.samereadgroup.cleaned	284378	284379		YPO_RS02430	1
ARS007ss_ds.merged.samereadgroup.cleaned	284956	284960		YPO_RS02430	4
ARS007ss_ds.merged.samereadgroup.cleaned	286455	286459		hutX	4
ARS007ss_ds.merged.samereadgroup.cleaned	286998	287004		YPO_RS02450	6
ARS007ss_ds.merged.samereadgroup.cleaned	288461	288488		YPO_RS02455	27
ARS007ss_ds.merged.samereadgroup.cleaned	288801	288802		YPO_RS02455	1
ARS007ss_ds.merged.samereadgroup.cleaned	288876	288898		YPO_RS02455	22
ARS007ss_ds.merged.samereadgroup.cleaned	288946	288961		YPO_RS02455	15
ARS007ss_ds.merged.samereadgroup.cleaned	293041	293061		YPO_RS02475	20
ARS007ss_ds.merged.samereadgroup.cleaned	293507	293510		YPO_RS02480	3
ARS007ss_ds.merged.samereadgroup.cleaned	294026	294027		YPO_RS02480	1
ARS007ss_ds.merged.samereadgroup.cleaned	294461	294480		YPO_RS02485	19
ARS007ss_ds.merged.samereadgroup.cleaned	297048	297052		YPO_RS02495	4
ARS007ss_ds.merged.samereadgroup.cleaned	299263	299268		YPO_RS02510	5
ARS007ss_ds.merged.samereadgroup.cleaned	299861	299862		YPO_RS02515	1
ARS007ss_ds.merged.samereadgroup.cleaned	300238	300250		YPO_RS02515	12
ARS007ss_ds.merged.samereadgroup.cleaned	302340	302359		YPO_RS02525	19
ARS007ss_ds.merged.samereadgroup.cleaned	303786	303787		YPO_RS02530	1
ARS007ss_ds.merged.samereadgroup.cleaned	304013	304018		YPO_RS02530	5
ARS007ss_ds.merged.samereadgroup.cleaned	305695	305702		YPO_RS02535	7
ARS007ss_ds.merged.samereadgroup.cleaned	307327	307336		YPO_RS02550	9
ARS007ss_ds.merged.samereadgroup.cleaned	308084	308102		YPO_RS02550	18
ARS007ss_ds.merged.samereadgroup.cleaned	311256	311259		YPO_RS02555	3
ARS007ss_ds.merged.samereadgroup.cleaned	312839	312845		yapK	6
ARS007ss_ds.merged.samereadgroup.cleaned	313493	313494		yapK	1
ARS007ss_ds.merged.samereadgroup.cleaned	313950	313959		yapK	9
ARS007ss_ds.merged.samereadgroup.cleaned	314495	314497		yapK	2
ARS007ss_ds.merged.samereadgroup.cleaned	314619	314620		yapK	1
ARS007ss_ds.merged.samereadgroup.cleaned	315038	315070		yapK	32
ARS007ss_ds.merged.samereadgroup.cleaned	317709	317733		ubiA	24
ARS007ss_ds.merged.samereadgroup.cleaned	317813	317822		ubiA	9
ARS007ss_ds.merged.samereadgroup.cleaned	318747	318758		plsB	11
ARS007ss_ds.merged.samereadgroup.cleaned	319467	319491		plsB	24
ARS007ss_ds.merged.samereadgroup.cleaned	320005	320007		plsB	2
ARS007ss_ds.merged.samereadgroup.cleaned	321836	321843		lexA	7
ARS007ss_ds.merged.samereadgroup.cleaned	323413	323424		dusA	11
ARS007ss_ds.merged.samereadgroup.cleaned	324739	324761		pspG	22
ARS007ss_ds.merged.samereadgroup.cleaned	325376	325377		YPO_RS02605	1
ARS007ss_ds.merged.samereadgroup.cleaned	325672	325695		YPO_RS02605	23
ARS007ss_ds.merged.samereadgroup.cleaned	325979	325990		YPO_RS02605	11
ARS007ss_ds.merged.samereadgroup.cleaned	326128	326136		YPO_RS02605	8
ARS007ss_ds.merged.samereadgroup.cleaned	328384	328386		alr	2
ARS007ss_ds.merged.samereadgroup.cleaned	331552	331553		uvrA	1
ARS007ss_ds.merged.samereadgroup.cleaned	332429	332430		uvrA	1
ARS007ss_ds.merged.samereadgroup.cleaned	333669	333683		uvrA	14
ARS007ss_ds.merged.samereadgroup.cleaned	333902	333916		uvrA	14
ARS007ss_ds.merged.samereadgroup.cleaned	335043	335045		ssb1	2
ARS007ss_ds.merged.samereadgroup.cleaned	336534	336544		fucO	10
ARS007ss_ds.merged.samereadgroup.cleaned	337336	337342		rhaD	6
ARS007ss_ds.merged.samereadgroup.cleaned	337607	337621		rhaD	14
ARS007ss_ds.merged.samereadgroup.cleaned	337845	337850		rhaD	5
ARS007ss_ds.merged.samereadgroup.cleaned	338570	338579		YPO_RS02655	9
ARS007ss_ds.merged.samereadgroup.cleaned	340014	340022		rhaB	8
ARS007ss_ds.merged.samereadgroup.cleaned	343294	343299		rhaT	5
ARS007ss_ds.merged.samereadgroup.cleaned	343638	343639		rhaT	1
ARS007ss_ds.merged.samereadgroup.cleaned	343730	343751		rhaT	21
ARS007ss_ds.merged.samereadgroup.cleaned	343914	343922		rhaT	8
ARS007ss_ds.merged.samereadgroup.cleaned	345107	345125		YPO_RS02690	18
ARS007ss_ds.merged.samereadgroup.cleaned	345929	345931		YPO_RS02695	2
ARS007ss_ds.merged.samereadgroup.cleaned	347179	347180		YPO_RS02695	1
ARS007ss_ds.merged.samereadgroup.cleaned	348046	348059		YPO_RS02695	13
ARS007ss_ds.merged.samereadgroup.cleaned	350160	350162		aegA	2
ARS007ss_ds.merged.samereadgroup.cleaned	351492	351493		aegA	1
ARS007ss_ds.merged.samereadgroup.cleaned	351841	351855		aegA	14
ARS007ss_ds.merged.samereadgroup.cleaned	352602	352609		fdhF	7
ARS007ss_ds.merged.samereadgroup.cleaned	353015	353022		fdhF	7
ARS007ss_ds.merged.samereadgroup.cleaned	353256	353262		fdhF	6
ARS007ss_ds.merged.samereadgroup.cleaned	353575	353603		fdhF	28
ARS007ss_ds.merged.samereadgroup.cleaned	354180	354190		fdhF	10
ARS007ss_ds.merged.samereadgroup.cleaned	354308	354310		fdhF	2
ARS007ss_ds.merged.samereadgroup.cleaned	354560	354571		fdhF	11
ARS007ss_ds.merged.samereadgroup.cleaned	355490	355496		YPO_RS02725	6
ARS007ss_ds.merged.samereadgroup.cleaned	356492	356507		YPO_RS02725	15
ARS007ss_ds.merged.samereadgroup.cleaned	356640	356649		cutA	9
ARS007ss_ds.merged.samereadgroup.cleaned	359264	359266		aspA	2
ARS007ss_ds.merged.samereadgroup.cleaned	359651	359657		aspA	6
ARS007ss_ds.merged.samereadgroup.cleaned	360477	360484		fxsA	7
ARS007ss_ds.merged.samereadgroup.cleaned	360528	360534		fxsA	6
ARS007ss_ds.merged.samereadgroup.cleaned	362824	362850		groL	26
ARS007ss_ds.merged.samereadgroup.cleaned	364681	364695		epmB	14
ARS007ss_ds.merged.samereadgroup.cleaned	366057	366075		efp	18
ARS007ss_ds.merged.samereadgroup.cleaned	371057	371059		YPO_RS02805	2
ARS007ss_ds.merged.samereadgroup.cleaned	371134	371159		YPO_RS02805	25
ARS007ss_ds.merged.samereadgroup.cleaned	371655	371666		epmA	11
ARS007ss_ds.merged.samereadgroup.cleaned	372586	372602		mscM	16
ARS007ss_ds.merged.samereadgroup.cleaned	372817	372829		mscM	12
ARS007ss_ds.merged.samereadgroup.cleaned	374456	374459		mscM	3
ARS007ss_ds.merged.samereadgroup.cleaned	375882	375914		psd	32
ARS007ss_ds.merged.samereadgroup.cleaned	376036	376046		psd	10
ARS007ss_ds.merged.samereadgroup.cleaned	376096	376102		psd	6
ARS007ss_ds.merged.samereadgroup.cleaned	378525	378536		orn	11
ARS007ss_ds.merged.samereadgroup.cleaned	381278	381280		nnr	2
ARS007ss_ds.merged.samereadgroup.cleaned	381411	381420		nnr	9
ARS007ss_ds.merged.samereadgroup.cleaned	381863	381882		nnr	19
ARS007ss_ds.merged.samereadgroup.cleaned	382634	382636		tsaE	2
ARS007ss_ds.merged.samereadgroup.cleaned	383544	383565		amiB	21
ARS007ss_ds.merged.samereadgroup.cleaned	386176	386184		mutL	8
ARS007ss_ds.merged.samereadgroup.cleaned	387198	387205		miaA	7
ARS007ss_ds.merged.samereadgroup.cleaned	389616	389634		hflX	18
ARS007ss_ds.merged.samereadgroup.cleaned	390932	390935		hflK	3
ARS007ss_ds.merged.samereadgroup.cleaned	391037	391048		hflK	11
ARS007ss_ds.merged.samereadgroup.cleaned	391611	391614		hflC	3
ARS007ss_ds.merged.samereadgroup.cleaned	392923	392924		YPO_RS02895	1
ARS007ss_ds.merged.samereadgroup.cleaned	393316	393354		YPO_RS02895	38
ARS007ss_ds.merged.samereadgroup.cleaned	394334	394427		nsrR	93
ARS007ss_ds.merged.samereadgroup.cleaned	399054	399074		YPO_RS02915	20
ARS007ss_ds.merged.samereadgroup.cleaned	399188	399191		YPO_RS02915	3
ARS007ss_ds.merged.samereadgroup.cleaned	401007	401042		YPO_RS02925	35
ARS007ss_ds.merged.samereadgroup.cleaned	403233	403240		YPO_RS02940	7
ARS007ss_ds.merged.samereadgroup.cleaned	403527	403531		YPO_RS02940	4
ARS007ss_ds.merged.samereadgroup.cleaned	404308	404324		YPO_RS02940	16
ARS007ss_ds.merged.samereadgroup.cleaned	405287	405290		YPO_RS02945	3
ARS007ss_ds.merged.samereadgroup.cleaned	407648	407667		YPO_RS02955	19
ARS007ss_ds.merged.samereadgroup.cleaned	407749	407780		YPO_RS02955	31
ARS007ss_ds.merged.samereadgroup.cleaned	408057	408065		YPO_RS02955	8
ARS007ss_ds.merged.samereadgroup.cleaned	408167	408199		YPO_RS02955	32
ARS007ss_ds.merged.samereadgroup.cleaned	408251	408253		YPO_RS02955	2
ARS007ss_ds.merged.samereadgroup.cleaned	408310	408336		YPO_RS02955	26
ARS007ss_ds.merged.samereadgroup.cleaned	408391	408400		YPO_RS02955	9
ARS007ss_ds.merged.samereadgroup.cleaned	408729	408735		YPO_RS02955	6
ARS007ss_ds.merged.samereadgroup.cleaned	409209	409218		YPO_RS02960	9
ARS007ss_ds.merged.samereadgroup.cleaned	409291	409296		YPO_RS02960	5
ARS007ss_ds.merged.samereadgroup.cleaned	409400	409411		YPO_RS02960	11
ARS007ss_ds.merged.samereadgroup.cleaned	409530	409546		YPO_RS02960	16
ARS007ss_ds.merged.samereadgroup.cleaned	409530	409593		YPO_RS02965	63
ARS007ss_ds.merged.samereadgroup.cleaned	409861	409880		YPO_RS02965	19
ARS007ss_ds.merged.samereadgroup.cleaned	409938	409951		YPO_RS02965	13
ARS007ss_ds.merged.samereadgroup.cleaned	409987	409998		YPO_RS02965	11
ARS007ss_ds.merged.samereadgroup.cleaned	410151	410161		YPO_RS02965	10
ARS007ss_ds.merged.samereadgroup.cleaned	410425	410429		YPO_RS02965	4
ARS007ss_ds.merged.samereadgroup.cleaned	410564	410599		YPO_RS02965	35
ARS007ss_ds.merged.samereadgroup.cleaned	410802	410815		YPO_RS02965	13
ARS007ss_ds.merged.samereadgroup.cleaned	410881	410891		YPO_RS02965	10
ARS007ss_ds.merged.samereadgroup.cleaned	411333	411350		YPO_RS02970	17
ARS007ss_ds.merged.samereadgroup.cleaned	413199	413219		YPO_RS02980	20
ARS007ss_ds.merged.samereadgroup.cleaned	413819	413823		YPO_RS02985	4
ARS007ss_ds.merged.samereadgroup.cleaned	414412	414418		YPO_RS02985	6
ARS007ss_ds.merged.samereadgroup.cleaned	414898	414907		YPO_RS02990	9
ARS007ss_ds.merged.samereadgroup.cleaned	415182	415234		YPO_RS02990	52
ARS007ss_ds.merged.samereadgroup.cleaned	415385	415386		YPO_RS02990	1
ARS007ss_ds.merged.samereadgroup.cleaned	415848	415854		YPO_RS02990	6
ARS007ss_ds.merged.samereadgroup.cleaned	416101	416115		YPO_RS02995	14
ARS007ss_ds.merged.samereadgroup.cleaned	416819	416829		YPO_RS02995	10
ARS007ss_ds.merged.samereadgroup.cleaned	418379	418400		YPO_RS03005	21
ARS007ss_ds.merged.samereadgroup.cleaned	419132	419136		YPO_RS03005	4
ARS007ss_ds.merged.samereadgroup.cleaned	420488	420507		YPO_RS03020	19
ARS007ss_ds.merged.samereadgroup.cleaned	421106	421110		YPO_RS03020	4
ARS007ss_ds.merged.samereadgroup.cleaned	422050	422083		ptsP	33
ARS007ss_ds.merged.samereadgroup.cleaned	422200	422243		ptsP	43
ARS007ss_ds.merged.samereadgroup.cleaned	422431	422436		ptsP	5
ARS007ss_ds.merged.samereadgroup.cleaned	422987	422998		ptsP	11
ARS007ss_ds.merged.samereadgroup.cleaned	423094	423097		ptsP	3
ARS007ss_ds.merged.samereadgroup.cleaned	424159	424165		ptsP	6
ARS007ss_ds.merged.samereadgroup.cleaned	426162	426172		lsrF	10
ARS007ss_ds.merged.samereadgroup.cleaned	427749	427789		lsrD	40
ARS007ss_ds.merged.samereadgroup.cleaned	428036	428044		lsrD	8
ARS007ss_ds.merged.samereadgroup.cleaned	428260	428272		lsrD	12
ARS007ss_ds.merged.samereadgroup.cleaned	428376	428421		lsrD	45
ARS007ss_ds.merged.samereadgroup.cleaned	429133	429138		lsrC	5
ARS007ss_ds.merged.samereadgroup.cleaned	429181	429211		lsrC	30
ARS007ss_ds.merged.samereadgroup.cleaned	429403	429415		lsrC	12
ARS007ss_ds.merged.samereadgroup.cleaned	429956	429962		lsrA	6
ARS007ss_ds.merged.samereadgroup.cleaned	431289	431332		YPO_RS03065	43
ARS007ss_ds.merged.samereadgroup.cleaned	432727	432732		lsrK	5
ARS007ss_ds.merged.samereadgroup.cleaned	433100	433117		lsrK	17
ARS007ss_ds.merged.samereadgroup.cleaned	435119	435124		rfaQ	5
ARS007ss_ds.merged.samereadgroup.cleaned	435686	435690		rfaQ	4
ARS007ss_ds.merged.samereadgroup.cleaned	435897	435908		YPO_RS03085	11
ARS007ss_ds.merged.samereadgroup.cleaned	436252	436255		YPO_RS03085	3
ARS007ss_ds.merged.samereadgroup.cleaned	436451	436466		YPO_RS03085	15
ARS007ss_ds.merged.samereadgroup.cleaned	438040	438053		YPO_RS03090	13
ARS007ss_ds.merged.samereadgroup.cleaned	439377	439380		YPO_RS03100	3
ARS007ss_ds.merged.samereadgroup.cleaned	440456	440461		YPO_RS03100	5
ARS007ss_ds.merged.samereadgroup.cleaned	440938	440956		YPO_RS03100	18
ARS007ss_ds.merged.samereadgroup.cleaned	441021	441032		YPO_RS03100	11
ARS007ss_ds.merged.samereadgroup.cleaned	443157	443159		YPO_RS03110	2
ARS007ss_ds.merged.samereadgroup.cleaned	443832	443847		YPO_RS03115	15
ARS007ss_ds.merged.samereadgroup.cleaned	445694	445697		YPO_RS03120	3
ARS007ss_ds.merged.samereadgroup.cleaned	445807	445811		YPO_RS03120	4
ARS007ss_ds.merged.samereadgroup.cleaned	446201	446259		YPO_RS03120	58
ARS007ss_ds.merged.samereadgroup.cleaned	446333	446338		YPO_RS03120	5
ARS007ss_ds.merged.samereadgroup.cleaned	447183	447192		YPO_RS03125	9
ARS007ss_ds.merged.samereadgroup.cleaned	447859	447862		rsmC	3
ARS007ss_ds.merged.samereadgroup.cleaned	448612	448621		rsmC	9
ARS007ss_ds.merged.samereadgroup.cleaned	449050	449057		YPO_RS03140	7
ARS007ss_ds.merged.samereadgroup.cleaned	449171	449175		YPO_RS03140	4
ARS007ss_ds.merged.samereadgroup.cleaned	450657	450674		prfC	17
ARS007ss_ds.merged.samereadgroup.cleaned	450989	450994		prfC	5
ARS007ss_ds.merged.samereadgroup.cleaned	451841	451849		osmY	8
ARS007ss_ds.merged.samereadgroup.cleaned	452226	452247		osmY	21
ARS007ss_ds.merged.samereadgroup.cleaned	452719	452723		YPO_RS03160	4
ARS007ss_ds.merged.samereadgroup.cleaned	453348	453374		YPO_RS03165	26
ARS007ss_ds.merged.samereadgroup.cleaned	453980	453982		YPO_RS03165	2
ARS007ss_ds.merged.samereadgroup.cleaned	454301	454302		YPO_RS03170	1
ARS007ss_ds.merged.samereadgroup.cleaned	454636	454639		YPO_RS03170	3
ARS007ss_ds.merged.samereadgroup.cleaned	456572	456588		YPO_RS03175	16
ARS007ss_ds.merged.samereadgroup.cleaned	459678	459679		deoB	1
ARS007ss_ds.merged.samereadgroup.cleaned	460296	460304		deoB	8
ARS007ss_ds.merged.samereadgroup.cleaned	461572	461586		deoD	14
ARS007ss_ds.merged.samereadgroup.cleaned	461920	461925		YPO_RS03200	5
ARS007ss_ds.merged.samereadgroup.cleaned	462990	462994		serB	4
ARS007ss_ds.merged.samereadgroup.cleaned	464346	464351		radA	5
ARS007ss_ds.merged.samereadgroup.cleaned	465137	465143		radA	6
ARS007ss_ds.merged.samereadgroup.cleaned	466235	466236		nadR	1
ARS007ss_ds.merged.samereadgroup.cleaned	466413	466429		nadR	16
ARS007ss_ds.merged.samereadgroup.cleaned	467490	467501		YPO_RS03220	11
ARS007ss_ds.merged.samereadgroup.cleaned	470333	470350		YPO_RS03230	17
ARS007ss_ds.merged.samereadgroup.cleaned	472193	472195		YPO_RS03240	2
ARS007ss_ds.merged.samereadgroup.cleaned	473468	473469		YPO_RS03245	1
ARS007ss_ds.merged.samereadgroup.cleaned	475167	475169		YPO_RS03245	2
ARS007ss_ds.merged.samereadgroup.cleaned	475403	475416		YPO_RS03245	13
ARS007ss_ds.merged.samereadgroup.cleaned	476483	476494		sltY	11
ARS007ss_ds.merged.samereadgroup.cleaned	476989	476991		sltY	2
ARS007ss_ds.merged.samereadgroup.cleaned	477770	477775		sltY	5
ARS007ss_ds.merged.samereadgroup.cleaned	478850	478855		yjjX	5
ARS007ss_ds.merged.samereadgroup.cleaned	479632	479640		gpmB	8
ARS007ss_ds.merged.samereadgroup.cleaned	482280	482285		arcA	5
ARS007ss_ds.merged.samereadgroup.cleaned	483712	483714		thrA	2
ARS007ss_ds.merged.samereadgroup.cleaned	484431	484443		thrA	12
ARS007ss_ds.merged.samereadgroup.cleaned	489980	489982		YPO_RS03310	2
ARS007ss_ds.merged.samereadgroup.cleaned	491445	491447		mog	2
ARS007ss_ds.merged.samereadgroup.cleaned	491632	491642		mog	10
ARS007ss_ds.merged.samereadgroup.cleaned	491797	491802		mog	5
ARS007ss_ds.merged.samereadgroup.cleaned	491976	491982		mog	6
ARS007ss_ds.merged.samereadgroup.cleaned	492557	492606		YPO_RS03325	49
ARS007ss_ds.merged.samereadgroup.cleaned	492794	492797		YPO_RS03325	3
ARS007ss_ds.merged.samereadgroup.cleaned	493034	493039		YPO_RS03325	5
ARS007ss_ds.merged.samereadgroup.cleaned	493420	493422		YPO_RS03325	2
ARS007ss_ds.merged.samereadgroup.cleaned	493456	493458		YPO_RS03325	2
ARS007ss_ds.merged.samereadgroup.cleaned	494213	494239		YPO_RS03330	26
ARS007ss_ds.merged.samereadgroup.cleaned	494471	494494		YPO_RS03330	23
ARS007ss_ds.merged.samereadgroup.cleaned	494984	495007		YPO_RS03330	23
ARS007ss_ds.merged.samereadgroup.cleaned	495373	495394		YPO_RS03330	21
ARS007ss_ds.merged.samereadgroup.cleaned	495763	495825		YPO_RS03330	62
ARS007ss_ds.merged.samereadgroup.cleaned	498020	498022		dnaK	2
ARS007ss_ds.merged.samereadgroup.cleaned	498465	498473		dnaK	8
ARS007ss_ds.merged.samereadgroup.cleaned	500070	500073		dnaJ	3
ARS007ss_ds.merged.samereadgroup.cleaned	500312	500319		dnaJ	7
ARS007ss_ds.merged.samereadgroup.cleaned	500841	500847		nhaA	6
ARS007ss_ds.merged.samereadgroup.cleaned	501057	501063		nhaA	6
ARS007ss_ds.merged.samereadgroup.cleaned	502130	502131		nhaR	1
ARS007ss_ds.merged.samereadgroup.cleaned	502819	502822		nhaR	3
ARS007ss_ds.merged.samereadgroup.cleaned	503267	503269		rpsT	2
ARS007ss_ds.merged.samereadgroup.cleaned	506292	506297		ileS	5
ARS007ss_ds.merged.samereadgroup.cleaned	508402	508405		fkpB	3
ARS007ss_ds.merged.samereadgroup.cleaned	508681	508701		ispH	20
ARS007ss_ds.merged.samereadgroup.cleaned	508951	508985		ispH	34
ARS007ss_ds.merged.samereadgroup.cleaned	510906	510914		dapB	8
ARS007ss_ds.merged.samereadgroup.cleaned	512979	512984		carA	5
ARS007ss_ds.merged.samereadgroup.cleaned	513085	513089		carA	4
ARS007ss_ds.merged.samereadgroup.cleaned	516323	516327		carB	4
ARS007ss_ds.merged.samereadgroup.cleaned	517964	517978		YPO_RS03425	14
ARS007ss_ds.merged.samereadgroup.cleaned	518463	518467		YPO_RS03425	4
ARS007ss_ds.merged.samereadgroup.cleaned	518503	518573		YPO_RS03430	70
ARS007ss_ds.merged.samereadgroup.cleaned	518726	518730		YPO_RS03430	4
ARS007ss_ds.merged.samereadgroup.cleaned	519290	519304		folA	14
ARS007ss_ds.merged.samereadgroup.cleaned	520994	521007		YPO_RS03445	13
ARS007ss_ds.merged.samereadgroup.cleaned	521134	521149		YPO_RS03450	15
ARS007ss_ds.merged.samereadgroup.cleaned	522373	522383		apaH	10
ARS007ss_ds.merged.samereadgroup.cleaned	524533	524540		pdxA	7
ARS007ss_ds.merged.samereadgroup.cleaned	524575	524583		pdxA	8
ARS007ss_ds.merged.samereadgroup.cleaned	525556	525566		surA	10
ARS007ss_ds.merged.samereadgroup.cleaned	526424	526460		lptD	36
ARS007ss_ds.merged.samereadgroup.cleaned	526702	526703		lptD	1
ARS007ss_ds.merged.samereadgroup.cleaned	526895	526897		lptD	2
ARS007ss_ds.merged.samereadgroup.cleaned	526982	527012		lptD	30
ARS007ss_ds.merged.samereadgroup.cleaned	527338	527339		lptD	1
ARS007ss_ds.merged.samereadgroup.cleaned	528064	528076		lptD	12
ARS007ss_ds.merged.samereadgroup.cleaned	528166	528175		lptD	9
ARS007ss_ds.merged.samereadgroup.cleaned	529922	529928		rluA	6
ARS007ss_ds.merged.samereadgroup.cleaned	532070	532074		YPO_RS03495	4
ARS007ss_ds.merged.samereadgroup.cleaned	533049	533063		YPO_RS03500	14
ARS007ss_ds.merged.samereadgroup.cleaned	533230	533231		YPO_RS03500	1
ARS007ss_ds.merged.samereadgroup.cleaned	534418	534435		tssC	17
ARS007ss_ds.merged.samereadgroup.cleaned	534616	534618		tssC	2
ARS007ss_ds.merged.samereadgroup.cleaned	535210	535217		tssC	7
ARS007ss_ds.merged.samereadgroup.cleaned	535704	535720		tssC	16
ARS007ss_ds.merged.samereadgroup.cleaned	536013	536032		YPO_RS03515	19
ARS007ss_ds.merged.samereadgroup.cleaned	536086	536089		YPO_RS03515	3
ARS007ss_ds.merged.samereadgroup.cleaned	536283	536287		YPO_RS03515	4
ARS007ss_ds.merged.samereadgroup.cleaned	536900	536913		YPO_RS03520	13
ARS007ss_ds.merged.samereadgroup.cleaned	538059	538072		tssF	13
ARS007ss_ds.merged.samereadgroup.cleaned	538818	538827		tssF	9
ARS007ss_ds.merged.samereadgroup.cleaned	540230	540232		tssH	2
ARS007ss_ds.merged.samereadgroup.cleaned	540799	540800		tssH	1
ARS007ss_ds.merged.samereadgroup.cleaned	541349	541360		tssH	11
ARS007ss_ds.merged.samereadgroup.cleaned	541433	541442		tssH	9
ARS007ss_ds.merged.samereadgroup.cleaned	541834	541840		tssH	6
ARS007ss_ds.merged.samereadgroup.cleaned	542153	542156		tssH	3
ARS007ss_ds.merged.samereadgroup.cleaned	542759	542780		vgrG	21
ARS007ss_ds.merged.samereadgroup.cleaned	543099	543102		vgrG	3
ARS007ss_ds.merged.samereadgroup.cleaned	544319	544339		vgrG	20
ARS007ss_ds.merged.samereadgroup.cleaned	544401	544487		vgrG	86
ARS007ss_ds.merged.samereadgroup.cleaned	544616	544618		vgrG	2
ARS007ss_ds.merged.samereadgroup.cleaned	544651	544653		vgrG	2
ARS007ss_ds.merged.samereadgroup.cleaned	544763	544814		vgrG	51
ARS007ss_ds.merged.samereadgroup.cleaned	545282	545308		YPO_RS03545	26
ARS007ss_ds.merged.samereadgroup.cleaned	545427	545429		YPO_RS03545	2
ARS007ss_ds.merged.samereadgroup.cleaned	546696	546701		YPO_RS03550	5
ARS007ss_ds.merged.samereadgroup.cleaned	547455	547479		YPO_RS03555	24
ARS007ss_ds.merged.samereadgroup.cleaned	547587	547589		YPO_RS03555	2
ARS007ss_ds.merged.samereadgroup.cleaned	548668	548670		YPO_RS03560	2
ARS007ss_ds.merged.samereadgroup.cleaned	549099	549110		YPO_RS03565	11
ARS007ss_ds.merged.samereadgroup.cleaned	549417	549424		tssJ	7
ARS007ss_ds.merged.samereadgroup.cleaned	549470	549483		tssJ	13
ARS007ss_ds.merged.samereadgroup.cleaned	550012	550016		tssK	4
ARS007ss_ds.merged.samereadgroup.cleaned	550583	550594		tssK	11
ARS007ss_ds.merged.samereadgroup.cleaned	551382	551383		YPO_RS03580	1
ARS007ss_ds.merged.samereadgroup.cleaned	551799	551803		YPO_RS03580	4
ARS007ss_ds.merged.samereadgroup.cleaned	552402	552410		YPO_RS03580	8
ARS007ss_ds.merged.samereadgroup.cleaned	552878	552886		tssM	8
ARS007ss_ds.merged.samereadgroup.cleaned	552923	552928		tssM	5
ARS007ss_ds.merged.samereadgroup.cleaned	553209	553212		tssM	3
ARS007ss_ds.merged.samereadgroup.cleaned	554886	554888		tssM	2
ARS007ss_ds.merged.samereadgroup.cleaned	556063	556066		tssM	3
ARS007ss_ds.merged.samereadgroup.cleaned	556450	556459		YPO_RS03590	9
ARS007ss_ds.merged.samereadgroup.cleaned	557610	557612		rapA	2
ARS007ss_ds.merged.samereadgroup.cleaned	558347	558348		rapA	1
ARS007ss_ds.merged.samereadgroup.cleaned	558581	558588		rapA	7
ARS007ss_ds.merged.samereadgroup.cleaned	558776	558780		rapA	4
ARS007ss_ds.merged.samereadgroup.cleaned	559000	559004		rapA	4
ARS007ss_ds.merged.samereadgroup.cleaned	559378	559399		rapA	21
ARS007ss_ds.merged.samereadgroup.cleaned	560327	560342		YPO_RS03600	15
ARS007ss_ds.merged.samereadgroup.cleaned	560470	560488		YPO_RS03600	18
ARS007ss_ds.merged.samereadgroup.cleaned	560784	560787		YPO_RS03600	3
ARS007ss_ds.merged.samereadgroup.cleaned	561099	561104		YPO_RS03600	5
ARS007ss_ds.merged.samereadgroup.cleaned	561737	561753		YPO_RS03600	16
ARS007ss_ds.merged.samereadgroup.cleaned	562293	562308		YPO_RS03600	15
ARS007ss_ds.merged.samereadgroup.cleaned	562647	562661		YPO_RS03600	14
ARS007ss_ds.merged.samereadgroup.cleaned	562968	562999		YPO_RS03605	31
ARS007ss_ds.merged.samereadgroup.cleaned	564010	564029		thiQ	19
ARS007ss_ds.merged.samereadgroup.cleaned	564219	564223		thiQ	4
ARS007ss_ds.merged.samereadgroup.cleaned	564768	564797		thiP	29
ARS007ss_ds.merged.samereadgroup.cleaned	568951	568963		YPO_RS03625	12
ARS007ss_ds.merged.samereadgroup.cleaned	573140	573141		YPO_RS03645	1
ARS007ss_ds.merged.samereadgroup.cleaned	573711	573713		leuD	2
ARS007ss_ds.merged.samereadgroup.cleaned	575263	575278		leuC	15
ARS007ss_ds.merged.samereadgroup.cleaned	575988	575989		leuB	1
ARS007ss_ds.merged.samereadgroup.cleaned	576317	576318		leuB	1
ARS007ss_ds.merged.samereadgroup.cleaned	576921	576923		leuA	2
ARS007ss_ds.merged.samereadgroup.cleaned	576967	576978		leuA	11
ARS007ss_ds.merged.samereadgroup.cleaned	578204	578221		leuA	17
ARS007ss_ds.merged.samereadgroup.cleaned	579542	579551		YPO_RS03675	9
ARS007ss_ds.merged.samereadgroup.cleaned	580499	580508		leuO	9
ARS007ss_ds.merged.samereadgroup.cleaned	580931	580957		leuO	26
ARS007ss_ds.merged.samereadgroup.cleaned	581049	581053		leuO	4
ARS007ss_ds.merged.samereadgroup.cleaned	582022	582049		YPO_RS03685	27
ARS007ss_ds.merged.samereadgroup.cleaned	583164	583183		YPO_RS03685	19
ARS007ss_ds.merged.samereadgroup.cleaned	585546	585561		ilvI	15
ARS007ss_ds.merged.samereadgroup.cleaned	588157	588165		cra	8
ARS007ss_ds.merged.samereadgroup.cleaned	592191	592193		YPO_RS03735	2
ARS007ss_ds.merged.samereadgroup.cleaned	594086	594103		murE	17
ARS007ss_ds.merged.samereadgroup.cleaned	595334	595357		murF	23
ARS007ss_ds.merged.samereadgroup.cleaned	596044	596053		murF	9
ARS007ss_ds.merged.samereadgroup.cleaned	596607	596615		mraY	8
ARS007ss_ds.merged.samereadgroup.cleaned	597793	597798		murD	5
ARS007ss_ds.merged.samereadgroup.cleaned	598404	598426		murD	22
ARS007ss_ds.merged.samereadgroup.cleaned	598932	598977		ftsW	45
ARS007ss_ds.merged.samereadgroup.cleaned	599459	599473		ftsW	14
ARS007ss_ds.merged.samereadgroup.cleaned	600863	600870		murG	7
ARS007ss_ds.merged.samereadgroup.cleaned	601897	601906		murC	9
ARS007ss_ds.merged.samereadgroup.cleaned	603026	603030		YPO_RS03775	4
ARS007ss_ds.merged.samereadgroup.cleaned	603872	603878		ftsQ	6
ARS007ss_ds.merged.samereadgroup.cleaned	605028	605032		ftsA	4
ARS007ss_ds.merged.samereadgroup.cleaned	606760	606761		ftsZ	1
ARS007ss_ds.merged.samereadgroup.cleaned	606891	606895		ftsZ	4
ARS007ss_ds.merged.samereadgroup.cleaned	616400	616414		YPO_RS03845	14
ARS007ss_ds.merged.samereadgroup.cleaned	616447	616462		YPO_RS03845	15
ARS007ss_ds.merged.samereadgroup.cleaned	616951	616955		YPO_RS03855	4
ARS007ss_ds.merged.samereadgroup.cleaned	618055	618061		YPO_RS03865	6
ARS007ss_ds.merged.samereadgroup.cleaned	618137	618141		YPO_RS03865	4
ARS007ss_ds.merged.samereadgroup.cleaned	618485	618493		YPO_RS03865	8
ARS007ss_ds.merged.samereadgroup.cleaned	619709	619710		exuR	1
ARS007ss_ds.merged.samereadgroup.cleaned	621027	621034		YPO_RS03880	7
ARS007ss_ds.merged.samereadgroup.cleaned	621124	621133		YPO_RS03880	9
ARS007ss_ds.merged.samereadgroup.cleaned	621743	621746		YPO_RS03880	3
ARS007ss_ds.merged.samereadgroup.cleaned	625004	625008		YPO_RS03890	4
ARS007ss_ds.merged.samereadgroup.cleaned	625567	625573		YPO_RS03890	6
ARS007ss_ds.merged.samereadgroup.cleaned	627732	627751		YPO_RS03900	19
ARS007ss_ds.merged.samereadgroup.cleaned	627864	627865		YPO_RS03900	1
ARS007ss_ds.merged.samereadgroup.cleaned	629122	629199		sstT	77
ARS007ss_ds.merged.samereadgroup.cleaned	629390	629393		sstT	3
ARS007ss_ds.merged.samereadgroup.cleaned	631265	631267		YPO_RS03915	2
ARS007ss_ds.merged.samereadgroup.cleaned	631858	631903		YPO_RS03920	45
ARS007ss_ds.merged.samereadgroup.cleaned	632846	632848		yapG	2
ARS007ss_ds.merged.samereadgroup.cleaned	633805	633807		yapG	2
ARS007ss_ds.merged.samereadgroup.cleaned	633944	633946		yapG	2
ARS007ss_ds.merged.samereadgroup.cleaned	634161	634173		yapG	12
ARS007ss_ds.merged.samereadgroup.cleaned	634308	634313		yapG	5
ARS007ss_ds.merged.samereadgroup.cleaned	634518	634543		yapG	25
ARS007ss_ds.merged.samereadgroup.cleaned	634998	635005		yapG	7
ARS007ss_ds.merged.samereadgroup.cleaned	635301	635306		yapG	5
ARS007ss_ds.merged.samereadgroup.cleaned	635496	635534		yapG	38
ARS007ss_ds.merged.samereadgroup.cleaned	636340	636341		rlmG	1
ARS007ss_ds.merged.samereadgroup.cleaned	636893	636894		rlmG	1
ARS007ss_ds.merged.samereadgroup.cleaned	637709	637721		YPO_RS03935	12
ARS007ss_ds.merged.samereadgroup.cleaned	637923	637924		YPO_RS03935	1
ARS007ss_ds.merged.samereadgroup.cleaned	638123	638159		YPO_RS03935	36
ARS007ss_ds.merged.samereadgroup.cleaned	639138	639146		YPO_RS03935	8
ARS007ss_ds.merged.samereadgroup.cleaned	640639	640666		YPO_RS03945	27
ARS007ss_ds.merged.samereadgroup.cleaned	641538	641554		YPO_RS03945	16
ARS007ss_ds.merged.samereadgroup.cleaned	642478	642488		YPO_RS03950	10
ARS007ss_ds.merged.samereadgroup.cleaned	642844	642847		YPO_RS03950	3
ARS007ss_ds.merged.samereadgroup.cleaned	644584	644600		YPO_RS03955	16
ARS007ss_ds.merged.samereadgroup.cleaned	645194	645199		YPO_RS03960	5
ARS007ss_ds.merged.samereadgroup.cleaned	645688	645697		YPO_RS03965	9
ARS007ss_ds.merged.samereadgroup.cleaned	646542	646544		YPO_RS03970	2
ARS007ss_ds.merged.samereadgroup.cleaned	646732	646735		YPO_RS03970	3
ARS007ss_ds.merged.samereadgroup.cleaned	650353	650354		cdiA	1
ARS007ss_ds.merged.samereadgroup.cleaned	650536	650552		cdiA	16
ARS007ss_ds.merged.samereadgroup.cleaned	652821	652842		cdiA	21
ARS007ss_ds.merged.samereadgroup.cleaned	653441	653475		cdiA	34
ARS007ss_ds.merged.samereadgroup.cleaned	653723	653742		cdiA	19
ARS007ss_ds.merged.samereadgroup.cleaned	654089	654093		cdiA	4
ARS007ss_ds.merged.samereadgroup.cleaned	654342	654349		cdiA	7
ARS007ss_ds.merged.samereadgroup.cleaned	654549	654583		cdiA	34
ARS007ss_ds.merged.samereadgroup.cleaned	655286	655298		cdiA	12
ARS007ss_ds.merged.samereadgroup.cleaned	655829	655831		cdiA	2
ARS007ss_ds.merged.samereadgroup.cleaned	656465	656466		cdiA	1
ARS007ss_ds.merged.samereadgroup.cleaned	657643	657688		cdiA	45
ARS007ss_ds.merged.samereadgroup.cleaned	657928	657935		cdiA	7
ARS007ss_ds.merged.samereadgroup.cleaned	659137	659170		cdiA	33
ARS007ss_ds.merged.samereadgroup.cleaned	659214	659240		cdiI	26
ARS007ss_ds.merged.samereadgroup.cleaned	659376	659394		cdiI	18
ARS007ss_ds.merged.samereadgroup.cleaned	660157	660165		YPO_RS04005	8
ARS007ss_ds.merged.samereadgroup.cleaned	660481	660484		YPO_RS04010	3
ARS007ss_ds.merged.samereadgroup.cleaned	661015	661025		YPO_RS04010	10
ARS007ss_ds.merged.samereadgroup.cleaned	661896	661900		yapF	4
ARS007ss_ds.merged.samereadgroup.cleaned	662190	662237		yapF	47
ARS007ss_ds.merged.samereadgroup.cleaned	662408	662417		yapF	9
ARS007ss_ds.merged.samereadgroup.cleaned	662520	662521		yapF	1
ARS007ss_ds.merged.samereadgroup.cleaned	662862	662863		yapF	1
ARS007ss_ds.merged.samereadgroup.cleaned	663485	663488		yapF	3
ARS007ss_ds.merged.samereadgroup.cleaned	666877	666878		YPO_RS04035	1
ARS007ss_ds.merged.samereadgroup.cleaned	667975	667987		YPO_RS04035	12
ARS007ss_ds.merged.samereadgroup.cleaned	668145	668149		YPO_RS04040	4
ARS007ss_ds.merged.samereadgroup.cleaned	668194	668202		YPO_RS04040	8
ARS007ss_ds.merged.samereadgroup.cleaned	668935	668953		YPO_RS04040	18
ARS007ss_ds.merged.samereadgroup.cleaned	669189	669239		YPO_RS04040	50
ARS007ss_ds.merged.samereadgroup.cleaned	669601	669602		YPO_RS04040	1
ARS007ss_ds.merged.samereadgroup.cleaned	669678	669684		YPO_RS04040	6
ARS007ss_ds.merged.samereadgroup.cleaned	669893	669910		YPO_RS04040	17
ARS007ss_ds.merged.samereadgroup.cleaned	670604	670620		YPO_RS04040	16
ARS007ss_ds.merged.samereadgroup.cleaned	670738	670739		YPO_RS04040	1
ARS007ss_ds.merged.samereadgroup.cleaned	672277	672279		YPO_RS04045	2
ARS007ss_ds.merged.samereadgroup.cleaned	672617	672650		YPO_RS04050	33
ARS007ss_ds.merged.samereadgroup.cleaned	672768	672781		YPO_RS04050	13
ARS007ss_ds.merged.samereadgroup.cleaned	672815	672816		YPO_RS04050	1
ARS007ss_ds.merged.samereadgroup.cleaned	673965	673972		YPO_RS04055	7
ARS007ss_ds.merged.samereadgroup.cleaned	674628	674640		YPO_RS04055	12
ARS007ss_ds.merged.samereadgroup.cleaned	675111	675154		YPO_RS04060	43
ARS007ss_ds.merged.samereadgroup.cleaned	675205	675210		YPO_RS04060	5
ARS007ss_ds.merged.samereadgroup.cleaned	675917	675924		YPO_RS04065	7
ARS007ss_ds.merged.samereadgroup.cleaned	675967	675973		YPO_RS04065	6
ARS007ss_ds.merged.samereadgroup.cleaned	676922	676929		YPO_RS04070	7
ARS007ss_ds.merged.samereadgroup.cleaned	677405	677413		YPO_RS04070	8
ARS007ss_ds.merged.samereadgroup.cleaned	677693	677696		YPO_RS04070	3
ARS007ss_ds.merged.samereadgroup.cleaned	678596	678597		YPO_RS04075	1
ARS007ss_ds.merged.samereadgroup.cleaned	679100	679101		YPO_RS04075	1
ARS007ss_ds.merged.samereadgroup.cleaned	679374	679382		YPO_RS04075	8
ARS007ss_ds.merged.samereadgroup.cleaned	680429	680430		YPO_RS04080	1
ARS007ss_ds.merged.samereadgroup.cleaned	680635	680646		YPO_RS04080	11
ARS007ss_ds.merged.samereadgroup.cleaned	680828	680830		YPO_RS04080	2
ARS007ss_ds.merged.samereadgroup.cleaned	681055	681057		YPO_RS04080	2
ARS007ss_ds.merged.samereadgroup.cleaned	681454	681457		YPO_RS04080	3
ARS007ss_ds.merged.samereadgroup.cleaned	682056	682064		mdtN	8
ARS007ss_ds.merged.samereadgroup.cleaned	682279	682280		mdtN	1
ARS007ss_ds.merged.samereadgroup.cleaned	682768	682770		mdtN	2
ARS007ss_ds.merged.samereadgroup.cleaned	682858	682867		mdtN	9
ARS007ss_ds.merged.samereadgroup.cleaned	684402	684421		YPO_RS04100	19
ARS007ss_ds.merged.samereadgroup.cleaned	684605	684616		YPO_RS04100	11
ARS007ss_ds.merged.samereadgroup.cleaned	685218	685222		YPO_RS04100	4
ARS007ss_ds.merged.samereadgroup.cleaned	685263	685291		YPO_RS04100	28
ARS007ss_ds.merged.samereadgroup.cleaned	686842	686851		YPO_RS04105	9
ARS007ss_ds.merged.samereadgroup.cleaned	686864	686882		YPO_RS04110	18
ARS007ss_ds.merged.samereadgroup.cleaned	687274	687301		YPO_RS04110	27
ARS007ss_ds.merged.samereadgroup.cleaned	687912	687958		YPO_RS04115	46
ARS007ss_ds.merged.samereadgroup.cleaned	688172	688176		YPO_RS04120	4
ARS007ss_ds.merged.samereadgroup.cleaned	688982	688987		YPO_RS04125	5
ARS007ss_ds.merged.samereadgroup.cleaned	689088	689093		YPO_RS04125	5
ARS007ss_ds.merged.samereadgroup.cleaned	690618	690630		YPO_RS04135	12
ARS007ss_ds.merged.samereadgroup.cleaned	696009	696010		YPO_RS04170	1
ARS007ss_ds.merged.samereadgroup.cleaned	696058	696061		YPO_RS04170	3
ARS007ss_ds.merged.samereadgroup.cleaned	696382	696387		YPO_RS04170	5
ARS007ss_ds.merged.samereadgroup.cleaned	700248	700249		rpoD	1
ARS007ss_ds.merged.samereadgroup.cleaned	700886	700896		rpoD	10
ARS007ss_ds.merged.samereadgroup.cleaned	702276	702278		dnaG	2
ARS007ss_ds.merged.samereadgroup.cleaned	702392	702415		dnaG	23
ARS007ss_ds.merged.samereadgroup.cleaned	703876	703877		tsaD	1
ARS007ss_ds.merged.samereadgroup.cleaned	703968	703974		tsaD	6
ARS007ss_ds.merged.samereadgroup.cleaned	704232	704252		tsaD	20
ARS007ss_ds.merged.samereadgroup.cleaned	704998	705018		plsY	20
ARS007ss_ds.merged.samereadgroup.cleaned	705472	705474		plsY	2
ARS007ss_ds.merged.samereadgroup.cleaned	708142	708143		YPO_RS04230	1
ARS007ss_ds.merged.samereadgroup.cleaned	708345	708346		YPO_RS04230	1
ARS007ss_ds.merged.samereadgroup.cleaned	708490	708491		YPO_RS04230	1
ARS007ss_ds.merged.samereadgroup.cleaned	708542	708570		YPO_RS04230	28
ARS007ss_ds.merged.samereadgroup.cleaned	709246	709252		YPO_RS04235	6
ARS007ss_ds.merged.samereadgroup.cleaned	710982	710988		YPO_RS04240	6
ARS007ss_ds.merged.samereadgroup.cleaned	714257	714267		hldE	10
ARS007ss_ds.merged.samereadgroup.cleaned	714915	714923		hldE	8
ARS007ss_ds.merged.samereadgroup.cleaned	715259	715270		hldE	11
ARS007ss_ds.merged.samereadgroup.cleaned	716821	716829		yjeH	8
ARS007ss_ds.merged.samereadgroup.cleaned	719358	719373		ygiD	15
ARS007ss_ds.merged.samereadgroup.cleaned	719589	719604		ygiD	15
ARS007ss_ds.merged.samereadgroup.cleaned	719812	719818		ygiD	6
ARS007ss_ds.merged.samereadgroup.cleaned	721101	721104		YPO_RS04275	3
ARS007ss_ds.merged.samereadgroup.cleaned	720878	720901		YPO_RS04275	23
ARS007ss_ds.merged.samereadgroup.cleaned	721944	721949		YPO_RS04280	5
ARS007ss_ds.merged.samereadgroup.cleaned	722801	722811		tolC	10
ARS007ss_ds.merged.samereadgroup.cleaned	723089	723109		tolC	20
ARS007ss_ds.merged.samereadgroup.cleaned	723427	723450		tolC	23
ARS007ss_ds.merged.samereadgroup.cleaned	724533	724553		nudF	20
ARS007ss_ds.merged.samereadgroup.cleaned	725856	725875		cpdA	19
ARS007ss_ds.merged.samereadgroup.cleaned	725923	725939		cpdA	16
ARS007ss_ds.merged.samereadgroup.cleaned	726454	726477		yqiA	23
ARS007ss_ds.merged.samereadgroup.cleaned	727756	727766		parE	10
ARS007ss_ds.merged.samereadgroup.cleaned	728052	728064		parE	12
ARS007ss_ds.merged.samereadgroup.cleaned	728590	728597		parE	7
ARS007ss_ds.merged.samereadgroup.cleaned	728984	728991		YPO_RS04315	7
ARS007ss_ds.merged.samereadgroup.cleaned	729466	729470		YPO_RS04315	4
ARS007ss_ds.merged.samereadgroup.cleaned	730203	730219		YPO_RS04320	16
ARS007ss_ds.merged.samereadgroup.cleaned	730821	730831		parC	10
ARS007ss_ds.merged.samereadgroup.cleaned	731088	731109		parC	21
ARS007ss_ds.merged.samereadgroup.cleaned	732849	732864		parC	15
ARS007ss_ds.merged.samereadgroup.cleaned	733665	733666		YPO_RS04335	1
ARS007ss_ds.merged.samereadgroup.cleaned	735220	735232		ftsP	12
ARS007ss_ds.merged.samereadgroup.cleaned	739983	740031		yqhD	48
ARS007ss_ds.merged.samereadgroup.cleaned	740157	740160		yqhD	3
ARS007ss_ds.merged.samereadgroup.cleaned	740272	740287		yqhD	15
ARS007ss_ds.merged.samereadgroup.cleaned	740468	740473		yqhD	5
ARS007ss_ds.merged.samereadgroup.cleaned	741311	741320		YPO_RS04365	9
ARS007ss_ds.merged.samereadgroup.cleaned	741518	741527		YPO_RS04365	9
ARS007ss_ds.merged.samereadgroup.cleaned	741715	741722		YPO_RS04365	7
ARS007ss_ds.merged.samereadgroup.cleaned	743676	743680		metC	4
ARS007ss_ds.merged.samereadgroup.cleaned	743877	743880		metC	3
ARS007ss_ds.merged.samereadgroup.cleaned	744822	744839		exbB	17
ARS007ss_ds.merged.samereadgroup.cleaned	745498	745501		exbB	3
ARS007ss_ds.merged.samereadgroup.cleaned	747056	747080		YPO_RS04390	24
ARS007ss_ds.merged.samereadgroup.cleaned	747136	747140		YPO_RS04390	4
ARS007ss_ds.merged.samereadgroup.cleaned	747184	747189		YPO_RS04390	5
ARS007ss_ds.merged.samereadgroup.cleaned	747501	747508		YPO_RS04390	7
ARS007ss_ds.merged.samereadgroup.cleaned	747592	747604		YPO_RS04390	12
ARS007ss_ds.merged.samereadgroup.cleaned	747805	747823		YPO_RS04390	18
ARS007ss_ds.merged.samereadgroup.cleaned	747894	747944		YPO_RS04395	50
ARS007ss_ds.merged.samereadgroup.cleaned	748214	748236		YPO_RS04395	22
ARS007ss_ds.merged.samereadgroup.cleaned	748542	748574		YPO_RS04400	32
ARS007ss_ds.merged.samereadgroup.cleaned	749285	749313		YPO_RS04405	28
ARS007ss_ds.merged.samereadgroup.cleaned	750130	750210		YPO_RS04410	80
ARS007ss_ds.merged.samereadgroup.cleaned	750261	750282		YPO_RS04410	21
ARS007ss_ds.merged.samereadgroup.cleaned	750426	750462		YPO_RS04410	36
ARS007ss_ds.merged.samereadgroup.cleaned	750459	750556		YPO_RS04415	97
ARS007ss_ds.merged.samereadgroup.cleaned	750915	750952		YPO_RS04415	37
ARS007ss_ds.merged.samereadgroup.cleaned	751097	751139		YPO_RS04415	42
ARS007ss_ds.merged.samereadgroup.cleaned	751884	751886		YPO_RS04420	2
ARS007ss_ds.merged.samereadgroup.cleaned	752607	752617		YPO_RS04420	10
ARS007ss_ds.merged.samereadgroup.cleaned	752629	752678		YPO_RS04425	49
ARS007ss_ds.merged.samereadgroup.cleaned	752920	752925		YPO_RS04425	5
ARS007ss_ds.merged.samereadgroup.cleaned	753307	753316		YPO_RS04425	9
ARS007ss_ds.merged.samereadgroup.cleaned	753523	753548		YPO_RS04425	25
ARS007ss_ds.merged.samereadgroup.cleaned	753739	753756		YPO_RS04425	17
ARS007ss_ds.merged.samereadgroup.cleaned	754423	754454		YPO_RS04435	31
ARS007ss_ds.merged.samereadgroup.cleaned	754854	754857		YPO_RS04440	3
ARS007ss_ds.merged.samereadgroup.cleaned	755250	755257		YPO_RS04440	7
ARS007ss_ds.merged.samereadgroup.cleaned	755318	755372		YPO_RS04440	54
ARS007ss_ds.merged.samereadgroup.cleaned	755369	755374		YPO_RS04445	5
ARS007ss_ds.merged.samereadgroup.cleaned	755530	755533		YPO_RS04445	3
ARS007ss_ds.merged.samereadgroup.cleaned	755593	755597		YPO_RS04445	4
ARS007ss_ds.merged.samereadgroup.cleaned	755791	755798		YPO_RS04445	7
ARS007ss_ds.merged.samereadgroup.cleaned	755979	755981		YPO_RS04445	2
ARS007ss_ds.merged.samereadgroup.cleaned	756661	756666		YPO_RS04450	5
ARS007ss_ds.merged.samereadgroup.cleaned	758430	760204		YPO_RS04465	1774
ARS007ss_ds.merged.samereadgroup.cleaned	760249	760682		YPO_RS04465	433
ARS007ss_ds.merged.samereadgroup.cleaned	760743	760910		YPO_RS04465	167
ARS007ss_ds.merged.samereadgroup.cleaned	760928	761647		YPO_RS04470	719
ARS007ss_ds.merged.samereadgroup.cleaned	761672	762778		YPO_RS04475	1106
ARS007ss_ds.merged.samereadgroup.cleaned	762990	764069		fepB	1079
ARS007ss_ds.merged.samereadgroup.cleaned	764925	765920		YPO_RS04485	995
ARS007ss_ds.merged.samereadgroup.cleaned	766012	766581		YPO_RS04490	569
ARS007ss_ds.merged.samereadgroup.cleaned	768877	770010		flhB	1133
ARS007ss_ds.merged.samereadgroup.cleaned	770010	770783		YPO_RS04505	773
ARS007ss_ds.merged.samereadgroup.cleaned	770790	771062		fliQ	272
ARS007ss_ds.merged.samereadgroup.cleaned	771064	771834		fliP	770
ARS007ss_ds.merged.samereadgroup.cleaned	771831	772244		fliN	413
ARS007ss_ds.merged.samereadgroup.cleaned	772237	773136		YPO_RS04525	899
ARS007ss_ds.merged.samereadgroup.cleaned	773659	774687		YPO_RS04530	1028
ARS007ss_ds.merged.samereadgroup.cleaned	774704	775084		fliE	380
ARS007ss_ds.merged.samereadgroup.cleaned	775094	776734		fliF	1640
ARS007ss_ds.merged.samereadgroup.cleaned	777602	777749		YPO_RS04545	147
ARS007ss_ds.merged.samereadgroup.cleaned	776706	777526		YPO_RS04545	820
ARS007ss_ds.merged.samereadgroup.cleaned	777754	778470		YPO_RS04550	716
ARS007ss_ds.merged.samereadgroup.cleaned	778463	779803		fliI	1340
ARS007ss_ds.merged.samereadgroup.cleaned	779807	780190		fliJ	383
ARS007ss_ds.merged.samereadgroup.cleaned	780518	780943		YPO_RS04565	425
ARS007ss_ds.merged.samereadgroup.cleaned	780950	781216		flgM	266
ARS007ss_ds.merged.samereadgroup.cleaned	781445	782293		flgA	848
ARS007ss_ds.merged.samereadgroup.cleaned	782351	782797		flgB	446
ARS007ss_ds.merged.samereadgroup.cleaned	782800	783225		flgC	425
ARS007ss_ds.merged.samereadgroup.cleaned	783228	783884		flgD	656
ARS007ss_ds.merged.samereadgroup.cleaned	783939	785180		flaE	1241
ARS007ss_ds.merged.samereadgroup.cleaned	785180	785305		YPO_RS04600	125
ARS007ss_ds.merged.samereadgroup.cleaned	786029	786622		flgF	593
ARS007ss_ds.merged.samereadgroup.cleaned	786690	787475		flgG	785
ARS007ss_ds.merged.samereadgroup.cleaned	787510	788175		flgH	665
ARS007ss_ds.merged.samereadgroup.cleaned	788299	789364		YPO_RS04625	1065
ARS007ss_ds.merged.samereadgroup.cleaned	788222	788223		YPO_RS04625	1
ARS007ss_ds.merged.samereadgroup.cleaned	789374	789667		flgJ	293
ARS007ss_ds.merged.samereadgroup.cleaned	789780	791141		flgK	1361
ARS007ss_ds.merged.samereadgroup.cleaned	791170	791542		flgL	372
ARS007ss_ds.merged.samereadgroup.cleaned	791597	791671		flgL	74
ARS007ss_ds.merged.samereadgroup.cleaned	791746	792093		flgL	347
ARS007ss_ds.merged.samereadgroup.cleaned	792105	793118		YPO_RS04645	1013
ARS007ss_ds.merged.samereadgroup.cleaned	793282	793728		YPO_RS04650	446
ARS007ss_ds.merged.samereadgroup.cleaned	793709	794755		YPO_RS04655	1046
ARS007ss_ds.merged.samereadgroup.cleaned	795381	795521		YPO_RS04660	140
ARS007ss_ds.merged.samereadgroup.cleaned	795563	795664		YPO_RS04660	101
ARS007ss_ds.merged.samereadgroup.cleaned	795884	796308		YPO_RS04660	424
ARS007ss_ds.merged.samereadgroup.cleaned	796353	796360		YPO_RS04660	7
ARS007ss_ds.merged.samereadgroup.cleaned	796555	796559		YPO_RS04660	4
ARS007ss_ds.merged.samereadgroup.cleaned	796592	796595		YPO_RS04660	3
ARS007ss_ds.merged.samereadgroup.cleaned	797873	797888		YPO_RS04665	15
ARS007ss_ds.merged.samereadgroup.cleaned	798632	798636		YPO_RS04670	4
ARS007ss_ds.merged.samereadgroup.cleaned	800052	800054		fliD	2
ARS007ss_ds.merged.samereadgroup.cleaned	800869	800893		fliD	24
ARS007ss_ds.merged.samereadgroup.cleaned	801180	801226		fliD	46
ARS007ss_ds.merged.samereadgroup.cleaned	801475	801492		fliS	17
ARS007ss_ds.merged.samereadgroup.cleaned	801960	801993		YPO_RS04685	33
ARS007ss_ds.merged.samereadgroup.cleaned	802097	802107		YPO_RS04690	10
ARS007ss_ds.merged.samereadgroup.cleaned	802258	802260		YPO_RS04690	2
ARS007ss_ds.merged.samereadgroup.cleaned	802541	802660		YPO_RS04690	119
ARS007ss_ds.merged.samereadgroup.cleaned	802698	802701		YPO_RS04690	3
ARS007ss_ds.merged.samereadgroup.cleaned	803234	803258		YPO_RS04695	24
ARS007ss_ds.merged.samereadgroup.cleaned	803380	803386		YPO_RS04695	6
ARS007ss_ds.merged.samereadgroup.cleaned	803488	803503		YPO_RS04695	15
ARS007ss_ds.merged.samereadgroup.cleaned	803575	803576		YPO_RS04695	1
ARS007ss_ds.merged.samereadgroup.cleaned	804455	804457		motA	2
ARS007ss_ds.merged.samereadgroup.cleaned	804801	804804		motA	3
ARS007ss_ds.merged.samereadgroup.cleaned	806740	806743		YPO_RS04715	3
ARS007ss_ds.merged.samereadgroup.cleaned	807279	807284		YPO_RS04720	5
ARS007ss_ds.merged.samereadgroup.cleaned	807624	807703		YPO_RS04720	79
ARS007ss_ds.merged.samereadgroup.cleaned	807690	807703		YPO_RS04725	13
ARS007ss_ds.merged.samereadgroup.cleaned	808996	809009		YPO_RS04735	13
ARS007ss_ds.merged.samereadgroup.cleaned	809185	809240		YPO_RS04735	55
ARS007ss_ds.merged.samereadgroup.cleaned	811227	811238		YPO_RS04745	11
ARS007ss_ds.merged.samereadgroup.cleaned	811614	811619		YPO_RS04745	5
ARS007ss_ds.merged.samereadgroup.cleaned	814208	814227		YPO_RS04755	19
ARS007ss_ds.merged.samereadgroup.cleaned	814790	814799		YPO_RS04755	9
ARS007ss_ds.merged.samereadgroup.cleaned	816726	816736		YPO_RS04765	10
ARS007ss_ds.merged.samereadgroup.cleaned	816977	816992		YPO_RS04770	15
ARS007ss_ds.merged.samereadgroup.cleaned	819111	819121		YPO_RS04770	10
ARS007ss_ds.merged.samereadgroup.cleaned	820431	820443		YPO_RS04770	12
ARS007ss_ds.merged.samereadgroup.cleaned	821097	821122		YPO_RS04770	25
ARS007ss_ds.merged.samereadgroup.cleaned	822112	822116		YPO_RS04775	4
ARS007ss_ds.merged.samereadgroup.cleaned	822191	822200		YPO_RS04775	9
ARS007ss_ds.merged.samereadgroup.cleaned	822657	822659		vgrG	2
ARS007ss_ds.merged.samereadgroup.cleaned	822775	822776		vgrG	1
ARS007ss_ds.merged.samereadgroup.cleaned	822818	822833		vgrG	15
ARS007ss_ds.merged.samereadgroup.cleaned	830662	830673		gntP	11
ARS007ss_ds.merged.samereadgroup.cleaned	830728	830730		gntP	2
ARS007ss_ds.merged.samereadgroup.cleaned	831328	831343		gntP	15
ARS007ss_ds.merged.samereadgroup.cleaned	833837	833875		YPO_RS04800	38
ARS007ss_ds.merged.samereadgroup.cleaned	834021	834038		YPO_RS04800	17
ARS007ss_ds.merged.samereadgroup.cleaned	834124	834135		YPO_RS04800	11
ARS007ss_ds.merged.samereadgroup.cleaned	834336	834338		YPO_RS04800	2
ARS007ss_ds.merged.samereadgroup.cleaned	834570	834574		YPO_RS04800	4
ARS007ss_ds.merged.samereadgroup.cleaned	835033	835035		YPO_RS04805	2
ARS007ss_ds.merged.samereadgroup.cleaned	835377	835385		YPO_RS04805	8
ARS007ss_ds.merged.samereadgroup.cleaned	836101	836118		YPO_RS04805	17
ARS007ss_ds.merged.samereadgroup.cleaned	836199	836210		YPO_RS04805	11
ARS007ss_ds.merged.samereadgroup.cleaned	836571	836579		YPO_RS04805	8
ARS007ss_ds.merged.samereadgroup.cleaned	836672	836695		YPO_RS04805	23
ARS007ss_ds.merged.samereadgroup.cleaned	837357	837376		YPO_RS04810	19
ARS007ss_ds.merged.samereadgroup.cleaned	837750	837760		YPO_RS04810	10
ARS007ss_ds.merged.samereadgroup.cleaned	838412	838446		YPO_RS04810	34
ARS007ss_ds.merged.samereadgroup.cleaned	838566	838574		YPO_RS04815	8
ARS007ss_ds.merged.samereadgroup.cleaned	838698	838699		YPO_RS04815	1
ARS007ss_ds.merged.samereadgroup.cleaned	838827	838921		YPO_RS04815	94
ARS007ss_ds.merged.samereadgroup.cleaned	839437	839443		YPO_RS04815	6
ARS007ss_ds.merged.samereadgroup.cleaned	840880	840885		YPO_RS04825	5
ARS007ss_ds.merged.samereadgroup.cleaned	840970	840972		YPO_RS04825	2
ARS007ss_ds.merged.samereadgroup.cleaned	841143	841148		YPO_RS04825	5
ARS007ss_ds.merged.samereadgroup.cleaned	841360	841367		YPO_RS04825	7
ARS007ss_ds.merged.samereadgroup.cleaned	841820	841823		YPO_RS04830	3
ARS007ss_ds.merged.samereadgroup.cleaned	842069	842076		YPO_RS04830	7
ARS007ss_ds.merged.samereadgroup.cleaned	843585	843617		YPO_RS04835	32
ARS007ss_ds.merged.samereadgroup.cleaned	844128	844133		YPO_RS04835	5
ARS007ss_ds.merged.samereadgroup.cleaned	844698	844704		YPO_RS04835	6
ARS007ss_ds.merged.samereadgroup.cleaned	844873	844882		YPO_RS04835	9
ARS007ss_ds.merged.samereadgroup.cleaned	844947	844971		YPO_RS04835	24
ARS007ss_ds.merged.samereadgroup.cleaned	845341	845344		YPO_RS04835	3
ARS007ss_ds.merged.samereadgroup.cleaned	845393	845630		YPO_RS04835	237
ARS007ss_ds.merged.samereadgroup.cleaned	845717	845723		YPO_RS04835	6
ARS007ss_ds.merged.samereadgroup.cleaned	845889	845950		YPO_RS04835	61
ARS007ss_ds.merged.samereadgroup.cleaned	846134	846147		YPO_RS04835	13
ARS007ss_ds.merged.samereadgroup.cleaned	846393	846405		YPO_RS04835	12
ARS007ss_ds.merged.samereadgroup.cleaned	846705	846707		YPO_RS04835	2
ARS007ss_ds.merged.samereadgroup.cleaned	847054	847069		YPO_RS04835	15
ARS007ss_ds.merged.samereadgroup.cleaned	847349	847361		YPO_RS04835	12
ARS007ss_ds.merged.samereadgroup.cleaned	848743	848752		YPO_RS04840	9
ARS007ss_ds.merged.samereadgroup.cleaned	848846	848871		YPO_RS04840	25
ARS007ss_ds.merged.samereadgroup.cleaned	849487	849497		YPO_RS04840	10
ARS007ss_ds.merged.samereadgroup.cleaned	850026	850035		YPO_RS04840	9
ARS007ss_ds.merged.samereadgroup.cleaned	850183	850191		YPO_RS04840	8
ARS007ss_ds.merged.samereadgroup.cleaned	850355	850364		YPO_RS04845	9
ARS007ss_ds.merged.samereadgroup.cleaned	851101	851105		YPO_RS04845	4
ARS007ss_ds.merged.samereadgroup.cleaned	851509	851511		YPO_RS04845	2
ARS007ss_ds.merged.samereadgroup.cleaned	852502	852529		YPO_RS04845	27
ARS007ss_ds.merged.samereadgroup.cleaned	853659	853673		YPO_RS04845	14
ARS007ss_ds.merged.samereadgroup.cleaned	853777	853798		YPO_RS04845	21
ARS007ss_ds.merged.samereadgroup.cleaned	854317	854322		YPO_RS04845	5
ARS007ss_ds.merged.samereadgroup.cleaned	854564	854602		YPO_RS04845	38
ARS007ss_ds.merged.samereadgroup.cleaned	854666	854674		YPO_RS04845	8
ARS007ss_ds.merged.samereadgroup.cleaned	854748	854754		YPO_RS04845	6
ARS007ss_ds.merged.samereadgroup.cleaned	856093	856119		YPO_RS04845	26
ARS007ss_ds.merged.samereadgroup.cleaned	856422	856429		YPO_RS04845	7
ARS007ss_ds.merged.samereadgroup.cleaned	858883	858885		YPO_RS04860	2
ARS007ss_ds.merged.samereadgroup.cleaned	859142	859144		YPO_RS04860	2
ARS007ss_ds.merged.samereadgroup.cleaned	859533	859540		thyA	7
ARS007ss_ds.merged.samereadgroup.cleaned	859996	860023		thyA	27
ARS007ss_ds.merged.samereadgroup.cleaned	860158	860160		thyA	2
ARS007ss_ds.merged.samereadgroup.cleaned	860618	860622		lgt	4
ARS007ss_ds.merged.samereadgroup.cleaned	862477	862490		ptsP	13
ARS007ss_ds.merged.samereadgroup.cleaned	862591	862594		ptsP	3
ARS007ss_ds.merged.samereadgroup.cleaned	862639	862657		ptsP	18
ARS007ss_ds.merged.samereadgroup.cleaned	863496	863508		ptsP	12
ARS007ss_ds.merged.samereadgroup.cleaned	865216	865219		mutH	3
ARS007ss_ds.merged.samereadgroup.cleaned	865965	865994		YPO_RS04890	29
ARS007ss_ds.merged.samereadgroup.cleaned	867734	867737		YPO_RS04900	3
ARS007ss_ds.merged.samereadgroup.cleaned	868054	868069		lplT	15
ARS007ss_ds.merged.samereadgroup.cleaned	868436	868444		lplT	8
ARS007ss_ds.merged.samereadgroup.cleaned	868489	868490		lplT	1
ARS007ss_ds.merged.samereadgroup.cleaned	868925	868936		lplT	11
ARS007ss_ds.merged.samereadgroup.cleaned	869646	869648		aas	2
ARS007ss_ds.merged.samereadgroup.cleaned	869966	869970		aas	4
ARS007ss_ds.merged.samereadgroup.cleaned	871154	871162		aas	8
ARS007ss_ds.merged.samereadgroup.cleaned	872899	872907		YPO_RS04915	8
ARS007ss_ds.merged.samereadgroup.cleaned	873992	874022		YPO_RS04915	30
ARS007ss_ds.merged.samereadgroup.cleaned	875233	875262		galR	29
ARS007ss_ds.merged.samereadgroup.cleaned	875492	875501		lysA	9
ARS007ss_ds.merged.samereadgroup.cleaned	877574	877575		YPO_RS04930	1
ARS007ss_ds.merged.samereadgroup.cleaned	877846	877855		YPO_RS04935	9
ARS007ss_ds.merged.samereadgroup.cleaned	877903	877930		YPO_RS04935	27
ARS007ss_ds.merged.samereadgroup.cleaned	878445	878458		YPO_RS04935	13
ARS007ss_ds.merged.samereadgroup.cleaned	878684	878704		YPO_RS04935	20
ARS007ss_ds.merged.samereadgroup.cleaned	879332	879335		YPO_RS04940	3
ARS007ss_ds.merged.samereadgroup.cleaned	882059	882064		YPO_RS04955	5
ARS007ss_ds.merged.samereadgroup.cleaned	882365	882390		YPO_RS04955	25
ARS007ss_ds.merged.samereadgroup.cleaned	882735	882740		YPO_RS04955	5
ARS007ss_ds.merged.samereadgroup.cleaned	882787	882793		YPO_RS04955	6
ARS007ss_ds.merged.samereadgroup.cleaned	882975	882982		YPO_RS04955	7
ARS007ss_ds.merged.samereadgroup.cleaned	884148	884151		YPO_RS04960	3
ARS007ss_ds.merged.samereadgroup.cleaned	884206	884250		YPO_RS04965	44
ARS007ss_ds.merged.samereadgroup.cleaned	884426	884479		YPO_RS04965	53
ARS007ss_ds.merged.samereadgroup.cleaned	884610	884619		YPO_RS04965	9
ARS007ss_ds.merged.samereadgroup.cleaned	884895	884907		YPO_RS04965	12
ARS007ss_ds.merged.samereadgroup.cleaned	884735	884751		YPO_RS04965	16
ARS007ss_ds.merged.samereadgroup.cleaned	885690	885707		YPO_RS04975	17
ARS007ss_ds.merged.samereadgroup.cleaned	885803	885807		YPO_RS04975	4
ARS007ss_ds.merged.samereadgroup.cleaned	885855	885857		YPO_RS04975	2
ARS007ss_ds.merged.samereadgroup.cleaned	886383	886390		YPO_RS04975	7
ARS007ss_ds.merged.samereadgroup.cleaned	886598	886817		YPO_RS04980	219
ARS007ss_ds.merged.samereadgroup.cleaned	886905	886908		gspL	3
ARS007ss_ds.merged.samereadgroup.cleaned	887181	887190		gspL	9
ARS007ss_ds.merged.samereadgroup.cleaned	887225	887233		gspL	8
ARS007ss_ds.merged.samereadgroup.cleaned	887405	887414		gspL	9
ARS007ss_ds.merged.samereadgroup.cleaned	887490	887493		gspL	3
ARS007ss_ds.merged.samereadgroup.cleaned	888024	888025		gspL	1
ARS007ss_ds.merged.samereadgroup.cleaned	888101	888203		YPO_RS04990	102
ARS007ss_ds.merged.samereadgroup.cleaned	888237	888241		YPO_RS04990	4
ARS007ss_ds.merged.samereadgroup.cleaned	888481	888492		YPO_RS04990	11
ARS007ss_ds.merged.samereadgroup.cleaned	888601	888608		YPO_RS04990	7
ARS007ss_ds.merged.samereadgroup.cleaned	888750	888751		YPO_RS04990	1
ARS007ss_ds.merged.samereadgroup.cleaned	888929	888957		YPO_RS04990	28
ARS007ss_ds.merged.samereadgroup.cleaned	889188	889229		gspJ	41
ARS007ss_ds.merged.samereadgroup.cleaned	889358	889453		gspJ	95
ARS007ss_ds.merged.samereadgroup.cleaned	889509	889542		gspJ	33
ARS007ss_ds.merged.samereadgroup.cleaned	889751	889761		gspI	10
ARS007ss_ds.merged.samereadgroup.cleaned	890149	890165		YPO_RS05005	16
ARS007ss_ds.merged.samereadgroup.cleaned	890594	890598		gspG	4
ARS007ss_ds.merged.samereadgroup.cleaned	890663	890664		gspG	1
ARS007ss_ds.merged.samereadgroup.cleaned	892280	892283		gspE	3
ARS007ss_ds.merged.samereadgroup.cleaned	892973	892986		gspE	13
ARS007ss_ds.merged.samereadgroup.cleaned	893272	893275		gspE	3
ARS007ss_ds.merged.samereadgroup.cleaned	893705	893827		gspD	122
ARS007ss_ds.merged.samereadgroup.cleaned	894437	894480		gspD	43
ARS007ss_ds.merged.samereadgroup.cleaned	894610	894628		gspD	18
ARS007ss_ds.merged.samereadgroup.cleaned	894857	894873		gspD	16
ARS007ss_ds.merged.samereadgroup.cleaned	894949	894954		gspD	5
ARS007ss_ds.merged.samereadgroup.cleaned	895099	895135		gspD	36
ARS007ss_ds.merged.samereadgroup.cleaned	895437	895443		gspD	6
ARS007ss_ds.merged.samereadgroup.cleaned	895604	895606		gspD	2
ARS007ss_ds.merged.samereadgroup.cleaned	895900	895911		YPO_RS05030	11
ARS007ss_ds.merged.samereadgroup.cleaned	896030	896060		YPO_RS05030	30
ARS007ss_ds.merged.samereadgroup.cleaned	896258	896370		YPO_RS05035	112
ARS007ss_ds.merged.samereadgroup.cleaned	896616	896635		YPO_RS05035	19
ARS007ss_ds.merged.samereadgroup.cleaned	897595	897604		YPO_RS05040	9
ARS007ss_ds.merged.samereadgroup.cleaned	898794	898802		YPO_RS05045	8
ARS007ss_ds.merged.samereadgroup.cleaned	900051	900086		YPO_RS05050	35
ARS007ss_ds.merged.samereadgroup.cleaned	900387	900393		YPO_RS05050	6
ARS007ss_ds.merged.samereadgroup.cleaned	901015	901032		yapM	17
ARS007ss_ds.merged.samereadgroup.cleaned	901588	901591		yapM	3
ARS007ss_ds.merged.samereadgroup.cleaned	902134	902165		yapM	31
ARS007ss_ds.merged.samereadgroup.cleaned	902270	902274		yapM	4
ARS007ss_ds.merged.samereadgroup.cleaned	902481	902490		yapM	9
ARS007ss_ds.merged.samereadgroup.cleaned	902651	902672		yapM	21
ARS007ss_ds.merged.samereadgroup.cleaned	902823	902850		YPO_RS05060	27
ARS007ss_ds.merged.samereadgroup.cleaned	903014	903016		YPO_RS05060	2
ARS007ss_ds.merged.samereadgroup.cleaned	903729	903763		YPO_RS05060	34
ARS007ss_ds.merged.samereadgroup.cleaned	903955	904019		YPO_RS05060	64
ARS007ss_ds.merged.samereadgroup.cleaned	904266	904276		YPO_RS05060	10
ARS007ss_ds.merged.samereadgroup.cleaned	904559	904560		YPO_RS05060	1
ARS007ss_ds.merged.samereadgroup.cleaned	905375	905382		YPO_RS05060	7
ARS007ss_ds.merged.samereadgroup.cleaned	905457	905458		YPO_RS05060	1
ARS007ss_ds.merged.samereadgroup.cleaned	905681	905683		YPO_RS05060	2
ARS007ss_ds.merged.samereadgroup.cleaned	909517	909541		YPO_RS05080	24
ARS007ss_ds.merged.samereadgroup.cleaned	910202	910223		YPO_RS05080	21
ARS007ss_ds.merged.samereadgroup.cleaned	910253	910264		YPO_RS05080	11
ARS007ss_ds.merged.samereadgroup.cleaned	910316	910321		YPO_RS05080	5
ARS007ss_ds.merged.samereadgroup.cleaned	910455	910458		YPO_RS05080	3
ARS007ss_ds.merged.samereadgroup.cleaned	911922	911930		YPO_RS05085	8
ARS007ss_ds.merged.samereadgroup.cleaned	912730	912731		kbaZ	1
ARS007ss_ds.merged.samereadgroup.cleaned	912900	912906		kbaZ	6
ARS007ss_ds.merged.samereadgroup.cleaned	913128	913136		kbaZ	8
ARS007ss_ds.merged.samereadgroup.cleaned	914200	914220		YPO_RS05095	20
ARS007ss_ds.merged.samereadgroup.cleaned	915416	915420		YPO_RS05105	4
ARS007ss_ds.merged.samereadgroup.cleaned	917154	917174		YPO_RS05115	20
ARS007ss_ds.merged.samereadgroup.cleaned	919227	919231		kduD	4
ARS007ss_ds.merged.samereadgroup.cleaned	919496	919524		kduD	28
ARS007ss_ds.merged.samereadgroup.cleaned	920118	920122		YPO_RS05130	4
ARS007ss_ds.merged.samereadgroup.cleaned	920856	920896		YPO_RS05135	40
ARS007ss_ds.merged.samereadgroup.cleaned	921689	921700		YPO_RS05135	11
ARS007ss_ds.merged.samereadgroup.cleaned	921737	921738		YPO_RS05135	1
ARS007ss_ds.merged.samereadgroup.cleaned	922157	922158		YPO_RS05140	1
ARS007ss_ds.merged.samereadgroup.cleaned	923130	923139		YPO_RS05140	9
ARS007ss_ds.merged.samereadgroup.cleaned	923302	923311		YPO_RS05140	9
ARS007ss_ds.merged.samereadgroup.cleaned	923499	923507		YPO_RS05140	8
ARS007ss_ds.merged.samereadgroup.cleaned	924524	924533		YPO_RS05145	9
ARS007ss_ds.merged.samereadgroup.cleaned	924741	924768		YPO_RS05145	27
ARS007ss_ds.merged.samereadgroup.cleaned	925036	925045		YPO_RS05145	9
ARS007ss_ds.merged.samereadgroup.cleaned	925963	925968		YPO_RS05150	5
ARS007ss_ds.merged.samereadgroup.cleaned	928602	928613		YPO_RS05165	11
ARS007ss_ds.merged.samereadgroup.cleaned	929061	929100		YPO_RS05165	39
ARS007ss_ds.merged.samereadgroup.cleaned	929588	929592		YPO_RS05165	4
ARS007ss_ds.merged.samereadgroup.cleaned	930754	930755		YPO_RS05170	1
ARS007ss_ds.merged.samereadgroup.cleaned	931590	931593		YPO_RS05170	3
ARS007ss_ds.merged.samereadgroup.cleaned	932257	932291		YPO_RS05170	34
ARS007ss_ds.merged.samereadgroup.cleaned	933618	933624		YPO_RS05175	6
ARS007ss_ds.merged.samereadgroup.cleaned	934299	934310		YPO_RS05180	11
ARS007ss_ds.merged.samereadgroup.cleaned	934350	934358		YPO_RS05180	8
ARS007ss_ds.merged.samereadgroup.cleaned	934957	934971		YPO_RS05180	14
ARS007ss_ds.merged.samereadgroup.cleaned	935100	935119		YPO_RS05180	19
ARS007ss_ds.merged.samereadgroup.cleaned	936334	936348		YPO_RS05190	14
ARS007ss_ds.merged.samereadgroup.cleaned	937863	937885		YPO_RS05190	22
ARS007ss_ds.merged.samereadgroup.cleaned	938223	938224		YPO_RS05190	1
ARS007ss_ds.merged.samereadgroup.cleaned	938689	938696		YPO_RS05195	7
ARS007ss_ds.merged.samereadgroup.cleaned	939486	939491		YPO_RS05200	5
ARS007ss_ds.merged.samereadgroup.cleaned	939533	939540		YPO_RS05200	7
ARS007ss_ds.merged.samereadgroup.cleaned	940217	940223		YPO_RS05200	6
ARS007ss_ds.merged.samereadgroup.cleaned	940506	940557		YPO_RS05205	51
ARS007ss_ds.merged.samereadgroup.cleaned	940657	940683		YPO_RS05205	26
ARS007ss_ds.merged.samereadgroup.cleaned	940993	940998		YPO_RS05205	5
ARS007ss_ds.merged.samereadgroup.cleaned	941157	941161		YPO_RS05205	4
ARS007ss_ds.merged.samereadgroup.cleaned	941556	941561		YPO_RS05205	5
ARS007ss_ds.merged.samereadgroup.cleaned	941812	941833		YPO_RS05210	21
ARS007ss_ds.merged.samereadgroup.cleaned	941915	941917		YPO_RS05210	2
ARS007ss_ds.merged.samereadgroup.cleaned	942151	942164		YPO_RS05210	13
ARS007ss_ds.merged.samereadgroup.cleaned	942488	942506		YPO_RS05210	18
ARS007ss_ds.merged.samereadgroup.cleaned	943971	943987		YPO_RS05215	16
ARS007ss_ds.merged.samereadgroup.cleaned	944209	944226		YPO_RS05215	17
ARS007ss_ds.merged.samereadgroup.cleaned	946155	946165		YPO_RS05220	10
ARS007ss_ds.merged.samereadgroup.cleaned	946838	946842		YPO_RS05225	4
ARS007ss_ds.merged.samereadgroup.cleaned	947642	947643		YPO_RS05225	1
ARS007ss_ds.merged.samereadgroup.cleaned	950119	950130		YPO_RS05235	11
ARS007ss_ds.merged.samereadgroup.cleaned	950166	950184		YPO_RS05235	18
ARS007ss_ds.merged.samereadgroup.cleaned	950300	950321		YPO_RS05235	21
ARS007ss_ds.merged.samereadgroup.cleaned	951056	951063		YPO_RS05240	7
ARS007ss_ds.merged.samereadgroup.cleaned	951589	951591		YPO_RS05240	2
ARS007ss_ds.merged.samereadgroup.cleaned	952980	952990		YPO_RS05250	10
ARS007ss_ds.merged.samereadgroup.cleaned	953665	953695		YPO_RS05260	30
ARS007ss_ds.merged.samereadgroup.cleaned	954116	954139		YPO_RS05260	23
ARS007ss_ds.merged.samereadgroup.cleaned	954303	954315		YPO_RS05260	12
ARS007ss_ds.merged.samereadgroup.cleaned	955209	955214		YPO_RS05265	5
ARS007ss_ds.merged.samereadgroup.cleaned	956166	956171		YPO_RS05270	5
ARS007ss_ds.merged.samereadgroup.cleaned	957907	957918		YPO_RS05270	11
ARS007ss_ds.merged.samereadgroup.cleaned	960381	960385		YPO_RS05290	4
ARS007ss_ds.merged.samereadgroup.cleaned	960488	960503		YPO_RS05290	15
ARS007ss_ds.merged.samereadgroup.cleaned	962574	962610		YPO_RS05295	36
ARS007ss_ds.merged.samereadgroup.cleaned	963337	963344		YPO_RS05305	7
ARS007ss_ds.merged.samereadgroup.cleaned	963478	963480		YPO_RS05305	2
ARS007ss_ds.merged.samereadgroup.cleaned	963552	963563		YPO_RS05310	11
ARS007ss_ds.merged.samereadgroup.cleaned	964127	964131		YPO_RS05315	4
ARS007ss_ds.merged.samereadgroup.cleaned	964675	964698		YPO_RS05325	23
ARS007ss_ds.merged.samereadgroup.cleaned	965348	965350		YPO_RS05330	2
ARS007ss_ds.merged.samereadgroup.cleaned	966477	966490		YPO_RS05330	13
ARS007ss_ds.merged.samereadgroup.cleaned	966613	966615		YPO_RS05330	2
ARS007ss_ds.merged.samereadgroup.cleaned	966700	966702		YPO_RS05330	2
ARS007ss_ds.merged.samereadgroup.cleaned	968014	968016		YPO_RS05335	2
ARS007ss_ds.merged.samereadgroup.cleaned	969042	969071		YPO_RS05350	29
ARS007ss_ds.merged.samereadgroup.cleaned	970613	970617		YPO_RS05360	4
ARS007ss_ds.merged.samereadgroup.cleaned	971802	971859		lysS	57
ARS007ss_ds.merged.samereadgroup.cleaned	972430	972453		lysS	23
ARS007ss_ds.merged.samereadgroup.cleaned	973020	973031		lysS	11
ARS007ss_ds.merged.samereadgroup.cleaned	974301	974309		prfB	8
ARS007ss_ds.merged.samereadgroup.cleaned	975223	975233		recJ	10
ARS007ss_ds.merged.samereadgroup.cleaned	976764	976778		dsbC	14
ARS007ss_ds.merged.samereadgroup.cleaned	976860	976861		dsbC	1
ARS007ss_ds.merged.samereadgroup.cleaned	976968	977004		dsbC	36
ARS007ss_ds.merged.samereadgroup.cleaned	977035	977064		xerD	29
ARS007ss_ds.merged.samereadgroup.cleaned	978074	978079		fldB	5
ARS007ss_ds.merged.samereadgroup.cleaned	979651	979660		creD	9
ARS007ss_ds.merged.samereadgroup.cleaned	979766	979767		creD	1
ARS007ss_ds.merged.samereadgroup.cleaned	980680	980685		creC	5
ARS007ss_ds.merged.samereadgroup.cleaned	980953	980959		creC	6
ARS007ss_ds.merged.samereadgroup.cleaned	981509	981520		creC	11
ARS007ss_ds.merged.samereadgroup.cleaned	982035	982042		creB	7
ARS007ss_ds.merged.samereadgroup.cleaned	982409	982445		YPO_RS05415	36
ARS007ss_ds.merged.samereadgroup.cleaned	982765	982771		YPO_RS05415	6
ARS007ss_ds.merged.samereadgroup.cleaned	983407	983408		ygfZ	1
ARS007ss_ds.merged.samereadgroup.cleaned	984762	984769		YPO_RS05430	7
ARS007ss_ds.merged.samereadgroup.cleaned	985306	985307		YPO_RS05435	1
ARS007ss_ds.merged.samereadgroup.cleaned	985710	985725		YPO_RS05435	15
ARS007ss_ds.merged.samereadgroup.cleaned	986615	986623		YPO_RS05440	8
ARS007ss_ds.merged.samereadgroup.cleaned	991607	991616		gcvP	9
ARS007ss_ds.merged.samereadgroup.cleaned	992312	992321		gcvP	9
ARS007ss_ds.merged.samereadgroup.cleaned	993145	993148		gcvP	3
ARS007ss_ds.merged.samereadgroup.cleaned	995169	995172		gcvT	3
ARS007ss_ds.merged.samereadgroup.cleaned	995502	995504		gcvT	2
ARS007ss_ds.merged.samereadgroup.cleaned	997038	997040		ubiI	2
ARS007ss_ds.merged.samereadgroup.cleaned	998390	998404		ubiH	14
ARS007ss_ds.merged.samereadgroup.cleaned	999500	999506		pepP	6
ARS007ss_ds.merged.samereadgroup.cleaned	999669	999685		pepP	16
ARS007ss_ds.merged.samereadgroup.cleaned	1000727	1000728		YPO_RS05490	1
ARS007ss_ds.merged.samereadgroup.cleaned	1003954	1003956		serA	2
ARS007ss_ds.merged.samereadgroup.cleaned	1004750	1004751		rpiA	1
ARS007ss_ds.merged.samereadgroup.cleaned	1005171	1005173		rpiA	2
ARS007ss_ds.merged.samereadgroup.cleaned	1005221	1005224		rpiA	3
ARS007ss_ds.merged.samereadgroup.cleaned	1005854	1005879		YPO_RS05520	25
ARS007ss_ds.merged.samereadgroup.cleaned	1007639	1007645		argO	6
ARS007ss_ds.merged.samereadgroup.cleaned	1007786	1007801		argO	15
ARS007ss_ds.merged.samereadgroup.cleaned	1007930	1007950		argO	20
ARS007ss_ds.merged.samereadgroup.cleaned	1007986	1007989		argO	3
ARS007ss_ds.merged.samereadgroup.cleaned	1008532	1008533		mscS	1
ARS007ss_ds.merged.samereadgroup.cleaned	1008697	1008698		mscS	1
ARS007ss_ds.merged.samereadgroup.cleaned	1008774	1008776		mscS	2
ARS007ss_ds.merged.samereadgroup.cleaned	1008923	1008925		mscS	2
ARS007ss_ds.merged.samereadgroup.cleaned	1009075	1009077		mscS	2
ARS007ss_ds.merged.samereadgroup.cleaned	1010811	1010817		fbaA	6
ARS007ss_ds.merged.samereadgroup.cleaned	1012727	1012730		epd	3
ARS007ss_ds.merged.samereadgroup.cleaned	1012964	1012969		epd	5
ARS007ss_ds.merged.samereadgroup.cleaned	1016600	1016614		tkt	14
ARS007ss_ds.merged.samereadgroup.cleaned	1016853	1016855		tkt	2
ARS007ss_ds.merged.samereadgroup.cleaned	1017086	1017100		tkt	14
ARS007ss_ds.merged.samereadgroup.cleaned	1017684	1017689		tkt	5
ARS007ss_ds.merged.samereadgroup.cleaned	1020030	1020039		YPO_RS05585	9
ARS007ss_ds.merged.samereadgroup.cleaned	1020095	1020096		YPO_RS05585	1
ARS007ss_ds.merged.samereadgroup.cleaned	1020358	1020364		speA	6
ARS007ss_ds.merged.samereadgroup.cleaned	1020674	1020696		speA	22
ARS007ss_ds.merged.samereadgroup.cleaned	1021286	1021294		speA	8
ARS007ss_ds.merged.samereadgroup.cleaned	1021616	1021617		speA	1
ARS007ss_ds.merged.samereadgroup.cleaned	1022163	1022168		speA	5
ARS007ss_ds.merged.samereadgroup.cleaned	1023689	1023694		metK	5
ARS007ss_ds.merged.samereadgroup.cleaned	1027330	1027335		gshB	5
ARS007ss_ds.merged.samereadgroup.cleaned	1027446	1027461		gshB	15
ARS007ss_ds.merged.samereadgroup.cleaned	1028590	1028593		YPO_RS05620	3
ARS007ss_ds.merged.samereadgroup.cleaned	1030011	1030013		aguB	2
ARS007ss_ds.merged.samereadgroup.cleaned	1030622	1030630		aguA	8
ARS007ss_ds.merged.samereadgroup.cleaned	1031989	1031992		YPO_RS05640	3
ARS007ss_ds.merged.samereadgroup.cleaned	1032401	1032405		YPO_RS05640	4
ARS007ss_ds.merged.samereadgroup.cleaned	1032699	1032702		YPO_RS05645	3
ARS007ss_ds.merged.samereadgroup.cleaned	1033658	1033664		YPO_RS05650	6
ARS007ss_ds.merged.samereadgroup.cleaned	1033894	1033901		YPO_RS05650	7
ARS007ss_ds.merged.samereadgroup.cleaned	1034673	1034684		YPO_RS05655	11
ARS007ss_ds.merged.samereadgroup.cleaned	1034731	1034736		YPO_RS05655	5
ARS007ss_ds.merged.samereadgroup.cleaned	1034790	1034806		YPO_RS05655	16
ARS007ss_ds.merged.samereadgroup.cleaned	1035971	1035981		YPO_RS05665	10
ARS007ss_ds.merged.samereadgroup.cleaned	1036259	1036261		hemW	2
ARS007ss_ds.merged.samereadgroup.cleaned	1037857	1037892		YPO_RS05675	35
ARS007ss_ds.merged.samereadgroup.cleaned	1038404	1038408		YPO_RS05675	4
ARS007ss_ds.merged.samereadgroup.cleaned	1038762	1038788		YPO_RS05675	26
ARS007ss_ds.merged.samereadgroup.cleaned	1038911	1038913		YPO_RS05675	2
ARS007ss_ds.merged.samereadgroup.cleaned	1039323	1039330		YPO_RS05675	7
ARS007ss_ds.merged.samereadgroup.cleaned	1039903	1039905		YPO_RS05675	2
ARS007ss_ds.merged.samereadgroup.cleaned	1040233	1040236		YPO_RS05675	3
ARS007ss_ds.merged.samereadgroup.cleaned	1040301	1040304		YPO_RS05675	3
ARS007ss_ds.merged.samereadgroup.cleaned	1040496	1040505		YPO_RS05675	9
ARS007ss_ds.merged.samereadgroup.cleaned	1040591	1040593		YPO_RS05675	2
ARS007ss_ds.merged.samereadgroup.cleaned	1040824	1040832		YPO_RS05675	8
ARS007ss_ds.merged.samereadgroup.cleaned	1040892	1040897		YPO_RS05675	5
ARS007ss_ds.merged.samereadgroup.cleaned	1041146	1041163		YPO_RS05675	17
ARS007ss_ds.merged.samereadgroup.cleaned	1041709	1041724		YPO_RS05675	15
ARS007ss_ds.merged.samereadgroup.cleaned	1041925	1041927		YPO_RS05675	2
ARS007ss_ds.merged.samereadgroup.cleaned	1042152	1042171		YPO_RS05675	19
ARS007ss_ds.merged.samereadgroup.cleaned	1042320	1042335		YPO_RS05675	15
ARS007ss_ds.merged.samereadgroup.cleaned	1042530	1042556		YPO_RS05675	26
ARS007ss_ds.merged.samereadgroup.cleaned	1042869	1042887		YPO_RS05675	18
ARS007ss_ds.merged.samereadgroup.cleaned	1043957	1043983		YPO_RS05675	26
ARS007ss_ds.merged.samereadgroup.cleaned	1044186	1044196		YPO_RS05675	10
ARS007ss_ds.merged.samereadgroup.cleaned	1044351	1044359		YPO_RS05675	8
ARS007ss_ds.merged.samereadgroup.cleaned	1044405	1044423		YPO_RS05675	18
ARS007ss_ds.merged.samereadgroup.cleaned	1044474	1044540		YPO_RS05675	66
ARS007ss_ds.merged.samereadgroup.cleaned	1044631	1044659		YPO_RS05675	28
ARS007ss_ds.merged.samereadgroup.cleaned	1045076	1045116		YPO_RS05675	40
ARS007ss_ds.merged.samereadgroup.cleaned	1045152	1045164		YPO_RS05675	12
ARS007ss_ds.merged.samereadgroup.cleaned	1045391	1045411		YPO_RS05675	20
ARS007ss_ds.merged.samereadgroup.cleaned	1045525	1045568		YPO_RS05675	43
ARS007ss_ds.merged.samereadgroup.cleaned	1045838	1045889		YPO_RS05675	51
ARS007ss_ds.merged.samereadgroup.cleaned	1046412	1046416		YPO_RS05675	4
ARS007ss_ds.merged.samereadgroup.cleaned	1046482	1046497		YPO_RS05675	15
ARS007ss_ds.merged.samereadgroup.cleaned	1046549	1046569		YPO_RS05675	20
ARS007ss_ds.merged.samereadgroup.cleaned	1046681	1046727		YPO_RS05675	46
ARS007ss_ds.merged.samereadgroup.cleaned	1046800	1046811		YPO_RS05675	11
ARS007ss_ds.merged.samereadgroup.cleaned	1048397	1048399		glsB	2
ARS007ss_ds.merged.samereadgroup.cleaned	1049071	1049076		glsB	5
ARS007ss_ds.merged.samereadgroup.cleaned	1049931	1049943		trmB	12
ARS007ss_ds.merged.samereadgroup.cleaned	1050901	1050913		mutY	12
ARS007ss_ds.merged.samereadgroup.cleaned	1051335	1051336		mutY	1
ARS007ss_ds.merged.samereadgroup.cleaned	1051479	1051488		mutY	9
ARS007ss_ds.merged.samereadgroup.cleaned	1053201	1053213		mltC	12
ARS007ss_ds.merged.samereadgroup.cleaned	1054018	1054024		YPO_RS05715	6
ARS007ss_ds.merged.samereadgroup.cleaned	1054449	1054468		YPO_RS05715	19
ARS007ss_ds.merged.samereadgroup.cleaned	1055035	1055042		YPO_RS05720	7
ARS007ss_ds.merged.samereadgroup.cleaned	1055121	1055126		YPO_RS05720	5
ARS007ss_ds.merged.samereadgroup.cleaned	1055528	1055531		YPO_RS05720	3
ARS007ss_ds.merged.samereadgroup.cleaned	1056619	1056626		YPO_RS05720	7
ARS007ss_ds.merged.samereadgroup.cleaned	1057183	1057187		YPO_RS05725	4
ARS007ss_ds.merged.samereadgroup.cleaned	1057266	1057280		YPO_RS05725	14
ARS007ss_ds.merged.samereadgroup.cleaned	1057645	1057659		YPO_RS05725	14
ARS007ss_ds.merged.samereadgroup.cleaned	1057993	1058002		YPO_RS05725	9
ARS007ss_ds.merged.samereadgroup.cleaned	1059640	1059645		YPO_RS05735	5
ARS007ss_ds.merged.samereadgroup.cleaned	1059783	1059792		YPO_RS05735	9
ARS007ss_ds.merged.samereadgroup.cleaned	1060075	1060076		YPO_RS05735	1
ARS007ss_ds.merged.samereadgroup.cleaned	1060215	1060216		YPO_RS05735	1
ARS007ss_ds.merged.samereadgroup.cleaned	1060479	1060482		YPO_RS05735	3
ARS007ss_ds.merged.samereadgroup.cleaned	1061586	1061596		speF	10
ARS007ss_ds.merged.samereadgroup.cleaned	1062156	1062165		speF	9
ARS007ss_ds.merged.samereadgroup.cleaned	1062382	1062385		speF	3
ARS007ss_ds.merged.samereadgroup.cleaned	1062482	1062490		speF	8
ARS007ss_ds.merged.samereadgroup.cleaned	1063252	1063257		speF	5
ARS007ss_ds.merged.samereadgroup.cleaned	1064873	1064877		YPO_RS05755	4
ARS007ss_ds.merged.samereadgroup.cleaned	1065861	1065954		YPO_RS05760	93
ARS007ss_ds.merged.samereadgroup.cleaned	1066953	1066975		YPO_RS05765	22
ARS007ss_ds.merged.samereadgroup.cleaned	1067079	1067090		YPO_RS05765	11
ARS007ss_ds.merged.samereadgroup.cleaned	1067146	1067148		YPO_RS05765	2
ARS007ss_ds.merged.samereadgroup.cleaned	1067229	1067233		YPO_RS05765	4
ARS007ss_ds.merged.samereadgroup.cleaned	1067301	1067389		YPO_RS05765	88
ARS007ss_ds.merged.samereadgroup.cleaned	1067376	1067394		YPO_RS05770	18
ARS007ss_ds.merged.samereadgroup.cleaned	1067441	1067447		YPO_RS05770	6
ARS007ss_ds.merged.samereadgroup.cleaned	1067529	1067564		YPO_RS05770	35
ARS007ss_ds.merged.samereadgroup.cleaned	1068087	1068182		YPO_RS05770	95
ARS007ss_ds.merged.samereadgroup.cleaned	1071658	1071661		YPO_RS05785	3
ARS007ss_ds.merged.samereadgroup.cleaned	1071912	1071945		YPO_RS05790	33
ARS007ss_ds.merged.samereadgroup.cleaned	1072136	1072143		YPO_RS05790	7
ARS007ss_ds.merged.samereadgroup.cleaned	1072480	1072492		YPO_RS05795	12
ARS007ss_ds.merged.samereadgroup.cleaned	1072966	1072978		YPO_RS05795	12
ARS007ss_ds.merged.samereadgroup.cleaned	1073150	1073154		YPO_RS05795	4
ARS007ss_ds.merged.samereadgroup.cleaned	1073698	1073704		YPO_RS05795	6
ARS007ss_ds.merged.samereadgroup.cleaned	1073818	1073841		YPO_RS05795	23
ARS007ss_ds.merged.samereadgroup.cleaned	1077191	1077197		tssH	6
ARS007ss_ds.merged.samereadgroup.cleaned	1077416	1077421		tssH	5
ARS007ss_ds.merged.samereadgroup.cleaned	1077688	1077704		tssH	16
ARS007ss_ds.merged.samereadgroup.cleaned	1077856	1077859		tssH	3
ARS007ss_ds.merged.samereadgroup.cleaned	1078866	1078868		tssH	2
ARS007ss_ds.merged.samereadgroup.cleaned	1080046	1080048		YPO_RS05810	2
ARS007ss_ds.merged.samereadgroup.cleaned	1080608	1080609		YPO_RS05815	1
ARS007ss_ds.merged.samereadgroup.cleaned	1080829	1080835		YPO_RS05815	6
ARS007ss_ds.merged.samereadgroup.cleaned	1081438	1081444		YPO_RS05815	6
ARS007ss_ds.merged.samereadgroup.cleaned	1081960	1081961		YPO_RS05815	1
ARS007ss_ds.merged.samereadgroup.cleaned	1082032	1082034		YPO_RS05815	2
ARS007ss_ds.merged.samereadgroup.cleaned	1082311	1082321		YPO_RS05820	10
ARS007ss_ds.merged.samereadgroup.cleaned	1082898	1082902		YPO_RS05820	4
ARS007ss_ds.merged.samereadgroup.cleaned	1083171	1083181		tssK	10
ARS007ss_ds.merged.samereadgroup.cleaned	1084056	1084069		tssK	13
ARS007ss_ds.merged.samereadgroup.cleaned	1086155	1086160		tssB	5
ARS007ss_ds.merged.samereadgroup.cleaned	1086360	1086365		tssB	5
ARS007ss_ds.merged.samereadgroup.cleaned	1088715	1088738		YPO_RS05845	23
ARS007ss_ds.merged.samereadgroup.cleaned	1089071	1089082		YPO_RS05845	11
ARS007ss_ds.merged.samereadgroup.cleaned	1091411	1091419		YPO_RS05855	8
ARS007ss_ds.merged.samereadgroup.cleaned	1093575	1093587		YPO_RS05865	12
ARS007ss_ds.merged.samereadgroup.cleaned	1094577	1094578		YPO_RS05865	1
ARS007ss_ds.merged.samereadgroup.cleaned	1095512	1095535		YPO_RS05870	23
ARS007ss_ds.merged.samereadgroup.cleaned	1096076	1096089		YPO_RS05875	13
ARS007ss_ds.merged.samereadgroup.cleaned	1096311	1096356		YPO_RS05880	45
ARS007ss_ds.merged.samereadgroup.cleaned	1096818	1096845		YPO_RS05880	27
ARS007ss_ds.merged.samereadgroup.cleaned	1096968	1096971		YPO_RS05880	3
ARS007ss_ds.merged.samereadgroup.cleaned	1101098	1101108		iucC	10
ARS007ss_ds.merged.samereadgroup.cleaned	1101210	1101236		iucC	26
ARS007ss_ds.merged.samereadgroup.cleaned	1102123	1102128		YPO_RS05900	5
ARS007ss_ds.merged.samereadgroup.cleaned	1102803	1102811		YPO_RS05900	8
ARS007ss_ds.merged.samereadgroup.cleaned	1102834	1102835		YPO_RS05900	1
ARS007ss_ds.merged.samereadgroup.cleaned	1103127	1103129		YPO_RS05900	2
ARS007ss_ds.merged.samereadgroup.cleaned	1104317	1104370		YPO_RS05905	53
ARS007ss_ds.merged.samereadgroup.cleaned	1105121	1105123		YPO_RS05905	2
ARS007ss_ds.merged.samereadgroup.cleaned	1105351	1105371		YPO_RS05905	20
ARS007ss_ds.merged.samereadgroup.cleaned	1105999	1106010		YPO_RS05910	11
ARS007ss_ds.merged.samereadgroup.cleaned	1106587	1106591		YPO_RS05910	4
ARS007ss_ds.merged.samereadgroup.cleaned	1106987	1107013		YPO_RS05910	26
ARS007ss_ds.merged.samereadgroup.cleaned	1107119	1107130		YPO_RS05910	11
ARS007ss_ds.merged.samereadgroup.cleaned	1110746	1110748		YPO_RS05920	2
ARS007ss_ds.merged.samereadgroup.cleaned	1110890	1110894		YPO_RS05920	4
ARS007ss_ds.merged.samereadgroup.cleaned	1111045	1111056		YPO_RS05920	11
ARS007ss_ds.merged.samereadgroup.cleaned	1111256	1111291		YPO_RS05920	35
ARS007ss_ds.merged.samereadgroup.cleaned	1111345	1111351		YPO_RS05920	6
ARS007ss_ds.merged.samereadgroup.cleaned	1112267	1112287		YPO_RS05930	20
ARS007ss_ds.merged.samereadgroup.cleaned	1113230	1113237		YPO_RS05930	7
ARS007ss_ds.merged.samereadgroup.cleaned	1114911	1114927		YPO_RS05935	16
ARS007ss_ds.merged.samereadgroup.cleaned	1115264	1115274		YPO_RS05935	10
ARS007ss_ds.merged.samereadgroup.cleaned	1115469	1115478		YPO_RS05935	9
ARS007ss_ds.merged.samereadgroup.cleaned	1115617	1115620		YPO_RS05935	3
ARS007ss_ds.merged.samereadgroup.cleaned	1116072	1116074		YPO_RS05935	2
ARS007ss_ds.merged.samereadgroup.cleaned	1116708	1116710		YPO_RS05940	2
ARS007ss_ds.merged.samereadgroup.cleaned	1116943	1116945		YPO_RS05940	2
ARS007ss_ds.merged.samereadgroup.cleaned	1117086	1117125		YPO_RS05940	39
ARS007ss_ds.merged.samereadgroup.cleaned	1117256	1117286		YPO_RS05940	30
ARS007ss_ds.merged.samereadgroup.cleaned	1117586	1117604		YPO_RS05940	18
ARS007ss_ds.merged.samereadgroup.cleaned	1117925	1117928		YPO_RS05940	3
ARS007ss_ds.merged.samereadgroup.cleaned	1118025	1118107		YPO_RS05940	82
ARS007ss_ds.merged.samereadgroup.cleaned	1118878	1118903		YPO_RS05945	25
ARS007ss_ds.merged.samereadgroup.cleaned	1120403	1120409		yapH	6
ARS007ss_ds.merged.samereadgroup.cleaned	1120749	1120771		yapH	22
ARS007ss_ds.merged.samereadgroup.cleaned	1120901	1120913		yapH	12
ARS007ss_ds.merged.samereadgroup.cleaned	1121109	1121116		yapH	7
ARS007ss_ds.merged.samereadgroup.cleaned	1122721	1122724		yapH	3
ARS007ss_ds.merged.samereadgroup.cleaned	1122986	1122992		yapH	6
ARS007ss_ds.merged.samereadgroup.cleaned	1123154	1123175		yapH	21
ARS007ss_ds.merged.samereadgroup.cleaned	1123360	1123410		yapH	50
ARS007ss_ds.merged.samereadgroup.cleaned	1123639	1123654		yapH	15
ARS007ss_ds.merged.samereadgroup.cleaned	1123830	1123831		yapH	1
ARS007ss_ds.merged.samereadgroup.cleaned	1124075	1124105		yapH	30
ARS007ss_ds.merged.samereadgroup.cleaned	1124177	1124238		yapH	61
ARS007ss_ds.merged.samereadgroup.cleaned	1124279	1124284		yapH	5
ARS007ss_ds.merged.samereadgroup.cleaned	1124383	1124397		yapH	14
ARS007ss_ds.merged.samereadgroup.cleaned	1124457	1124492		yapH	35
ARS007ss_ds.merged.samereadgroup.cleaned	1124537	1124556		yapH	19
ARS007ss_ds.merged.samereadgroup.cleaned	1124608	1124620		yapH	12
ARS007ss_ds.merged.samereadgroup.cleaned	1124694	1124881		yapH	187
ARS007ss_ds.merged.samereadgroup.cleaned	1124975	1125006		yapH	31
ARS007ss_ds.merged.samereadgroup.cleaned	1125108	1125129		yapH	21
ARS007ss_ds.merged.samereadgroup.cleaned	1125163	1125258		yapH	95
ARS007ss_ds.merged.samereadgroup.cleaned	1125305	1125399		yapH	94
ARS007ss_ds.merged.samereadgroup.cleaned	1125443	1125475		yapH	32
ARS007ss_ds.merged.samereadgroup.cleaned	1125541	1125575		yapH	34
ARS007ss_ds.merged.samereadgroup.cleaned	1125651	1125695		yapH	44
ARS007ss_ds.merged.samereadgroup.cleaned	1126168	1126170		yapH	2
ARS007ss_ds.merged.samereadgroup.cleaned	1127245	1127246		yapH	1
ARS007ss_ds.merged.samereadgroup.cleaned	1127635	1127643		yapH	8
ARS007ss_ds.merged.samereadgroup.cleaned	1128710	1128726		yapH	16
ARS007ss_ds.merged.samereadgroup.cleaned	1128764	1128792		yapH	28
ARS007ss_ds.merged.samereadgroup.cleaned	1128831	1128846		yapH	15
ARS007ss_ds.merged.samereadgroup.cleaned	1129330	1129348		yapH	18
ARS007ss_ds.merged.samereadgroup.cleaned	1129583	1129589		yapH	6
ARS007ss_ds.merged.samereadgroup.cleaned	1129696	1129722		yapH	26
ARS007ss_ds.merged.samereadgroup.cleaned	1130357	1130360		yapH	3
ARS007ss_ds.merged.samereadgroup.cleaned	1131134	1131139		YPO_RS05955	5
ARS007ss_ds.merged.samereadgroup.cleaned	1132041	1132056		YPO_RS05955	15
ARS007ss_ds.merged.samereadgroup.cleaned	1132925	1132929		YPO_RS05955	4
ARS007ss_ds.merged.samereadgroup.cleaned	1133652	1133667		YPO_RS05965	15
ARS007ss_ds.merged.samereadgroup.cleaned	1134610	1134614		YPO_RS05970	4
ARS007ss_ds.merged.samereadgroup.cleaned	1134792	1134801		YPO_RS05970	9
ARS007ss_ds.merged.samereadgroup.cleaned	1134999	1135000		YPO_RS05970	1
ARS007ss_ds.merged.samereadgroup.cleaned	1135052	1135059		YPO_RS05970	7
ARS007ss_ds.merged.samereadgroup.cleaned	1135683	1135709		YPO_RS05970	26
ARS007ss_ds.merged.samereadgroup.cleaned	1135753	1135771		YPO_RS05970	18
ARS007ss_ds.merged.samereadgroup.cleaned	1136122	1136135		YPO_RS05970	13
ARS007ss_ds.merged.samereadgroup.cleaned	1137423	1137426		YPO_RS05975	3
ARS007ss_ds.merged.samereadgroup.cleaned	1137667	1137670		YPO_RS05975	3
ARS007ss_ds.merged.samereadgroup.cleaned	1137716	1137720		YPO_RS05975	4
ARS007ss_ds.merged.samereadgroup.cleaned	1138560	1138607		YPO_RS05975	47
ARS007ss_ds.merged.samereadgroup.cleaned	1139828	1139843		pepT	15
ARS007ss_ds.merged.samereadgroup.cleaned	1140443	1140455		YPO_RS05985	12
ARS007ss_ds.merged.samereadgroup.cleaned	1140714	1140736		YPO_RS05985	22
ARS007ss_ds.merged.samereadgroup.cleaned	1141262	1141263		YPO_RS05985	1
ARS007ss_ds.merged.samereadgroup.cleaned	1141691	1141704		YPO_RS05985	13
ARS007ss_ds.merged.samereadgroup.cleaned	1142083	1142099		YPO_RS05985	16
ARS007ss_ds.merged.samereadgroup.cleaned	1142183	1142198		YPO_RS05985	15
ARS007ss_ds.merged.samereadgroup.cleaned	1142428	1142437		YPO_RS05985	9
ARS007ss_ds.merged.samereadgroup.cleaned	1147962	1147964		YPO_RS06005	2
ARS007ss_ds.merged.samereadgroup.cleaned	1148603	1148624		YPO_RS06010	21
ARS007ss_ds.merged.samereadgroup.cleaned	1150819	1150829		recC	10
ARS007ss_ds.merged.samereadgroup.cleaned	1151725	1151733		recC	8
ARS007ss_ds.merged.samereadgroup.cleaned	1152638	1152642		recC	4
ARS007ss_ds.merged.samereadgroup.cleaned	1153391	1153399		ptrA	8
ARS007ss_ds.merged.samereadgroup.cleaned	1154047	1154052		ptrA	5
ARS007ss_ds.merged.samereadgroup.cleaned	1154162	1154189		ptrA	27
ARS007ss_ds.merged.samereadgroup.cleaned	1154338	1154342		ptrA	4
ARS007ss_ds.merged.samereadgroup.cleaned	1154687	1154714		ptrA	27
ARS007ss_ds.merged.samereadgroup.cleaned	1155163	1155165		ptrA	2
ARS007ss_ds.merged.samereadgroup.cleaned	1155433	1155437		ptrA	4
ARS007ss_ds.merged.samereadgroup.cleaned	1155586	1155593		ptrA	7
ARS007ss_ds.merged.samereadgroup.cleaned	1155923	1155924		ptrA	1
ARS007ss_ds.merged.samereadgroup.cleaned	1156006	1156059		recB	53
ARS007ss_ds.merged.samereadgroup.cleaned	1157364	1157407		recB	43
ARS007ss_ds.merged.samereadgroup.cleaned	1157504	1157537		recB	33
ARS007ss_ds.merged.samereadgroup.cleaned	1158881	1158897		recB	16
ARS007ss_ds.merged.samereadgroup.cleaned	1159013	1159015		recB	2
ARS007ss_ds.merged.samereadgroup.cleaned	1159866	1159884		recD	18
ARS007ss_ds.merged.samereadgroup.cleaned	1161066	1161067		recD	1
ARS007ss_ds.merged.samereadgroup.cleaned	1161570	1161575		recD	5
ARS007ss_ds.merged.samereadgroup.cleaned	1162453	1162460		argA	7
ARS007ss_ds.merged.samereadgroup.cleaned	1162735	1162738		argA	3
ARS007ss_ds.merged.samereadgroup.cleaned	1162899	1162948		argA	49
ARS007ss_ds.merged.samereadgroup.cleaned	1163506	1163509		YPO_RS06050	3
ARS007ss_ds.merged.samereadgroup.cleaned	1163760	1163770		YPO_RS06050	10
ARS007ss_ds.merged.samereadgroup.cleaned	1164419	1164426		YPO_RS06050	7
ARS007ss_ds.merged.samereadgroup.cleaned	1166424	1166432		mltA	8
ARS007ss_ds.merged.samereadgroup.cleaned	1167279	1167302		tcdA	23
ARS007ss_ds.merged.samereadgroup.cleaned	1167411	1167440		tcdA	29
ARS007ss_ds.merged.samereadgroup.cleaned	1167601	1167645		csdE	44
ARS007ss_ds.merged.samereadgroup.cleaned	1169371	1169385		YPO_RS06085	14
ARS007ss_ds.merged.samereadgroup.cleaned	1174554	1174574		YPO_RS06110	20
ARS007ss_ds.merged.samereadgroup.cleaned	1175374	1175382		queF	8
ARS007ss_ds.merged.samereadgroup.cleaned	1175927	1175930		queF	3
ARS007ss_ds.merged.samereadgroup.cleaned	1176045	1176058		queF	13
ARS007ss_ds.merged.samereadgroup.cleaned	1178377	1178384		YPO_RS06130	7
ARS007ss_ds.merged.samereadgroup.cleaned	1179169	1179177		truC	8
ARS007ss_ds.merged.samereadgroup.cleaned	1179230	1179249		truC	19
ARS007ss_ds.merged.samereadgroup.cleaned	1179380	1179381		YPO_RS06140	1
ARS007ss_ds.merged.samereadgroup.cleaned	1181524	1181529		glnD	5
ARS007ss_ds.merged.samereadgroup.cleaned	1181778	1181779		glnD	1
ARS007ss_ds.merged.samereadgroup.cleaned	1181822	1181824		glnD	2
ARS007ss_ds.merged.samereadgroup.cleaned	1181966	1181974		glnD	8
ARS007ss_ds.merged.samereadgroup.cleaned	1182516	1182520		glnD	4
ARS007ss_ds.merged.samereadgroup.cleaned	1182731	1182736		glnD	5
ARS007ss_ds.merged.samereadgroup.cleaned	1183895	1183908		glnD	13
ARS007ss_ds.merged.samereadgroup.cleaned	1184629	1184659		map	30
ARS007ss_ds.merged.samereadgroup.cleaned	1186005	1186006		rpsB	1
ARS007ss_ds.merged.samereadgroup.cleaned	1187572	1187577		pyrH	5
ARS007ss_ds.merged.samereadgroup.cleaned	1187687	1187697		pyrH	10
ARS007ss_ds.merged.samereadgroup.cleaned	1188250	1188269		frr	19
ARS007ss_ds.merged.samereadgroup.cleaned	1188360	1188385		frr	25
ARS007ss_ds.merged.samereadgroup.cleaned	1191375	1191380		cdsA	5
ARS007ss_ds.merged.samereadgroup.cleaned	1192144	1192151		rseP	7
ARS007ss_ds.merged.samereadgroup.cleaned	1192812	1192826		rseP	14
ARS007ss_ds.merged.samereadgroup.cleaned	1194728	1194738		bamA	10
ARS007ss_ds.merged.samereadgroup.cleaned	1198439	1198463		lpxA	24
ARS007ss_ds.merged.samereadgroup.cleaned	1198570	1198576		lpxA	6
ARS007ss_ds.merged.samereadgroup.cleaned	1199464	1199495		lpxB	31
ARS007ss_ds.merged.samereadgroup.cleaned	1201206	1201220		dnaE	14
ARS007ss_ds.merged.samereadgroup.cleaned	1201721	1201724		dnaE	3
ARS007ss_ds.merged.samereadgroup.cleaned	1201982	1202000		dnaE	18
ARS007ss_ds.merged.samereadgroup.cleaned	1202995	1203026		dnaE	31
ARS007ss_ds.merged.samereadgroup.cleaned	1203899	1203908		dnaE	9
ARS007ss_ds.merged.samereadgroup.cleaned	1204702	1204715		accA	13
ARS007ss_ds.merged.samereadgroup.cleaned	1204861	1204871		accA	10
ARS007ss_ds.merged.samereadgroup.cleaned	1205679	1205681		YPO_RS06250	2
ARS007ss_ds.merged.samereadgroup.cleaned	1206016	1206025		tilS	9
ARS007ss_ds.merged.samereadgroup.cleaned	1206795	1206798		tilS	3
ARS007ss_ds.merged.samereadgroup.cleaned	1207674	1207680		YPO_RS06260	6
ARS007ss_ds.merged.samereadgroup.cleaned	1211032	1211068		proS	36
ARS007ss_ds.merged.samereadgroup.cleaned	1211337	1211347		proS	10
ARS007ss_ds.merged.samereadgroup.cleaned	1214128	1214144		YPO_RS06305	16
ARS007ss_ds.merged.samereadgroup.cleaned	1214658	1214666		metI	8
ARS007ss_ds.merged.samereadgroup.cleaned	1214712	1214728		metI	16
ARS007ss_ds.merged.samereadgroup.cleaned	1215133	1215155		metI	22
ARS007ss_ds.merged.samereadgroup.cleaned	1215272	1215274		metN	2
ARS007ss_ds.merged.samereadgroup.cleaned	1217392	1217404		YPO_RS06325	12
ARS007ss_ds.merged.samereadgroup.cleaned	1223707	1223714		dkgB	7
ARS007ss_ds.merged.samereadgroup.cleaned	1223964	1223968		dkgB	4
ARS007ss_ds.merged.samereadgroup.cleaned	1225078	1225080		YPO_RS06365	2
ARS007ss_ds.merged.samereadgroup.cleaned	1225166	1225183		YPO_RS06365	17
ARS007ss_ds.merged.samereadgroup.cleaned	1226725	1226737		mltD	12
ARS007ss_ds.merged.samereadgroup.cleaned	1227193	1227194		gloB	1
ARS007ss_ds.merged.samereadgroup.cleaned	1227647	1227655		gloB	8
ARS007ss_ds.merged.samereadgroup.cleaned	1227984	1227987		YPO_RS06380	3
ARS007ss_ds.merged.samereadgroup.cleaned	1228812	1228815		rnhA	3
ARS007ss_ds.merged.samereadgroup.cleaned	1230765	1230766		YPO_RS06400	1
ARS007ss_ds.merged.samereadgroup.cleaned	1231268	1231287		YPO_RS06400	19
ARS007ss_ds.merged.samereadgroup.cleaned	1231566	1231568		YPO_RS06400	2
ARS007ss_ds.merged.samereadgroup.cleaned	1231680	1231689		YPO_RS06400	9
ARS007ss_ds.merged.samereadgroup.cleaned	1232123	1232127		YPO_RS06405	4
ARS007ss_ds.merged.samereadgroup.cleaned	1232276	1232282		YPO_RS06405	6
ARS007ss_ds.merged.samereadgroup.cleaned	1237287	1237320		YPO_RS06440	33
ARS007ss_ds.merged.samereadgroup.cleaned	1238019	1238021		YPO_RS06445	2
ARS007ss_ds.merged.samereadgroup.cleaned	1238181	1238200		YPO_RS06445	19
ARS007ss_ds.merged.samereadgroup.cleaned	1238875	1238878		YPO_RS06455	3
ARS007ss_ds.merged.samereadgroup.cleaned	1239276	1239289		YPO_RS06455	13
ARS007ss_ds.merged.samereadgroup.cleaned	1240744	1240759		YPO_RS06465	15
ARS007ss_ds.merged.samereadgroup.cleaned	1240821	1240826		YPO_RS06465	5
ARS007ss_ds.merged.samereadgroup.cleaned	1240944	1240969		YPO_RS06465	25
ARS007ss_ds.merged.samereadgroup.cleaned	1241053	1241134		YPO_RS06465	81
ARS007ss_ds.merged.samereadgroup.cleaned	1241447	1241456		YPO_RS06465	9
ARS007ss_ds.merged.samereadgroup.cleaned	1241538	1241567		YPO_RS06465	29
ARS007ss_ds.merged.samereadgroup.cleaned	1241901	1241906		YPO_RS06465	5
ARS007ss_ds.merged.samereadgroup.cleaned	1242249	1242251		YPO_RS06465	2
ARS007ss_ds.merged.samereadgroup.cleaned	1242528	1242533		YPO_RS06470	5
ARS007ss_ds.merged.samereadgroup.cleaned	1242580	1242593		YPO_RS06470	13
ARS007ss_ds.merged.samereadgroup.cleaned	1242667	1242670		YPO_RS06470	3
ARS007ss_ds.merged.samereadgroup.cleaned	1243202	1243210		YPO_RS06470	8
ARS007ss_ds.merged.samereadgroup.cleaned	1243332	1243334		YPO_RS06470	2
ARS007ss_ds.merged.samereadgroup.cleaned	1243484	1243540		YPO_RS06475	56
ARS007ss_ds.merged.samereadgroup.cleaned	1243884	1243886		YPO_RS06475	2
ARS007ss_ds.merged.samereadgroup.cleaned	1244034	1244047		YPO_RS06475	13
ARS007ss_ds.merged.samereadgroup.cleaned	1244490	1244491		YPO_RS06475	1
ARS007ss_ds.merged.samereadgroup.cleaned	1246748	1246754		YPO_RS06495	6
ARS007ss_ds.merged.samereadgroup.cleaned	1246841	1246848		YPO_RS06495	7
ARS007ss_ds.merged.samereadgroup.cleaned	1247720	1247729		bamE	9
ARS007ss_ds.merged.samereadgroup.cleaned	1249612	1249620		recN	8
ARS007ss_ds.merged.samereadgroup.cleaned	1250327	1250337		nadK	10
ARS007ss_ds.merged.samereadgroup.cleaned	1251756	1251764		YPO_RS06525	8
ARS007ss_ds.merged.samereadgroup.cleaned	1251903	1251908		YPO_RS06525	5
ARS007ss_ds.merged.samereadgroup.cleaned	1252507	1252510		YPO_RS06525	3
ARS007ss_ds.merged.samereadgroup.cleaned	1252616	1252624		YPO_RS06525	8
ARS007ss_ds.merged.samereadgroup.cleaned	1254015	1254017		sdhD	2
ARS007ss_ds.merged.samereadgroup.cleaned	1254255	1254273		sdhA	18
ARS007ss_ds.merged.samereadgroup.cleaned	1254865	1254876		sdhA	11
ARS007ss_ds.merged.samereadgroup.cleaned	1255191	1255193		sdhA	2
ARS007ss_ds.merged.samereadgroup.cleaned	1256002	1256005		YPO_RS06545	3
ARS007ss_ds.merged.samereadgroup.cleaned	1256224	1256232		YPO_RS06545	8
ARS007ss_ds.merged.samereadgroup.cleaned	1257715	1257723		sucA	8
ARS007ss_ds.merged.samereadgroup.cleaned	1257879	1257887		sucA	8
ARS007ss_ds.merged.samereadgroup.cleaned	1259653	1259655		sucA	2
ARS007ss_ds.merged.samereadgroup.cleaned	1261650	1261652		sucC	2
ARS007ss_ds.merged.samereadgroup.cleaned	1261775	1261784		sucC	9
ARS007ss_ds.merged.samereadgroup.cleaned	1262750	1262755		sucD	5
ARS007ss_ds.merged.samereadgroup.cleaned	1264795	1264816		cydA	21
ARS007ss_ds.merged.samereadgroup.cleaned	1264979	1264997		cydA	18
ARS007ss_ds.merged.samereadgroup.cleaned	1265660	1265671		cydB	11
ARS007ss_ds.merged.samereadgroup.cleaned	1266361	1266366		cydB	5
ARS007ss_ds.merged.samereadgroup.cleaned	1268156	1268161		tolQ	5
ARS007ss_ds.merged.samereadgroup.cleaned	1268363	1268377		tolR	14
ARS007ss_ds.merged.samereadgroup.cleaned	1268619	1268623		tolR	4
ARS007ss_ds.merged.samereadgroup.cleaned	1269078	1269085		tolA	7
ARS007ss_ds.merged.samereadgroup.cleaned	1269599	1269653		tolA	54
ARS007ss_ds.merged.samereadgroup.cleaned	1270517	1270543		tolB	26
ARS007ss_ds.merged.samereadgroup.cleaned	1271113	1271115		tolB	2
ARS007ss_ds.merged.samereadgroup.cleaned	1271241	1271246		tolB	5
ARS007ss_ds.merged.samereadgroup.cleaned	1272630	1272639		cpoB	9
ARS007ss_ds.merged.samereadgroup.cleaned	1274553	1274569		nadA	16
ARS007ss_ds.merged.samereadgroup.cleaned	1274625	1274642		nadA	17
ARS007ss_ds.merged.samereadgroup.cleaned	1275152	1275155		YPO_RS06645	3
ARS007ss_ds.merged.samereadgroup.cleaned	1275266	1275316		YPO_RS06645	50
ARS007ss_ds.merged.samereadgroup.cleaned	1275395	1275405		YPO_RS06645	10
ARS007ss_ds.merged.samereadgroup.cleaned	1275737	1275755		zitB	18
ARS007ss_ds.merged.samereadgroup.cleaned	1275901	1275921		zitB	20
ARS007ss_ds.merged.samereadgroup.cleaned	1276109	1276113		zitB	4
ARS007ss_ds.merged.samereadgroup.cleaned	1276303	1276319		zitB	16
ARS007ss_ds.merged.samereadgroup.cleaned	1276429	1276442		zitB	13
ARS007ss_ds.merged.samereadgroup.cleaned	1277856	1277859		aroG	3
ARS007ss_ds.merged.samereadgroup.cleaned	1280018	1280032		YPO_RS06670	14
ARS007ss_ds.merged.samereadgroup.cleaned	1280078	1280107		YPO_RS06670	29
ARS007ss_ds.merged.samereadgroup.cleaned	1281717	1281730		YPO_RS06680	13
ARS007ss_ds.merged.samereadgroup.cleaned	1282262	1282264		galM	2
ARS007ss_ds.merged.samereadgroup.cleaned	1285034	1285038		galT	4
ARS007ss_ds.merged.samereadgroup.cleaned	1285096	1285105		galT	9
ARS007ss_ds.merged.samereadgroup.cleaned	1285194	1285217		galT	23
ARS007ss_ds.merged.samereadgroup.cleaned	1285921	1285939		galE	18
ARS007ss_ds.merged.samereadgroup.cleaned	1286120	1286161		galE	41
ARS007ss_ds.merged.samereadgroup.cleaned	1286672	1286678		YPO_RS06710	6
ARS007ss_ds.merged.samereadgroup.cleaned	1287181	1287191		YPO_RS06710	10
ARS007ss_ds.merged.samereadgroup.cleaned	1287368	1287399		YPO_RS06710	31
ARS007ss_ds.merged.samereadgroup.cleaned	1287474	1287490		YPO_RS06710	16
ARS007ss_ds.merged.samereadgroup.cleaned	1288383	1288401		modF	18
ARS007ss_ds.merged.samereadgroup.cleaned	1288555	1288562		modF	7
ARS007ss_ds.merged.samereadgroup.cleaned	1290449	1290455		YPO_RS06725	6
ARS007ss_ds.merged.samereadgroup.cleaned	1291253	1291254		modA	1
ARS007ss_ds.merged.samereadgroup.cleaned	1291464	1291473		modA	9
ARS007ss_ds.merged.samereadgroup.cleaned	1291752	1291756		modB	4
ARS007ss_ds.merged.samereadgroup.cleaned	1292902	1292920		modC	18
ARS007ss_ds.merged.samereadgroup.cleaned	1293010	1293027		modC	17
ARS007ss_ds.merged.samereadgroup.cleaned	1293853	1293856		YPO_RS06745	3
ARS007ss_ds.merged.samereadgroup.cleaned	1294020	1294041		YPO_RS06745	21
ARS007ss_ds.merged.samereadgroup.cleaned	1295327	1295330		pgl	3
ARS007ss_ds.merged.samereadgroup.cleaned	1296109	1296114		bioA	5
ARS007ss_ds.merged.samereadgroup.cleaned	1296549	1296555		bioA	6
ARS007ss_ds.merged.samereadgroup.cleaned	1298643	1298649		bioF	6
ARS007ss_ds.merged.samereadgroup.cleaned	1299143	1299151		bioF	8
ARS007ss_ds.merged.samereadgroup.cleaned	1299231	1299239		bioF	8
ARS007ss_ds.merged.samereadgroup.cleaned	1300137	1300144		bioD	7
ARS007ss_ds.merged.samereadgroup.cleaned	1303977	1303980		uvrB	3
ARS007ss_ds.merged.samereadgroup.cleaned	1306161	1306200		yvcK	39
ARS007ss_ds.merged.samereadgroup.cleaned	1306259	1306265		yvcK	6
ARS007ss_ds.merged.samereadgroup.cleaned	1308634	1308654		moaD	20
ARS007ss_ds.merged.samereadgroup.cleaned	1308807	1308810		moaE	3
ARS007ss_ds.merged.samereadgroup.cleaned	1308891	1308893		moaE	2
ARS007ss_ds.merged.samereadgroup.cleaned	1309747	1309768		YPO_RS06820	21
ARS007ss_ds.merged.samereadgroup.cleaned	1311091	1311103		betA	12
ARS007ss_ds.merged.samereadgroup.cleaned	1311869	1311884		betA	15
ARS007ss_ds.merged.samereadgroup.cleaned	1311984	1312005		betA	21
ARS007ss_ds.merged.samereadgroup.cleaned	1312984	1312990		betB	6
ARS007ss_ds.merged.samereadgroup.cleaned	1315545	1315555		YPO_RS06845	10
ARS007ss_ds.merged.samereadgroup.cleaned	1316285	1316286		YPO_RS06845	1
ARS007ss_ds.merged.samereadgroup.cleaned	1317532	1317549		YPO_RS06850	17
ARS007ss_ds.merged.samereadgroup.cleaned	1318370	1318386		YPO_RS06855	16
ARS007ss_ds.merged.samereadgroup.cleaned	1322223	1322254		YPO_RS06875	31
ARS007ss_ds.merged.samereadgroup.cleaned	1322302	1322312		YPO_RS06875	10
ARS007ss_ds.merged.samereadgroup.cleaned	1322381	1322419		YPO_RS06875	38
ARS007ss_ds.merged.samereadgroup.cleaned	1322731	1322737		YPO_RS06875	6
ARS007ss_ds.merged.samereadgroup.cleaned	1322828	1322843		YPO_RS06875	15
ARS007ss_ds.merged.samereadgroup.cleaned	1322961	1322979		YPO_RS06875	18
ARS007ss_ds.merged.samereadgroup.cleaned	1323035	1323042		YPO_RS06875	7
ARS007ss_ds.merged.samereadgroup.cleaned	1323576	1323602		dusC	26
ARS007ss_ds.merged.samereadgroup.cleaned	1325136	1325144		pbpG	8
ARS007ss_ds.merged.samereadgroup.cleaned	1325269	1325270		pbpG	1
ARS007ss_ds.merged.samereadgroup.cleaned	1326169	1326181		dld	12
ARS007ss_ds.merged.samereadgroup.cleaned	1326660	1326673		dld	13
ARS007ss_ds.merged.samereadgroup.cleaned	1327605	1327612		dld	7
ARS007ss_ds.merged.samereadgroup.cleaned	1329809	1329814		YPO_RS06910	5
ARS007ss_ds.merged.samereadgroup.cleaned	1329955	1330004		YPO_RS06910	49
ARS007ss_ds.merged.samereadgroup.cleaned	1331069	1331075		phnC	6
ARS007ss_ds.merged.samereadgroup.cleaned	1331234	1331253		phnC	19
ARS007ss_ds.merged.samereadgroup.cleaned	1331718	1331720		phnD	2
ARS007ss_ds.merged.samereadgroup.cleaned	1331818	1331820		phnD	2
ARS007ss_ds.merged.samereadgroup.cleaned	1332198	1332217		phnD	19
ARS007ss_ds.merged.samereadgroup.cleaned	1332285	1332288		phnD	3
ARS007ss_ds.merged.samereadgroup.cleaned	1333249	1333255		phnE	6
ARS007ss_ds.merged.samereadgroup.cleaned	1334392	1334411		phnE	19
ARS007ss_ds.merged.samereadgroup.cleaned	1334740	1334777		YPO_RS06940	37
ARS007ss_ds.merged.samereadgroup.cleaned	1334965	1334980		YPO_RS06940	15
ARS007ss_ds.merged.samereadgroup.cleaned	1336636	1336644		urtA	8
ARS007ss_ds.merged.samereadgroup.cleaned	1337584	1337588		urtB	4
ARS007ss_ds.merged.samereadgroup.cleaned	1337734	1337758		urtB	24
ARS007ss_ds.merged.samereadgroup.cleaned	1338464	1338470		urtB	6
ARS007ss_ds.merged.samereadgroup.cleaned	1338617	1338635		urtB	18
ARS007ss_ds.merged.samereadgroup.cleaned	1338680	1338689		urtC	9
ARS007ss_ds.merged.samereadgroup.cleaned	1339454	1339461		urtC	7
ARS007ss_ds.merged.samereadgroup.cleaned	1339922	1339930		urtD	8
ARS007ss_ds.merged.samereadgroup.cleaned	1339994	1340005		urtD	11
ARS007ss_ds.merged.samereadgroup.cleaned	1340306	1340320		urtD	14
ARS007ss_ds.merged.samereadgroup.cleaned	1340669	1340674		urtE	5
ARS007ss_ds.merged.samereadgroup.cleaned	1340835	1340851		urtE	16
ARS007ss_ds.merged.samereadgroup.cleaned	1341138	1341160		urtE	22
ARS007ss_ds.merged.samereadgroup.cleaned	1341496	1341507		YPO_RS06970	11
ARS007ss_ds.merged.samereadgroup.cleaned	1341684	1341698		YPO_RS06970	14
ARS007ss_ds.merged.samereadgroup.cleaned	1342057	1342069		YPO_RS06970	12
ARS007ss_ds.merged.samereadgroup.cleaned	1342623	1342635		YPO_RS06975	12
ARS007ss_ds.merged.samereadgroup.cleaned	1343989	1343994		sseA	5
ARS007ss_ds.merged.samereadgroup.cleaned	1344060	1344061		sseA	1
ARS007ss_ds.merged.samereadgroup.cleaned	1344340	1344345		sseA	5
ARS007ss_ds.merged.samereadgroup.cleaned	1344554	1344572		sseA	18
ARS007ss_ds.merged.samereadgroup.cleaned	1346166	1346167		YPO_RS06990	1
ARS007ss_ds.merged.samereadgroup.cleaned	1346957	1346960		YPO_RS06995	3
ARS007ss_ds.merged.samereadgroup.cleaned	1347218	1347221		YPO_RS06995	3
ARS007ss_ds.merged.samereadgroup.cleaned	1347542	1347549		YPO_RS06995	7
ARS007ss_ds.merged.samereadgroup.cleaned	1347694	1347703		YPO_RS06995	9
ARS007ss_ds.merged.samereadgroup.cleaned	1347896	1347904		YPO_RS07000	8
ARS007ss_ds.merged.samereadgroup.cleaned	1349393	1349405		YPO_RS07005	12
ARS007ss_ds.merged.samereadgroup.cleaned	1350091	1350096		adiC	5
ARS007ss_ds.merged.samereadgroup.cleaned	1350130	1350135		adiC	5
ARS007ss_ds.merged.samereadgroup.cleaned	1350463	1350483		adiC	20
ARS007ss_ds.merged.samereadgroup.cleaned	1351179	1351189		adiC	10
ARS007ss_ds.merged.samereadgroup.cleaned	1351332	1351338		adiC	6
ARS007ss_ds.merged.samereadgroup.cleaned	1351558	1351567		YPO_RS07015	9
ARS007ss_ds.merged.samereadgroup.cleaned	1352850	1352861		YPO_RS07015	11
ARS007ss_ds.merged.samereadgroup.cleaned	1353401	1353404		YPO_RS07015	3
ARS007ss_ds.merged.samereadgroup.cleaned	1353565	1353574		YPO_RS07015	9
ARS007ss_ds.merged.samereadgroup.cleaned	1353677	1353687		YPO_RS07015	10
ARS007ss_ds.merged.samereadgroup.cleaned	1355020	1355023		yedA	3
ARS007ss_ds.merged.samereadgroup.cleaned	1355738	1355740		ompF2	2
ARS007ss_ds.merged.samereadgroup.cleaned	1356512	1356525		ompF2	13
ARS007ss_ds.merged.samereadgroup.cleaned	1357679	1357686		dinG	7
ARS007ss_ds.merged.samereadgroup.cleaned	1359055	1359056		dinG	1
ARS007ss_ds.merged.samereadgroup.cleaned	1359329	1359332		YPO_RS07040	3
ARS007ss_ds.merged.samereadgroup.cleaned	1359802	1359807		YPO_RS07040	5
ARS007ss_ds.merged.samereadgroup.cleaned	1361136	1361144		YPO_RS07045	8
ARS007ss_ds.merged.samereadgroup.cleaned	1361227	1361234		YPO_RS07045	7
ARS007ss_ds.merged.samereadgroup.cleaned	1361781	1361786		tyrP	5
ARS007ss_ds.merged.samereadgroup.cleaned	1362374	1362378		tyrP	4
ARS007ss_ds.merged.samereadgroup.cleaned	1363760	1363773		YPO_RS07055	13
ARS007ss_ds.merged.samereadgroup.cleaned	1364058	1364065		YPO_RS07055	7
ARS007ss_ds.merged.samereadgroup.cleaned	1364731	1364740		YPO_RS07055	9
ARS007ss_ds.merged.samereadgroup.cleaned	1364930	1364941		eco	11
ARS007ss_ds.merged.samereadgroup.cleaned	1365305	1365368		eco	63
ARS007ss_ds.merged.samereadgroup.cleaned	1365629	1365630		YPO_RS07065	1
ARS007ss_ds.merged.samereadgroup.cleaned	1365804	1365832		nrdB	28
ARS007ss_ds.merged.samereadgroup.cleaned	1366274	1366300		nrdB	26
ARS007ss_ds.merged.samereadgroup.cleaned	1367131	1367132		nrdA	1
ARS007ss_ds.merged.samereadgroup.cleaned	1367747	1367757		nrdA	10
ARS007ss_ds.merged.samereadgroup.cleaned	1367788	1367789		nrdA	1
ARS007ss_ds.merged.samereadgroup.cleaned	1368586	1368606		nrdA	20
ARS007ss_ds.merged.samereadgroup.cleaned	1371324	1371357		gyrA	33
ARS007ss_ds.merged.samereadgroup.cleaned	1372362	1372364		gyrA	2
ARS007ss_ds.merged.samereadgroup.cleaned	1372947	1372951		gyrA	4
ARS007ss_ds.merged.samereadgroup.cleaned	1372999	1373001		gyrA	2
ARS007ss_ds.merged.samereadgroup.cleaned	1373178	1373185		gyrA	7
ARS007ss_ds.merged.samereadgroup.cleaned	1374494	1374511		rcsC	17
ARS007ss_ds.merged.samereadgroup.cleaned	1374741	1374764		rcsC	23
ARS007ss_ds.merged.samereadgroup.cleaned	1376221	1376236		rcsC	15
ARS007ss_ds.merged.samereadgroup.cleaned	1378600	1378625		rcsD	25
ARS007ss_ds.merged.samereadgroup.cleaned	1379045	1379046		rcsD	1
ARS007ss_ds.merged.samereadgroup.cleaned	1379092	1379095		rcsD	3
ARS007ss_ds.merged.samereadgroup.cleaned	1380153	1380180		YPO_RS07110	27
ARS007ss_ds.merged.samereadgroup.cleaned	1380435	1380442		YPO_RS07110	7
ARS007ss_ds.merged.samereadgroup.cleaned	1380892	1380894		YPO_RS07110	2
ARS007ss_ds.merged.samereadgroup.cleaned	1382770	1382773		YPO_RS07115	3
ARS007ss_ds.merged.samereadgroup.cleaned	1385432	1385450		ampH	18
ARS007ss_ds.merged.samereadgroup.cleaned	1386223	1386230		YPO_RS07140	7
ARS007ss_ds.merged.samereadgroup.cleaned	1386642	1386645		YPO_RS07140	3
ARS007ss_ds.merged.samereadgroup.cleaned	1387517	1387524		YPO_RS07140	7
ARS007ss_ds.merged.samereadgroup.cleaned	1387557	1387563		YPO_RS07140	6
ARS007ss_ds.merged.samereadgroup.cleaned	1387603	1387610		YPO_RS07140	7
ARS007ss_ds.merged.samereadgroup.cleaned	1388794	1388807		YPO_RS07145	13
ARS007ss_ds.merged.samereadgroup.cleaned	1388876	1388879		YPO_RS07145	3
ARS007ss_ds.merged.samereadgroup.cleaned	1389501	1389504		YPO_RS07150	3
ARS007ss_ds.merged.samereadgroup.cleaned	1390171	1390174		YPO_RS07150	3
ARS007ss_ds.merged.samereadgroup.cleaned	1390422	1390466		YPO_RS07150	44
ARS007ss_ds.merged.samereadgroup.cleaned	1390815	1390825		YPO_RS07150	10
ARS007ss_ds.merged.samereadgroup.cleaned	1392224	1392227		ycoA	3
ARS007ss_ds.merged.samereadgroup.cleaned	1394070	1394075		YPO_RS07170	5
ARS007ss_ds.merged.samereadgroup.cleaned	1394113	1394126		YPO_RS07170	13
ARS007ss_ds.merged.samereadgroup.cleaned	1394754	1394760		YPO_RS07175	6
ARS007ss_ds.merged.samereadgroup.cleaned	1396719	1396738		YPO_RS07185	19
ARS007ss_ds.merged.samereadgroup.cleaned	1397321	1397325		YPO_RS07185	4
ARS007ss_ds.merged.samereadgroup.cleaned	1397496	1397517		YPO_RS07190	21
ARS007ss_ds.merged.samereadgroup.cleaned	1397819	1397828		YPO_RS07190	9
ARS007ss_ds.merged.samereadgroup.cleaned	1398854	1398855		YPO_RS07195	1
ARS007ss_ds.merged.samereadgroup.cleaned	1399041	1399046		YPO_RS07195	5
ARS007ss_ds.merged.samereadgroup.cleaned	1399375	1399385		YPO_RS07200	10
ARS007ss_ds.merged.samereadgroup.cleaned	1399953	1399954		YPO_RS07205	1
ARS007ss_ds.merged.samereadgroup.cleaned	1400258	1400261		YPO_RS07210	3
ARS007ss_ds.merged.samereadgroup.cleaned	1400438	1400450		YPO_RS07210	12
ARS007ss_ds.merged.samereadgroup.cleaned	1400585	1400589		YPO_RS07210	4
ARS007ss_ds.merged.samereadgroup.cleaned	1401039	1401050		YPO_RS07210	11
ARS007ss_ds.merged.samereadgroup.cleaned	1402027	1402043		YPO_RS07220	16
ARS007ss_ds.merged.samereadgroup.cleaned	1402315	1402332		YPO_RS07225	17
ARS007ss_ds.merged.samereadgroup.cleaned	1402528	1402543		YPO_RS07225	15
ARS007ss_ds.merged.samereadgroup.cleaned	1402909	1402911		YPO_RS07225	2
ARS007ss_ds.merged.samereadgroup.cleaned	1402971	1402977		YPO_RS07225	6
ARS007ss_ds.merged.samereadgroup.cleaned	1403247	1403250		YPO_RS07225	3
ARS007ss_ds.merged.samereadgroup.cleaned	1404428	1404446		YPO_RS07230	18
ARS007ss_ds.merged.samereadgroup.cleaned	1404739	1404744		YPO_RS07230	5
ARS007ss_ds.merged.samereadgroup.cleaned	1404829	1404839		YPO_RS07230	10
ARS007ss_ds.merged.samereadgroup.cleaned	1404944	1404947		YPO_RS07230	3
ARS007ss_ds.merged.samereadgroup.cleaned	1405208	1405221		YPO_RS07230	13
ARS007ss_ds.merged.samereadgroup.cleaned	1405337	1405341		YPO_RS07230	4
ARS007ss_ds.merged.samereadgroup.cleaned	1405601	1405612		YPO_RS07235	11
ARS007ss_ds.merged.samereadgroup.cleaned	1405657	1405661		YPO_RS07235	4
ARS007ss_ds.merged.samereadgroup.cleaned	1405841	1405843		YPO_RS07235	2
ARS007ss_ds.merged.samereadgroup.cleaned	1405930	1405957		YPO_RS07235	27
ARS007ss_ds.merged.samereadgroup.cleaned	1405991	1406010		YPO_RS07235	19
ARS007ss_ds.merged.samereadgroup.cleaned	1406116	1406124		YPO_RS07235	8
ARS007ss_ds.merged.samereadgroup.cleaned	1406730	1406734		YPO_RS07240	4
ARS007ss_ds.merged.samereadgroup.cleaned	1406846	1406869		YPO_RS07240	23
ARS007ss_ds.merged.samereadgroup.cleaned	1407550	1407558		YPO_RS07245	8
ARS007ss_ds.merged.samereadgroup.cleaned	1407747	1407752		YPO_RS07250	5
ARS007ss_ds.merged.samereadgroup.cleaned	1407921	1407940		YPO_RS07250	19
ARS007ss_ds.merged.samereadgroup.cleaned	1408249	1408271		YPO_RS07250	22
ARS007ss_ds.merged.samereadgroup.cleaned	1408537	1408541		YPO_RS07250	4
ARS007ss_ds.merged.samereadgroup.cleaned	1409289	1409306		YPO_RS07260	17
ARS007ss_ds.merged.samereadgroup.cleaned	1409868	1409881		YPO_RS07265	13
ARS007ss_ds.merged.samereadgroup.cleaned	1409911	1409925		YPO_RS07265	14
ARS007ss_ds.merged.samereadgroup.cleaned	1410048	1410053		YPO_RS07265	5
ARS007ss_ds.merged.samereadgroup.cleaned	1410600	1410601		YPO_RS07270	1
ARS007ss_ds.merged.samereadgroup.cleaned	1410900	1410936		YPO_RS07270	36
ARS007ss_ds.merged.samereadgroup.cleaned	1411191	1411220		YPO_RS07270	29
ARS007ss_ds.merged.samereadgroup.cleaned	1411638	1411642		YPO_RS07275	4
ARS007ss_ds.merged.samereadgroup.cleaned	1412135	1412147		YPO_RS07275	12
ARS007ss_ds.merged.samereadgroup.cleaned	1414492	1414506		YPO_RS07285	14
ARS007ss_ds.merged.samereadgroup.cleaned	1414593	1414601		YPO_RS07285	8
ARS007ss_ds.merged.samereadgroup.cleaned	1415487	1415499		YPO_RS07290	12
ARS007ss_ds.merged.samereadgroup.cleaned	1416310	1416312		YPO_RS07295	2
ARS007ss_ds.merged.samereadgroup.cleaned	1417182	1417185		YPO_RS07305	3
ARS007ss_ds.merged.samereadgroup.cleaned	1417639	1417647		YPO_RS07305	8
ARS007ss_ds.merged.samereadgroup.cleaned	1418391	1418394		YPO_RS07305	3
ARS007ss_ds.merged.samereadgroup.cleaned	1418723	1418727		YPO_RS07310	4
ARS007ss_ds.merged.samereadgroup.cleaned	1422131	1422138		YPO_RS07330	7
ARS007ss_ds.merged.samereadgroup.cleaned	1422267	1422275		YPO_RS07330	8
ARS007ss_ds.merged.samereadgroup.cleaned	1423602	1423612		rsuA	10
ARS007ss_ds.merged.samereadgroup.cleaned	1423849	1423855		rsuA	6
ARS007ss_ds.merged.samereadgroup.cleaned	1424777	1424790		YPO_RS07340	13
ARS007ss_ds.merged.samereadgroup.cleaned	1424848	1424874		YPO_RS07340	26
ARS007ss_ds.merged.samereadgroup.cleaned	1425278	1425281		YPO_RS07340	3
ARS007ss_ds.merged.samereadgroup.cleaned	1425496	1425500		YPO_RS07340	4
ARS007ss_ds.merged.samereadgroup.cleaned	1427215	1427224		yejF	9
ARS007ss_ds.merged.samereadgroup.cleaned	1427739	1427750		yejF	11
ARS007ss_ds.merged.samereadgroup.cleaned	1428791	1428792		YPO_RS07355	1
ARS007ss_ds.merged.samereadgroup.cleaned	1428961	1428976		YPO_RS07355	15
ARS007ss_ds.merged.samereadgroup.cleaned	1429146	1429147		YPO_RS07355	1
ARS007ss_ds.merged.samereadgroup.cleaned	1429207	1429217		YPO_RS07355	10
ARS007ss_ds.merged.samereadgroup.cleaned	1429663	1429670		YPO_RS07360	7
ARS007ss_ds.merged.samereadgroup.cleaned	1429818	1429835		YPO_RS07360	17
ARS007ss_ds.merged.samereadgroup.cleaned	1430123	1430177		YPO_RS07360	54
ARS007ss_ds.merged.samereadgroup.cleaned	1430437	1430443		YPO_RS07360	6
ARS007ss_ds.merged.samereadgroup.cleaned	1430478	1430480		YPO_RS07360	2
ARS007ss_ds.merged.samereadgroup.cleaned	1430556	1430559		YPO_RS07360	3
ARS007ss_ds.merged.samereadgroup.cleaned	1430646	1430651		YPO_RS07365	5
ARS007ss_ds.merged.samereadgroup.cleaned	1431800	1431833		YPO_RS07365	33
ARS007ss_ds.merged.samereadgroup.cleaned	1431996	1432000		YPO_RS07365	4
ARS007ss_ds.merged.samereadgroup.cleaned	1432932	1432939		YPO_RS07370	7
ARS007ss_ds.merged.samereadgroup.cleaned	1433310	1433313		YPO_RS07370	3
ARS007ss_ds.merged.samereadgroup.cleaned	1433895	1433909		YPO_RS07370	14
ARS007ss_ds.merged.samereadgroup.cleaned	1433956	1433985		YPO_RS07370	29
ARS007ss_ds.merged.samereadgroup.cleaned	1435803	1435806		YPO_RS07380	3
ARS007ss_ds.merged.samereadgroup.cleaned	1436349	1436373		YPO_RS07380	24
ARS007ss_ds.merged.samereadgroup.cleaned	1436775	1436790		YPO_RS07385	15
ARS007ss_ds.merged.samereadgroup.cleaned	1437260	1437267		YPO_RS07385	7
ARS007ss_ds.merged.samereadgroup.cleaned	1440027	1440032		YPO_RS07395	5
ARS007ss_ds.merged.samereadgroup.cleaned	1440139	1440149		YPO_RS07395	10
ARS007ss_ds.merged.samereadgroup.cleaned	1440502	1440509		YPO_RS07395	7
ARS007ss_ds.merged.samereadgroup.cleaned	1441972	1441975		uxuA	3
ARS007ss_ds.merged.samereadgroup.cleaned	1442181	1442186		uxuA	5
ARS007ss_ds.merged.samereadgroup.cleaned	1444301	1444305		mtr	4
ARS007ss_ds.merged.samereadgroup.cleaned	1445173	1445177		YPO_RS07420	4
ARS007ss_ds.merged.samereadgroup.cleaned	1446024	1446026		YPO_RS07425	2
ARS007ss_ds.merged.samereadgroup.cleaned	1446500	1446505		YPO_RS07425	5
ARS007ss_ds.merged.samereadgroup.cleaned	1446750	1446753		YPO_RS07425	3
ARS007ss_ds.merged.samereadgroup.cleaned	1447165	1447174		YPO_RS07430	9
ARS007ss_ds.merged.samereadgroup.cleaned	1447793	1447801		YPO_RS07430	8
ARS007ss_ds.merged.samereadgroup.cleaned	1447884	1447902		YPO_RS07430	18
ARS007ss_ds.merged.samereadgroup.cleaned	1448914	1448943		YPO_RS07435	29
ARS007ss_ds.merged.samereadgroup.cleaned	1449012	1449023		YPO_RS07435	11
ARS007ss_ds.merged.samereadgroup.cleaned	1449393	1449394		YPO_RS07435	1
ARS007ss_ds.merged.samereadgroup.cleaned	1449532	1449554		YPO_RS07435	22
ARS007ss_ds.merged.samereadgroup.cleaned	1449828	1449831		YPO_RS07435	3
ARS007ss_ds.merged.samereadgroup.cleaned	1450093	1450127		xylB	34
ARS007ss_ds.merged.samereadgroup.cleaned	1450277	1450292		xylB	15
ARS007ss_ds.merged.samereadgroup.cleaned	1450556	1450559		xylB	3
ARS007ss_ds.merged.samereadgroup.cleaned	1451091	1451099		xylB	8
ARS007ss_ds.merged.samereadgroup.cleaned	1451134	1451135		xylB	1
ARS007ss_ds.merged.samereadgroup.cleaned	1451273	1451282		xylB	9
ARS007ss_ds.merged.samereadgroup.cleaned	1451369	1451374		xylB	5
ARS007ss_ds.merged.samereadgroup.cleaned	1452020	1452027		rpiA	7
ARS007ss_ds.merged.samereadgroup.cleaned	1452611	1452621		YPO_RS07450	10
ARS007ss_ds.merged.samereadgroup.cleaned	1453031	1453033		YPO_RS07450	2
ARS007ss_ds.merged.samereadgroup.cleaned	1454669	1454699		YPO_RS07455	30
ARS007ss_ds.merged.samereadgroup.cleaned	1454809	1454813		YPO_RS07455	4
ARS007ss_ds.merged.samereadgroup.cleaned	1455381	1455382		YPO_RS07460	1
ARS007ss_ds.merged.samereadgroup.cleaned	1456699	1456713		YPO_RS07465	14
ARS007ss_ds.merged.samereadgroup.cleaned	1457177	1457189		YPO_RS07470	12
ARS007ss_ds.merged.samereadgroup.cleaned	1457588	1457611		YPO_RS07470	23
ARS007ss_ds.merged.samereadgroup.cleaned	1458377	1458378		fruK	1
ARS007ss_ds.merged.samereadgroup.cleaned	1458957	1458981		fruK	24
ARS007ss_ds.merged.samereadgroup.cleaned	1459264	1459270		fruA	6
ARS007ss_ds.merged.samereadgroup.cleaned	1460017	1460026		fruA	9
ARS007ss_ds.merged.samereadgroup.cleaned	1460710	1460739		fruA	29
ARS007ss_ds.merged.samereadgroup.cleaned	1461364	1461389		YPO_RS07485	25
ARS007ss_ds.merged.samereadgroup.cleaned	1461559	1461572		YPO_RS07485	13
ARS007ss_ds.merged.samereadgroup.cleaned	1461769	1461816		YPO_RS07490	47
ARS007ss_ds.merged.samereadgroup.cleaned	1462027	1462031		YPO_RS07490	4
ARS007ss_ds.merged.samereadgroup.cleaned	1462105	1462118		YPO_RS07490	13
ARS007ss_ds.merged.samereadgroup.cleaned	1462186	1462204		YPO_RS07490	18
ARS007ss_ds.merged.samereadgroup.cleaned	1463105	1463122		psaA	17
ARS007ss_ds.merged.samereadgroup.cleaned	1463185	1463186		psaA	1
ARS007ss_ds.merged.samereadgroup.cleaned	1463379	1463429		YPO_RS07500	50
ARS007ss_ds.merged.samereadgroup.cleaned	1463538	1463558		YPO_RS07500	20
ARS007ss_ds.merged.samereadgroup.cleaned	1464102	1464105		YPO_RS07500	3
ARS007ss_ds.merged.samereadgroup.cleaned	1464655	1464661		psaC	6
ARS007ss_ds.merged.samereadgroup.cleaned	1464886	1464892		psaC	6
ARS007ss_ds.merged.samereadgroup.cleaned	1465071	1465089		psaC	18
ARS007ss_ds.merged.samereadgroup.cleaned	1466221	1466229		psaC	8
ARS007ss_ds.merged.samereadgroup.cleaned	1467663	1467666		nfo	3
ARS007ss_ds.merged.samereadgroup.cleaned	1468601	1468604		YPO_RS07515	3
ARS007ss_ds.merged.samereadgroup.cleaned	1470047	1470052		YPO_RS07520	5
ARS007ss_ds.merged.samereadgroup.cleaned	1470329	1470343		YPO_RS07520	14
ARS007ss_ds.merged.samereadgroup.cleaned	1470841	1470846		YPO_RS07525	5
ARS007ss_ds.merged.samereadgroup.cleaned	1470889	1470906		YPO_RS07525	17
ARS007ss_ds.merged.samereadgroup.cleaned	1471599	1471629		YPO_RS07525	30
ARS007ss_ds.merged.samereadgroup.cleaned	1472169	1472170		YPO_RS07525	1
ARS007ss_ds.merged.samereadgroup.cleaned	1474296	1474299		YPO_RS07535	3
ARS007ss_ds.merged.samereadgroup.cleaned	1474805	1474808		YPO_RS07535	3
ARS007ss_ds.merged.samereadgroup.cleaned	1474943	1474948		YPO_RS07535	5
ARS007ss_ds.merged.samereadgroup.cleaned	1475070	1475078		YPO_RS07540	8
ARS007ss_ds.merged.samereadgroup.cleaned	1475527	1475537		YPO_RS07540	10
ARS007ss_ds.merged.samereadgroup.cleaned	1475568	1475578		YPO_RS07540	10
ARS007ss_ds.merged.samereadgroup.cleaned	1476436	1476446		YPO_RS07545	10
ARS007ss_ds.merged.samereadgroup.cleaned	1476493	1476495		YPO_RS07545	2
ARS007ss_ds.merged.samereadgroup.cleaned	1476779	1476781		YPO_RS07545	2
ARS007ss_ds.merged.samereadgroup.cleaned	1476980	1477034		YPO_RS07545	54
ARS007ss_ds.merged.samereadgroup.cleaned	1477307	1477335		YPO_RS07545	28
ARS007ss_ds.merged.samereadgroup.cleaned	1477516	1477518		YPO_RS07545	2
ARS007ss_ds.merged.samereadgroup.cleaned	1477712	1477718		YPO_RS07545	6
ARS007ss_ds.merged.samereadgroup.cleaned	1477858	1477860		YPO_RS07545	2
ARS007ss_ds.merged.samereadgroup.cleaned	1477956	1477990		YPO_RS07545	34
ARS007ss_ds.merged.samereadgroup.cleaned	1478381	1478395		YPO_RS07550	14
ARS007ss_ds.merged.samereadgroup.cleaned	1478782	1478795		YPO_RS07550	13
ARS007ss_ds.merged.samereadgroup.cleaned	1479044	1479048		YPO_RS07555	4
ARS007ss_ds.merged.samereadgroup.cleaned	1480271	1480275		YPO_RS07560	4
ARS007ss_ds.merged.samereadgroup.cleaned	1481014	1481019		YPO_RS07560	5
ARS007ss_ds.merged.samereadgroup.cleaned	1481908	1481912		YPO_RS07565	4
ARS007ss_ds.merged.samereadgroup.cleaned	1482169	1482172		YPO_RS07565	3
ARS007ss_ds.merged.samereadgroup.cleaned	1482340	1482341		YPO_RS07570	1
ARS007ss_ds.merged.samereadgroup.cleaned	1482768	1482774		YPO_RS07570	6
ARS007ss_ds.merged.samereadgroup.cleaned	1483210	1483212		YPO_RS07570	2
ARS007ss_ds.merged.samereadgroup.cleaned	1483548	1483557		YPO_RS07575	9
ARS007ss_ds.merged.samereadgroup.cleaned	1483593	1483594		YPO_RS07575	1
ARS007ss_ds.merged.samereadgroup.cleaned	1483859	1483862		YPO_RS07575	3
ARS007ss_ds.merged.samereadgroup.cleaned	1485009	1485025		YPO_RS07580	16
ARS007ss_ds.merged.samereadgroup.cleaned	1486818	1486829		YPO_RS07585	11
ARS007ss_ds.merged.samereadgroup.cleaned	1488861	1488862		deoR	1
ARS007ss_ds.merged.samereadgroup.cleaned	1489397	1489398		YPO_RS07595	1
ARS007ss_ds.merged.samereadgroup.cleaned	1490258	1490262		ybjG	4
ARS007ss_ds.merged.samereadgroup.cleaned	1490476	1490478		ybjG	2
ARS007ss_ds.merged.samereadgroup.cleaned	1490718	1490734		ybjG	16
ARS007ss_ds.merged.samereadgroup.cleaned	1491027	1491034		YPO_RS07605	7
ARS007ss_ds.merged.samereadgroup.cleaned	1492166	1492174		YPO_RS07610	8
ARS007ss_ds.merged.samereadgroup.cleaned	1492405	1492415		YPO_RS07610	10
ARS007ss_ds.merged.samereadgroup.cleaned	1493079	1493084		YPO_RS07610	5
ARS007ss_ds.merged.samereadgroup.cleaned	1493269	1493279		YPO_RS07610	10
ARS007ss_ds.merged.samereadgroup.cleaned	1496333	1496343		potF	10
ARS007ss_ds.merged.samereadgroup.cleaned	1497664	1497666		potG	2
ARS007ss_ds.merged.samereadgroup.cleaned	1499195	1499203		potH	8
ARS007ss_ds.merged.samereadgroup.cleaned	1499539	1499540		potH	1
ARS007ss_ds.merged.samereadgroup.cleaned	1499630	1499632		potH	2
ARS007ss_ds.merged.samereadgroup.cleaned	1499739	1499756		potI	17
ARS007ss_ds.merged.samereadgroup.cleaned	1500144	1500149		potI	5
ARS007ss_ds.merged.samereadgroup.cleaned	1500370	1500374		potI	4
ARS007ss_ds.merged.samereadgroup.cleaned	1501324	1501330		rlmC	6
ARS007ss_ds.merged.samereadgroup.cleaned	1501673	1501675		rlmC	2
ARS007ss_ds.merged.samereadgroup.cleaned	1502298	1502301		rlmC	3
ARS007ss_ds.merged.samereadgroup.cleaned	1505975	1505982		YPO_RS07685	7
ARS007ss_ds.merged.samereadgroup.cleaned	1506273	1506288		YPO_RS07685	15
ARS007ss_ds.merged.samereadgroup.cleaned	1506529	1506532		YPO_RS07685	3
ARS007ss_ds.merged.samereadgroup.cleaned	1507772	1507773		YPO_RS07690	1
ARS007ss_ds.merged.samereadgroup.cleaned	1507926	1507927		YPO_RS07690	1
ARS007ss_ds.merged.samereadgroup.cleaned	1508815	1508821		YPO_RS07700	6
ARS007ss_ds.merged.samereadgroup.cleaned	1508880	1508888		YPO_RS07700	8
ARS007ss_ds.merged.samereadgroup.cleaned	1509866	1509869		YPO_RS07710	3
ARS007ss_ds.merged.samereadgroup.cleaned	1510615	1510616		YPO_RS07715	1
ARS007ss_ds.merged.samereadgroup.cleaned	1511094	1511113		YPO_RS07720	19
ARS007ss_ds.merged.samereadgroup.cleaned	1511190	1511200		YPO_RS07720	10
ARS007ss_ds.merged.samereadgroup.cleaned	1512049	1512068		YPO_RS07720	19
ARS007ss_ds.merged.samereadgroup.cleaned	1513025	1513030		YPO_RS07725	5
ARS007ss_ds.merged.samereadgroup.cleaned	1513338	1513344		YPO_RS07730	6
ARS007ss_ds.merged.samereadgroup.cleaned	1513548	1513562		artM	14
ARS007ss_ds.merged.samereadgroup.cleaned	1514839	1514840		artJ	1
ARS007ss_ds.merged.samereadgroup.cleaned	1514931	1514945		artJ	14
ARS007ss_ds.merged.samereadgroup.cleaned	1515138	1515143		artJ	5
ARS007ss_ds.merged.samereadgroup.cleaned	1515236	1515239		artJ	3
ARS007ss_ds.merged.samereadgroup.cleaned	1516263	1516269		artP	6
ARS007ss_ds.merged.samereadgroup.cleaned	1516738	1516743		YPO_RS07755	5
ARS007ss_ds.merged.samereadgroup.cleaned	1517044	1517077		YPO_RS07755	33
ARS007ss_ds.merged.samereadgroup.cleaned	1518096	1518106		YPO_RS07765	10
ARS007ss_ds.merged.samereadgroup.cleaned	1520069	1520076		YPO_RS07770	7
ARS007ss_ds.merged.samereadgroup.cleaned	1520360	1520367		YPO_RS07770	7
ARS007ss_ds.merged.samereadgroup.cleaned	1521518	1521524		ltaE	6
ARS007ss_ds.merged.samereadgroup.cleaned	1522013	1522023		poxB	10
ARS007ss_ds.merged.samereadgroup.cleaned	1522288	1522321		poxB	33
ARS007ss_ds.merged.samereadgroup.cleaned	1522355	1522385		poxB	30
ARS007ss_ds.merged.samereadgroup.cleaned	1522848	1522858		poxB	10
ARS007ss_ds.merged.samereadgroup.cleaned	1522945	1522951		poxB	6
ARS007ss_ds.merged.samereadgroup.cleaned	1523162	1523167		poxB	5
ARS007ss_ds.merged.samereadgroup.cleaned	1523912	1523917		hcr	5
ARS007ss_ds.merged.samereadgroup.cleaned	1524023	1524040		hcr	17
ARS007ss_ds.merged.samereadgroup.cleaned	1524776	1524809		hcr	33
ARS007ss_ds.merged.samereadgroup.cleaned	1526048	1526063		hcp	15
ARS007ss_ds.merged.samereadgroup.cleaned	1526943	1526948		YPO_RS07795	5
ARS007ss_ds.merged.samereadgroup.cleaned	1527499	1527511		YPO_RS07795	12
ARS007ss_ds.merged.samereadgroup.cleaned	1528689	1528693		YPO_RS07800	4
ARS007ss_ds.merged.samereadgroup.cleaned	1529008	1529009		YPO_RS07800	1
ARS007ss_ds.merged.samereadgroup.cleaned	1529357	1529361		YPO_RS07800	4
ARS007ss_ds.merged.samereadgroup.cleaned	1529645	1529656		YPO_RS07800	11
ARS007ss_ds.merged.samereadgroup.cleaned	1531961	1531967		macA	6
ARS007ss_ds.merged.samereadgroup.cleaned	1532357	1532368		macB	11
ARS007ss_ds.merged.samereadgroup.cleaned	1532673	1532703		macB	30
ARS007ss_ds.merged.samereadgroup.cleaned	1532738	1532741		macB	3
ARS007ss_ds.merged.samereadgroup.cleaned	1533125	1533152		macB	27
ARS007ss_ds.merged.samereadgroup.cleaned	1533418	1533427		macB	9
ARS007ss_ds.merged.samereadgroup.cleaned	1533592	1533598		macB	6
ARS007ss_ds.merged.samereadgroup.cleaned	1534065	1534067		macB	2
ARS007ss_ds.merged.samereadgroup.cleaned	1534391	1534430		cspD	39
ARS007ss_ds.merged.samereadgroup.cleaned	1535088	1535096		clpS	8
ARS007ss_ds.merged.samereadgroup.cleaned	1536848	1536852		clpA	4
ARS007ss_ds.merged.samereadgroup.cleaned	1540205	1540221		cydC	16
ARS007ss_ds.merged.samereadgroup.cleaned	1541392	1541405		cydC	13
ARS007ss_ds.merged.samereadgroup.cleaned	1541631	1541637		cydC	6
ARS007ss_ds.merged.samereadgroup.cleaned	1541931	1541959		cydD	28
ARS007ss_ds.merged.samereadgroup.cleaned	1542014	1542018		cydD	4
ARS007ss_ds.merged.samereadgroup.cleaned	1543047	1543049		cydD	2
ARS007ss_ds.merged.samereadgroup.cleaned	1543250	1543252		cydD	2
ARS007ss_ds.merged.samereadgroup.cleaned	1544103	1544122		trxB	19
ARS007ss_ds.merged.samereadgroup.cleaned	1544847	1544849		trxB	2
ARS007ss_ds.merged.samereadgroup.cleaned	1545875	1545877		lrp	2
ARS007ss_ds.merged.samereadgroup.cleaned	1547283	1547298		YPO_RS07870	15
ARS007ss_ds.merged.samereadgroup.cleaned	1547610	1547621		YPO_RS07870	11
ARS007ss_ds.merged.samereadgroup.cleaned	1548159	1548164		YPO_RS07870	5
ARS007ss_ds.merged.samereadgroup.cleaned	1548260	1548263		YPO_RS07870	3
ARS007ss_ds.merged.samereadgroup.cleaned	1548591	1548631		YPO_RS07870	40
ARS007ss_ds.merged.samereadgroup.cleaned	1548957	1548967		YPO_RS07870	10
ARS007ss_ds.merged.samereadgroup.cleaned	1549859	1549860		YPO_RS07870	1
ARS007ss_ds.merged.samereadgroup.cleaned	1550026	1550058		YPO_RS07870	32
ARS007ss_ds.merged.samereadgroup.cleaned	1550645	1550651		lolA	6
ARS007ss_ds.merged.samereadgroup.cleaned	1551481	1551503		YPO_RS07880	22
ARS007ss_ds.merged.samereadgroup.cleaned	1552086	1552087		YPO_RS07880	1
ARS007ss_ds.merged.samereadgroup.cleaned	1552277	1552285		YPO_RS07880	8
ARS007ss_ds.merged.samereadgroup.cleaned	1552358	1552372		YPO_RS07880	14
ARS007ss_ds.merged.samereadgroup.cleaned	1554922	1554948		YPO_RS07890	26
ARS007ss_ds.merged.samereadgroup.cleaned	1555626	1555646		pflA	20
ARS007ss_ds.merged.samereadgroup.cleaned	1555898	1555901		pflA	3
ARS007ss_ds.merged.samereadgroup.cleaned	1557832	1557857		YPO_RS07900	25
ARS007ss_ds.merged.samereadgroup.cleaned	1561079	1561080		focA	1
ARS007ss_ds.merged.samereadgroup.cleaned	1561215	1561226		focA	11
ARS007ss_ds.merged.samereadgroup.cleaned	1562328	1562340		YPO_RS07915	12
ARS007ss_ds.merged.samereadgroup.cleaned	1562561	1562562		YPO_RS07915	1
ARS007ss_ds.merged.samereadgroup.cleaned	1564018	1564027		ansB	9
ARS007ss_ds.merged.samereadgroup.cleaned	1564393	1564408		ansB	15
ARS007ss_ds.merged.samereadgroup.cleaned	1564472	1564474		ansB	2
ARS007ss_ds.merged.samereadgroup.cleaned	1564615	1564632		ansB	17
ARS007ss_ds.merged.samereadgroup.cleaned	1565791	1565812		YPO_RS07925	21
ARS007ss_ds.merged.samereadgroup.cleaned	1565870	1565922		YPO_RS07925	52
ARS007ss_ds.merged.samereadgroup.cleaned	1565997	1566038		YPO_RS07925	41
ARS007ss_ds.merged.samereadgroup.cleaned	1566335	1566398		YPO_RS07930	63
ARS007ss_ds.merged.samereadgroup.cleaned	1566739	1566783		YPO_RS07930	44
ARS007ss_ds.merged.samereadgroup.cleaned	1566882	1566891		YPO_RS07930	9
ARS007ss_ds.merged.samereadgroup.cleaned	1567019	1567028		YPO_RS07930	9
ARS007ss_ds.merged.samereadgroup.cleaned	1567113	1567118		YPO_RS07930	5
ARS007ss_ds.merged.samereadgroup.cleaned	1567525	1567620		YPO_RS07930	95
ARS007ss_ds.merged.samereadgroup.cleaned	1567751	1567791		YPO_RS07930	40
ARS007ss_ds.merged.samereadgroup.cleaned	1567973	1567980		YPO_RS07930	7
ARS007ss_ds.merged.samereadgroup.cleaned	1568854	1568876		serC	22
ARS007ss_ds.merged.samereadgroup.cleaned	1569490	1569517		serC	27
ARS007ss_ds.merged.samereadgroup.cleaned	1569771	1569777		aroA	6
ARS007ss_ds.merged.samereadgroup.cleaned	1569921	1569933		aroA	12
ARS007ss_ds.merged.samereadgroup.cleaned	1569969	1569983		aroA	14
ARS007ss_ds.merged.samereadgroup.cleaned	1570817	1570832		aroA	15
ARS007ss_ds.merged.samereadgroup.cleaned	1574855	1574868		YPO_RS07960	13
ARS007ss_ds.merged.samereadgroup.cleaned	1575015	1575024		YPO_RS07960	9
ARS007ss_ds.merged.samereadgroup.cleaned	1575206	1575213		YPO_RS07960	7
ARS007ss_ds.merged.samereadgroup.cleaned	1575982	1575989		YPO_RS07960	7
ARS007ss_ds.merged.samereadgroup.cleaned	1576379	1576388		YPO_RS07960	9
ARS007ss_ds.merged.samereadgroup.cleaned	1576635	1576657		YPO_RS07960	22
ARS007ss_ds.merged.samereadgroup.cleaned	1577026	1577030		YPO_RS07960	4
ARS007ss_ds.merged.samereadgroup.cleaned	1577162	1577201		msbA	39
ARS007ss_ds.merged.samereadgroup.cleaned	1577544	1577549		msbA	5
ARS007ss_ds.merged.samereadgroup.cleaned	1579007	1579019		lpxK	12
ARS007ss_ds.merged.samereadgroup.cleaned	1579517	1579533		lpxK	16
ARS007ss_ds.merged.samereadgroup.cleaned	1579823	1579833		lpxK	10
ARS007ss_ds.merged.samereadgroup.cleaned	1579972	1579976		YPO_RS07975	4
ARS007ss_ds.merged.samereadgroup.cleaned	1580335	1580343		YPO_RS07975	8
ARS007ss_ds.merged.samereadgroup.cleaned	1580506	1580513		YPO_RS07975	7
ARS007ss_ds.merged.samereadgroup.cleaned	1580747	1580770		YPO_RS07975	23
ARS007ss_ds.merged.samereadgroup.cleaned	1580936	1580971		YPO_RS07975	35
ARS007ss_ds.merged.samereadgroup.cleaned	1584143	1584151		YPO_RS07995	8
ARS007ss_ds.merged.samereadgroup.cleaned	1584429	1584439		YPO_RS07995	10
ARS007ss_ds.merged.samereadgroup.cleaned	1584624	1584630		YPO_RS07995	6
ARS007ss_ds.merged.samereadgroup.cleaned	1586322	1586330		cmoM	8
ARS007ss_ds.merged.samereadgroup.cleaned	1586929	1586932		mukF	3
ARS007ss_ds.merged.samereadgroup.cleaned	1587144	1587147		mukF	3
ARS007ss_ds.merged.samereadgroup.cleaned	1587770	1587805		mukF	35
ARS007ss_ds.merged.samereadgroup.cleaned	1587798	1587805		mukE	7
ARS007ss_ds.merged.samereadgroup.cleaned	1588895	1588900		mukB	5
ARS007ss_ds.merged.samereadgroup.cleaned	1589328	1589356		mukB	28
ARS007ss_ds.merged.samereadgroup.cleaned	1589426	1589447		mukB	21
ARS007ss_ds.merged.samereadgroup.cleaned	1589965	1589987		mukB	22
ARS007ss_ds.merged.samereadgroup.cleaned	1590248	1590256		mukB	8
ARS007ss_ds.merged.samereadgroup.cleaned	1590652	1590695		mukB	43
ARS007ss_ds.merged.samereadgroup.cleaned	1591015	1591018		mukB	3
ARS007ss_ds.merged.samereadgroup.cleaned	1591157	1591162		mukB	5
ARS007ss_ds.merged.samereadgroup.cleaned	1591347	1591356		mukB	9
ARS007ss_ds.merged.samereadgroup.cleaned	1591568	1591583		mukB	15
ARS007ss_ds.merged.samereadgroup.cleaned	1592603	1592608		mukB	5
ARS007ss_ds.merged.samereadgroup.cleaned	1595086	1595112		ldtD	26
ARS007ss_ds.merged.samereadgroup.cleaned	1595623	1595624		ldtD	1
ARS007ss_ds.merged.samereadgroup.cleaned	1595720	1595737		ldtD	17
ARS007ss_ds.merged.samereadgroup.cleaned	1596140	1596141		YPO_RS08030	1
ARS007ss_ds.merged.samereadgroup.cleaned	1596406	1596415		YPO_RS08030	9
ARS007ss_ds.merged.samereadgroup.cleaned	1596708	1596727		YPO_RS08035	19
ARS007ss_ds.merged.samereadgroup.cleaned	1597072	1597073		YPO_RS08035	1
ARS007ss_ds.merged.samereadgroup.cleaned	1597443	1597467		YPO_RS08040	24
ARS007ss_ds.merged.samereadgroup.cleaned	1598119	1598120		YPO_RS08045	1
ARS007ss_ds.merged.samereadgroup.cleaned	1598323	1598325		YPO_RS08045	2
ARS007ss_ds.merged.samereadgroup.cleaned	1598747	1598758		YPO_RS08045	11
ARS007ss_ds.merged.samereadgroup.cleaned	1600982	1600990		asnS	8
ARS007ss_ds.merged.samereadgroup.cleaned	1601437	1601439		asnS	2
ARS007ss_ds.merged.samereadgroup.cleaned	1602574	1602594		pncB	20
ARS007ss_ds.merged.samereadgroup.cleaned	1603268	1603284		pncB	16
ARS007ss_ds.merged.samereadgroup.cleaned	1605423	1605425		pepN	2
ARS007ss_ds.merged.samereadgroup.cleaned	1605810	1605811		pepN	1
ARS007ss_ds.merged.samereadgroup.cleaned	1606642	1606643		pepN	1
ARS007ss_ds.merged.samereadgroup.cleaned	1607850	1607857		pyrD	7
ARS007ss_ds.merged.samereadgroup.cleaned	1608129	1608151		pyrD	22
ARS007ss_ds.merged.samereadgroup.cleaned	1608296	1608311		pyrD	15
ARS007ss_ds.merged.samereadgroup.cleaned	1609640	1609648		YPO_RS08080	8
ARS007ss_ds.merged.samereadgroup.cleaned	1610652	1610666		rlmKL	14
ARS007ss_ds.merged.samereadgroup.cleaned	1611030	1611034		rlmKL	4
ARS007ss_ds.merged.samereadgroup.cleaned	1611461	1611470		rlmKL	9
ARS007ss_ds.merged.samereadgroup.cleaned	1611965	1611966		rlmKL	1
ARS007ss_ds.merged.samereadgroup.cleaned	1615634	1615636		pqiA	2
ARS007ss_ds.merged.samereadgroup.cleaned	1616132	1616153		pqiB	21
ARS007ss_ds.merged.samereadgroup.cleaned	1616278	1616310		pqiB	32
ARS007ss_ds.merged.samereadgroup.cleaned	1616689	1616697		pqiB	8
ARS007ss_ds.merged.samereadgroup.cleaned	1617774	1617778		pqiC	4
ARS007ss_ds.merged.samereadgroup.cleaned	1617961	1617968		pqiC	7
ARS007ss_ds.merged.samereadgroup.cleaned	1618621	1618627		rmf	6
ARS007ss_ds.merged.samereadgroup.cleaned	1623803	1623809		fabA	6
ARS007ss_ds.merged.samereadgroup.cleaned	1624207	1624223		YPO_RS08150	16
ARS007ss_ds.merged.samereadgroup.cleaned	1624398	1624426		YPO_RS08150	28
ARS007ss_ds.merged.samereadgroup.cleaned	1624863	1624880		YPO_RS08150	17
ARS007ss_ds.merged.samereadgroup.cleaned	1625417	1625418		YPO_RS08150	1
ARS007ss_ds.merged.samereadgroup.cleaned	1627620	1627625		ompA	5
ARS007ss_ds.merged.samereadgroup.cleaned	1627746	1627758		ompA	12
ARS007ss_ds.merged.samereadgroup.cleaned	1627841	1627860		ompA	19
ARS007ss_ds.merged.samereadgroup.cleaned	1628103	1628121		ompA	18
ARS007ss_ds.merged.samereadgroup.cleaned	1628157	1628164		ompA	7
ARS007ss_ds.merged.samereadgroup.cleaned	1629072	1629080		sulA	8
ARS007ss_ds.merged.samereadgroup.cleaned	1630677	1630694		yccS	17
ARS007ss_ds.merged.samereadgroup.cleaned	1631830	1631835		yccS	5
ARS007ss_ds.merged.samereadgroup.cleaned	1632384	1632435		YPO_RS08185	51
ARS007ss_ds.merged.samereadgroup.cleaned	1633144	1633146		helD	2
ARS007ss_ds.merged.samereadgroup.cleaned	1633748	1633768		helD	20
ARS007ss_ds.merged.samereadgroup.cleaned	1634462	1634466		helD	4
ARS007ss_ds.merged.samereadgroup.cleaned	1635264	1635267		YPO_RS08195	3
ARS007ss_ds.merged.samereadgroup.cleaned	1635581	1635588		YPO_RS08200	7
ARS007ss_ds.merged.samereadgroup.cleaned	1635974	1636008		YPO_RS08200	34
ARS007ss_ds.merged.samereadgroup.cleaned	1636915	1636916		YPO_RS08205	1
ARS007ss_ds.merged.samereadgroup.cleaned	1637102	1637132		hspQ	30
ARS007ss_ds.merged.samereadgroup.cleaned	1637541	1637555		rlmI	14
ARS007ss_ds.merged.samereadgroup.cleaned	1638126	1638131		rlmI	5
ARS007ss_ds.merged.samereadgroup.cleaned	1638951	1638953		yccX	2
ARS007ss_ds.merged.samereadgroup.cleaned	1639330	1639338		tusE	8
ARS007ss_ds.merged.samereadgroup.cleaned	1643727	1643738		YPO_RS08245	11
ARS007ss_ds.merged.samereadgroup.cleaned	1644101	1644114		YPO_RS08245	13
ARS007ss_ds.merged.samereadgroup.cleaned	1644339	1644349		YPO_RS08245	10
ARS007ss_ds.merged.samereadgroup.cleaned	1645034	1645049		YPO_RS08245	15
ARS007ss_ds.merged.samereadgroup.cleaned	1645453	1645460		YPO_RS08245	7
ARS007ss_ds.merged.samereadgroup.cleaned	1645948	1645950		YPO_RS08250	2
ARS007ss_ds.merged.samereadgroup.cleaned	1646043	1646051		YPO_RS08250	8
ARS007ss_ds.merged.samereadgroup.cleaned	1647598	1647643		YPO_RS08260	45
ARS007ss_ds.merged.samereadgroup.cleaned	1647814	1647826		YPO_RS08260	12
ARS007ss_ds.merged.samereadgroup.cleaned	1647960	1647968		YPO_RS08260	8
ARS007ss_ds.merged.samereadgroup.cleaned	1648474	1648489		YPO_RS08265	15
ARS007ss_ds.merged.samereadgroup.cleaned	1648820	1648829		YPO_RS08265	9
ARS007ss_ds.merged.samereadgroup.cleaned	1648962	1648975		YPO_RS08265	13
ARS007ss_ds.merged.samereadgroup.cleaned	1649605	1649606		YPO_RS08270	1
ARS007ss_ds.merged.samereadgroup.cleaned	1649767	1649768		YPO_RS08270	1
ARS007ss_ds.merged.samereadgroup.cleaned	1649964	1649978		YPO_RS08270	14
ARS007ss_ds.merged.samereadgroup.cleaned	1650162	1650166		YPO_RS08275	4
ARS007ss_ds.merged.samereadgroup.cleaned	1650880	1650901		YPO_RS08275	21
ARS007ss_ds.merged.samereadgroup.cleaned	1651299	1651313		YPO_RS08275	14
ARS007ss_ds.merged.samereadgroup.cleaned	1651370	1651388		YPO_RS08275	18
ARS007ss_ds.merged.samereadgroup.cleaned	1651381	1651403		YPO_RS08280	22
ARS007ss_ds.merged.samereadgroup.cleaned	1651517	1651518		YPO_RS08280	1
ARS007ss_ds.merged.samereadgroup.cleaned	1652085	1652100		YPO_RS08280	15
ARS007ss_ds.merged.samereadgroup.cleaned	1652420	1652427		YPO_RS08285	7
ARS007ss_ds.merged.samereadgroup.cleaned	1652511	1652534		YPO_RS08285	23
ARS007ss_ds.merged.samereadgroup.cleaned	1652594	1652601		YPO_RS08285	7
ARS007ss_ds.merged.samereadgroup.cleaned	1653169	1653184		YPO_RS08290	15
ARS007ss_ds.merged.samereadgroup.cleaned	1653791	1653804		YPO_RS08295	13
ARS007ss_ds.merged.samereadgroup.cleaned	1653868	1653869		YPO_RS08295	1
ARS007ss_ds.merged.samereadgroup.cleaned	1653974	1653977		YPO_RS08295	3
ARS007ss_ds.merged.samereadgroup.cleaned	1656439	1656444		tssB	5
ARS007ss_ds.merged.samereadgroup.cleaned	1656766	1656774		tssB	8
ARS007ss_ds.merged.samereadgroup.cleaned	1657800	1657814		tssC	14
ARS007ss_ds.merged.samereadgroup.cleaned	1658259	1658265		tssC	6
ARS007ss_ds.merged.samereadgroup.cleaned	1658411	1658415		tssC	4
ARS007ss_ds.merged.samereadgroup.cleaned	1658764	1658765		tssK	1
ARS007ss_ds.merged.samereadgroup.cleaned	1659242	1659246		tssK	4
ARS007ss_ds.merged.samereadgroup.cleaned	1660849	1660865		YPO_RS08330	16
ARS007ss_ds.merged.samereadgroup.cleaned	1661359	1661372		YPO_RS08330	13
ARS007ss_ds.merged.samereadgroup.cleaned	1661810	1661822		YPO_RS08330	12
ARS007ss_ds.merged.samereadgroup.cleaned	1662764	1662765		YPO_RS08335	1
ARS007ss_ds.merged.samereadgroup.cleaned	1663356	1663357		tssH	1
ARS007ss_ds.merged.samereadgroup.cleaned	1663635	1663648		tssH	13
ARS007ss_ds.merged.samereadgroup.cleaned	1663875	1663879		tssH	4
ARS007ss_ds.merged.samereadgroup.cleaned	1664444	1664457		tssH	13
ARS007ss_ds.merged.samereadgroup.cleaned	1664821	1664827		tssH	6
ARS007ss_ds.merged.samereadgroup.cleaned	1665720	1665732		tssH	12
ARS007ss_ds.merged.samereadgroup.cleaned	1665834	1665843		YPO_RS08345	9
ARS007ss_ds.merged.samereadgroup.cleaned	1666064	1666071		YPO_RS08345	7
ARS007ss_ds.merged.samereadgroup.cleaned	1666146	1666164		YPO_RS08345	18
ARS007ss_ds.merged.samereadgroup.cleaned	1666981	1666987		YPO_RS08345	6
ARS007ss_ds.merged.samereadgroup.cleaned	1667102	1667132		YPO_RS08345	30
ARS007ss_ds.merged.samereadgroup.cleaned	1667457	1667459		YPO_RS08345	2
ARS007ss_ds.merged.samereadgroup.cleaned	1667517	1667520		YPO_RS08345	3
ARS007ss_ds.merged.samereadgroup.cleaned	1668170	1668172		YPO_RS08350	2
ARS007ss_ds.merged.samereadgroup.cleaned	1669870	1669873		YPO_RS08350	3
ARS007ss_ds.merged.samereadgroup.cleaned	1670196	1670198		YPO_RS08350	2
ARS007ss_ds.merged.samereadgroup.cleaned	1670475	1670498		YPO_RS08355	23
ARS007ss_ds.merged.samereadgroup.cleaned	1670568	1670612		YPO_RS08355	44
ARS007ss_ds.merged.samereadgroup.cleaned	1670723	1670730		YPO_RS08355	7
ARS007ss_ds.merged.samereadgroup.cleaned	1670944	1670986		YPO_RS08355	42
ARS007ss_ds.merged.samereadgroup.cleaned	1672554	1672561		YPO_RS08365	7
ARS007ss_ds.merged.samereadgroup.cleaned	1673835	1673845		YPO_RS08365	10
ARS007ss_ds.merged.samereadgroup.cleaned	1674241	1674246		YPO_RS08370	5
ARS007ss_ds.merged.samereadgroup.cleaned	1674402	1674427		YPO_RS08370	25
ARS007ss_ds.merged.samereadgroup.cleaned	1676905	1676925		YPO_RS08380	20
ARS007ss_ds.merged.samereadgroup.cleaned	1676995	1677001		YPO_RS08380	6
ARS007ss_ds.merged.samereadgroup.cleaned	1677257	1677262		YPO_RS08380	5
ARS007ss_ds.merged.samereadgroup.cleaned	1677507	1677519		YPO_RS08380	12
ARS007ss_ds.merged.samereadgroup.cleaned	1678048	1678056		YPO_RS08385	8
ARS007ss_ds.merged.samereadgroup.cleaned	1678910	1678939		YPO_RS08385	29
ARS007ss_ds.merged.samereadgroup.cleaned	1679866	1679883		YPO_RS08385	17
ARS007ss_ds.merged.samereadgroup.cleaned	1680417	1680422		YPO_RS08385	5
ARS007ss_ds.merged.samereadgroup.cleaned	1680762	1680767		YPO_RS08385	5
ARS007ss_ds.merged.samereadgroup.cleaned	1680852	1680855		YPO_RS08385	3
ARS007ss_ds.merged.samereadgroup.cleaned	1681053	1681061		YPO_RS08385	8
ARS007ss_ds.merged.samereadgroup.cleaned	1681389	1681390		tssA	1
ARS007ss_ds.merged.samereadgroup.cleaned	1682706	1682707		tssA	1
ARS007ss_ds.merged.samereadgroup.cleaned	1683367	1683375		YPO_RS08395	8
ARS007ss_ds.merged.samereadgroup.cleaned	1683570	1683588		YPO_RS08395	18
ARS007ss_ds.merged.samereadgroup.cleaned	1683702	1683712		YPO_RS08395	10
ARS007ss_ds.merged.samereadgroup.cleaned	1684012	1684025		YPO_RS08395	13
ARS007ss_ds.merged.samereadgroup.cleaned	1684040	1684150		YPO_RS08400	110
ARS007ss_ds.merged.samereadgroup.cleaned	1684229	1684232		YPO_RS08400	3
ARS007ss_ds.merged.samereadgroup.cleaned	1684271	1684275		YPO_RS08400	4
ARS007ss_ds.merged.samereadgroup.cleaned	1684393	1684408		YPO_RS08400	15
ARS007ss_ds.merged.samereadgroup.cleaned	1684468	1684495		YPO_RS08400	27
ARS007ss_ds.merged.samereadgroup.cleaned	1685796	1685817		tssF	21
ARS007ss_ds.merged.samereadgroup.cleaned	1685876	1685900		tssF	24
ARS007ss_ds.merged.samereadgroup.cleaned	1686290	1686311		tssF	21
ARS007ss_ds.merged.samereadgroup.cleaned	1686753	1686758		tssG	5
ARS007ss_ds.merged.samereadgroup.cleaned	1686916	1686922		tssG	6
ARS007ss_ds.merged.samereadgroup.cleaned	1687448	1687453		tssG	5
ARS007ss_ds.merged.samereadgroup.cleaned	1688028	1688035		tssJ	7
ARS007ss_ds.merged.samereadgroup.cleaned	1689283	1689287		YPO_RS08425	4
ARS007ss_ds.merged.samereadgroup.cleaned	1690140	1690167		YPO_RS08430	27
ARS007ss_ds.merged.samereadgroup.cleaned	1690235	1690253		YPO_RS08430	18
ARS007ss_ds.merged.samereadgroup.cleaned	1690327	1690328		YPO_RS08430	1
ARS007ss_ds.merged.samereadgroup.cleaned	1690439	1690466		YPO_RS08430	27
ARS007ss_ds.merged.samereadgroup.cleaned	1690594	1690652		YPO_RS08430	58
ARS007ss_ds.merged.samereadgroup.cleaned	1691589	1691602		YPO_RS08435	13
ARS007ss_ds.merged.samereadgroup.cleaned	1691756	1691761		YPO_RS08435	5
ARS007ss_ds.merged.samereadgroup.cleaned	1692156	1692172		YPO_RS08435	16
ARS007ss_ds.merged.samereadgroup.cleaned	1693314	1693326		YPO_RS08440	12
ARS007ss_ds.merged.samereadgroup.cleaned	1693434	1693435		YPO_RS08440	1
ARS007ss_ds.merged.samereadgroup.cleaned	1693705	1693712		YPO_RS08440	7
ARS007ss_ds.merged.samereadgroup.cleaned	1695701	1695707		moeB	6
ARS007ss_ds.merged.samereadgroup.cleaned	1695876	1695884		moeB	8
ARS007ss_ds.merged.samereadgroup.cleaned	1696407	1696408		moeA	1
ARS007ss_ds.merged.samereadgroup.cleaned	1697029	1697034		moeA	5
ARS007ss_ds.merged.samereadgroup.cleaned	1697264	1697285		moeA	21
ARS007ss_ds.merged.samereadgroup.cleaned	1697942	1697949		darE	7
ARS007ss_ds.merged.samereadgroup.cleaned	1698370	1698373		darE	3
ARS007ss_ds.merged.samereadgroup.cleaned	1698441	1698476		darE	35
ARS007ss_ds.merged.samereadgroup.cleaned	1698527	1698545		darE	18
ARS007ss_ds.merged.samereadgroup.cleaned	1698643	1698677		darE	34
ARS007ss_ds.merged.samereadgroup.cleaned	1698906	1698933		darE	27
ARS007ss_ds.merged.samereadgroup.cleaned	1699182	1699201		darE	19
ARS007ss_ds.merged.samereadgroup.cleaned	1699309	1699311		darD	2
ARS007ss_ds.merged.samereadgroup.cleaned	1699878	1699879		darD	1
ARS007ss_ds.merged.samereadgroup.cleaned	1699881	1699896		darC	15
ARS007ss_ds.merged.samereadgroup.cleaned	1700033	1700046		darC	13
ARS007ss_ds.merged.samereadgroup.cleaned	1700301	1700350		darC	49
ARS007ss_ds.merged.samereadgroup.cleaned	1700407	1700426		darC	19
ARS007ss_ds.merged.samereadgroup.cleaned	1700485	1700494		darC	9
ARS007ss_ds.merged.samereadgroup.cleaned	1700576	1700589		darC	13
ARS007ss_ds.merged.samereadgroup.cleaned	1700892	1700895		darC	3
ARS007ss_ds.merged.samereadgroup.cleaned	1701102	1701143		darC	41
ARS007ss_ds.merged.samereadgroup.cleaned	1701328	1701393		darB	65
ARS007ss_ds.merged.samereadgroup.cleaned	1701855	1701876		darB	21
ARS007ss_ds.merged.samereadgroup.cleaned	1702165	1702168		darB	3
ARS007ss_ds.merged.samereadgroup.cleaned	1702631	1702676		darB	45
ARS007ss_ds.merged.samereadgroup.cleaned	1703151	1703157		darB	6
ARS007ss_ds.merged.samereadgroup.cleaned	1703371	1703384		darB	13
ARS007ss_ds.merged.samereadgroup.cleaned	1704259	1704285		fghA	26
ARS007ss_ds.merged.samereadgroup.cleaned	1704593	1704595		fghA	2
ARS007ss_ds.merged.samereadgroup.cleaned	1704648	1704670		fghA	22
ARS007ss_ds.merged.samereadgroup.cleaned	1704758	1704762		fghA	4
ARS007ss_ds.merged.samereadgroup.cleaned	1705326	1705329		YPO_RS08490	3
ARS007ss_ds.merged.samereadgroup.cleaned	1705810	1705815		YPO_RS08490	5
ARS007ss_ds.merged.samereadgroup.cleaned	1705883	1705887		YPO_RS08490	4
ARS007ss_ds.merged.samereadgroup.cleaned	1706487	1706490		YPO_RS08495	3
ARS007ss_ds.merged.samereadgroup.cleaned	1706686	1706690		YPO_RS08495	4
ARS007ss_ds.merged.samereadgroup.cleaned	1706859	1706877		YPO_RS08495	18
ARS007ss_ds.merged.samereadgroup.cleaned	1707893	1707894		YPO_RS08500	1
ARS007ss_ds.merged.samereadgroup.cleaned	1710276	1710285		YPO_RS08510	9
ARS007ss_ds.merged.samereadgroup.cleaned	1711361	1711362		mglB	1
ARS007ss_ds.merged.samereadgroup.cleaned	1711851	1711871		mglB	20
ARS007ss_ds.merged.samereadgroup.cleaned	1711930	1711945		mglB	15
ARS007ss_ds.merged.samereadgroup.cleaned	1712666	1712669		mglA	3
ARS007ss_ds.merged.samereadgroup.cleaned	1713766	1713787		mglA	21
ARS007ss_ds.merged.samereadgroup.cleaned	1713834	1713840		mglA	6
ARS007ss_ds.merged.samereadgroup.cleaned	1714142	1714156		mglC	14
ARS007ss_ds.merged.samereadgroup.cleaned	1714317	1714321		mglC	4
ARS007ss_ds.merged.samereadgroup.cleaned	1714501	1714510		mglC	9
ARS007ss_ds.merged.samereadgroup.cleaned	1714925	1714935		mglC	10
ARS007ss_ds.merged.samereadgroup.cleaned	1714966	1714978		mglC	12
ARS007ss_ds.merged.samereadgroup.cleaned	1716132	1716138		sanA	6
ARS007ss_ds.merged.samereadgroup.cleaned	1716717	1716736		YPO_RS08535	19
ARS007ss_ds.merged.samereadgroup.cleaned	1716888	1716919		YPO_RS08535	31
ARS007ss_ds.merged.samereadgroup.cleaned	1719060	1719065		cdd	5
ARS007ss_ds.merged.samereadgroup.cleaned	1720210	1720212		YPO_RS08545	2
ARS007ss_ds.merged.samereadgroup.cleaned	1720582	1720609		YPO_RS08550	27
ARS007ss_ds.merged.samereadgroup.cleaned	1720861	1720872		YPO_RS08550	11
ARS007ss_ds.merged.samereadgroup.cleaned	1721219	1721221		YPO_RS08555	2
ARS007ss_ds.merged.samereadgroup.cleaned	1722280	1722288		YPO_RS08555	8
ARS007ss_ds.merged.samereadgroup.cleaned	1722848	1722854		YPO_RS08560	6
ARS007ss_ds.merged.samereadgroup.cleaned	1723325	1723330		YPO_RS08560	5
ARS007ss_ds.merged.samereadgroup.cleaned	1723439	1723450		YPO_RS08560	11
ARS007ss_ds.merged.samereadgroup.cleaned	1724948	1724964		YPO_RS08565	16
ARS007ss_ds.merged.samereadgroup.cleaned	1726204	1726223		YPO_RS08570	19
ARS007ss_ds.merged.samereadgroup.cleaned	1726305	1726322		YPO_RS08570	17
ARS007ss_ds.merged.samereadgroup.cleaned	1729355	1729411		metG	56
ARS007ss_ds.merged.samereadgroup.cleaned	1729531	1729545		metG	14
ARS007ss_ds.merged.samereadgroup.cleaned	1729725	1729734		metG	9
ARS007ss_ds.merged.samereadgroup.cleaned	1730421	1730447		metG	26
ARS007ss_ds.merged.samereadgroup.cleaned	1731049	1731051		metG	2
ARS007ss_ds.merged.samereadgroup.cleaned	1731767	1731775		apbC	8
ARS007ss_ds.merged.samereadgroup.cleaned	1731976	1731986		apbC	10
ARS007ss_ds.merged.samereadgroup.cleaned	1733591	1733593		dcd	2
ARS007ss_ds.merged.samereadgroup.cleaned	1734084	1734090		dcd	6
ARS007ss_ds.merged.samereadgroup.cleaned	1734575	1734583		asmA	8
ARS007ss_ds.merged.samereadgroup.cleaned	1734971	1734984		asmA	13
ARS007ss_ds.merged.samereadgroup.cleaned	1735135	1735158		asmA	23
ARS007ss_ds.merged.samereadgroup.cleaned	1735329	1735333		asmA	4
ARS007ss_ds.merged.samereadgroup.cleaned	1735578	1735582		asmA	4
ARS007ss_ds.merged.samereadgroup.cleaned	1737035	1737039		YPO_RS08615	4
ARS007ss_ds.merged.samereadgroup.cleaned	1737290	1737299		YPO_RS08615	9
ARS007ss_ds.merged.samereadgroup.cleaned	1738392	1738405		fhuF	13
ARS007ss_ds.merged.samereadgroup.cleaned	1738542	1738563		fhuF	21
ARS007ss_ds.merged.samereadgroup.cleaned	1738814	1738815		fhuF	1
ARS007ss_ds.merged.samereadgroup.cleaned	1739128	1739151		fhuF	23
ARS007ss_ds.merged.samereadgroup.cleaned	1739303	1739313		YPO_RS08625	10
ARS007ss_ds.merged.samereadgroup.cleaned	1739358	1739407		YPO_RS08625	49
ARS007ss_ds.merged.samereadgroup.cleaned	1739585	1739595		YPO_RS08625	10
ARS007ss_ds.merged.samereadgroup.cleaned	1739955	1739959		YPO_RS08625	4
ARS007ss_ds.merged.samereadgroup.cleaned	1740483	1740485		YPO_RS08625	2
ARS007ss_ds.merged.samereadgroup.cleaned	1741167	1741170		YPO_RS08630	3
ARS007ss_ds.merged.samereadgroup.cleaned	1741260	1741266		YPO_RS08630	6
ARS007ss_ds.merged.samereadgroup.cleaned	1741341	1741353		YPO_RS08630	12
ARS007ss_ds.merged.samereadgroup.cleaned	1741677	1741682		YPO_RS08630	5
ARS007ss_ds.merged.samereadgroup.cleaned	1741774	1741777		YPO_RS08630	3
ARS007ss_ds.merged.samereadgroup.cleaned	1742921	1742938		YPO_RS08640	17
ARS007ss_ds.merged.samereadgroup.cleaned	1743016	1743019		YPO_RS08640	3
ARS007ss_ds.merged.samereadgroup.cleaned	1743258	1743262		YPO_RS08640	4
ARS007ss_ds.merged.samereadgroup.cleaned	1743527	1743532		YPO_RS08640	5
ARS007ss_ds.merged.samereadgroup.cleaned	1744396	1744416		YPO_RS08640	20
ARS007ss_ds.merged.samereadgroup.cleaned	1744883	1744892		YPO_RS08645	9
ARS007ss_ds.merged.samereadgroup.cleaned	1745037	1745059		YPO_RS08645	22
ARS007ss_ds.merged.samereadgroup.cleaned	1745580	1745587		YPO_RS08650	7
ARS007ss_ds.merged.samereadgroup.cleaned	1746195	1746206		YPO_RS08650	11
ARS007ss_ds.merged.samereadgroup.cleaned	1746796	1746814		YPO_RS08655	18
ARS007ss_ds.merged.samereadgroup.cleaned	1746851	1746854		YPO_RS08655	3
ARS007ss_ds.merged.samereadgroup.cleaned	1746998	1747001		YPO_RS08655	3
ARS007ss_ds.merged.samereadgroup.cleaned	1747089	1747093		YPO_RS08655	4
ARS007ss_ds.merged.samereadgroup.cleaned	1747200	1747203		YPO_RS08655	3
ARS007ss_ds.merged.samereadgroup.cleaned	1747568	1747575		YPO_RS08655	7
ARS007ss_ds.merged.samereadgroup.cleaned	1747956	1747973		YPO_RS08660	17
ARS007ss_ds.merged.samereadgroup.cleaned	1748117	1748123		YPO_RS08660	6
ARS007ss_ds.merged.samereadgroup.cleaned	1748921	1748922		YPO_RS08665	1
ARS007ss_ds.merged.samereadgroup.cleaned	1749047	1749065		YPO_RS08665	18
ARS007ss_ds.merged.samereadgroup.cleaned	1749292	1749296		YPO_RS08665	4
ARS007ss_ds.merged.samereadgroup.cleaned	1749759	1749767		YPO_RS08665	8
ARS007ss_ds.merged.samereadgroup.cleaned	1750108	1750122		YPO_RS08665	14
ARS007ss_ds.merged.samereadgroup.cleaned	1750520	1750555		YPO_RS08665	35
ARS007ss_ds.merged.samereadgroup.cleaned	1750803	1750808		YPO_RS08665	5
ARS007ss_ds.merged.samereadgroup.cleaned	1751731	1751739		YPO_RS08670	8
ARS007ss_ds.merged.samereadgroup.cleaned	1751793	1751795		YPO_RS08670	2
ARS007ss_ds.merged.samereadgroup.cleaned	1751854	1751868		YPO_RS08670	14
ARS007ss_ds.merged.samereadgroup.cleaned	1752112	1752135		YPO_RS08670	23
ARS007ss_ds.merged.samereadgroup.cleaned	1752341	1752348		YPO_RS08670	7
ARS007ss_ds.merged.samereadgroup.cleaned	1754146	1754148		galU	2
ARS007ss_ds.merged.samereadgroup.cleaned	1754365	1754368		galU	3
ARS007ss_ds.merged.samereadgroup.cleaned	1757384	1757390		gndA	6
ARS007ss_ds.merged.samereadgroup.cleaned	1757651	1757669		gndA	18
ARS007ss_ds.merged.samereadgroup.cleaned	1758195	1758197		YPO_RS08690	2
ARS007ss_ds.merged.samereadgroup.cleaned	1758866	1758867		hisF	1
ARS007ss_ds.merged.samereadgroup.cleaned	1759685	1759695		hisA	10
ARS007ss_ds.merged.samereadgroup.cleaned	1759779	1759781		hisA	2
ARS007ss_ds.merged.samereadgroup.cleaned	1761285	1761288		hisB	3
ARS007ss_ds.merged.samereadgroup.cleaned	1761731	1761738		hisC	7
ARS007ss_ds.merged.samereadgroup.cleaned	1762712	1762719		hisC	7
ARS007ss_ds.merged.samereadgroup.cleaned	1762752	1762758		hisC	6
ARS007ss_ds.merged.samereadgroup.cleaned	1762808	1762810		hisD	2
ARS007ss_ds.merged.samereadgroup.cleaned	1763374	1763416		hisD	42
ARS007ss_ds.merged.samereadgroup.cleaned	1763521	1763523		hisD	2
ARS007ss_ds.merged.samereadgroup.cleaned	1763864	1763883		hisD	19
ARS007ss_ds.merged.samereadgroup.cleaned	1764009	1764035		hisD	26
ARS007ss_ds.merged.samereadgroup.cleaned	1764391	1764397		hisG	6
ARS007ss_ds.merged.samereadgroup.cleaned	1764552	1764563		hisG	11
ARS007ss_ds.merged.samereadgroup.cleaned	1764839	1764849		hisG	10
ARS007ss_ds.merged.samereadgroup.cleaned	1765825	1765841		YPO_RS08735	16
ARS007ss_ds.merged.samereadgroup.cleaned	1766073	1766082		YPO_RS08735	9
ARS007ss_ds.merged.samereadgroup.cleaned	1766267	1766289		YPO_RS08735	22
ARS007ss_ds.merged.samereadgroup.cleaned	1769264	1769281		YPO_RS08755	17
ARS007ss_ds.merged.samereadgroup.cleaned	1769834	1769842		YPO_RS08755	8
ARS007ss_ds.merged.samereadgroup.cleaned	1770237	1770245		YPO_RS08760	8
ARS007ss_ds.merged.samereadgroup.cleaned	1770569	1770584		YPO_RS08760	15
ARS007ss_ds.merged.samereadgroup.cleaned	1770681	1770684		YPO_RS08760	3
ARS007ss_ds.merged.samereadgroup.cleaned	1770750	1770773		YPO_RS08760	23
ARS007ss_ds.merged.samereadgroup.cleaned	1770881	1770886		YPO_RS08760	5
ARS007ss_ds.merged.samereadgroup.cleaned	1770954	1770955		YPO_RS08760	1
ARS007ss_ds.merged.samereadgroup.cleaned	1771649	1771656		YPO_RS08765	7
ARS007ss_ds.merged.samereadgroup.cleaned	1772345	1772349		YPO_RS08770	4
ARS007ss_ds.merged.samereadgroup.cleaned	1773010	1773013		YPO_RS08770	3
ARS007ss_ds.merged.samereadgroup.cleaned	1774060	1774063		sbcB	3
ARS007ss_ds.merged.samereadgroup.cleaned	1774232	1774239		sbcB	7
ARS007ss_ds.merged.samereadgroup.cleaned	1774527	1774533		sbcB	6
ARS007ss_ds.merged.samereadgroup.cleaned	1775043	1775044		sbcB	1
ARS007ss_ds.merged.samereadgroup.cleaned	1775724	1775726		YPO_RS08785	2
ARS007ss_ds.merged.samereadgroup.cleaned	1775811	1775816		YPO_RS08785	5
ARS007ss_ds.merged.samereadgroup.cleaned	1775881	1775892		YPO_RS08785	11
ARS007ss_ds.merged.samereadgroup.cleaned	1775956	1775962		YPO_RS08785	6
ARS007ss_ds.merged.samereadgroup.cleaned	1776584	1776585		YPO_RS08785	1
ARS007ss_ds.merged.samereadgroup.cleaned	1779331	1779393		YPO_RS08800	62
ARS007ss_ds.merged.samereadgroup.cleaned	1780868	1780903		YPO_RS08800	35
ARS007ss_ds.merged.samereadgroup.cleaned	1781241	1781246		YPO_RS08800	5
ARS007ss_ds.merged.samereadgroup.cleaned	1781404	1781412		YPO_RS08800	8
ARS007ss_ds.merged.samereadgroup.cleaned	1781602	1781605		YPO_RS08800	3
ARS007ss_ds.merged.samereadgroup.cleaned	1781774	1781780		YPO_RS08800	6
ARS007ss_ds.merged.samereadgroup.cleaned	1782027	1782030		YPO_RS08800	3
ARS007ss_ds.merged.samereadgroup.cleaned	1783215	1783228		YPO_RS08805	13
ARS007ss_ds.merged.samereadgroup.cleaned	1783486	1783491		YPO_RS08805	5
ARS007ss_ds.merged.samereadgroup.cleaned	1783680	1783683		YPO_RS08805	3
ARS007ss_ds.merged.samereadgroup.cleaned	1783883	1783900		YPO_RS08805	17
ARS007ss_ds.merged.samereadgroup.cleaned	1784199	1784211		YPO_RS08805	12
ARS007ss_ds.merged.samereadgroup.cleaned	1785413	1785414		YPO_RS08815	1
ARS007ss_ds.merged.samereadgroup.cleaned	1786549	1786568		YPO_RS08820	19
ARS007ss_ds.merged.samereadgroup.cleaned	1786761	1786764		YPO_RS08820	3
ARS007ss_ds.merged.samereadgroup.cleaned	1786954	1786961		YPO_RS08820	7
ARS007ss_ds.merged.samereadgroup.cleaned	1790034	1790036		argG	2
ARS007ss_ds.merged.samereadgroup.cleaned	1790334	1790362		argG	28
ARS007ss_ds.merged.samereadgroup.cleaned	1791761	1791769		YPO_RS08840	8
ARS007ss_ds.merged.samereadgroup.cleaned	1791881	1791885		YPO_RS08840	4
ARS007ss_ds.merged.samereadgroup.cleaned	1792553	1792572		YPO_RS08840	19
ARS007ss_ds.merged.samereadgroup.cleaned	1792851	1792862		YPO_RS08840	11
ARS007ss_ds.merged.samereadgroup.cleaned	1793018	1793024		YPO_RS08840	6
ARS007ss_ds.merged.samereadgroup.cleaned	1793244	1793258		YPO_RS08845	14
ARS007ss_ds.merged.samereadgroup.cleaned	1794167	1794175		YPO_RS08845	8
ARS007ss_ds.merged.samereadgroup.cleaned	1794380	1794407		YPO_RS08845	27
ARS007ss_ds.merged.samereadgroup.cleaned	1795250	1795266		YPO_RS08850	16
ARS007ss_ds.merged.samereadgroup.cleaned	1795991	1796052		YPO_RS08855	61
ARS007ss_ds.merged.samereadgroup.cleaned	1796115	1796184		YPO_RS08855	69
ARS007ss_ds.merged.samereadgroup.cleaned	1796976	1796982		YPO_RS08860	6
ARS007ss_ds.merged.samereadgroup.cleaned	1798097	1798131		YPO_RS08870	34
ARS007ss_ds.merged.samereadgroup.cleaned	1798385	1798392		YPO_RS08870	7
ARS007ss_ds.merged.samereadgroup.cleaned	1799410	1799417		YPO_RS08875	7
ARS007ss_ds.merged.samereadgroup.cleaned	1799568	1799577		YPO_RS08875	9
ARS007ss_ds.merged.samereadgroup.cleaned	1799911	1799934		YPO_RS08875	23
ARS007ss_ds.merged.samereadgroup.cleaned	1800600	1800616		YPO_RS08880	16
ARS007ss_ds.merged.samereadgroup.cleaned	1801323	1801324		YPO_RS08885	1
ARS007ss_ds.merged.samereadgroup.cleaned	1801432	1801445		YPO_RS08885	13
ARS007ss_ds.merged.samereadgroup.cleaned	1801539	1801583		YPO_RS08885	44
ARS007ss_ds.merged.samereadgroup.cleaned	1802902	1802916		YPO_RS08890	14
ARS007ss_ds.merged.samereadgroup.cleaned	1803470	1803474		YPO_RS08895	4
ARS007ss_ds.merged.samereadgroup.cleaned	1803812	1803834		YPO_RS08900	22
ARS007ss_ds.merged.samereadgroup.cleaned	1803955	1803957		YPO_RS08900	2
ARS007ss_ds.merged.samereadgroup.cleaned	1804322	1804327		YPO_RS08900	5
ARS007ss_ds.merged.samereadgroup.cleaned	1804696	1804697		YPO_RS08900	1
ARS007ss_ds.merged.samereadgroup.cleaned	1804867	1804873		YPO_RS08900	6
ARS007ss_ds.merged.samereadgroup.cleaned	1805049	1805051		YPO_RS08900	2
ARS007ss_ds.merged.samereadgroup.cleaned	1805090	1805100		YPO_RS08900	10
ARS007ss_ds.merged.samereadgroup.cleaned	1806064	1806078		YPO_RS08905	14
ARS007ss_ds.merged.samereadgroup.cleaned	1806449	1806451		YPO_RS08905	2
ARS007ss_ds.merged.samereadgroup.cleaned	1806723	1806737		YPO_RS08905	14
ARS007ss_ds.merged.samereadgroup.cleaned	1806985	1806998		YPO_RS08905	13
ARS007ss_ds.merged.samereadgroup.cleaned	1808306	1808321		bssS	15
ARS007ss_ds.merged.samereadgroup.cleaned	1808458	1808489		bssS	31
ARS007ss_ds.merged.samereadgroup.cleaned	1810007	1810010		pyrC	3
ARS007ss_ds.merged.samereadgroup.cleaned	1810218	1810230		pyrC	12
ARS007ss_ds.merged.samereadgroup.cleaned	1812868	1812879		rne	11
ARS007ss_ds.merged.samereadgroup.cleaned	1812939	1812940		rne	1
ARS007ss_ds.merged.samereadgroup.cleaned	1813820	1813821		rne	1
ARS007ss_ds.merged.samereadgroup.cleaned	1814179	1814190		rne	11
ARS007ss_ds.merged.samereadgroup.cleaned	1814414	1814423		rne	9
ARS007ss_ds.merged.samereadgroup.cleaned	1817221	1817226		rluC	5
ARS007ss_ds.merged.samereadgroup.cleaned	1817328	1817342		rluC	14
ARS007ss_ds.merged.samereadgroup.cleaned	1821134	1821139		plsX	5
ARS007ss_ds.merged.samereadgroup.cleaned	1821709	1821715		YPO_RS08980	6
ARS007ss_ds.merged.samereadgroup.cleaned	1822003	1822006		YPO_RS08980	3
ARS007ss_ds.merged.samereadgroup.cleaned	1822669	1822687		fabD	18
ARS007ss_ds.merged.samereadgroup.cleaned	1822871	1822877		fabD	6
ARS007ss_ds.merged.samereadgroup.cleaned	1823106	1823121		fabD	15
ARS007ss_ds.merged.samereadgroup.cleaned	1823351	1823366		fabG	15
ARS007ss_ds.merged.samereadgroup.cleaned	1824320	1824324		acpP	4
ARS007ss_ds.merged.samereadgroup.cleaned	1824693	1824702		fabF	9
ARS007ss_ds.merged.samereadgroup.cleaned	1824881	1824897		fabF	16
ARS007ss_ds.merged.samereadgroup.cleaned	1825030	1825034		fabF	4
ARS007ss_ds.merged.samereadgroup.cleaned	1828308	1828315		mltG	7
ARS007ss_ds.merged.samereadgroup.cleaned	1828602	1828603		mltG	1
ARS007ss_ds.merged.samereadgroup.cleaned	1828667	1828674		mltG	7
ARS007ss_ds.merged.samereadgroup.cleaned	1828939	1828967		YPO_RS09020	28
ARS007ss_ds.merged.samereadgroup.cleaned	1829274	1829293		YPO_RS09020	19
ARS007ss_ds.merged.samereadgroup.cleaned	1829696	1829701		holB	5
ARS007ss_ds.merged.samereadgroup.cleaned	1830107	1830120		holB	13
ARS007ss_ds.merged.samereadgroup.cleaned	1830506	1830510		holB	4
ARS007ss_ds.merged.samereadgroup.cleaned	1830585	1830597		YPO_RS09030	12
ARS007ss_ds.merged.samereadgroup.cleaned	1832171	1832172		ptsG	1
ARS007ss_ds.merged.samereadgroup.cleaned	1835642	1835648		YPO_RS09055	6
ARS007ss_ds.merged.samereadgroup.cleaned	1836105	1836119		lpoB	14
ARS007ss_ds.merged.samereadgroup.cleaned	1836849	1836851		thiK	2
ARS007ss_ds.merged.samereadgroup.cleaned	1837005	1837007		thiK	2
ARS007ss_ds.merged.samereadgroup.cleaned	1837737	1837748		nagZ	11
ARS007ss_ds.merged.samereadgroup.cleaned	1838337	1838342		nagZ	5
ARS007ss_ds.merged.samereadgroup.cleaned	1839047	1839052		YPO_RS09075	5
ARS007ss_ds.merged.samereadgroup.cleaned	1839604	1839616		YPO_RS09080	12
ARS007ss_ds.merged.samereadgroup.cleaned	1840364	1840377		YPO_RS09080	13
ARS007ss_ds.merged.samereadgroup.cleaned	1840717	1840720		YPO_RS09080	3
ARS007ss_ds.merged.samereadgroup.cleaned	1840806	1840809		YPO_RS09080	3
ARS007ss_ds.merged.samereadgroup.cleaned	1842047	1842051		YPO_RS09090	4
ARS007ss_ds.merged.samereadgroup.cleaned	1842204	1842248		YPO_RS09090	44
ARS007ss_ds.merged.samereadgroup.cleaned	1848245	1848258		mfd	13
ARS007ss_ds.merged.samereadgroup.cleaned	1848716	1848731		mfd	15
ARS007ss_ds.merged.samereadgroup.cleaned	1848933	1848944		mfd	11
ARS007ss_ds.merged.samereadgroup.cleaned	1850597	1850601		lolC	4
ARS007ss_ds.merged.samereadgroup.cleaned	1850847	1850850		lolC	3
ARS007ss_ds.merged.samereadgroup.cleaned	1851483	1851486		lolC	3
ARS007ss_ds.merged.samereadgroup.cleaned	1851854	1851871		lolD	17
ARS007ss_ds.merged.samereadgroup.cleaned	1852371	1852375		lolD	4
ARS007ss_ds.merged.samereadgroup.cleaned	1852693	1852743		lolE	50
ARS007ss_ds.merged.samereadgroup.cleaned	1853394	1853402		lolE	8
ARS007ss_ds.merged.samereadgroup.cleaned	1853610	1853616		lolE	6
ARS007ss_ds.merged.samereadgroup.cleaned	1855304	1855317		cobB	13
ARS007ss_ds.merged.samereadgroup.cleaned	1856046	1856069		pepT	23
ARS007ss_ds.merged.samereadgroup.cleaned	1856516	1856523		pepT	7
ARS007ss_ds.merged.samereadgroup.cleaned	1856757	1856795		pepT	38
ARS007ss_ds.merged.samereadgroup.cleaned	1856843	1856855		pepT	12
ARS007ss_ds.merged.samereadgroup.cleaned	1858112	1858116		YPO_RS09150	4
ARS007ss_ds.merged.samereadgroup.cleaned	1858196	1858206		YPO_RS09150	10
ARS007ss_ds.merged.samereadgroup.cleaned	1859399	1859421		phoQ	22
ARS007ss_ds.merged.samereadgroup.cleaned	1859517	1859523		phoQ	6
ARS007ss_ds.merged.samereadgroup.cleaned	1859806	1859833		phoQ	27
ARS007ss_ds.merged.samereadgroup.cleaned	1860861	1860866		YPO_RS09165	5
ARS007ss_ds.merged.samereadgroup.cleaned	1861361	1861377		YPO_RS09165	16
ARS007ss_ds.merged.samereadgroup.cleaned	1863042	1863054		hflD	12
ARS007ss_ds.merged.samereadgroup.cleaned	1863156	1863157		hflD	1
ARS007ss_ds.merged.samereadgroup.cleaned	1863390	1863407		hflD	17
ARS007ss_ds.merged.samereadgroup.cleaned	1863490	1863515		hflD	25
ARS007ss_ds.merged.samereadgroup.cleaned	1863586	1863595		hflD	9
ARS007ss_ds.merged.samereadgroup.cleaned	1863772	1863776		mnmA	4
ARS007ss_ds.merged.samereadgroup.cleaned	1864000	1864008		mnmA	8
ARS007ss_ds.merged.samereadgroup.cleaned	1864141	1864149		mnmA	8
ARS007ss_ds.merged.samereadgroup.cleaned	1864411	1864416		mnmA	5
ARS007ss_ds.merged.samereadgroup.cleaned	1865673	1865684		rluE	11
ARS007ss_ds.merged.samereadgroup.cleaned	1866016	1866024		rluE	8
ARS007ss_ds.merged.samereadgroup.cleaned	1866532	1866546		icd	14
ARS007ss_ds.merged.samereadgroup.cleaned	1868458	1868462		YPO_RS09200	4
ARS007ss_ds.merged.samereadgroup.cleaned	1869577	1869581		YPO_RS09210	4
ARS007ss_ds.merged.samereadgroup.cleaned	1870455	1870460		YPO_RS09210	5
ARS007ss_ds.merged.samereadgroup.cleaned	1871852	1871867		YPO_RS09215	15
ARS007ss_ds.merged.samereadgroup.cleaned	1872283	1872289		YPO_RS09215	6
ARS007ss_ds.merged.samereadgroup.cleaned	1872360	1872368		YPO_RS09215	8
ARS007ss_ds.merged.samereadgroup.cleaned	1872482	1872484		YPO_RS09215	2
ARS007ss_ds.merged.samereadgroup.cleaned	1872653	1872664		YPO_RS09215	11
ARS007ss_ds.merged.samereadgroup.cleaned	1872991	1873013		YPO_RS09220	22
ARS007ss_ds.merged.samereadgroup.cleaned	1873218	1873221		YPO_RS09220	3
ARS007ss_ds.merged.samereadgroup.cleaned	1873956	1873961		YPO_RS09230	5
ARS007ss_ds.merged.samereadgroup.cleaned	1874012	1874013		YPO_RS09230	1
ARS007ss_ds.merged.samereadgroup.cleaned	1874076	1874084		YPO_RS09230	8
ARS007ss_ds.merged.samereadgroup.cleaned	1874816	1874819		YPO_RS09230	3
ARS007ss_ds.merged.samereadgroup.cleaned	1875569	1875583		ydfZ	14
ARS007ss_ds.merged.samereadgroup.cleaned	1875960	1875967		YPO_RS09240	7
ARS007ss_ds.merged.samereadgroup.cleaned	1876773	1876785		YPO_RS09240	12
ARS007ss_ds.merged.samereadgroup.cleaned	1876915	1876945		YPO_RS09245	30
ARS007ss_ds.merged.samereadgroup.cleaned	1878279	1878288		YPO_RS09250	9
ARS007ss_ds.merged.samereadgroup.cleaned	1878986	1878991		YPO_RS09255	5
ARS007ss_ds.merged.samereadgroup.cleaned	1880078	1880094		YPO_RS09260	16
ARS007ss_ds.merged.samereadgroup.cleaned	1880406	1880431		YPO_RS09260	25
ARS007ss_ds.merged.samereadgroup.cleaned	1880887	1880901		YPO_RS09260	14
ARS007ss_ds.merged.samereadgroup.cleaned	1880936	1880953		YPO_RS09260	17
ARS007ss_ds.merged.samereadgroup.cleaned	1881092	1881098		YPO_RS09260	6
ARS007ss_ds.merged.samereadgroup.cleaned	1881171	1881178		YPO_RS09260	7
ARS007ss_ds.merged.samereadgroup.cleaned	1881254	1881274		YPO_RS09260	20
ARS007ss_ds.merged.samereadgroup.cleaned	1881571	1881572		YPO_RS09260	1
ARS007ss_ds.merged.samereadgroup.cleaned	1881911	1881921		YPO_RS09260	10
ARS007ss_ds.merged.samereadgroup.cleaned	1882107	1882125		YPO_RS09260	18
ARS007ss_ds.merged.samereadgroup.cleaned	1882166	1882172		YPO_RS09260	6
ARS007ss_ds.merged.samereadgroup.cleaned	1882305	1882310		YPO_RS09260	5
ARS007ss_ds.merged.samereadgroup.cleaned	1882433	1882440		YPO_RS09260	7
ARS007ss_ds.merged.samereadgroup.cleaned	1882687	1882692		YPO_RS09260	5
ARS007ss_ds.merged.samereadgroup.cleaned	1882949	1882954		YPO_RS09260	5
ARS007ss_ds.merged.samereadgroup.cleaned	1883212	1883215		YPO_RS09260	3
ARS007ss_ds.merged.samereadgroup.cleaned	1888820	1888834		mgtA	14
ARS007ss_ds.merged.samereadgroup.cleaned	1889272	1889327		mgtA	55
ARS007ss_ds.merged.samereadgroup.cleaned	1889424	1889428		mgtA	4
ARS007ss_ds.merged.samereadgroup.cleaned	1889556	1889561		mgtA	5
ARS007ss_ds.merged.samereadgroup.cleaned	1889640	1889648		mgtA	8
ARS007ss_ds.merged.samereadgroup.cleaned	1890566	1890574		mgtA	8
ARS007ss_ds.merged.samereadgroup.cleaned	1892917	1892933		flhC	16
ARS007ss_ds.merged.samereadgroup.cleaned	1893204	1893205		flhC	1
ARS007ss_ds.merged.samereadgroup.cleaned	1893786	1893803		motA	17
ARS007ss_ds.merged.samereadgroup.cleaned	1894559	1894560		motB	1
ARS007ss_ds.merged.samereadgroup.cleaned	1894691	1894706		motB	15
ARS007ss_ds.merged.samereadgroup.cleaned	1894829	1894831		motB	2
ARS007ss_ds.merged.samereadgroup.cleaned	1895336	1895349		motB	13
ARS007ss_ds.merged.samereadgroup.cleaned	1895437	1895448		motB	11
ARS007ss_ds.merged.samereadgroup.cleaned	1895839	1895842		cheA	3
ARS007ss_ds.merged.samereadgroup.cleaned	1896348	1896395		cheA	47
ARS007ss_ds.merged.samereadgroup.cleaned	1896621	1896625		cheA	4
ARS007ss_ds.merged.samereadgroup.cleaned	1898304	1898310		cheW	6
ARS007ss_ds.merged.samereadgroup.cleaned	1898957	1898960		YPO_RS09320	3
ARS007ss_ds.merged.samereadgroup.cleaned	1899186	1899198		YPO_RS09320	12
ARS007ss_ds.merged.samereadgroup.cleaned	1899530	1899531		YPO_RS09320	1
ARS007ss_ds.merged.samereadgroup.cleaned	1899579	1899581		YPO_RS09320	2
ARS007ss_ds.merged.samereadgroup.cleaned	1899849	1899859		YPO_RS09320	10
ARS007ss_ds.merged.samereadgroup.cleaned	1899954	1899970		YPO_RS09320	16
ARS007ss_ds.merged.samereadgroup.cleaned	1900243	1900265		YPO_RS09325	22
ARS007ss_ds.merged.samereadgroup.cleaned	1900824	1900847		YPO_RS09330	23
ARS007ss_ds.merged.samereadgroup.cleaned	1901131	1901135		YPO_RS09330	4
ARS007ss_ds.merged.samereadgroup.cleaned	1901660	1901705		YPO_RS09335	45
ARS007ss_ds.merged.samereadgroup.cleaned	1901982	1901983		YPO_RS09335	1
ARS007ss_ds.merged.samereadgroup.cleaned	1903130	1903148		yapJ	18
ARS007ss_ds.merged.samereadgroup.cleaned	1903535	1903536		yapJ	1
ARS007ss_ds.merged.samereadgroup.cleaned	1903770	1903789		yapJ	19
ARS007ss_ds.merged.samereadgroup.cleaned	1903945	1903946		yapJ	1
ARS007ss_ds.merged.samereadgroup.cleaned	1904261	1904266		yapJ	5
ARS007ss_ds.merged.samereadgroup.cleaned	1904457	1904477		yapJ	20
ARS007ss_ds.merged.samereadgroup.cleaned	1904869	1904885		yapJ	16
ARS007ss_ds.merged.samereadgroup.cleaned	1905494	1905495		yapJ	1
ARS007ss_ds.merged.samereadgroup.cleaned	1905614	1905624		yapJ	10
ARS007ss_ds.merged.samereadgroup.cleaned	1905788	1905796		yapJ	8
ARS007ss_ds.merged.samereadgroup.cleaned	1906002	1906014		yapJ	12
ARS007ss_ds.merged.samereadgroup.cleaned	1906286	1906289		yapJ	3
ARS007ss_ds.merged.samereadgroup.cleaned	1906585	1906592		yapJ	7
ARS007ss_ds.merged.samereadgroup.cleaned	1907231	1907236		YPO_RS09345	5
ARS007ss_ds.merged.samereadgroup.cleaned	1907493	1907499		YPO_RS09345	6
ARS007ss_ds.merged.samereadgroup.cleaned	1908707	1908727		YPO_RS09345	20
ARS007ss_ds.merged.samereadgroup.cleaned	1910115	1910128		YPO_RS09350	13
ARS007ss_ds.merged.samereadgroup.cleaned	1910197	1910206		YPO_RS09350	9
ARS007ss_ds.merged.samereadgroup.cleaned	1910689	1910705		YPO_RS09350	16
ARS007ss_ds.merged.samereadgroup.cleaned	1910759	1910763		YPO_RS09350	4
ARS007ss_ds.merged.samereadgroup.cleaned	1911053	1911064		YPO_RS09355	11
ARS007ss_ds.merged.samereadgroup.cleaned	1911401	1911409		YPO_RS09355	8
ARS007ss_ds.merged.samereadgroup.cleaned	1911693	1911698		YPO_RS09355	5
ARS007ss_ds.merged.samereadgroup.cleaned	1911844	1911855		YPO_RS09355	11
ARS007ss_ds.merged.samereadgroup.cleaned	1912016	1912022		YPO_RS09355	6
ARS007ss_ds.merged.samereadgroup.cleaned	1915007	1915008		cheR	1
ARS007ss_ds.merged.samereadgroup.cleaned	1915845	1915856		YPO_RS09370	11
ARS007ss_ds.merged.samereadgroup.cleaned	1916256	1916278		YPO_RS09370	22
ARS007ss_ds.merged.samereadgroup.cleaned	1916499	1916500		YPO_RS09370	1
ARS007ss_ds.merged.samereadgroup.cleaned	1916574	1916582		YPO_RS09370	8
ARS007ss_ds.merged.samereadgroup.cleaned	1917000	1917005		cheY	5
ARS007ss_ds.merged.samereadgroup.cleaned	1918291	1918301		YPO_RS09385	10
ARS007ss_ds.merged.samereadgroup.cleaned	1919616	1919657		YPO_RS09390	41
ARS007ss_ds.merged.samereadgroup.cleaned	1919830	1919839		YPO_RS09390	9
ARS007ss_ds.merged.samereadgroup.cleaned	1920477	1920499		YPO_RS09390	22
ARS007ss_ds.merged.samereadgroup.cleaned	1920542	1920556		YPO_RS09390	14
ARS007ss_ds.merged.samereadgroup.cleaned	1920624	1920634		YPO_RS09390	10
ARS007ss_ds.merged.samereadgroup.cleaned	1920800	1920810		YPO_RS09390	10
ARS007ss_ds.merged.samereadgroup.cleaned	1921270	1921284		YPO_RS09390	14
ARS007ss_ds.merged.samereadgroup.cleaned	1921547	1921552		YPO_RS09390	5
ARS007ss_ds.merged.samereadgroup.cleaned	1921879	1921942		YPO_RS09395	63
ARS007ss_ds.merged.samereadgroup.cleaned	1922560	1922570		YPO_RS09400	10
ARS007ss_ds.merged.samereadgroup.cleaned	1922916	1922924		YPO_RS09400	8
ARS007ss_ds.merged.samereadgroup.cleaned	1923882	1923890		YPO_RS09405	8
ARS007ss_ds.merged.samereadgroup.cleaned	1924149	1924155		YPO_RS09405	6
ARS007ss_ds.merged.samereadgroup.cleaned	1924416	1924422		YPO_RS09405	6
ARS007ss_ds.merged.samereadgroup.cleaned	1931147	1931160		YPO_RS09440	13
ARS007ss_ds.merged.samereadgroup.cleaned	1931487	1931488		YPO_RS09440	1
ARS007ss_ds.merged.samereadgroup.cleaned	1931651	1931660		YPO_RS09445	9
ARS007ss_ds.merged.samereadgroup.cleaned	1932251	1932267		YPO_RS09450	16
ARS007ss_ds.merged.samereadgroup.cleaned	1932647	1932658		YPO_RS09450	11
ARS007ss_ds.merged.samereadgroup.cleaned	1932714	1932734		YPO_RS09450	20
ARS007ss_ds.merged.samereadgroup.cleaned	1932823	1932842		YPO_RS09450	19
ARS007ss_ds.merged.samereadgroup.cleaned	1932956	1932991		YPO_RS09450	35
ARS007ss_ds.merged.samereadgroup.cleaned	1933451	1933464		YPO_RS09455	13
ARS007ss_ds.merged.samereadgroup.cleaned	1933814	1933874		YPO_RS09455	60
ARS007ss_ds.merged.samereadgroup.cleaned	1934785	1934806		YPO_RS09455	21
ARS007ss_ds.merged.samereadgroup.cleaned	1934934	1934942		YPO_RS09455	8
ARS007ss_ds.merged.samereadgroup.cleaned	1935049	1935075		YPO_RS09455	26
ARS007ss_ds.merged.samereadgroup.cleaned	1935686	1935697		YPO_RS09455	11
ARS007ss_ds.merged.samereadgroup.cleaned	1933309	1933315		YPO_RS09455	6
ARS007ss_ds.merged.samereadgroup.cleaned	1935925	1935942		YPO_RS09460	17
ARS007ss_ds.merged.samereadgroup.cleaned	1935974	1935978		YPO_RS09460	4
ARS007ss_ds.merged.samereadgroup.cleaned	1936416	1936444		YPO_RS09460	28
ARS007ss_ds.merged.samereadgroup.cleaned	1936584	1936594		YPO_RS09460	10
ARS007ss_ds.merged.samereadgroup.cleaned	1936706	1936746		YPO_RS09465	40
ARS007ss_ds.merged.samereadgroup.cleaned	1936819	1936832		YPO_RS09465	13
ARS007ss_ds.merged.samereadgroup.cleaned	1936911	1936916		YPO_RS09465	5
ARS007ss_ds.merged.samereadgroup.cleaned	1937194	1937216		YPO_RS09465	22
ARS007ss_ds.merged.samereadgroup.cleaned	1937321	1937325		YPO_RS09470	4
ARS007ss_ds.merged.samereadgroup.cleaned	1937399	1937409		YPO_RS09470	10
ARS007ss_ds.merged.samereadgroup.cleaned	1937506	1937536		YPO_RS09470	30
ARS007ss_ds.merged.samereadgroup.cleaned	1937820	1937847		YPO_RS09475	27
ARS007ss_ds.merged.samereadgroup.cleaned	1938039	1938066		YPO_RS09475	27
ARS007ss_ds.merged.samereadgroup.cleaned	1938114	1938118		YPO_RS09475	4
ARS007ss_ds.merged.samereadgroup.cleaned	1939125	1939127		YPO_RS09480	2
ARS007ss_ds.merged.samereadgroup.cleaned	1940244	1940261		YPO_RS09480	17
ARS007ss_ds.merged.samereadgroup.cleaned	1940609	1940621		YPO_RS09480	12
ARS007ss_ds.merged.samereadgroup.cleaned	1941167	1941174		YPO_RS09480	7
ARS007ss_ds.merged.samereadgroup.cleaned	1941205	1941217		YPO_RS09480	12
ARS007ss_ds.merged.samereadgroup.cleaned	1941676	1941681		yebS	5
ARS007ss_ds.merged.samereadgroup.cleaned	1943225	1943236		YPO_RS09490	11
ARS007ss_ds.merged.samereadgroup.cleaned	1943302	1943309		YPO_RS09490	7
ARS007ss_ds.merged.samereadgroup.cleaned	1943791	1943803		proQ	12
ARS007ss_ds.merged.samereadgroup.cleaned	1943975	1943980		proQ	5
ARS007ss_ds.merged.samereadgroup.cleaned	1945592	1945606		prc	14
ARS007ss_ds.merged.samereadgroup.cleaned	1946056	1946062		prc	6
ARS007ss_ds.merged.samereadgroup.cleaned	1946862	1946876		htpX	14
ARS007ss_ds.merged.samereadgroup.cleaned	1947700	1947705		htpX	5
ARS007ss_ds.merged.samereadgroup.cleaned	1948901	1948905		YPO_RS09510	4
ARS007ss_ds.merged.samereadgroup.cleaned	1949176	1949177		YPO_RS09515	1
ARS007ss_ds.merged.samereadgroup.cleaned	1949311	1949346		YPO_RS09515	35
ARS007ss_ds.merged.samereadgroup.cleaned	1949796	1949799		YPO_RS09515	3
ARS007ss_ds.merged.samereadgroup.cleaned	1950087	1950119		YPO_RS09520	32
ARS007ss_ds.merged.samereadgroup.cleaned	1950445	1950465		YPO_RS09520	20
ARS007ss_ds.merged.samereadgroup.cleaned	1950864	1950876		YPO_RS09520	12
ARS007ss_ds.merged.samereadgroup.cleaned	1951968	1951969		YPO_RS09520	1
ARS007ss_ds.merged.samereadgroup.cleaned	1952291	1952299		YPO_RS09520	8
ARS007ss_ds.merged.samereadgroup.cleaned	1952475	1952510		YPO_RS09520	35
ARS007ss_ds.merged.samereadgroup.cleaned	1952703	1952721		YPO_RS09525	18
ARS007ss_ds.merged.samereadgroup.cleaned	1953116	1953122		YPO_RS09525	6
ARS007ss_ds.merged.samereadgroup.cleaned	1953497	1953513		YPO_RS09525	16
ARS007ss_ds.merged.samereadgroup.cleaned	1953837	1953838		YPO_RS09530	1
ARS007ss_ds.merged.samereadgroup.cleaned	1954030	1954037		YPO_RS09530	7
ARS007ss_ds.merged.samereadgroup.cleaned	1954232	1954234		YPO_RS09530	2
ARS007ss_ds.merged.samereadgroup.cleaned	1954371	1954379		YPO_RS09530	8
ARS007ss_ds.merged.samereadgroup.cleaned	1955441	1955442		YPO_RS09535	1
ARS007ss_ds.merged.samereadgroup.cleaned	1955708	1955723		YPO_RS09535	15
ARS007ss_ds.merged.samereadgroup.cleaned	1955884	1955892		YPO_RS09535	8
ARS007ss_ds.merged.samereadgroup.cleaned	1957125	1957142		YPO_RS09540	17
ARS007ss_ds.merged.samereadgroup.cleaned	1957268	1957300		YPO_RS09540	32
ARS007ss_ds.merged.samereadgroup.cleaned	1957944	1957961		kdgR	17
ARS007ss_ds.merged.samereadgroup.cleaned	1958036	1958037		kdgR	1
ARS007ss_ds.merged.samereadgroup.cleaned	1958768	1958787		YPO_RS09550	19
ARS007ss_ds.merged.samereadgroup.cleaned	1958921	1958924		YPO_RS09550	3
ARS007ss_ds.merged.samereadgroup.cleaned	1958972	1958998		YPO_RS09550	26
ARS007ss_ds.merged.samereadgroup.cleaned	1959184	1959188		YPO_RS09550	4
ARS007ss_ds.merged.samereadgroup.cleaned	1960055	1960081		YPO_RS09555	26
ARS007ss_ds.merged.samereadgroup.cleaned	1961641	1961656		YPO_RS09560	15
ARS007ss_ds.merged.samereadgroup.cleaned	1963136	1963167		YPO_RS09565	31
ARS007ss_ds.merged.samereadgroup.cleaned	1963636	1963641		YPO_RS09570	5
ARS007ss_ds.merged.samereadgroup.cleaned	1963740	1963742		YPO_RS09570	2
ARS007ss_ds.merged.samereadgroup.cleaned	1964058	1964092		YPO_RS09570	34
ARS007ss_ds.merged.samereadgroup.cleaned	1964198	1964201		YPO_RS09570	3
ARS007ss_ds.merged.samereadgroup.cleaned	1964648	1964658		YPO_RS09570	10
ARS007ss_ds.merged.samereadgroup.cleaned	1964823	1964827		YPO_RS09575	4
ARS007ss_ds.merged.samereadgroup.cleaned	1965212	1965217		YPO_RS09575	5
ARS007ss_ds.merged.samereadgroup.cleaned	1966185	1966198		YPO_RS09580	13
ARS007ss_ds.merged.samereadgroup.cleaned	1966397	1966423		YPO_RS09580	26
ARS007ss_ds.merged.samereadgroup.cleaned	1967016	1967020		YPO_RS09585	4
ARS007ss_ds.merged.samereadgroup.cleaned	1967672	1967673		YPO_RS09585	1
ARS007ss_ds.merged.samereadgroup.cleaned	1968081	1968091		YPO_RS09590	10
ARS007ss_ds.merged.samereadgroup.cleaned	1969073	1969079		YPO_RS09590	6
ARS007ss_ds.merged.samereadgroup.cleaned	1970462	1970463		kduD	1
ARS007ss_ds.merged.samereadgroup.cleaned	1970846	1970870		kduI	24
ARS007ss_ds.merged.samereadgroup.cleaned	1970936	1970969		kduI	33
ARS007ss_ds.merged.samereadgroup.cleaned	1971056	1971072		kduI	16
ARS007ss_ds.merged.samereadgroup.cleaned	1976670	1976692		YPO_RS09630	22
ARS007ss_ds.merged.samereadgroup.cleaned	1976755	1976768		YPO_RS09630	13
ARS007ss_ds.merged.samereadgroup.cleaned	1976841	1976842		YPO_RS09630	1
ARS007ss_ds.merged.samereadgroup.cleaned	1977464	1977499		mtfA	35
ARS007ss_ds.merged.samereadgroup.cleaned	1977872	1977889		mtfA	17
ARS007ss_ds.merged.samereadgroup.cleaned	1978591	1978611		YPO_RS09645	20
ARS007ss_ds.merged.samereadgroup.cleaned	1978682	1978702		YPO_RS09645	20
ARS007ss_ds.merged.samereadgroup.cleaned	1979168	1979178		YPO_RS09650	10
ARS007ss_ds.merged.samereadgroup.cleaned	1979411	1979419		YPO_RS09650	8
ARS007ss_ds.merged.samereadgroup.cleaned	1979693	1979701		YPO_RS09650	8
ARS007ss_ds.merged.samereadgroup.cleaned	1980002	1980003		YPO_RS09655	1
ARS007ss_ds.merged.samereadgroup.cleaned	1980402	1980403		YPO_RS09655	1
ARS007ss_ds.merged.samereadgroup.cleaned	1980635	1980639		YPO_RS09655	4
ARS007ss_ds.merged.samereadgroup.cleaned	1981018	1981048		YPO_RS09655	30
ARS007ss_ds.merged.samereadgroup.cleaned	1982376	1982389		YPO_RS09660	13
ARS007ss_ds.merged.samereadgroup.cleaned	1982713	1982754		YPO_RS09665	41
ARS007ss_ds.merged.samereadgroup.cleaned	1982855	1982865		YPO_RS09665	10
ARS007ss_ds.merged.samereadgroup.cleaned	1983848	1983860		YPO_RS09675	12
ARS007ss_ds.merged.samereadgroup.cleaned	1983990	1983997		YPO_RS09675	7
ARS007ss_ds.merged.samereadgroup.cleaned	1984827	1984833		YPO_RS09685	6
ARS007ss_ds.merged.samereadgroup.cleaned	1985387	1985388		YPO_RS09690	1
ARS007ss_ds.merged.samereadgroup.cleaned	1985810	1985814		YPO_RS09695	4
ARS007ss_ds.merged.samereadgroup.cleaned	1986938	1986957		YPO_RS09700	19
ARS007ss_ds.merged.samereadgroup.cleaned	1987338	1987341		YPO_RS09700	3
ARS007ss_ds.merged.samereadgroup.cleaned	1987372	1987376		YPO_RS09700	4
ARS007ss_ds.merged.samereadgroup.cleaned	1987775	1987803		YPO_RS09705	28
ARS007ss_ds.merged.samereadgroup.cleaned	1990171	1990174		pgeF	3
ARS007ss_ds.merged.samereadgroup.cleaned	1990970	1990987		rlmA	17
ARS007ss_ds.merged.samereadgroup.cleaned	1992123	1992125		YPO_RS09730	2
ARS007ss_ds.merged.samereadgroup.cleaned	1992183	1992206		YPO_RS09730	23
ARS007ss_ds.merged.samereadgroup.cleaned	1995084	1995090		YPO_RS09745	6
ARS007ss_ds.merged.samereadgroup.cleaned	1995854	1995855		YPO_RS09745	1
ARS007ss_ds.merged.samereadgroup.cleaned	1996009	1996010		YPO_RS09745	1
ARS007ss_ds.merged.samereadgroup.cleaned	1996139	1996145		YPO_RS09745	6
ARS007ss_ds.merged.samereadgroup.cleaned	1997011	1997013		YPO_RS09750	2
ARS007ss_ds.merged.samereadgroup.cleaned	1997086	1997088		YPO_RS09750	2
ARS007ss_ds.merged.samereadgroup.cleaned	1997814	1997815		YPO_RS09750	1
ARS007ss_ds.merged.samereadgroup.cleaned	1997872	1997873		YPO_RS09750	1
ARS007ss_ds.merged.samereadgroup.cleaned	1998072	1998139		YPO_RS09750	67
ARS007ss_ds.merged.samereadgroup.cleaned	1998201	1998215		YPO_RS09750	14
ARS007ss_ds.merged.samereadgroup.cleaned	1998757	1998763		YPO_RS09750	6
ARS007ss_ds.merged.samereadgroup.cleaned	1999014	1999037		YPO_RS09750	23
ARS007ss_ds.merged.samereadgroup.cleaned	1999338	1999346		mntP	8
ARS007ss_ds.merged.samereadgroup.cleaned	1999422	1999433		mntP	11
ARS007ss_ds.merged.samereadgroup.cleaned	1999864	1999898		mntP	34
ARS007ss_ds.merged.samereadgroup.cleaned	2000365	2000381		YPO_RS09760	16
ARS007ss_ds.merged.samereadgroup.cleaned	2000597	2000601		YPO_RS09760	4
ARS007ss_ds.merged.samereadgroup.cleaned	2001197	2001206		YPO_RS09765	9
ARS007ss_ds.merged.samereadgroup.cleaned	2001337	2001349		YPO_RS09765	12
ARS007ss_ds.merged.samereadgroup.cleaned	2001417	2001421		YPO_RS09765	4
ARS007ss_ds.merged.samereadgroup.cleaned	2001986	2002002		YPO_RS09770	16
ARS007ss_ds.merged.samereadgroup.cleaned	2002778	2002795		manX	17
ARS007ss_ds.merged.samereadgroup.cleaned	2003227	2003240		manX	13
ARS007ss_ds.merged.samereadgroup.cleaned	2003389	2003404		manX	15
ARS007ss_ds.merged.samereadgroup.cleaned	2003573	2003587		manX	14
ARS007ss_ds.merged.samereadgroup.cleaned	2003744	2003749		manX	5
ARS007ss_ds.merged.samereadgroup.cleaned	2004730	2004740		YPO_RS09780	10
ARS007ss_ds.merged.samereadgroup.cleaned	2005689	2005694		YPO_RS09780	5
ARS007ss_ds.merged.samereadgroup.cleaned	2005812	2005814		YPO_RS09780	2
ARS007ss_ds.merged.samereadgroup.cleaned	2005893	2005896		YPO_RS09780	3
ARS007ss_ds.merged.samereadgroup.cleaned	2007557	2007561		YPO_RS09795	4
ARS007ss_ds.merged.samereadgroup.cleaned	2008110	2008121		YPO_RS09795	11
ARS007ss_ds.merged.samereadgroup.cleaned	2008196	2008239		YPO_RS09795	43
ARS007ss_ds.merged.samereadgroup.cleaned	2008741	2008754		YPO_RS09800	13
ARS007ss_ds.merged.samereadgroup.cleaned	2008833	2008834		YPO_RS09800	1
ARS007ss_ds.merged.samereadgroup.cleaned	2009267	2009283		YPO_RS09800	16
ARS007ss_ds.merged.samereadgroup.cleaned	2009938	2009940		hpaD	2
ARS007ss_ds.merged.samereadgroup.cleaned	2010059	2010063		hpaD	4
ARS007ss_ds.merged.samereadgroup.cleaned	2010489	2010513		hpaD	24
ARS007ss_ds.merged.samereadgroup.cleaned	2010786	2010799		YPO_RS09810	13
ARS007ss_ds.merged.samereadgroup.cleaned	2011149	2011217		hpaH	68
ARS007ss_ds.merged.samereadgroup.cleaned	2012093	2012096		hpaI	3
ARS007ss_ds.merged.samereadgroup.cleaned	2012187	2012198		hpaI	11
ARS007ss_ds.merged.samereadgroup.cleaned	2012434	2012435		hpaI	1
ARS007ss_ds.merged.samereadgroup.cleaned	2012549	2012566		hpaI	17
ARS007ss_ds.merged.samereadgroup.cleaned	2012637	2012656		hpaI	19
ARS007ss_ds.merged.samereadgroup.cleaned	2012730	2012735		hpaX	5
ARS007ss_ds.merged.samereadgroup.cleaned	2012965	2012978		hpaX	13
ARS007ss_ds.merged.samereadgroup.cleaned	2013118	2013121		hpaX	3
ARS007ss_ds.merged.samereadgroup.cleaned	2013332	2013351		hpaX	19
ARS007ss_ds.merged.samereadgroup.cleaned	2013493	2013499		hpaX	6
ARS007ss_ds.merged.samereadgroup.cleaned	2013736	2013746		hpaX	10
ARS007ss_ds.merged.samereadgroup.cleaned	2014949	2014956		hpaB	7
ARS007ss_ds.merged.samereadgroup.cleaned	2015198	2015203		hpaB	5
ARS007ss_ds.merged.samereadgroup.cleaned	2015714	2015721		hpaC	7
ARS007ss_ds.merged.samereadgroup.cleaned	2018603	2018605		YPO_RS09845	2
ARS007ss_ds.merged.samereadgroup.cleaned	2018907	2018909		YPO_RS09845	2
ARS007ss_ds.merged.samereadgroup.cleaned	2019016	2019028		YPO_RS09845	12
ARS007ss_ds.merged.samereadgroup.cleaned	2021301	2021314		purT	13
ARS007ss_ds.merged.samereadgroup.cleaned	2021934	2021946		purT	12
ARS007ss_ds.merged.samereadgroup.cleaned	2023136	2023140		dbpA	4
ARS007ss_ds.merged.samereadgroup.cleaned	2023611	2023619		dbpA	8
ARS007ss_ds.merged.samereadgroup.cleaned	2023811	2023818		dbpA	7
ARS007ss_ds.merged.samereadgroup.cleaned	2024866	2024876		YPO_RS09880	10
ARS007ss_ds.merged.samereadgroup.cleaned	2025618	2025633		YPO_RS09885	15
ARS007ss_ds.merged.samereadgroup.cleaned	2026368	2026372		YPO_RS09885	4
ARS007ss_ds.merged.samereadgroup.cleaned	2026704	2026709		YPO_RS09885	5
ARS007ss_ds.merged.samereadgroup.cleaned	2026928	2026940		YPO_RS09885	12
ARS007ss_ds.merged.samereadgroup.cleaned	2027333	2027340		YPO_RS09885	7
ARS007ss_ds.merged.samereadgroup.cleaned	2029073	2029132		pip	59
ARS007ss_ds.merged.samereadgroup.cleaned	2031682	2031689		copD	7
ARS007ss_ds.merged.samereadgroup.cleaned	2031736	2031743		copD	7
ARS007ss_ds.merged.samereadgroup.cleaned	2031971	2031980		copD	9
ARS007ss_ds.merged.samereadgroup.cleaned	2033242	2033249		YPO_RS09920	7
ARS007ss_ds.merged.samereadgroup.cleaned	2033320	2033340		YPO_RS09920	20
ARS007ss_ds.merged.samereadgroup.cleaned	2033418	2033428		YPO_RS09920	10
ARS007ss_ds.merged.samereadgroup.cleaned	2033422	2033451		YPO_RS09925	29
ARS007ss_ds.merged.samereadgroup.cleaned	2034999	2035014		flhB	15
ARS007ss_ds.merged.samereadgroup.cleaned	2035045	2035058		flhB	13
ARS007ss_ds.merged.samereadgroup.cleaned	2035981	2036009		flhA	28
ARS007ss_ds.merged.samereadgroup.cleaned	2036593	2036600		flhA	7
ARS007ss_ds.merged.samereadgroup.cleaned	2036814	2036817		flhA	3
ARS007ss_ds.merged.samereadgroup.cleaned	2037398	2037424		flhA	26
ARS007ss_ds.merged.samereadgroup.cleaned	2037579	2037585		flhA	6
ARS007ss_ds.merged.samereadgroup.cleaned	2037762	2037793		YPO_RS09940	31
ARS007ss_ds.merged.samereadgroup.cleaned	2037968	2037979		YPO_RS09940	11
ARS007ss_ds.merged.samereadgroup.cleaned	2042754	2042760		YPO_RS09960	6
ARS007ss_ds.merged.samereadgroup.cleaned	2043057	2043062		flgM	5
ARS007ss_ds.merged.samereadgroup.cleaned	2043293	2043299		flgM	6
ARS007ss_ds.merged.samereadgroup.cleaned	2044717	2044722		flgB	5
ARS007ss_ds.merged.samereadgroup.cleaned	2044795	2044802		flgB	7
ARS007ss_ds.merged.samereadgroup.cleaned	2045619	2045642		flgD	23
ARS007ss_ds.merged.samereadgroup.cleaned	2045737	2045749		flgD	12
ARS007ss_ds.merged.samereadgroup.cleaned	2046130	2046137		YPO_RS09990	7
ARS007ss_ds.merged.samereadgroup.cleaned	2046854	2046857		YPO_RS09990	3
ARS007ss_ds.merged.samereadgroup.cleaned	2048149	2048154		flgG	5
ARS007ss_ds.merged.samereadgroup.cleaned	2048443	2048450		flgG	7
ARS007ss_ds.merged.samereadgroup.cleaned	2048572	2048576		flgG	4
ARS007ss_ds.merged.samereadgroup.cleaned	2049261	2049267		flgH	6
ARS007ss_ds.merged.samereadgroup.cleaned	2049786	2049806		YPO_RS10010	20
ARS007ss_ds.merged.samereadgroup.cleaned	2049950	2049954		YPO_RS10010	4
ARS007ss_ds.merged.samereadgroup.cleaned	2050019	2050024		YPO_RS10010	5
ARS007ss_ds.merged.samereadgroup.cleaned	2050362	2050367		YPO_RS10010	5
ARS007ss_ds.merged.samereadgroup.cleaned	2051091	2051114		flgJ	23
ARS007ss_ds.merged.samereadgroup.cleaned	2051380	2051385		flgJ	5
ARS007ss_ds.merged.samereadgroup.cleaned	2051470	2051473		flgJ	3
ARS007ss_ds.merged.samereadgroup.cleaned	2052494	2052495		flgK	1
ARS007ss_ds.merged.samereadgroup.cleaned	2052660	2052667		flgK	7
ARS007ss_ds.merged.samereadgroup.cleaned	2052933	2052937		flgK	4
ARS007ss_ds.merged.samereadgroup.cleaned	2053311	2053341		flgK	30
ARS007ss_ds.merged.samereadgroup.cleaned	2053466	2053467		flgK	1
ARS007ss_ds.merged.samereadgroup.cleaned	2053593	2053626		flgK	33
ARS007ss_ds.merged.samereadgroup.cleaned	2053825	2053832		flgK	7
ARS007ss_ds.merged.samereadgroup.cleaned	2054637	2054643		flgL	6
ARS007ss_ds.merged.samereadgroup.cleaned	2054748	2054767		flgL	19
ARS007ss_ds.merged.samereadgroup.cleaned	2054825	2054837		flgL	12
ARS007ss_ds.merged.samereadgroup.cleaned	2054925	2054941		flgL	16
ARS007ss_ds.merged.samereadgroup.cleaned	2055054	2055060		flgL	6
ARS007ss_ds.merged.samereadgroup.cleaned	2056585	2056592		YPO_RS10035	7
ARS007ss_ds.merged.samereadgroup.cleaned	2056655	2056663		YPO_RS10035	8
ARS007ss_ds.merged.samereadgroup.cleaned	2056813	2056816		YPO_RS10035	3
ARS007ss_ds.merged.samereadgroup.cleaned	2056935	2056960		YPO_RS10035	25
ARS007ss_ds.merged.samereadgroup.cleaned	2057107	2057109		YPO_RS10035	2
ARS007ss_ds.merged.samereadgroup.cleaned	2057288	2057289		YPO_RS10035	1
ARS007ss_ds.merged.samereadgroup.cleaned	2057854	2057859		YPO_RS10035	5
ARS007ss_ds.merged.samereadgroup.cleaned	2058553	2058558		YPO_RS10035	5
ARS007ss_ds.merged.samereadgroup.cleaned	2058843	2058860		YPO_RS10040	17
ARS007ss_ds.merged.samereadgroup.cleaned	2059030	2059044		YPO_RS10040	14
ARS007ss_ds.merged.samereadgroup.cleaned	2059467	2059469		YPO_RS10040	2
ARS007ss_ds.merged.samereadgroup.cleaned	2059581	2059604		YPO_RS10040	23
ARS007ss_ds.merged.samereadgroup.cleaned	2060263	2060272		YPO_RS10045	9
ARS007ss_ds.merged.samereadgroup.cleaned	2060619	2060623		YPO_RS10045	4
ARS007ss_ds.merged.samereadgroup.cleaned	2061169	2061171		YPO_RS10050	2
ARS007ss_ds.merged.samereadgroup.cleaned	2061473	2061476		YPO_RS10050	3
ARS007ss_ds.merged.samereadgroup.cleaned	2062097	2062098		YPO_RS10050	1
ARS007ss_ds.merged.samereadgroup.cleaned	2062313	2062335		YPO_RS10050	22
ARS007ss_ds.merged.samereadgroup.cleaned	2062850	2062851		YPO_RS10055	1
ARS007ss_ds.merged.samereadgroup.cleaned	2062921	2062943		YPO_RS10055	22
ARS007ss_ds.merged.samereadgroup.cleaned	2063387	2063389		YPO_RS10055	2
ARS007ss_ds.merged.samereadgroup.cleaned	2063897	2063906		YPO_RS10060	9
ARS007ss_ds.merged.samereadgroup.cleaned	2063961	2063969		YPO_RS10060	8
ARS007ss_ds.merged.samereadgroup.cleaned	2065167	2065191		YPO_RS10065	24
ARS007ss_ds.merged.samereadgroup.cleaned	2065348	2065351		YPO_RS10070	3
ARS007ss_ds.merged.samereadgroup.cleaned	2065802	2065818		fliR	16
ARS007ss_ds.merged.samereadgroup.cleaned	2066049	2066052		fliR	3
ARS007ss_ds.merged.samereadgroup.cleaned	2066492	2066536		fliQ	44
ARS007ss_ds.merged.samereadgroup.cleaned	2066584	2066585		fliQ	1
ARS007ss_ds.merged.samereadgroup.cleaned	2066622	2066623		fliQ	1
ARS007ss_ds.merged.samereadgroup.cleaned	2067755	2067783		fliO	28
ARS007ss_ds.merged.samereadgroup.cleaned	2067944	2067987		fliO	43
ARS007ss_ds.merged.samereadgroup.cleaned	2068210	2068217		fliN	7
ARS007ss_ds.merged.samereadgroup.cleaned	2068624	2068643		fliM	19
ARS007ss_ds.merged.samereadgroup.cleaned	2068982	2068985		fliM	3
ARS007ss_ds.merged.samereadgroup.cleaned	2069531	2069534		fliM	3
ARS007ss_ds.merged.samereadgroup.cleaned	2069931	2069964		fliL	33
ARS007ss_ds.merged.samereadgroup.cleaned	2070359	2070399		YPO_RS10110	40
ARS007ss_ds.merged.samereadgroup.cleaned	2070452	2070502		YPO_RS10110	50
ARS007ss_ds.merged.samereadgroup.cleaned	2070740	2070749		YPO_RS10110	9
ARS007ss_ds.merged.samereadgroup.cleaned	2070887	2070893		YPO_RS10110	6
ARS007ss_ds.merged.samereadgroup.cleaned	2070968	2070992		YPO_RS10110	24
ARS007ss_ds.merged.samereadgroup.cleaned	2071356	2071370		YPO_RS10110	14
ARS007ss_ds.merged.samereadgroup.cleaned	2072338	2072339		fliI	1
ARS007ss_ds.merged.samereadgroup.cleaned	2072509	2072517		fliI	8
ARS007ss_ds.merged.samereadgroup.cleaned	2073329	2073349		fliI	20
ARS007ss_ds.merged.samereadgroup.cleaned	2073665	2073667		fliH	2
ARS007ss_ds.merged.samereadgroup.cleaned	2074507	2074516		fliG	9
ARS007ss_ds.merged.samereadgroup.cleaned	2075198	2075215		fliG	17
ARS007ss_ds.merged.samereadgroup.cleaned	2075660	2075663		fliF	3
ARS007ss_ds.merged.samereadgroup.cleaned	2076806	2076818		fliF	12
ARS007ss_ds.merged.samereadgroup.cleaned	2077452	2077457		fliE	5
ARS007ss_ds.merged.samereadgroup.cleaned	2078529	2078533		YPO_RS10155	4
ARS007ss_ds.merged.samereadgroup.cleaned	2078585	2078590		YPO_RS10155	5
ARS007ss_ds.merged.samereadgroup.cleaned	2078708	2078710		YPO_RS10155	2
ARS007ss_ds.merged.samereadgroup.cleaned	2079323	2079332		YPO_RS10160	9
ARS007ss_ds.merged.samereadgroup.cleaned	2079525	2079529		YPO_RS10160	4
ARS007ss_ds.merged.samereadgroup.cleaned	2079703	2079716		YPO_RS10165	13
ARS007ss_ds.merged.samereadgroup.cleaned	2080753	2080754		YPO_RS10170	1
ARS007ss_ds.merged.samereadgroup.cleaned	2081556	2081584		YPO_RS10170	28
ARS007ss_ds.merged.samereadgroup.cleaned	2081651	2081697		YPO_RS10170	46
ARS007ss_ds.merged.samereadgroup.cleaned	2083548	2083552		YPO_RS10175	4
ARS007ss_ds.merged.samereadgroup.cleaned	2083586	2083594		YPO_RS10175	8
ARS007ss_ds.merged.samereadgroup.cleaned	2084254	2084258		fliT	4
ARS007ss_ds.merged.samereadgroup.cleaned	2084964	2084971		fliD	7
ARS007ss_ds.merged.samereadgroup.cleaned	2085116	2085137		fliD	21
ARS007ss_ds.merged.samereadgroup.cleaned	2085627	2085628		fliD	1
ARS007ss_ds.merged.samereadgroup.cleaned	2085710	2085737		fliD	27
ARS007ss_ds.merged.samereadgroup.cleaned	2085824	2085840		fliD	16
ARS007ss_ds.merged.samereadgroup.cleaned	2086018	2086028		fliD	10
ARS007ss_ds.merged.samereadgroup.cleaned	2086333	2086346		fliD	13
ARS007ss_ds.merged.samereadgroup.cleaned	2087192	2087209		YPO_RS10195	17
ARS007ss_ds.merged.samereadgroup.cleaned	2087296	2087308		YPO_RS10195	12
ARS007ss_ds.merged.samereadgroup.cleaned	2087612	2087628		YPO_RS10195	16
ARS007ss_ds.merged.samereadgroup.cleaned	2088323	2088351		YPO_RS10200	28
ARS007ss_ds.merged.samereadgroup.cleaned	2089062	2089092		fliZ	30
ARS007ss_ds.merged.samereadgroup.cleaned	2089285	2089298		fliZ	13
ARS007ss_ds.merged.samereadgroup.cleaned	2090050	2090061		YPO_RS10210	11
ARS007ss_ds.merged.samereadgroup.cleaned	2090316	2090324		YPO_RS10210	8
ARS007ss_ds.merged.samereadgroup.cleaned	2090517	2090526		YPO_RS10210	9
ARS007ss_ds.merged.samereadgroup.cleaned	2090713	2090730		YPO_RS10210	17
ARS007ss_ds.merged.samereadgroup.cleaned	2090847	2090851		YPO_RS10210	4
ARS007ss_ds.merged.samereadgroup.cleaned	2091017	2091021		tcyJ	4
ARS007ss_ds.merged.samereadgroup.cleaned	2091095	2091101		tcyJ	6
ARS007ss_ds.merged.samereadgroup.cleaned	2091997	2092009		tcyL	12
ARS007ss_ds.merged.samereadgroup.cleaned	2092423	2092432		tcyL	9
ARS007ss_ds.merged.samereadgroup.cleaned	2092552	2092558		yecC	6
ARS007ss_ds.merged.samereadgroup.cleaned	2093965	2093970		YPO_RS10235	5
ARS007ss_ds.merged.samereadgroup.cleaned	2094026	2094041		YPO_RS10235	15
ARS007ss_ds.merged.samereadgroup.cleaned	2094152	2094158		YPO_RS10235	6
ARS007ss_ds.merged.samereadgroup.cleaned	2094848	2094863		putA	15
ARS007ss_ds.merged.samereadgroup.cleaned	2095074	2095077		putA	3
ARS007ss_ds.merged.samereadgroup.cleaned	2095393	2095397		putA	4
ARS007ss_ds.merged.samereadgroup.cleaned	2096525	2096529		putA	4
ARS007ss_ds.merged.samereadgroup.cleaned	2096715	2096733		putA	18
ARS007ss_ds.merged.samereadgroup.cleaned	2096893	2096906		putA	13
ARS007ss_ds.merged.samereadgroup.cleaned	2097521	2097533		putA	12
ARS007ss_ds.merged.samereadgroup.cleaned	2098625	2098629		putA	4
ARS007ss_ds.merged.samereadgroup.cleaned	2098980	2098981		YPO_RS10245	1
ARS007ss_ds.merged.samereadgroup.cleaned	2099207	2099214		putP	7
ARS007ss_ds.merged.samereadgroup.cleaned	2099267	2099281		putP	14
ARS007ss_ds.merged.samereadgroup.cleaned	2099719	2099740		putP	21
ARS007ss_ds.merged.samereadgroup.cleaned	2100002	2100003		putP	1
ARS007ss_ds.merged.samereadgroup.cleaned	2100237	2100238		putP	1
ARS007ss_ds.merged.samereadgroup.cleaned	2101602	2101623		YPO_RS10255	21
ARS007ss_ds.merged.samereadgroup.cleaned	2101994	2101997		YPO_RS10260	3
ARS007ss_ds.merged.samereadgroup.cleaned	2102122	2102128		YPO_RS10260	6
ARS007ss_ds.merged.samereadgroup.cleaned	2102247	2102289		YPO_RS10260	42
ARS007ss_ds.merged.samereadgroup.cleaned	2102742	2102743		YPO_RS10260	1
ARS007ss_ds.merged.samereadgroup.cleaned	2103128	2103145		efeB	17
ARS007ss_ds.merged.samereadgroup.cleaned	2103397	2103421		efeB	24
ARS007ss_ds.merged.samereadgroup.cleaned	2104275	2104277		efeB	2
ARS007ss_ds.merged.samereadgroup.cleaned	2104729	2104763		wrbA	34
ARS007ss_ds.merged.samereadgroup.cleaned	2105494	2105518		YPO_RS10275	24
ARS007ss_ds.merged.samereadgroup.cleaned	2105711	2105722		YPO_RS10275	11
ARS007ss_ds.merged.samereadgroup.cleaned	2106011	2106024		YPO_RS10275	13
ARS007ss_ds.merged.samereadgroup.cleaned	2106204	2106207		YPO_RS10275	3
ARS007ss_ds.merged.samereadgroup.cleaned	2106569	2106582		YPO_RS10275	13
ARS007ss_ds.merged.samereadgroup.cleaned	2107418	2107430		cycA	12
ARS007ss_ds.merged.samereadgroup.cleaned	2107799	2107810		cycA	11
ARS007ss_ds.merged.samereadgroup.cleaned	2108025	2108035		cycA	10
ARS007ss_ds.merged.samereadgroup.cleaned	2109341	2109351		YPO_RS10290	10
ARS007ss_ds.merged.samereadgroup.cleaned	2109432	2109437		YPO_RS10290	5
ARS007ss_ds.merged.samereadgroup.cleaned	2109514	2109523		YPO_RS10290	9
ARS007ss_ds.merged.samereadgroup.cleaned	2110656	2110664		YPO_RS10300	8
ARS007ss_ds.merged.samereadgroup.cleaned	2114111	2114116		uvrC	5
ARS007ss_ds.merged.samereadgroup.cleaned	2114149	2114154		uvrC	5
ARS007ss_ds.merged.samereadgroup.cleaned	2117262	2117263		YPO_RS10350	1
ARS007ss_ds.merged.samereadgroup.cleaned	2117685	2117697		YPO_RS10355	12
ARS007ss_ds.merged.samereadgroup.cleaned	2117763	2117786		YPO_RS10355	23
ARS007ss_ds.merged.samereadgroup.cleaned	2118059	2118061		hcp	2
ARS007ss_ds.merged.samereadgroup.cleaned	2118332	2118347		hcp	15
ARS007ss_ds.merged.samereadgroup.cleaned	2119128	2119139		YPO_RS10365	11
ARS007ss_ds.merged.samereadgroup.cleaned	2119368	2119379		YPO_RS10365	11
ARS007ss_ds.merged.samereadgroup.cleaned	2122262	2122274		YPO_RS10390	12
ARS007ss_ds.merged.samereadgroup.cleaned	2122485	2122489		YPO_RS10390	4
ARS007ss_ds.merged.samereadgroup.cleaned	2123418	2123464		YPO_RS10405	46
ARS007ss_ds.merged.samereadgroup.cleaned	2123604	2123612		YPO_RS10405	8
ARS007ss_ds.merged.samereadgroup.cleaned	2126330	2126333		YPO_RS10415	3
ARS007ss_ds.merged.samereadgroup.cleaned	2126564	2126565		YPO_RS10420	1
ARS007ss_ds.merged.samereadgroup.cleaned	2126692	2126693		YPO_RS10420	1
ARS007ss_ds.merged.samereadgroup.cleaned	2126776	2126824		YPO_RS10420	48
ARS007ss_ds.merged.samereadgroup.cleaned	2126898	2126932		YPO_RS10420	34
ARS007ss_ds.merged.samereadgroup.cleaned	2128046	2128053		YPO_RS10430	7
ARS007ss_ds.merged.samereadgroup.cleaned	2128453	2128465		YPO_RS10430	12
ARS007ss_ds.merged.samereadgroup.cleaned	2129992	2130004		YPO_RS10435	12
ARS007ss_ds.merged.samereadgroup.cleaned	2130347	2130354		YPO_RS10435	7
ARS007ss_ds.merged.samereadgroup.cleaned	2130479	2130481		YPO_RS10440	2
ARS007ss_ds.merged.samereadgroup.cleaned	2130553	2130554		YPO_RS10440	1
ARS007ss_ds.merged.samereadgroup.cleaned	2130650	2130675		YPO_RS10440	25
ARS007ss_ds.merged.samereadgroup.cleaned	2130752	2130777		YPO_RS10440	25
ARS007ss_ds.merged.samereadgroup.cleaned	2131333	2131345		YPO_RS10440	12
ARS007ss_ds.merged.samereadgroup.cleaned	2131514	2131521		YPO_RS10440	7
ARS007ss_ds.merged.samereadgroup.cleaned	2131668	2131674		YPO_RS10440	6
ARS007ss_ds.merged.samereadgroup.cleaned	2132352	2132362		YPO_RS10445	10
ARS007ss_ds.merged.samereadgroup.cleaned	2132844	2132848		YPO_RS10450	4
ARS007ss_ds.merged.samereadgroup.cleaned	2133097	2133107		YPO_RS10450	10
ARS007ss_ds.merged.samereadgroup.cleaned	2133371	2133384		YPO_RS10450	13
ARS007ss_ds.merged.samereadgroup.cleaned	2134071	2134116		YPO_RS10455	45
ARS007ss_ds.merged.samereadgroup.cleaned	2134339	2134343		YPO_RS10455	4
ARS007ss_ds.merged.samereadgroup.cleaned	2134807	2134809		YPO_RS10465	2
ARS007ss_ds.merged.samereadgroup.cleaned	2135072	2135087		YPO_RS10470	15
ARS007ss_ds.merged.samereadgroup.cleaned	2137528	2137532		YPO_RS10485	4
ARS007ss_ds.merged.samereadgroup.cleaned	2138049	2138065		YPO_RS10495	16
ARS007ss_ds.merged.samereadgroup.cleaned	2138223	2138242		YPO_RS10495	19
ARS007ss_ds.merged.samereadgroup.cleaned	2138512	2138526		YPO_RS10495	14
ARS007ss_ds.merged.samereadgroup.cleaned	2138898	2138900		YPO_RS10500	2
ARS007ss_ds.merged.samereadgroup.cleaned	2139281	2139282		YPO_RS10505	1
ARS007ss_ds.merged.samereadgroup.cleaned	2141002	2141010		fyuA	8
ARS007ss_ds.merged.samereadgroup.cleaned	2142096	2142100		fyuA	4
ARS007ss_ds.merged.samereadgroup.cleaned	2143637	2143643		ybtE	6
ARS007ss_ds.merged.samereadgroup.cleaned	2144522	2144528		ybtE	6
ARS007ss_ds.merged.samereadgroup.cleaned	2145563	2145565		ybtU	2
ARS007ss_ds.merged.samereadgroup.cleaned	2145647	2145648		ybtU	1
ARS007ss_ds.merged.samereadgroup.cleaned	2145790	2145793		ybtU	3
ARS007ss_ds.merged.samereadgroup.cleaned	2146179	2146189		ybtU	10
ARS007ss_ds.merged.samereadgroup.cleaned	2146984	2147000		irp1	16
ARS007ss_ds.merged.samereadgroup.cleaned	2147257	2147278		irp1	21
ARS007ss_ds.merged.samereadgroup.cleaned	2147343	2147347		irp1	4
ARS007ss_ds.merged.samereadgroup.cleaned	2148034	2148039		irp1	5
ARS007ss_ds.merged.samereadgroup.cleaned	2149175	2149178		irp1	3
ARS007ss_ds.merged.samereadgroup.cleaned	2149994	2149996		irp1	2
ARS007ss_ds.merged.samereadgroup.cleaned	2150178	2150189		irp1	11
ARS007ss_ds.merged.samereadgroup.cleaned	2150308	2150310		irp1	2
ARS007ss_ds.merged.samereadgroup.cleaned	2150848	2150901		irp1	53
ARS007ss_ds.merged.samereadgroup.cleaned	2151512	2151519		irp1	7
ARS007ss_ds.merged.samereadgroup.cleaned	2151955	2151986		irp1	31
ARS007ss_ds.merged.samereadgroup.cleaned	2152397	2152407		irp1	10
ARS007ss_ds.merged.samereadgroup.cleaned	2153380	2153385		irp1	5
ARS007ss_ds.merged.samereadgroup.cleaned	2153500	2153505		irp1	5
ARS007ss_ds.merged.samereadgroup.cleaned	2154297	2154302		irp1	5
ARS007ss_ds.merged.samereadgroup.cleaned	2155180	2155199		irp1	19
ARS007ss_ds.merged.samereadgroup.cleaned	2157042	2157057		irp2	15
ARS007ss_ds.merged.samereadgroup.cleaned	2157214	2157234		irp2	20
ARS007ss_ds.merged.samereadgroup.cleaned	2157354	2157367		irp2	13
ARS007ss_ds.merged.samereadgroup.cleaned	2157424	2157439		irp2	15
ARS007ss_ds.merged.samereadgroup.cleaned	2157822	2157838		irp2	16
ARS007ss_ds.merged.samereadgroup.cleaned	2158270	2158276		irp2	6
ARS007ss_ds.merged.samereadgroup.cleaned	2159471	2159481		irp2	10
ARS007ss_ds.merged.samereadgroup.cleaned	2159914	2159916		irp2	2
ARS007ss_ds.merged.samereadgroup.cleaned	2159992	2160031		irp2	39
ARS007ss_ds.merged.samereadgroup.cleaned	2160789	2160802		irp2	13
ARS007ss_ds.merged.samereadgroup.cleaned	2160865	2160868		irp2	3
ARS007ss_ds.merged.samereadgroup.cleaned	2163592	2163593		ybtP	1
ARS007ss_ds.merged.samereadgroup.cleaned	2164609	2164611		ybtP	2
ARS007ss_ds.merged.samereadgroup.cleaned	2164653	2164660		ybtP	7
ARS007ss_ds.merged.samereadgroup.cleaned	2165489	2165546		ybtQ	57
ARS007ss_ds.merged.samereadgroup.cleaned	2165655	2165659		ybtQ	4
ARS007ss_ds.merged.samereadgroup.cleaned	2165913	2165915		ybtQ	2
ARS007ss_ds.merged.samereadgroup.cleaned	2166066	2166070		ybtQ	4
ARS007ss_ds.merged.samereadgroup.cleaned	2166910	2166931		ybtQ	21
ARS007ss_ds.merged.samereadgroup.cleaned	2167171	2167180		ybtX	9
ARS007ss_ds.merged.samereadgroup.cleaned	2167364	2167374		ybtX	10
ARS007ss_ds.merged.samereadgroup.cleaned	2167656	2167677		ybtX	21
ARS007ss_ds.merged.samereadgroup.cleaned	2168486	2168487		ybtS	1
ARS007ss_ds.merged.samereadgroup.cleaned	2168637	2168640		ybtS	3
ARS007ss_ds.merged.samereadgroup.cleaned	2169078	2169080		ybtS	2
ARS007ss_ds.merged.samereadgroup.cleaned	2169868	2169898		YPO_RS10570	30
ARS007ss_ds.merged.samereadgroup.cleaned	2170514	2170534		YPO_RS10570	20
ARS007ss_ds.merged.samereadgroup.cleaned	2170683	2170724		YPO_RS10570	41
ARS007ss_ds.merged.samereadgroup.cleaned	2171010	2171019		YPO_RS10570	9
ARS007ss_ds.merged.samereadgroup.cleaned	2171936	2171955		YPO_RS10580	19
ARS007ss_ds.merged.samereadgroup.cleaned	2172656	2172662		YPO_RS10585	6
ARS007ss_ds.merged.samereadgroup.cleaned	2172769	2172812		YPO_RS10585	43
ARS007ss_ds.merged.samereadgroup.cleaned	2172922	2172934		YPO_RS10585	12
ARS007ss_ds.merged.samereadgroup.cleaned	2172981	2172984		YPO_RS10585	3
ARS007ss_ds.merged.samereadgroup.cleaned	2173093	2173116		YPO_RS10585	23
ARS007ss_ds.merged.samereadgroup.cleaned	2173366	2173383		YPO_RS10585	17
ARS007ss_ds.merged.samereadgroup.cleaned	2173560	2173585		YPO_RS10585	25
ARS007ss_ds.merged.samereadgroup.cleaned	2174603	2174604		YPO_RS10590	1
ARS007ss_ds.merged.samereadgroup.cleaned	2175215	2175224		YPO_RS10590	9
ARS007ss_ds.merged.samereadgroup.cleaned	2175650	2175653		YPO_RS10590	3
ARS007ss_ds.merged.samereadgroup.cleaned	2175701	2175703		YPO_RS10590	2
ARS007ss_ds.merged.samereadgroup.cleaned	2176496	2176500		YPO_RS10595	4
ARS007ss_ds.merged.samereadgroup.cleaned	2176651	2176673		YPO_RS10595	22
ARS007ss_ds.merged.samereadgroup.cleaned	2176891	2176894		YPO_RS10595	3
ARS007ss_ds.merged.samereadgroup.cleaned	2177673	2177674		YPO_RS10600	1
ARS007ss_ds.merged.samereadgroup.cleaned	2179343	2179374		YPO_RS10605	31
ARS007ss_ds.merged.samereadgroup.cleaned	2179528	2179532		YPO_RS10605	4
ARS007ss_ds.merged.samereadgroup.cleaned	2179950	2180063		YPO_RS10605	113
ARS007ss_ds.merged.samereadgroup.cleaned	2180498	2180518		YPO_RS10605	20
ARS007ss_ds.merged.samereadgroup.cleaned	2180803	2180807		YPO_RS10610	4
ARS007ss_ds.merged.samereadgroup.cleaned	2181867	2181882		YPO_RS10610	15
ARS007ss_ds.merged.samereadgroup.cleaned	2182012	2182027		YPO_RS10615	15
ARS007ss_ds.merged.samereadgroup.cleaned	2182504	2182510		YPO_RS10615	6
ARS007ss_ds.merged.samereadgroup.cleaned	2183668	2183716		YPO_RS10620	48
ARS007ss_ds.merged.samereadgroup.cleaned	2183749	2183758		YPO_RS10620	9
ARS007ss_ds.merged.samereadgroup.cleaned	2184155	2184177		YPO_RS10620	22
ARS007ss_ds.merged.samereadgroup.cleaned	2184488	2184505		YPO_RS10620	17
ARS007ss_ds.merged.samereadgroup.cleaned	2184777	2184789		YPO_RS10620	12
ARS007ss_ds.merged.samereadgroup.cleaned	2185407	2185427		YPO_RS10630	20
ARS007ss_ds.merged.samereadgroup.cleaned	2185547	2185562		YPO_RS10630	15
ARS007ss_ds.merged.samereadgroup.cleaned	2186034	2186049		YPO_RS10630	15
ARS007ss_ds.merged.samereadgroup.cleaned	2187160	2187163		YPO_RS10635	3
ARS007ss_ds.merged.samereadgroup.cleaned	2187795	2187817		YPO_RS10645	22
ARS007ss_ds.merged.samereadgroup.cleaned	2187901	2187935		YPO_RS10645	34
ARS007ss_ds.merged.samereadgroup.cleaned	2188011	2188023		YPO_RS10645	12
ARS007ss_ds.merged.samereadgroup.cleaned	2189101	2189109		YPO_RS10650	8
ARS007ss_ds.merged.samereadgroup.cleaned	2189594	2189600		YPO_RS10650	6
ARS007ss_ds.merged.samereadgroup.cleaned	2190118	2190141		YPO_RS10655	23
ARS007ss_ds.merged.samereadgroup.cleaned	2190610	2190625		YPO_RS10655	15
ARS007ss_ds.merged.samereadgroup.cleaned	2191511	2191529		YPO_RS10660	18
ARS007ss_ds.merged.samereadgroup.cleaned	2191783	2191799		YPO_RS10660	16
ARS007ss_ds.merged.samereadgroup.cleaned	2192469	2192472		nqrE	3
ARS007ss_ds.merged.samereadgroup.cleaned	2192520	2192573		nqrE	53
ARS007ss_ds.merged.samereadgroup.cleaned	2193219	2193233		YPO_RS10670	14
ARS007ss_ds.merged.samereadgroup.cleaned	2194587	2194597		ansP	10
ARS007ss_ds.merged.samereadgroup.cleaned	2195274	2195279		ansP	5
ARS007ss_ds.merged.samereadgroup.cleaned	2195852	2195862		ansP	10
ARS007ss_ds.merged.samereadgroup.cleaned	2196676	2196677		YPO_RS10680	1
ARS007ss_ds.merged.samereadgroup.cleaned	2196849	2196852		YPO_RS10680	3
ARS007ss_ds.merged.samereadgroup.cleaned	2196914	2196920		YPO_RS10680	6
ARS007ss_ds.merged.samereadgroup.cleaned	2198062	2198074		YPO_RS10685	12
ARS007ss_ds.merged.samereadgroup.cleaned	2198174	2198176		YPO_RS10685	2
ARS007ss_ds.merged.samereadgroup.cleaned	2199273	2199289		glsA	16
ARS007ss_ds.merged.samereadgroup.cleaned	2199952	2199957		YPO_RS10695	5
ARS007ss_ds.merged.samereadgroup.cleaned	2200110	2200130		YPO_RS10695	20
ARS007ss_ds.merged.samereadgroup.cleaned	2201071	2201072		YPO_RS10695	1
ARS007ss_ds.merged.samereadgroup.cleaned	2203103	2203104		YPO_RS10700	1
ARS007ss_ds.merged.samereadgroup.cleaned	2203780	2203782		YPO_RS10700	2
ARS007ss_ds.merged.samereadgroup.cleaned	2204292	2204295		YPO_RS10705	3
ARS007ss_ds.merged.samereadgroup.cleaned	2204387	2204401		YPO_RS10705	14
ARS007ss_ds.merged.samereadgroup.cleaned	2205254	2205258		YPO_RS10710	4
ARS007ss_ds.merged.samereadgroup.cleaned	2205820	2205828		YPO_RS10710	8
ARS007ss_ds.merged.samereadgroup.cleaned	2206051	2206052		YPO_RS10710	1
ARS007ss_ds.merged.samereadgroup.cleaned	2206511	2206513		YPO_RS10715	2
ARS007ss_ds.merged.samereadgroup.cleaned	2206838	2206841		YPO_RS10715	3
ARS007ss_ds.merged.samereadgroup.cleaned	2207329	2207339		YPO_RS10715	10
ARS007ss_ds.merged.samereadgroup.cleaned	2207441	2207450		YPO_RS10715	9
ARS007ss_ds.merged.samereadgroup.cleaned	2207627	2207630		YPO_RS10715	3
ARS007ss_ds.merged.samereadgroup.cleaned	2208036	2208042		YPO_RS10720	6
ARS007ss_ds.merged.samereadgroup.cleaned	2208147	2208151		YPO_RS10720	4
ARS007ss_ds.merged.samereadgroup.cleaned	2208395	2208399		YPO_RS10720	4
ARS007ss_ds.merged.samereadgroup.cleaned	2208450	2208465		YPO_RS10720	15
ARS007ss_ds.merged.samereadgroup.cleaned	2208627	2208632		YPO_RS10720	5
ARS007ss_ds.merged.samereadgroup.cleaned	2208668	2208685		YPO_RS10720	17
ARS007ss_ds.merged.samereadgroup.cleaned	2208903	2208914		YPO_RS10725	11
ARS007ss_ds.merged.samereadgroup.cleaned	2209136	2209143		YPO_RS10725	7
ARS007ss_ds.merged.samereadgroup.cleaned	2209283	2209290		YPO_RS10725	7
ARS007ss_ds.merged.samereadgroup.cleaned	2209472	2209513		YPO_RS10725	41
ARS007ss_ds.merged.samereadgroup.cleaned	2209511	2209513		YPO_RS10730	2
ARS007ss_ds.merged.samereadgroup.cleaned	2209888	2209892		YPO_RS10730	4
ARS007ss_ds.merged.samereadgroup.cleaned	2210022	2210044		YPO_RS10735	22
ARS007ss_ds.merged.samereadgroup.cleaned	2210074	2210075		YPO_RS10735	1
ARS007ss_ds.merged.samereadgroup.cleaned	2211677	2211679		YPO_RS10745	2
ARS007ss_ds.merged.samereadgroup.cleaned	2212421	2212431		YPO_RS10745	10
ARS007ss_ds.merged.samereadgroup.cleaned	2212527	2212531		YPO_RS10745	4
ARS007ss_ds.merged.samereadgroup.cleaned	2214316	2214320		pgaA	4
ARS007ss_ds.merged.samereadgroup.cleaned	2214382	2214393		pgaA	11
ARS007ss_ds.merged.samereadgroup.cleaned	2215087	2215105		pgaA	18
ARS007ss_ds.merged.samereadgroup.cleaned	2215946	2215950		pgaB	4
ARS007ss_ds.merged.samereadgroup.cleaned	2216185	2216209		pgaB	24
ARS007ss_ds.merged.samereadgroup.cleaned	2216457	2216462		pgaB	5
ARS007ss_ds.merged.samereadgroup.cleaned	2216621	2216622		pgaB	1
ARS007ss_ds.merged.samereadgroup.cleaned	2216703	2216716		pgaB	13
ARS007ss_ds.merged.samereadgroup.cleaned	2217113	2217115		pgaB	2
ARS007ss_ds.merged.samereadgroup.cleaned	2217411	2217451		pgaB	40
ARS007ss_ds.merged.samereadgroup.cleaned	2217863	2217891		pgaB	28
ARS007ss_ds.merged.samereadgroup.cleaned	2218056	2218107		YPO_RS10760	51
ARS007ss_ds.merged.samereadgroup.cleaned	2220500	2220504		YPO_RS10770	4
ARS007ss_ds.merged.samereadgroup.cleaned	2222597	2222601		chaA	4
ARS007ss_ds.merged.samereadgroup.cleaned	2223063	2223064		chaA	1
ARS007ss_ds.merged.samereadgroup.cleaned	2223532	2223534		chaA	2
ARS007ss_ds.merged.samereadgroup.cleaned	2224523	2224562		narX	39
ARS007ss_ds.merged.samereadgroup.cleaned	2224948	2224949		narX	1
ARS007ss_ds.merged.samereadgroup.cleaned	2225953	2225965		narX	12
ARS007ss_ds.merged.samereadgroup.cleaned	2226531	2226569		YPO_RS10800	38
ARS007ss_ds.merged.samereadgroup.cleaned	2226607	2226609		YPO_RS10800	2
ARS007ss_ds.merged.samereadgroup.cleaned	2227299	2227306		YPO_RS10800	7
ARS007ss_ds.merged.samereadgroup.cleaned	2227422	2227423		YPO_RS10800	1
ARS007ss_ds.merged.samereadgroup.cleaned	2228468	2228481		YPO_RS10805	13
ARS007ss_ds.merged.samereadgroup.cleaned	2228536	2228577		YPO_RS10805	41
ARS007ss_ds.merged.samereadgroup.cleaned	2229745	2229752		astA	7
ARS007ss_ds.merged.samereadgroup.cleaned	2230250	2230257		astA	7
ARS007ss_ds.merged.samereadgroup.cleaned	2230514	2230516		astA	2
ARS007ss_ds.merged.samereadgroup.cleaned	2230655	2230656		astA	1
ARS007ss_ds.merged.samereadgroup.cleaned	2231127	2231161		astD	34
ARS007ss_ds.merged.samereadgroup.cleaned	2231279	2231285		astD	6
ARS007ss_ds.merged.samereadgroup.cleaned	2231781	2231788		astD	7
ARS007ss_ds.merged.samereadgroup.cleaned	2232803	2232804		astB	1
ARS007ss_ds.merged.samereadgroup.cleaned	2233259	2233269		astB	10
ARS007ss_ds.merged.samereadgroup.cleaned	2234003	2234005		astE	2
ARS007ss_ds.merged.samereadgroup.cleaned	2234148	2234152		astE	4
ARS007ss_ds.merged.samereadgroup.cleaned	2234348	2234351		astE	3
ARS007ss_ds.merged.samereadgroup.cleaned	2234462	2234472		astE	10
ARS007ss_ds.merged.samereadgroup.cleaned	2234552	2234553		astE	1
ARS007ss_ds.merged.samereadgroup.cleaned	2237356	2237375		YPO_RS10835	19
ARS007ss_ds.merged.samereadgroup.cleaned	2238920	2238930		hutG	10
ARS007ss_ds.merged.samereadgroup.cleaned	2239553	2239556		YPO_RS10855	3
ARS007ss_ds.merged.samereadgroup.cleaned	2239874	2239896		YPO_RS10855	22
ARS007ss_ds.merged.samereadgroup.cleaned	2240262	2240264		YPO_RS10855	2
ARS007ss_ds.merged.samereadgroup.cleaned	2240961	2240962		hutC	1
ARS007ss_ds.merged.samereadgroup.cleaned	2241543	2241556		hutC	13
ARS007ss_ds.merged.samereadgroup.cleaned	2241963	2241975		YPO_RS10865	12
ARS007ss_ds.merged.samereadgroup.cleaned	2242627	2242653		YPO_RS10865	26
ARS007ss_ds.merged.samereadgroup.cleaned	2243524	2243541		YPO_RS10870	17
ARS007ss_ds.merged.samereadgroup.cleaned	2244198	2244205		YPO_RS10875	7
ARS007ss_ds.merged.samereadgroup.cleaned	2244459	2244465		YPO_RS10875	6
ARS007ss_ds.merged.samereadgroup.cleaned	2244524	2244535		YPO_RS10875	11
ARS007ss_ds.merged.samereadgroup.cleaned	2244948	2244976		YPO_RS10875	28
ARS007ss_ds.merged.samereadgroup.cleaned	2245014	2245018		YPO_RS10875	4
ARS007ss_ds.merged.samereadgroup.cleaned	2247623	2247625		YPO_RS10885	2
ARS007ss_ds.merged.samereadgroup.cleaned	2247855	2247859		YPO_RS10885	4
ARS007ss_ds.merged.samereadgroup.cleaned	2248057	2248061		YPO_RS10885	4
ARS007ss_ds.merged.samereadgroup.cleaned	2248278	2248325		YPO_RS10885	47
ARS007ss_ds.merged.samereadgroup.cleaned	2248632	2248638		YPO_RS10885	6
ARS007ss_ds.merged.samereadgroup.cleaned	2248632	2248638		YPO_RS10890	6
ARS007ss_ds.merged.samereadgroup.cleaned	2249178	2249202		YPO_RS10890	24
ARS007ss_ds.merged.samereadgroup.cleaned	2249340	2249342		YPO_RS10890	2
ARS007ss_ds.merged.samereadgroup.cleaned	2249671	2249673		YPO_RS10895	2
ARS007ss_ds.merged.samereadgroup.cleaned	2249765	2249772		YPO_RS10895	7
ARS007ss_ds.merged.samereadgroup.cleaned	2250206	2250216		YPO_RS10895	10
ARS007ss_ds.merged.samereadgroup.cleaned	2250270	2250271		YPO_RS10895	1
ARS007ss_ds.merged.samereadgroup.cleaned	2251089	2251096		YPO_RS10900	7
ARS007ss_ds.merged.samereadgroup.cleaned	2251214	2251220		YPO_RS10900	6
ARS007ss_ds.merged.samereadgroup.cleaned	2251281	2251284		YPO_RS10900	3
ARS007ss_ds.merged.samereadgroup.cleaned	2251795	2251796		YPO_RS10900	1
ARS007ss_ds.merged.samereadgroup.cleaned	2251898	2251908		YPO_RS10905	10
ARS007ss_ds.merged.samereadgroup.cleaned	2252172	2252175		YPO_RS10905	3
ARS007ss_ds.merged.samereadgroup.cleaned	2252370	2252387		YPO_RS10905	17
ARS007ss_ds.merged.samereadgroup.cleaned	2252564	2252566		YPO_RS10905	2
ARS007ss_ds.merged.samereadgroup.cleaned	2252816	2252825		YPO_RS10905	9
ARS007ss_ds.merged.samereadgroup.cleaned	2252967	2252971		YPO_RS10905	4
ARS007ss_ds.merged.samereadgroup.cleaned	2252968	2252989		YPO_RS10910	21
ARS007ss_ds.merged.samereadgroup.cleaned	2253353	2253362		YPO_RS10910	9
ARS007ss_ds.merged.samereadgroup.cleaned	2253744	2253749		YPO_RS10915	5
ARS007ss_ds.merged.samereadgroup.cleaned	2253980	2253982		YPO_RS10915	2
ARS007ss_ds.merged.samereadgroup.cleaned	2254268	2254277		YPO_RS10915	9
ARS007ss_ds.merged.samereadgroup.cleaned	2254979	2254982		YPO_RS10920	3
ARS007ss_ds.merged.samereadgroup.cleaned	2255280	2255292		YPO_RS10920	12
ARS007ss_ds.merged.samereadgroup.cleaned	2255853	2255858		YPO_RS10925	5
ARS007ss_ds.merged.samereadgroup.cleaned	2256129	2256136		YPO_RS10925	7
ARS007ss_ds.merged.samereadgroup.cleaned	2256189	2256197		YPO_RS10925	8
ARS007ss_ds.merged.samereadgroup.cleaned	2256624	2256638		YPO_RS10925	14
ARS007ss_ds.merged.samereadgroup.cleaned	2257088	2257095		YPO_RS10925	7
ARS007ss_ds.merged.samereadgroup.cleaned	2258990	2259001		YPO_RS10935	11
ARS007ss_ds.merged.samereadgroup.cleaned	2259035	2259084		YPO_RS10935	49
ARS007ss_ds.merged.samereadgroup.cleaned	2259210	2259250		YPO_RS10935	40
ARS007ss_ds.merged.samereadgroup.cleaned	2259705	2259710		YPO_RS10935	5
ARS007ss_ds.merged.samereadgroup.cleaned	2259753	2259761		YPO_RS10935	8
ARS007ss_ds.merged.samereadgroup.cleaned	2259843	2259854		YPO_RS10935	11
ARS007ss_ds.merged.samereadgroup.cleaned	2260120	2260133		YPO_RS10935	13
ARS007ss_ds.merged.samereadgroup.cleaned	2260235	2260236		YPO_RS10935	1
ARS007ss_ds.merged.samereadgroup.cleaned	2260709	2260735		YPO_RS10935	26
ARS007ss_ds.merged.samereadgroup.cleaned	2262001	2262003		YPO_RS10940	2
ARS007ss_ds.merged.samereadgroup.cleaned	2263341	2263360		YPO_RS10940	19
ARS007ss_ds.merged.samereadgroup.cleaned	2263465	2263475		YPO_RS10940	10
ARS007ss_ds.merged.samereadgroup.cleaned	2263952	2264004		YPO_RS10945	52
ARS007ss_ds.merged.samereadgroup.cleaned	2264591	2264596		YPO_RS10950	5
ARS007ss_ds.merged.samereadgroup.cleaned	2264916	2264942		YPO_RS10950	26
ARS007ss_ds.merged.samereadgroup.cleaned	2265556	2265584		YPO_RS10955	28
ARS007ss_ds.merged.samereadgroup.cleaned	2265710	2265712		YPO_RS10955	2
ARS007ss_ds.merged.samereadgroup.cleaned	2265877	2265887		YPO_RS10955	10
ARS007ss_ds.merged.samereadgroup.cleaned	2266292	2266333		YPO_RS10965	41
ARS007ss_ds.merged.samereadgroup.cleaned	2266601	2266606		YPO_RS10965	5
ARS007ss_ds.merged.samereadgroup.cleaned	2266693	2266696		YPO_RS10965	3
ARS007ss_ds.merged.samereadgroup.cleaned	2267584	2267610		YPO_RS10970	26
ARS007ss_ds.merged.samereadgroup.cleaned	2268679	2268697		YPO_RS10975	18
ARS007ss_ds.merged.samereadgroup.cleaned	2270365	2270367		YPO_RS10980	2
ARS007ss_ds.merged.samereadgroup.cleaned	2270408	2270413		YPO_RS10980	5
ARS007ss_ds.merged.samereadgroup.cleaned	2271528	2271545		YPO_RS10985	17
ARS007ss_ds.merged.samereadgroup.cleaned	2271742	2271749		YPO_RS10990	7
ARS007ss_ds.merged.samereadgroup.cleaned	2271847	2271849		YPO_RS10990	2
ARS007ss_ds.merged.samereadgroup.cleaned	2271919	2271958		YPO_RS10990	39
ARS007ss_ds.merged.samereadgroup.cleaned	2272374	2272381		YPO_RS10995	7
ARS007ss_ds.merged.samereadgroup.cleaned	2272791	2272814		YPO_RS10995	23
ARS007ss_ds.merged.samereadgroup.cleaned	2273595	2273598		YPO_RS10995	3
ARS007ss_ds.merged.samereadgroup.cleaned	2274367	2274370		YPO_RS11000	3
ARS007ss_ds.merged.samereadgroup.cleaned	2275021	2275028		YPO_RS11005	7
ARS007ss_ds.merged.samereadgroup.cleaned	2277029	2277042		YPO_RS11015	13
ARS007ss_ds.merged.samereadgroup.cleaned	2277235	2277300		YPO_RS11015	65
ARS007ss_ds.merged.samereadgroup.cleaned	2277767	2277770		YPO_RS11020	3
ARS007ss_ds.merged.samereadgroup.cleaned	2277802	2277820		YPO_RS11020	18
ARS007ss_ds.merged.samereadgroup.cleaned	2278204	2278205		YPO_RS11020	1
ARS007ss_ds.merged.samereadgroup.cleaned	2278256	2278257		YPO_RS11020	1
ARS007ss_ds.merged.samereadgroup.cleaned	2279097	2279099		YPO_RS11025	2
ARS007ss_ds.merged.samereadgroup.cleaned	2279158	2279162		YPO_RS11025	4
ARS007ss_ds.merged.samereadgroup.cleaned	2279230	2279239		YPO_RS11025	9
ARS007ss_ds.merged.samereadgroup.cleaned	2279420	2279426		YPO_RS11025	6
ARS007ss_ds.merged.samereadgroup.cleaned	2279702	2279707		YPO_RS11025	5
ARS007ss_ds.merged.samereadgroup.cleaned	2280264	2280271		YPO_RS11030	7
ARS007ss_ds.merged.samereadgroup.cleaned	2280340	2280348		YPO_RS11030	8
ARS007ss_ds.merged.samereadgroup.cleaned	2280624	2280628		YPO_RS11035	4
ARS007ss_ds.merged.samereadgroup.cleaned	2280776	2280796		YPO_RS11035	20
ARS007ss_ds.merged.samereadgroup.cleaned	2283599	2283608		pth	9
ARS007ss_ds.merged.samereadgroup.cleaned	2286459	2286484		ispE	25
ARS007ss_ds.merged.samereadgroup.cleaned	2286568	2286571		ispE	3
ARS007ss_ds.merged.samereadgroup.cleaned	2286629	2286630		ispE	1
ARS007ss_ds.merged.samereadgroup.cleaned	2286806	2286813		ispE	7
ARS007ss_ds.merged.samereadgroup.cleaned	2287076	2287086		lolB	10
ARS007ss_ds.merged.samereadgroup.cleaned	2287123	2287127		lolB	4
ARS007ss_ds.merged.samereadgroup.cleaned	2287180	2287197		lolB	17
ARS007ss_ds.merged.samereadgroup.cleaned	2291267	2291272		YPO_RS11090	5
ARS007ss_ds.merged.samereadgroup.cleaned	2291375	2291377		YPO_RS11090	2
ARS007ss_ds.merged.samereadgroup.cleaned	2291660	2291664		YPO_RS11095	4
ARS007ss_ds.merged.samereadgroup.cleaned	2294432	2294437		YPO_RS11110	5
ARS007ss_ds.merged.samereadgroup.cleaned	2294639	2294657		YPO_RS11110	18
ARS007ss_ds.merged.samereadgroup.cleaned	2294853	2294854		YPO_RS11110	1
ARS007ss_ds.merged.samereadgroup.cleaned	2299193	2299206		YPO_RS11135	13
ARS007ss_ds.merged.samereadgroup.cleaned	2299556	2299566		YPO_RS11135	10
ARS007ss_ds.merged.samereadgroup.cleaned	2299782	2299816		YPO_RS11135	34
ARS007ss_ds.merged.samereadgroup.cleaned	2299958	2300030		YPO_RS11135	72
ARS007ss_ds.merged.samereadgroup.cleaned	2300800	2300809		YPO_RS11140	9
ARS007ss_ds.merged.samereadgroup.cleaned	2300855	2300864		YPO_RS11140	9
ARS007ss_ds.merged.samereadgroup.cleaned	2301718	2301726		YPO_RS11145	8
ARS007ss_ds.merged.samereadgroup.cleaned	2301806	2301817		YPO_RS11145	11
ARS007ss_ds.merged.samereadgroup.cleaned	2301995	2302005		YPO_RS11145	10
ARS007ss_ds.merged.samereadgroup.cleaned	2302515	2302518		YPO_RS11150	3
ARS007ss_ds.merged.samereadgroup.cleaned	2303079	2303084		YPO_RS11150	5
ARS007ss_ds.merged.samereadgroup.cleaned	2303371	2303376		YPO_RS11155	5
ARS007ss_ds.merged.samereadgroup.cleaned	2303895	2303908		YPO_RS11155	13
ARS007ss_ds.merged.samereadgroup.cleaned	2305121	2305125		YPO_RS11170	4
ARS007ss_ds.merged.samereadgroup.cleaned	2305287	2305290		YPO_RS11170	3
ARS007ss_ds.merged.samereadgroup.cleaned	2305828	2305832		YPO_RS11170	4
ARS007ss_ds.merged.samereadgroup.cleaned	2306258	2306271		YPO_RS11175	13
ARS007ss_ds.merged.samereadgroup.cleaned	2306883	2306911		YPO_RS11175	28
ARS007ss_ds.merged.samereadgroup.cleaned	2307010	2307014		YPO_RS11175	4
ARS007ss_ds.merged.samereadgroup.cleaned	2307836	2307838		YPO_RS11185	2
ARS007ss_ds.merged.samereadgroup.cleaned	2308435	2308441		YPO_RS11185	6
ARS007ss_ds.merged.samereadgroup.cleaned	2308907	2308918		YPO_RS11190	11
ARS007ss_ds.merged.samereadgroup.cleaned	2310003	2310009		YPO_RS11195	6
ARS007ss_ds.merged.samereadgroup.cleaned	2310632	2310639		mdtH	7
ARS007ss_ds.merged.samereadgroup.cleaned	2311304	2311324		mdtH	20
ARS007ss_ds.merged.samereadgroup.cleaned	2311460	2311463		mdtH	3
ARS007ss_ds.merged.samereadgroup.cleaned	2311957	2311970		rimJ	13
ARS007ss_ds.merged.samereadgroup.cleaned	2312478	2312483		rimJ	5
ARS007ss_ds.merged.samereadgroup.cleaned	2313774	2313784		YPO_RS11210	10
ARS007ss_ds.merged.samereadgroup.cleaned	2313833	2313836		YPO_RS11210	3
ARS007ss_ds.merged.samereadgroup.cleaned	2314878	2314882		murJ	4
ARS007ss_ds.merged.samereadgroup.cleaned	2315005	2315008		murJ	3
ARS007ss_ds.merged.samereadgroup.cleaned	2315259	2315268		murJ	9
ARS007ss_ds.merged.samereadgroup.cleaned	2315754	2315758		murJ	4
ARS007ss_ds.merged.samereadgroup.cleaned	2315798	2315810		murJ	12
ARS007ss_ds.merged.samereadgroup.cleaned	2316441	2316513		YPO_RS11220	72
ARS007ss_ds.merged.samereadgroup.cleaned	2316613	2316615		YPO_RS11220	2
ARS007ss_ds.merged.samereadgroup.cleaned	2317181	2317184		YPO_RS11220	3
ARS007ss_ds.merged.samereadgroup.cleaned	2317692	2317711		YPO_RS11220	19
ARS007ss_ds.merged.samereadgroup.cleaned	2318487	2318494		YPO_RS11225	7
ARS007ss_ds.merged.samereadgroup.cleaned	2318671	2318675		YPO_RS11225	4
ARS007ss_ds.merged.samereadgroup.cleaned	2319100	2319120		YPO_RS11225	20
ARS007ss_ds.merged.samereadgroup.cleaned	2319293	2319301		YPO_RS11225	8
ARS007ss_ds.merged.samereadgroup.cleaned	2319533	2319551		YPO_RS11225	18
ARS007ss_ds.merged.samereadgroup.cleaned	2319731	2319732		YPO_RS11225	1
ARS007ss_ds.merged.samereadgroup.cleaned	2319790	2319802		YPO_RS11225	12
ARS007ss_ds.merged.samereadgroup.cleaned	2319929	2319932		YPO_RS11225	3
ARS007ss_ds.merged.samereadgroup.cleaned	2320040	2320055		YPO_RS11225	15
ARS007ss_ds.merged.samereadgroup.cleaned	2320278	2320338		YPO_RS11225	60
ARS007ss_ds.merged.samereadgroup.cleaned	2320563	2320577		YPO_RS11225	14
ARS007ss_ds.merged.samereadgroup.cleaned	2320660	2320701		YPO_RS11225	41
ARS007ss_ds.merged.samereadgroup.cleaned	2321011	2321027		YPO_RS11225	16
ARS007ss_ds.merged.samereadgroup.cleaned	2321359	2321397		YPO_RS11225	38
ARS007ss_ds.merged.samereadgroup.cleaned	2321496	2321505		YPO_RS11225	9
ARS007ss_ds.merged.samereadgroup.cleaned	2321736	2321737		YPO_RS11225	1
ARS007ss_ds.merged.samereadgroup.cleaned	2321847	2321852		YPO_RS11225	5
ARS007ss_ds.merged.samereadgroup.cleaned	2321956	2321959		YPO_RS11225	3
ARS007ss_ds.merged.samereadgroup.cleaned	2322023	2322025		YPO_RS11225	2
ARS007ss_ds.merged.samereadgroup.cleaned	2322421	2322428		YPO_RS11225	7
ARS007ss_ds.merged.samereadgroup.cleaned	2322606	2322608		YPO_RS11225	2
ARS007ss_ds.merged.samereadgroup.cleaned	2322817	2322836		YPO_RS11225	19
ARS007ss_ds.merged.samereadgroup.cleaned	2323125	2323126		argS	1
ARS007ss_ds.merged.samereadgroup.cleaned	2326450	2326458		cutC	8
ARS007ss_ds.merged.samereadgroup.cleaned	2327335	2327338		cmoB	3
ARS007ss_ds.merged.samereadgroup.cleaned	2327486	2327503		cmoB	17
ARS007ss_ds.merged.samereadgroup.cleaned	2327577	2327580		cmoB	3
ARS007ss_ds.merged.samereadgroup.cleaned	2327987	2327991		cmoB	4
ARS007ss_ds.merged.samereadgroup.cleaned	2328582	2328583		cmoA	1
ARS007ss_ds.merged.samereadgroup.cleaned	2329998	2330004		YPO_RS11260	6
ARS007ss_ds.merged.samereadgroup.cleaned	2330197	2330207		YPO_RS11260	10
ARS007ss_ds.merged.samereadgroup.cleaned	2330518	2330520		YPO_RS11260	2
ARS007ss_ds.merged.samereadgroup.cleaned	2332568	2332579		aspS	11
ARS007ss_ds.merged.samereadgroup.cleaned	2332943	2332960		aspS	17
ARS007ss_ds.merged.samereadgroup.cleaned	2332990	2333003		aspS	13
ARS007ss_ds.merged.samereadgroup.cleaned	2333034	2333053		aspS	19
ARS007ss_ds.merged.samereadgroup.cleaned	2333793	2333802		nudB	9
ARS007ss_ds.merged.samereadgroup.cleaned	2334033	2334034		YPO_RS11275	1
ARS007ss_ds.merged.samereadgroup.cleaned	2334287	2334289		YPO_RS11275	2
ARS007ss_ds.merged.samereadgroup.cleaned	2334414	2334421		YPO_RS11275	7
ARS007ss_ds.merged.samereadgroup.cleaned	2334497	2334499		YPO_RS11275	2
ARS007ss_ds.merged.samereadgroup.cleaned	2335240	2335243		ruvC	3
ARS007ss_ds.merged.samereadgroup.cleaned	2336185	2336194		ruvA	9
ARS007ss_ds.merged.samereadgroup.cleaned	2336913	2336927		ruvB	14
ARS007ss_ds.merged.samereadgroup.cleaned	2337611	2337623		znuB	12
ARS007ss_ds.merged.samereadgroup.cleaned	2337721	2337736		znuB	15
ARS007ss_ds.merged.samereadgroup.cleaned	2337778	2337784		znuB	6
ARS007ss_ds.merged.samereadgroup.cleaned	2338418	2338474		znuC	56
ARS007ss_ds.merged.samereadgroup.cleaned	2339040	2339044		znuC	4
ARS007ss_ds.merged.samereadgroup.cleaned	2339558	2339579		znuA	21
ARS007ss_ds.merged.samereadgroup.cleaned	2340171	2340172		mepM	1
ARS007ss_ds.merged.samereadgroup.cleaned	2340376	2340389		mepM	13
ARS007ss_ds.merged.samereadgroup.cleaned	2340426	2340438		mepM	12
ARS007ss_ds.merged.samereadgroup.cleaned	2340687	2340692		mepM	5
ARS007ss_ds.merged.samereadgroup.cleaned	2341965	2341968		lpxM	3
ARS007ss_ds.merged.samereadgroup.cleaned	2342155	2342159		lpxM	4
ARS007ss_ds.merged.samereadgroup.cleaned	2342307	2342308		lpxM	1
ARS007ss_ds.merged.samereadgroup.cleaned	2343030	2343036		pyk	6
ARS007ss_ds.merged.samereadgroup.cleaned	2346153	2346155		zwf	2
ARS007ss_ds.merged.samereadgroup.cleaned	2346650	2346655		zwf	5
ARS007ss_ds.merged.samereadgroup.cleaned	2347267	2347285		zwf	18
ARS007ss_ds.merged.samereadgroup.cleaned	2348070	2348084		YPO_RS11335	14
ARS007ss_ds.merged.samereadgroup.cleaned	2349182	2349187		mdtJ	5
ARS007ss_ds.merged.samereadgroup.cleaned	2349321	2349323		mdtJ	2
ARS007ss_ds.merged.samereadgroup.cleaned	2349609	2349610		mdtI	1
ARS007ss_ds.merged.samereadgroup.cleaned	2349819	2349826		mdtI	7
ARS007ss_ds.merged.samereadgroup.cleaned	2350165	2350167		YPO_RS11350	2
ARS007ss_ds.merged.samereadgroup.cleaned	2351002	2351049		YPO_RS11355	47
ARS007ss_ds.merged.samereadgroup.cleaned	2351285	2351295		YPO_RS11355	10
ARS007ss_ds.merged.samereadgroup.cleaned	2351918	2351926		YPO_RS11355	8
ARS007ss_ds.merged.samereadgroup.cleaned	2352000	2352004		YPO_RS11355	4
ARS007ss_ds.merged.samereadgroup.cleaned	2352760	2352788		tsaB	28
ARS007ss_ds.merged.samereadgroup.cleaned	2352944	2352964		tsaB	20
ARS007ss_ds.merged.samereadgroup.cleaned	2353409	2353410		YPO_RS11365	1
ARS007ss_ds.merged.samereadgroup.cleaned	2353753	2353796		YPO_RS11365	43
ARS007ss_ds.merged.samereadgroup.cleaned	2354833	2354834		fadD	1
ARS007ss_ds.merged.samereadgroup.cleaned	2355308	2355356		fadD	48
ARS007ss_ds.merged.samereadgroup.cleaned	2355590	2355598		fadD	8
ARS007ss_ds.merged.samereadgroup.cleaned	2355715	2355716		fadD	1
ARS007ss_ds.merged.samereadgroup.cleaned	2356038	2356062		fadD	24
ARS007ss_ds.merged.samereadgroup.cleaned	2356695	2356720		rnd	25
ARS007ss_ds.merged.samereadgroup.cleaned	2357166	2357180		rnd	14
ARS007ss_ds.merged.samereadgroup.cleaned	2358037	2358043		minD	6
ARS007ss_ds.merged.samereadgroup.cleaned	2359199	2359201		minC	2
ARS007ss_ds.merged.samereadgroup.cleaned	2360712	2360713		YPO_RS11405	1
ARS007ss_ds.merged.samereadgroup.cleaned	2361789	2361792		YPO_RS11410	3
ARS007ss_ds.merged.samereadgroup.cleaned	2361877	2361903		YPO_RS11410	26
ARS007ss_ds.merged.samereadgroup.cleaned	2361979	2361986		YPO_RS11410	7
ARS007ss_ds.merged.samereadgroup.cleaned	2362851	2362852		YPO_RS11415	1
ARS007ss_ds.merged.samereadgroup.cleaned	2363124	2363126		YPO_RS11420	2
ARS007ss_ds.merged.samereadgroup.cleaned	2363750	2363761		YPO_RS11420	11
ARS007ss_ds.merged.samereadgroup.cleaned	2364229	2364232		YPO_RS11420	3
ARS007ss_ds.merged.samereadgroup.cleaned	2368420	2368440		YPO_RS11450	20
ARS007ss_ds.merged.samereadgroup.cleaned	2369304	2369315		YPO_RS11460	11
ARS007ss_ds.merged.samereadgroup.cleaned	2369700	2369702		YPO_RS11465	2
ARS007ss_ds.merged.samereadgroup.cleaned	2370508	2370549		YPO_RS11470	41
ARS007ss_ds.merged.samereadgroup.cleaned	2370699	2370702		YPO_RS11475	3
ARS007ss_ds.merged.samereadgroup.cleaned	2371161	2371192		YPO_RS11480	31
ARS007ss_ds.merged.samereadgroup.cleaned	2372957	2372964		YPO_RS11495	7
ARS007ss_ds.merged.samereadgroup.cleaned	2373426	2373432		YPO_RS11495	6
ARS007ss_ds.merged.samereadgroup.cleaned	2374276	2374277		YPO_RS11500	1
ARS007ss_ds.merged.samereadgroup.cleaned	2374912	2374928		YPO_RS11505	16
ARS007ss_ds.merged.samereadgroup.cleaned	2375036	2375057		YPO_RS11505	21
ARS007ss_ds.merged.samereadgroup.cleaned	2375317	2375344		YPO_RS11510	27
ARS007ss_ds.merged.samereadgroup.cleaned	2375431	2375443		YPO_RS11510	12
ARS007ss_ds.merged.samereadgroup.cleaned	2376942	2376978		YPO_RS11520	36
ARS007ss_ds.merged.samereadgroup.cleaned	2378226	2378231		YPO_RS11525	5
ARS007ss_ds.merged.samereadgroup.cleaned	2379018	2379019		YPO_RS11530	1
ARS007ss_ds.merged.samereadgroup.cleaned	2379077	2379082		YPO_RS11530	5
ARS007ss_ds.merged.samereadgroup.cleaned	2379370	2379372		YPO_RS11535	2
ARS007ss_ds.merged.samereadgroup.cleaned	2381744	2381763		YPO_RS11545	19
ARS007ss_ds.merged.samereadgroup.cleaned	2381935	2381980		YPO_RS11545	45
ARS007ss_ds.merged.samereadgroup.cleaned	2382042	2382052		YPO_RS11545	10
ARS007ss_ds.merged.samereadgroup.cleaned	2382384	2382388		YPO_RS11545	4
ARS007ss_ds.merged.samereadgroup.cleaned	2382594	2382599		YPO_RS11550	5
ARS007ss_ds.merged.samereadgroup.cleaned	2382939	2382947		YPO_RS11550	8
ARS007ss_ds.merged.samereadgroup.cleaned	2383385	2383407		YPO_RS11560	22
ARS007ss_ds.merged.samereadgroup.cleaned	2383923	2383924		YPO_RS11565	1
ARS007ss_ds.merged.samereadgroup.cleaned	2384452	2384466		YPO_RS11570	14
ARS007ss_ds.merged.samereadgroup.cleaned	2384543	2384549		YPO_RS11570	6
ARS007ss_ds.merged.samereadgroup.cleaned	2385528	2385529		YPO_RS11575	1
ARS007ss_ds.merged.samereadgroup.cleaned	2386131	2386143		YPO_RS11585	12
ARS007ss_ds.merged.samereadgroup.cleaned	2387634	2387645		YPO_RS11590	11
ARS007ss_ds.merged.samereadgroup.cleaned	2387863	2387867		YPO_RS11590	4
ARS007ss_ds.merged.samereadgroup.cleaned	2388097	2388103		YPO_RS11590	6
ARS007ss_ds.merged.samereadgroup.cleaned	2388299	2388304		YPO_RS11590	5
ARS007ss_ds.merged.samereadgroup.cleaned	2389981	2389985		YPO_RS11595	4
ARS007ss_ds.merged.samereadgroup.cleaned	2391120	2391121		YPO_RS11605	1
ARS007ss_ds.merged.samereadgroup.cleaned	2391514	2391527		YPO_RS11605	13
ARS007ss_ds.merged.samereadgroup.cleaned	2391603	2391755		YPO_RS11605	152
ARS007ss_ds.merged.samereadgroup.cleaned	2391758	2391817		YPO_RS11610	59
ARS007ss_ds.merged.samereadgroup.cleaned	2392433	2392438		YPO_RS11610	5
ARS007ss_ds.merged.samereadgroup.cleaned	2394676	2394677		YPO_RS11630	1
ARS007ss_ds.merged.samereadgroup.cleaned	2394753	2394754		YPO_RS11630	1
ARS007ss_ds.merged.samereadgroup.cleaned	2394903	2394916		YPO_RS11630	13
ARS007ss_ds.merged.samereadgroup.cleaned	2396578	2396597		YPO_RS11645	19
ARS007ss_ds.merged.samereadgroup.cleaned	2396692	2396699		YPO_RS11645	7
ARS007ss_ds.merged.samereadgroup.cleaned	2396760	2396782		YPO_RS11645	22
ARS007ss_ds.merged.samereadgroup.cleaned	2396847	2396850		YPO_RS11645	3
ARS007ss_ds.merged.samereadgroup.cleaned	2397010	2397078		YPO_RS11650	68
ARS007ss_ds.merged.samereadgroup.cleaned	2398296	2398305		YPO_RS11660	9
ARS007ss_ds.merged.samereadgroup.cleaned	2398342	2398344		YPO_RS11660	2
ARS007ss_ds.merged.samereadgroup.cleaned	2398474	2398489		YPO_RS11660	15
ARS007ss_ds.merged.samereadgroup.cleaned	2398938	2398943		YPO_RS11660	5
ARS007ss_ds.merged.samereadgroup.cleaned	2399404	2399424		YPO_RS11660	20
ARS007ss_ds.merged.samereadgroup.cleaned	2399693	2399700		YPO_RS11660	7
ARS007ss_ds.merged.samereadgroup.cleaned	2400001	2400011		YPO_RS11660	10
ARS007ss_ds.merged.samereadgroup.cleaned	2400625	2400636		YPO_RS11660	11
ARS007ss_ds.merged.samereadgroup.cleaned	2400716	2400732		YPO_RS11665	16
ARS007ss_ds.merged.samereadgroup.cleaned	2400904	2400928		YPO_RS11665	24
ARS007ss_ds.merged.samereadgroup.cleaned	2401010	2401018		YPO_RS11665	8
ARS007ss_ds.merged.samereadgroup.cleaned	2401552	2401566		YPO_RS11665	14
ARS007ss_ds.merged.samereadgroup.cleaned	2401603	2401622		YPO_RS11665	19
ARS007ss_ds.merged.samereadgroup.cleaned	2401717	2401718		YPO_RS11670	1
ARS007ss_ds.merged.samereadgroup.cleaned	2401818	2401823		YPO_RS11670	5
ARS007ss_ds.merged.samereadgroup.cleaned	2401953	2401961		YPO_RS11670	8
ARS007ss_ds.merged.samereadgroup.cleaned	2402394	2402412		YPO_RS11670	18
ARS007ss_ds.merged.samereadgroup.cleaned	2402833	2402834		YPO_RS11675	1
ARS007ss_ds.merged.samereadgroup.cleaned	2405133	2405151		YPO_RS11685	18
ARS007ss_ds.merged.samereadgroup.cleaned	2405327	2405333		YPO_RS11685	6
ARS007ss_ds.merged.samereadgroup.cleaned	2406159	2406168		YPO_RS11690	9
ARS007ss_ds.merged.samereadgroup.cleaned	2406876	2406911		YPO_RS11690	35
ARS007ss_ds.merged.samereadgroup.cleaned	2407820	2407842		YPO_RS11695	22
ARS007ss_ds.merged.samereadgroup.cleaned	2409157	2409160		YPO_RS11700	3
ARS007ss_ds.merged.samereadgroup.cleaned	2409341	2409350		YPO_RS11700	9
ARS007ss_ds.merged.samereadgroup.cleaned	2410137	2410155		dsbB	18
ARS007ss_ds.merged.samereadgroup.cleaned	2410586	2410589		nhaB	3
ARS007ss_ds.merged.samereadgroup.cleaned	2410721	2410723		nhaB	2
ARS007ss_ds.merged.samereadgroup.cleaned	2411632	2411633		nhaB	1
ARS007ss_ds.merged.samereadgroup.cleaned	2412015	2412038		nhaB	23
ARS007ss_ds.merged.samereadgroup.cleaned	2412999	2413006		fadR	7
ARS007ss_ds.merged.samereadgroup.cleaned	2413572	2413578		YPO_RS11720	6
ARS007ss_ds.merged.samereadgroup.cleaned	2413858	2413874		YPO_RS11720	16
ARS007ss_ds.merged.samereadgroup.cleaned	2413945	2413949		YPO_RS11720	4
ARS007ss_ds.merged.samereadgroup.cleaned	2414145	2414150		YPO_RS11720	5
ARS007ss_ds.merged.samereadgroup.cleaned	2414659	2414677		YPO_RS11720	18
ARS007ss_ds.merged.samereadgroup.cleaned	2414716	2414720		YPO_RS11720	4
ARS007ss_ds.merged.samereadgroup.cleaned	2415351	2415377		YPO_RS11725	26
ARS007ss_ds.merged.samereadgroup.cleaned	2415467	2415484		YPO_RS11725	17
ARS007ss_ds.merged.samereadgroup.cleaned	2416102	2416115		YPO_RS11725	13
ARS007ss_ds.merged.samereadgroup.cleaned	2416237	2416247		YPO_RS11725	10
ARS007ss_ds.merged.samereadgroup.cleaned	2416869	2416879		YPO_RS11730	10
ARS007ss_ds.merged.samereadgroup.cleaned	2417486	2417518		YPO_RS11730	32
ARS007ss_ds.merged.samereadgroup.cleaned	2417785	2417789		YPO_RS11730	4
ARS007ss_ds.merged.samereadgroup.cleaned	2418283	2418286		YPO_RS11735	3
ARS007ss_ds.merged.samereadgroup.cleaned	2418672	2418673		YPO_RS11735	1
ARS007ss_ds.merged.samereadgroup.cleaned	2419178	2419180		YPO_RS11740	2
ARS007ss_ds.merged.samereadgroup.cleaned	2419242	2419249		YPO_RS11740	7
ARS007ss_ds.merged.samereadgroup.cleaned	2420294	2420303		YPO_RS11745	9
ARS007ss_ds.merged.samereadgroup.cleaned	2420350	2420366		YPO_RS11745	16
ARS007ss_ds.merged.samereadgroup.cleaned	2420890	2420899		YPO_RS11745	9
ARS007ss_ds.merged.samereadgroup.cleaned	2420933	2420964		YPO_RS11745	31
ARS007ss_ds.merged.samereadgroup.cleaned	2422342	2422403		YPO_RS11750	61
ARS007ss_ds.merged.samereadgroup.cleaned	2422817	2422821		yeaG	4
ARS007ss_ds.merged.samereadgroup.cleaned	2423119	2423128		yeaG	9
ARS007ss_ds.merged.samereadgroup.cleaned	2423701	2423703		yeaG	2
ARS007ss_ds.merged.samereadgroup.cleaned	2424439	2424454		yeaG	15
ARS007ss_ds.merged.samereadgroup.cleaned	2425268	2425309		YPO_RS11760	41
ARS007ss_ds.merged.samereadgroup.cleaned	2425454	2425469		YPO_RS11760	15
ARS007ss_ds.merged.samereadgroup.cleaned	2426135	2426144		YPO_RS11765	9
ARS007ss_ds.merged.samereadgroup.cleaned	2426442	2426465		YPO_RS11765	23
ARS007ss_ds.merged.samereadgroup.cleaned	2428722	2428728		msrB	6
ARS007ss_ds.merged.samereadgroup.cleaned	2429490	2429500		pncA	10
ARS007ss_ds.merged.samereadgroup.cleaned	2429773	2429802		pncA	29
ARS007ss_ds.merged.samereadgroup.cleaned	2430213	2430230		ansA	17
ARS007ss_ds.merged.samereadgroup.cleaned	2430786	2430794		ansA	8
ARS007ss_ds.merged.samereadgroup.cleaned	2431179	2431199		sppA	20
ARS007ss_ds.merged.samereadgroup.cleaned	2431484	2431486		sppA	2
ARS007ss_ds.merged.samereadgroup.cleaned	2431646	2431664		sppA	18
ARS007ss_ds.merged.samereadgroup.cleaned	2432078	2432104		sppA	26
ARS007ss_ds.merged.samereadgroup.cleaned	2432502	2432515		sppA	13
ARS007ss_ds.merged.samereadgroup.cleaned	2432822	2432824		sppA	2
ARS007ss_ds.merged.samereadgroup.cleaned	2433597	2433607		YPO_RS11800	10
ARS007ss_ds.merged.samereadgroup.cleaned	2434265	2434291		selD	26
ARS007ss_ds.merged.samereadgroup.cleaned	2434718	2434732		selD	14
ARS007ss_ds.merged.samereadgroup.cleaned	2434818	2434830		selD	12
ARS007ss_ds.merged.samereadgroup.cleaned	2434894	2434902		selD	8
ARS007ss_ds.merged.samereadgroup.cleaned	2435184	2435195		YPO_RS11810	11
ARS007ss_ds.merged.samereadgroup.cleaned	2435662	2435670		YPO_RS11810	8
ARS007ss_ds.merged.samereadgroup.cleaned	2436640	2436642		YPO_RS11810	2
ARS007ss_ds.merged.samereadgroup.cleaned	2437219	2437240		YPO_RS11815	21
ARS007ss_ds.merged.samereadgroup.cleaned	2437619	2437652		YPO_RS11820	33
ARS007ss_ds.merged.samereadgroup.cleaned	2437851	2437876		xthA	25
ARS007ss_ds.merged.samereadgroup.cleaned	2438139	2438144		xthA	5
ARS007ss_ds.merged.samereadgroup.cleaned	2438404	2438405		xthA	1
ARS007ss_ds.merged.samereadgroup.cleaned	2439675	2439695		YPO_RS11830	20
ARS007ss_ds.merged.samereadgroup.cleaned	2439884	2439970		YPO_RS11830	86
ARS007ss_ds.merged.samereadgroup.cleaned	2440158	2440176		YPO_RS11830	18
ARS007ss_ds.merged.samereadgroup.cleaned	2440240	2440259		YPO_RS11830	19
ARS007ss_ds.merged.samereadgroup.cleaned	2440422	2440432		YPO_RS11835	10
ARS007ss_ds.merged.samereadgroup.cleaned	2440602	2440605		YPO_RS11840	3
ARS007ss_ds.merged.samereadgroup.cleaned	2440685	2440721		YPO_RS11840	36
ARS007ss_ds.merged.samereadgroup.cleaned	2442345	2442385		purU	40
ARS007ss_ds.merged.samereadgroup.cleaned	2442733	2442738		purU	5
ARS007ss_ds.merged.samereadgroup.cleaned	2443333	2443338		YPO_RS11860	5
ARS007ss_ds.merged.samereadgroup.cleaned	2443688	2443690		YPO_RS11860	2
ARS007ss_ds.merged.samereadgroup.cleaned	2445053	2445069		rssB	16
ARS007ss_ds.merged.samereadgroup.cleaned	2445246	2445275		rssB	29
ARS007ss_ds.merged.samereadgroup.cleaned	2445686	2445733		rssB	47
ARS007ss_ds.merged.samereadgroup.cleaned	2445957	2445961		rssB	4
ARS007ss_ds.merged.samereadgroup.cleaned	2446431	2446459		YPO_RS11870	28
ARS007ss_ds.merged.samereadgroup.cleaned	2446697	2446735		YPO_RS11870	38
ARS007ss_ds.merged.samereadgroup.cleaned	2446927	2446932		YPO_RS11870	5
ARS007ss_ds.merged.samereadgroup.cleaned	2446977	2446978		YPO_RS11870	1
ARS007ss_ds.merged.samereadgroup.cleaned	2448281	2448307		hns	26
ARS007ss_ds.merged.samereadgroup.cleaned	2452736	2452752		adhE	16
ARS007ss_ds.merged.samereadgroup.cleaned	2453469	2453492		adhE	23
ARS007ss_ds.merged.samereadgroup.cleaned	2454071	2454083		adhE	12
ARS007ss_ds.merged.samereadgroup.cleaned	2454354	2454355		adhE	1
ARS007ss_ds.merged.samereadgroup.cleaned	2454421	2454462		adhE	41
ARS007ss_ds.merged.samereadgroup.cleaned	2454775	2454794		adhE	19
ARS007ss_ds.merged.samereadgroup.cleaned	2455111	2455126		adhE	15
ARS007ss_ds.merged.samereadgroup.cleaned	2456539	2456542		YPO_RS11900	3
ARS007ss_ds.merged.samereadgroup.cleaned	2456658	2456697		YPO_RS11900	39
ARS007ss_ds.merged.samereadgroup.cleaned	2457607	2457612		oppA	5
ARS007ss_ds.merged.samereadgroup.cleaned	2457750	2457752		oppA	2
ARS007ss_ds.merged.samereadgroup.cleaned	2457805	2457849		oppA	44
ARS007ss_ds.merged.samereadgroup.cleaned	2458460	2458474		oppA	14
ARS007ss_ds.merged.samereadgroup.cleaned	2458606	2458621		oppA	15
ARS007ss_ds.merged.samereadgroup.cleaned	2458862	2458863		oppA	1
ARS007ss_ds.merged.samereadgroup.cleaned	2458947	2458967		oppA	20
ARS007ss_ds.merged.samereadgroup.cleaned	2460419	2460421		oppC	2
ARS007ss_ds.merged.samereadgroup.cleaned	2460902	2460904		oppC	2
ARS007ss_ds.merged.samereadgroup.cleaned	2461234	2461249		YPO_RS11920	15
ARS007ss_ds.merged.samereadgroup.cleaned	2461992	2461993		YPO_RS11920	1
ARS007ss_ds.merged.samereadgroup.cleaned	2462135	2462138		YPO_RS11920	3
ARS007ss_ds.merged.samereadgroup.cleaned	2462199	2462214		YPO_RS11925	15
ARS007ss_ds.merged.samereadgroup.cleaned	2462304	2462305		YPO_RS11925	1
ARS007ss_ds.merged.samereadgroup.cleaned	2462627	2462628		YPO_RS11925	1
ARS007ss_ds.merged.samereadgroup.cleaned	2462843	2462910		YPO_RS11925	67
ARS007ss_ds.merged.samereadgroup.cleaned	2463709	2463711		YPO_RS11930	2
ARS007ss_ds.merged.samereadgroup.cleaned	2464966	2464970		cls	4
ARS007ss_ds.merged.samereadgroup.cleaned	2465080	2465086		cls	6
ARS007ss_ds.merged.samereadgroup.cleaned	2465293	2465304		cls	11
ARS007ss_ds.merged.samereadgroup.cleaned	2465346	2465358		cls	12
ARS007ss_ds.merged.samereadgroup.cleaned	2465639	2465643		cls	4
ARS007ss_ds.merged.samereadgroup.cleaned	2467287	2467297		YPO_RS11950	10
ARS007ss_ds.merged.samereadgroup.cleaned	2467499	2467502		YPO_RS11950	3
ARS007ss_ds.merged.samereadgroup.cleaned	2467626	2467634		YPO_RS11950	8
ARS007ss_ds.merged.samereadgroup.cleaned	2467971	2467999		YPO_RS11955	28
ARS007ss_ds.merged.samereadgroup.cleaned	2468036	2468037		YPO_RS11955	1
ARS007ss_ds.merged.samereadgroup.cleaned	2468108	2468111		YPO_RS11955	3
ARS007ss_ds.merged.samereadgroup.cleaned	2468350	2468353		YPO_RS11960	3
ARS007ss_ds.merged.samereadgroup.cleaned	2468836	2468867		YPO_RS11965	31
ARS007ss_ds.merged.samereadgroup.cleaned	2469978	2469983		tonB	5
ARS007ss_ds.merged.samereadgroup.cleaned	2473123	2473151		YPO_RS11990	28
ARS007ss_ds.merged.samereadgroup.cleaned	2473207	2473210		YPO_RS11990	3
ARS007ss_ds.merged.samereadgroup.cleaned	2473433	2473475		YPO_RS11990	42
ARS007ss_ds.merged.samereadgroup.cleaned	2473579	2473588		YPO_RS11990	9
ARS007ss_ds.merged.samereadgroup.cleaned	2473793	2473798		YPO_RS11990	5
ARS007ss_ds.merged.samereadgroup.cleaned	2474412	2474422		YPO_RS11995	10
ARS007ss_ds.merged.samereadgroup.cleaned	2474589	2474594		YPO_RS11995	5
ARS007ss_ds.merged.samereadgroup.cleaned	2474890	2474914		YPO_RS12000	24
ARS007ss_ds.merged.samereadgroup.cleaned	2474999	2475004		YPO_RS12000	5
ARS007ss_ds.merged.samereadgroup.cleaned	2475092	2475099		YPO_RS12000	7
ARS007ss_ds.merged.samereadgroup.cleaned	2475143	2475151		YPO_RS12000	8
ARS007ss_ds.merged.samereadgroup.cleaned	2475217	2475235		YPO_RS12000	18
ARS007ss_ds.merged.samereadgroup.cleaned	2475793	2475858		YPO_RS12005	65
ARS007ss_ds.merged.samereadgroup.cleaned	2476022	2476025		ompW	3
ARS007ss_ds.merged.samereadgroup.cleaned	2476078	2476098		ompW	20
ARS007ss_ds.merged.samereadgroup.cleaned	2476167	2476174		ompW	7
ARS007ss_ds.merged.samereadgroup.cleaned	2476464	2476470		ompW	6
ARS007ss_ds.merged.samereadgroup.cleaned	2476795	2476800		YPO_RS12015	5
ARS007ss_ds.merged.samereadgroup.cleaned	2477417	2477419		trpA	2
ARS007ss_ds.merged.samereadgroup.cleaned	2477701	2477713		trpA	12
ARS007ss_ds.merged.samereadgroup.cleaned	2477862	2477891		trpA	29
ARS007ss_ds.merged.samereadgroup.cleaned	2478034	2478042		trpA	8
ARS007ss_ds.merged.samereadgroup.cleaned	2478302	2478305		trpB	3
ARS007ss_ds.merged.samereadgroup.cleaned	2478564	2478567		trpB	3
ARS007ss_ds.merged.samereadgroup.cleaned	2480066	2480076		trpCF	10
ARS007ss_ds.merged.samereadgroup.cleaned	2480687	2480697		trpCF	10
ARS007ss_ds.merged.samereadgroup.cleaned	2481351	2481359		trpD	8
ARS007ss_ds.merged.samereadgroup.cleaned	2481483	2481487		trpD	4
ARS007ss_ds.merged.samereadgroup.cleaned	2482559	2482563		YPO_RS12040	4
ARS007ss_ds.merged.samereadgroup.cleaned	2482699	2482706		YPO_RS12045	7
ARS007ss_ds.merged.samereadgroup.cleaned	2482799	2482813		YPO_RS12045	14
ARS007ss_ds.merged.samereadgroup.cleaned	2482860	2482870		YPO_RS12045	10
ARS007ss_ds.merged.samereadgroup.cleaned	2483074	2483079		YPO_RS12045	5
ARS007ss_ds.merged.samereadgroup.cleaned	2483305	2483311		YPO_RS12045	6
ARS007ss_ds.merged.samereadgroup.cleaned	2484851	2484856		YPO_RS12055	5
ARS007ss_ds.merged.samereadgroup.cleaned	2484954	2484968		YPO_RS12055	14
ARS007ss_ds.merged.samereadgroup.cleaned	2485163	2485173		YPO_RS12055	10
ARS007ss_ds.merged.samereadgroup.cleaned	2485325	2485348		YPO_RS12055	23
ARS007ss_ds.merged.samereadgroup.cleaned	2485806	2485814		YPO_RS12060	8
ARS007ss_ds.merged.samereadgroup.cleaned	2485941	2485956		YPO_RS12060	15
ARS007ss_ds.merged.samereadgroup.cleaned	2486071	2486080		YPO_RS12060	9
ARS007ss_ds.merged.samereadgroup.cleaned	2486922	2486928		rluB	6
ARS007ss_ds.merged.samereadgroup.cleaned	2487885	2487909		cobO	24
ARS007ss_ds.merged.samereadgroup.cleaned	2488271	2488273		YPO_RS12075	2
ARS007ss_ds.merged.samereadgroup.cleaned	2488752	2488758		YPO_RS12075	6
ARS007ss_ds.merged.samereadgroup.cleaned	2489398	2489415		sohB	17
ARS007ss_ds.merged.samereadgroup.cleaned	2489533	2489544		sohB	11
ARS007ss_ds.merged.samereadgroup.cleaned	2490234	2490235		sohB	1
ARS007ss_ds.merged.samereadgroup.cleaned	2490597	2490605		YPO_RS12085	8
ARS007ss_ds.merged.samereadgroup.cleaned	2490354	2490391		YPO_RS12085	37
ARS007ss_ds.merged.samereadgroup.cleaned	2490767	2490785		YPO_RS12090	18
ARS007ss_ds.merged.samereadgroup.cleaned	2490990	2490997		YPO_RS12090	7
ARS007ss_ds.merged.samereadgroup.cleaned	2491165	2491268		topA	103
ARS007ss_ds.merged.samereadgroup.cleaned	2492358	2492372		topA	14
ARS007ss_ds.merged.samereadgroup.cleaned	2493497	2493507		topA	10
ARS007ss_ds.merged.samereadgroup.cleaned	2494203	2494222		cysB	19
ARS007ss_ds.merged.samereadgroup.cleaned	2494521	2494574		cysB	53
ARS007ss_ds.merged.samereadgroup.cleaned	2494750	2494768		cysB	18
ARS007ss_ds.merged.samereadgroup.cleaned	2494968	2494977		cysB	9
ARS007ss_ds.merged.samereadgroup.cleaned	2495424	2495445		YPO_RS12105	21
ARS007ss_ds.merged.samereadgroup.cleaned	2495570	2495574		YPO_RS12105	4
ARS007ss_ds.merged.samereadgroup.cleaned	2495711	2495719		YPO_RS12105	8
ARS007ss_ds.merged.samereadgroup.cleaned	2495950	2495953		YPO_RS12105	3
ARS007ss_ds.merged.samereadgroup.cleaned	2496032	2496043		YPO_RS12105	11
ARS007ss_ds.merged.samereadgroup.cleaned	2496654	2496675		acnA	21
ARS007ss_ds.merged.samereadgroup.cleaned	2496720	2496730		acnA	10
ARS007ss_ds.merged.samereadgroup.cleaned	2497543	2497565		acnA	22
ARS007ss_ds.merged.samereadgroup.cleaned	2498681	2498699		acnA	18
ARS007ss_ds.merged.samereadgroup.cleaned	2499022	2499024		acnA	2
ARS007ss_ds.merged.samereadgroup.cleaned	2499495	2499499		ribA	4
ARS007ss_ds.merged.samereadgroup.cleaned	2499910	2499911		ribA	1
ARS007ss_ds.merged.samereadgroup.cleaned	2500654	2500659		pgpB	5
ARS007ss_ds.merged.samereadgroup.cleaned	2501484	2501489		YPO_RS12125	5
ARS007ss_ds.merged.samereadgroup.cleaned	2502095	2502122		lapB	27
ARS007ss_ds.merged.samereadgroup.cleaned	2502431	2502432		lapB	1
ARS007ss_ds.merged.samereadgroup.cleaned	2502718	2502723		lapB	5
ARS007ss_ds.merged.samereadgroup.cleaned	2503051	2503081		YPO_RS12135	30
ARS007ss_ds.merged.samereadgroup.cleaned	2505108	2505121		osmB	13
ARS007ss_ds.merged.samereadgroup.cleaned	2505857	2505858		araD	1
ARS007ss_ds.merged.samereadgroup.cleaned	2505950	2505971		araD	21
ARS007ss_ds.merged.samereadgroup.cleaned	2506076	2506096		araD	20
ARS007ss_ds.merged.samereadgroup.cleaned	2506183	2506184		araD	1
ARS007ss_ds.merged.samereadgroup.cleaned	2506358	2506364		araD	6
ARS007ss_ds.merged.samereadgroup.cleaned	2507314	2507353		fsa	39
ARS007ss_ds.merged.samereadgroup.cleaned	2507916	2507920		YPO_RS12170	4
ARS007ss_ds.merged.samereadgroup.cleaned	2508769	2508778		YPO_RS12175	9
ARS007ss_ds.merged.samereadgroup.cleaned	2508898	2508932		YPO_RS12175	34
ARS007ss_ds.merged.samereadgroup.cleaned	2509001	2509005		YPO_RS12175	4
ARS007ss_ds.merged.samereadgroup.cleaned	2509117	2509120		YPO_RS12175	3
ARS007ss_ds.merged.samereadgroup.cleaned	2509211	2509224		YPO_RS12175	13
ARS007ss_ds.merged.samereadgroup.cleaned	2509427	2509442		YPO_RS12175	15
ARS007ss_ds.merged.samereadgroup.cleaned	2509626	2509629		YPO_RS12175	3
ARS007ss_ds.merged.samereadgroup.cleaned	2509873	2509887		YPO_RS12175	14
ARS007ss_ds.merged.samereadgroup.cleaned	2509951	2509952		YPO_RS12175	1
ARS007ss_ds.merged.samereadgroup.cleaned	2511219	2511224		YPO_RS12180	5
ARS007ss_ds.merged.samereadgroup.cleaned	2511696	2511700		YPO_RS12180	4
ARS007ss_ds.merged.samereadgroup.cleaned	2513251	2513262		YPO_RS12185	11
ARS007ss_ds.merged.samereadgroup.cleaned	2513772	2513793		YPO_RS12185	21
ARS007ss_ds.merged.samereadgroup.cleaned	2514248	2514273		YPO_RS12185	25
ARS007ss_ds.merged.samereadgroup.cleaned	2514381	2514387		YPO_RS12185	6
ARS007ss_ds.merged.samereadgroup.cleaned	2515805	2515806		nth	1
ARS007ss_ds.merged.samereadgroup.cleaned	2515899	2515903		nth	4
ARS007ss_ds.merged.samereadgroup.cleaned	2516169	2516181		nth	12
ARS007ss_ds.merged.samereadgroup.cleaned	2516656	2516657		YPO_RS12200	1
ARS007ss_ds.merged.samereadgroup.cleaned	2517073	2517092		rsxG	19
ARS007ss_ds.merged.samereadgroup.cleaned	2517155	2517160		rsxG	5
ARS007ss_ds.merged.samereadgroup.cleaned	2517287	2517296		rsxG	9
ARS007ss_ds.merged.samereadgroup.cleaned	2517441	2517453		rsxG	12
ARS007ss_ds.merged.samereadgroup.cleaned	2517710	2517732		rsxD	22
ARS007ss_ds.merged.samereadgroup.cleaned	2517863	2517877		rsxD	14
ARS007ss_ds.merged.samereadgroup.cleaned	2518251	2518258		rsxD	7
ARS007ss_ds.merged.samereadgroup.cleaned	2518470	2518500		rsxD	30
ARS007ss_ds.merged.samereadgroup.cleaned	2519275	2519316		YPO_RS12215	41
ARS007ss_ds.merged.samereadgroup.cleaned	2520836	2520842		rsxC	6
ARS007ss_ds.merged.samereadgroup.cleaned	2521108	2521123		rsxC	15
ARS007ss_ds.merged.samereadgroup.cleaned	2521797	2521801		rsxC	4
ARS007ss_ds.merged.samereadgroup.cleaned	2521972	2521989		rsxC	17
ARS007ss_ds.merged.samereadgroup.cleaned	2522340	2522343		rsxB	3
ARS007ss_ds.merged.samereadgroup.cleaned	2522563	2522580		rsxB	17
ARS007ss_ds.merged.samereadgroup.cleaned	2522975	2522982		rsxA	7
ARS007ss_ds.merged.samereadgroup.cleaned	2523197	2523214		rsxA	17
ARS007ss_ds.merged.samereadgroup.cleaned	2523713	2523736		YPO_RS12235	23
ARS007ss_ds.merged.samereadgroup.cleaned	2526481	2526484		YPO_RS12245	3
ARS007ss_ds.merged.samereadgroup.cleaned	2527434	2527445		YPO_RS12245	11
ARS007ss_ds.merged.samereadgroup.cleaned	2527700	2527725		YPO_RS12250	25
ARS007ss_ds.merged.samereadgroup.cleaned	2527962	2527967		YPO_RS12255	5
ARS007ss_ds.merged.samereadgroup.cleaned	2528466	2528468		YPO_RS12255	2
ARS007ss_ds.merged.samereadgroup.cleaned	2528563	2528569		YPO_RS12255	6
ARS007ss_ds.merged.samereadgroup.cleaned	2529342	2529366		YPO_RS12255	24
ARS007ss_ds.merged.samereadgroup.cleaned	2529572	2529577		YPO_RS12255	5
ARS007ss_ds.merged.samereadgroup.cleaned	2529656	2529661		YPO_RS12255	5
ARS007ss_ds.merged.samereadgroup.cleaned	2529702	2529721		YPO_RS12255	19
ARS007ss_ds.merged.samereadgroup.cleaned	2531632	2531640		araA	8
ARS007ss_ds.merged.samereadgroup.cleaned	2532164	2532171		YPO_RS12265	7
ARS007ss_ds.merged.samereadgroup.cleaned	2532562	2532590		YPO_RS12265	28
ARS007ss_ds.merged.samereadgroup.cleaned	2532851	2532871		YPO_RS12265	20
ARS007ss_ds.merged.samereadgroup.cleaned	2533161	2533181		YPO_RS12265	20
ARS007ss_ds.merged.samereadgroup.cleaned	2533436	2533441		YPO_RS12265	5
ARS007ss_ds.merged.samereadgroup.cleaned	2533885	2533892		YPO_RS12270	7
ARS007ss_ds.merged.samereadgroup.cleaned	2534097	2534098		YPO_RS12270	1
ARS007ss_ds.merged.samereadgroup.cleaned	2534469	2534490		YPO_RS12270	21
ARS007ss_ds.merged.samereadgroup.cleaned	2534622	2534630		YPO_RS12270	8
ARS007ss_ds.merged.samereadgroup.cleaned	2535126	2535155		YPO_RS12275	29
ARS007ss_ds.merged.samereadgroup.cleaned	2536379	2536386		YPO_RS12275	7
ARS007ss_ds.merged.samereadgroup.cleaned	2536590	2536602		YPO_RS12280	12
ARS007ss_ds.merged.samereadgroup.cleaned	2536866	2536872		YPO_RS12280	6
ARS007ss_ds.merged.samereadgroup.cleaned	2536917	2536931		YPO_RS12280	14
ARS007ss_ds.merged.samereadgroup.cleaned	2537108	2537120		YPO_RS12280	12
ARS007ss_ds.merged.samereadgroup.cleaned	2537868	2537877		araC	9
ARS007ss_ds.merged.samereadgroup.cleaned	2537950	2537951		araC	1
ARS007ss_ds.merged.samereadgroup.cleaned	2538889	2538891		YPO_RS12290	2
ARS007ss_ds.merged.samereadgroup.cleaned	2539007	2539017		YPO_RS12290	10
ARS007ss_ds.merged.samereadgroup.cleaned	2539126	2539140		YPO_RS12290	14
ARS007ss_ds.merged.samereadgroup.cleaned	2540369	2540375		YPO_RS12295	6
ARS007ss_ds.merged.samereadgroup.cleaned	2540832	2540852		YPO_RS12295	20
ARS007ss_ds.merged.samereadgroup.cleaned	2540982	2540983		YPO_RS12295	1
ARS007ss_ds.merged.samereadgroup.cleaned	2541041	2541046		YPO_RS12295	5
ARS007ss_ds.merged.samereadgroup.cleaned	2541492	2541519		YPO_RS12300	27
ARS007ss_ds.merged.samereadgroup.cleaned	2541600	2541601		YPO_RS12300	1
ARS007ss_ds.merged.samereadgroup.cleaned	2541711	2541715		YPO_RS12300	4
ARS007ss_ds.merged.samereadgroup.cleaned	2541847	2541849		YPO_RS12300	2
ARS007ss_ds.merged.samereadgroup.cleaned	2541925	2541933		YPO_RS12300	8
ARS007ss_ds.merged.samereadgroup.cleaned	2542613	2542615		YPO_RS12305	2
ARS007ss_ds.merged.samereadgroup.cleaned	2543057	2543059		YPO_RS12305	2
ARS007ss_ds.merged.samereadgroup.cleaned	2544237	2544247		manA	10
ARS007ss_ds.merged.samereadgroup.cleaned	2544452	2544465		manA	13
ARS007ss_ds.merged.samereadgroup.cleaned	2545257	2545289		fumC	32
ARS007ss_ds.merged.samereadgroup.cleaned	2545591	2545595		fumC	4
ARS007ss_ds.merged.samereadgroup.cleaned	2545681	2545696		fumC	15
ARS007ss_ds.merged.samereadgroup.cleaned	2545814	2545818		fumC	4
ARS007ss_ds.merged.samereadgroup.cleaned	2546832	2546840		YPO_RS12320	8
ARS007ss_ds.merged.samereadgroup.cleaned	2547179	2547181		YPO_RS12320	2
ARS007ss_ds.merged.samereadgroup.cleaned	2547304	2547314		YPO_RS12320	10
ARS007ss_ds.merged.samereadgroup.cleaned	2547446	2547451		YPO_RS12320	5
ARS007ss_ds.merged.samereadgroup.cleaned	2548335	2548352		YPO_RS12325	17
ARS007ss_ds.merged.samereadgroup.cleaned	2548642	2548643		YPO_RS12325	1
ARS007ss_ds.merged.samereadgroup.cleaned	2548917	2548923		YPO_RS12325	6
ARS007ss_ds.merged.samereadgroup.cleaned	2549125	2549140		YPO_RS12325	15
ARS007ss_ds.merged.samereadgroup.cleaned	2549511	2549512		YPO_RS12330	1
ARS007ss_ds.merged.samereadgroup.cleaned	2549640	2549668		YPO_RS12335	28
ARS007ss_ds.merged.samereadgroup.cleaned	2549909	2549912		YPO_RS12335	3
ARS007ss_ds.merged.samereadgroup.cleaned	2550045	2550066		YPO_RS12335	21
ARS007ss_ds.merged.samereadgroup.cleaned	2550913	2550936		YPO_RS12340	23
ARS007ss_ds.merged.samereadgroup.cleaned	2551049	2551066		YPO_RS12340	17
ARS007ss_ds.merged.samereadgroup.cleaned	2551139	2551166		YPO_RS12340	27
ARS007ss_ds.merged.samereadgroup.cleaned	2552867	2552894		clcB	27
ARS007ss_ds.merged.samereadgroup.cleaned	2552932	2552936		clcB	4
ARS007ss_ds.merged.samereadgroup.cleaned	2552970	2552994		clcB	24
ARS007ss_ds.merged.samereadgroup.cleaned	2553129	2553154		clcB	25
ARS007ss_ds.merged.samereadgroup.cleaned	2553766	2553787		clcB	21
ARS007ss_ds.merged.samereadgroup.cleaned	2554373	2554633		YPO_RS12355	260
ARS007ss_ds.merged.samereadgroup.cleaned	2554658	2555065		YPO_RS12360	407
ARS007ss_ds.merged.samereadgroup.cleaned	2555162	2555608		YPO_RS12365	446
ARS007ss_ds.merged.samereadgroup.cleaned	2555780	2556832		YPO_RS12370	1052
ARS007ss_ds.merged.samereadgroup.cleaned	2556844	2557161		YPO_RS12375	317
ARS007ss_ds.merged.samereadgroup.cleaned	2557164	2557415		YPO_RS12380	251
ARS007ss_ds.merged.samereadgroup.cleaned	2557451	2557684		YPO_RS12385	233
ARS007ss_ds.merged.samereadgroup.cleaned	2557749	2559461		YPO_RS12390	1712
ARS007ss_ds.merged.samereadgroup.cleaned	2559474	2559761		YPO_RS12395	287
ARS007ss_ds.merged.samereadgroup.cleaned	2559765	2560790		YPO_RS12400	1025
ARS007ss_ds.merged.samereadgroup.cleaned	2560790	2562034		YPO_RS12405	1244
ARS007ss_ds.merged.samereadgroup.cleaned	2562123	2562371		YPO_RS12410	248
ARS007ss_ds.merged.samereadgroup.cleaned	2562568	2562765		YPO_RS12415	197
ARS007ss_ds.merged.samereadgroup.cleaned	2563325	2563937		YPO_RS12420	612
ARS007ss_ds.merged.samereadgroup.cleaned	2564504	2564524		YPO_RS12425	20
ARS007ss_ds.merged.samereadgroup.cleaned	2565815	2565839		YPO_RS12435	24
ARS007ss_ds.merged.samereadgroup.cleaned	2565914	2565933		YPO_RS12435	19
ARS007ss_ds.merged.samereadgroup.cleaned	2565997	2565999		YPO_RS12435	2
ARS007ss_ds.merged.samereadgroup.cleaned	2566642	2566648		YPO_RS12435	6
ARS007ss_ds.merged.samereadgroup.cleaned	2566864	2566930		YPO_RS12440	66
ARS007ss_ds.merged.samereadgroup.cleaned	2567280	2567288		YPO_RS12440	8
ARS007ss_ds.merged.samereadgroup.cleaned	2568118	2568124		YPO_RS12445	6
ARS007ss_ds.merged.samereadgroup.cleaned	2568166	2568169		YPO_RS12445	3
ARS007ss_ds.merged.samereadgroup.cleaned	2568630	2568654		YPO_RS12445	24
ARS007ss_ds.merged.samereadgroup.cleaned	2569420	2569431		YPO_RS12445	11
ARS007ss_ds.merged.samereadgroup.cleaned	2569933	2569956		YPO_RS12450	23
ARS007ss_ds.merged.samereadgroup.cleaned	2570557	2570564		YPO_RS12450	7
ARS007ss_ds.merged.samereadgroup.cleaned	2571545	2571549		YPO_RS12455	4
ARS007ss_ds.merged.samereadgroup.cleaned	2572466	2572476		YPO_RS12455	10
ARS007ss_ds.merged.samereadgroup.cleaned	2572991	2572996		YPO_RS12455	5
ARS007ss_ds.merged.samereadgroup.cleaned	2573725	2573729		YPO_RS12455	4
ARS007ss_ds.merged.samereadgroup.cleaned	2574832	2574875		YPO_RS12460	43
ARS007ss_ds.merged.samereadgroup.cleaned	2574949	2574961		YPO_RS12460	12
ARS007ss_ds.merged.samereadgroup.cleaned	2575032	2575047		YPO_RS12460	15
ARS007ss_ds.merged.samereadgroup.cleaned	2575266	2575267		YPO_RS12460	1
ARS007ss_ds.merged.samereadgroup.cleaned	2575496	2575532		YPO_RS12460	36
ARS007ss_ds.merged.samereadgroup.cleaned	2576623	2576663		YPO_RS12460	40
ARS007ss_ds.merged.samereadgroup.cleaned	2576701	2576716		YPO_RS12460	15
ARS007ss_ds.merged.samereadgroup.cleaned	2577425	2577460		YPO_RS12465	35
ARS007ss_ds.merged.samereadgroup.cleaned	2577791	2577805		YPO_RS12465	14
ARS007ss_ds.merged.samereadgroup.cleaned	2579302	2579303		ilvB	1
ARS007ss_ds.merged.samereadgroup.cleaned	2580588	2580596		yjjG	8
ARS007ss_ds.merged.samereadgroup.cleaned	2580655	2580667		yjjG	12
ARS007ss_ds.merged.samereadgroup.cleaned	2581241	2581246		YPO_RS12490	5
ARS007ss_ds.merged.samereadgroup.cleaned	2581606	2581610		YPO_RS12490	4
ARS007ss_ds.merged.samereadgroup.cleaned	2581911	2581912		YPO_RS12490	1
ARS007ss_ds.merged.samereadgroup.cleaned	2582120	2582126		YPO_RS12490	6
ARS007ss_ds.merged.samereadgroup.cleaned	2582248	2582256		YPO_RS12490	8
ARS007ss_ds.merged.samereadgroup.cleaned	2582658	2582666		YPO_RS12495	8
ARS007ss_ds.merged.samereadgroup.cleaned	2582816	2582826		YPO_RS12495	10
ARS007ss_ds.merged.samereadgroup.cleaned	2583199	2583205		YPO_RS12495	6
ARS007ss_ds.merged.samereadgroup.cleaned	2583401	2583407		YPO_RS12495	6
ARS007ss_ds.merged.samereadgroup.cleaned	2583587	2583596		YPO_RS12495	9
ARS007ss_ds.merged.samereadgroup.cleaned	2584723	2584740		phoA	17
ARS007ss_ds.merged.samereadgroup.cleaned	2585047	2585060		phoA	13
ARS007ss_ds.merged.samereadgroup.cleaned	2586321	2586386		ogt	65
ARS007ss_ds.merged.samereadgroup.cleaned	2588280	2588291		uspE	11
ARS007ss_ds.merged.samereadgroup.cleaned	2588900	2588902		pntB	2
ARS007ss_ds.merged.samereadgroup.cleaned	2589032	2589037		pntB	5
ARS007ss_ds.merged.samereadgroup.cleaned	2589129	2589151		pntB	22
ARS007ss_ds.merged.samereadgroup.cleaned	2589252	2589253		pntB	1
ARS007ss_ds.merged.samereadgroup.cleaned	2589418	2589419		pntB	1
ARS007ss_ds.merged.samereadgroup.cleaned	2589528	2589529		pntB	1
ARS007ss_ds.merged.samereadgroup.cleaned	2590090	2590091		pntA	1
ARS007ss_ds.merged.samereadgroup.cleaned	2590251	2590269		pntA	18
ARS007ss_ds.merged.samereadgroup.cleaned	2590786	2590787		pntA	1
ARS007ss_ds.merged.samereadgroup.cleaned	2591064	2591080		pntA	16
ARS007ss_ds.merged.samereadgroup.cleaned	2591163	2591169		pntA	6
ARS007ss_ds.merged.samereadgroup.cleaned	2592974	2592995		YPO_RS12530	21
ARS007ss_ds.merged.samereadgroup.cleaned	2593765	2593775		YPO_RS12535	10
ARS007ss_ds.merged.samereadgroup.cleaned	2594071	2594087		YPO_RS12535	16
ARS007ss_ds.merged.samereadgroup.cleaned	2594159	2594160		YPO_RS12535	1
ARS007ss_ds.merged.samereadgroup.cleaned	2594228	2594255		YPO_RS12535	27
ARS007ss_ds.merged.samereadgroup.cleaned	2594438	2594443		YPO_RS12535	5
ARS007ss_ds.merged.samereadgroup.cleaned	2595657	2595662		rstA	5
ARS007ss_ds.merged.samereadgroup.cleaned	2596724	2596743		rstB	19
ARS007ss_ds.merged.samereadgroup.cleaned	2596822	2596827		rstB	5
ARS007ss_ds.merged.samereadgroup.cleaned	2596864	2596869		rstB	5
ARS007ss_ds.merged.samereadgroup.cleaned	2597434	2597435		rstB	1
ARS007ss_ds.merged.samereadgroup.cleaned	2598187	2598199		YPO_RS12555	12
ARS007ss_ds.merged.samereadgroup.cleaned	2605090	2605104		YPO_RS12580	14
ARS007ss_ds.merged.samereadgroup.cleaned	2605197	2605213		YPO_RS12580	16
ARS007ss_ds.merged.samereadgroup.cleaned	2606362	2606414		asr	52
ARS007ss_ds.merged.samereadgroup.cleaned	2607300	2607319		YPO_RS12590	19
ARS007ss_ds.merged.samereadgroup.cleaned	2607784	2607801		YPO_RS12595	17
ARS007ss_ds.merged.samereadgroup.cleaned	2608133	2608150		YPO_RS12600	17
ARS007ss_ds.merged.samereadgroup.cleaned	2608310	2608323		YPO_RS12600	13
ARS007ss_ds.merged.samereadgroup.cleaned	2609133	2609139		hrpA	6
ARS007ss_ds.merged.samereadgroup.cleaned	2609242	2609258		hrpA	16
ARS007ss_ds.merged.samereadgroup.cleaned	2609410	2609422		hrpA	12
ARS007ss_ds.merged.samereadgroup.cleaned	2610049	2610050		hrpA	1
ARS007ss_ds.merged.samereadgroup.cleaned	2610175	2610176		hrpA	1
ARS007ss_ds.merged.samereadgroup.cleaned	2610577	2610578		hrpA	1
ARS007ss_ds.merged.samereadgroup.cleaned	2610620	2610624		hrpA	4
ARS007ss_ds.merged.samereadgroup.cleaned	2610786	2610793		hrpA	7
ARS007ss_ds.merged.samereadgroup.cleaned	2611954	2611981		hrpA	27
ARS007ss_ds.merged.samereadgroup.cleaned	2613932	2613941		YPO_RS12615	9
ARS007ss_ds.merged.samereadgroup.cleaned	2614249	2614255		YPO_RS12615	6
ARS007ss_ds.merged.samereadgroup.cleaned	2615070	2615079		YPO_RS12620	9
ARS007ss_ds.merged.samereadgroup.cleaned	2615263	2615279		YPO_RS12620	16
ARS007ss_ds.merged.samereadgroup.cleaned	2615535	2615543		YPO_RS12620	8
ARS007ss_ds.merged.samereadgroup.cleaned	2616857	2616860		YPO_RS12625	3
ARS007ss_ds.merged.samereadgroup.cleaned	2617007	2617009		YPO_RS12630	2
ARS007ss_ds.merged.samereadgroup.cleaned	2617818	2617829		YPO_RS12635	11
ARS007ss_ds.merged.samereadgroup.cleaned	2620953	2620966		YPO_RS12640	13
ARS007ss_ds.merged.samereadgroup.cleaned	2621526	2621537		hslJ	11
ARS007ss_ds.merged.samereadgroup.cleaned	2621851	2621852		YPO_RS12650	1
ARS007ss_ds.merged.samereadgroup.cleaned	2622457	2622466		YPO_RS12655	9
ARS007ss_ds.merged.samereadgroup.cleaned	2622543	2622551		YPO_RS12655	8
ARS007ss_ds.merged.samereadgroup.cleaned	2622622	2622624		YPO_RS12655	2
ARS007ss_ds.merged.samereadgroup.cleaned	2622867	2622870		YPO_RS12655	3
ARS007ss_ds.merged.samereadgroup.cleaned	2622975	2623003		YPO_RS12660	28
ARS007ss_ds.merged.samereadgroup.cleaned	2623842	2623852		nifJ	10
ARS007ss_ds.merged.samereadgroup.cleaned	2624773	2624781		nifJ	8
ARS007ss_ds.merged.samereadgroup.cleaned	2625295	2625313		nifJ	18
ARS007ss_ds.merged.samereadgroup.cleaned	2625902	2625915		nifJ	13
ARS007ss_ds.merged.samereadgroup.cleaned	2626312	2626378		nifJ	66
ARS007ss_ds.merged.samereadgroup.cleaned	2629290	2629296		YPO_RS12675	6
ARS007ss_ds.merged.samereadgroup.cleaned	2629404	2629416		YPO_RS12675	12
ARS007ss_ds.merged.samereadgroup.cleaned	2630107	2630112		YPO_RS12680	5
ARS007ss_ds.merged.samereadgroup.cleaned	2630519	2630529		YPO_RS12680	10
ARS007ss_ds.merged.samereadgroup.cleaned	2630658	2630678		YPO_RS12680	20
ARS007ss_ds.merged.samereadgroup.cleaned	2631381	2631382		zntB	1
ARS007ss_ds.merged.samereadgroup.cleaned	2631418	2631425		zntB	7
ARS007ss_ds.merged.samereadgroup.cleaned	2631521	2631523		zntB	2
ARS007ss_ds.merged.samereadgroup.cleaned	2632221	2632229		zntB	8
ARS007ss_ds.merged.samereadgroup.cleaned	2632639	2632644		YPO_RS12690	5
ARS007ss_ds.merged.samereadgroup.cleaned	2632880	2632899		YPO_RS12690	19
ARS007ss_ds.merged.samereadgroup.cleaned	2632997	2632999		YPO_RS12690	2
ARS007ss_ds.merged.samereadgroup.cleaned	2633536	2633564		YPO_RS12690	28
ARS007ss_ds.merged.samereadgroup.cleaned	2634711	2634718		mpaA	7
ARS007ss_ds.merged.samereadgroup.cleaned	2635352	2635367		ycjG	15
ARS007ss_ds.merged.samereadgroup.cleaned	2638719	2638753		tyrR	34
ARS007ss_ds.merged.samereadgroup.cleaned	2639238	2639240		tyrR	2
ARS007ss_ds.merged.samereadgroup.cleaned	2640403	2640418		YPO_RS12725	15
ARS007ss_ds.merged.samereadgroup.cleaned	2640510	2640521		YPO_RS12725	11
ARS007ss_ds.merged.samereadgroup.cleaned	2641849	2641851		YPO_RS12735	2
ARS007ss_ds.merged.samereadgroup.cleaned	2642500	2642508		YPO_RS12735	8
ARS007ss_ds.merged.samereadgroup.cleaned	2642987	2643000		YPO_RS12735	13
ARS007ss_ds.merged.samereadgroup.cleaned	2645271	2645278		pspF	7
ARS007ss_ds.merged.samereadgroup.cleaned	2645908	2645945		pspF	37
ARS007ss_ds.merged.samereadgroup.cleaned	2646103	2646106		pspF	3
ARS007ss_ds.merged.samereadgroup.cleaned	2647700	2647710		sapA	10
ARS007ss_ds.merged.samereadgroup.cleaned	2648063	2648072		sapA	9
ARS007ss_ds.merged.samereadgroup.cleaned	2648222	2648234		sapA	12
ARS007ss_ds.merged.samereadgroup.cleaned	2648336	2648339		sapA	3
ARS007ss_ds.merged.samereadgroup.cleaned	2649086	2649087		sapA	1
ARS007ss_ds.merged.samereadgroup.cleaned	2649206	2649212		sapB	6
ARS007ss_ds.merged.samereadgroup.cleaned	2649585	2649597		sapB	12
ARS007ss_ds.merged.samereadgroup.cleaned	2649872	2649891		sapB	19
ARS007ss_ds.merged.samereadgroup.cleaned	2649977	2650001		sapB	24
ARS007ss_ds.merged.samereadgroup.cleaned	2650346	2650353		sapC	7
ARS007ss_ds.merged.samereadgroup.cleaned	2650465	2650477		sapC	12
ARS007ss_ds.merged.samereadgroup.cleaned	2650602	2650615		sapC	13
ARS007ss_ds.merged.samereadgroup.cleaned	2651764	2651770		sapD	6
ARS007ss_ds.merged.samereadgroup.cleaned	2652200	2652203		sapF	3
ARS007ss_ds.merged.samereadgroup.cleaned	2652361	2652373		sapF	12
ARS007ss_ds.merged.samereadgroup.cleaned	2653629	2653643		YPO_RS12795	14
ARS007ss_ds.merged.samereadgroup.cleaned	2653747	2653796		YPO_RS12795	49
ARS007ss_ds.merged.samereadgroup.cleaned	2653843	2653858		YPO_RS12795	15
ARS007ss_ds.merged.samereadgroup.cleaned	2654200	2654205		YPO_RS12795	5
ARS007ss_ds.merged.samereadgroup.cleaned	2655181	2655204		dtpA	23
ARS007ss_ds.merged.samereadgroup.cleaned	2656223	2656273		dtpA	50
ARS007ss_ds.merged.samereadgroup.cleaned	2657914	2657918		YPO_RS12810	4
ARS007ss_ds.merged.samereadgroup.cleaned	2660236	2660237		gstA	1
ARS007ss_ds.merged.samereadgroup.cleaned	2660565	2660583		gstA	18
ARS007ss_ds.merged.samereadgroup.cleaned	2660706	2660707		gstA	1
ARS007ss_ds.merged.samereadgroup.cleaned	2661308	2661323		pdxY	15
ARS007ss_ds.merged.samereadgroup.cleaned	2663756	2663761		pdxH	5
ARS007ss_ds.merged.samereadgroup.cleaned	2663769	2663771		pdxH	2
ARS007ss_ds.merged.samereadgroup.cleaned	2664109	2664112		YPO_RS12845	3
ARS007ss_ds.merged.samereadgroup.cleaned	2664620	2664628		anmK	8
ARS007ss_ds.merged.samereadgroup.cleaned	2665412	2665413		anmK	1
ARS007ss_ds.merged.samereadgroup.cleaned	2666125	2666137		YPO_RS12855	12
ARS007ss_ds.merged.samereadgroup.cleaned	2666229	2666238		YPO_RS12855	9
ARS007ss_ds.merged.samereadgroup.cleaned	2668642	2668656		YPO_RS12865	14
ARS007ss_ds.merged.samereadgroup.cleaned	2670009	2670011		eptA	2
ARS007ss_ds.merged.samereadgroup.cleaned	2670066	2670067		eptA	1
ARS007ss_ds.merged.samereadgroup.cleaned	2670398	2670405		eptA	7
ARS007ss_ds.merged.samereadgroup.cleaned	2670728	2670749		eptA	21
ARS007ss_ds.merged.samereadgroup.cleaned	2670905	2670907		eptA	2
ARS007ss_ds.merged.samereadgroup.cleaned	2671213	2671231		YPO_RS12880	18
ARS007ss_ds.merged.samereadgroup.cleaned	2671467	2671472		YPO_RS12880	5
ARS007ss_ds.merged.samereadgroup.cleaned	2672101	2672118		YPO_RS12885	17
ARS007ss_ds.merged.samereadgroup.cleaned	2672159	2672161		YPO_RS12885	2
ARS007ss_ds.merged.samereadgroup.cleaned	2672616	2672618		YPO_RS12885	2
ARS007ss_ds.merged.samereadgroup.cleaned	2672971	2672988		YPO_RS12885	17
ARS007ss_ds.merged.samereadgroup.cleaned	2673783	2673794		YPO_RS12890	11
ARS007ss_ds.merged.samereadgroup.cleaned	2674571	2674596		YPO_RS12890	25
ARS007ss_ds.merged.samereadgroup.cleaned	2674931	2674936		YPO_RS12890	5
ARS007ss_ds.merged.samereadgroup.cleaned	2675040	2675068		YPO_RS12890	28
ARS007ss_ds.merged.samereadgroup.cleaned	2675951	2675954		YPO_RS12890	3
ARS007ss_ds.merged.samereadgroup.cleaned	2677014	2677034		rnt	20
ARS007ss_ds.merged.samereadgroup.cleaned	2677420	2677434		rnt	14
ARS007ss_ds.merged.samereadgroup.cleaned	2679210	2679223		YPO_RS12915	13
ARS007ss_ds.merged.samereadgroup.cleaned	2679547	2679552		YPO_RS12915	5
ARS007ss_ds.merged.samereadgroup.cleaned	2680451	2680477		sodB	26
ARS007ss_ds.merged.samereadgroup.cleaned	2681137	2681150		purR	13
ARS007ss_ds.merged.samereadgroup.cleaned	2682206	2682214		YPO_RS12935	8
ARS007ss_ds.merged.samereadgroup.cleaned	2683816	2683818		YPO_RS12940	2
ARS007ss_ds.merged.samereadgroup.cleaned	2685208	2685222		cfa	14
ARS007ss_ds.merged.samereadgroup.cleaned	2685802	2685804		cfa	2
ARS007ss_ds.merged.samereadgroup.cleaned	2686687	2686690		YPO_RS12950	3
ARS007ss_ds.merged.samereadgroup.cleaned	2686898	2686903		YPO_RS12950	5
ARS007ss_ds.merged.samereadgroup.cleaned	2687739	2687756		YPO_RS12960	17
ARS007ss_ds.merged.samereadgroup.cleaned	2689909	2689911		pykF	2
ARS007ss_ds.merged.samereadgroup.cleaned	2690511	2690512		pykF	1
ARS007ss_ds.merged.samereadgroup.cleaned	2694631	2694634		YPO_RS13000	3
ARS007ss_ds.merged.samereadgroup.cleaned	2695224	2695226		YPO_RS13000	2
ARS007ss_ds.merged.samereadgroup.cleaned	2695380	2695399		YPO_RS13000	19
ARS007ss_ds.merged.samereadgroup.cleaned	2696040	2696043		sufE	3
ARS007ss_ds.merged.samereadgroup.cleaned	2697031	2697041		sufS	10
ARS007ss_ds.merged.samereadgroup.cleaned	2697464	2697466		sufS	2
ARS007ss_ds.merged.samereadgroup.cleaned	2698203	2698207		sufD	4
ARS007ss_ds.merged.samereadgroup.cleaned	2698450	2698463		sufD	13
ARS007ss_ds.merged.samereadgroup.cleaned	2699229	2699230		sufC	1
ARS007ss_ds.merged.samereadgroup.cleaned	2699595	2699607		sufC	12
ARS007ss_ds.merged.samereadgroup.cleaned	2700086	2700087		sufB	1
ARS007ss_ds.merged.samereadgroup.cleaned	2700573	2700581		sufB	8
ARS007ss_ds.merged.samereadgroup.cleaned	2702532	2702547		YPO_RS13035	15
ARS007ss_ds.merged.samereadgroup.cleaned	2703008	2703023		YPO_RS13040	15
ARS007ss_ds.merged.samereadgroup.cleaned	2703289	2703298		YPO_RS13040	9
ARS007ss_ds.merged.samereadgroup.cleaned	2703796	2703826		YPO_RS13040	30
ARS007ss_ds.merged.samereadgroup.cleaned	2704554	2704572		YPO_RS13040	18
ARS007ss_ds.merged.samereadgroup.cleaned	2704645	2704667		YPO_RS13040	22
ARS007ss_ds.merged.samereadgroup.cleaned	2705373	2705389		YPO_RS13040	16
ARS007ss_ds.merged.samereadgroup.cleaned	2706987	2706989		ydiK	2
ARS007ss_ds.merged.samereadgroup.cleaned	2707358	2707406		ydiK	48
ARS007ss_ds.merged.samereadgroup.cleaned	2707995	2708029		rprA	34
ARS007ss_ds.merged.samereadgroup.cleaned	2708875	2708881		ppsA	6
ARS007ss_ds.merged.samereadgroup.cleaned	2708954	2708967		ppsA	13
ARS007ss_ds.merged.samereadgroup.cleaned	2709346	2709363		ppsA	17
ARS007ss_ds.merged.samereadgroup.cleaned	2709598	2709603		ppsA	5
ARS007ss_ds.merged.samereadgroup.cleaned	2709913	2709940		ppsA	27
ARS007ss_ds.merged.samereadgroup.cleaned	2710096	2710106		ppsA	10
ARS007ss_ds.merged.samereadgroup.cleaned	2712400	2712409		YPO_RS13065	9
ARS007ss_ds.merged.samereadgroup.cleaned	2712637	2712649		YPO_RS13065	12
ARS007ss_ds.merged.samereadgroup.cleaned	2712684	2712690		YPO_RS13065	6
ARS007ss_ds.merged.samereadgroup.cleaned	2714918	2714926		YPO_RS13075	8
ARS007ss_ds.merged.samereadgroup.cleaned	2716034	2716057		YPO_RS13080	23
ARS007ss_ds.merged.samereadgroup.cleaned	2716144	2716164		YPO_RS13080	20
ARS007ss_ds.merged.samereadgroup.cleaned	2716231	2716250		YPO_RS13080	19
ARS007ss_ds.merged.samereadgroup.cleaned	2716243	2716250		YPO_RS13085	7
ARS007ss_ds.merged.samereadgroup.cleaned	2716893	2716901		arnF	8
ARS007ss_ds.merged.samereadgroup.cleaned	2716939	2716967		arnF	28
ARS007ss_ds.merged.samereadgroup.cleaned	2716965	2716967		arnE	2
ARS007ss_ds.merged.samereadgroup.cleaned	2717283	2717288		arnE	5
ARS007ss_ds.merged.samereadgroup.cleaned	2717996	2718007		arnT	11
ARS007ss_ds.merged.samereadgroup.cleaned	2718135	2718179		arnT	44
ARS007ss_ds.merged.samereadgroup.cleaned	2718385	2718393		arnT	8
ARS007ss_ds.merged.samereadgroup.cleaned	2718579	2718597		arnT	18
ARS007ss_ds.merged.samereadgroup.cleaned	2719835	2719837		YPO_RS13105	2
ARS007ss_ds.merged.samereadgroup.cleaned	2720698	2720707		arnA	9
ARS007ss_ds.merged.samereadgroup.cleaned	2721413	2721421		arnA	8
ARS007ss_ds.merged.samereadgroup.cleaned	2722173	2722177		arnC	4
ARS007ss_ds.merged.samereadgroup.cleaned	2722811	2722815		arnC	4
ARS007ss_ds.merged.samereadgroup.cleaned	2723422	2723443		arnB	21
ARS007ss_ds.merged.samereadgroup.cleaned	2724465	2724479		btuD	14
ARS007ss_ds.merged.samereadgroup.cleaned	2724612	2724620		btuD	8
ARS007ss_ds.merged.samereadgroup.cleaned	2724876	2724893		btuD	17
ARS007ss_ds.merged.samereadgroup.cleaned	2726154	2726155		btuC	1
ARS007ss_ds.merged.samereadgroup.cleaned	2727298	2727316		YPO_RS13140	18
ARS007ss_ds.merged.samereadgroup.cleaned	2729769	2729775		pheT	6
ARS007ss_ds.merged.samereadgroup.cleaned	2730169	2730171		pheT	2
ARS007ss_ds.merged.samereadgroup.cleaned	2730370	2730371		pheT	1
ARS007ss_ds.merged.samereadgroup.cleaned	2731163	2731169		pheS	6
ARS007ss_ds.merged.samereadgroup.cleaned	2731337	2731344		pheS	7
ARS007ss_ds.merged.samereadgroup.cleaned	2732181	2732184		rplT	3
ARS007ss_ds.merged.samereadgroup.cleaned	2733499	2733500		thrS	1
ARS007ss_ds.merged.samereadgroup.cleaned	2734065	2734077		thrS	12
ARS007ss_ds.merged.samereadgroup.cleaned	2734151	2734154		thrS	3
ARS007ss_ds.merged.samereadgroup.cleaned	2734997	2734999		thrS	2
ARS007ss_ds.merged.samereadgroup.cleaned	2737144	2737149		YPO_RS13195	5
ARS007ss_ds.merged.samereadgroup.cleaned	2737289	2737293		YPO_RS13195	4
ARS007ss_ds.merged.samereadgroup.cleaned	2737731	2737746		YPO_RS13195	15
ARS007ss_ds.merged.samereadgroup.cleaned	2739035	2739042		yfeA	7
ARS007ss_ds.merged.samereadgroup.cleaned	2739178	2739193		yfeA	15
ARS007ss_ds.merged.samereadgroup.cleaned	2741204	2741219		yfeC	15
ARS007ss_ds.merged.samereadgroup.cleaned	2741279	2741283		yfeC	4
ARS007ss_ds.merged.samereadgroup.cleaned	2742274	2742286		yfeD	12
ARS007ss_ds.merged.samereadgroup.cleaned	2742369	2742371		yfeD	2
ARS007ss_ds.merged.samereadgroup.cleaned	2742493	2742494		YPO_RS13225	1
ARS007ss_ds.merged.samereadgroup.cleaned	2742890	2742905		YPO_RS13230	15
ARS007ss_ds.merged.samereadgroup.cleaned	2742994	2743003		YPO_RS13230	9
ARS007ss_ds.merged.samereadgroup.cleaned	2743228	2743270		YPO_RS13230	42
ARS007ss_ds.merged.samereadgroup.cleaned	2747570	2747583		solA	13
ARS007ss_ds.merged.samereadgroup.cleaned	2748116	2748117		solA	1
ARS007ss_ds.merged.samereadgroup.cleaned	2748578	2748605		YPO_RS13255	27
ARS007ss_ds.merged.samereadgroup.cleaned	2748809	2748860		YPO_RS13255	51
ARS007ss_ds.merged.samereadgroup.cleaned	2749119	2749126		YPO_RS13255	7
ARS007ss_ds.merged.samereadgroup.cleaned	2750020	2750037		YPO_RS13265	17
ARS007ss_ds.merged.samereadgroup.cleaned	2750102	2750105		YPO_RS13265	3
ARS007ss_ds.merged.samereadgroup.cleaned	2750272	2750299		YPO_RS13265	27
ARS007ss_ds.merged.samereadgroup.cleaned	2750741	2750756		YPO_RS13265	15
ARS007ss_ds.merged.samereadgroup.cleaned	2751967	2751972		YPO_RS13270	5
ARS007ss_ds.merged.samereadgroup.cleaned	2753041	2753042		YPO_RS13280	1
ARS007ss_ds.merged.samereadgroup.cleaned	2753240	2753242		YPO_RS13280	2
ARS007ss_ds.merged.samereadgroup.cleaned	2754244	2754300		YPO_RS13285	56
ARS007ss_ds.merged.samereadgroup.cleaned	2755173	2755179		YPO_RS13290	6
ARS007ss_ds.merged.samereadgroup.cleaned	2755461	2755488		YPO_RS13290	27
ARS007ss_ds.merged.samereadgroup.cleaned	2756215	2756230		YPO_RS13295	15
ARS007ss_ds.merged.samereadgroup.cleaned	2756673	2756683		YPO_RS13295	10
ARS007ss_ds.merged.samereadgroup.cleaned	2756872	2756875		YPO_RS13295	3
ARS007ss_ds.merged.samereadgroup.cleaned	2757657	2757668		YPO_RS13305	11
ARS007ss_ds.merged.samereadgroup.cleaned	2758960	2758969		fae	9
ARS007ss_ds.merged.samereadgroup.cleaned	2759092	2759097		fae	5
ARS007ss_ds.merged.samereadgroup.cleaned	2759171	2759175		fae	4
ARS007ss_ds.merged.samereadgroup.cleaned	2759662	2759683		YPO_RS13315	21
ARS007ss_ds.merged.samereadgroup.cleaned	2760914	2760936		cas6f	22
ARS007ss_ds.merged.samereadgroup.cleaned	2761627	2761637		csy3	10
ARS007ss_ds.merged.samereadgroup.cleaned	2761986	2761999		csy2	13
ARS007ss_ds.merged.samereadgroup.cleaned	2763015	2763022		csy1	7
ARS007ss_ds.merged.samereadgroup.cleaned	2763432	2763437		csy1	5
ARS007ss_ds.merged.samereadgroup.cleaned	2764675	2764700		cas3f	25
ARS007ss_ds.merged.samereadgroup.cleaned	2765197	2765220		cas3f	23
ARS007ss_ds.merged.samereadgroup.cleaned	2765695	2765700		cas3f	5
ARS007ss_ds.merged.samereadgroup.cleaned	2766909	2766926		cas3f	17
ARS007ss_ds.merged.samereadgroup.cleaned	2767027	2767038		cas3f	11
ARS007ss_ds.merged.samereadgroup.cleaned	2767707	2767710		cas3f	3
ARS007ss_ds.merged.samereadgroup.cleaned	2768165	2768188		cas1f	23
ARS007ss_ds.merged.samereadgroup.cleaned	2768787	2768788		cas1f	1
ARS007ss_ds.merged.samereadgroup.cleaned	2770639	2770682		YPO_RS13350	43
ARS007ss_ds.merged.samereadgroup.cleaned	2770713	2770714		YPO_RS13350	1
ARS007ss_ds.merged.samereadgroup.cleaned	2771015	2771022		YPO_RS13350	7
ARS007ss_ds.merged.samereadgroup.cleaned	2771150	2771153		YPO_RS13350	3
ARS007ss_ds.merged.samereadgroup.cleaned	2772098	2772153		YPO_RS13355	55
ARS007ss_ds.merged.samereadgroup.cleaned	2772474	2772476		YPO_RS13355	2
ARS007ss_ds.merged.samereadgroup.cleaned	2772533	2772539		YPO_RS13355	6
ARS007ss_ds.merged.samereadgroup.cleaned	2773225	2773241		YPO_RS13355	16
ARS007ss_ds.merged.samereadgroup.cleaned	2773280	2773284		YPO_RS13360	4
ARS007ss_ds.merged.samereadgroup.cleaned	2773759	2773804		YPO_RS13360	45
ARS007ss_ds.merged.samereadgroup.cleaned	2774358	2774395		YPO_RS13360	37
ARS007ss_ds.merged.samereadgroup.cleaned	2774746	2774757		YPO_RS13365	11
ARS007ss_ds.merged.samereadgroup.cleaned	2775563	2775565		YPO_RS13370	2
ARS007ss_ds.merged.samereadgroup.cleaned	2775685	2775688		YPO_RS13370	3
ARS007ss_ds.merged.samereadgroup.cleaned	2776233	2776240		YPO_RS13370	7
ARS007ss_ds.merged.samereadgroup.cleaned	2776685	2776686		YPO_RS13375	1
ARS007ss_ds.merged.samereadgroup.cleaned	2777049	2777056		YPO_RS13375	7
ARS007ss_ds.merged.samereadgroup.cleaned	2777088	2777092		YPO_RS13375	4
ARS007ss_ds.merged.samereadgroup.cleaned	2777656	2777665		YPO_RS13380	9
ARS007ss_ds.merged.samereadgroup.cleaned	2778243	2778251		YPO_RS13380	8
ARS007ss_ds.merged.samereadgroup.cleaned	2780212	2780218		YPO_RS13390	6
ARS007ss_ds.merged.samereadgroup.cleaned	2781012	2781032		YPO_RS13390	20
ARS007ss_ds.merged.samereadgroup.cleaned	2783324	2783339		ugpC	15
ARS007ss_ds.merged.samereadgroup.cleaned	2783942	2783946		YPO_RS13405	4
ARS007ss_ds.merged.samereadgroup.cleaned	2785018	2785028		YPO_RS13410	10
ARS007ss_ds.merged.samereadgroup.cleaned	2785615	2785622		YPO_RS13415	7
ARS007ss_ds.merged.samereadgroup.cleaned	2786710	2786721		YPO_RS13430	11
ARS007ss_ds.merged.samereadgroup.cleaned	2786813	2786845		YPO_RS13430	32
ARS007ss_ds.merged.samereadgroup.cleaned	2786939	2786942		YPO_RS13430	3
ARS007ss_ds.merged.samereadgroup.cleaned	2787257	2787263		YPO_RS13430	6
ARS007ss_ds.merged.samereadgroup.cleaned	2788000	2788010		YPO_RS13430	10
ARS007ss_ds.merged.samereadgroup.cleaned	2788897	2788929		YPO_RS13435	32
ARS007ss_ds.merged.samereadgroup.cleaned	2789326	2789331		YPO_RS13440	5
ARS007ss_ds.merged.samereadgroup.cleaned	2789713	2789732		YPO_RS13445	19
ARS007ss_ds.merged.samereadgroup.cleaned	2789801	2789841		YPO_RS13445	40
ARS007ss_ds.merged.samereadgroup.cleaned	2789984	2789987		YPO_RS13445	3
ARS007ss_ds.merged.samereadgroup.cleaned	2790061	2790082		YPO_RS13445	21
ARS007ss_ds.merged.samereadgroup.cleaned	2792190	2792196		cdiA	6
ARS007ss_ds.merged.samereadgroup.cleaned	2792491	2792492		cdiA	1
ARS007ss_ds.merged.samereadgroup.cleaned	2792573	2792574		cdiA	1
ARS007ss_ds.merged.samereadgroup.cleaned	2792646	2792649		cdiA	3
ARS007ss_ds.merged.samereadgroup.cleaned	2792754	2792765		cdiA	11
ARS007ss_ds.merged.samereadgroup.cleaned	2792795	2792801		cdiA	6
ARS007ss_ds.merged.samereadgroup.cleaned	2792919	2792922		cdiA	3
ARS007ss_ds.merged.samereadgroup.cleaned	2793489	2793501		cdiA	12
ARS007ss_ds.merged.samereadgroup.cleaned	2793745	2793749		cdiA	4
ARS007ss_ds.merged.samereadgroup.cleaned	2794199	2794216		cdiA	17
ARS007ss_ds.merged.samereadgroup.cleaned	2794596	2794621		cdiA	25
ARS007ss_ds.merged.samereadgroup.cleaned	2794705	2794720		cdiA	15
ARS007ss_ds.merged.samereadgroup.cleaned	2794820	2794837		cdiA	17
ARS007ss_ds.merged.samereadgroup.cleaned	2795005	2795020		cdiA	15
ARS007ss_ds.merged.samereadgroup.cleaned	2795338	2795347		cdiA	9
ARS007ss_ds.merged.samereadgroup.cleaned	2795460	2795476		cdiA	16
ARS007ss_ds.merged.samereadgroup.cleaned	2795593	2795615		cdiA	22
ARS007ss_ds.merged.samereadgroup.cleaned	2795986	2796017		cdiA	31
ARS007ss_ds.merged.samereadgroup.cleaned	2796124	2796134		cdiA	10
ARS007ss_ds.merged.samereadgroup.cleaned	2796579	2796582		cdiA	3
ARS007ss_ds.merged.samereadgroup.cleaned	2796661	2796664		cdiA	3
ARS007ss_ds.merged.samereadgroup.cleaned	2796946	2796947		cdiA	1
ARS007ss_ds.merged.samereadgroup.cleaned	2797117	2797118		cdiA	1
ARS007ss_ds.merged.samereadgroup.cleaned	2797548	2797557		cdiA	9
ARS007ss_ds.merged.samereadgroup.cleaned	2799048	2799060		YPO_RS13455	12
ARS007ss_ds.merged.samereadgroup.cleaned	2799374	2799377		YPO_RS13455	3
ARS007ss_ds.merged.samereadgroup.cleaned	2801675	2801704		YPO_RS13465	29
ARS007ss_ds.merged.samereadgroup.cleaned	2801800	2801813		YPO_RS13465	13
ARS007ss_ds.merged.samereadgroup.cleaned	2803231	2803256		YPO_RS13470	25
ARS007ss_ds.merged.samereadgroup.cleaned	2803913	2803920		YPO_RS13470	7
ARS007ss_ds.merged.samereadgroup.cleaned	2805512	2805514		YPO_RS13475	2
ARS007ss_ds.merged.samereadgroup.cleaned	2807675	2807685		YPO_RS13485	10
ARS007ss_ds.merged.samereadgroup.cleaned	2807962	2807974		YPO_RS13485	12
ARS007ss_ds.merged.samereadgroup.cleaned	2808014	2808032		YPO_RS13485	18
ARS007ss_ds.merged.samereadgroup.cleaned	2808803	2808815		YPO_RS13490	12
ARS007ss_ds.merged.samereadgroup.cleaned	2808851	2808852		YPO_RS13490	1
ARS007ss_ds.merged.samereadgroup.cleaned	2809087	2809092		YPO_RS13490	5
ARS007ss_ds.merged.samereadgroup.cleaned	2809128	2809136		YPO_RS13490	8
ARS007ss_ds.merged.samereadgroup.cleaned	2809960	2809964		YPO_RS13495	4
ARS007ss_ds.merged.samereadgroup.cleaned	2810004	2810008		YPO_RS13495	4
ARS007ss_ds.merged.samereadgroup.cleaned	2810636	2810655		YPO_RS13495	19
ARS007ss_ds.merged.samereadgroup.cleaned	2811244	2811246		YPO_RS13500	2
ARS007ss_ds.merged.samereadgroup.cleaned	2811288	2811312		YPO_RS13500	24
ARS007ss_ds.merged.samereadgroup.cleaned	2811536	2811543		YPO_RS13500	7
ARS007ss_ds.merged.samereadgroup.cleaned	2813733	2813736		YPO_RS13510	3
ARS007ss_ds.merged.samereadgroup.cleaned	2813803	2813806		YPO_RS13510	3
ARS007ss_ds.merged.samereadgroup.cleaned	2814008	2814019		YPO_RS13510	11
ARS007ss_ds.merged.samereadgroup.cleaned	2814094	2814095		YPO_RS13510	1
ARS007ss_ds.merged.samereadgroup.cleaned	2814218	2814236		YPO_RS13510	18
ARS007ss_ds.merged.samereadgroup.cleaned	2814277	2814293		YPO_RS13510	16
ARS007ss_ds.merged.samereadgroup.cleaned	2814610	2814614		YPO_RS13515	4
ARS007ss_ds.merged.samereadgroup.cleaned	2814852	2814866		YPO_RS13515	14
ARS007ss_ds.merged.samereadgroup.cleaned	2815664	2815689		YPO_RS13520	25
ARS007ss_ds.merged.samereadgroup.cleaned	2815750	2815757		YPO_RS13520	7
ARS007ss_ds.merged.samereadgroup.cleaned	2815991	2815996		YPO_RS13520	5
ARS007ss_ds.merged.samereadgroup.cleaned	2816182	2816198		YPO_RS13520	16
ARS007ss_ds.merged.samereadgroup.cleaned	2816262	2816294		YPO_RS13520	32
ARS007ss_ds.merged.samereadgroup.cleaned	2816805	2816820		ompX	15
ARS007ss_ds.merged.samereadgroup.cleaned	2816964	2816970		ompX	6
ARS007ss_ds.merged.samereadgroup.cleaned	2818208	2818215		rhtA	7
ARS007ss_ds.merged.samereadgroup.cleaned	2818934	2818936		YPO_RS13535	2
ARS007ss_ds.merged.samereadgroup.cleaned	2819318	2819340		tam	22
ARS007ss_ds.merged.samereadgroup.cleaned	2821149	2821158		YPO_RS13550	9
ARS007ss_ds.merged.samereadgroup.cleaned	2822856	2822863		glnH	7
ARS007ss_ds.merged.samereadgroup.cleaned	2823392	2823421		glnP	29
ARS007ss_ds.merged.samereadgroup.cleaned	2823737	2823741		glnP	4
ARS007ss_ds.merged.samereadgroup.cleaned	2825613	2825627		YPO_RS13570	14
ARS007ss_ds.merged.samereadgroup.cleaned	2826096	2826110		YPO_RS13570	14
ARS007ss_ds.merged.samereadgroup.cleaned	2826170	2826172		YPO_RS13570	2
ARS007ss_ds.merged.samereadgroup.cleaned	2828427	2828449		YPO_RS13585	22
ARS007ss_ds.merged.samereadgroup.cleaned	2829153	2829198		rlmF	45
ARS007ss_ds.merged.samereadgroup.cleaned	2829471	2829472		rlmF	1
ARS007ss_ds.merged.samereadgroup.cleaned	2829569	2829574		rlmF	5
ARS007ss_ds.merged.samereadgroup.cleaned	2831191	2831228		ybiB	37
ARS007ss_ds.merged.samereadgroup.cleaned	2831727	2831733		ybiB	6
ARS007ss_ds.merged.samereadgroup.cleaned	2831817	2831827		ybiB	10
ARS007ss_ds.merged.samereadgroup.cleaned	2832324	2832326		menE	2
ARS007ss_ds.merged.samereadgroup.cleaned	2832543	2832575		menE	32
ARS007ss_ds.merged.samereadgroup.cleaned	2832630	2832660		menE	30
ARS007ss_ds.merged.samereadgroup.cleaned	2833252	2833256		menE	4
ARS007ss_ds.merged.samereadgroup.cleaned	2833408	2833422		menC	14
ARS007ss_ds.merged.samereadgroup.cleaned	2833639	2833641		menC	2
ARS007ss_ds.merged.samereadgroup.cleaned	2834052	2834064		menC	12
ARS007ss_ds.merged.samereadgroup.cleaned	2835614	2835615		menH	1
ARS007ss_ds.merged.samereadgroup.cleaned	2835838	2835839		menH	1
ARS007ss_ds.merged.samereadgroup.cleaned	2835992	2835998		menD	6
ARS007ss_ds.merged.samereadgroup.cleaned	2836040	2836045		menD	5
ARS007ss_ds.merged.samereadgroup.cleaned	2836228	2836261		menD	33
ARS007ss_ds.merged.samereadgroup.cleaned	2837127	2837131		menD	4
ARS007ss_ds.merged.samereadgroup.cleaned	2839128	2839133		menF	5
ARS007ss_ds.merged.samereadgroup.cleaned	2840403	2840423		YPO_RS13635	20
ARS007ss_ds.merged.samereadgroup.cleaned	2841032	2841045		YPO_RS13640	13
ARS007ss_ds.merged.samereadgroup.cleaned	2842584	2842593		YPO_RS13645	9
ARS007ss_ds.merged.samereadgroup.cleaned	2842818	2842823		YPO_RS13645	5
ARS007ss_ds.merged.samereadgroup.cleaned	2843551	2843555		YPO_RS13645	4
ARS007ss_ds.merged.samereadgroup.cleaned	2843742	2843765		YPO_RS13645	23
ARS007ss_ds.merged.samereadgroup.cleaned	2844806	2844820		YPO_RS13655	14
ARS007ss_ds.merged.samereadgroup.cleaned	2845491	2845496		YPO_RS13655	5
ARS007ss_ds.merged.samereadgroup.cleaned	2845593	2845609		YPO_RS13655	16
ARS007ss_ds.merged.samereadgroup.cleaned	2846741	2846757		YPO_RS13660	16
ARS007ss_ds.merged.samereadgroup.cleaned	2847112	2847117		YPO_RS13660	5
ARS007ss_ds.merged.samereadgroup.cleaned	2847312	2847323		YPO_RS13660	11
ARS007ss_ds.merged.samereadgroup.cleaned	2848121	2848123		YPO_RS13665	2
ARS007ss_ds.merged.samereadgroup.cleaned	2848287	2848307		YPO_RS13665	20
ARS007ss_ds.merged.samereadgroup.cleaned	2849822	2849823		YPO_RS13670	1
ARS007ss_ds.merged.samereadgroup.cleaned	2849978	2849988		YPO_RS13670	10
ARS007ss_ds.merged.samereadgroup.cleaned	2850085	2850102		YPO_RS13670	17
ARS007ss_ds.merged.samereadgroup.cleaned	2851890	2851894		idnO	4
ARS007ss_ds.merged.samereadgroup.cleaned	2852182	2852183		idnO	1
ARS007ss_ds.merged.samereadgroup.cleaned	2853266	2853272		YPO_RS13685	6
ARS007ss_ds.merged.samereadgroup.cleaned	2853312	2853313		YPO_RS13685	1
ARS007ss_ds.merged.samereadgroup.cleaned	2853936	2853951		YPO_RS13690	15
ARS007ss_ds.merged.samereadgroup.cleaned	2854060	2854069		YPO_RS13690	9
ARS007ss_ds.merged.samereadgroup.cleaned	2854143	2854145		YPO_RS13690	2
ARS007ss_ds.merged.samereadgroup.cleaned	2854267	2854274		YPO_RS13690	7
ARS007ss_ds.merged.samereadgroup.cleaned	2854322	2854323		YPO_RS13690	1
ARS007ss_ds.merged.samereadgroup.cleaned	2854782	2854791		YPO_RS13690	9
ARS007ss_ds.merged.samereadgroup.cleaned	2855989	2856006		nuoN	17
ARS007ss_ds.merged.samereadgroup.cleaned	2857703	2857718		nuoM	15
ARS007ss_ds.merged.samereadgroup.cleaned	2858165	2858170		nuoL	5
ARS007ss_ds.merged.samereadgroup.cleaned	2858326	2858342		nuoL	16
ARS007ss_ds.merged.samereadgroup.cleaned	2858539	2858540		nuoL	1
ARS007ss_ds.merged.samereadgroup.cleaned	2859598	2859647		nuoL	49
ARS007ss_ds.merged.samereadgroup.cleaned	2860204	2860209		nuoK	5
ARS007ss_ds.merged.samereadgroup.cleaned	2861164	2861168		nuoI	4
ARS007ss_ds.merged.samereadgroup.cleaned	2861307	2861317		nuoI	10
ARS007ss_ds.merged.samereadgroup.cleaned	2862466	2862485		nuoG	19
ARS007ss_ds.merged.samereadgroup.cleaned	2864765	2864767		nuoG	2
ARS007ss_ds.merged.samereadgroup.cleaned	2866196	2866226		nuoF	30
ARS007ss_ds.merged.samereadgroup.cleaned	2868175	2868176		nuoC	1
ARS007ss_ds.merged.samereadgroup.cleaned	2868382	2868383		nuoC	1
ARS007ss_ds.merged.samereadgroup.cleaned	2868472	2868475		nuoC	3
ARS007ss_ds.merged.samereadgroup.cleaned	2868771	2868796		nuoC	25
ARS007ss_ds.merged.samereadgroup.cleaned	2869600	2869617		YPO_RS13750	17
ARS007ss_ds.merged.samereadgroup.cleaned	2871152	2871163		lrhA	11
ARS007ss_ds.merged.samereadgroup.cleaned	2871848	2871864		lrhA	16
ARS007ss_ds.merged.samereadgroup.cleaned	2873069	2873071		YPO_RS13765	2
ARS007ss_ds.merged.samereadgroup.cleaned	2876463	2876466		YPO_RS13775	3
ARS007ss_ds.merged.samereadgroup.cleaned	2876726	2876728		YPO_RS13775	2
ARS007ss_ds.merged.samereadgroup.cleaned	2877634	2877635		YPO_RS13780	1
ARS007ss_ds.merged.samereadgroup.cleaned	2877832	2877836		YPO_RS13780	4
ARS007ss_ds.merged.samereadgroup.cleaned	2879159	2879161		YPO_RS13790	2
ARS007ss_ds.merged.samereadgroup.cleaned	2880065	2880095		ackA	30
ARS007ss_ds.merged.samereadgroup.cleaned	2880374	2880377		ackA	3
ARS007ss_ds.merged.samereadgroup.cleaned	2880441	2880457		ackA	16
ARS007ss_ds.merged.samereadgroup.cleaned	2882870	2882872		pta	2
ARS007ss_ds.merged.samereadgroup.cleaned	2885167	2885190		YPO_RS13810	23
ARS007ss_ds.merged.samereadgroup.cleaned	2885545	2885570		YPO_RS13815	25
ARS007ss_ds.merged.samereadgroup.cleaned	2885777	2885790		YPO_RS13815	13
ARS007ss_ds.merged.samereadgroup.cleaned	2887092	2887243		YPO_RS13825	151
ARS007ss_ds.merged.samereadgroup.cleaned	2887277	2887932		YPO_RS13825	655
ARS007ss_ds.merged.samereadgroup.cleaned	2887989	2893967		YPO_RS13830	5978
ARS007ss_ds.merged.samereadgroup.cleaned	2894374	2894582		YPO_RS13835	208
ARS007ss_ds.merged.samereadgroup.cleaned	2894615	2894922		YPO_RS13835	307
ARS007ss_ds.merged.samereadgroup.cleaned	2895617	2896471		YPO_RS13840	854
ARS007ss_ds.merged.samereadgroup.cleaned	2896777	2897241		YPO_RS13845	464
ARS007ss_ds.merged.samereadgroup.cleaned	2897282	2897314		YPO_RS13845	32
ARS007ss_ds.merged.samereadgroup.cleaned	2897369	2898091		YPO_RS13845	722
ARS007ss_ds.merged.samereadgroup.cleaned	2898146	2898303		YPO_RS13845	157
ARS007ss_ds.merged.samereadgroup.cleaned	2898338	2898768		iolD	430
ARS007ss_ds.merged.samereadgroup.cleaned	2898801	2900263		iolD	1462
ARS007ss_ds.merged.samereadgroup.cleaned	2901775	2901795		YPO_RS13860	20
ARS007ss_ds.merged.samereadgroup.cleaned	2901836	2901844		YPO_RS13860	8
ARS007ss_ds.merged.samereadgroup.cleaned	2902900	2902905		YPO_RS13865	5
ARS007ss_ds.merged.samereadgroup.cleaned	2903294	2903316		YPO_RS13865	22
ARS007ss_ds.merged.samereadgroup.cleaned	2903364	2903366		YPO_RS13865	2
ARS007ss_ds.merged.samereadgroup.cleaned	2903904	2903915		YPO_RS13865	11
ARS007ss_ds.merged.samereadgroup.cleaned	2904384	2904390		YPO_RS13870	6
ARS007ss_ds.merged.samereadgroup.cleaned	2904738	2904743		YPO_RS13870	5
ARS007ss_ds.merged.samereadgroup.cleaned	2905037	2905041		YPO_RS13870	4
ARS007ss_ds.merged.samereadgroup.cleaned	2905506	2905520		YPO_RS13875	14
ARS007ss_ds.merged.samereadgroup.cleaned	2905738	2905765		YPO_RS13875	27
ARS007ss_ds.merged.samereadgroup.cleaned	2905961	2905972		YPO_RS13875	11
ARS007ss_ds.merged.samereadgroup.cleaned	2906518	2906524		iolC	6
ARS007ss_ds.merged.samereadgroup.cleaned	2907084	2907087		iolC	3
ARS007ss_ds.merged.samereadgroup.cleaned	2907261	2907266		iolC	5
ARS007ss_ds.merged.samereadgroup.cleaned	2907401	2907414		iolC	13
ARS007ss_ds.merged.samereadgroup.cleaned	2907553	2907562		iolC	9
ARS007ss_ds.merged.samereadgroup.cleaned	2908164	2908212		iolC	48
ARS007ss_ds.merged.samereadgroup.cleaned	2909010	2909025		iolE	15
ARS007ss_ds.merged.samereadgroup.cleaned	2909475	2909503		iolB	28
ARS007ss_ds.merged.samereadgroup.cleaned	2910203	2910226		iolB	23
ARS007ss_ds.merged.samereadgroup.cleaned	2910261	2910290		iolB	29
ARS007ss_ds.merged.samereadgroup.cleaned	2910601	2910602		YPO_RS13895	1
ARS007ss_ds.merged.samereadgroup.cleaned	2910973	2910990		YPO_RS13900	17
ARS007ss_ds.merged.samereadgroup.cleaned	2912388	2912390		YPO_RS13900	2
ARS007ss_ds.merged.samereadgroup.cleaned	2912892	2912896		YPO_RS13905	4
ARS007ss_ds.merged.samereadgroup.cleaned	2913565	2913581		YPO_RS13910	16
ARS007ss_ds.merged.samereadgroup.cleaned	2913697	2913710		YPO_RS13915	13
ARS007ss_ds.merged.samereadgroup.cleaned	2913995	2913996		YPO_RS13920	1
ARS007ss_ds.merged.samereadgroup.cleaned	2914576	2914592		YPO_RS13920	16
ARS007ss_ds.merged.samereadgroup.cleaned	2915418	2915436		YPO_RS13925	18
ARS007ss_ds.merged.samereadgroup.cleaned	2915971	2915974		YPO_RS13925	3
ARS007ss_ds.merged.samereadgroup.cleaned	2918042	2918046		crcB	4
ARS007ss_ds.merged.samereadgroup.cleaned	2918701	2918723		tatA	22
ARS007ss_ds.merged.samereadgroup.cleaned	2919622	2919641		lipA	19
ARS007ss_ds.merged.samereadgroup.cleaned	2920366	2920385		lipB	19
ARS007ss_ds.merged.samereadgroup.cleaned	2920592	2920598		lipB	6
ARS007ss_ds.merged.samereadgroup.cleaned	2920882	2920889		lipB	7
ARS007ss_ds.merged.samereadgroup.cleaned	2922329	2922337		dacA	8
ARS007ss_ds.merged.samereadgroup.cleaned	2922418	2922427		dacA	9
ARS007ss_ds.merged.samereadgroup.cleaned	2923211	2923216		rlpA	5
ARS007ss_ds.merged.samereadgroup.cleaned	2926640	2926656		mrdA	16
ARS007ss_ds.merged.samereadgroup.cleaned	2927256	2927261		mrdA	5
ARS007ss_ds.merged.samereadgroup.cleaned	2927637	2927640		rlmH	3
ARS007ss_ds.merged.samereadgroup.cleaned	2929099	2929121		nadD	22
ARS007ss_ds.merged.samereadgroup.cleaned	2931784	2931789		leuS	5
ARS007ss_ds.merged.samereadgroup.cleaned	2931908	2931918		leuS	10
ARS007ss_ds.merged.samereadgroup.cleaned	2932477	2932493		leuS	16
ARS007ss_ds.merged.samereadgroup.cleaned	2932735	2932736		leuS	1
ARS007ss_ds.merged.samereadgroup.cleaned	2933365	2933369		leuS	4
ARS007ss_ds.merged.samereadgroup.cleaned	2933494	2933495		leuS	1
ARS007ss_ds.merged.samereadgroup.cleaned	2934029	2934035		YPO_RS14015	6
ARS007ss_ds.merged.samereadgroup.cleaned	2935210	2935224		gltK	14
ARS007ss_ds.merged.samereadgroup.cleaned	2935259	2935290		gltK	31
ARS007ss_ds.merged.samereadgroup.cleaned	2935355	2935369		gltK	14
ARS007ss_ds.merged.samereadgroup.cleaned	2936157	2936169		YPO_RS14030	12
ARS007ss_ds.merged.samereadgroup.cleaned	2938475	2938486		lnt	11
ARS007ss_ds.merged.samereadgroup.cleaned	2938808	2938810		lnt	2
ARS007ss_ds.merged.samereadgroup.cleaned	2939022	2939034		lnt	12
ARS007ss_ds.merged.samereadgroup.cleaned	2939291	2939295		lnt	4
ARS007ss_ds.merged.samereadgroup.cleaned	2939381	2939412		lnt	31
ARS007ss_ds.merged.samereadgroup.cleaned	2939719	2939724		lnt	5
ARS007ss_ds.merged.samereadgroup.cleaned	2939868	2939874		lnt	6
ARS007ss_ds.merged.samereadgroup.cleaned	2940938	2940955		ybeY	17
ARS007ss_ds.merged.samereadgroup.cleaned	2941037	2941038		ybeY	1
ARS007ss_ds.merged.samereadgroup.cleaned	2941288	2941296		ybeY	8
ARS007ss_ds.merged.samereadgroup.cleaned	2941410	2941414		YPO_RS14055	4
ARS007ss_ds.merged.samereadgroup.cleaned	2941501	2941515		YPO_RS14055	14
ARS007ss_ds.merged.samereadgroup.cleaned	2941712	2941715		YPO_RS14055	3
ARS007ss_ds.merged.samereadgroup.cleaned	2942002	2942006		YPO_RS14055	4
ARS007ss_ds.merged.samereadgroup.cleaned	2943238	2943239		miaB	1
ARS007ss_ds.merged.samereadgroup.cleaned	2943717	2943720		miaB	3
ARS007ss_ds.merged.samereadgroup.cleaned	2944730	2944735		ubiF	5
ARS007ss_ds.merged.samereadgroup.cleaned	2945120	2945125		ubiF	5
ARS007ss_ds.merged.samereadgroup.cleaned	2947913	2947925		asnB	12
ARS007ss_ds.merged.samereadgroup.cleaned	2948432	2948446		asnB	14
ARS007ss_ds.merged.samereadgroup.cleaned	2948992	2948994		YPO_RS14100	2
ARS007ss_ds.merged.samereadgroup.cleaned	2950514	2950522		YPO_RS14105	8
ARS007ss_ds.merged.samereadgroup.cleaned	2951884	2951904		nagA	20
ARS007ss_ds.merged.samereadgroup.cleaned	2952135	2952136		nagA	1
ARS007ss_ds.merged.samereadgroup.cleaned	2953515	2953521		YPO_RS14120	6
ARS007ss_ds.merged.samereadgroup.cleaned	2953668	2953669		YPO_RS14120	1
ARS007ss_ds.merged.samereadgroup.cleaned	2953917	2953919		YPO_RS14120	2
ARS007ss_ds.merged.samereadgroup.cleaned	2954731	2954735		YPO_RS14120	4
ARS007ss_ds.merged.samereadgroup.cleaned	2955064	2955069		YPO_RS14120	5
ARS007ss_ds.merged.samereadgroup.cleaned	2957484	2957486		glnS	2
ARS007ss_ds.merged.samereadgroup.cleaned	2959147	2959162		YPO_RS14135	15
ARS007ss_ds.merged.samereadgroup.cleaned	2959224	2959242		YPO_RS14135	18
ARS007ss_ds.merged.samereadgroup.cleaned	2959618	2959622		YPO_RS14135	4
ARS007ss_ds.merged.samereadgroup.cleaned	2959736	2959750		YPO_RS14135	14
ARS007ss_ds.merged.samereadgroup.cleaned	2964749	2964757		fldA	8
ARS007ss_ds.merged.samereadgroup.cleaned	2965342	2965348		ybfE	6
ARS007ss_ds.merged.samereadgroup.cleaned	2966090	2966097		ybfF	7
ARS007ss_ds.merged.samereadgroup.cleaned	2966548	2966552		ybfF	4
ARS007ss_ds.merged.samereadgroup.cleaned	2966680	2966684		ybfF	4
ARS007ss_ds.merged.samereadgroup.cleaned	2972494	2972496		proX	2
ARS007ss_ds.merged.samereadgroup.cleaned	2972868	2972893		proW	25
ARS007ss_ds.merged.samereadgroup.cleaned	2972989	2972993		proW	4
ARS007ss_ds.merged.samereadgroup.cleaned	2973705	2973708		proW	3
ARS007ss_ds.merged.samereadgroup.cleaned	2973884	2973900		proW	16
ARS007ss_ds.merged.samereadgroup.cleaned	2974027	2974029		proV	2
ARS007ss_ds.merged.samereadgroup.cleaned	2974868	2974883		proV	15
ARS007ss_ds.merged.samereadgroup.cleaned	2975192	2975196		proV	4
ARS007ss_ds.merged.samereadgroup.cleaned	2976027	2976030		nrdF	3
ARS007ss_ds.merged.samereadgroup.cleaned	2976317	2976324		nrdF	7
ARS007ss_ds.merged.samereadgroup.cleaned	2976444	2976466		nrdF	22
ARS007ss_ds.merged.samereadgroup.cleaned	2977437	2977446		nrdE	9
ARS007ss_ds.merged.samereadgroup.cleaned	2979191	2979193		nrdI	2
ARS007ss_ds.merged.samereadgroup.cleaned	2979318	2979342		nrdI	24
ARS007ss_ds.merged.samereadgroup.cleaned	2979542	2979550		YPO_RS14230	8
ARS007ss_ds.merged.samereadgroup.cleaned	2979680	2979698		YPO_RS14230	18
ARS007ss_ds.merged.samereadgroup.cleaned	2980341	2980364		YPO_RS14235	23
ARS007ss_ds.merged.samereadgroup.cleaned	2980426	2980590		YPO_RS14235	164
ARS007ss_ds.merged.samereadgroup.cleaned	2981931	2981939		YPO_RS14245	8
ARS007ss_ds.merged.samereadgroup.cleaned	2986107	2986129		YPO_RS14265	22
ARS007ss_ds.merged.samereadgroup.cleaned	2986265	2986272		YPO_RS14265	7
ARS007ss_ds.merged.samereadgroup.cleaned	2986330	2986355		YPO_RS14265	25
ARS007ss_ds.merged.samereadgroup.cleaned	2986495	2986510		YPO_RS14265	15
ARS007ss_ds.merged.samereadgroup.cleaned	2989269	2989271		YPO_RS14280	2
ARS007ss_ds.merged.samereadgroup.cleaned	2989706	2989726		YPO_RS14285	20
ARS007ss_ds.merged.samereadgroup.cleaned	2989813	2989814		YPO_RS14285	1
ARS007ss_ds.merged.samereadgroup.cleaned	2991691	2991697		YPO_RS14290	6
ARS007ss_ds.merged.samereadgroup.cleaned	2992783	2992790		YPO_RS14300	7
ARS007ss_ds.merged.samereadgroup.cleaned	2993133	2993135		YPO_RS14300	2
ARS007ss_ds.merged.samereadgroup.cleaned	2993212	2993214		YPO_RS14300	2
ARS007ss_ds.merged.samereadgroup.cleaned	2993708	2993725		YPO_RS14300	17
ARS007ss_ds.merged.samereadgroup.cleaned	2994975	2994983		ureE	8
ARS007ss_ds.merged.samereadgroup.cleaned	2995366	2995367		YPO_RS14310	1
ARS007ss_ds.merged.samereadgroup.cleaned	2995876	2995882		ureG	6
ARS007ss_ds.merged.samereadgroup.cleaned	2996211	2996215		ureG	4
ARS007ss_ds.merged.samereadgroup.cleaned	2996341	2996346		ureG	5
ARS007ss_ds.merged.samereadgroup.cleaned	2997811	2997812		yut	1
ARS007ss_ds.merged.samereadgroup.cleaned	2997940	2997945		yut	5
ARS007ss_ds.merged.samereadgroup.cleaned	2998365	2998396		yut	31
ARS007ss_ds.merged.samereadgroup.cleaned	2999362	2999366		YPO_RS14330	4
ARS007ss_ds.merged.samereadgroup.cleaned	2999470	2999471		YPO_RS14330	1
ARS007ss_ds.merged.samereadgroup.cleaned	2999767	2999835		YPO_RS14330	68
ARS007ss_ds.merged.samereadgroup.cleaned	3000163	3000201		hdeB	38
ARS007ss_ds.merged.samereadgroup.cleaned	3001194	3001223		kch	29
ARS007ss_ds.merged.samereadgroup.cleaned	3001762	3001763		kch	1
ARS007ss_ds.merged.samereadgroup.cleaned	3002804	3002841		crcB	37
ARS007ss_ds.merged.samereadgroup.cleaned	3004455	3004466		chbC	11
ARS007ss_ds.merged.samereadgroup.cleaned	3004624	3004625		chbC	1
ARS007ss_ds.merged.samereadgroup.cleaned	3004847	3004851		chbC	4
ARS007ss_ds.merged.samereadgroup.cleaned	3005112	3005120		chbC	8
ARS007ss_ds.merged.samereadgroup.cleaned	3006117	3006120		chbA	3
ARS007ss_ds.merged.samereadgroup.cleaned	3006191	3006198		chbA	7
ARS007ss_ds.merged.samereadgroup.cleaned	3006769	3006772		chbR	3
ARS007ss_ds.merged.samereadgroup.cleaned	3007075	3007085		chbR	10
ARS007ss_ds.merged.samereadgroup.cleaned	3009978	3009979		pgm	1
ARS007ss_ds.merged.samereadgroup.cleaned	3010468	3010473		pgm	5
ARS007ss_ds.merged.samereadgroup.cleaned	3010675	3010677		pgm	2
ARS007ss_ds.merged.samereadgroup.cleaned	3010745	3010761		pgm	16
ARS007ss_ds.merged.samereadgroup.cleaned	3011169	3011180		pgm	11
ARS007ss_ds.merged.samereadgroup.cleaned	3012125	3012138		YPO_RS14405	13
ARS007ss_ds.merged.samereadgroup.cleaned	3012174	3012221		YPO_RS14405	47
ARS007ss_ds.merged.samereadgroup.cleaned	3012552	3012553		YPO_RS14405	1
ARS007ss_ds.merged.samereadgroup.cleaned	3013575	3013596		kdbD	21
ARS007ss_ds.merged.samereadgroup.cleaned	3014514	3014526		kdbD	12
ARS007ss_ds.merged.samereadgroup.cleaned	3016059	3016077		kdbD	18
ARS007ss_ds.merged.samereadgroup.cleaned	3016641	3016645		kdpC	4
ARS007ss_ds.merged.samereadgroup.cleaned	3016824	3016851		kdpC	27
ARS007ss_ds.merged.samereadgroup.cleaned	3017734	3017756		kdpB	22
ARS007ss_ds.merged.samereadgroup.cleaned	3018405	3018424		kdpB	19
ARS007ss_ds.merged.samereadgroup.cleaned	3018769	3018778		kdpB	9
ARS007ss_ds.merged.samereadgroup.cleaned	3019044	3019070		kdpB	26
ARS007ss_ds.merged.samereadgroup.cleaned	3019323	3019327		kdpA	4
ARS007ss_ds.merged.samereadgroup.cleaned	3019687	3019694		kdpA	7
ARS007ss_ds.merged.samereadgroup.cleaned	3020030	3020032		kdpA	2
ARS007ss_ds.merged.samereadgroup.cleaned	3020086	3020087		kdpA	1
ARS007ss_ds.merged.samereadgroup.cleaned	3020354	3020365		kdpA	11
ARS007ss_ds.merged.samereadgroup.cleaned	3021075	3021085		YPO_RS14440	10
ARS007ss_ds.merged.samereadgroup.cleaned	3021122	3021163		YPO_RS14440	41
ARS007ss_ds.merged.samereadgroup.cleaned	3022094	3022096		YPO_RS14450	2
ARS007ss_ds.merged.samereadgroup.cleaned	3022904	3022908		phrB	4
ARS007ss_ds.merged.samereadgroup.cleaned	3023912	3023916		phrB	4
ARS007ss_ds.merged.samereadgroup.cleaned	3024218	3024229		YPO_RS14460	11
ARS007ss_ds.merged.samereadgroup.cleaned	3024651	3024657		YPO_RS14460	6
ARS007ss_ds.merged.samereadgroup.cleaned	3024695	3024699		YPO_RS14460	4
ARS007ss_ds.merged.samereadgroup.cleaned	3024878	3024890		YPO_RS14460	12
ARS007ss_ds.merged.samereadgroup.cleaned	3028089	3028092		YPO_RS14480	3
ARS007ss_ds.merged.samereadgroup.cleaned	3028351	3028352		pxpA	1
ARS007ss_ds.merged.samereadgroup.cleaned	3030007	3030009		YPO_RS14495	2
ARS007ss_ds.merged.samereadgroup.cleaned	3030611	3030639		YPO_RS14495	28
ARS007ss_ds.merged.samereadgroup.cleaned	3030811	3030818		pcp	7
ARS007ss_ds.merged.samereadgroup.cleaned	3031160	3031163		pcp	3
ARS007ss_ds.merged.samereadgroup.cleaned	3031941	3031944		ung	3
ARS007ss_ds.merged.samereadgroup.cleaned	3032181	3032185		ung	4
ARS007ss_ds.merged.samereadgroup.cleaned	3033308	3033349		YPO_RS14515	41
ARS007ss_ds.merged.samereadgroup.cleaned	3033708	3033718		YPO_RS14515	10
ARS007ss_ds.merged.samereadgroup.cleaned	3034711	3034727		YPO_RS14520	16
ARS007ss_ds.merged.samereadgroup.cleaned	3035373	3035386		srmB	13
ARS007ss_ds.merged.samereadgroup.cleaned	3036635	3036641		YPO_RS14530	6
ARS007ss_ds.merged.samereadgroup.cleaned	3036877	3036884		YPO_RS14530	7
ARS007ss_ds.merged.samereadgroup.cleaned	3037096	3037117		YPO_RS14530	21
ARS007ss_ds.merged.samereadgroup.cleaned	3037250	3037264		YPO_RS14530	14
ARS007ss_ds.merged.samereadgroup.cleaned	3037599	3037620		nadB	21
ARS007ss_ds.merged.samereadgroup.cleaned	3038002	3038016		nadB	14
ARS007ss_ds.merged.samereadgroup.cleaned	3038083	3038087		nadB	4
ARS007ss_ds.merged.samereadgroup.cleaned	3038343	3038348		nadB	5
ARS007ss_ds.merged.samereadgroup.cleaned	3038476	3038490		nadB	14
ARS007ss_ds.merged.samereadgroup.cleaned	3038772	3038779		nadB	7
ARS007ss_ds.merged.samereadgroup.cleaned	3039818	3039826		rpoE	8
ARS007ss_ds.merged.samereadgroup.cleaned	3041104	3041106		rseB	2
ARS007ss_ds.merged.samereadgroup.cleaned	3041215	3041243		rseB	28
ARS007ss_ds.merged.samereadgroup.cleaned	3042466	3042507		YPO_RS14560	41
ARS007ss_ds.merged.samereadgroup.cleaned	3042541	3042548		YPO_RS14560	7
ARS007ss_ds.merged.samereadgroup.cleaned	3042596	3042598		YPO_RS14560	2
ARS007ss_ds.merged.samereadgroup.cleaned	3042712	3042714		YPO_RS14560	2
ARS007ss_ds.merged.samereadgroup.cleaned	3042814	3042826		YPO_RS14560	12
ARS007ss_ds.merged.samereadgroup.cleaned	3043576	3043579		lepA	3
ARS007ss_ds.merged.samereadgroup.cleaned	3044518	3044527		lepA	9
ARS007ss_ds.merged.samereadgroup.cleaned	3045702	3045721		lepB	19
ARS007ss_ds.merged.samereadgroup.cleaned	3046049	3046050		lepB	1
ARS007ss_ds.merged.samereadgroup.cleaned	3047158	3047175		rnc	17
ARS007ss_ds.merged.samereadgroup.cleaned	3047434	3047442		YPO_RS14580	8
ARS007ss_ds.merged.samereadgroup.cleaned	3052804	3052806		tssM	2
ARS007ss_ds.merged.samereadgroup.cleaned	3053197	3053212		tssM	15
ARS007ss_ds.merged.samereadgroup.cleaned	3053824	3053826		tssM	2
ARS007ss_ds.merged.samereadgroup.cleaned	3054282	3054287		tssM	5
ARS007ss_ds.merged.samereadgroup.cleaned	3054619	3054624		tssM	5
ARS007ss_ds.merged.samereadgroup.cleaned	3054932	3054939		tssM	7
ARS007ss_ds.merged.samereadgroup.cleaned	3055853	3055857		YPO_RS14610	4
ARS007ss_ds.merged.samereadgroup.cleaned	3056163	3056169		YPO_RS14610	6
ARS007ss_ds.merged.samereadgroup.cleaned	3056447	3056462		YPO_RS14610	15
ARS007ss_ds.merged.samereadgroup.cleaned	3057238	3057255		YPO_RS14610	17
ARS007ss_ds.merged.samereadgroup.cleaned	3057622	3057660		YPO_RS14610	38
ARS007ss_ds.merged.samereadgroup.cleaned	3058091	3058092		YPO_RS14610	1
ARS007ss_ds.merged.samereadgroup.cleaned	3058140	3058171		YPO_RS14610	31
ARS007ss_ds.merged.samereadgroup.cleaned	3058922	3058928		YPO_RS14615	6
ARS007ss_ds.merged.samereadgroup.cleaned	3058934	3058956		YPO_RS14620	22
ARS007ss_ds.merged.samereadgroup.cleaned	3059037	3059053		YPO_RS14620	16
ARS007ss_ds.merged.samereadgroup.cleaned	3060409	3060425		YPO_RS14625	16
ARS007ss_ds.merged.samereadgroup.cleaned	3061119	3061132		YPO_RS14630	13
ARS007ss_ds.merged.samereadgroup.cleaned	3061359	3061361		YPO_RS14635	2
ARS007ss_ds.merged.samereadgroup.cleaned	3061756	3061761		YPO_RS14640	5
ARS007ss_ds.merged.samereadgroup.cleaned	3061864	3061876		YPO_RS14640	12
ARS007ss_ds.merged.samereadgroup.cleaned	3062509	3062515		YPO_RS14645	6
ARS007ss_ds.merged.samereadgroup.cleaned	3062725	3062729		YPO_RS14645	4
ARS007ss_ds.merged.samereadgroup.cleaned	3062806	3062814		YPO_RS14645	8
ARS007ss_ds.merged.samereadgroup.cleaned	3064675	3064676		YPO_RS14650	1
ARS007ss_ds.merged.samereadgroup.cleaned	3065545	3065586		YPO_RS14660	41
ARS007ss_ds.merged.samereadgroup.cleaned	3065737	3065745		YPO_RS14660	8
ARS007ss_ds.merged.samereadgroup.cleaned	3066545	3066562		ccmA	17
ARS007ss_ds.merged.samereadgroup.cleaned	3066638	3066653		ccmA	15
ARS007ss_ds.merged.samereadgroup.cleaned	3066773	3066802		ccmA	29
ARS007ss_ds.merged.samereadgroup.cleaned	3067316	3067319		ccmB	3
ARS007ss_ds.merged.samereadgroup.cleaned	3067352	3067354		ccmB	2
ARS007ss_ds.merged.samereadgroup.cleaned	3067708	3067723		ccmB	15
ARS007ss_ds.merged.samereadgroup.cleaned	3068007	3068011		YPO_RS14675	4
ARS007ss_ds.merged.samereadgroup.cleaned	3068873	3068894		ccmE	21
ARS007ss_ds.merged.samereadgroup.cleaned	3069150	3069158		ccmE	8
ARS007ss_ds.merged.samereadgroup.cleaned	3069299	3069308		ccmE	9
ARS007ss_ds.merged.samereadgroup.cleaned	3071072	3071080		YPO_RS14690	8
ARS007ss_ds.merged.samereadgroup.cleaned	3071481	3071491		YPO_RS14695	10
ARS007ss_ds.merged.samereadgroup.cleaned	3071764	3071773		YPO_RS14695	9
ARS007ss_ds.merged.samereadgroup.cleaned	3071851	3071872		YPO_RS14700	21
ARS007ss_ds.merged.samereadgroup.cleaned	3072637	3072657		ccmI	20
ARS007ss_ds.merged.samereadgroup.cleaned	3073261	3073287		ccmI	26
ARS007ss_ds.merged.samereadgroup.cleaned	3074024	3074036		mlaA	12
ARS007ss_ds.merged.samereadgroup.cleaned	3074653	3074658		fadL	5
ARS007ss_ds.merged.samereadgroup.cleaned	3074761	3074782		fadL	21
ARS007ss_ds.merged.samereadgroup.cleaned	3074876	3074881		fadL	5
ARS007ss_ds.merged.samereadgroup.cleaned	3076827	3076832		fadI	5
ARS007ss_ds.merged.samereadgroup.cleaned	3077403	3077405		fadI	2
ARS007ss_ds.merged.samereadgroup.cleaned	3077684	3077707		fadI	23
ARS007ss_ds.merged.samereadgroup.cleaned	3078000	3078005		fadI	5
ARS007ss_ds.merged.samereadgroup.cleaned	3078267	3078269		fadJ	2
ARS007ss_ds.merged.samereadgroup.cleaned	3078636	3078681		fadJ	45
ARS007ss_ds.merged.samereadgroup.cleaned	3079507	3079519		fadJ	12
ARS007ss_ds.merged.samereadgroup.cleaned	3079574	3079583		fadJ	9
ARS007ss_ds.merged.samereadgroup.cleaned	3080013	3080033		fadJ	20
ARS007ss_ds.merged.samereadgroup.cleaned	3080989	3080992		sixA	3
ARS007ss_ds.merged.samereadgroup.cleaned	3081868	3081913		smrB	45
ARS007ss_ds.merged.samereadgroup.cleaned	3083821	3083831		aroC	10
ARS007ss_ds.merged.samereadgroup.cleaned	3083966	3083969		aroC	3
ARS007ss_ds.merged.samereadgroup.cleaned	3084064	3084086		aroC	22
ARS007ss_ds.merged.samereadgroup.cleaned	3084206	3084226		aroC	20
ARS007ss_ds.merged.samereadgroup.cleaned	3084756	3084766		aroC	10
ARS007ss_ds.merged.samereadgroup.cleaned	3084864	3084876		mepA	12
ARS007ss_ds.merged.samereadgroup.cleaned	3085117	3085119		mepA	2
ARS007ss_ds.merged.samereadgroup.cleaned	3085760	3085793		YPO_RS14760	33
ARS007ss_ds.merged.samereadgroup.cleaned	3086305	3086310		YPO_RS14760	5
ARS007ss_ds.merged.samereadgroup.cleaned	3086614	3086615		YPO_RS14765	1
ARS007ss_ds.merged.samereadgroup.cleaned	3087872	3087882		mnmC	10
ARS007ss_ds.merged.samereadgroup.cleaned	3087924	3087942		mnmC	18
ARS007ss_ds.merged.samereadgroup.cleaned	3088489	3088492		mnmC	3
ARS007ss_ds.merged.samereadgroup.cleaned	3088787	3088799		mnmC	12
ARS007ss_ds.merged.samereadgroup.cleaned	3090004	3090011		fabB	7
ARS007ss_ds.merged.samereadgroup.cleaned	3090635	3090638		fabB	3
ARS007ss_ds.merged.samereadgroup.cleaned	3090914	3090931		fabB	17
ARS007ss_ds.merged.samereadgroup.cleaned	3091924	3091942		YPO_RS14785	18
ARS007ss_ds.merged.samereadgroup.cleaned	3092079	3092090		YPO_RS14785	11
ARS007ss_ds.merged.samereadgroup.cleaned	3093172	3093179		YPO_RS14790	7
ARS007ss_ds.merged.samereadgroup.cleaned	3093497	3093505		YPO_RS14790	8
ARS007ss_ds.merged.samereadgroup.cleaned	3095876	3095893		YPO_RS14800	17
ARS007ss_ds.merged.samereadgroup.cleaned	3096845	3096855		YPO_RS14805	10
ARS007ss_ds.merged.samereadgroup.cleaned	3096951	3096976		YPO_RS14805	25
ARS007ss_ds.merged.samereadgroup.cleaned	3097350	3097354		pdxB	4
ARS007ss_ds.merged.samereadgroup.cleaned	3101694	3101704		YPO_RS14830	10
ARS007ss_ds.merged.samereadgroup.cleaned	3101741	3101744		YPO_RS14830	3
ARS007ss_ds.merged.samereadgroup.cleaned	3103773	3103778		folC	5
ARS007ss_ds.merged.samereadgroup.cleaned	3104128	3104131		folC	3
ARS007ss_ds.merged.samereadgroup.cleaned	3104738	3104739		dedD	1
ARS007ss_ds.merged.samereadgroup.cleaned	3104973	3104974		dedD	1
ARS007ss_ds.merged.samereadgroup.cleaned	3105275	3105284		dedD	9
ARS007ss_ds.merged.samereadgroup.cleaned	3110269	3110270		YPO_RS14870	1
ARS007ss_ds.merged.samereadgroup.cleaned	3110643	3110650		YPO_RS14870	7
ARS007ss_ds.merged.samereadgroup.cleaned	3110766	3110792		YPO_RS14875	26
ARS007ss_ds.merged.samereadgroup.cleaned	3110853	3110861		YPO_RS14875	8
ARS007ss_ds.merged.samereadgroup.cleaned	3112824	3112845		YPO_RS14885	21
ARS007ss_ds.merged.samereadgroup.cleaned	3113172	3113180		YPO_RS14885	8
ARS007ss_ds.merged.samereadgroup.cleaned	3113578	3113582		YPO_RS14890	4
ARS007ss_ds.merged.samereadgroup.cleaned	3113955	3113956		YPO_RS14890	1
ARS007ss_ds.merged.samereadgroup.cleaned	3114551	3114561		yfcE	10
ARS007ss_ds.merged.samereadgroup.cleaned	3114639	3114641		yfcE	2
ARS007ss_ds.merged.samereadgroup.cleaned	3114877	3114880		yfcE	3
ARS007ss_ds.merged.samereadgroup.cleaned	3114923	3114946		yfcE	23
ARS007ss_ds.merged.samereadgroup.cleaned	3115002	3115007		yfcE	5
ARS007ss_ds.merged.samereadgroup.cleaned	3116119	3116122		YPO_RS14905	3
ARS007ss_ds.merged.samereadgroup.cleaned	3116253	3116260		YPO_RS14905	7
ARS007ss_ds.merged.samereadgroup.cleaned	3116683	3116691		YPO_RS14905	8
ARS007ss_ds.merged.samereadgroup.cleaned	3117129	3117133		YPO_RS14905	4
ARS007ss_ds.merged.samereadgroup.cleaned	3120316	3120561		YPO_RS14920	245
ARS007ss_ds.merged.samereadgroup.cleaned	3121234	3121815		YPO_RS14925	581
ARS007ss_ds.merged.samereadgroup.cleaned	3122083	3122484		YPO_RS14930	401
ARS007ss_ds.merged.samereadgroup.cleaned	3122717	3123118		YPO_RS14935	401
ARS007ss_ds.merged.samereadgroup.cleaned	3123130	3123702		YPO_RS14940	572
ARS007ss_ds.merged.samereadgroup.cleaned	3123726	3123977		YPO_RS14945	251
ARS007ss_ds.merged.samereadgroup.cleaned	3124016	3124255		YPO_RS14950	239
ARS007ss_ds.merged.samereadgroup.cleaned	3125064	3126980		yapC	1916
ARS007ss_ds.merged.samereadgroup.cleaned	3127171	3127226		YPO_RS14960	55
ARS007ss_ds.merged.samereadgroup.cleaned	3127515	3128096		YPO_RS14965	581
ARS007ss_ds.merged.samereadgroup.cleaned	3130158	3132365		YPO_RS14980	2207
ARS007ss_ds.merged.samereadgroup.cleaned	3132358	3132888		YPO_RS14985	530
ARS007ss_ds.merged.samereadgroup.cleaned	3133047	3135428		YPO_RS14990	2381
ARS007ss_ds.merged.samereadgroup.cleaned	3135507	3136047		YPO_RS14995	540
ARS007ss_ds.merged.samereadgroup.cleaned	3136078	3136519		YPO_RS14995	441
ARS007ss_ds.merged.samereadgroup.cleaned	3136599	3137135		YPO_RS14995	536
ARS007ss_ds.merged.samereadgroup.cleaned	3137608	3138459		YPO_RS15000	851
ARS007ss_ds.merged.samereadgroup.cleaned	3138485	3138698		YPO_RS15005	213
ARS007ss_ds.merged.samereadgroup.cleaned	3138743	3138919		YPO_RS15005	176
ARS007ss_ds.merged.samereadgroup.cleaned	3138954	3139474		YPO_RS15005	520
ARS007ss_ds.merged.samereadgroup.cleaned	3139529	3140416		YPO_RS15010	887
ARS007ss_ds.merged.samereadgroup.cleaned	3142684	3142989		YPO_RS15025	305
ARS007ss_ds.merged.samereadgroup.cleaned	3143086	3143487		YPO_RS15030	401
ARS007ss_ds.merged.samereadgroup.cleaned	3143469	3144181		YPO_RS15035	712
ARS007ss_ds.merged.samereadgroup.cleaned	3144338	3144349		YPO_RS15035	11
ARS007ss_ds.merged.samereadgroup.cleaned	3144892	3144895		YPO_RS15040	3
ARS007ss_ds.merged.samereadgroup.cleaned	3145288	3145299		YPO_RS15040	11
ARS007ss_ds.merged.samereadgroup.cleaned	3145751	3145753		YPO_RS15040	2
ARS007ss_ds.merged.samereadgroup.cleaned	3145845	3145854		YPO_RS15040	9
ARS007ss_ds.merged.samereadgroup.cleaned	3146183	3146192		YPO_RS15040	9
ARS007ss_ds.merged.samereadgroup.cleaned	3146986	3146987		YPO_RS15045	1
ARS007ss_ds.merged.samereadgroup.cleaned	3147760	3147772		YPO_RS15050	12
ARS007ss_ds.merged.samereadgroup.cleaned	3148343	3148354		YPO_RS15055	11
ARS007ss_ds.merged.samereadgroup.cleaned	3148693	3148694		YPO_RS15055	1
ARS007ss_ds.merged.samereadgroup.cleaned	3149193	3149199		YPO_RS15060	6
ARS007ss_ds.merged.samereadgroup.cleaned	3150432	3150438		YPO_RS15075	6
ARS007ss_ds.merged.samereadgroup.cleaned	3152111	3152119		folD	8
ARS007ss_ds.merged.samereadgroup.cleaned	3152185	3152188		folD	3
ARS007ss_ds.merged.samereadgroup.cleaned	3152338	3152359		folD	21
ARS007ss_ds.merged.samereadgroup.cleaned	3152399	3152403		folD	4
ARS007ss_ds.merged.samereadgroup.cleaned	3155207	3155210		purM	3
ARS007ss_ds.merged.samereadgroup.cleaned	3155875	3155879		purM	4
ARS007ss_ds.merged.samereadgroup.cleaned	3156022	3156024		purN	2
ARS007ss_ds.merged.samereadgroup.cleaned	3156938	3156940		speG	2
ARS007ss_ds.merged.samereadgroup.cleaned	3159632	3159657		pstB	25
ARS007ss_ds.merged.samereadgroup.cleaned	3160131	3160132		pstA	1
ARS007ss_ds.merged.samereadgroup.cleaned	3160367	3160372		pstA	5
ARS007ss_ds.merged.samereadgroup.cleaned	3160477	3160495		pstA	18
ARS007ss_ds.merged.samereadgroup.cleaned	3160994	3161002		pstA	8
ARS007ss_ds.merged.samereadgroup.cleaned	3161108	3161127		pstA	19
ARS007ss_ds.merged.samereadgroup.cleaned	3161941	3161944		YPO_RS15145	3
ARS007ss_ds.merged.samereadgroup.cleaned	3162085	3162091		YPO_RS15145	6
ARS007ss_ds.merged.samereadgroup.cleaned	3162326	3162328		YPO_RS15145	2
ARS007ss_ds.merged.samereadgroup.cleaned	3162497	3162501		YPO_RS15145	4
ARS007ss_ds.merged.samereadgroup.cleaned	3165737	3165742		ppk1	5
ARS007ss_ds.merged.samereadgroup.cleaned	3167133	3167135		ppx	2
ARS007ss_ds.merged.samereadgroup.cleaned	3168347	3168355		mgtE	8
ARS007ss_ds.merged.samereadgroup.cleaned	3169091	3169110		mgtE	19
ARS007ss_ds.merged.samereadgroup.cleaned	3169255	3169270		mgtE	15
ARS007ss_ds.merged.samereadgroup.cleaned	3169360	3169364		mgtE	4
ARS007ss_ds.merged.samereadgroup.cleaned	3169460	3169466		mgtE	6
ARS007ss_ds.merged.samereadgroup.cleaned	3170359	3170361		yegD	2
ARS007ss_ds.merged.samereadgroup.cleaned	3171523	3171524		YPO_RS15175	1
ARS007ss_ds.merged.samereadgroup.cleaned	3171626	3171661		YPO_RS15175	35
ARS007ss_ds.merged.samereadgroup.cleaned	3172754	3172756		YPO_RS15180	2
ARS007ss_ds.merged.samereadgroup.cleaned	3172891	3172903		YPO_RS15180	12
ARS007ss_ds.merged.samereadgroup.cleaned	3173193	3173206		YPO_RS15180	13
ARS007ss_ds.merged.samereadgroup.cleaned	3173725	3173749		YPO_RS15185	24
ARS007ss_ds.merged.samereadgroup.cleaned	3174102	3174103		YPO_RS15185	1
ARS007ss_ds.merged.samereadgroup.cleaned	3176327	3176338		YPO_RS15195	11
ARS007ss_ds.merged.samereadgroup.cleaned	3176723	3176745		YPO_RS15195	22
ARS007ss_ds.merged.samereadgroup.cleaned	3177066	3177086		YPO_RS15195	20
ARS007ss_ds.merged.samereadgroup.cleaned	3178386	3178390		YPO_RS15200	4
ARS007ss_ds.merged.samereadgroup.cleaned	3178669	3178672		YPO_RS15200	3
ARS007ss_ds.merged.samereadgroup.cleaned	3179516	3179521		YPO_RS15205	5
ARS007ss_ds.merged.samereadgroup.cleaned	3179679	3179695		YPO_RS15205	16
ARS007ss_ds.merged.samereadgroup.cleaned	3180827	3180870		YPO_RS15210	43
ARS007ss_ds.merged.samereadgroup.cleaned	3181249	3181250		YPO_RS15210	1
ARS007ss_ds.merged.samereadgroup.cleaned	3182625	3182646		YPO_RS15210	21
ARS007ss_ds.merged.samereadgroup.cleaned	3183177	3183190		YPO_RS15210	13
ARS007ss_ds.merged.samereadgroup.cleaned	3183893	3183898		mdtC	5
ARS007ss_ds.merged.samereadgroup.cleaned	3183935	3183955		mdtC	20
ARS007ss_ds.merged.samereadgroup.cleaned	3185177	3185190		mdtC	13
ARS007ss_ds.merged.samereadgroup.cleaned	3185835	3185847		mdtC	12
ARS007ss_ds.merged.samereadgroup.cleaned	3186342	3186354		mdtC	12
ARS007ss_ds.merged.samereadgroup.cleaned	3187663	3187665		YPO_RS15220	2
ARS007ss_ds.merged.samereadgroup.cleaned	3187749	3187759		YPO_RS15220	10
ARS007ss_ds.merged.samereadgroup.cleaned	3188163	3188178		YPO_RS15220	15
ARS007ss_ds.merged.samereadgroup.cleaned	3188301	3188320		YPO_RS15220	19
ARS007ss_ds.merged.samereadgroup.cleaned	3189983	3189985		baeR	2
ARS007ss_ds.merged.samereadgroup.cleaned	3191307	3191309		YPO_RS15240	2
ARS007ss_ds.merged.samereadgroup.cleaned	3191619	3191621		YPO_RS15240	2
ARS007ss_ds.merged.samereadgroup.cleaned	3192261	3192265		YPO_RS15240	4
ARS007ss_ds.merged.samereadgroup.cleaned	3193693	3193703		yegS	10
ARS007ss_ds.merged.samereadgroup.cleaned	3193764	3193769		yegS	5
ARS007ss_ds.merged.samereadgroup.cleaned	3193965	3193970		yegS	5
ARS007ss_ds.merged.samereadgroup.cleaned	3194829	3194849		YPO_RS15250	20
ARS007ss_ds.merged.samereadgroup.cleaned	3196403	3196406		thiD	3
ARS007ss_ds.merged.samereadgroup.cleaned	3196472	3196479		thiD	7
ARS007ss_ds.merged.samereadgroup.cleaned	3197588	3197604		YPO_RS15265	16
ARS007ss_ds.merged.samereadgroup.cleaned	3197712	3197742		YPO_RS15265	30
ARS007ss_ds.merged.samereadgroup.cleaned	3197789	3197830		YPO_RS15265	41
ARS007ss_ds.merged.samereadgroup.cleaned	3198011	3198015		YPO_RS15270	4
ARS007ss_ds.merged.samereadgroup.cleaned	3198116	3198119		YPO_RS15270	3
ARS007ss_ds.merged.samereadgroup.cleaned	3198224	3198232		YPO_RS15270	8
ARS007ss_ds.merged.samereadgroup.cleaned	3200392	3200473		YPO_RS15285	81
ARS007ss_ds.merged.samereadgroup.cleaned	3200565	3200587		YPO_RS15285	22
ARS007ss_ds.merged.samereadgroup.cleaned	3200658	3200755		YPO_RS15290	97
ARS007ss_ds.merged.samereadgroup.cleaned	3200825	3200954		YPO_RS15290	129
ARS007ss_ds.merged.samereadgroup.cleaned	3201032	3201046		YPO_RS15290	14
ARS007ss_ds.merged.samereadgroup.cleaned	3201143	3201147		YPO_RS15295	4
ARS007ss_ds.merged.samereadgroup.cleaned	3201308	3201343		YPO_RS15295	35
ARS007ss_ds.merged.samereadgroup.cleaned	3201583	3201635		YPO_RS15300	52
ARS007ss_ds.merged.samereadgroup.cleaned	3201694	3201699		YPO_RS15300	5
ARS007ss_ds.merged.samereadgroup.cleaned	3201869	3201898		YPO_RS15300	29
ARS007ss_ds.merged.samereadgroup.cleaned	3201951	3201952		YPO_RS15300	1
ARS007ss_ds.merged.samereadgroup.cleaned	3202026	3202030		YPO_RS15305	4
ARS007ss_ds.merged.samereadgroup.cleaned	3202234	3202311		YPO_RS15305	77
ARS007ss_ds.merged.samereadgroup.cleaned	3203824	3203836		guaA	12
ARS007ss_ds.merged.samereadgroup.cleaned	3204021	3204047		guaA	26
ARS007ss_ds.merged.samereadgroup.cleaned	3204413	3204419		guaA	6
ARS007ss_ds.merged.samereadgroup.cleaned	3204553	3204576		guaA	23
ARS007ss_ds.merged.samereadgroup.cleaned	3204781	3204787		guaA	6
ARS007ss_ds.merged.samereadgroup.cleaned	3205337	3205341		guaB	4
ARS007ss_ds.merged.samereadgroup.cleaned	3210758	3210772		der	14
ARS007ss_ds.merged.samereadgroup.cleaned	3212265	3212279		bamB	14
ARS007ss_ds.merged.samereadgroup.cleaned	3212605	3212615		bamB	10
ARS007ss_ds.merged.samereadgroup.cleaned	3213169	3213193		YPO_RS15350	24
ARS007ss_ds.merged.samereadgroup.cleaned	3213258	3213267		YPO_RS15350	9
ARS007ss_ds.merged.samereadgroup.cleaned	3213789	3213800		hisS	11
ARS007ss_ds.merged.samereadgroup.cleaned	3215121	3215148		ispG	27
ARS007ss_ds.merged.samereadgroup.cleaned	3216441	3216447		rodZ	6
ARS007ss_ds.merged.samereadgroup.cleaned	3217795	3217800		pilW	5
ARS007ss_ds.merged.samereadgroup.cleaned	3218626	3218636		trmG/rlmN	10
ARS007ss_ds.merged.samereadgroup.cleaned	3219134	3219144		trmG/rlmN	10
ARS007ss_ds.merged.samereadgroup.cleaned	3221113	3221119		YPO_RS15385	6
ARS007ss_ds.merged.samereadgroup.cleaned	3221388	3221392		YPO_RS15385	4
ARS007ss_ds.merged.samereadgroup.cleaned	3221576	3221649		YPO_RS15385	73
ARS007ss_ds.merged.samereadgroup.cleaned	3221811	3221861		YPO_RS15385	50
ARS007ss_ds.merged.samereadgroup.cleaned	3221992	3221995		YPO_RS15385	3
ARS007ss_ds.merged.samereadgroup.cleaned	3222116	3222119		YPO_RS15385	3
ARS007ss_ds.merged.samereadgroup.cleaned	3222352	3222357		YPO_RS15385	5
ARS007ss_ds.merged.samereadgroup.cleaned	3222542	3222561		YPO_RS15385	19
ARS007ss_ds.merged.samereadgroup.cleaned	3223343	3223352		yapA	9
ARS007ss_ds.merged.samereadgroup.cleaned	3223392	3223396		yapA	4
ARS007ss_ds.merged.samereadgroup.cleaned	3223470	3223474		yapA	4
ARS007ss_ds.merged.samereadgroup.cleaned	3223557	3223559		yapA	2
ARS007ss_ds.merged.samereadgroup.cleaned	3223670	3223673		yapA	3
ARS007ss_ds.merged.samereadgroup.cleaned	3223983	3223993		yapA	10
ARS007ss_ds.merged.samereadgroup.cleaned	3224255	3224258		yapA	3
ARS007ss_ds.merged.samereadgroup.cleaned	3224861	3224863		yapA	2
ARS007ss_ds.merged.samereadgroup.cleaned	3224992	3225002		yapA	10
ARS007ss_ds.merged.samereadgroup.cleaned	3225108	3225128		yapA	20
ARS007ss_ds.merged.samereadgroup.cleaned	3225475	3225535		yapA	60
ARS007ss_ds.merged.samereadgroup.cleaned	3225575	3225620		yapA	45
ARS007ss_ds.merged.samereadgroup.cleaned	3226827	3226841		yapA	14
ARS007ss_ds.merged.samereadgroup.cleaned	3227171	3227182		yapA	11
ARS007ss_ds.merged.samereadgroup.cleaned	3227434	3227444		yapA	10
ARS007ss_ds.merged.samereadgroup.cleaned	3228582	3228585		YPO_RS15395	3
ARS007ss_ds.merged.samereadgroup.cleaned	3229874	3229883		YPO_RS15395	9
ARS007ss_ds.merged.samereadgroup.cleaned	3230064	3230084		YPO_RS15395	20
ARS007ss_ds.merged.samereadgroup.cleaned	3230341	3230354		YPO_RS15395	13
ARS007ss_ds.merged.samereadgroup.cleaned	3230818	3230830		YPO_RS15395	12
ARS007ss_ds.merged.samereadgroup.cleaned	3230901	3230907		YPO_RS15395	6
ARS007ss_ds.merged.samereadgroup.cleaned	3231125	3231136		YPO_RS15395	11
ARS007ss_ds.merged.samereadgroup.cleaned	3233289	3233291		pepB	2
ARS007ss_ds.merged.samereadgroup.cleaned	3234269	3234270		pepB	1
ARS007ss_ds.merged.samereadgroup.cleaned	3236077	3236084		hscA	7
ARS007ss_ds.merged.samereadgroup.cleaned	3236721	3236731		hscA	10
ARS007ss_ds.merged.samereadgroup.cleaned	3236855	3236858		hscA	3
ARS007ss_ds.merged.samereadgroup.cleaned	3238836	3238847		iscU	11
ARS007ss_ds.merged.samereadgroup.cleaned	3238996	3238999		YPO_RS15450	3
ARS007ss_ds.merged.samereadgroup.cleaned	3239430	3239432		YPO_RS15450	2
ARS007ss_ds.merged.samereadgroup.cleaned	3241246	3241248		trmJ	2
ARS007ss_ds.merged.samereadgroup.cleaned	3241476	3241505		trmJ	29
ARS007ss_ds.merged.samereadgroup.cleaned	3241562	3241563		trmJ	1
ARS007ss_ds.merged.samereadgroup.cleaned	3243776	3243781		YPO_RS15475	5
ARS007ss_ds.merged.samereadgroup.cleaned	3243983	3243995		YPO_RS15475	12
ARS007ss_ds.merged.samereadgroup.cleaned	3244639	3244642		YPO_RS15480	3
ARS007ss_ds.merged.samereadgroup.cleaned	3244785	3244787		YPO_RS15480	2
ARS007ss_ds.merged.samereadgroup.cleaned	3244862	3244864		YPO_RS15480	2
ARS007ss_ds.merged.samereadgroup.cleaned	3245238	3245241		csiE	3
ARS007ss_ds.merged.samereadgroup.cleaned	3245706	3245707		csiE	1
ARS007ss_ds.merged.samereadgroup.cleaned	3245965	3245978		csiE	13
ARS007ss_ds.merged.samereadgroup.cleaned	3246391	3246394		csiE	3
ARS007ss_ds.merged.samereadgroup.cleaned	3246766	3246767		YPO_RS15490	1
ARS007ss_ds.merged.samereadgroup.cleaned	3247409	3247436		YPO_RS15490	27
ARS007ss_ds.merged.samereadgroup.cleaned	3247641	3247648		YPO_RS15490	7
ARS007ss_ds.merged.samereadgroup.cleaned	3248339	3248341		ail	2
ARS007ss_ds.merged.samereadgroup.cleaned	3249374	3249375		YPO_RS15505	1
ARS007ss_ds.merged.samereadgroup.cleaned	3251692	3251706		hmpA	14
ARS007ss_ds.merged.samereadgroup.cleaned	3253836	3253852		glnB	16
ARS007ss_ds.merged.samereadgroup.cleaned	3255297	3255331		YPO_RS15525	34
ARS007ss_ds.merged.samereadgroup.cleaned	3256375	3256376		glrR	1
ARS007ss_ds.merged.samereadgroup.cleaned	3256551	3256556		glrR	5
ARS007ss_ds.merged.samereadgroup.cleaned	3258333	3258335		YPO_RS15540	2
ARS007ss_ds.merged.samereadgroup.cleaned	3258388	3258395		YPO_RS15540	7
ARS007ss_ds.merged.samereadgroup.cleaned	3259257	3259267		YPO_RS15540	10
ARS007ss_ds.merged.samereadgroup.cleaned	3261521	3261538		YPO_RS15555	17
ARS007ss_ds.merged.samereadgroup.cleaned	3262721	3262749		YPO_RS15560	28
ARS007ss_ds.merged.samereadgroup.cleaned	3262819	3262839		YPO_RS15560	20
ARS007ss_ds.merged.samereadgroup.cleaned	3263285	3263287		YPO_RS15565	2
ARS007ss_ds.merged.samereadgroup.cleaned	3264275	3264295		purL	20
ARS007ss_ds.merged.samereadgroup.cleaned	3265218	3265219		purL	1
ARS007ss_ds.merged.samereadgroup.cleaned	3266103	3266117		purL	14
ARS007ss_ds.merged.samereadgroup.cleaned	3266460	3266494		purL	34
ARS007ss_ds.merged.samereadgroup.cleaned	3267980	3267997		mltF	17
ARS007ss_ds.merged.samereadgroup.cleaned	3268524	3268530		mltF	6
ARS007ss_ds.merged.samereadgroup.cleaned	3269189	3269198		tadA	9
ARS007ss_ds.merged.samereadgroup.cleaned	3269847	3269861		yfhb	14
ARS007ss_ds.merged.samereadgroup.cleaned	3270228	3270243		yfhb	15
ARS007ss_ds.merged.samereadgroup.cleaned	3271256	3271272		murQ	16
ARS007ss_ds.merged.samereadgroup.cleaned	3272584	3272593		YPO_RS15595	9
ARS007ss_ds.merged.samereadgroup.cleaned	3274602	3274610		pdxJ	8
ARS007ss_ds.merged.samereadgroup.cleaned	3278139	3278161		tssK	22
ARS007ss_ds.merged.samereadgroup.cleaned	3279329	3279358		tssJ	29
ARS007ss_ds.merged.samereadgroup.cleaned	3280150	3280158		YPO_RS15645	8
ARS007ss_ds.merged.samereadgroup.cleaned	3280656	3280658		tssC	2
ARS007ss_ds.merged.samereadgroup.cleaned	3281167	3281168		tssC	1
ARS007ss_ds.merged.samereadgroup.cleaned	3281596	3281600		tssC	4
ARS007ss_ds.merged.samereadgroup.cleaned	3282536	3282539		tssB	3
ARS007ss_ds.merged.samereadgroup.cleaned	3283191	3283203		YPO_RS15660	12
ARS007ss_ds.merged.samereadgroup.cleaned	3283282	3283284		YPO_RS15660	2
ARS007ss_ds.merged.samereadgroup.cleaned	3284001	3284013		YPO_RS15665	12
ARS007ss_ds.merged.samereadgroup.cleaned	3284362	3284371		YPO_RS15665	9
ARS007ss_ds.merged.samereadgroup.cleaned	3285803	3285813		YPO_RS15675	10
ARS007ss_ds.merged.samereadgroup.cleaned	3285971	3286005		YPO_RS15675	34
ARS007ss_ds.merged.samereadgroup.cleaned	3286078	3286092		YPO_RS15675	14
ARS007ss_ds.merged.samereadgroup.cleaned	3286573	3286576		YPO_RS15675	3
ARS007ss_ds.merged.samereadgroup.cleaned	3287072	3287088		YPO_RS15675	16
ARS007ss_ds.merged.samereadgroup.cleaned	3287489	3287514		YPO_RS15680	25
ARS007ss_ds.merged.samereadgroup.cleaned	3289321	3289322		tssH	1
ARS007ss_ds.merged.samereadgroup.cleaned	3289932	3289960		tssH	28
ARS007ss_ds.merged.samereadgroup.cleaned	3290674	3290677		tssH	3
ARS007ss_ds.merged.samereadgroup.cleaned	3291050	3291079		tssH	29
ARS007ss_ds.merged.samereadgroup.cleaned	3292619	3292626		tssF	7
ARS007ss_ds.merged.samereadgroup.cleaned	3293309	3293313		tssF	4
ARS007ss_ds.merged.samereadgroup.cleaned	3293895	3293911		tssF	16
ARS007ss_ds.merged.samereadgroup.cleaned	3294252	3294272		tssF	20
ARS007ss_ds.merged.samereadgroup.cleaned	3293180	3293197		tssF	17
ARS007ss_ds.merged.samereadgroup.cleaned	3295018	3295019		tssG	1
ARS007ss_ds.merged.samereadgroup.cleaned	3295447	3295458		tssG	11
ARS007ss_ds.merged.samereadgroup.cleaned	3295943	3295961		YPO_RS15705	18
ARS007ss_ds.merged.samereadgroup.cleaned	3296652	3296675		YPO_RS15705	23
ARS007ss_ds.merged.samereadgroup.cleaned	3298135	3298140		YPO_RS15715	5
ARS007ss_ds.merged.samereadgroup.cleaned	3298918	3298920		YPO_RS15715	2
ARS007ss_ds.merged.samereadgroup.cleaned	3299170	3299177		YPO_RS15715	7
ARS007ss_ds.merged.samereadgroup.cleaned	3299237	3299249		YPO_RS15720	12
ARS007ss_ds.merged.samereadgroup.cleaned	3299625	3299640		YPO_RS15720	15
ARS007ss_ds.merged.samereadgroup.cleaned	3299683	3299685		YPO_RS15720	2
ARS007ss_ds.merged.samereadgroup.cleaned	3300854	3300866		YPO_RS15725	12
ARS007ss_ds.merged.samereadgroup.cleaned	3301028	3301044		YPO_RS15725	16
ARS007ss_ds.merged.samereadgroup.cleaned	3301084	3301087		YPO_RS15725	3
ARS007ss_ds.merged.samereadgroup.cleaned	3301419	3301437		YPO_RS15725	18
ARS007ss_ds.merged.samereadgroup.cleaned	3301823	3301847		YPO_RS15730	24
ARS007ss_ds.merged.samereadgroup.cleaned	3302760	3302827		YPO_RS15735	67
ARS007ss_ds.merged.samereadgroup.cleaned	3304314	3304321		mltB	7
ARS007ss_ds.merged.samereadgroup.cleaned	3305260	3305270		mltB	10
ARS007ss_ds.merged.samereadgroup.cleaned	3305858	3305866		YPO_RS15745	8
ARS007ss_ds.merged.samereadgroup.cleaned	3306959	3306961		YPO_RS15750	2
ARS007ss_ds.merged.samereadgroup.cleaned	3307340	3307383		YPO_RS15750	43
ARS007ss_ds.merged.samereadgroup.cleaned	3307696	3307707		YPO_RS15750	11
ARS007ss_ds.merged.samereadgroup.cleaned	3307856	3307857		YPO_RS15750	1
ARS007ss_ds.merged.samereadgroup.cleaned	3307895	3307905		YPO_RS15750	10
ARS007ss_ds.merged.samereadgroup.cleaned	3309842	3309865		YPO_RS15760	23
ARS007ss_ds.merged.samereadgroup.cleaned	3310495	3310496		YPO_RS15765	1
ARS007ss_ds.merged.samereadgroup.cleaned	3310669	3310670		YPO_RS15765	1
ARS007ss_ds.merged.samereadgroup.cleaned	3310743	3310771		YPO_RS15765	28
ARS007ss_ds.merged.samereadgroup.cleaned	3311363	3311367		YPO_RS15770	4
ARS007ss_ds.merged.samereadgroup.cleaned	3311465	3311485		YPO_RS15770	20
ARS007ss_ds.merged.samereadgroup.cleaned	3311648	3311656		YPO_RS15770	8
ARS007ss_ds.merged.samereadgroup.cleaned	3314057	3314085		YPO_RS15775	28
ARS007ss_ds.merged.samereadgroup.cleaned	3314521	3314525		YPO_RS15775	4
ARS007ss_ds.merged.samereadgroup.cleaned	3314895	3314902		YPO_RS15775	7
ARS007ss_ds.merged.samereadgroup.cleaned	3315321	3315324		dmsB	3
ARS007ss_ds.merged.samereadgroup.cleaned	3315506	3315510		dmsB	4
ARS007ss_ds.merged.samereadgroup.cleaned	3316070	3316071		YPO_RS15785	1
ARS007ss_ds.merged.samereadgroup.cleaned	3316101	3316108		YPO_RS15785	7
ARS007ss_ds.merged.samereadgroup.cleaned	3316301	3316306		YPO_RS15785	5
ARS007ss_ds.merged.samereadgroup.cleaned	3317609	3317612		YPO_RS15790	3
ARS007ss_ds.merged.samereadgroup.cleaned	3317864	3317882		YPO_RS15795	18
ARS007ss_ds.merged.samereadgroup.cleaned	3318061	3318067		YPO_RS15795	6
ARS007ss_ds.merged.samereadgroup.cleaned	3318216	3318217		YPO_RS15795	1
ARS007ss_ds.merged.samereadgroup.cleaned	3318222	3318235		YPO_RS15795	13
ARS007ss_ds.merged.samereadgroup.cleaned	3318654	3318670		YPO_RS15800	16
ARS007ss_ds.merged.samereadgroup.cleaned	3318860	3318871		YPO_RS15800	11
ARS007ss_ds.merged.samereadgroup.cleaned	3318932	3318941		YPO_RS15800	9
ARS007ss_ds.merged.samereadgroup.cleaned	3319490	3319502		YPO_RS15805	12
ARS007ss_ds.merged.samereadgroup.cleaned	3319761	3319782		YPO_RS15810	21
ARS007ss_ds.merged.samereadgroup.cleaned	3320209	3320272		YPO_RS15810	63
ARS007ss_ds.merged.samereadgroup.cleaned	3321197	3321216		YPO_RS15815	19
ARS007ss_ds.merged.samereadgroup.cleaned	3321888	3321891		YPO_RS15820	3
ARS007ss_ds.merged.samereadgroup.cleaned	3323728	3323739		YPO_RS15830	11
ARS007ss_ds.merged.samereadgroup.cleaned	3324435	3324439		YPO_RS15830	4
ARS007ss_ds.merged.samereadgroup.cleaned	3324631	3324665		YPO_RS15830	34
ARS007ss_ds.merged.samereadgroup.cleaned	3325754	3325770		glk	16
ARS007ss_ds.merged.samereadgroup.cleaned	3325821	3325830		glk	9
ARS007ss_ds.merged.samereadgroup.cleaned	3327026	3327031		YPO_RS15845	5
ARS007ss_ds.merged.samereadgroup.cleaned	3327364	3327366		YPO_RS15845	2
ARS007ss_ds.merged.samereadgroup.cleaned	3327843	3327851		YPO_RS15850	8
ARS007ss_ds.merged.samereadgroup.cleaned	3327894	3327937		YPO_RS15850	43
ARS007ss_ds.merged.samereadgroup.cleaned	3327975	3327981		YPO_RS15850	6
ARS007ss_ds.merged.samereadgroup.cleaned	3328286	3328288		YPO_RS15850	2
ARS007ss_ds.merged.samereadgroup.cleaned	3329629	3329636		YPO_RS15860	7
ARS007ss_ds.merged.samereadgroup.cleaned	3329949	3329954		YPO_RS15860	5
ARS007ss_ds.merged.samereadgroup.cleaned	3330015	3330024		YPO_RS15860	9
ARS007ss_ds.merged.samereadgroup.cleaned	3330179	3330183		YPO_RS15860	4
ARS007ss_ds.merged.samereadgroup.cleaned	3330484	3330485		YPO_RS15860	1
ARS007ss_ds.merged.samereadgroup.cleaned	3331099	3331106		YPO_RS15865	7
ARS007ss_ds.merged.samereadgroup.cleaned	3331305	3331306		YPO_RS15865	1
ARS007ss_ds.merged.samereadgroup.cleaned	3331427	3331430		YPO_RS15865	3
ARS007ss_ds.merged.samereadgroup.cleaned	3331637	3331662		YPO_RS15865	25
ARS007ss_ds.merged.samereadgroup.cleaned	3331867	3331868		YPO_RS15865	1
ARS007ss_ds.merged.samereadgroup.cleaned	3332122	3332126		YPO_RS15865	4
ARS007ss_ds.merged.samereadgroup.cleaned	3334139	3334147		gltX	8
ARS007ss_ds.merged.samereadgroup.cleaned	3334331	3334345		gltX	14
ARS007ss_ds.merged.samereadgroup.cleaned	3336256	3336260		YPO_RS15920	4
ARS007ss_ds.merged.samereadgroup.cleaned	3336622	3336635		YPO_RS15920	13
ARS007ss_ds.merged.samereadgroup.cleaned	3339391	3339392		ligA	1
ARS007ss_ds.merged.samereadgroup.cleaned	3339424	3339449		ligA	25
ARS007ss_ds.merged.samereadgroup.cleaned	3340507	3340508		zipA	1
ARS007ss_ds.merged.samereadgroup.cleaned	3341905	3341907		cysK	2
ARS007ss_ds.merged.samereadgroup.cleaned	3342081	3342083		cysK	2
ARS007ss_ds.merged.samereadgroup.cleaned	3342175	3342179		cysK	4
ARS007ss_ds.merged.samereadgroup.cleaned	3342426	3342443		cysK	17
ARS007ss_ds.merged.samereadgroup.cleaned	3344146	3344159		ptsI	13
ARS007ss_ds.merged.samereadgroup.cleaned	3344486	3344488		ptsI	2
ARS007ss_ds.merged.samereadgroup.cleaned	3345536	3345537		crr	1
ARS007ss_ds.merged.samereadgroup.cleaned	3345861	3345881		crr	20
ARS007ss_ds.merged.samereadgroup.cleaned	3347847	3347862		YPO_RS15975	15
ARS007ss_ds.merged.samereadgroup.cleaned	3348339	3348340		YPO_RS15980	1
ARS007ss_ds.merged.samereadgroup.cleaned	3348733	3348735		YPO_RS15980	2
ARS007ss_ds.merged.samereadgroup.cleaned	3348817	3348828		YPO_RS15980	11
ARS007ss_ds.merged.samereadgroup.cleaned	3349293	3349303		YPO_RS15985	10
ARS007ss_ds.merged.samereadgroup.cleaned	3350102	3350106		YPO_RS15985	4
ARS007ss_ds.merged.samereadgroup.cleaned	3350224	3350281		YPO_RS15985	57
ARS007ss_ds.merged.samereadgroup.cleaned	3351051	3351053		macB	2
ARS007ss_ds.merged.samereadgroup.cleaned	3351403	3351409		macB	6
ARS007ss_ds.merged.samereadgroup.cleaned	3351459	3351481		macB	22
ARS007ss_ds.merged.samereadgroup.cleaned	3351549	3351552		macB	3
ARS007ss_ds.merged.samereadgroup.cleaned	3351669	3351670		macB	1
ARS007ss_ds.merged.samereadgroup.cleaned	3352301	3352305		macB	4
ARS007ss_ds.merged.samereadgroup.cleaned	3352717	3352720		YPO_RS15995	3
ARS007ss_ds.merged.samereadgroup.cleaned	3352820	3352832		YPO_RS15995	12
ARS007ss_ds.merged.samereadgroup.cleaned	3353030	3353040		YPO_RS15995	10
ARS007ss_ds.merged.samereadgroup.cleaned	3353424	3353436		YPO_RS15995	12
ARS007ss_ds.merged.samereadgroup.cleaned	3353832	3353839		YPO_RS15995	7
ARS007ss_ds.merged.samereadgroup.cleaned	3353897	3353904		YPO_RS15995	7
ARS007ss_ds.merged.samereadgroup.cleaned	3354179	3354188		YPO_RS15995	9
ARS007ss_ds.merged.samereadgroup.cleaned	3354220	3354226		YPO_RS15995	6
ARS007ss_ds.merged.samereadgroup.cleaned	3354308	3354324		YPO_RS16000	16
ARS007ss_ds.merged.samereadgroup.cleaned	3354570	3354572		YPO_RS16000	2
ARS007ss_ds.merged.samereadgroup.cleaned	3354769	3354773		YPO_RS16000	4
ARS007ss_ds.merged.samereadgroup.cleaned	3354987	3354993		YPO_RS16000	6
ARS007ss_ds.merged.samereadgroup.cleaned	3355081	3355128		YPO_RS16000	47
ARS007ss_ds.merged.samereadgroup.cleaned	3355447	3355450		YPO_RS16000	3
ARS007ss_ds.merged.samereadgroup.cleaned	3355549	3355559		YPO_RS16000	10
ARS007ss_ds.merged.samereadgroup.cleaned	3355643	3355661		YPO_RS16000	18
ARS007ss_ds.merged.samereadgroup.cleaned	3356155	3356187		YPO_RS16010	32
ARS007ss_ds.merged.samereadgroup.cleaned	3356402	3356403		YPO_RS16010	1
ARS007ss_ds.merged.samereadgroup.cleaned	3357143	3357146		YPO_RS16015	3
ARS007ss_ds.merged.samereadgroup.cleaned	3357382	3357383		YPO_RS16020	1
ARS007ss_ds.merged.samereadgroup.cleaned	3358069	3358071		YPO_RS16020	2
ARS007ss_ds.merged.samereadgroup.cleaned	3359597	3359624		YPO_RS16025	27
ARS007ss_ds.merged.samereadgroup.cleaned	3359968	3359971		YPO_RS16025	3
ARS007ss_ds.merged.samereadgroup.cleaned	3360338	3360355		YPO_RS16025	17
ARS007ss_ds.merged.samereadgroup.cleaned	3361017	3361028		YPO_RS16030	11
ARS007ss_ds.merged.samereadgroup.cleaned	3361636	3361640		YPO_RS16030	4
ARS007ss_ds.merged.samereadgroup.cleaned	3361743	3361759		YPO_RS16030	16
ARS007ss_ds.merged.samereadgroup.cleaned	3362151	3362156		YPO_RS16030	5
ARS007ss_ds.merged.samereadgroup.cleaned	3363675	3363688		YPO_RS16040	13
ARS007ss_ds.merged.samereadgroup.cleaned	3363733	3363759		YPO_RS16040	26
ARS007ss_ds.merged.samereadgroup.cleaned	3363821	3363838		YPO_RS16040	17
ARS007ss_ds.merged.samereadgroup.cleaned	3363984	3364005		YPO_RS16040	21
ARS007ss_ds.merged.samereadgroup.cleaned	3364091	3364117		YPO_RS16040	26
ARS007ss_ds.merged.samereadgroup.cleaned	3364218	3364225		YPO_RS16040	7
ARS007ss_ds.merged.samereadgroup.cleaned	3364283	3364290		YPO_RS16040	7
ARS007ss_ds.merged.samereadgroup.cleaned	3364369	3364384		YPO_RS16040	15
ARS007ss_ds.merged.samereadgroup.cleaned	3364701	3364715		YPO_RS16040	14
ARS007ss_ds.merged.samereadgroup.cleaned	3367095	3367096		cysA	1
ARS007ss_ds.merged.samereadgroup.cleaned	3369230	3369238		YPO_RS16065	8
ARS007ss_ds.merged.samereadgroup.cleaned	3369666	3369672		YPO_RS16065	6
ARS007ss_ds.merged.samereadgroup.cleaned	3369765	3369768		YPO_RS16065	3
ARS007ss_ds.merged.samereadgroup.cleaned	3370205	3370215		YPO_RS16070	10
ARS007ss_ds.merged.samereadgroup.cleaned	3370399	3370409		YPO_RS16070	10
ARS007ss_ds.merged.samereadgroup.cleaned	3370605	3370606		YPO_RS16070	1
ARS007ss_ds.merged.samereadgroup.cleaned	3371415	3371445		YPO_RS16070	30
ARS007ss_ds.merged.samereadgroup.cleaned	3372720	3372725		YPO_RS16075	5
ARS007ss_ds.merged.samereadgroup.cleaned	3372760	3372790		YPO_RS16075	30
ARS007ss_ds.merged.samereadgroup.cleaned	3373376	3373385		YPO_RS16080	9
ARS007ss_ds.merged.samereadgroup.cleaned	3377956	3377979		YPO_RS16100	23
ARS007ss_ds.merged.samereadgroup.cleaned	3378627	3378632		YPO_RS16105	5
ARS007ss_ds.merged.samereadgroup.cleaned	3379469	3379499		YPO_RS16110	30
ARS007ss_ds.merged.samereadgroup.cleaned	3379676	3379720		YPO_RS16110	44
ARS007ss_ds.merged.samereadgroup.cleaned	3380413	3380424		YPO_RS16115	11
ARS007ss_ds.merged.samereadgroup.cleaned	3381236	3381274		yapL	38
ARS007ss_ds.merged.samereadgroup.cleaned	3382150	3382151		yapL	1
ARS007ss_ds.merged.samereadgroup.cleaned	3383545	3383557		YPO_RS16125	12
ARS007ss_ds.merged.samereadgroup.cleaned	3383651	3383661		YPO_RS16125	10
ARS007ss_ds.merged.samereadgroup.cleaned	3383723	3383742		YPO_RS16125	19
ARS007ss_ds.merged.samereadgroup.cleaned	3383854	3383860		YPO_RS16125	6
ARS007ss_ds.merged.samereadgroup.cleaned	3386294	3386297		YPO_RS16140	3
ARS007ss_ds.merged.samereadgroup.cleaned	3387210	3387224		maeB	14
ARS007ss_ds.merged.samereadgroup.cleaned	3387709	3387716		maeB	7
ARS007ss_ds.merged.samereadgroup.cleaned	3388298	3388306		maeB	8
ARS007ss_ds.merged.samereadgroup.cleaned	3388513	3388515		maeB	2
ARS007ss_ds.merged.samereadgroup.cleaned	3389240	3389249		nudK	9
ARS007ss_ds.merged.samereadgroup.cleaned	3389317	3389325		nudK	8
ARS007ss_ds.merged.samereadgroup.cleaned	3390664	3390666		napB	2
ARS007ss_ds.merged.samereadgroup.cleaned	3390879	3390884		napB	5
ARS007ss_ds.merged.samereadgroup.cleaned	3391053	3391055		napA	2
ARS007ss_ds.merged.samereadgroup.cleaned	3391130	3391140		napA	10
ARS007ss_ds.merged.samereadgroup.cleaned	3391186	3391188		napA	2
ARS007ss_ds.merged.samereadgroup.cleaned	3391343	3391364		napA	21
ARS007ss_ds.merged.samereadgroup.cleaned	3391891	3391896		napA	5
ARS007ss_ds.merged.samereadgroup.cleaned	3391956	3391967		napA	11
ARS007ss_ds.merged.samereadgroup.cleaned	3392374	3392381		napA	7
ARS007ss_ds.merged.samereadgroup.cleaned	3392740	3392752		napA	12
ARS007ss_ds.merged.samereadgroup.cleaned	3393354	3393360		napA	6
ARS007ss_ds.merged.samereadgroup.cleaned	3393690	3393694		napD	4
ARS007ss_ds.merged.samereadgroup.cleaned	3393831	3393875		napF	44
ARS007ss_ds.merged.samereadgroup.cleaned	3394205	3394215		napF	10
ARS007ss_ds.merged.samereadgroup.cleaned	3395972	3395986		YPO_RS16185	14
ARS007ss_ds.merged.samereadgroup.cleaned	3396579	3396583		acrD	4
ARS007ss_ds.merged.samereadgroup.cleaned	3396822	3396823		acrD	1
ARS007ss_ds.merged.samereadgroup.cleaned	3397043	3397055		acrD	12
ARS007ss_ds.merged.samereadgroup.cleaned	3398530	3398550		acrD	20
ARS007ss_ds.merged.samereadgroup.cleaned	3399172	3399182		acrD	10
ARS007ss_ds.merged.samereadgroup.cleaned	3399464	3399469		acrD	5
ARS007ss_ds.merged.samereadgroup.cleaned	3399832	3399842		YPO_RS16195	10
ARS007ss_ds.merged.samereadgroup.cleaned	3401021	3401024		YPO_RS16200	3
ARS007ss_ds.merged.samereadgroup.cleaned	3403008	3403009		YPO_RS16205	1
ARS007ss_ds.merged.samereadgroup.cleaned	3403235	3403295		YPO_RS16210	60
ARS007ss_ds.merged.samereadgroup.cleaned	3403402	3403448		YPO_RS16210	46
ARS007ss_ds.merged.samereadgroup.cleaned	3403584	3403585		YPO_RS16210	1
ARS007ss_ds.merged.samereadgroup.cleaned	3404510	3404522		YPO_RS16210	12
ARS007ss_ds.merged.samereadgroup.cleaned	3404826	3404827		YPO_RS16210	1
ARS007ss_ds.merged.samereadgroup.cleaned	3405492	3405528		YPO_RS16220	36
ARS007ss_ds.merged.samereadgroup.cleaned	3405634	3405672		YPO_RS16220	38
ARS007ss_ds.merged.samereadgroup.cleaned	3406810	3406814		YPO_RS16225	4
ARS007ss_ds.merged.samereadgroup.cleaned	3407552	3407575		YPO_RS16225	23
ARS007ss_ds.merged.samereadgroup.cleaned	3407656	3407660		YPO_RS16225	4
ARS007ss_ds.merged.samereadgroup.cleaned	3408140	3408157		YPO_RS16225	17
ARS007ss_ds.merged.samereadgroup.cleaned	3408628	3408631		YPO_RS16230	3
ARS007ss_ds.merged.samereadgroup.cleaned	3408923	3408937		YPO_RS16230	14
ARS007ss_ds.merged.samereadgroup.cleaned	3410492	3410496		YPO_RS16240	4
ARS007ss_ds.merged.samereadgroup.cleaned	3411028	3411051		dapE	23
ARS007ss_ds.merged.samereadgroup.cleaned	3411455	3411458		dapE	3
ARS007ss_ds.merged.samereadgroup.cleaned	3413013	3413048		YPO_RS16260	35
ARS007ss_ds.merged.samereadgroup.cleaned	3413517	3413518		YPO_RS16260	1
ARS007ss_ds.merged.samereadgroup.cleaned	3414236	3414264		YPO_RS16260	28
ARS007ss_ds.merged.samereadgroup.cleaned	3415214	3415242		YPO_RS16265	28
ARS007ss_ds.merged.samereadgroup.cleaned	3415283	3415296		YPO_RS16265	13
ARS007ss_ds.merged.samereadgroup.cleaned	3416133	3416147		YPO_RS16270	14
ARS007ss_ds.merged.samereadgroup.cleaned	3416436	3416448		YPO_RS16270	12
ARS007ss_ds.merged.samereadgroup.cleaned	3418767	3418775		bamC	8
ARS007ss_ds.merged.samereadgroup.cleaned	3420420	3420431		YPO_RS16295	11
ARS007ss_ds.merged.samereadgroup.cleaned	3421133	3421135		bcp	2
ARS007ss_ds.merged.samereadgroup.cleaned	3422274	3422278		YPO_RS16305	4
ARS007ss_ds.merged.samereadgroup.cleaned	3422526	3422537		YPO_RS16305	11
ARS007ss_ds.merged.samereadgroup.cleaned	3423559	3423563		YPO_RS16310	4
ARS007ss_ds.merged.samereadgroup.cleaned	3423812	3423822		YPO_RS16310	10
ARS007ss_ds.merged.samereadgroup.cleaned	3424425	3424429		YPO_RS16310	4
ARS007ss_ds.merged.samereadgroup.cleaned	3424784	3424797		YPO_RS16315	13
ARS007ss_ds.merged.samereadgroup.cleaned	3424886	3424888		YPO_RS16315	2
ARS007ss_ds.merged.samereadgroup.cleaned	3424984	3424995		YPO_RS16315	11
ARS007ss_ds.merged.samereadgroup.cleaned	3425261	3425265		YPO_RS16315	4
ARS007ss_ds.merged.samereadgroup.cleaned	3425310	3425313		YPO_RS16315	3
ARS007ss_ds.merged.samereadgroup.cleaned	3425768	3425783		YPO_RS16315	15
ARS007ss_ds.merged.samereadgroup.cleaned	3425839	3425840		YPO_RS16315	1
ARS007ss_ds.merged.samereadgroup.cleaned	3425942	3425952		YPO_RS16315	10
ARS007ss_ds.merged.samereadgroup.cleaned	3429929	3429933		cysS	4
ARS007ss_ds.merged.samereadgroup.cleaned	3430779	3430798		YPO_RS16345	19
ARS007ss_ds.merged.samereadgroup.cleaned	3431061	3431073		YPO_RS16345	12
ARS007ss_ds.merged.samereadgroup.cleaned	3431361	3431377		YPO_RS16345	16
ARS007ss_ds.merged.samereadgroup.cleaned	3432678	3432680		purK	2
ARS007ss_ds.merged.samereadgroup.cleaned	3433248	3433252		purK	4
ARS007ss_ds.merged.samereadgroup.cleaned	3433560	3433568		YPO_RS16360	8
ARS007ss_ds.merged.samereadgroup.cleaned	3433688	3433689		YPO_RS16360	1
ARS007ss_ds.merged.samereadgroup.cleaned	3433856	3433860		YPO_RS16360	4
ARS007ss_ds.merged.samereadgroup.cleaned	3434052	3434058		YPO_RS16360	6
ARS007ss_ds.merged.samereadgroup.cleaned	3434160	3434176		YPO_RS16360	16
ARS007ss_ds.merged.samereadgroup.cleaned	3434588	3434610		YPO_RS16360	22
ARS007ss_ds.merged.samereadgroup.cleaned	3434733	3434752		YPO_RS16360	19
ARS007ss_ds.merged.samereadgroup.cleaned	3434797	3434800		YPO_RS16360	3
ARS007ss_ds.merged.samereadgroup.cleaned	3436887	3436893		tesA	6
ARS007ss_ds.merged.samereadgroup.cleaned	3437800	3438248		YPO_RS16375	448
ARS007ss_ds.merged.samereadgroup.cleaned	3438325	3439194		YPO_RS16380	869
ARS007ss_ds.merged.samereadgroup.cleaned	3439389	3439705		YPO_RS16385	316
ARS007ss_ds.merged.samereadgroup.cleaned	3439747	3439790		YPO_RS16385	43
ARS007ss_ds.merged.samereadgroup.cleaned	3439852	3439880		YPO_RS16385	28
ARS007ss_ds.merged.samereadgroup.cleaned	3440242	3440247		YPO_RS16385	5
ARS007ss_ds.merged.samereadgroup.cleaned	3442180	3442182		copA	2
ARS007ss_ds.merged.samereadgroup.cleaned	3442634	3442639		copA	5
ARS007ss_ds.merged.samereadgroup.cleaned	3443192	3443198		copA	6
ARS007ss_ds.merged.samereadgroup.cleaned	3443266	3443280		copA	14
ARS007ss_ds.merged.samereadgroup.cleaned	3444029	3444037		copA	8
ARS007ss_ds.merged.samereadgroup.cleaned	3444941	3444949		YPO_RS16405	8
ARS007ss_ds.merged.samereadgroup.cleaned	3446906	3446942		YPO_RS16415	36
ARS007ss_ds.merged.samereadgroup.cleaned	3449913	3449982		YPO_RS16425	69
ARS007ss_ds.merged.samereadgroup.cleaned	3450148	3450185		YPO_RS16425	37
ARS007ss_ds.merged.samereadgroup.cleaned	3450523	3450540		YPO_RS16430	17
ARS007ss_ds.merged.samereadgroup.cleaned	3450602	3450616		YPO_RS16430	14
ARS007ss_ds.merged.samereadgroup.cleaned	3451605	3451621		YPO_RS16430	16
ARS007ss_ds.merged.samereadgroup.cleaned	3451809	3451823		YPO_RS16430	14
ARS007ss_ds.merged.samereadgroup.cleaned	3452098	3452099		YPO_RS16430	1
ARS007ss_ds.merged.samereadgroup.cleaned	3452531	3452549		YPO_RS16435	18
ARS007ss_ds.merged.samereadgroup.cleaned	3452891	3452940		YPO_RS16435	49
ARS007ss_ds.merged.samereadgroup.cleaned	3453259	3453261		YPO_RS16435	2
ARS007ss_ds.merged.samereadgroup.cleaned	3453484	3453495		YPO_RS16435	11
ARS007ss_ds.merged.samereadgroup.cleaned	3454286	3454302		fepE	16
ARS007ss_ds.merged.samereadgroup.cleaned	3454445	3454460		fepE	15
ARS007ss_ds.merged.samereadgroup.cleaned	3454768	3454835		fepE	67
ARS007ss_ds.merged.samereadgroup.cleaned	3455009	3455070		cpsG	61
ARS007ss_ds.merged.samereadgroup.cleaned	3455150	3455160		cpsG	10
ARS007ss_ds.merged.samereadgroup.cleaned	3455592	3455598		cpsG	6
ARS007ss_ds.merged.samereadgroup.cleaned	3455663	3455674		cpsG	11
ARS007ss_ds.merged.samereadgroup.cleaned	3455886	3455962		cpsG	76
ARS007ss_ds.merged.samereadgroup.cleaned	3456107	3456183		cpsG	76
ARS007ss_ds.merged.samereadgroup.cleaned	3456248	3456250		cpsG	2
ARS007ss_ds.merged.samereadgroup.cleaned	3456471	3456527		YPO_RS16450	56
ARS007ss_ds.merged.samereadgroup.cleaned	3456575	3456590		YPO_RS16450	15
ARS007ss_ds.merged.samereadgroup.cleaned	3456842	3456849		YPO_RS16450	7
ARS007ss_ds.merged.samereadgroup.cleaned	3457097	3457112		YPO_RS16450	15
ARS007ss_ds.merged.samereadgroup.cleaned	3457755	3457769		YPO_RS16455	14
ARS007ss_ds.merged.samereadgroup.cleaned	3461015	3461032		YPO_RS16470	17
ARS007ss_ds.merged.samereadgroup.cleaned	3461159	3461173		YPO_RS16470	14
ARS007ss_ds.merged.samereadgroup.cleaned	3461336	3461348		YPO_RS16470	12
ARS007ss_ds.merged.samereadgroup.cleaned	3461652	3461657		YPO_RS16470	5
ARS007ss_ds.merged.samereadgroup.cleaned	3461805	3461854		YPO_RS16470	49
ARS007ss_ds.merged.samereadgroup.cleaned	3463321	3463410		YPO_RS16480	89
ARS007ss_ds.merged.samereadgroup.cleaned	3463470	3463475		YPO_RS16480	5
ARS007ss_ds.merged.samereadgroup.cleaned	3463728	3463809		YPO_RS16480	81
ARS007ss_ds.merged.samereadgroup.cleaned	3463900	3463946		YPO_RS16480	46
ARS007ss_ds.merged.samereadgroup.cleaned	3464021	3464031		YPO_RS16480	10
ARS007ss_ds.merged.samereadgroup.cleaned	3464169	3464174		YPO_RS16480	5
ARS007ss_ds.merged.samereadgroup.cleaned	3464843	3464874		YPO_RS16485	31
ARS007ss_ds.merged.samereadgroup.cleaned	3465021	3465112		YPO_RS16485	91
ARS007ss_ds.merged.samereadgroup.cleaned	3465214	3465243		YPO_RS16485	29
ARS007ss_ds.merged.samereadgroup.cleaned	3465307	3465330		YPO_RS16485	23
ARS007ss_ds.merged.samereadgroup.cleaned	3465430	3465435		YPO_RS16485	5
ARS007ss_ds.merged.samereadgroup.cleaned	3465486	3465556		YPO_RS16485	70
ARS007ss_ds.merged.samereadgroup.cleaned	3466043	3466059		YPO_RS16490	16
ARS007ss_ds.merged.samereadgroup.cleaned	3466258	3466387		YPO_RS16490	129
ARS007ss_ds.merged.samereadgroup.cleaned	3466530	3466531		YPO_RS16490	1
ARS007ss_ds.merged.samereadgroup.cleaned	3466579	3466651		YPO_RS16490	72
ARS007ss_ds.merged.samereadgroup.cleaned	3466787	3466798		YPO_RS16490	11
ARS007ss_ds.merged.samereadgroup.cleaned	3466863	3466871		YPO_RS16490	8
ARS007ss_ds.merged.samereadgroup.cleaned	3466984	3467000		YPO_RS16495	16
ARS007ss_ds.merged.samereadgroup.cleaned	3467372	3467407		YPO_RS16495	35
ARS007ss_ds.merged.samereadgroup.cleaned	3467465	3467532		YPO_RS16495	67
ARS007ss_ds.merged.samereadgroup.cleaned	3468212	3468215		YPO_RS16495	3
ARS007ss_ds.merged.samereadgroup.cleaned	3468387	3468392		YPO_RS16500	5
ARS007ss_ds.merged.samereadgroup.cleaned	3468703	3468704		YPO_RS16500	1
ARS007ss_ds.merged.samereadgroup.cleaned	3471583	3471594		rfbF	11
ARS007ss_ds.merged.samereadgroup.cleaned	3472482	3472484		YPO_RS16520	2
ARS007ss_ds.merged.samereadgroup.cleaned	3472743	3472745		YPO_RS16520	2
ARS007ss_ds.merged.samereadgroup.cleaned	3473064	3473119		YPO_RS16520	55
ARS007ss_ds.merged.samereadgroup.cleaned	3473994	3474004		hemH	10
ARS007ss_ds.merged.samereadgroup.cleaned	3474290	3474292		hemH	2
ARS007ss_ds.merged.samereadgroup.cleaned	3475393	3475395		adk	2
ARS007ss_ds.merged.samereadgroup.cleaned	3476347	3476351		htpG	4
ARS007ss_ds.merged.samereadgroup.cleaned	3477537	3477541		htpG	4
ARS007ss_ds.merged.samereadgroup.cleaned	3478075	3478099		recR	24
ARS007ss_ds.merged.samereadgroup.cleaned	3478195	3478197		recR	2
ARS007ss_ds.merged.samereadgroup.cleaned	3479753	3479768		dnaX	15
ARS007ss_ds.merged.samereadgroup.cleaned	3480783	3480797		dnaX	14
ARS007ss_ds.merged.samereadgroup.cleaned	3481900	3481901		apt	1
ARS007ss_ds.merged.samereadgroup.cleaned	3485405	3485420		YPO_RS16575	15
ARS007ss_ds.merged.samereadgroup.cleaned	3486828	3486830		mscK	2
ARS007ss_ds.merged.samereadgroup.cleaned	3487016	3487027		mscK	11
ARS007ss_ds.merged.samereadgroup.cleaned	3487413	3487421		mscK	8
ARS007ss_ds.merged.samereadgroup.cleaned	3487935	3487958		mscK	23
ARS007ss_ds.merged.samereadgroup.cleaned	3491708	3491710		YPO_RS16600	2
ARS007ss_ds.merged.samereadgroup.cleaned	3492818	3492830		YPO_RS16605	12
ARS007ss_ds.merged.samereadgroup.cleaned	3493147	3493149		YPO_RS16605	2
ARS007ss_ds.merged.samereadgroup.cleaned	3495084	3495090		YPO_RS16605	6
ARS007ss_ds.merged.samereadgroup.cleaned	3495173	3495199		YPO_RS16605	26
ARS007ss_ds.merged.samereadgroup.cleaned	3495563	3495568		YPO_RS16610	5
ARS007ss_ds.merged.samereadgroup.cleaned	3496918	3496930		YPO_RS16620	12
ARS007ss_ds.merged.samereadgroup.cleaned	3497463	3497464		tomB	1
ARS007ss_ds.merged.samereadgroup.cleaned	3500623	3500624		tesB	1
ARS007ss_ds.merged.samereadgroup.cleaned	3501613	3501614		amtB	1
ARS007ss_ds.merged.samereadgroup.cleaned	3502811	3502822		glnK	11
ARS007ss_ds.merged.samereadgroup.cleaned	3503360	3503380		YPO_RS16665	20
ARS007ss_ds.merged.samereadgroup.cleaned	3503711	3503743		YPO_RS16665	32
ARS007ss_ds.merged.samereadgroup.cleaned	3503880	3503887		YPO_RS16665	7
ARS007ss_ds.merged.samereadgroup.cleaned	3504114	3504123		YPO_RS16665	9
ARS007ss_ds.merged.samereadgroup.cleaned	3504288	3504295		YPO_RS16665	7
ARS007ss_ds.merged.samereadgroup.cleaned	3504847	3504851		YPO_RS16665	4
ARS007ss_ds.merged.samereadgroup.cleaned	3505807	3505822		YPO_RS16670	15
ARS007ss_ds.merged.samereadgroup.cleaned	3506121	3506134		YPO_RS16670	13
ARS007ss_ds.merged.samereadgroup.cleaned	3506453	3506489		YPO_RS16670	36
ARS007ss_ds.merged.samereadgroup.cleaned	3506822	3506823		YPO_RS16670	1
ARS007ss_ds.merged.samereadgroup.cleaned	3507579	3507591		YPO_RS16680	12
ARS007ss_ds.merged.samereadgroup.cleaned	3507676	3507704		YPO_RS16680	28
ARS007ss_ds.merged.samereadgroup.cleaned	3508845	3508873		cof	28
ARS007ss_ds.merged.samereadgroup.cleaned	3509289	3509293		cof	4
ARS007ss_ds.merged.samereadgroup.cleaned	3510087	3510096		YPO_RS16690	9
ARS007ss_ds.merged.samereadgroup.cleaned	3510661	3510663		YPO_RS16690	2
ARS007ss_ds.merged.samereadgroup.cleaned	3511375	3511382		YPO_RS16690	7
ARS007ss_ds.merged.samereadgroup.cleaned	3514384	3514388		ppiD	4
ARS007ss_ds.merged.samereadgroup.cleaned	3514983	3514995		ppiD	12
ARS007ss_ds.merged.samereadgroup.cleaned	3516274	3516283		hupB	9
ARS007ss_ds.merged.samereadgroup.cleaned	3516543	3516545		lon	2
ARS007ss_ds.merged.samereadgroup.cleaned	3516695	3516703		lon	8
ARS007ss_ds.merged.samereadgroup.cleaned	3517030	3517051		lon	21
ARS007ss_ds.merged.samereadgroup.cleaned	3517808	3517814		lon	6
ARS007ss_ds.merged.samereadgroup.cleaned	3520936	3520946		clpP	10
ARS007ss_ds.merged.samereadgroup.cleaned	3522345	3522367		tig	22
ARS007ss_ds.merged.samereadgroup.cleaned	3524088	3524091		YPO_RS16745	3
ARS007ss_ds.merged.samereadgroup.cleaned	3524951	3524961		ampG	10
ARS007ss_ds.merged.samereadgroup.cleaned	3525663	3525668		ampG	5
ARS007ss_ds.merged.samereadgroup.cleaned	3526124	3526127		ampG	3
ARS007ss_ds.merged.samereadgroup.cleaned	3527255	3527267		YPO_RS16755	12
ARS007ss_ds.merged.samereadgroup.cleaned	3528423	3528425		cyoA	2
ARS007ss_ds.merged.samereadgroup.cleaned	3528512	3528520		cyoA	8
ARS007ss_ds.merged.samereadgroup.cleaned	3529613	3529617		cyoB	4
ARS007ss_ds.merged.samereadgroup.cleaned	3530874	3530876		YPO_RS16770	2
ARS007ss_ds.merged.samereadgroup.cleaned	3531009	3531015		YPO_RS16770	6
ARS007ss_ds.merged.samereadgroup.cleaned	3531296	3531314		YPO_RS16775	18
ARS007ss_ds.merged.samereadgroup.cleaned	3531643	3531659		cyoE	16
ARS007ss_ds.merged.samereadgroup.cleaned	3532124	3532127		cyoE	3
ARS007ss_ds.merged.samereadgroup.cleaned	3532951	3532960		YPO_RS16785	9
ARS007ss_ds.merged.samereadgroup.cleaned	3534442	3534454		YPO_RS16790	12
ARS007ss_ds.merged.samereadgroup.cleaned	3534635	3534664		YPO_RS16790	29
ARS007ss_ds.merged.samereadgroup.cleaned	3535773	3535787		panE	14
ARS007ss_ds.merged.samereadgroup.cleaned	3536336	3536367		yajL	31
ARS007ss_ds.merged.samereadgroup.cleaned	3536801	3536818		thiI	17
ARS007ss_ds.merged.samereadgroup.cleaned	3537304	3537306		thiI	2
ARS007ss_ds.merged.samereadgroup.cleaned	3537453	3537457		thiI	4
ARS007ss_ds.merged.samereadgroup.cleaned	3537708	3537710		thiI	2
ARS007ss_ds.merged.samereadgroup.cleaned	3538956	3538980		ispA	24
ARS007ss_ds.merged.samereadgroup.cleaned	3540322	3540329		dxs	7
ARS007ss_ds.merged.samereadgroup.cleaned	3540941	3540946		dxs	5
ARS007ss_ds.merged.samereadgroup.cleaned	3541055	3541073		dxs	18
ARS007ss_ds.merged.samereadgroup.cleaned	3541176	3541193		dxs	17
ARS007ss_ds.merged.samereadgroup.cleaned	3541279	3541280		dxs	1
ARS007ss_ds.merged.samereadgroup.cleaned	3541471	3541480		dxs	9
ARS007ss_ds.merged.samereadgroup.cleaned	3542890	3542904		pgpA	14
ARS007ss_ds.merged.samereadgroup.cleaned	3543166	3543185		thiL	19
ARS007ss_ds.merged.samereadgroup.cleaned	3543524	3543530		thiL	6
ARS007ss_ds.merged.samereadgroup.cleaned	3544704	3544706		ribE	2
ARS007ss_ds.merged.samereadgroup.cleaned	3544861	3544862		ribE	1
ARS007ss_ds.merged.samereadgroup.cleaned	3544938	3544956		ribE	18
ARS007ss_ds.merged.samereadgroup.cleaned	3546810	3546811		nrdR	1
ARS007ss_ds.merged.samereadgroup.cleaned	3547210	3547250		YPO_RS16860	40
ARS007ss_ds.merged.samereadgroup.cleaned	3547327	3547328		YPO_RS16860	1
ARS007ss_ds.merged.samereadgroup.cleaned	3547433	3547467		YPO_RS16860	34
ARS007ss_ds.merged.samereadgroup.cleaned	3547949	3547954		YPO_RS16865	5
ARS007ss_ds.merged.samereadgroup.cleaned	3548027	3548135		YPO_RS16865	108
ARS007ss_ds.merged.samereadgroup.cleaned	3548297	3548309		YPO_RS16865	12
ARS007ss_ds.merged.samereadgroup.cleaned	3549432	3549451		secF	19
ARS007ss_ds.merged.samereadgroup.cleaned	3549975	3549979		secF	4
ARS007ss_ds.merged.samereadgroup.cleaned	3550723	3550770		secD	47
ARS007ss_ds.merged.samereadgroup.cleaned	3551748	3551762		secD	14
ARS007ss_ds.merged.samereadgroup.cleaned	3552958	3552979		tgt	21
ARS007ss_ds.merged.samereadgroup.cleaned	3553240	3553242		tgt	2
ARS007ss_ds.merged.samereadgroup.cleaned	3553565	3553566		tgt	1
ARS007ss_ds.merged.samereadgroup.cleaned	3553647	3553648		tgt	1
ARS007ss_ds.merged.samereadgroup.cleaned	3554244	3554247		queA	3
ARS007ss_ds.merged.samereadgroup.cleaned	3555545	3555549		YPO_RS16900	4
ARS007ss_ds.merged.samereadgroup.cleaned	3559671	3559686		YPO_RS16920	15
ARS007ss_ds.merged.samereadgroup.cleaned	3559758	3559759		YPO_RS16920	1
ARS007ss_ds.merged.samereadgroup.cleaned	3560286	3560293		YPO_RS16920	7
ARS007ss_ds.merged.samereadgroup.cleaned	3560987	3560989		malZ	2
ARS007ss_ds.merged.samereadgroup.cleaned	3561051	3561060		malZ	9
ARS007ss_ds.merged.samereadgroup.cleaned	3563728	3563751		proY	23
ARS007ss_ds.merged.samereadgroup.cleaned	3564580	3564581		brnQ	1
ARS007ss_ds.merged.samereadgroup.cleaned	3565144	3565163		brnQ	19
ARS007ss_ds.merged.samereadgroup.cleaned	3565313	3565324		brnQ	11
ARS007ss_ds.merged.samereadgroup.cleaned	3565578	3565584		brnQ	6
ARS007ss_ds.merged.samereadgroup.cleaned	3566593	3566595		YPO_RS16945	2
ARS007ss_ds.merged.samereadgroup.cleaned	3568195	3568220		phoR	25
ARS007ss_ds.merged.samereadgroup.cleaned	3569535	3569542		sbcD	7
ARS007ss_ds.merged.samereadgroup.cleaned	3569765	3569771		sbcD	6
ARS007ss_ds.merged.samereadgroup.cleaned	3571765	3571769		YPO_RS16965	4
ARS007ss_ds.merged.samereadgroup.cleaned	3572085	3572127		YPO_RS16965	42
ARS007ss_ds.merged.samereadgroup.cleaned	3572320	3572329		YPO_RS16965	9
ARS007ss_ds.merged.samereadgroup.cleaned	3572592	3572609		YPO_RS16965	17
ARS007ss_ds.merged.samereadgroup.cleaned	3573938	3573942		YPO_RS16965	4
ARS007ss_ds.merged.samereadgroup.cleaned	3577194	3577206		mak	12
ARS007ss_ds.merged.samereadgroup.cleaned	3577466	3577485		mak	19
ARS007ss_ds.merged.samereadgroup.cleaned	3578372	3578385		rdgC	13
ARS007ss_ds.merged.samereadgroup.cleaned	3580276	3580281		aroL	5
ARS007ss_ds.merged.samereadgroup.cleaned	3580484	3580512		aroL	28
ARS007ss_ds.merged.samereadgroup.cleaned	3582742	3582744		YPO_RS17005	2
ARS007ss_ds.merged.samereadgroup.cleaned	3583055	3583101		YPO_RS17010	46
ARS007ss_ds.merged.samereadgroup.cleaned	3583132	3583150		YPO_RS17010	18
ARS007ss_ds.merged.samereadgroup.cleaned	3583241	3583251		YPO_RS17010	10
ARS007ss_ds.merged.samereadgroup.cleaned	3584822	3584837		proA	15
ARS007ss_ds.merged.samereadgroup.cleaned	3585925	3585931		proB	6
ARS007ss_ds.merged.samereadgroup.cleaned	3586286	3586292		proB	6
ARS007ss_ds.merged.samereadgroup.cleaned	3586442	3586447		proB	5
ARS007ss_ds.merged.samereadgroup.cleaned	3589189	3589213		gpt	24
ARS007ss_ds.merged.samereadgroup.cleaned	3589274	3589290		gpt	16
ARS007ss_ds.merged.samereadgroup.cleaned	3589892	3589898		YPO_RS17045	6
ARS007ss_ds.merged.samereadgroup.cleaned	3590026	3590035		YPO_RS17045	9
ARS007ss_ds.merged.samereadgroup.cleaned	3590104	3590128		YPO_RS17045	24
ARS007ss_ds.merged.samereadgroup.cleaned	3591696	3591722		YPO_RS17050	26
ARS007ss_ds.merged.samereadgroup.cleaned	3592389	3592554		YPO_RS17055	165
ARS007ss_ds.merged.samereadgroup.cleaned	3592802	3592811		YPO_RS17055	9
ARS007ss_ds.merged.samereadgroup.cleaned	3595732	3595734		pepD	2
ARS007ss_ds.merged.samereadgroup.cleaned	3596508	3596512		pepD	4
ARS007ss_ds.merged.samereadgroup.cleaned	3596898	3596900		dinB	2
ARS007ss_ds.merged.samereadgroup.cleaned	3598235	3598244		YPO_RS17070	9
ARS007ss_ds.merged.samereadgroup.cleaned	3598445	3598453		YPO_RS17070	8
ARS007ss_ds.merged.samereadgroup.cleaned	3598500	3598545		YPO_RS17070	45
ARS007ss_ds.merged.samereadgroup.cleaned	3598740	3598745		YPO_RS17070	5
ARS007ss_ds.merged.samereadgroup.cleaned	3599108	3599110		YPO_RS17070	2
ARS007ss_ds.merged.samereadgroup.cleaned	3599726	3599760		YPO_RS17080	34
ARS007ss_ds.merged.samereadgroup.cleaned	3599899	3599905		YPO_RS17080	6
ARS007ss_ds.merged.samereadgroup.cleaned	3600279	3600292		YPO_RS17080	13
ARS007ss_ds.merged.samereadgroup.cleaned	3600566	3600580		YPO_RS17080	14
ARS007ss_ds.merged.samereadgroup.cleaned	3600833	3600836		nqrF	3
ARS007ss_ds.merged.samereadgroup.cleaned	3601619	3601620		nqrF	1
ARS007ss_ds.merged.samereadgroup.cleaned	3602049	3602052		nqrE	3
ARS007ss_ds.merged.samereadgroup.cleaned	3602218	3602223		nqrE	5
ARS007ss_ds.merged.samereadgroup.cleaned	3602278	3602281		nqrE	3
ARS007ss_ds.merged.samereadgroup.cleaned	3602713	3602718		YPO_RS17095	5
ARS007ss_ds.merged.samereadgroup.cleaned	3603020	3603025		YPO_RS17095	5
ARS007ss_ds.merged.samereadgroup.cleaned	3603116	3603117		YPO_RS17095	1
ARS007ss_ds.merged.samereadgroup.cleaned	3603509	3603527		YPO_RS17100	18
ARS007ss_ds.merged.samereadgroup.cleaned	3603803	3603813		YPO_RS17100	10
ARS007ss_ds.merged.samereadgroup.cleaned	3604100	3604101		YPO_RS17105	1
ARS007ss_ds.merged.samereadgroup.cleaned	3604356	3604359		YPO_RS17105	3
ARS007ss_ds.merged.samereadgroup.cleaned	3604558	3604559		YPO_RS17105	1
ARS007ss_ds.merged.samereadgroup.cleaned	3604824	3604830		YPO_RS17105	6
ARS007ss_ds.merged.samereadgroup.cleaned	3605293	3605303		YPO_RS17110	10
ARS007ss_ds.merged.samereadgroup.cleaned	3606398	3606414		YPO_RS17110	16
ARS007ss_ds.merged.samereadgroup.cleaned	3608397	3608398		YPO_RS17120	1
ARS007ss_ds.merged.samereadgroup.cleaned	3608676	3608677		lpcA	1
ARS007ss_ds.merged.samereadgroup.cleaned	3609250	3609257		lpcA	7
ARS007ss_ds.merged.samereadgroup.cleaned	3609535	3609537		YPO_RS17130	2
ARS007ss_ds.merged.samereadgroup.cleaned	3609644	3609647		YPO_RS17130	3
ARS007ss_ds.merged.samereadgroup.cleaned	3609928	3609943		YPO_RS17130	15
ARS007ss_ds.merged.samereadgroup.cleaned	3610539	3610550		YPO_RS17130	11
ARS007ss_ds.merged.samereadgroup.cleaned	3610802	3610818		YPO_RS17130	16
ARS007ss_ds.merged.samereadgroup.cleaned	3613107	3613121		YPO_RS17140	14
ARS007ss_ds.merged.samereadgroup.cleaned	3613299	3613311		YPO_RS17140	12
ARS007ss_ds.merged.samereadgroup.cleaned	3613615	3613625		YPO_RS17140	10
ARS007ss_ds.merged.samereadgroup.cleaned	3613906	3613909		YPO_RS17140	3
ARS007ss_ds.merged.samereadgroup.cleaned	3614359	3614373		YPO_RS17140	14
ARS007ss_ds.merged.samereadgroup.cleaned	3614677	3614683		YPO_RS17140	6
ARS007ss_ds.merged.samereadgroup.cleaned	3614884	3614902		YPO_RS17145	18
ARS007ss_ds.merged.samereadgroup.cleaned	3615309	3615325		YPO_RS17145	16
ARS007ss_ds.merged.samereadgroup.cleaned	3615768	3615770		YPO_RS17145	2
ARS007ss_ds.merged.samereadgroup.cleaned	3616280	3616287		YPO_RS17145	7
ARS007ss_ds.merged.samereadgroup.cleaned	3616921	3616945		YPO_RS17145	24
ARS007ss_ds.merged.samereadgroup.cleaned	3617459	3617478		YPO_RS17145	19
ARS007ss_ds.merged.samereadgroup.cleaned	3617616	3617630		YPO_RS17145	14
ARS007ss_ds.merged.samereadgroup.cleaned	3617922	3617959		YPO_RS17145	37
ARS007ss_ds.merged.samereadgroup.cleaned	3618259	3618260		YPO_RS17145	1
ARS007ss_ds.merged.samereadgroup.cleaned	3618471	3618479		YPO_RS17145	8
ARS007ss_ds.merged.samereadgroup.cleaned	3618690	3618701		YPO_RS17145	11
ARS007ss_ds.merged.samereadgroup.cleaned	3618888	3618918		YPO_RS17145	30
ARS007ss_ds.merged.samereadgroup.cleaned	3619501	3619518		YPO_RS17145	17
ARS007ss_ds.merged.samereadgroup.cleaned	3619645	3619651		YPO_RS17145	6
ARS007ss_ds.merged.samereadgroup.cleaned	3620026	3620044		YPO_RS17145	18
ARS007ss_ds.merged.samereadgroup.cleaned	3620705	3620716		YPO_RS17150	11
ARS007ss_ds.merged.samereadgroup.cleaned	3622180	3622181		YPO_RS17150	1
ARS007ss_ds.merged.samereadgroup.cleaned	3624109	3624111		YPO_RS17160	2
ARS007ss_ds.merged.samereadgroup.cleaned	3624367	3624373		YPO_RS17160	6
ARS007ss_ds.merged.samereadgroup.cleaned	3624523	3624527		YPO_RS17160	4
ARS007ss_ds.merged.samereadgroup.cleaned	3624878	3624881		YPO_RS17165	3
ARS007ss_ds.merged.samereadgroup.cleaned	3624924	3624930		YPO_RS17165	6
ARS007ss_ds.merged.samereadgroup.cleaned	3627212	3627228		YPO_RS17180	16
ARS007ss_ds.merged.samereadgroup.cleaned	3627418	3627420		YPO_RS17180	2
ARS007ss_ds.merged.samereadgroup.cleaned	3628854	3628860		YPO_RS17185	6
ARS007ss_ds.merged.samereadgroup.cleaned	3629208	3629209		YPO_RS17190	1
ARS007ss_ds.merged.samereadgroup.cleaned	3629274	3629281		YPO_RS17190	7
ARS007ss_ds.merged.samereadgroup.cleaned	3629424	3629429		YPO_RS17190	5
ARS007ss_ds.merged.samereadgroup.cleaned	3629828	3629847		YPO_RS17195	19
ARS007ss_ds.merged.samereadgroup.cleaned	3629879	3629883		YPO_RS17195	4
ARS007ss_ds.merged.samereadgroup.cleaned	3630061	3630069		YPO_RS17195	8
ARS007ss_ds.merged.samereadgroup.cleaned	3630457	3630459		YPO_RS17200	2
ARS007ss_ds.merged.samereadgroup.cleaned	3630495	3630496		YPO_RS17200	1
ARS007ss_ds.merged.samereadgroup.cleaned	3631481	3631485		YPO_RS17205	4
ARS007ss_ds.merged.samereadgroup.cleaned	3631877	3631882		YPO_RS17205	5
ARS007ss_ds.merged.samereadgroup.cleaned	3632676	3632677		YPO_RS17215	1
ARS007ss_ds.merged.samereadgroup.cleaned	3632964	3632970		YPO_RS17215	6
ARS007ss_ds.merged.samereadgroup.cleaned	3633491	3633501		YPO_RS17215	10
ARS007ss_ds.merged.samereadgroup.cleaned	3635816	3635822		YPO_RS17225	6
ARS007ss_ds.merged.samereadgroup.cleaned	3636996	3637016		ygaH	20
ARS007ss_ds.merged.samereadgroup.cleaned	3637431	3637434		mprA	3
ARS007ss_ds.merged.samereadgroup.cleaned	3638490	3638491		emrA	1
ARS007ss_ds.merged.samereadgroup.cleaned	3640018	3640027		emrB	9
ARS007ss_ds.merged.samereadgroup.cleaned	3641623	3641627		YPO_RS17255	4
ARS007ss_ds.merged.samereadgroup.cleaned	3643004	3643017		trxC	13
ARS007ss_ds.merged.samereadgroup.cleaned	3643731	3643746		YPO_RS17265	15
ARS007ss_ds.merged.samereadgroup.cleaned	3644374	3644388		YPO_RS17270	14
ARS007ss_ds.merged.samereadgroup.cleaned	3644910	3644913		YPO_RS17270	3
ARS007ss_ds.merged.samereadgroup.cleaned	3645103	3645113		YPO_RS17270	10
ARS007ss_ds.merged.samereadgroup.cleaned	3645966	3645968		YPO_RS17270	2
ARS007ss_ds.merged.samereadgroup.cleaned	3647320	3647322		pssA	2
ARS007ss_ds.merged.samereadgroup.cleaned	3647547	3647548		pssA	1
ARS007ss_ds.merged.samereadgroup.cleaned	3647931	3647934		pssA	3
ARS007ss_ds.merged.samereadgroup.cleaned	3648395	3648401		YPO_RS17280	6
ARS007ss_ds.merged.samereadgroup.cleaned	3649933	3649936		YPO_RS17290	3
ARS007ss_ds.merged.samereadgroup.cleaned	3654008	3654009		YPO_RS17305	1
ARS007ss_ds.merged.samereadgroup.cleaned	3654246	3654248		YPO_RS17310	2
ARS007ss_ds.merged.samereadgroup.cleaned	3654971	3654972		clpB	1
ARS007ss_ds.merged.samereadgroup.cleaned	3655012	3655025		clpB	13
ARS007ss_ds.merged.samereadgroup.cleaned	3655310	3655312		clpB	2
ARS007ss_ds.merged.samereadgroup.cleaned	3656308	3656331		clpB	23
ARS007ss_ds.merged.samereadgroup.cleaned	3656392	3656409		clpB	17
ARS007ss_ds.merged.samereadgroup.cleaned	3657849	3657895		pgeF	46
ARS007ss_ds.merged.samereadgroup.cleaned	3658225	3658247		rluD	22
ARS007ss_ds.merged.samereadgroup.cleaned	3658680	3658686		rluD	6
ARS007ss_ds.merged.samereadgroup.cleaned	3662091	3662100		pheA	9
ARS007ss_ds.merged.samereadgroup.cleaned	3665540	3665550		tyrA	10
ARS007ss_ds.merged.samereadgroup.cleaned	3666676	3666721		YPO_RS17370	45
ARS007ss_ds.merged.samereadgroup.cleaned	3666855	3666869		YPO_RS17370	14
ARS007ss_ds.merged.samereadgroup.cleaned	3668002	3668003		yehT	1
ARS007ss_ds.merged.samereadgroup.cleaned	3670500	3670501		YPO_RS17385	1
ARS007ss_ds.merged.samereadgroup.cleaned	3670666	3670677		YPO_RS17385	11
ARS007ss_ds.merged.samereadgroup.cleaned	3672980	3672987		trmD	7
ARS007ss_ds.merged.samereadgroup.cleaned	3674534	3674549		ffh	15
ARS007ss_ds.merged.samereadgroup.cleaned	3676704	3676713		YPO_RS17425	9
ARS007ss_ds.merged.samereadgroup.cleaned	3677000	3677014		YPO_RS17425	14
ARS007ss_ds.merged.samereadgroup.cleaned	3677584	3677593		YPO_RS17425	9
ARS007ss_ds.merged.samereadgroup.cleaned	3677889	3677894		YPO_RS17425	5
ARS007ss_ds.merged.samereadgroup.cleaned	3679751	3679763		gshA	12
ARS007ss_ds.merged.samereadgroup.cleaned	3680056	3680057		gshA	1
ARS007ss_ds.merged.samereadgroup.cleaned	3681944	3681954		yqaB	10
ARS007ss_ds.merged.samereadgroup.cleaned	3682300	3682311		YPO_RS17455	11
ARS007ss_ds.merged.samereadgroup.cleaned	3682472	3682484		YPO_RS17460	12
ARS007ss_ds.merged.samereadgroup.cleaned	3682639	3682643		YPO_RS17465	4
ARS007ss_ds.merged.samereadgroup.cleaned	3683889	3683892		alaS	3
ARS007ss_ds.merged.samereadgroup.cleaned	3684328	3684330		alaS	2
ARS007ss_ds.merged.samereadgroup.cleaned	3684739	3684741		alaS	2
ARS007ss_ds.merged.samereadgroup.cleaned	3685133	3685145		alaS	12
ARS007ss_ds.merged.samereadgroup.cleaned	3685186	3685196		alaS	10
ARS007ss_ds.merged.samereadgroup.cleaned	3685795	3685809		alaS	14
ARS007ss_ds.merged.samereadgroup.cleaned	3685852	3685856		alaS	4
ARS007ss_ds.merged.samereadgroup.cleaned	3686248	3686282		alaS	34
ARS007ss_ds.merged.samereadgroup.cleaned	3687371	3687375		recA	4
ARS007ss_ds.merged.samereadgroup.cleaned	3687542	3687566		recA	24
ARS007ss_ds.merged.samereadgroup.cleaned	3688761	3688763		pncC	2
ARS007ss_ds.merged.samereadgroup.cleaned	3689602	3689616		YPO_RS17505	14
ARS007ss_ds.merged.samereadgroup.cleaned	3689706	3689707		YPO_RS17505	1
ARS007ss_ds.merged.samereadgroup.cleaned	3690802	3690815		YPO_RS17510	13
ARS007ss_ds.merged.samereadgroup.cleaned	3691626	3691637		YPO_RS17510	11
ARS007ss_ds.merged.samereadgroup.cleaned	3693929	3693934		YPO_RS17520	5
ARS007ss_ds.merged.samereadgroup.cleaned	3694207	3694220		YPO_RS17520	13
ARS007ss_ds.merged.samereadgroup.cleaned	3694416	3694429		YPO_RS17520	13
ARS007ss_ds.merged.samereadgroup.cleaned	3694977	3694996		YPO_RS17525	19
ARS007ss_ds.merged.samereadgroup.cleaned	3695332	3695338		YPO_RS17525	6
ARS007ss_ds.merged.samereadgroup.cleaned	3695603	3695614		YPO_RS17525	11
ARS007ss_ds.merged.samereadgroup.cleaned	3697521	3697565		YPO_RS17535	44
ARS007ss_ds.merged.samereadgroup.cleaned	3697980	3697982		YPO_RS17535	2
ARS007ss_ds.merged.samereadgroup.cleaned	3698753	3698767		YPO_RS17540	14
ARS007ss_ds.merged.samereadgroup.cleaned	3700112	3700115		YPO_RS17545	3
ARS007ss_ds.merged.samereadgroup.cleaned	3700491	3700525		YPO_RS17550	34
ARS007ss_ds.merged.samereadgroup.cleaned	3701022	3701029		YPO_RS17550	7
ARS007ss_ds.merged.samereadgroup.cleaned	3702105	3702113		katG	8
ARS007ss_ds.merged.samereadgroup.cleaned	3702978	3702989		katG	11
ARS007ss_ds.merged.samereadgroup.cleaned	3703631	3703634		katG	3
ARS007ss_ds.merged.samereadgroup.cleaned	3704396	3704409		cybC	13
ARS007ss_ds.merged.samereadgroup.cleaned	3704989	3705025		cybB	36
ARS007ss_ds.merged.samereadgroup.cleaned	3705400	3705418		dmsD	18
ARS007ss_ds.merged.samereadgroup.cleaned	3705952	3706049		dmsD	97
ARS007ss_ds.merged.samereadgroup.cleaned	3706226	3706232		YPO_RS17575	6
ARS007ss_ds.merged.samereadgroup.cleaned	3707057	3707060		YPO_RS17575	3
ARS007ss_ds.merged.samereadgroup.cleaned	3707329	3707330		dmsB	1
ARS007ss_ds.merged.samereadgroup.cleaned	3707760	3707763		dmsA	3
ARS007ss_ds.merged.samereadgroup.cleaned	3709265	3709266		dmsA	1
ARS007ss_ds.merged.samereadgroup.cleaned	3709305	3709317		dmsA	12
ARS007ss_ds.merged.samereadgroup.cleaned	3709596	3709602		dmsA	6
ARS007ss_ds.merged.samereadgroup.cleaned	3709789	3709793		dmsA	4
ARS007ss_ds.merged.samereadgroup.cleaned	3709837	3709843		dmsA	6
ARS007ss_ds.merged.samereadgroup.cleaned	3710103	3710104		dmsA	1
ARS007ss_ds.merged.samereadgroup.cleaned	3711096	3711102		YPO_RS17590	6
ARS007ss_ds.merged.samereadgroup.cleaned	3713473	3713478		YPO_RS17600	5
ARS007ss_ds.merged.samereadgroup.cleaned	3715297	3715312		YPO_RS17610	15
ARS007ss_ds.merged.samereadgroup.cleaned	3716529	3716535		YPO_RS17615	6
ARS007ss_ds.merged.samereadgroup.cleaned	3717062	3717072		YPO_RS17615	10
ARS007ss_ds.merged.samereadgroup.cleaned	3717345	3717368		YPO_RS17620	23
ARS007ss_ds.merged.samereadgroup.cleaned	3717912	3717913		YPO_RS17620	1
ARS007ss_ds.merged.samereadgroup.cleaned	3718011	3718022		YPO_RS17620	11
ARS007ss_ds.merged.samereadgroup.cleaned	3718270	3718277		YPO_RS17620	7
ARS007ss_ds.merged.samereadgroup.cleaned	3719740	3719757		YPO_RS17630	17
ARS007ss_ds.merged.samereadgroup.cleaned	3719973	3719997		YPO_RS17630	24
ARS007ss_ds.merged.samereadgroup.cleaned	3720287	3720292		YPO_RS17630	5
ARS007ss_ds.merged.samereadgroup.cleaned	3720336	3720338		YPO_RS17630	2
ARS007ss_ds.merged.samereadgroup.cleaned	3720819	3720880		YPO_RS17630	61
ARS007ss_ds.merged.samereadgroup.cleaned	3722190	3722196		YPO_RS17635	6
ARS007ss_ds.merged.samereadgroup.cleaned	3722314	3722315		YPO_RS17635	1
ARS007ss_ds.merged.samereadgroup.cleaned	3722604	3722615		YPO_RS17635	11
ARS007ss_ds.merged.samereadgroup.cleaned	3723200	3723207		YPO_RS17640	7
ARS007ss_ds.merged.samereadgroup.cleaned	3724605	3724613		YPO_RS17650	8
ARS007ss_ds.merged.samereadgroup.cleaned	3724756	3724757		YPO_RS17650	1
ARS007ss_ds.merged.samereadgroup.cleaned	3725208	3725226		YPO_RS17650	18
ARS007ss_ds.merged.samereadgroup.cleaned	3725453	3725473		YPO_RS17650	20
ARS007ss_ds.merged.samereadgroup.cleaned	3725600	3725642		YPO_RS17650	42
ARS007ss_ds.merged.samereadgroup.cleaned	3729174	3729190		YPO_RS17665	16
ARS007ss_ds.merged.samereadgroup.cleaned	3731764	3731800		YPO_RS17675	36
ARS007ss_ds.merged.samereadgroup.cleaned	3732863	3732871		YPO_RS17685	8
ARS007ss_ds.merged.samereadgroup.cleaned	3735596	3735600		YPO_RS17695	4
ARS007ss_ds.merged.samereadgroup.cleaned	3736027	3736033		dhaL	6
ARS007ss_ds.merged.samereadgroup.cleaned	3736310	3736315		dhaL	5
ARS007ss_ds.merged.samereadgroup.cleaned	3737671	3737691		YPO_RS17710	20
ARS007ss_ds.merged.samereadgroup.cleaned	3737897	3737911		YPO_RS17710	14
ARS007ss_ds.merged.samereadgroup.cleaned	3738358	3738365		YPO_RS17710	7
ARS007ss_ds.merged.samereadgroup.cleaned	3738656	3738659		YPO_RS17715	3
ARS007ss_ds.merged.samereadgroup.cleaned	3738860	3738868		YPO_RS17715	8
ARS007ss_ds.merged.samereadgroup.cleaned	3738984	3739006		YPO_RS17715	22
ARS007ss_ds.merged.samereadgroup.cleaned	3741773	3741784		mutS	11
ARS007ss_ds.merged.samereadgroup.cleaned	3743190	3743192		mutS	2
ARS007ss_ds.merged.samereadgroup.cleaned	3745874	3745884		nlpD	10
ARS007ss_ds.merged.samereadgroup.cleaned	3746027	3746033		nlpD	6
ARS007ss_ds.merged.samereadgroup.cleaned	3746094	3746111		nlpD	17
ARS007ss_ds.merged.samereadgroup.cleaned	3746158	3746174		nlpD	16
ARS007ss_ds.merged.samereadgroup.cleaned	3748390	3748395		truD	5
ARS007ss_ds.merged.samereadgroup.cleaned	3748556	3748568		truD	12
ARS007ss_ds.merged.samereadgroup.cleaned	3748850	3748856		ispF	6
ARS007ss_ds.merged.samereadgroup.cleaned	3749577	3749593		ispD	16
ARS007ss_ds.merged.samereadgroup.cleaned	3749892	3749906		ispD	14
ARS007ss_ds.merged.samereadgroup.cleaned	3750844	3750870		YPO_RS17770	26
ARS007ss_ds.merged.samereadgroup.cleaned	3750908	3750915		YPO_RS17770	7
ARS007ss_ds.merged.samereadgroup.cleaned	3751853	3751854		cysC	1
ARS007ss_ds.merged.samereadgroup.cleaned	3754080	3754082		cysD	2
ARS007ss_ds.merged.samereadgroup.cleaned	3754506	3754508		cobA	2
ARS007ss_ds.merged.samereadgroup.cleaned	3754572	3754610		cobA	38
ARS007ss_ds.merged.samereadgroup.cleaned	3754833	3754839		cobA	6
ARS007ss_ds.merged.samereadgroup.cleaned	3754884	3754890		cobA	6
ARS007ss_ds.merged.samereadgroup.cleaned	3755412	3755421		cobA	9
ARS007ss_ds.merged.samereadgroup.cleaned	3755698	3755714		cobA	16
ARS007ss_ds.merged.samereadgroup.cleaned	3756778	3756788		YPO_RS17805	10
ARS007ss_ds.merged.samereadgroup.cleaned	3758321	3758337		cysI	16
ARS007ss_ds.merged.samereadgroup.cleaned	3759102	3759130		cysI	28
ARS007ss_ds.merged.samereadgroup.cleaned	3760246	3760248		cysJ	2
ARS007ss_ds.merged.samereadgroup.cleaned	3760425	3760432		cysJ	7
ARS007ss_ds.merged.samereadgroup.cleaned	3761004	3761010		cysJ	6
ARS007ss_ds.merged.samereadgroup.cleaned	3761572	3761589		cysJ	17
ARS007ss_ds.merged.samereadgroup.cleaned	3763080	3763093		queE	13
ARS007ss_ds.merged.samereadgroup.cleaned	3763478	3763495		YPO_RS17840	17
ARS007ss_ds.merged.samereadgroup.cleaned	3763554	3763557		YPO_RS17840	3
ARS007ss_ds.merged.samereadgroup.cleaned	3763682	3763692		YPO_RS17840	10
ARS007ss_ds.merged.samereadgroup.cleaned	3763848	3763849		YPO_RS17840	1
ARS007ss_ds.merged.samereadgroup.cleaned	3767960	3767964		mazG	4
ARS007ss_ds.merged.samereadgroup.cleaned	3769289	3769301		relA	12
ARS007ss_ds.merged.samereadgroup.cleaned	3770595	3770601		relA	6
ARS007ss_ds.merged.samereadgroup.cleaned	3770692	3770694		relA	2
ARS007ss_ds.merged.samereadgroup.cleaned	3771453	3771468		barA	15
ARS007ss_ds.merged.samereadgroup.cleaned	3771853	3771861		barA	8
ARS007ss_ds.merged.samereadgroup.cleaned	3772535	3772553		barA	18
ARS007ss_ds.merged.samereadgroup.cleaned	3772871	3772872		barA	1
ARS007ss_ds.merged.samereadgroup.cleaned	3772947	3772964		barA	17
ARS007ss_ds.merged.samereadgroup.cleaned	3773611	3773621		barA	10
ARS007ss_ds.merged.samereadgroup.cleaned	3773774	3773785		barA	11
ARS007ss_ds.merged.samereadgroup.cleaned	3774601	3774611		degP	10
ARS007ss_ds.merged.samereadgroup.cleaned	3774978	3774997		degP	19
ARS007ss_ds.merged.samereadgroup.cleaned	3775027	3775038		degP	11
ARS007ss_ds.merged.samereadgroup.cleaned	3775411	3775418		degP	7
ARS007ss_ds.merged.samereadgroup.cleaned	3775600	3775628		degP	28
ARS007ss_ds.merged.samereadgroup.cleaned	3776265	3776273		dgt	8
ARS007ss_ds.merged.samereadgroup.cleaned	3777810	3777819		mtnN	9
ARS007ss_ds.merged.samereadgroup.cleaned	3778151	3778155		mtnN	4
ARS007ss_ds.merged.samereadgroup.cleaned	3779453	3779480		YPO_RS17900	27
ARS007ss_ds.merged.samereadgroup.cleaned	3779894	3779903		YPO_RS17900	9
ARS007ss_ds.merged.samereadgroup.cleaned	3780732	3780750		clcA	18
ARS007ss_ds.merged.samereadgroup.cleaned	3780849	3780853		clcA	4
ARS007ss_ds.merged.samereadgroup.cleaned	3781223	3781230		clcA	7
ARS007ss_ds.merged.samereadgroup.cleaned	3782058	3782077		clcA	19
ARS007ss_ds.merged.samereadgroup.cleaned	3782643	3782647		hemL	4
ARS007ss_ds.merged.samereadgroup.cleaned	3783551	3783582		hemL	31
ARS007ss_ds.merged.samereadgroup.cleaned	3784575	3784593		fhuB	18
ARS007ss_ds.merged.samereadgroup.cleaned	3785106	3785114		fhuB	8
ARS007ss_ds.merged.samereadgroup.cleaned	3785325	3785345		fhuB	20
ARS007ss_ds.merged.samereadgroup.cleaned	3785498	3785511		fhuB	13
ARS007ss_ds.merged.samereadgroup.cleaned	3785543	3785546		fhuB	3
ARS007ss_ds.merged.samereadgroup.cleaned	3785814	3785821		fhuB	7
ARS007ss_ds.merged.samereadgroup.cleaned	3786156	3786160		fhuB	4
ARS007ss_ds.merged.samereadgroup.cleaned	3786901	3786902		fhuD	1
ARS007ss_ds.merged.samereadgroup.cleaned	3787019	3787033		fhuD	14
ARS007ss_ds.merged.samereadgroup.cleaned	3787556	3787559		fhuC	3
ARS007ss_ds.merged.samereadgroup.cleaned	3787845	3787851		fhuC	6
ARS007ss_ds.merged.samereadgroup.cleaned	3789126	3789129		mrcB	3
ARS007ss_ds.merged.samereadgroup.cleaned	3789323	3789327		mrcB	4
ARS007ss_ds.merged.samereadgroup.cleaned	3789665	3789669		mrcB	4
ARS007ss_ds.merged.samereadgroup.cleaned	3789983	3789995		mrcB	12
ARS007ss_ds.merged.samereadgroup.cleaned	3791095	3791098		hrpB	3
ARS007ss_ds.merged.samereadgroup.cleaned	3792125	3792127		hrpB	2
ARS007ss_ds.merged.samereadgroup.cleaned	3792287	3792290		hrpB	3
ARS007ss_ds.merged.samereadgroup.cleaned	3793708	3793713		thpR	5
ARS007ss_ds.merged.samereadgroup.cleaned	3794726	3794730		sfsA	4
ARS007ss_ds.merged.samereadgroup.cleaned	3795334	3795342		dksA	8
ARS007ss_ds.merged.samereadgroup.cleaned	3796148	3796154		gluQRS	6
ARS007ss_ds.merged.samereadgroup.cleaned	3796601	3796607		gluQRS	6
ARS007ss_ds.merged.samereadgroup.cleaned	3796820	3796833		gluQRS	13
ARS007ss_ds.merged.samereadgroup.cleaned	3797295	3797304		pcnB	9
ARS007ss_ds.merged.samereadgroup.cleaned	3798427	3798439		pcnB	12
ARS007ss_ds.merged.samereadgroup.cleaned	3799308	3799309		panB	1
ARS007ss_ds.merged.samereadgroup.cleaned	3799644	3799646		panB	2
ARS007ss_ds.merged.samereadgroup.cleaned	3800190	3800191		panC	1
ARS007ss_ds.merged.samereadgroup.cleaned	3800603	3800604		panC	1
ARS007ss_ds.merged.samereadgroup.cleaned	3801651	3801654		panD	3
ARS007ss_ds.merged.samereadgroup.cleaned	3802849	3802851		YPO_RS17990	2
ARS007ss_ds.merged.samereadgroup.cleaned	3803084	3803091		YPO_RS17990	7
ARS007ss_ds.merged.samereadgroup.cleaned	3803851	3803864		YPO_RS17995	13
ARS007ss_ds.merged.samereadgroup.cleaned	3804276	3804288		YPO_RS18000	12
ARS007ss_ds.merged.samereadgroup.cleaned	3804777	3804795		YPO_RS18000	18
ARS007ss_ds.merged.samereadgroup.cleaned	3805620	3805638		can	18
ARS007ss_ds.merged.samereadgroup.cleaned	3807025	3807038		cueO	13
ARS007ss_ds.merged.samereadgroup.cleaned	3807397	3807400		cueO	3
ARS007ss_ds.merged.samereadgroup.cleaned	3807529	3807566		cueO	37
ARS007ss_ds.merged.samereadgroup.cleaned	3807649	3807651		cueO	2
ARS007ss_ds.merged.samereadgroup.cleaned	3808276	3808280		cueO	4
ARS007ss_ds.merged.samereadgroup.cleaned	3809816	3809836		speE	20
ARS007ss_ds.merged.samereadgroup.cleaned	3812170	3812185		YPO_RS18035	15
ARS007ss_ds.merged.samereadgroup.cleaned	3812502	3812517		YPO_RS18040	15
ARS007ss_ds.merged.samereadgroup.cleaned	3813839	3813841		acnB	2
ARS007ss_ds.merged.samereadgroup.cleaned	3818139	3818141		lpdA	2
ARS007ss_ds.merged.samereadgroup.cleaned	3818326	3818327		lpdA	1
ARS007ss_ds.merged.samereadgroup.cleaned	3822299	3822312		aceE	13
ARS007ss_ds.merged.samereadgroup.cleaned	3825565	3825568		YPO_RS18075	3
ARS007ss_ds.merged.samereadgroup.cleaned	3826084	3826088		YPO_RS18075	4
ARS007ss_ds.merged.samereadgroup.cleaned	3826976	3826981		ampE	5
ARS007ss_ds.merged.samereadgroup.cleaned	3827017	3827019		ampE	2
ARS007ss_ds.merged.samereadgroup.cleaned	3827201	3827202		ampE	1
ARS007ss_ds.merged.samereadgroup.cleaned	3828160	3828195		ampD	35
ARS007ss_ds.merged.samereadgroup.cleaned	3828248	3828253		ampD	5
ARS007ss_ds.merged.samereadgroup.cleaned	3828503	3828510		nadC	7
ARS007ss_ds.merged.samereadgroup.cleaned	3828903	3828915		nadC	12
ARS007ss_ds.merged.samereadgroup.cleaned	3830785	3830787		gspE	2
ARS007ss_ds.merged.samereadgroup.cleaned	3830968	3830973		gspE	5
ARS007ss_ds.merged.samereadgroup.cleaned	3831576	3831582		hofC	6
ARS007ss_ds.merged.samereadgroup.cleaned	3832707	3832712		hofC	5
ARS007ss_ds.merged.samereadgroup.cleaned	3834007	3834014		YPO_RS18110	7
ARS007ss_ds.merged.samereadgroup.cleaned	3834741	3834746		coaE	5
ARS007ss_ds.merged.samereadgroup.cleaned	3834811	3834817		coaE	6
ARS007ss_ds.merged.samereadgroup.cleaned	3835054	3835055		coaE	1
ARS007ss_ds.merged.samereadgroup.cleaned	3835476	3835485		zapD	9
ARS007ss_ds.merged.samereadgroup.cleaned	3835524	3835531		zapD	7
ARS007ss_ds.merged.samereadgroup.cleaned	3839201	3839205		YPO_RS18145	4
ARS007ss_ds.merged.samereadgroup.cleaned	3841804	3841811		YPO_RS18150	7
ARS007ss_ds.merged.samereadgroup.cleaned	3843910	3843912		lptG	2
ARS007ss_ds.merged.samereadgroup.cleaned	3844083	3844090		lptG	7
ARS007ss_ds.merged.samereadgroup.cleaned	3845250	3845269		lptF	19
ARS007ss_ds.merged.samereadgroup.cleaned	3846402	3846409		pepA	7
ARS007ss_ds.merged.samereadgroup.cleaned	3846704	3846714		pepA	10
ARS007ss_ds.merged.samereadgroup.cleaned	3847382	3847406		pepA	24
ARS007ss_ds.merged.samereadgroup.cleaned	3847986	3847991		YPO_RS18180	5
ARS007ss_ds.merged.samereadgroup.cleaned	3848498	3848518		YPO_RS18185	20
ARS007ss_ds.merged.samereadgroup.cleaned	3852290	3852306		rraB	16
ARS007ss_ds.merged.samereadgroup.cleaned	3853219	3853224		argF	5
ARS007ss_ds.merged.samereadgroup.cleaned	3853746	3853755		argF	9
ARS007ss_ds.merged.samereadgroup.cleaned	3854630	3854645		YPO_RS18205	15
ARS007ss_ds.merged.samereadgroup.cleaned	3857064	3857083		YPO_RS18215	19
ARS007ss_ds.merged.samereadgroup.cleaned	3857294	3857305		YPO_RS18215	11
ARS007ss_ds.merged.samereadgroup.cleaned	3857922	3857940		YPO_RS18215	18
ARS007ss_ds.merged.samereadgroup.cleaned	3858630	3858638		YPO_RS18220	8
ARS007ss_ds.merged.samereadgroup.cleaned	3859661	3859667		YPO_RS18225	6
ARS007ss_ds.merged.samereadgroup.cleaned	3860258	3860264		YPO_RS18230	6
ARS007ss_ds.merged.samereadgroup.cleaned	3862404	3862405		nrdD	1
ARS007ss_ds.merged.samereadgroup.cleaned	3863242	3863258		nrdG	16
ARS007ss_ds.merged.samereadgroup.cleaned	3865828	3865830		phnH	2
ARS007ss_ds.merged.samereadgroup.cleaned	3866105	3866108		YPO_RS18260	3
ARS007ss_ds.merged.samereadgroup.cleaned	3866960	3866974		YPO_RS18260	14
ARS007ss_ds.merged.samereadgroup.cleaned	3867740	3867743		YPO_RS18265	3
ARS007ss_ds.merged.samereadgroup.cleaned	3867894	3867896		YPO_RS18265	2
ARS007ss_ds.merged.samereadgroup.cleaned	3868628	3868631		phnK	3
ARS007ss_ds.merged.samereadgroup.cleaned	3869158	3869163		phnL	5
ARS007ss_ds.merged.samereadgroup.cleaned	3870047	3870056		phnM	9
ARS007ss_ds.merged.samereadgroup.cleaned	3870346	3870347		phnM	1
ARS007ss_ds.merged.samereadgroup.cleaned	3870602	3870607		phnM	5
ARS007ss_ds.merged.samereadgroup.cleaned	3870676	3870687		phnM	11
ARS007ss_ds.merged.samereadgroup.cleaned	3871524	3871527		phnP	3
ARS007ss_ds.merged.samereadgroup.cleaned	3871794	3871810		phnP	16
ARS007ss_ds.merged.samereadgroup.cleaned	3871986	3872011		phnP	25
ARS007ss_ds.merged.samereadgroup.cleaned	3872124	3872126		phnP	2
ARS007ss_ds.merged.samereadgroup.cleaned	3872184	3872193		phnP	9
ARS007ss_ds.merged.samereadgroup.cleaned	3874730	3874733		YPO_RS18305	3
ARS007ss_ds.merged.samereadgroup.cleaned	3876269	3876316		YPO_RS18315	47
ARS007ss_ds.merged.samereadgroup.cleaned	3876781	3876787		YPO_RS18320	6
ARS007ss_ds.merged.samereadgroup.cleaned	3877218	3877226		YPO_RS18320	8
ARS007ss_ds.merged.samereadgroup.cleaned	3877293	3877300		YPO_RS18320	7
ARS007ss_ds.merged.samereadgroup.cleaned	3877927	3877939		YPO_RS18325	12
ARS007ss_ds.merged.samereadgroup.cleaned	3877991	3877998		YPO_RS18325	7
ARS007ss_ds.merged.samereadgroup.cleaned	3878060	3878062		YPO_RS18325	2
ARS007ss_ds.merged.samereadgroup.cleaned	3878180	3878187		YPO_RS18325	7
ARS007ss_ds.merged.samereadgroup.cleaned	3878539	3878549		YPO_RS18325	10
ARS007ss_ds.merged.samereadgroup.cleaned	3878589	3878590		YPO_RS18325	1
ARS007ss_ds.merged.samereadgroup.cleaned	3879562	3879567		YPO_RS18330	5
ARS007ss_ds.merged.samereadgroup.cleaned	3879709	3879712		YPO_RS18330	3
ARS007ss_ds.merged.samereadgroup.cleaned	3880568	3880573		YPO_RS18330	5
ARS007ss_ds.merged.samereadgroup.cleaned	3881471	3881483		YPO_RS18335	12
ARS007ss_ds.merged.samereadgroup.cleaned	3881582	3881590		YPO_RS18335	8
ARS007ss_ds.merged.samereadgroup.cleaned	3881853	3881864		YPO_RS18335	11
ARS007ss_ds.merged.samereadgroup.cleaned	3882312	3882314		YPO_RS18335	2
ARS007ss_ds.merged.samereadgroup.cleaned	3883665	3883694		YPO_RS18345	29
ARS007ss_ds.merged.samereadgroup.cleaned	3883749	3883759		YPO_RS18345	10
ARS007ss_ds.merged.samereadgroup.cleaned	3883903	3883907		YPO_RS18345	4
ARS007ss_ds.merged.samereadgroup.cleaned	3885218	3885224		YPO_RS18355	6
ARS007ss_ds.merged.samereadgroup.cleaned	3886179	3886199		YPO_RS18360	20
ARS007ss_ds.merged.samereadgroup.cleaned	3886866	3886867		YPO_RS18365	1
ARS007ss_ds.merged.samereadgroup.cleaned	3887862	3887881		YPO_RS18365	19
ARS007ss_ds.merged.samereadgroup.cleaned	3888396	3888397		YPO_RS18370	1
ARS007ss_ds.merged.samereadgroup.cleaned	3888484	3888502		YPO_RS18370	18
ARS007ss_ds.merged.samereadgroup.cleaned	3891229	3891253		YPO_RS18370	24
ARS007ss_ds.merged.samereadgroup.cleaned	3891636	3891639		YPO_RS18375	3
ARS007ss_ds.merged.samereadgroup.cleaned	3891958	3891977		YPO_RS18375	19
ARS007ss_ds.merged.samereadgroup.cleaned	3892032	3892033		YPO_RS18375	1
ARS007ss_ds.merged.samereadgroup.cleaned	3893121	3893128		YPO_RS18380	7
ARS007ss_ds.merged.samereadgroup.cleaned	3893553	3893570		YPO_RS18380	17
ARS007ss_ds.merged.samereadgroup.cleaned	3893578	3893579		YPO_RS18380	1
ARS007ss_ds.merged.samereadgroup.cleaned	3894557	3894566		YPO_RS18390	9
ARS007ss_ds.merged.samereadgroup.cleaned	3895695	3895711		YPO_RS18400	16
ARS007ss_ds.merged.samereadgroup.cleaned	3902861	3902862		truB	1
ARS007ss_ds.merged.samereadgroup.cleaned	3905039	3905050		infB	11
ARS007ss_ds.merged.samereadgroup.cleaned	3906048	3906049		infB	1
ARS007ss_ds.merged.samereadgroup.cleaned	3906353	3906378		infB	25
ARS007ss_ds.merged.samereadgroup.cleaned	3910324	3910334		glmM	10
ARS007ss_ds.merged.samereadgroup.cleaned	3910968	3910969		glmM	1
ARS007ss_ds.merged.samereadgroup.cleaned	3911363	3911366		folP	3
ARS007ss_ds.merged.samereadgroup.cleaned	3914324	3914330		rlmE	6
ARS007ss_ds.merged.samereadgroup.cleaned	3914398	3914412		rlmE	14
ARS007ss_ds.merged.samereadgroup.cleaned	3914544	3914550		rlmE	6
ARS007ss_ds.merged.samereadgroup.cleaned	3916536	3916538		dacB	2
ARS007ss_ds.merged.samereadgroup.cleaned	3918262	3918278		pmrB	16
ARS007ss_ds.merged.samereadgroup.cleaned	3918827	3918835		pmrB	8
ARS007ss_ds.merged.samereadgroup.cleaned	3919789	3919794		cgtA	5
ARS007ss_ds.merged.samereadgroup.cleaned	3920042	3920060		cgtA	18
ARS007ss_ds.merged.samereadgroup.cleaned	3922659	3922660		ispB	1
ARS007ss_ds.merged.samereadgroup.cleaned	3922913	3922920		ispB	7
ARS007ss_ds.merged.samereadgroup.cleaned	3923824	3923828		YPO_RS18540	4
ARS007ss_ds.merged.samereadgroup.cleaned	3927165	3927184		yhcN	19
ARS007ss_ds.merged.samereadgroup.cleaned	3928284	3928288		mpl	4
ARS007ss_ds.merged.samereadgroup.cleaned	3928886	3928913		mpl	27
ARS007ss_ds.merged.samereadgroup.cleaned	3929851	3929869		fbp	18
ARS007ss_ds.merged.samereadgroup.cleaned	3930014	3930020		fbp	6
ARS007ss_ds.merged.samereadgroup.cleaned	3930536	3930561		ppa	25
ARS007ss_ds.merged.samereadgroup.cleaned	3931554	3931565		YPO_RS18585	11
ARS007ss_ds.merged.samereadgroup.cleaned	3931633	3931640		YPO_RS18585	7
ARS007ss_ds.merged.samereadgroup.cleaned	3932390	3932395		YPO_RS18585	5
ARS007ss_ds.merged.samereadgroup.cleaned	3933113	3933118		YPO_RS18585	5
ARS007ss_ds.merged.samereadgroup.cleaned	3933736	3933742		YPO_RS18585	6
ARS007ss_ds.merged.samereadgroup.cleaned	3934303	3934306		YPO_RS18585	3
ARS007ss_ds.merged.samereadgroup.cleaned	3935139	3935140		YPO_RS18585	1
ARS007ss_ds.merged.samereadgroup.cleaned	3935213	3935220		YPO_RS18585	7
ARS007ss_ds.merged.samereadgroup.cleaned	3935809	3935815		YPO_RS18590	6
ARS007ss_ds.merged.samereadgroup.cleaned	3936029	3936044		YPO_RS18590	15
ARS007ss_ds.merged.samereadgroup.cleaned	3936199	3936231		YPO_RS18590	32
ARS007ss_ds.merged.samereadgroup.cleaned	3938218	3938229		YPO_RS18600	11
ARS007ss_ds.merged.samereadgroup.cleaned	3938712	3938769		YPO_RS18600	57
ARS007ss_ds.merged.samereadgroup.cleaned	3938949	3938971		YPO_RS18600	22
ARS007ss_ds.merged.samereadgroup.cleaned	3939205	3939206		YPO_RS18600	1
ARS007ss_ds.merged.samereadgroup.cleaned	3940227	3940239		YPO_RS18610	12
ARS007ss_ds.merged.samereadgroup.cleaned	3941041	3941046		cysQ	5
ARS007ss_ds.merged.samereadgroup.cleaned	3941283	3941295		cysQ	12
ARS007ss_ds.merged.samereadgroup.cleaned	3945092	3945103		YPO_RS18630	11
ARS007ss_ds.merged.samereadgroup.cleaned	3946186	3946231		YPO_RS18635	45
ARS007ss_ds.merged.samereadgroup.cleaned	3946976	3946980		YPO_RS18640	4
ARS007ss_ds.merged.samereadgroup.cleaned	3948764	3948768		priB	4
ARS007ss_ds.merged.samereadgroup.cleaned	3949229	3949246		rpsF	17
ARS007ss_ds.merged.samereadgroup.cleaned	3949717	3949720		yjfP	3
ARS007ss_ds.merged.samereadgroup.cleaned	3949804	3949814		yjfP	10
ARS007ss_ds.merged.samereadgroup.cleaned	3950123	3950126		yjfP	3
ARS007ss_ds.merged.samereadgroup.cleaned	3955066	3955070		YPO_RS18695	4
ARS007ss_ds.merged.samereadgroup.cleaned	3957658	3957662		YPO_RS18710	4
ARS007ss_ds.merged.samereadgroup.cleaned	3958506	3958516		YPO_RS18710	10
ARS007ss_ds.merged.samereadgroup.cleaned	3959474	3959479		YPO_RS18715	5
ARS007ss_ds.merged.samereadgroup.cleaned	3960441	3960472		yraP	31
ARS007ss_ds.merged.samereadgroup.cleaned	3960527	3960545		yraP	18
ARS007ss_ds.merged.samereadgroup.cleaned	3962040	3962043		elbB	3
ARS007ss_ds.merged.samereadgroup.cleaned	3962299	3962327		elbB	28
ARS007ss_ds.merged.samereadgroup.cleaned	3963175	3963195		arcB	20
ARS007ss_ds.merged.samereadgroup.cleaned	3963542	3963550		arcB	8
ARS007ss_ds.merged.samereadgroup.cleaned	3963660	3963662		arcB	2
ARS007ss_ds.merged.samereadgroup.cleaned	3963725	3963742		arcB	17
ARS007ss_ds.merged.samereadgroup.cleaned	3968446	3968464		gltB	18
ARS007ss_ds.merged.samereadgroup.cleaned	3968678	3968686		gltB	8
ARS007ss_ds.merged.samereadgroup.cleaned	3969253	3969258		gltB	5
ARS007ss_ds.merged.samereadgroup.cleaned	3969520	3969521		gltB	1
ARS007ss_ds.merged.samereadgroup.cleaned	3970141	3970146		gltB	5
ARS007ss_ds.merged.samereadgroup.cleaned	3971134	3971141		gltB	7
ARS007ss_ds.merged.samereadgroup.cleaned	3973709	3973711		YPO_RS18760	2
ARS007ss_ds.merged.samereadgroup.cleaned	3974538	3974544		sspB	6
ARS007ss_ds.merged.samereadgroup.cleaned	3975093	3975116		sspA	23
ARS007ss_ds.merged.samereadgroup.cleaned	3975487	3975488		YPO_RS18775	1
ARS007ss_ds.merged.samereadgroup.cleaned	3975592	3975598		YPO_RS18775	6
ARS007ss_ds.merged.samereadgroup.cleaned	3976801	3976809		YPO_RS18790	8
ARS007ss_ds.merged.samereadgroup.cleaned	3976865	3976884		YPO_RS18790	19
ARS007ss_ds.merged.samereadgroup.cleaned	3977689	3977708		YPO_RS18790	19
ARS007ss_ds.merged.samereadgroup.cleaned	3978883	3978896		degQ	13
ARS007ss_ds.merged.samereadgroup.cleaned	3978931	3978941		degQ	10
ARS007ss_ds.merged.samereadgroup.cleaned	3979396	3979398		degQ	2
ARS007ss_ds.merged.samereadgroup.cleaned	3979496	3979497		degQ	1
ARS007ss_ds.merged.samereadgroup.cleaned	3981073	3981074		degS	1
ARS007ss_ds.merged.samereadgroup.cleaned	3981478	3981484		degS	6
ARS007ss_ds.merged.samereadgroup.cleaned	3981769	3981797		degS	28
ARS007ss_ds.merged.samereadgroup.cleaned	3982034	3982035		degS	1
ARS007ss_ds.merged.samereadgroup.cleaned	3982865	3982883		murA	18
ARS007ss_ds.merged.samereadgroup.cleaned	3983004	3983015		murA	11
ARS007ss_ds.merged.samereadgroup.cleaned	3983922	3983931		ibaG	9
ARS007ss_ds.merged.samereadgroup.cleaned	3984146	3984150		mlaB	4
ARS007ss_ds.merged.samereadgroup.cleaned	3984786	3984794		mlaC	8
ARS007ss_ds.merged.samereadgroup.cleaned	3985321	3985333		mlaD	12
ARS007ss_ds.merged.samereadgroup.cleaned	3985550	3985551		mlaD	1
ARS007ss_ds.merged.samereadgroup.cleaned	3986785	3986799		mlaF	14
ARS007ss_ds.merged.samereadgroup.cleaned	3986893	3986894		mlaF	1
ARS007ss_ds.merged.samereadgroup.cleaned	3989188	3989192		kdsD	4
ARS007ss_ds.merged.samereadgroup.cleaned	3990325	3990327		kdsC	2
ARS007ss_ds.merged.samereadgroup.cleaned	3990604	3990605		lptC	1
ARS007ss_ds.merged.samereadgroup.cleaned	3991601	3991644		lptA	43
ARS007ss_ds.merged.samereadgroup.cleaned	3991971	3991973		lptB	2
ARS007ss_ds.merged.samereadgroup.cleaned	3994499	3994509		ptsN	10
ARS007ss_ds.merged.samereadgroup.cleaned	3996768	3996781		pyrB	13
ARS007ss_ds.merged.samereadgroup.cleaned	3997228	3997234		pyrB	6
ARS007ss_ds.merged.samereadgroup.cleaned	4001307	4001330		YPO_RS18935	23
ARS007ss_ds.merged.samereadgroup.cleaned	4002992	4003003		tagH	11
ARS007ss_ds.merged.samereadgroup.cleaned	4003517	4003530		tagH	13
ARS007ss_ds.merged.samereadgroup.cleaned	4004324	4004327		tssJ	3
ARS007ss_ds.merged.samereadgroup.cleaned	4004971	4004972		tssK	1
ARS007ss_ds.merged.samereadgroup.cleaned	4005072	4005100		tssK	28
ARS007ss_ds.merged.samereadgroup.cleaned	4005174	4005197		tssK	23
ARS007ss_ds.merged.samereadgroup.cleaned	4005707	4005717		tssK	10
ARS007ss_ds.merged.samereadgroup.cleaned	4005929	4005973		tssK	44
ARS007ss_ds.merged.samereadgroup.cleaned	4006227	4006230		YPO_RS18960	3
ARS007ss_ds.merged.samereadgroup.cleaned	4006531	4006533		YPO_RS18960	2
ARS007ss_ds.merged.samereadgroup.cleaned	4007024	4007059		tssH	35
ARS007ss_ds.merged.samereadgroup.cleaned	4008028	4008029		tssH	1
ARS007ss_ds.merged.samereadgroup.cleaned	4008589	4008601		tssH	12
ARS007ss_ds.merged.samereadgroup.cleaned	4008864	4008869		tssH	5
ARS007ss_ds.merged.samereadgroup.cleaned	4009069	4009070		tssH	1
ARS007ss_ds.merged.samereadgroup.cleaned	4009621	4009624		YPO_RS18970	3
ARS007ss_ds.merged.samereadgroup.cleaned	4010073	4010078		YPO_RS18970	5
ARS007ss_ds.merged.samereadgroup.cleaned	4010954	4010964		tagO	10
ARS007ss_ds.merged.samereadgroup.cleaned	4011060	4011062		tssA	2
ARS007ss_ds.merged.samereadgroup.cleaned	4011205	4011217		tssA	12
ARS007ss_ds.merged.samereadgroup.cleaned	4011718	4011724		tssA	6
ARS007ss_ds.merged.samereadgroup.cleaned	4012868	4012879		tssM	11
ARS007ss_ds.merged.samereadgroup.cleaned	4013534	4013536		tssM	2
ARS007ss_ds.merged.samereadgroup.cleaned	4014002	4014004		tssM	2
ARS007ss_ds.merged.samereadgroup.cleaned	4016053	4016082		YPO_RS18990	29
ARS007ss_ds.merged.samereadgroup.cleaned	4016317	4016324		YPO_RS18990	7
ARS007ss_ds.merged.samereadgroup.cleaned	4016435	4016436		YPO_RS18990	1
ARS007ss_ds.merged.samereadgroup.cleaned	4016691	4016722		YPO_RS18990	31
ARS007ss_ds.merged.samereadgroup.cleaned	4018506	4018507		YPO_RS19000	1
ARS007ss_ds.merged.samereadgroup.cleaned	4018983	4018987		YPO_RS19000	4
ARS007ss_ds.merged.samereadgroup.cleaned	4019298	4019300		YPO_RS19000	2
ARS007ss_ds.merged.samereadgroup.cleaned	4019376	4019784		YPO_RS19000	408
ARS007ss_ds.merged.samereadgroup.cleaned	4019790	4020248		YPO_RS19005	458
ARS007ss_ds.merged.samereadgroup.cleaned	4020241	4023105		YPO_RS19010	2864
ARS007ss_ds.merged.samereadgroup.cleaned	4023133	4024503		YPO_RS19015	1370
ARS007ss_ds.merged.samereadgroup.cleaned	4024505	4024990		YPO_RS19020	485
ARS007ss_ds.merged.samereadgroup.cleaned	4025040	4025231		YPO_RS19025	191
ARS007ss_ds.merged.samereadgroup.cleaned	4025307	4025531		YPO_RS19030	224
ARS007ss_ds.merged.samereadgroup.cleaned	4025613	4026020		YPO_RS19035	407
ARS007ss_ds.merged.samereadgroup.cleaned	4026407	4026436		YPO_RS19045	29
ARS007ss_ds.merged.samereadgroup.cleaned	4026582	4026720		YPO_RS19045	138
ARS007ss_ds.merged.samereadgroup.cleaned	4026759	4026780		YPO_RS19045	21
ARS007ss_ds.merged.samereadgroup.cleaned	4026849	4026855		YPO_RS19045	6
ARS007ss_ds.merged.samereadgroup.cleaned	4026891	4026904		YPO_RS19045	13
ARS007ss_ds.merged.samereadgroup.cleaned	4027001	4027038		YPO_RS19045	37
ARS007ss_ds.merged.samereadgroup.cleaned	4027079	4027109		YPO_RS19045	30
ARS007ss_ds.merged.samereadgroup.cleaned	4027240	4027279		YPO_RS19045	39
ARS007ss_ds.merged.samereadgroup.cleaned	4027325	4027378		YPO_RS19045	53
ARS007ss_ds.merged.samereadgroup.cleaned	4027512	4027563		YPO_RS19045	51
ARS007ss_ds.merged.samereadgroup.cleaned	4027633	4027703		YPO_RS19045	70
ARS007ss_ds.merged.samereadgroup.cleaned	4027763	4027867		YPO_RS19045	104
ARS007ss_ds.merged.samereadgroup.cleaned	4027908	4027952		YPO_RS19045	44
ARS007ss_ds.merged.samereadgroup.cleaned	4028912	4028924		YPO_RS19050	12
ARS007ss_ds.merged.samereadgroup.cleaned	4029422	4029426		YPO_RS19055	4
ARS007ss_ds.merged.samereadgroup.cleaned	4029546	4029553		YPO_RS19055	7
ARS007ss_ds.merged.samereadgroup.cleaned	4029655	4029658		YPO_RS19055	3
ARS007ss_ds.merged.samereadgroup.cleaned	4031896	4031921		YPO_RS19055	25
ARS007ss_ds.merged.samereadgroup.cleaned	4032180	4032219		YPO_RS19055	39
ARS007ss_ds.merged.samereadgroup.cleaned	4032250	4032264		YPO_RS19055	14
ARS007ss_ds.merged.samereadgroup.cleaned	4032645	4032652		YPO_RS19055	7
ARS007ss_ds.merged.samereadgroup.cleaned	4033091	4033134		YPO_RS19055	43
ARS007ss_ds.merged.samereadgroup.cleaned	4033289	4033313		YPO_RS19055	24
ARS007ss_ds.merged.samereadgroup.cleaned	4033762	4033849		YPO_RS19060	87
ARS007ss_ds.merged.samereadgroup.cleaned	4033949	4033966		YPO_RS19060	17
ARS007ss_ds.merged.samereadgroup.cleaned	4034516	4034526		YPO_RS19065	10
ARS007ss_ds.merged.samereadgroup.cleaned	4034668	4034672		YPO_RS19065	4
ARS007ss_ds.merged.samereadgroup.cleaned	4036330	4036332		YPO_RS19075	2
ARS007ss_ds.merged.samereadgroup.cleaned	4037412	4037423		YPO_RS19080	11
ARS007ss_ds.merged.samereadgroup.cleaned	4037459	4037463		YPO_RS19080	4
ARS007ss_ds.merged.samereadgroup.cleaned	4037504	4037508		YPO_RS19080	4
ARS007ss_ds.merged.samereadgroup.cleaned	4038511	4038512		rbsD	1
ARS007ss_ds.merged.samereadgroup.cleaned	4038556	4038564		rbsD	8
ARS007ss_ds.merged.samereadgroup.cleaned	4038570	4038576		YPO_RS19090	6
ARS007ss_ds.merged.samereadgroup.cleaned	4038790	4038794		YPO_RS19090	4
ARS007ss_ds.merged.samereadgroup.cleaned	4038922	4038926		YPO_RS19090	4
ARS007ss_ds.merged.samereadgroup.cleaned	4039337	4039349		YPO_RS19090	12
ARS007ss_ds.merged.samereadgroup.cleaned	4040850	4040862		ssuE	12
ARS007ss_ds.merged.samereadgroup.cleaned	4041196	4041213		ssuE	17
ARS007ss_ds.merged.samereadgroup.cleaned	4042056	4042059		YPO_RS19105	3
ARS007ss_ds.merged.samereadgroup.cleaned	4042276	4042285		YPO_RS19105	9
ARS007ss_ds.merged.samereadgroup.cleaned	4044178	4044182		ssuC	4
ARS007ss_ds.merged.samereadgroup.cleaned	4044386	4044399		ssuC	13
ARS007ss_ds.merged.samereadgroup.cleaned	4044728	4044739		ssuB	11
ARS007ss_ds.merged.samereadgroup.cleaned	4045243	4045252		ssuB	9
ARS007ss_ds.merged.samereadgroup.cleaned	4046606	4046614		YPO_RS19135	8
ARS007ss_ds.merged.samereadgroup.cleaned	4046751	4046759		YPO_RS19135	8
ARS007ss_ds.merged.samereadgroup.cleaned	4047043	4047054		YPO_RS19135	11
ARS007ss_ds.merged.samereadgroup.cleaned	4047291	4047293		YPO_RS19135	2
ARS007ss_ds.merged.samereadgroup.cleaned	4046841	4046851		YPO_RS19135	10
ARS007ss_ds.merged.samereadgroup.cleaned	4049576	4049579		YPO_RS19140	3
ARS007ss_ds.merged.samereadgroup.cleaned	4050229	4050232		YPO_RS19145	3
ARS007ss_ds.merged.samereadgroup.cleaned	4052334	4052336		lpxP	2
ARS007ss_ds.merged.samereadgroup.cleaned	4053284	4053288		YPO_RS19155	4
ARS007ss_ds.merged.samereadgroup.cleaned	4054952	4054953		YPO_RS19160	1
ARS007ss_ds.merged.samereadgroup.cleaned	4055319	4055320		YPO_RS19160	1
ARS007ss_ds.merged.samereadgroup.cleaned	4056164	4056166		YPO_RS19165	2
ARS007ss_ds.merged.samereadgroup.cleaned	4056594	4056606		YPO_RS19165	12
ARS007ss_ds.merged.samereadgroup.cleaned	4057124	4057127		YPO_RS19170	3
ARS007ss_ds.merged.samereadgroup.cleaned	4057240	4057248		YPO_RS19170	8
ARS007ss_ds.merged.samereadgroup.cleaned	4057812	4057819		YPO_RS19170	7
ARS007ss_ds.merged.samereadgroup.cleaned	4058152	4058154		YPO_RS19175	2
ARS007ss_ds.merged.samereadgroup.cleaned	4058203	4058205		YPO_RS19175	2
ARS007ss_ds.merged.samereadgroup.cleaned	4058241	4058259		YPO_RS19175	18
ARS007ss_ds.merged.samereadgroup.cleaned	4058597	4058625		YPO_RS19175	28
ARS007ss_ds.merged.samereadgroup.cleaned	4059316	4059325		YPO_RS19175	9
ARS007ss_ds.merged.samereadgroup.cleaned	4059376	4059380		YPO_RS19175	4
ARS007ss_ds.merged.samereadgroup.cleaned	4059664	4059688		YPO_RS19180	24
ARS007ss_ds.merged.samereadgroup.cleaned	4066486	4066509		YPO_RS19215	23
ARS007ss_ds.merged.samereadgroup.cleaned	4068737	4068759		YPO_RS19225	22
ARS007ss_ds.merged.samereadgroup.cleaned	4069763	4069770		YPO_RS19235	7
ARS007ss_ds.merged.samereadgroup.cleaned	4069947	4069949		YPO_RS19235	2
ARS007ss_ds.merged.samereadgroup.cleaned	4070516	4070519		YPO_RS19235	3
ARS007ss_ds.merged.samereadgroup.cleaned	4070833	4070849		YPO_RS19235	16
ARS007ss_ds.merged.samereadgroup.cleaned	4071027	4071039		YPO_RS19235	12
ARS007ss_ds.merged.samereadgroup.cleaned	4072262	4072282		YPO_RS19245	20
ARS007ss_ds.merged.samereadgroup.cleaned	4073284	4073287		fis	3
ARS007ss_ds.merged.samereadgroup.cleaned	4074056	4074061		dusB	5
ARS007ss_ds.merged.samereadgroup.cleaned	4075035	4075039		prmA	4
ARS007ss_ds.merged.samereadgroup.cleaned	4075986	4075998		panF	12
ARS007ss_ds.merged.samereadgroup.cleaned	4076917	4076939		panF	22
ARS007ss_ds.merged.samereadgroup.cleaned	4077037	4077040		panF	3
ARS007ss_ds.merged.samereadgroup.cleaned	4077590	4077591		YPO_RS19280	1
ARS007ss_ds.merged.samereadgroup.cleaned	4078603	4078604		YPO_RS19285	1
ARS007ss_ds.merged.samereadgroup.cleaned	4078682	4078683		YPO_RS19285	1
ARS007ss_ds.merged.samereadgroup.cleaned	4080155	4080158		accC	3
ARS007ss_ds.merged.samereadgroup.cleaned	4080649	4080662		accB	13
ARS007ss_ds.merged.samereadgroup.cleaned	4081943	4081944		msrQ	1
ARS007ss_ds.merged.samereadgroup.cleaned	4082244	4082247		msrQ	3
ARS007ss_ds.merged.samereadgroup.cleaned	4082738	4082744		msrP	6
ARS007ss_ds.merged.samereadgroup.cleaned	4084170	4084181		YPO_RS19315	11
ARS007ss_ds.merged.samereadgroup.cleaned	4085293	4085296		csrD	3
ARS007ss_ds.merged.samereadgroup.cleaned	4086738	4086752		csrD	14
ARS007ss_ds.merged.samereadgroup.cleaned	4089396	4089398		mreC	2
ARS007ss_ds.merged.samereadgroup.cleaned	4089674	4089692		mreD	18
ARS007ss_ds.merged.samereadgroup.cleaned	4089845	4089853		mreD	8
ARS007ss_ds.merged.samereadgroup.cleaned	4090038	4090047		YPO_RS19340	9
ARS007ss_ds.merged.samereadgroup.cleaned	4091757	4091758		rng	1
ARS007ss_ds.merged.samereadgroup.cleaned	4092331	4092337		YPO_RS19350	6
ARS007ss_ds.merged.samereadgroup.cleaned	4092770	4092773		YPO_RS19350	3
ARS007ss_ds.merged.samereadgroup.cleaned	4093319	4093330		YPO_RS19350	11
ARS007ss_ds.merged.samereadgroup.cleaned	4093798	4093805		YPO_RS19350	7
ARS007ss_ds.merged.samereadgroup.cleaned	4093859	4093893		YPO_RS19350	34
ARS007ss_ds.merged.samereadgroup.cleaned	4094008	4094009		YPO_RS19350	1
ARS007ss_ds.merged.samereadgroup.cleaned	4095097	4095109		YPO_RS19350	12
ARS007ss_ds.merged.samereadgroup.cleaned	4095142	4095175		YPO_RS19350	33
ARS007ss_ds.merged.samereadgroup.cleaned	4095784	4095785		YPO_RS19350	1
ARS007ss_ds.merged.samereadgroup.cleaned	4096202	4096221		YPO_RS19355	19
ARS007ss_ds.merged.samereadgroup.cleaned	4096273	4096283		YPO_RS19355	10
ARS007ss_ds.merged.samereadgroup.cleaned	4096469	4096503		YPO_RS19355	34
ARS007ss_ds.merged.samereadgroup.cleaned	4097012	4097037		tldD	25
ARS007ss_ds.merged.samereadgroup.cleaned	4097120	4097126		tldD	6
ARS007ss_ds.merged.samereadgroup.cleaned	4097714	4097735		tldD	21
ARS007ss_ds.merged.samereadgroup.cleaned	4097870	4097886		tldD	16
ARS007ss_ds.merged.samereadgroup.cleaned	4097929	4097931		tldD	2
ARS007ss_ds.merged.samereadgroup.cleaned	4098633	4098648		YPO_RS19365	15
ARS007ss_ds.merged.samereadgroup.cleaned	4098943	4098957		YPO_RS19365	14
ARS007ss_ds.merged.samereadgroup.cleaned	4099419	4099445		YPO_RS19365	26
ARS007ss_ds.merged.samereadgroup.cleaned	4100247	4100249		YPO_RS19365	2
ARS007ss_ds.merged.samereadgroup.cleaned	4100280	4100307		YPO_RS19365	27
ARS007ss_ds.merged.samereadgroup.cleaned	4100969	4101088		YPO_RS19365	119
ARS007ss_ds.merged.samereadgroup.cleaned	4101164	4101176		YPO_RS19365	12
ARS007ss_ds.merged.samereadgroup.cleaned	4101277	4101325		YPO_RS19365	48
ARS007ss_ds.merged.samereadgroup.cleaned	4101357	4101377		YPO_RS19365	20
ARS007ss_ds.merged.samereadgroup.cleaned	4101411	4101425		YPO_RS19365	14
ARS007ss_ds.merged.samereadgroup.cleaned	4101464	4101491		YPO_RS19365	27
ARS007ss_ds.merged.samereadgroup.cleaned	4101516	4102043		YPO_RS19370	527
ARS007ss_ds.merged.samereadgroup.cleaned	4102117	4102383		YPO_RS19370	266
ARS007ss_ds.merged.samereadgroup.cleaned	4102424	4102550		YPO_RS19370	126
ARS007ss_ds.merged.samereadgroup.cleaned	4102696	4102879		YPO_RS19370	183
ARS007ss_ds.merged.samereadgroup.cleaned	4102928	4102949		YPO_RS19370	21
ARS007ss_ds.merged.samereadgroup.cleaned	4103038	4103057		YPO_RS19370	19
ARS007ss_ds.merged.samereadgroup.cleaned	4103100	4103163		YPO_RS19370	63
ARS007ss_ds.merged.samereadgroup.cleaned	4103208	4103221		YPO_RS19370	13
ARS007ss_ds.merged.samereadgroup.cleaned	4103260	4103266		YPO_RS19370	6
ARS007ss_ds.merged.samereadgroup.cleaned	4103431	4103439		YPO_RS19370	8
ARS007ss_ds.merged.samereadgroup.cleaned	4104133	4104139		YPO_RS19370	6
ARS007ss_ds.merged.samereadgroup.cleaned	4104610	4104614		YPO_RS19375	4
ARS007ss_ds.merged.samereadgroup.cleaned	4105419	4105424		YPO_RS19385	5
ARS007ss_ds.merged.samereadgroup.cleaned	4105986	4105995		YPO_RS19390	9
ARS007ss_ds.merged.samereadgroup.cleaned	4107374	4107387		YPO_RS19390	13
ARS007ss_ds.merged.samereadgroup.cleaned	4107844	4107849		YPO_RS19390	5
ARS007ss_ds.merged.samereadgroup.cleaned	4108184	4108190		YPO_RS19390	6
ARS007ss_ds.merged.samereadgroup.cleaned	4108573	4108580		YPO_RS19390	7
ARS007ss_ds.merged.samereadgroup.cleaned	4108747	4108766		YPO_RS19390	19
ARS007ss_ds.merged.samereadgroup.cleaned	4110054	4110068		YPO_RS19390	14
ARS007ss_ds.merged.samereadgroup.cleaned	4110120	4110129		YPO_RS19390	9
ARS007ss_ds.merged.samereadgroup.cleaned	4110165	4110189		YPO_RS19390	24
ARS007ss_ds.merged.samereadgroup.cleaned	4110686	4110689		YPO_RS19395	3
ARS007ss_ds.merged.samereadgroup.cleaned	4111449	4111461		YPO_RS19395	12
ARS007ss_ds.merged.samereadgroup.cleaned	4112302	4112305		YPO_RS19395	3
ARS007ss_ds.merged.samereadgroup.cleaned	4112532	4112543		YPO_RS19400	11
ARS007ss_ds.merged.samereadgroup.cleaned	4112714	4112803		YPO_RS19400	89
ARS007ss_ds.merged.samereadgroup.cleaned	4112866	4112884		YPO_RS19400	18
ARS007ss_ds.merged.samereadgroup.cleaned	4113046	4113050		YPO_RS19400	4
ARS007ss_ds.merged.samereadgroup.cleaned	4113281	4113300		YPO_RS19400	19
ARS007ss_ds.merged.samereadgroup.cleaned	4113381	4113386		YPO_RS19400	5
ARS007ss_ds.merged.samereadgroup.cleaned	4113877	4113893		YPO_RS19400	16
ARS007ss_ds.merged.samereadgroup.cleaned	4114017	4114022		YPO_RS19405	5
ARS007ss_ds.merged.samereadgroup.cleaned	4114231	4114233		YPO_RS19405	2
ARS007ss_ds.merged.samereadgroup.cleaned	4114685	4114720		YPO_RS19405	35
ARS007ss_ds.merged.samereadgroup.cleaned	4115224	4115229		YPO_RS19405	5
ARS007ss_ds.merged.samereadgroup.cleaned	4115619	4115649		YPO_RS19405	30
ARS007ss_ds.merged.samereadgroup.cleaned	4115912	4115926		YPO_RS19405	14
ARS007ss_ds.merged.samereadgroup.cleaned	4116750	4116819		YPO_RS19410	69
ARS007ss_ds.merged.samereadgroup.cleaned	4117159	4117165		YPO_RS19410	6
ARS007ss_ds.merged.samereadgroup.cleaned	4118693	4118709		aaeR	16
ARS007ss_ds.merged.samereadgroup.cleaned	4119511	4119515		aaeA	4
ARS007ss_ds.merged.samereadgroup.cleaned	4119582	4119583		aaeA	1
ARS007ss_ds.merged.samereadgroup.cleaned	4120921	4120932		aaeB	11
ARS007ss_ds.merged.samereadgroup.cleaned	4121802	4121805		aaeB	3
ARS007ss_ds.merged.samereadgroup.cleaned	4124476	4124481		YPO_RS19440	5
ARS007ss_ds.merged.samereadgroup.cleaned	4125059	4125081		YPO_RS19450	22
ARS007ss_ds.merged.samereadgroup.cleaned	4126506	4126512		pmbA	6
ARS007ss_ds.merged.samereadgroup.cleaned	4127411	4127425		YPO_RS19460	14
ARS007ss_ds.merged.samereadgroup.cleaned	4129728	4129741		treC	13
ARS007ss_ds.merged.samereadgroup.cleaned	4131876	4131881		treB	5
ARS007ss_ds.merged.samereadgroup.cleaned	4133362	4133371		treR	9
ARS007ss_ds.merged.samereadgroup.cleaned	4133512	4133519		treR	7
ARS007ss_ds.merged.samereadgroup.cleaned	4134240	4134244		YPO_RS19490	4
ARS007ss_ds.merged.samereadgroup.cleaned	4139353	4139378		tssE	25
ARS007ss_ds.merged.samereadgroup.cleaned	4139621	4139628		tssC	7
ARS007ss_ds.merged.samereadgroup.cleaned	4142069	4142079		YPO_RS19530	10
ARS007ss_ds.merged.samereadgroup.cleaned	4142441	4142442		YPO_RS19530	1
ARS007ss_ds.merged.samereadgroup.cleaned	4142786	4142829		YPO_RS19535	43
ARS007ss_ds.merged.samereadgroup.cleaned	4144284	4144293		malM	9
ARS007ss_ds.merged.samereadgroup.cleaned	4144629	4144632		YPO_RS19545	3
ARS007ss_ds.merged.samereadgroup.cleaned	4144676	4144678		YPO_RS19545	2
ARS007ss_ds.merged.samereadgroup.cleaned	4144843	4144855		YPO_RS19545	12
ARS007ss_ds.merged.samereadgroup.cleaned	4146747	4146762		malK	15
ARS007ss_ds.merged.samereadgroup.cleaned	4148946	4148947		malE	1
ARS007ss_ds.merged.samereadgroup.cleaned	4149724	4149731		malF	7
ARS007ss_ds.merged.samereadgroup.cleaned	4149807	4149809		malF	2
ARS007ss_ds.merged.samereadgroup.cleaned	4150647	4150657		malF	10
ARS007ss_ds.merged.samereadgroup.cleaned	4152809	4152824		pgi	15
ARS007ss_ds.merged.samereadgroup.cleaned	4155033	4155050		lysC	17
ARS007ss_ds.merged.samereadgroup.cleaned	4155112	4155118		lysC	6
ARS007ss_ds.merged.samereadgroup.cleaned	4155782	4155789		lysC	7
ARS007ss_ds.merged.samereadgroup.cleaned	4156670	4156674		YPO_RS19590	4
ARS007ss_ds.merged.samereadgroup.cleaned	4157959	4157967		YPO_RS19590	8
ARS007ss_ds.merged.samereadgroup.cleaned	4158734	4158765		YPO_RS19595	31
ARS007ss_ds.merged.samereadgroup.cleaned	4159997	4160012		YPO_RS19595	15
ARS007ss_ds.merged.samereadgroup.cleaned	4160279	4160285		YPO_RS19595	6
ARS007ss_ds.merged.samereadgroup.cleaned	4160746	4160765		YPO_RS19595	19
ARS007ss_ds.merged.samereadgroup.cleaned	4160981	4160989		YPO_RS19595	8
ARS007ss_ds.merged.samereadgroup.cleaned	4161049	4161058		YPO_RS19595	9
ARS007ss_ds.merged.samereadgroup.cleaned	4162081	4162089		YPO_RS19595	8
ARS007ss_ds.merged.samereadgroup.cleaned	4162597	4162599		YPO_RS19595	2
ARS007ss_ds.merged.samereadgroup.cleaned	4164931	4164946		metH	15
ARS007ss_ds.merged.samereadgroup.cleaned	4166145	4166167		metH	22
ARS007ss_ds.merged.samereadgroup.cleaned	4166382	4166394		metH	12
ARS007ss_ds.merged.samereadgroup.cleaned	4168191	4168198		aceK	7
ARS007ss_ds.merged.samereadgroup.cleaned	4168620	4168622		aceK	2
ARS007ss_ds.merged.samereadgroup.cleaned	4170835	4170840		aceA	5
ARS007ss_ds.merged.samereadgroup.cleaned	4170992	4170993		aceA	1
ARS007ss_ds.merged.samereadgroup.cleaned	4171066	4171067		aceA	1
ARS007ss_ds.merged.samereadgroup.cleaned	4172424	4172430		aceB	6
ARS007ss_ds.merged.samereadgroup.cleaned	4175014	4175016		rrf	2
ARS007ss_ds.merged.samereadgroup.cleaned	4176217	4176220		YPO_RS19645	3
ARS007ss_ds.merged.samereadgroup.cleaned	4181245	4181253		purH	8
ARS007ss_ds.merged.samereadgroup.cleaned	4181709	4181718		purH	9
ARS007ss_ds.merged.samereadgroup.cleaned	4183514	4183515		purD	1
ARS007ss_ds.merged.samereadgroup.cleaned	4187198	4187214		hemE	16
ARS007ss_ds.merged.samereadgroup.cleaned	4191287	4191289		thiC	2
ARS007ss_ds.merged.samereadgroup.cleaned	4191417	4191436		thiC	19
ARS007ss_ds.merged.samereadgroup.cleaned	4192056	4192062		thiC	6
ARS007ss_ds.merged.samereadgroup.cleaned	4193042	4193045		thiE	3
ARS007ss_ds.merged.samereadgroup.cleaned	4194752	4194754		YPO_RS19740	2
ARS007ss_ds.merged.samereadgroup.cleaned	4194876	4194878		YPO_RS19740	2
ARS007ss_ds.merged.samereadgroup.cleaned	4195383	4195394		thiH	11
ARS007ss_ds.merged.samereadgroup.cleaned	4195825	4195832		thiH	7
ARS007ss_ds.merged.samereadgroup.cleaned	4195924	4195930		thiH	6
ARS007ss_ds.merged.samereadgroup.cleaned	4199565	4199566		rpoC	1
ARS007ss_ds.merged.samereadgroup.cleaned	4207466	4207468		rplA	2
ARS007ss_ds.merged.samereadgroup.cleaned	4209209	4209210		secE	1
ARS007ss_ds.merged.samereadgroup.cleaned	4210086	4210102		tuf	16
ARS007ss_ds.merged.samereadgroup.cleaned	4210885	4210905		tuf	20
ARS007ss_ds.merged.samereadgroup.cleaned	4215270	4215272		coaA	2
ARS007ss_ds.merged.samereadgroup.cleaned	4215379	4215402		coaA	23
ARS007ss_ds.merged.samereadgroup.cleaned	4215697	4215709		birA	12
ARS007ss_ds.merged.samereadgroup.cleaned	4216374	4216400		birA	26
ARS007ss_ds.merged.samereadgroup.cleaned	4216452	4216465		birA	13
ARS007ss_ds.merged.samereadgroup.cleaned	4216601	4216605		birA	4
ARS007ss_ds.merged.samereadgroup.cleaned	4216806	4216827		murB	21
ARS007ss_ds.merged.samereadgroup.cleaned	4217286	4217288		murB	2
ARS007ss_ds.merged.samereadgroup.cleaned	4223140	4223146		YPO_RS19870	6
ARS007ss_ds.merged.samereadgroup.cleaned	4223799	4223815		hemG	16
ARS007ss_ds.merged.samereadgroup.cleaned	4224318	4224322		hemG	4
ARS007ss_ds.merged.samereadgroup.cleaned	4225123	4225131		trkH	8
ARS007ss_ds.merged.samereadgroup.cleaned	4227229	4227247		pepQ	18
ARS007ss_ds.merged.samereadgroup.cleaned	4227457	4227459		pepQ	2
ARS007ss_ds.merged.samereadgroup.cleaned	4227873	4227882		pepQ	9
ARS007ss_ds.merged.samereadgroup.cleaned	4228243	4228250		pepQ	7
ARS007ss_ds.merged.samereadgroup.cleaned	4229161	4229162		fadB	1
ARS007ss_ds.merged.samereadgroup.cleaned	4230282	4230295		fadB	13
ARS007ss_ds.merged.samereadgroup.cleaned	4230454	4230466		fadB	12
ARS007ss_ds.merged.samereadgroup.cleaned	4230992	4231002		fadB	10
ARS007ss_ds.merged.samereadgroup.cleaned	4231083	4231088		fadA	5
ARS007ss_ds.merged.samereadgroup.cleaned	4231873	4231876		fadA	3
ARS007ss_ds.merged.samereadgroup.cleaned	4233499	4233512		ubiD	13
ARS007ss_ds.merged.samereadgroup.cleaned	4235787	4235793		hemB	6
ARS007ss_ds.merged.samereadgroup.cleaned	4235941	4235942		hemB	1
ARS007ss_ds.merged.samereadgroup.cleaned	4236062	4236074		hemB	12
ARS007ss_ds.merged.samereadgroup.cleaned	4236278	4236289		hemB	11
ARS007ss_ds.merged.samereadgroup.cleaned	4236786	4236791		YPO_RS19940	5
ARS007ss_ds.merged.samereadgroup.cleaned	4239502	4239503		tatC	1
ARS007ss_ds.merged.samereadgroup.cleaned	4240292	4240320		tatB	28
ARS007ss_ds.merged.samereadgroup.cleaned	4241893	4241895		ubiB	2
ARS007ss_ds.merged.samereadgroup.cleaned	4242685	4242693		ubiB	8
ARS007ss_ds.merged.samereadgroup.cleaned	4242912	4242913		YPO_RS19980	1
ARS007ss_ds.merged.samereadgroup.cleaned	4243392	4243394		YPO_RS19980	2
ARS007ss_ds.merged.samereadgroup.cleaned	4244689	4244691		rmuC	2
ARS007ss_ds.merged.samereadgroup.cleaned	4245667	4245679		rmuC	12
ARS007ss_ds.merged.samereadgroup.cleaned	4245767	4245773		rmuC	6
ARS007ss_ds.merged.samereadgroup.cleaned	4246932	4246948		YPO_RS20000	16
ARS007ss_ds.merged.samereadgroup.cleaned	4247184	4247191		YPO_RS20000	7
ARS007ss_ds.merged.samereadgroup.cleaned	4247323	4247324		YPO_RS20000	1
ARS007ss_ds.merged.samereadgroup.cleaned	4247716	4247730		YPO_RS20000	14
ARS007ss_ds.merged.samereadgroup.cleaned	4247966	4247967		YPO_RS20000	1
ARS007ss_ds.merged.samereadgroup.cleaned	4248041	4248049		YPO_RS20000	8
ARS007ss_ds.merged.samereadgroup.cleaned	4249551	4249556		YPO_RS20005	5
ARS007ss_ds.merged.samereadgroup.cleaned	4250491	4250492		udp	1
ARS007ss_ds.merged.samereadgroup.cleaned	4250562	4250563		udp	1
ARS007ss_ds.merged.samereadgroup.cleaned	4251489	4251513		YPO_RS20015	24
ARS007ss_ds.merged.samereadgroup.cleaned	4251771	4251782		YPO_RS20015	11
ARS007ss_ds.merged.samereadgroup.cleaned	4253272	4253274		metE	2
ARS007ss_ds.merged.samereadgroup.cleaned	4255586	4255591		YPO_RS20030	5
ARS007ss_ds.merged.samereadgroup.cleaned	4256887	4256921		YPO_RS20035	34
ARS007ss_ds.merged.samereadgroup.cleaned	4258286	4258330		ugpQ	44
ARS007ss_ds.merged.samereadgroup.cleaned	4258605	4258607		YPO_RS20045	2
ARS007ss_ds.merged.samereadgroup.cleaned	4259281	4259282		YPO_RS20045	1
ARS007ss_ds.merged.samereadgroup.cleaned	4259874	4259884		ugpE	10
ARS007ss_ds.merged.samereadgroup.cleaned	4260957	4260959		ugpA	2
ARS007ss_ds.merged.samereadgroup.cleaned	4261718	4261728		ugpB	10
ARS007ss_ds.merged.samereadgroup.cleaned	4262391	4262395		ugpB	4
ARS007ss_ds.merged.samereadgroup.cleaned	4263344	4263382		YPO_RS20065	38
ARS007ss_ds.merged.samereadgroup.cleaned	4264109	4264112		YPO_RS20070	3
ARS007ss_ds.merged.samereadgroup.cleaned	4264233	4264272		YPO_RS20070	39
ARS007ss_ds.merged.samereadgroup.cleaned	4264323	4264405		YPO_RS20070	82
ARS007ss_ds.merged.samereadgroup.cleaned	4265036	4265039		YPO_RS20070	3
ARS007ss_ds.merged.samereadgroup.cleaned	4265322	4265336		YPO_RS20070	14
ARS007ss_ds.merged.samereadgroup.cleaned	4265451	4265471		YPO_RS20070	20
ARS007ss_ds.merged.samereadgroup.cleaned	4266249	4266274		YPO_RS20070	25
ARS007ss_ds.merged.samereadgroup.cleaned	4266348	4266351		YPO_RS20070	3
ARS007ss_ds.merged.samereadgroup.cleaned	4266515	4266516		YPO_RS20075	1
ARS007ss_ds.merged.samereadgroup.cleaned	4266562	4266574		YPO_RS20075	12
ARS007ss_ds.merged.samereadgroup.cleaned	4267196	4267197		YPO_RS20080	1
ARS007ss_ds.merged.samereadgroup.cleaned	4267711	4267735		YPO_RS20080	24
ARS007ss_ds.merged.samereadgroup.cleaned	4268190	4268197		YPO_RS20085	7
ARS007ss_ds.merged.samereadgroup.cleaned	4268311	4268321		YPO_RS20085	10
ARS007ss_ds.merged.samereadgroup.cleaned	4268929	4268939		YPO_RS20090	10
ARS007ss_ds.merged.samereadgroup.cleaned	4269099	4269105		YPO_RS20090	6
ARS007ss_ds.merged.samereadgroup.cleaned	4269773	4269774		YPO_RS20095	1
ARS007ss_ds.merged.samereadgroup.cleaned	4269974	4270030		YPO_RS20095	56
ARS007ss_ds.merged.samereadgroup.cleaned	4270344	4270346		livF	2
ARS007ss_ds.merged.samereadgroup.cleaned	4270881	4270890		livF	9
ARS007ss_ds.merged.samereadgroup.cleaned	4271618	4271631		YPO_RS20105	13
ARS007ss_ds.merged.samereadgroup.cleaned	4272075	4272079		YPO_RS20110	4
ARS007ss_ds.merged.samereadgroup.cleaned	4273030	4273049		YPO_RS20110	19
ARS007ss_ds.merged.samereadgroup.cleaned	4273323	4273374		livH	51
ARS007ss_ds.merged.samereadgroup.cleaned	4274244	4274252		YPO_RS20120	8
ARS007ss_ds.merged.samereadgroup.cleaned	4274991	4275008		YPO_RS20120	17
ARS007ss_ds.merged.samereadgroup.cleaned	4275811	4275813		panM	2
ARS007ss_ds.merged.samereadgroup.cleaned	4275886	4275887		panM	1
ARS007ss_ds.merged.samereadgroup.cleaned	4278334	4278343		ftsX	9
ARS007ss_ds.merged.samereadgroup.cleaned	4279535	4279545		ftsE	10
ARS007ss_ds.merged.samereadgroup.cleaned	4280004	4280021		ftsY	17
ARS007ss_ds.merged.samereadgroup.cleaned	4280131	4280136		ftsY	5
ARS007ss_ds.merged.samereadgroup.cleaned	4280711	4280719		ftsY	8
ARS007ss_ds.merged.samereadgroup.cleaned	4280846	4280866		ftsY	20
ARS007ss_ds.merged.samereadgroup.cleaned	4281448	4281468		ftsY	20
ARS007ss_ds.merged.samereadgroup.cleaned	4286738	4286759		YPO_RS20180	21
ARS007ss_ds.merged.samereadgroup.cleaned	4287208	4287219		YPO_RS20180	11
ARS007ss_ds.merged.samereadgroup.cleaned	4287439	4287445		YPO_RS20180	6
ARS007ss_ds.merged.samereadgroup.cleaned	4288675	4288676		YPO_RS20190	1
ARS007ss_ds.merged.samereadgroup.cleaned	4289915	4289918		glpC	3
ARS007ss_ds.merged.samereadgroup.cleaned	4291303	4291307		glpB	4
ARS007ss_ds.merged.samereadgroup.cleaned	4291915	4291919		glpB	4
ARS007ss_ds.merged.samereadgroup.cleaned	4292275	4292282		glpA	7
ARS007ss_ds.merged.samereadgroup.cleaned	4293022	4293025		glpA	3
ARS007ss_ds.merged.samereadgroup.cleaned	4294537	4294552		glpQ	15
ARS007ss_ds.merged.samereadgroup.cleaned	4295007	4295010		glpQ	3
ARS007ss_ds.merged.samereadgroup.cleaned	4298059	4298115		pldB	56
ARS007ss_ds.merged.samereadgroup.cleaned	4298461	4298464		pldB	3
ARS007ss_ds.merged.samereadgroup.cleaned	4298811	4298821		pldB	10
ARS007ss_ds.merged.samereadgroup.cleaned	4302524	4302536		pldA	12
ARS007ss_ds.merged.samereadgroup.cleaned	4302860	4302874		pldA	14
ARS007ss_ds.merged.samereadgroup.cleaned	4303189	4303201		pldA	12
ARS007ss_ds.merged.samereadgroup.cleaned	4304838	4304845		rarD	7
ARS007ss_ds.merged.samereadgroup.cleaned	4307892	4307936		YPO_RS20280	44
ARS007ss_ds.merged.samereadgroup.cleaned	4308459	4308460		YPO_RS20280	1
ARS007ss_ds.merged.samereadgroup.cleaned	4308604	4308610		YPO_RS20280	6
ARS007ss_ds.merged.samereadgroup.cleaned	4310439	4310446		uvrD	7
ARS007ss_ds.merged.samereadgroup.cleaned	4310615	4310653		uvrD	38
ARS007ss_ds.merged.samereadgroup.cleaned	4312826	4312832		yigB	6
ARS007ss_ds.merged.samereadgroup.cleaned	4314505	4314514		YPO_RS20305	9
ARS007ss_ds.merged.samereadgroup.cleaned	4315408	4315421		dapF	13
ARS007ss_ds.merged.samereadgroup.cleaned	4315731	4315737		YPO_RS20315	6
ARS007ss_ds.merged.samereadgroup.cleaned	4316275	4316285		cyaY	10
ARS007ss_ds.merged.samereadgroup.cleaned	4318655	4318659		YPO_RS20325	4
ARS007ss_ds.merged.samereadgroup.cleaned	4320040	4320044		hemC	4
ARS007ss_ds.merged.samereadgroup.cleaned	4320382	4320386		hemC	4
ARS007ss_ds.merged.samereadgroup.cleaned	4320927	4320932		hemD	5
ARS007ss_ds.merged.samereadgroup.cleaned	4321148	4321149		hemD	1
ARS007ss_ds.merged.samereadgroup.cleaned	4321422	4321425		hemX	3
ARS007ss_ds.merged.samereadgroup.cleaned	4322632	4322641		hemY	9
ARS007ss_ds.merged.samereadgroup.cleaned	4322967	4323006		hemY	39
ARS007ss_ds.merged.samereadgroup.cleaned	4323494	4323514		hemY	20
ARS007ss_ds.merged.samereadgroup.cleaned	4326458	4326467		YPO_RS20380	9
ARS007ss_ds.merged.samereadgroup.cleaned	4326618	4326619		YPO_RS20380	1
ARS007ss_ds.merged.samereadgroup.cleaned	4326686	4326687		YPO_RS20380	1
ARS007ss_ds.merged.samereadgroup.cleaned	4326986	4327008		YPO_RS20380	22
ARS007ss_ds.merged.samereadgroup.cleaned	4327879	4327888		rffM	9
ARS007ss_ds.merged.samereadgroup.cleaned	4328019	4328031		rffM	12
ARS007ss_ds.merged.samereadgroup.cleaned	4328239	4328244		rffM	5
ARS007ss_ds.merged.samereadgroup.cleaned	4328865	4328878		wzyE	13
ARS007ss_ds.merged.samereadgroup.cleaned	4330152	4330158		YPO_RS20395	6
ARS007ss_ds.merged.samereadgroup.cleaned	4333852	4333870		rffC	18
ARS007ss_ds.merged.samereadgroup.cleaned	4335632	4335655		rffG	23
ARS007ss_ds.merged.samereadgroup.cleaned	4336270	4336281		rffG	11
ARS007ss_ds.merged.samereadgroup.cleaned	4336483	4336488		wecC	5
ARS007ss_ds.merged.samereadgroup.cleaned	4336564	4336565		wecC	1
ARS007ss_ds.merged.samereadgroup.cleaned	4336602	4336611		wecC	9
ARS007ss_ds.merged.samereadgroup.cleaned	4337254	4337257		wecC	3
ARS007ss_ds.merged.samereadgroup.cleaned	4337491	4337492		wecC	1
ARS007ss_ds.merged.samereadgroup.cleaned	4337883	4337894		wecB	11
ARS007ss_ds.merged.samereadgroup.cleaned	4339245	4339251		wzzE	6
ARS007ss_ds.merged.samereadgroup.cleaned	4339879	4339880		wzzE	1
ARS007ss_ds.merged.samereadgroup.cleaned	4340645	4340671		wecA	26
ARS007ss_ds.merged.samereadgroup.cleaned	4340824	4340857		wecA	33
ARS007ss_ds.merged.samereadgroup.cleaned	4343673	4343676		trxA	3
ARS007ss_ds.merged.samereadgroup.cleaned	4345164	4345167		rhlB	3
ARS007ss_ds.merged.samereadgroup.cleaned	4347750	4347752		rep	2
ARS007ss_ds.merged.samereadgroup.cleaned	4349969	4349972		YPO_RS20480	3
ARS007ss_ds.merged.samereadgroup.cleaned	4352766	4352773		YPO_RS20490	7
ARS007ss_ds.merged.samereadgroup.cleaned	4353034	4353036		YPO_RS20490	2
ARS007ss_ds.merged.samereadgroup.cleaned	4353239	4353246		YPO_RS20495	7
ARS007ss_ds.merged.samereadgroup.cleaned	4353632	4353645		YPO_RS20495	13
ARS007ss_ds.merged.samereadgroup.cleaned	4354286	4354293		YPO_RS20500	7
ARS007ss_ds.merged.samereadgroup.cleaned	4354444	4354445		YPO_RS20500	1
ARS007ss_ds.merged.samereadgroup.cleaned	4355474	4355476		YPO_RS20500	2
ARS007ss_ds.merged.samereadgroup.cleaned	4356309	4356320		YPO_RS20500	11
ARS007ss_ds.merged.samereadgroup.cleaned	4356675	4356677		stbD	2
ARS007ss_ds.merged.samereadgroup.cleaned	4356896	4356898		stbD	2
ARS007ss_ds.merged.samereadgroup.cleaned	4357738	4357749		stbD	11
ARS007ss_ds.merged.samereadgroup.cleaned	4358206	4358218		YPO_RS20510	12
ARS007ss_ds.merged.samereadgroup.cleaned	4358516	4358519		YPO_RS20510	3
ARS007ss_ds.merged.samereadgroup.cleaned	4359333	4359365		YPO_RS20515	32
ARS007ss_ds.merged.samereadgroup.cleaned	4360201	4360279		YPO_RS20525	78
ARS007ss_ds.merged.samereadgroup.cleaned	4360795	4360806		YPO_RS20530	11
ARS007ss_ds.merged.samereadgroup.cleaned	4361218	4361220		YPO_RS20530	2
ARS007ss_ds.merged.samereadgroup.cleaned	4362517	4362523		ilvC	6
ARS007ss_ds.merged.samereadgroup.cleaned	4363119	4363127		ilvC	8
ARS007ss_ds.merged.samereadgroup.cleaned	4363254	4363256		ilvC	2
ARS007ss_ds.merged.samereadgroup.cleaned	4365137	4365147		YPO_RS20550	10
ARS007ss_ds.merged.samereadgroup.cleaned	4365231	4365239		YPO_RS20550	8
ARS007ss_ds.merged.samereadgroup.cleaned	4365271	4365287		YPO_RS20550	16
ARS007ss_ds.merged.samereadgroup.cleaned	4366600	4366607		YPO_RS20560	7
ARS007ss_ds.merged.samereadgroup.cleaned	4368060	4368097		YPO_RS20575	37
ARS007ss_ds.merged.samereadgroup.cleaned	4369260	4369261		ilvA	1
ARS007ss_ds.merged.samereadgroup.cleaned	4369566	4369586		ilvA	20
ARS007ss_ds.merged.samereadgroup.cleaned	4370921	4370923		ilvD	2
ARS007ss_ds.merged.samereadgroup.cleaned	4372933	4372935		YPO_RS20590	2
ARS007ss_ds.merged.samereadgroup.cleaned	4373847	4373856		YPO_RS20600	9
ARS007ss_ds.merged.samereadgroup.cleaned	4374775	4374790		YPO_RS20600	15
ARS007ss_ds.merged.samereadgroup.cleaned	4375742	4375745		YPO_RS20610	3
ARS007ss_ds.merged.samereadgroup.cleaned	4376216	4376232		YPO_RS20610	16
ARS007ss_ds.merged.samereadgroup.cleaned	4379552	4379554		yjfF	2
ARS007ss_ds.merged.samereadgroup.cleaned	4381265	4381288		YPO_RS20635	23
ARS007ss_ds.merged.samereadgroup.cleaned	4391627	4391628		btuB	1
ARS007ss_ds.merged.samereadgroup.cleaned	4391917	4391919		btuB	2
ARS007ss_ds.merged.samereadgroup.cleaned	4392061	4392079		btuB	18
ARS007ss_ds.merged.samereadgroup.cleaned	4392141	4392166		btuB	25
ARS007ss_ds.merged.samereadgroup.cleaned	4394294	4394303		trmA	9
ARS007ss_ds.merged.samereadgroup.cleaned	4394439	4394446		trmA	7
ARS007ss_ds.merged.samereadgroup.cleaned	4396864	4396869		sthA	5
ARS007ss_ds.merged.samereadgroup.cleaned	4397217	4397223		sthA	6
ARS007ss_ds.merged.samereadgroup.cleaned	4397400	4397408		oxyR	8
ARS007ss_ds.merged.samereadgroup.cleaned	4397467	4397476		oxyR	9
ARS007ss_ds.merged.samereadgroup.cleaned	4397882	4397888		oxyR	6
ARS007ss_ds.merged.samereadgroup.cleaned	4397932	4397935		oxyR	3
ARS007ss_ds.merged.samereadgroup.cleaned	4399261	4399282		YPO_RS20720	21
ARS007ss_ds.merged.samereadgroup.cleaned	4399990	4399991		YPO_RS20720	1
ARS007ss_ds.merged.samereadgroup.cleaned	4400883	4400887		YPO_RS20725	4
ARS007ss_ds.merged.samereadgroup.cleaned	4401429	4401435		YPO_RS20725	6
ARS007ss_ds.merged.samereadgroup.cleaned	4401543	4401546		YPO_RS20725	3
ARS007ss_ds.merged.samereadgroup.cleaned	4403712	4403713		YPO_RS20735	1
ARS007ss_ds.merged.samereadgroup.cleaned	4405828	4405840		YPO_RS20745	12
ARS007ss_ds.merged.samereadgroup.cleaned	4405936	4405942		YPO_RS20745	6
ARS007ss_ds.merged.samereadgroup.cleaned	4406323	4406332		YPO_RS20745	9
ARS007ss_ds.merged.samereadgroup.cleaned	4406441	4406447		YPO_RS20745	6
ARS007ss_ds.merged.samereadgroup.cleaned	4406796	4406806		YPO_RS20745	10
ARS007ss_ds.merged.samereadgroup.cleaned	4407028	4407057		YPO_RS20745	29
ARS007ss_ds.merged.samereadgroup.cleaned	4407880	4407881		YPO_RS20745	1
ARS007ss_ds.merged.samereadgroup.cleaned	4408188	4408192		YPO_RS20745	4
ARS007ss_ds.merged.samereadgroup.cleaned	4408283	4408320		YPO_RS20745	37
ARS007ss_ds.merged.samereadgroup.cleaned	4409279	4409286		argH	7
ARS007ss_ds.merged.samereadgroup.cleaned	4411105	4411106		argB	1
ARS007ss_ds.merged.samereadgroup.cleaned	4411206	4411211		argB	5
ARS007ss_ds.merged.samereadgroup.cleaned	4412909	4412911		argE	2
ARS007ss_ds.merged.samereadgroup.cleaned	4412971	4412986		argE	15
ARS007ss_ds.merged.samereadgroup.cleaned	4413143	4413150		argE	7
ARS007ss_ds.merged.samereadgroup.cleaned	4415754	4415756		ppc	2
ARS007ss_ds.merged.samereadgroup.cleaned	4421260	4421263		glpD	3
ARS007ss_ds.merged.samereadgroup.cleaned	4421434	4421435		glpD	1
ARS007ss_ds.merged.samereadgroup.cleaned	4421608	4421611		glpD	3
ARS007ss_ds.merged.samereadgroup.cleaned	4421713	4421714		glpD	1
ARS007ss_ds.merged.samereadgroup.cleaned	4421968	4421985		glpD	17
ARS007ss_ds.merged.samereadgroup.cleaned	4422102	4422104		glpD	2
ARS007ss_ds.merged.samereadgroup.cleaned	4422199	4422208		glpD	9
ARS007ss_ds.merged.samereadgroup.cleaned	4422426	4422436		glpD	10
ARS007ss_ds.merged.samereadgroup.cleaned	4423750	4423762		glgP	12
ARS007ss_ds.merged.samereadgroup.cleaned	4424219	4424226		glgP	7
ARS007ss_ds.merged.samereadgroup.cleaned	4426826	4426828		glgA	2
ARS007ss_ds.merged.samereadgroup.cleaned	4428610	4428619		glgX	9
ARS007ss_ds.merged.samereadgroup.cleaned	4428678	4428689		glgX	11
ARS007ss_ds.merged.samereadgroup.cleaned	4430607	4430613		glgB	6
ARS007ss_ds.merged.samereadgroup.cleaned	4431218	4431220		glgB	2
ARS007ss_ds.merged.samereadgroup.cleaned	4433389	4433394		YPO_RS20825	5
ARS007ss_ds.merged.samereadgroup.cleaned	4433885	4433896		YPO_RS20825	11
ARS007ss_ds.merged.samereadgroup.cleaned	4435004	4435016		YPO_RS20830	12
ARS007ss_ds.merged.samereadgroup.cleaned	4435136	4435139		YPO_RS20830	3
ARS007ss_ds.merged.samereadgroup.cleaned	4435451	4435458		YPO_RS20830	7
ARS007ss_ds.merged.samereadgroup.cleaned	4435710	4435714		YPO_RS20830	4
ARS007ss_ds.merged.samereadgroup.cleaned	4436224	4436228		YPO_RS20830	4
ARS007ss_ds.merged.samereadgroup.cleaned	4436935	4436938		YPO_RS20830	3
ARS007ss_ds.merged.samereadgroup.cleaned	4437156	4437175		YPO_RS20830	19
ARS007ss_ds.merged.samereadgroup.cleaned	4437415	4437427		YPO_RS20830	12
ARS007ss_ds.merged.samereadgroup.cleaned	4438037	4438062		YPO_RS20830	25
ARS007ss_ds.merged.samereadgroup.cleaned	4438354	4438364		YPO_RS20830	10
ARS007ss_ds.merged.samereadgroup.cleaned	4438662	4438673		YPO_RS20830	11
ARS007ss_ds.merged.samereadgroup.cleaned	4439556	4439562		YPO_RS20830	6
ARS007ss_ds.merged.samereadgroup.cleaned	4439797	4439800		YPO_RS20830	3
ARS007ss_ds.merged.samereadgroup.cleaned	4440091	4440102		YPO_RS20830	11
ARS007ss_ds.merged.samereadgroup.cleaned	4440437	4440448		YPO_RS20830	11
ARS007ss_ds.merged.samereadgroup.cleaned	4440899	4440900		YPO_RS20830	1
ARS007ss_ds.merged.samereadgroup.cleaned	4441188	4441207		YPO_RS20830	19
ARS007ss_ds.merged.samereadgroup.cleaned	4441277	4441284		YPO_RS20830	7
ARS007ss_ds.merged.samereadgroup.cleaned	4441618	4441631		YPO_RS20830	13
ARS007ss_ds.merged.samereadgroup.cleaned	4441870	4441886		YPO_RS20830	16
ARS007ss_ds.merged.samereadgroup.cleaned	4442161	4442171		YPO_RS20830	10
ARS007ss_ds.merged.samereadgroup.cleaned	4442998	4443000		YPO_RS20830	2
ARS007ss_ds.merged.samereadgroup.cleaned	4445965	4445979		YPO_RS20840	14
ARS007ss_ds.merged.samereadgroup.cleaned	4446873	4446877		YPO_RS20855	4
ARS007ss_ds.merged.samereadgroup.cleaned	4447425	4447461		asd	36
ARS007ss_ds.merged.samereadgroup.cleaned	4447541	4447554		asd	13
ARS007ss_ds.merged.samereadgroup.cleaned	4448910	4448945		YPO_RS20865	35
ARS007ss_ds.merged.samereadgroup.cleaned	4451076	4451080		YPO_RS20880	4
ARS007ss_ds.merged.samereadgroup.cleaned	4451516	4451527		gntT	11
ARS007ss_ds.merged.samereadgroup.cleaned	4451930	4451942		gntT	12
ARS007ss_ds.merged.samereadgroup.cleaned	4452083	4452092		gntT	9
ARS007ss_ds.merged.samereadgroup.cleaned	4452322	4452326		gntT	4
ARS007ss_ds.merged.samereadgroup.cleaned	4452407	4452423		gntT	16
ARS007ss_ds.merged.samereadgroup.cleaned	4452537	4452540		gntT	3
ARS007ss_ds.merged.samereadgroup.cleaned	4452730	4452745		gntR	15
ARS007ss_ds.merged.samereadgroup.cleaned	4454221	4454226		YPO_RS20895	5
ARS007ss_ds.merged.samereadgroup.cleaned	4456765	4456768		YPO_RS20910	3
ARS007ss_ds.merged.samereadgroup.cleaned	4457593	4457595		YPO_RS20915	2
ARS007ss_ds.merged.samereadgroup.cleaned	4462171	4462190		YPO_RS20935	19
ARS007ss_ds.merged.samereadgroup.cleaned	4462647	4462659		YPO_RS20940	12
ARS007ss_ds.merged.samereadgroup.cleaned	4463826	4463838		YPO_RS20940	12
ARS007ss_ds.merged.samereadgroup.cleaned	4463986	4463996		YPO_RS20940	10
ARS007ss_ds.merged.samereadgroup.cleaned	4464662	4464663		YPO_RS20940	1
ARS007ss_ds.merged.samereadgroup.cleaned	4464781	4464792		YPO_RS20940	11
ARS007ss_ds.merged.samereadgroup.cleaned	4465395	4465434		YPO_RS20945	39
ARS007ss_ds.merged.samereadgroup.cleaned	4467004	4467006		pitA	2
ARS007ss_ds.merged.samereadgroup.cleaned	4468073	4468135		pitA	62
ARS007ss_ds.merged.samereadgroup.cleaned	4469332	4469338		uspB	6
ARS007ss_ds.merged.samereadgroup.cleaned	4470467	4470475		uspA	8
ARS007ss_ds.merged.samereadgroup.cleaned	4472982	4472985		YPO_RS20975	3
ARS007ss_ds.merged.samereadgroup.cleaned	4473111	4473133		YPO_RS20975	22
ARS007ss_ds.merged.samereadgroup.cleaned	4473869	4473872		rsmJ	3
ARS007ss_ds.merged.samereadgroup.cleaned	4473969	4473985		rsmJ	16
ARS007ss_ds.merged.samereadgroup.cleaned	4474512	4474531		rsmJ	19
ARS007ss_ds.merged.samereadgroup.cleaned	4474739	4474752		prlC	13
ARS007ss_ds.merged.samereadgroup.cleaned	4475230	4475241		prlC	11
ARS007ss_ds.merged.samereadgroup.cleaned	4475925	4475926		prlC	1
ARS007ss_ds.merged.samereadgroup.cleaned	4475997	4476004		prlC	7
ARS007ss_ds.merged.samereadgroup.cleaned	4477811	4477832		YPO_RS20990	21
ARS007ss_ds.merged.samereadgroup.cleaned	4478780	4478783		gorA	3
ARS007ss_ds.merged.samereadgroup.cleaned	4478919	4478937		gorA	18
ARS007ss_ds.merged.samereadgroup.cleaned	4479063	4479067		gorA	4
ARS007ss_ds.merged.samereadgroup.cleaned	4479155	4479160		gorA	5
ARS007ss_ds.merged.samereadgroup.cleaned	4479880	4479893		YPO_RS21000	13
ARS007ss_ds.merged.samereadgroup.cleaned	4480604	4480627		YPO_RS21000	23
ARS007ss_ds.merged.samereadgroup.cleaned	4481014	4481020		YPO_RS21010	6
ARS007ss_ds.merged.samereadgroup.cleaned	4482288	4482291		YPO_RS21015	3
ARS007ss_ds.merged.samereadgroup.cleaned	4482883	4482893		YPO_RS21015	10
ARS007ss_ds.merged.samereadgroup.cleaned	4483141	4483142		YPO_RS21015	1
ARS007ss_ds.merged.samereadgroup.cleaned	4483582	4483597		YPO_RS21020	15
ARS007ss_ds.merged.samereadgroup.cleaned	4483693	4483698		YPO_RS21020	5
ARS007ss_ds.merged.samereadgroup.cleaned	4483832	4483849		YPO_RS21020	17
ARS007ss_ds.merged.samereadgroup.cleaned	4483891	4483917		YPO_RS21020	26
ARS007ss_ds.merged.samereadgroup.cleaned	4483968	4483970		YPO_RS21020	2
ARS007ss_ds.merged.samereadgroup.cleaned	4484177	4484240		YPO_RS21025	63
ARS007ss_ds.merged.samereadgroup.cleaned	4484452	4484475		YPO_RS21025	23
ARS007ss_ds.merged.samereadgroup.cleaned	4484813	4484818		YPO_RS21030	5
ARS007ss_ds.merged.samereadgroup.cleaned	4484948	4484969		YPO_RS21030	21
ARS007ss_ds.merged.samereadgroup.cleaned	4485013	4485029		YPO_RS21030	16
ARS007ss_ds.merged.samereadgroup.cleaned	4485104	4485106		YPO_RS21030	2
ARS007ss_ds.merged.samereadgroup.cleaned	4486094	4486114		yapE	20
ARS007ss_ds.merged.samereadgroup.cleaned	4486214	4486215		yapE	1
ARS007ss_ds.merged.samereadgroup.cleaned	4487143	4487151		yapE	8
ARS007ss_ds.merged.samereadgroup.cleaned	4487321	4487325		yapE	4
ARS007ss_ds.merged.samereadgroup.cleaned	4487376	4487407		yapE	31
ARS007ss_ds.merged.samereadgroup.cleaned	4487470	4487473		yapE	3
ARS007ss_ds.merged.samereadgroup.cleaned	4487557	4487562		yapE	5
ARS007ss_ds.merged.samereadgroup.cleaned	4488017	4488043		yapE	26
ARS007ss_ds.merged.samereadgroup.cleaned	4488155	4488158		yapE	3
ARS007ss_ds.merged.samereadgroup.cleaned	4488270	4488288		yapE	18
ARS007ss_ds.merged.samereadgroup.cleaned	4488675	4488688		yapE	13
ARS007ss_ds.merged.samereadgroup.cleaned	4490405	4490407		yhjD	2
ARS007ss_ds.merged.samereadgroup.cleaned	4490461	4490475		yhjD	14
ARS007ss_ds.merged.samereadgroup.cleaned	4491396	4491443		YPO_RS21050	47
ARS007ss_ds.merged.samereadgroup.cleaned	4491778	4491789		YPO_RS21050	11
ARS007ss_ds.merged.samereadgroup.cleaned	4492072	4492079		YPO_RS21050	7
ARS007ss_ds.merged.samereadgroup.cleaned	4493291	4493311		YPO_RS21050	20
ARS007ss_ds.merged.samereadgroup.cleaned	4494271	4494287		pdeH	16
ARS007ss_ds.merged.samereadgroup.cleaned	4494434	4494441		pdeH	7
ARS007ss_ds.merged.samereadgroup.cleaned	4497341	4497345		YPO_RS21070	4
ARS007ss_ds.merged.samereadgroup.cleaned	4498454	4498475		YPO_RS21075	21
ARS007ss_ds.merged.samereadgroup.cleaned	4498747	4498755		YPO_RS21075	8
ARS007ss_ds.merged.samereadgroup.cleaned	4499004	4499024		YPO_RS21075	20
ARS007ss_ds.merged.samereadgroup.cleaned	4500296	4500300		YPO_RS21080	4
ARS007ss_ds.merged.samereadgroup.cleaned	4501158	4501160		YPO_RS21085	2
ARS007ss_ds.merged.samereadgroup.cleaned	4501404	4501406		YPO_RS21085	2
ARS007ss_ds.merged.samereadgroup.cleaned	4502232	4502235		YPO_RS21085	3
ARS007ss_ds.merged.samereadgroup.cleaned	4502666	4502673		YPO_RS21090	7
ARS007ss_ds.merged.samereadgroup.cleaned	4502932	4502934		YPO_RS21090	2
ARS007ss_ds.merged.samereadgroup.cleaned	4503141	4503149		YPO_RS21090	8
ARS007ss_ds.merged.samereadgroup.cleaned	4504582	4504591		hmsP	9
ARS007ss_ds.merged.samereadgroup.cleaned	4507304	4507318		YPO_RS21105	14
ARS007ss_ds.merged.samereadgroup.cleaned	4507613	4507624		YPO_RS21110	11
ARS007ss_ds.merged.samereadgroup.cleaned	4508341	4508345		YPO_RS21110	4
ARS007ss_ds.merged.samereadgroup.cleaned	4509521	4509522		dppD	1
ARS007ss_ds.merged.samereadgroup.cleaned	4510414	4510429		dppC	15
ARS007ss_ds.merged.samereadgroup.cleaned	4510633	4510637		dppB	4
ARS007ss_ds.merged.samereadgroup.cleaned	4512504	4512508		YPO_RS21130	4
ARS007ss_ds.merged.samereadgroup.cleaned	4513158	4513159		YPO_RS21130	1
ARS007ss_ds.merged.samereadgroup.cleaned	4513362	4513366		YPO_RS21130	4
ARS007ss_ds.merged.samereadgroup.cleaned	4514287	4514290		YPO_RS21135	3
ARS007ss_ds.merged.samereadgroup.cleaned	4514641	4514649		YPO_RS21135	8
ARS007ss_ds.merged.samereadgroup.cleaned	4515047	4515078		YPO_RS21135	31
ARS007ss_ds.merged.samereadgroup.cleaned	4515666	4515670		YPO_RS21135	4
ARS007ss_ds.merged.samereadgroup.cleaned	4516149	4516152		YPO_RS21140	3
ARS007ss_ds.merged.samereadgroup.cleaned	4516246	4516310		YPO_RS21140	64
ARS007ss_ds.merged.samereadgroup.cleaned	4516569	4516571		YPO_RS21140	2
ARS007ss_ds.merged.samereadgroup.cleaned	4516734	4516769		YPO_RS21140	35
ARS007ss_ds.merged.samereadgroup.cleaned	4517294	4517319		YPO_RS21140	25
ARS007ss_ds.merged.samereadgroup.cleaned	4519405	4519410		YPO_RS21155	5
ARS007ss_ds.merged.samereadgroup.cleaned	4519622	4519627		YPO_RS21155	5
ARS007ss_ds.merged.samereadgroup.cleaned	4523959	4523975		eptB	16
ARS007ss_ds.merged.samereadgroup.cleaned	4524383	4524385		eptB	2
ARS007ss_ds.merged.samereadgroup.cleaned	4524594	4524606		eptB	12
ARS007ss_ds.merged.samereadgroup.cleaned	4525071	4525076		eptB	5
ARS007ss_ds.merged.samereadgroup.cleaned	4527121	4527126		YPO_RS21185	5
ARS007ss_ds.merged.samereadgroup.cleaned	4528334	4528342		YPO_RS21190	8
ARS007ss_ds.merged.samereadgroup.cleaned	4528447	4528450		YPO_RS21190	3
ARS007ss_ds.merged.samereadgroup.cleaned	4528493	4528510		YPO_RS21190	17
ARS007ss_ds.merged.samereadgroup.cleaned	4528804	4528821		YPO_RS21190	17
ARS007ss_ds.merged.samereadgroup.cleaned	4529905	4529906		hutH	1
ARS007ss_ds.merged.samereadgroup.cleaned	4533463	4533476		YPO_RS21205	13
ARS007ss_ds.merged.samereadgroup.cleaned	4534001	4534005		YPO_RS21205	4
ARS007ss_ds.merged.samereadgroup.cleaned	4534222	4534225		YPO_RS21205	3
ARS007ss_ds.merged.samereadgroup.cleaned	4534678	4534682		YPO_RS21210	4
ARS007ss_ds.merged.samereadgroup.cleaned	4534825	4534832		YPO_RS21210	7
ARS007ss_ds.merged.samereadgroup.cleaned	4535567	4535590		YPO_RS21215	23
ARS007ss_ds.merged.samereadgroup.cleaned	4539348	4539353		YPO_RS21230	5
ARS007ss_ds.merged.samereadgroup.cleaned	4540042	4540047		YPO_RS21235	5
ARS007ss_ds.merged.samereadgroup.cleaned	4540470	4540497		YPO_RS21235	27
ARS007ss_ds.merged.samereadgroup.cleaned	4540709	4540718		YPO_RS21240	9
ARS007ss_ds.merged.samereadgroup.cleaned	4543494	4543497		YPO_RS21265	3
ARS007ss_ds.merged.samereadgroup.cleaned	4544818	4544824		YPO_RS21275	6
ARS007ss_ds.merged.samereadgroup.cleaned	4545394	4545418		YPO_RS21280	24
ARS007ss_ds.merged.samereadgroup.cleaned	4545704	4545705		YPO_RS21280	1
ARS007ss_ds.merged.samereadgroup.cleaned	4545824	4545879		YPO_RS21280	55
ARS007ss_ds.merged.samereadgroup.cleaned	4546094	4546101		YPO_RS21280	7
ARS007ss_ds.merged.samereadgroup.cleaned	4546307	4546323		YPO_RS21280	16
ARS007ss_ds.merged.samereadgroup.cleaned	4548582	4548584		YPO_RS21295	2
ARS007ss_ds.merged.samereadgroup.cleaned	4549653	4549655		YPO_RS21300	2
ARS007ss_ds.merged.samereadgroup.cleaned	4549928	4549941		YPO_RS21300	13
ARS007ss_ds.merged.samereadgroup.cleaned	4550685	4550689		YPO_RS21305	4
ARS007ss_ds.merged.samereadgroup.cleaned	4550952	4550954		YPO_RS21305	2
ARS007ss_ds.merged.samereadgroup.cleaned	4551456	4551462		YPO_RS21305	6
ARS007ss_ds.merged.samereadgroup.cleaned	4551771	4551777		YPO_RS21305	6
ARS007ss_ds.merged.samereadgroup.cleaned	4552455	4552466		xylF	11
ARS007ss_ds.merged.samereadgroup.cleaned	4554345	4554349		xylA	4
ARS007ss_ds.merged.samereadgroup.cleaned	4555671	4555673		xylB	2
ARS007ss_ds.merged.samereadgroup.cleaned	4555711	4555727		xylB	16
ARS007ss_ds.merged.samereadgroup.cleaned	4555800	4555803		xylB	3
ARS007ss_ds.merged.samereadgroup.cleaned	4556431	4556434		xylB	3
ARS007ss_ds.merged.samereadgroup.cleaned	4557529	4557540		YPO_RS21325	11
ARS007ss_ds.merged.samereadgroup.cleaned	4558131	4558157		YPO_RS21330	26
ARS007ss_ds.merged.samereadgroup.cleaned	4558492	4558513		YPO_RS21330	21
ARS007ss_ds.merged.samereadgroup.cleaned	4561488	4561492		YPO_RS21340	4
ARS007ss_ds.merged.samereadgroup.cleaned	4561865	4561867		YPO_RS21340	2
ARS007ss_ds.merged.samereadgroup.cleaned	4566120	4566125		YPO_RS21360	5
ARS007ss_ds.merged.samereadgroup.cleaned	4566409	4566422		YPO_RS21360	13
ARS007ss_ds.merged.samereadgroup.cleaned	4567061	4567064		YPO_RS21360	3
ARS007ss_ds.merged.samereadgroup.cleaned	4567754	4567785		YPO_RS21370	31
ARS007ss_ds.merged.samereadgroup.cleaned	4568102	4568104		YPO_RS21375	2
ARS007ss_ds.merged.samereadgroup.cleaned	4568466	4568472		YPO_RS21380	6
ARS007ss_ds.merged.samereadgroup.cleaned	4569619	4569630		selB	11
ARS007ss_ds.merged.samereadgroup.cleaned	4569883	4569887		selB	4
ARS007ss_ds.merged.samereadgroup.cleaned	4570825	4570826		selB	1
ARS007ss_ds.merged.samereadgroup.cleaned	4570934	4570949		selB	15
ARS007ss_ds.merged.samereadgroup.cleaned	4570988	4570999		selB	11
ARS007ss_ds.merged.samereadgroup.cleaned	4571449	4571451		YPO_RS21395	2
ARS007ss_ds.merged.samereadgroup.cleaned	4572525	4572559		YPO_RS21400	34
ARS007ss_ds.merged.samereadgroup.cleaned	4574116	4574122		fdoI	6
ARS007ss_ds.merged.samereadgroup.cleaned	4574728	4574756		fdxH	28
ARS007ss_ds.merged.samereadgroup.cleaned	4574976	4575001		fdxH	25
ARS007ss_ds.merged.samereadgroup.cleaned	4580200	4580203		sodA	3
ARS007ss_ds.merged.samereadgroup.cleaned	4582253	4582261		YPO_RS21435	8
ARS007ss_ds.merged.samereadgroup.cleaned	4583273	4583278		YPO_RS21440	5
ARS007ss_ds.merged.samereadgroup.cleaned	4583317	4583344		YPO_RS21440	27
ARS007ss_ds.merged.samereadgroup.cleaned	4584830	4584836		YPO_RS21450	6
ARS007ss_ds.merged.samereadgroup.cleaned	4585047	4585059		YPO_RS21450	12
ARS007ss_ds.merged.samereadgroup.cleaned	4585700	4585707		YPO_RS21455	7
ARS007ss_ds.merged.samereadgroup.cleaned	4587552	4587569		YPO_RS21465	17
ARS007ss_ds.merged.samereadgroup.cleaned	4589107	4589126		YPO_RS21465	19
ARS007ss_ds.merged.samereadgroup.cleaned	4590295	4590298		YPO_RS21470	3
ARS007ss_ds.merged.samereadgroup.cleaned	4590970	4590988		YPO_RS21475	18
ARS007ss_ds.merged.samereadgroup.cleaned	4593629	4593639		glyQ	10
ARS007ss_ds.merged.samereadgroup.cleaned	4593757	4593760		glyQ	3
ARS007ss_ds.merged.samereadgroup.cleaned	4594610	4594618		YPO_RS21490	8
ARS007ss_ds.merged.samereadgroup.cleaned	4595261	4595267		YPO_RS21495	6
ARS007ss_ds.merged.samereadgroup.cleaned	4596141	4596148		YPO_RS21500	7
ARS007ss_ds.merged.samereadgroup.cleaned	4599308	4599319		YPO_RS21515	11
ARS007ss_ds.merged.samereadgroup.cleaned	4599431	4599447		YPO_RS21515	16
ARS007ss_ds.merged.samereadgroup.cleaned	4599480	4599491		YPO_RS21515	11
ARS007ss_ds.merged.samereadgroup.cleaned	4601716	4601733		YPO_RS21520	17
ARS007ss_ds.merged.samereadgroup.cleaned	4601982	4602067		YPO_RS21520	85
ARS007ss_ds.merged.samereadgroup.cleaned	4602603	4602614		YPO_RS21525	11
ARS007ss_ds.merged.samereadgroup.cleaned	4602906	4602917		YPO_RS21525	11
ARS007ss_ds.merged.samereadgroup.cleaned	4604113	4604140		YPO_RS21530	27
ARS007ss_ds.merged.samereadgroup.cleaned	4604909	4604920		YPO_RS21530	11
ARS007ss_ds.merged.samereadgroup.cleaned	4605542	4605545		YPO_RS21530	3
ARS007ss_ds.merged.samereadgroup.cleaned	4606294	4606299		ibpB	5
ARS007ss_ds.merged.samereadgroup.cleaned	4606984	4606991		ibpA	7
ARS007ss_ds.merged.samereadgroup.cleaned	4607532	4607547		YPO_RS21545	15
ARS007ss_ds.merged.samereadgroup.cleaned	4608685	4608695		YPO_RS21555	10
ARS007ss_ds.merged.samereadgroup.cleaned	4609862	4609867		YPO_RS21560	5
ARS007ss_ds.merged.samereadgroup.cleaned	4610556	4610557		YPO_RS21560	1
ARS007ss_ds.merged.samereadgroup.cleaned	4612519	4612529		yidA	10
ARS007ss_ds.merged.samereadgroup.cleaned	4612581	4612584		yidA	3
ARS007ss_ds.merged.samereadgroup.cleaned	4613619	4613620		gyrB	1
ARS007ss_ds.merged.samereadgroup.cleaned	4615084	4615101		gyrB	17
ARS007ss_ds.merged.samereadgroup.cleaned	4616762	4616770		recF	8
ARS007ss_ds.merged.samereadgroup.cleaned	4620960	4620966		yidD	6
ARS007ss_ds.merged.samereadgroup.cleaned	4621338	4621350		yidC	12
ARS007ss_ds.merged.samereadgroup.cleaned	4623117	4623124		mnmE	7
ARS007ss_ds.merged.samereadgroup.cleaned	4623764	4623779		mnmE	15
ARS007ss_ds.merged.samereadgroup.cleaned	4625906	4625915		YPO_RS21625	9
ARS007ss_ds.merged.samereadgroup.cleaned	4626088	4626089		YPO_RS21625	1
ARS007ss_ds.merged.samereadgroup.cleaned	4626181	4626196		YPO_RS21630	15
ARS007ss_ds.merged.samereadgroup.cleaned	4626269	4626298		YPO_RS21630	29
ARS007ss_ds.merged.samereadgroup.cleaned	4626378	4626379		YPO_RS21630	1
ARS007ss_ds.merged.samereadgroup.cleaned	4626593	4626604		YPO_RS21635	11
ARS007ss_ds.merged.samereadgroup.cleaned	4627725	4627734		YPO_RS21640	9
ARS007ss_ds.merged.samereadgroup.cleaned	4627799	4627817		YPO_RS21640	18
ARS007ss_ds.merged.samereadgroup.cleaned	4628263	4628266		YPO_RS21640	3
ARS007ss_ds.merged.samereadgroup.cleaned	4628556	4628576		YPO_RS21640	20
ARS007ss_ds.merged.samereadgroup.cleaned	4629419	4629435		YPO_RS21645	16
ARS007ss_ds.merged.samereadgroup.cleaned	4630268	4630271		YPO_RS21655	3
ARS007ss_ds.merged.samereadgroup.cleaned	4630686	4630696		YPO_RS21655	10
ARS007ss_ds.merged.samereadgroup.cleaned	4632031	4632032		YPO_RS21665	1
ARS007ss_ds.merged.samereadgroup.cleaned	4633581	4633587		YPO_RS21670	6
ARS007ss_ds.merged.samereadgroup.cleaned	4634564	4634578		phoU	14
ARS007ss_ds.merged.samereadgroup.cleaned	4635333	4635334		pstB	1
ARS007ss_ds.merged.samereadgroup.cleaned	4635598	4635603		pstA	5
ARS007ss_ds.merged.samereadgroup.cleaned	4636678	4636693		pstC	15
ARS007ss_ds.merged.samereadgroup.cleaned	4641707	4641716		glmU	9
ARS007ss_ds.merged.samereadgroup.cleaned	4642181	4642182		glmU	1
ARS007ss_ds.merged.samereadgroup.cleaned	4642548	4642576		glmU	28
ARS007ss_ds.merged.samereadgroup.cleaned	4643989	4643993		atpD	4
ARS007ss_ds.merged.samereadgroup.cleaned	4644303	4644317		atpD	14
ARS007ss_ds.merged.samereadgroup.cleaned	4644762	4644767		atpD	5
ARS007ss_ds.merged.samereadgroup.cleaned	4644803	4644807		atpD	4
ARS007ss_ds.merged.samereadgroup.cleaned	4645632	4645643		atpG	11
ARS007ss_ds.merged.samereadgroup.cleaned	4646722	4646731		atpA	9
ARS007ss_ds.merged.samereadgroup.cleaned	4646998	4647015		atpA	17
ARS007ss_ds.merged.samereadgroup.cleaned	4649442	4649444		atpB	2
ARS007ss_ds.merged.samereadgroup.cleaned	4649823	4649872		atpB	49
ARS007ss_ds.merged.samereadgroup.cleaned	4650141	4650168		atpI	27
ARS007ss_ds.merged.samereadgroup.cleaned	4651966	4651968		mnmG	2
ARS007ss_ds.merged.samereadgroup.cleaned	4652811	4652822		mnmG	11
CHC004_libmerged	3217	3218		viaA	1
CHC004_libmerged	7235	7245		kup	10
CHC004_libmerged	7954	7961		rbsD	7
CHC004_libmerged	9546	9553		YPO_RS01055	7
CHC004_libmerged	14916	14919		YPO_RS01080	3
CHC004_libmerged	19625	19628		mobB	3
CHC004_libmerged	19671	19673		mobB	2
CHC004_libmerged	23847	23882		polA	35
CHC004_libmerged	24997	25001		polA	4
CHC004_libmerged	37829	37837		yihX	8
CHC004_libmerged	41560	41561		fabY	1
CHC004_libmerged	49720	49722		trmH	2
CHC004_libmerged	53807	53820		ligB	13
CHC004_libmerged	61767	61775		YPO_RS01280	8
CHC004_libmerged	63555	63559		mutM	4
CHC004_libmerged	67068	67078		rfaC	10
CHC004_libmerged	71700	71704		tdh	4
CHC004_libmerged	81878	81882		ada	4
CHC004_libmerged	106581	106588		YPO_RS01520	7
CHC004_libmerged	109093	109094		YPO_RS01530	1
CHC004_libmerged	112382	112390		YPO_RS01550	8
CHC004_libmerged	114978	115004		hslV	26
CHC004_libmerged	116451	116460		cytR	9
CHC004_libmerged	124870	124871		YPO_RS01600	1
CHC004_libmerged	134731	134752		malP	21
CHC004_libmerged	135761	135798		malP	37
CHC004_libmerged	141037	141039		bioH	2
CHC004_libmerged	141715	141720		YPO_RS01670	5
CHC004_libmerged	148486	148488		greB	2
CHC004_libmerged	151660	151666		pckA	6
CHC004_libmerged	156691	156695		YPO_RS01725	4
CHC004_libmerged	158000	158001		nudE	1
CHC004_libmerged	160845	160849		mrcA	4
CHC004_libmerged	160890	160903		mrcA	13
CHC004_libmerged	163388	163390		YPO_RS01755	2
CHC004_libmerged	163452	163453		YPO_RS01755	1
CHC004_libmerged	163626	163630		hofQ	4
CHC004_libmerged	177297	177299		YPO_RS01815	2
CHC004_libmerged	178852	178855		YPO_RS01820	3
CHC004_libmerged	193566	193567		YPO_RS01880	1
CHC004_libmerged	193773	193774		YPO_RS01880	1
CHC004_libmerged	194727	194742		YPO_RS01880	15
CHC004_libmerged	196223	196226		YPO_RS01890	3
CHC004_libmerged	196651	196722		YPO_RS01895	71
CHC004_libmerged	196755	196808		YPO_RS01895	53
CHC004_libmerged	196904	196914		YPO_RS01895	10
CHC004_libmerged	204133	204137		YPO_RS01940	4
CHC004_libmerged	205801	205806		YPO_RS01945	5
CHC004_libmerged	208908	208914		kefB	6
CHC004_libmerged	226032	226041		rplP	9
CHC004_libmerged	236808	236821		mscL	13
CHC004_libmerged	244905	244908		aroE	3
CHC004_libmerged	245394	245398		YPO_RS02240	4
CHC004_libmerged	249222	249223		actP	1
CHC004_libmerged	253547	253548		gltP	1
CHC004_libmerged	258747	258777		YPO_RS02290	30
CHC004_libmerged	261079	261081		sctD	2
CHC004_libmerged	262687	262690		sctF	3
CHC004_libmerged	269396	269406		YPO_RS02355	10
CHC004_libmerged	269545	269554		YPO_RS02355	9
CHC004_libmerged	270960	270962		sctR	2
CHC004_libmerged	273986	273991		yedE	5
CHC004_libmerged	275507	275575		YPO_RS02395	68
CHC004_libmerged	277754	277764		YPO_RS02400	10
CHC004_libmerged	277883	277906		metC	23
CHC004_libmerged	281537	281539		YPO_RS02420	2
CHC004_libmerged	284647	284650		YPO_RS02430	3
CHC004_libmerged	285602	285608		YPO_RS02440	6
CHC004_libmerged	288504	288510		YPO_RS02455	6
CHC004_libmerged	288788	288792		YPO_RS02455	4
CHC004_libmerged	288878	288909		YPO_RS02455	31
CHC004_libmerged	289061	289063		YPO_RS02455	2
CHC004_libmerged	289431	289448		YPO_RS02460	17
CHC004_libmerged	293300	293302		YPO_RS02480	2
CHC004_libmerged	293611	293616		YPO_RS02480	5
CHC004_libmerged	294469	294471		YPO_RS02485	2
CHC004_libmerged	303524	303533		YPO_RS02530	9
CHC004_libmerged	304091	304119		YPO_RS02530	28
CHC004_libmerged	307340	307349		YPO_RS02550	9
CHC004_libmerged	308150	308151		YPO_RS02550	1
CHC004_libmerged	315065	315091		yapK	26
CHC004_libmerged	335077	335078		ssb1	1
CHC004_libmerged	343801	343805		rhaT	4
CHC004_libmerged	345110	345111		YPO_RS02690	1
CHC004_libmerged	345811	345813		YPO_RS02695	2
CHC004_libmerged	345932	345979		YPO_RS02695	47
CHC004_libmerged	346625	346686		YPO_RS02695	61
CHC004_libmerged	347185	347218		YPO_RS02695	33
CHC004_libmerged	347258	347265		YPO_RS02695	7
CHC004_libmerged	347727	347752		YPO_RS02695	25
CHC004_libmerged	347970	347971		YPO_RS02695	1
CHC004_libmerged	353437	353477		fdhF	40
CHC004_libmerged	358987	358991		aspA	4
CHC004_libmerged	360805	360818		fxsA	13
CHC004_libmerged	369187	369191		frdA	4
CHC004_libmerged	371056	371075		YPO_RS02805	19
CHC004_libmerged	373616	373630		mscM	14
CHC004_libmerged	374127	374155		mscM	28
CHC004_libmerged	375053	375062		mscM	9
CHC004_libmerged	378637	378639		orn	2
CHC004_libmerged	380330	380345		queG	15
CHC004_libmerged	394639	394645		nsrR	6
CHC004_libmerged	396294	396305		rnr	11
CHC004_libmerged	399054	399059		YPO_RS02915	5
CHC004_libmerged	400508	400514		bsmA	6
CHC004_libmerged	407640	407651		YPO_RS02955	11
CHC004_libmerged	407771	407788		YPO_RS02955	17
CHC004_libmerged	408056	408063		YPO_RS02955	7
CHC004_libmerged	408159	408214		YPO_RS02955	55
CHC004_libmerged	408299	408337		YPO_RS02955	38
CHC004_libmerged	408467	408505		YPO_RS02955	38
CHC004_libmerged	408824	408828		YPO_RS02960	4
CHC004_libmerged	409007	409025		YPO_RS02960	18
CHC004_libmerged	409187	409210		YPO_RS02960	23
CHC004_libmerged	409413	409453		YPO_RS02960	40
CHC004_libmerged	409838	409917		YPO_RS02965	79
CHC004_libmerged	410023	410032		YPO_RS02965	9
CHC004_libmerged	410341	410360		YPO_RS02965	19
CHC004_libmerged	410531	410594		YPO_RS02965	63
CHC004_libmerged	410808	410813		YPO_RS02965	5
CHC004_libmerged	410858	410891		YPO_RS02965	33
CHC004_libmerged	409578	409699		YPO_RS02965	121
CHC004_libmerged	411342	411346		YPO_RS02970	4
CHC004_libmerged	413818	413824		YPO_RS02985	6
CHC004_libmerged	415383	415385		YPO_RS02990	2
CHC004_libmerged	416442	416449		YPO_RS02995	7
CHC004_libmerged	422242	422245		ptsP	3
CHC004_libmerged	422307	422323		ptsP	16
CHC004_libmerged	423428	423431		ptsP	3
CHC004_libmerged	425994	425998		lsrF	4
CHC004_libmerged	426090	426093		lsrF	3
CHC004_libmerged	428366	428376		lsrD	10
CHC004_libmerged	429000	429002		lsrC	2
CHC004_libmerged	431284	431363		YPO_RS03065	79
CHC004_libmerged	432725	432736		lsrK	11
CHC004_libmerged	433225	433235		lsrK	10
CHC004_libmerged	439586	439594		YPO_RS03100	8
CHC004_libmerged	444680	444700		YPO_RS03115	20
CHC004_libmerged	446217	446232		YPO_RS03120	15
CHC004_libmerged	446330	446351		YPO_RS03120	21
CHC004_libmerged	450996	451017		prfC	21
CHC004_libmerged	453364	453370		YPO_RS03165	6
CHC004_libmerged	454638	454639		YPO_RS03170	1
CHC004_libmerged	460093	460122		deoB	29
CHC004_libmerged	464233	464243		radA	10
CHC004_libmerged	464716	464720		radA	4
CHC004_libmerged	467912	467922		YPO_RS03220	10
CHC004_libmerged	472815	472821		YPO_RS03245	6
CHC004_libmerged	473280	473288		YPO_RS03245	8
CHC004_libmerged	480976	480978		creA	2
CHC004_libmerged	491799	491809		mog	10
CHC004_libmerged	493534	493548		YPO_RS03325	14
CHC004_libmerged	494714	494718		YPO_RS03330	4
CHC004_libmerged	494971	495078		YPO_RS03330	107
CHC004_libmerged	495179	495180		YPO_RS03330	1
CHC004_libmerged	495221	495318		YPO_RS03330	97
CHC004_libmerged	495404	495424		YPO_RS03330	20
CHC004_libmerged	495740	495803		YPO_RS03330	63
CHC004_libmerged	500440	500448		dnaJ	8
CHC004_libmerged	501108	501117		nhaA	9
CHC004_libmerged	504428	504439		ribF	11
CHC004_libmerged	520843	520844		YPO_RS03445	1
CHC004_libmerged	521134	521138		YPO_RS03450	4
CHC004_libmerged	526904	526907		lptD	3
CHC004_libmerged	527317	527326		lptD	9
CHC004_libmerged	528237	528246		lptD	9
CHC004_libmerged	532061	532062		YPO_RS03495	1
CHC004_libmerged	533774	533775		tssB	1
CHC004_libmerged	539404	539409		tssG	5
CHC004_libmerged	541835	541837		tssH	2
CHC004_libmerged	544347	544350		vgrG	3
CHC004_libmerged	544405	544410		vgrG	5
CHC004_libmerged	557577	557578		rapA	1
CHC004_libmerged	562660	562673		YPO_RS03600	13
CHC004_libmerged	564017	564034		thiQ	17
CHC004_libmerged	565661	565662		thiP	1
CHC004_libmerged	566127	566131		YPO_RS03620	4
CHC004_libmerged	573140	573143		YPO_RS03645	3
CHC004_libmerged	575326	575347		leuC	21
CHC004_libmerged	579548	579586		YPO_RS03675	38
CHC004_libmerged	592045	592066		YPO_RS03735	21
CHC004_libmerged	592187	592193		YPO_RS03735	6
CHC004_libmerged	595344	595361		murF	17
CHC004_libmerged	606197	606200		ftsZ	3
CHC004_libmerged	616448	616464		YPO_RS03845	16
CHC004_libmerged	618624	618627		YPO_RS03865	3
CHC004_libmerged	635498	635501		yapG	3
CHC004_libmerged	637707	637720		YPO_RS03935	13
CHC004_libmerged	638335	638337		YPO_RS03935	2
CHC004_libmerged	643385	643388		YPO_RS03950	3
CHC004_libmerged	647611	647614		YPO_RS03975	3
CHC004_libmerged	652059	652060		cdiA	1
CHC004_libmerged	652235	652242		cdiA	7
CHC004_libmerged	653899	653909		cdiA	10
CHC004_libmerged	659383	659415		cdiI	32
CHC004_libmerged	660167	660180		YPO_RS04005	13
CHC004_libmerged	662054	662056		yapF	2
CHC004_libmerged	662358	662359		yapF	1
CHC004_libmerged	663796	663813		yapF	17
CHC004_libmerged	664996	665000		YPO_RS04025	4
CHC004_libmerged	666282	666300		YPO_RS04030	18
CHC004_libmerged	666541	666545		YPO_RS04030	4
CHC004_libmerged	667980	667987		YPO_RS04035	7
CHC004_libmerged	671619	671625		YPO_RS04045	6
CHC004_libmerged	673950	673974		YPO_RS04055	24
CHC004_libmerged	675930	675931		YPO_RS04065	1
CHC004_libmerged	680635	680642		YPO_RS04080	7
CHC004_libmerged	684565	684612		YPO_RS04100	47
CHC004_libmerged	687063	687077		YPO_RS04110	14
CHC004_libmerged	687844	687846		YPO_RS04115	2
CHC004_libmerged	687967	687981		YPO_RS04115	14
CHC004_libmerged	688448	688457		YPO_RS04120	9
CHC004_libmerged	689061	689082		YPO_RS04125	21
CHC004_libmerged	690272	690282		YPO_RS04135	10
CHC004_libmerged	691177	691196		YPO_RS04140	19
CHC004_libmerged	700885	700902		rpoD	17
CHC004_libmerged	702672	702675		dnaG	3
CHC004_libmerged	704027	704035		tsaD	8
CHC004_libmerged	707573	707591		YPO_RS04230	18
CHC004_libmerged	708564	708580		YPO_RS04230	16
CHC004_libmerged	715880	715882		yjeH	2
CHC004_libmerged	716333	716335		yjeH	2
CHC004_libmerged	719525	719542		ygiD	17
CHC004_libmerged	720886	720892		YPO_RS04275	6
CHC004_libmerged	721727	721742		YPO_RS04280	15
CHC004_libmerged	727866	727872		parE	6
CHC004_libmerged	728977	728985		YPO_RS04315	8
CHC004_libmerged	729410	729414		YPO_RS04315	4
CHC004_libmerged	730278	730286		YPO_RS04320	8
CHC004_libmerged	731257	731259		parC	2
CHC004_libmerged	739036	739039		dkgA	3
CHC004_libmerged	739654	739666		yqhD	12
CHC004_libmerged	744214	744220		metC	6
CHC004_libmerged	744832	744873		exbB	41
CHC004_libmerged	746466	746482		YPO_RS04390	16
CHC004_libmerged	746615	746619		YPO_RS04390	4
CHC004_libmerged	746876	746884		YPO_RS04390	8
CHC004_libmerged	747063	747080		YPO_RS04390	17
CHC004_libmerged	747587	747592		YPO_RS04390	5
CHC004_libmerged	747752	747783		YPO_RS04390	31
CHC004_libmerged	749304	749335		YPO_RS04405	31
CHC004_libmerged	749630	749644		YPO_RS04405	14
CHC004_libmerged	749630	749644		YPO_RS04410	14
CHC004_libmerged	749681	749700		YPO_RS04410	19
CHC004_libmerged	750204	750284		YPO_RS04410	80
CHC004_libmerged	750484	750517		YPO_RS04415	33
CHC004_libmerged	750991	751017		YPO_RS04415	26
CHC004_libmerged	751102	751158		YPO_RS04415	56
CHC004_libmerged	752926	752928		YPO_RS04425	2
CHC004_libmerged	753294	753300		YPO_RS04425	6
CHC004_libmerged	753520	753563		YPO_RS04425	43
CHC004_libmerged	753728	753756		YPO_RS04425	28
CHC004_libmerged	753767	753776		YPO_RS04430	9
CHC004_libmerged	753824	753830		YPO_RS04430	6
CHC004_libmerged	753877	753920		YPO_RS04430	43
CHC004_libmerged	754830	754858		YPO_RS04440	28
CHC004_libmerged	755026	755052		YPO_RS04440	26
CHC004_libmerged	755306	755356		YPO_RS04440	50
CHC004_libmerged	755781	755799		YPO_RS04445	18
CHC004_libmerged	756605	756615		YPO_RS04450	10
CHC004_libmerged	769883	769916		flhB	33
CHC004_libmerged	771725	771736		fliP	11
CHC004_libmerged	772963	773027		YPO_RS04525	64
CHC004_libmerged	777828	777841		YPO_RS04550	13
CHC004_libmerged	778081	778082		YPO_RS04550	1
CHC004_libmerged	781525	781533		flgA	8
CHC004_libmerged	782236	782251		flgA	15
CHC004_libmerged	782522	782528		flgB	6
CHC004_libmerged	782978	782984		flgC	6
CHC004_libmerged	784086	784087		flaE	1
CHC004_libmerged	785300	785316		YPO_RS04600	16
CHC004_libmerged	787661	787681		flgH	20
CHC004_libmerged	791128	791141		flgK	13
CHC004_libmerged	792429	792439		YPO_RS04645	10
CHC004_libmerged	794749	794755		YPO_RS04655	6
CHC004_libmerged	796063	796082		YPO_RS04660	19
CHC004_libmerged	800879	800887		fliD	8
CHC004_libmerged	801480	801499		fliS	19
CHC004_libmerged	802103	802106		YPO_RS04690	3
CHC004_libmerged	802550	802674		YPO_RS04690	124
CHC004_libmerged	803071	803077		YPO_RS04690	6
CHC004_libmerged	804377	804382		YPO_RS04700	5
CHC004_libmerged	804888	804899		motA	11
CHC004_libmerged	805182	805190		motA	8
CHC004_libmerged	806663	806688		YPO_RS04715	25
CHC004_libmerged	806880	806884		YPO_RS04715	4
CHC004_libmerged	807455	807459		YPO_RS04720	4
CHC004_libmerged	807624	807705		YPO_RS04720	81
CHC004_libmerged	807690	807705		YPO_RS04725	15
CHC004_libmerged	809002	809003		YPO_RS04735	1
CHC004_libmerged	809053	809057		YPO_RS04735	4
CHC004_libmerged	809186	809241		YPO_RS04735	55
CHC004_libmerged	811498	811501		YPO_RS04745	3
CHC004_libmerged	812702	812704		YPO_RS04750	2
CHC004_libmerged	814064	814070		YPO_RS04755	6
CHC004_libmerged	816391	816412		YPO_RS04765	21
CHC004_libmerged	816685	816687		YPO_RS04765	2
CHC004_libmerged	816733	816736		YPO_RS04765	3
CHC004_libmerged	816871	816874		YPO_RS04770	3
CHC004_libmerged	822828	822835		vgrG	7
CHC004_libmerged	833835	833846		YPO_RS04800	11
CHC004_libmerged	835327	835333		YPO_RS04805	6
CHC004_libmerged	837364	837369		YPO_RS04810	5
CHC004_libmerged	838859	838924		YPO_RS04815	65
CHC004_libmerged	841372	841377		YPO_RS04825	5
CHC004_libmerged	842078	842081		YPO_RS04830	3
CHC004_libmerged	843448	843455		YPO_RS04835	7
CHC004_libmerged	845404	845613		YPO_RS04835	209
CHC004_libmerged	847054	847064		YPO_RS04835	10
CHC004_libmerged	849960	849970		YPO_RS04840	10
CHC004_libmerged	852609	852613		YPO_RS04845	4
CHC004_libmerged	856527	856530		YPO_RS04845	3
CHC004_libmerged	858884	858885		YPO_RS04860	1
CHC004_libmerged	859559	859567		thyA	8
CHC004_libmerged	863505	863506		ptsP	1
CHC004_libmerged	876533	876534		lysA	1
CHC004_libmerged	877924	877926		YPO_RS04935	2
CHC004_libmerged	884093	884119		YPO_RS04960	26
CHC004_libmerged	884205	884206		YPO_RS04965	1
CHC004_libmerged	884302	884321		YPO_RS04965	19
CHC004_libmerged	884432	884461		YPO_RS04965	29
CHC004_libmerged	884761	884796		YPO_RS04965	35
CHC004_libmerged	885656	885688		YPO_RS04975	32
CHC004_libmerged	886229	886235		YPO_RS04975	6
CHC004_libmerged	886466	886515		YPO_RS04980	49
CHC004_libmerged	886592	886696		YPO_RS04980	104
CHC004_libmerged	886727	886745		YPO_RS04980	18
CHC004_libmerged	886978	886981		gspL	3
CHC004_libmerged	887080	887149		gspL	69
CHC004_libmerged	887230	887238		gspL	8
CHC004_libmerged	887823	887839		gspL	16
CHC004_libmerged	888129	888207		YPO_RS04990	78
CHC004_libmerged	888464	888494		YPO_RS04990	30
CHC004_libmerged	888748	888753		YPO_RS04990	5
CHC004_libmerged	889187	889204		gspJ	17
CHC004_libmerged	889312	889369		gspJ	57
CHC004_libmerged	889424	889453		gspJ	29
CHC004_libmerged	889999	890033		YPO_RS05005	34
CHC004_libmerged	890142	890148		YPO_RS05005	6
CHC004_libmerged	890249	890261		YPO_RS05005	12
CHC004_libmerged	890964	890968		gspG	4
CHC004_libmerged	892834	892836		gspE	2
CHC004_libmerged	893707	893835		gspD	128
CHC004_libmerged	894046	894097		gspD	51
CHC004_libmerged	894455	894467		gspD	12
CHC004_libmerged	894845	894863		gspD	18
CHC004_libmerged	894941	894956		gspD	15
CHC004_libmerged	895112	895121		gspD	9
CHC004_libmerged	895448	895492		gspD	44
CHC004_libmerged	895687	895702		YPO_RS05030	15
CHC004_libmerged	895748	895772		YPO_RS05030	24
CHC004_libmerged	895819	895824		YPO_RS05030	5
CHC004_libmerged	895907	895936		YPO_RS05030	29
CHC004_libmerged	896136	896147		YPO_RS05030	11
CHC004_libmerged	896258	896266		YPO_RS05035	8
CHC004_libmerged	896331	896335		YPO_RS05035	4
CHC004_libmerged	896429	896432		YPO_RS05035	3
CHC004_libmerged	897417	897441		YPO_RS05040	24
CHC004_libmerged	898708	898721		YPO_RS05045	13
CHC004_libmerged	903190	903197		YPO_RS05060	7
CHC004_libmerged	908125	908126		tnpA	1
CHC004_libmerged	915417	915418		YPO_RS05105	1
CHC004_libmerged	918251	918265		nagA	14
CHC004_libmerged	924407	924410		YPO_RS05145	3
CHC004_libmerged	927915	927916		YPO_RS05160	1
CHC004_libmerged	929088	929093		YPO_RS05165	5
CHC004_libmerged	930391	930412		YPO_RS05170	21
CHC004_libmerged	934596	934597		YPO_RS05180	1
CHC004_libmerged	935741	935760		YPO_RS05185	19
CHC004_libmerged	938968	938972		YPO_RS05195	4
CHC004_libmerged	939514	939537		YPO_RS05200	23
CHC004_libmerged	940562	940574		YPO_RS05205	12
CHC004_libmerged	944235	944237		YPO_RS05215	2
CHC004_libmerged	947092	947099		YPO_RS05225	7
CHC004_libmerged	950123	950179		YPO_RS05235	56
CHC004_libmerged	953030	953033		YPO_RS05250	3
CHC004_libmerged	953662	953792		YPO_RS05260	130
CHC004_libmerged	954181	954183		YPO_RS05260	2
CHC004_libmerged	958490	958497		YPO_RS05275	7
CHC004_libmerged	963357	963361		YPO_RS05305	4
CHC004_libmerged	963462	963474		YPO_RS05305	12
CHC004_libmerged	963535	963545		YPO_RS05310	10
CHC004_libmerged	973178	973179		lysS	1
CHC004_libmerged	976916	976925		dsbC	9
CHC004_libmerged	976992	977004		dsbC	12
CHC004_libmerged	982512	982515		YPO_RS05415	3
CHC004_libmerged	986740	986745		YPO_RS05440	5
CHC004_libmerged	993981	993991		gcvP	10
CHC004_libmerged	1019199	1019200		YPO_RS05575	1
CHC004_libmerged	1019897	1019899		YPO_RS05585	2
CHC004_libmerged	1035282	1035283		YPO_RS05660	1
CHC004_libmerged	1038766	1038780		YPO_RS05675	14
CHC004_libmerged	1040297	1040340		YPO_RS05675	43
CHC004_libmerged	1040893	1040913		YPO_RS05675	20
CHC004_libmerged	1041305	1041311		YPO_RS05675	6
CHC004_libmerged	1043774	1043801		YPO_RS05675	27
CHC004_libmerged	1043945	1043978		YPO_RS05675	33
CHC004_libmerged	1044261	1044300		YPO_RS05675	39
CHC004_libmerged	1044413	1044419		YPO_RS05675	6
CHC004_libmerged	1044513	1044536		YPO_RS05675	23
CHC004_libmerged	1044639	1044649		YPO_RS05675	10
CHC004_libmerged	1044803	1044805		YPO_RS05675	2
CHC004_libmerged	1044888	1044890		YPO_RS05675	2
CHC004_libmerged	1044986	1045089		YPO_RS05675	103
CHC004_libmerged	1045529	1045570		YPO_RS05675	41
CHC004_libmerged	1045614	1045627		YPO_RS05675	13
CHC004_libmerged	1046478	1046496		YPO_RS05675	18
CHC004_libmerged	1046552	1046575		YPO_RS05675	23
CHC004_libmerged	1046687	1046716		YPO_RS05675	29
CHC004_libmerged	1048207	1048208		glsB	1
CHC004_libmerged	1048340	1048355		glsB	15
CHC004_libmerged	1051486	1051489		mutY	3
CHC004_libmerged	1053164	1053170		mltC	6
CHC004_libmerged	1059636	1059640		YPO_RS05735	4
CHC004_libmerged	1066722	1066727		YPO_RS05765	5
CHC004_libmerged	1066877	1066936		YPO_RS05765	59
CHC004_libmerged	1066983	1067036		YPO_RS05765	53
CHC004_libmerged	1067342	1067389		YPO_RS05765	47
CHC004_libmerged	1067376	1067406		YPO_RS05770	30
CHC004_libmerged	1067528	1067534		YPO_RS05770	6
CHC004_libmerged	1068150	1068186		YPO_RS05770	36
CHC004_libmerged	1071672	1071695		YPO_RS05785	23
CHC004_libmerged	1073123	1073137		YPO_RS05795	14
CHC004_libmerged	1074635	1074638		YPO_RS05800	3
CHC004_libmerged	1085042	1085044		tssC	2
CHC004_libmerged	1088691	1088729		YPO_RS05845	38
CHC004_libmerged	1089063	1089082		YPO_RS05845	19
CHC004_libmerged	1091585	1091587		YPO_RS05855	2
CHC004_libmerged	1094202	1094220		YPO_RS05865	18
CHC004_libmerged	1101136	1101137		iucC	1
CHC004_libmerged	1104586	1104590		YPO_RS05905	4
CHC004_libmerged	1106425	1106426		YPO_RS05910	1
CHC004_libmerged	1111303	1111307		YPO_RS05920	4
CHC004_libmerged	1116083	1116093		YPO_RS05935	10
CHC004_libmerged	1117058	1117104		YPO_RS05940	46
CHC004_libmerged	1117249	1117349		YPO_RS05940	100
CHC004_libmerged	1117761	1117793		YPO_RS05940	32
CHC004_libmerged	1118021	1118032		YPO_RS05940	11
CHC004_libmerged	1120403	1120407		yapH	4
CHC004_libmerged	1121308	1121311		yapH	3
CHC004_libmerged	1124075	1124103		yapH	28
CHC004_libmerged	1124159	1124227		yapH	68
CHC004_libmerged	1124387	1124402		yapH	15
CHC004_libmerged	1124461	1124503		yapH	42
CHC004_libmerged	1124533	1124544		yapH	11
CHC004_libmerged	1124608	1124611		yapH	3
CHC004_libmerged	1124694	1124887		yapH	193
CHC004_libmerged	1124919	1124935		yapH	16
CHC004_libmerged	1124980	1125007		yapH	27
CHC004_libmerged	1125116	1125275		yapH	159
CHC004_libmerged	1125306	1125407		yapH	101
CHC004_libmerged	1125446	1125488		yapH	42
CHC004_libmerged	1125543	1125607		yapH	64
CHC004_libmerged	1125669	1125676		yapH	7
CHC004_libmerged	1125801	1125815		yapH	14
CHC004_libmerged	1129979	1129990		yapH	11
CHC004_libmerged	1134093	1134094		YPO_RS05965	1
CHC004_libmerged	1135061	1135072		YPO_RS05970	11
CHC004_libmerged	1135687	1135693		YPO_RS05970	6
CHC004_libmerged	1140365	1140372		YPO_RS05985	7
CHC004_libmerged	1140539	1140546		YPO_RS05985	7
CHC004_libmerged	1140865	1140871		YPO_RS05985	6
CHC004_libmerged	1142057	1142095		YPO_RS05985	38
CHC004_libmerged	1142273	1142284		YPO_RS05985	11
CHC004_libmerged	1142411	1142437		YPO_RS05985	26
CHC004_libmerged	1148861	1148864		YPO_RS06015	3
CHC004_libmerged	1150299	1150300		recC	1
CHC004_libmerged	1154157	1154181		ptrA	24
CHC004_libmerged	1155588	1155605		ptrA	17
CHC004_libmerged	1160319	1160321		recD	2
CHC004_libmerged	1171634	1171647		rlmM	13
CHC004_libmerged	1182724	1182727		glnD	3
CHC004_libmerged	1194156	1194157		bamA	1
CHC004_libmerged	1197276	1197291		lpxD	15
CHC004_libmerged	1199475	1199478		lpxB	3
CHC004_libmerged	1204783	1204799		accA	16
CHC004_libmerged	1214655	1214697		metI	42
CHC004_libmerged	1215983	1215995		metN	12
CHC004_libmerged	1216145	1216147		metN	2
CHC004_libmerged	1220115	1220121		YPO_RS06340	6
CHC004_libmerged	1221215	1221226		YPO_RS06340	11
CHC004_libmerged	1221601	1221603		YPO_RS06340	2
CHC004_libmerged	1223362	1223364		dkgB	2
CHC004_libmerged	1227691	1227693		gloB	2
CHC004_libmerged	1228483	1228497		YPO_RS06380	14
CHC004_libmerged	1231357	1231358		YPO_RS06400	1
CHC004_libmerged	1237290	1237307		YPO_RS06440	17
CHC004_libmerged	1240924	1241004		YPO_RS06465	80
CHC004_libmerged	1241056	1241135		YPO_RS06465	79
CHC004_libmerged	1241448	1241458		YPO_RS06465	10
CHC004_libmerged	1241694	1241712		YPO_RS06465	18
CHC004_libmerged	1241909	1241932		YPO_RS06465	23
CHC004_libmerged	1242009	1242017		YPO_RS06465	8
CHC004_libmerged	1242253	1242257		YPO_RS06465	4
CHC004_libmerged	1242560	1242598		YPO_RS06470	38
CHC004_libmerged	1243199	1243218		YPO_RS06470	19
CHC004_libmerged	1244668	1244683		YPO_RS06475	15
CHC004_libmerged	1248210	1248234		recN	24
CHC004_libmerged	1249273	1249292		recN	19
CHC004_libmerged	1251890	1251901		YPO_RS06525	11
CHC004_libmerged	1254277	1254287		sdhA	10
CHC004_libmerged	1254529	1254532		sdhA	3
CHC004_libmerged	1257525	1257527		sucA	2
CHC004_libmerged	1260310	1260342		odhB	32
CHC004_libmerged	1261223	1261236		sucC	13
CHC004_libmerged	1266877	1266892		ybgE	15
CHC004_libmerged	1269589	1269640		tolA	51
CHC004_libmerged	1272102	1272110		cpoB	8
CHC004_libmerged	1275751	1275759		zitB	8
CHC004_libmerged	1280092	1280104		YPO_RS06670	12
CHC004_libmerged	1282114	1282121		galM	7
CHC004_libmerged	1285612	1285617		galE	5
CHC004_libmerged	1292909	1292916		modC	7
CHC004_libmerged	1295730	1295731		bioA	1
CHC004_libmerged	1300156	1300162		bioD	6
CHC004_libmerged	1307289	1307293		moaA	4
CHC004_libmerged	1318608	1318615		YPO_RS06855	7
CHC004_libmerged	1322409	1322438		YPO_RS06875	29
CHC004_libmerged	1322728	1322747		YPO_RS06875	19
CHC004_libmerged	1322832	1322842		YPO_RS06875	10
CHC004_libmerged	1322953	1322965		YPO_RS06875	12
CHC004_libmerged	1326090	1326097		dld	7
CHC004_libmerged	1327606	1327616		dld	10
CHC004_libmerged	1330072	1330081		YPO_RS06910	9
CHC004_libmerged	1331074	1331098		phnC	24
CHC004_libmerged	1331718	1331721		phnD	3
CHC004_libmerged	1334483	1334494		phnE	11
CHC004_libmerged	1334740	1334743		YPO_RS06940	3
CHC004_libmerged	1340003	1340009		urtD	6
CHC004_libmerged	1341508	1341512		YPO_RS06970	4
CHC004_libmerged	1347706	1347708		YPO_RS06995	2
CHC004_libmerged	1351013	1351016		adiC	3
CHC004_libmerged	1351553	1351557		YPO_RS07015	4
CHC004_libmerged	1354051	1354066		YPO_RS07020	15
CHC004_libmerged	1354385	1354388		yedA	3
CHC004_libmerged	1373877	1373882		rcsC	5
CHC004_libmerged	1376911	1376932		rcsB	21
CHC004_libmerged	1385420	1385451		ampH	31
CHC004_libmerged	1387327	1387328		YPO_RS07140	1
CHC004_libmerged	1388249	1388251		YPO_RS07145	2
CHC004_libmerged	1392312	1392317		ycoA	5
CHC004_libmerged	1397904	1397919		YPO_RS07190	15
CHC004_libmerged	1399574	1399575		YPO_RS07200	1
CHC004_libmerged	1400584	1400601		YPO_RS07210	17
CHC004_libmerged	1402525	1402542		YPO_RS07225	17
CHC004_libmerged	1407094	1407097		YPO_RS07240	3
CHC004_libmerged	1407466	1407477		YPO_RS07245	11
CHC004_libmerged	1408266	1408279		YPO_RS07250	13
CHC004_libmerged	1410580	1410585		YPO_RS07270	5
CHC004_libmerged	1410673	1410706		YPO_RS07270	33
CHC004_libmerged	1411187	1411214		YPO_RS07270	27
CHC004_libmerged	1412552	1412561		YPO_RS07275	9
CHC004_libmerged	1413165	1413178		YPO_RS07280	13
CHC004_libmerged	1414334	1414348		YPO_RS07285	14
CHC004_libmerged	1416609	1416614		YPO_RS07300	5
CHC004_libmerged	1422133	1422139		YPO_RS07330	6
CHC004_libmerged	1423676	1423698		rsuA	22
CHC004_libmerged	1428494	1428504		YPO_RS07355	10
CHC004_libmerged	1428588	1428594		YPO_RS07355	6
CHC004_libmerged	1433941	1433944		YPO_RS07370	3
CHC004_libmerged	1436178	1436181		YPO_RS07380	3
CHC004_libmerged	1449535	1449540		YPO_RS07435	5
CHC004_libmerged	1459341	1459346		fruA	5
CHC004_libmerged	1461790	1461812		YPO_RS07490	22
CHC004_libmerged	1462085	1462096		YPO_RS07490	11
CHC004_libmerged	1462218	1462231		YPO_RS07490	13
CHC004_libmerged	1463133	1463140		psaA	7
CHC004_libmerged	1463379	1463427		YPO_RS07500	48
CHC004_libmerged	1464284	1464288		psaC	4
CHC004_libmerged	1470900	1470901		YPO_RS07525	1
CHC004_libmerged	1475273	1475296		YPO_RS07540	23
CHC004_libmerged	1477000	1477004		YPO_RS07545	4
CHC004_libmerged	1486681	1486684		YPO_RS07585	3
CHC004_libmerged	1490262	1490273		ybjG	11
CHC004_libmerged	1492315	1492318		YPO_RS07610	3
CHC004_libmerged	1495410	1495414		YPO_RS07625	4
CHC004_libmerged	1513566	1513582		artM	16
CHC004_libmerged	1532581	1532586		macB	5
CHC004_libmerged	1534058	1534071		macB	13
CHC004_libmerged	1534488	1534489		cspD	1
CHC004_libmerged	1536848	1536857		clpA	9
CHC004_libmerged	1541401	1541410		cydC	9
CHC004_libmerged	1544334	1544339		trxB	5
CHC004_libmerged	1545754	1545762		lrp	8
CHC004_libmerged	1547119	1547121		YPO_RS07870	2
CHC004_libmerged	1548444	1548450		YPO_RS07870	6
CHC004_libmerged	1550635	1550640		lolA	5
CHC004_libmerged	1551073	1551087		lolA	14
CHC004_libmerged	1553479	1553482		serS	3
CHC004_libmerged	1554920	1554925		YPO_RS07890	5
CHC004_libmerged	1559291	1559292		pflB	1
CHC004_libmerged	1564292	1564297		ansB	5
CHC004_libmerged	1565873	1565886		YPO_RS07925	13
CHC004_libmerged	1566771	1566775		YPO_RS07930	4
CHC004_libmerged	1567522	1567571		YPO_RS07930	49
CHC004_libmerged	1567750	1567772		YPO_RS07930	22
CHC004_libmerged	1567815	1567851		YPO_RS07930	36
CHC004_libmerged	1570215	1570229		aroA	14
CHC004_libmerged	1575925	1575926		YPO_RS07960	1
CHC004_libmerged	1575982	1575989		YPO_RS07960	7
CHC004_libmerged	1580760	1580770		YPO_RS07975	10
CHC004_libmerged	1580947	1580974		YPO_RS07975	27
CHC004_libmerged	1595710	1595729		ldtD	19
CHC004_libmerged	1596719	1596721		YPO_RS08035	2
CHC004_libmerged	1599248	1599250		ompF	2
CHC004_libmerged	1599854	1599864		ompF	10
CHC004_libmerged	1605134	1605138		pepN	4
CHC004_libmerged	1605615	1605616		pepN	1
CHC004_libmerged	1616245	1616264		pqiB	19
CHC004_libmerged	1632416	1632427		YPO_RS08185	11
CHC004_libmerged	1633015	1633025		helD	10
CHC004_libmerged	1635174	1635185		YPO_RS08195	11
CHC004_libmerged	1635957	1635962		YPO_RS08200	5
CHC004_libmerged	1643721	1643732		YPO_RS08245	11
CHC004_libmerged	1647302	1647312		YPO_RS08255	10
CHC004_libmerged	1647598	1647709		YPO_RS08260	111
CHC004_libmerged	1651864	1651883		YPO_RS08280	19
CHC004_libmerged	1652093	1652100		YPO_RS08280	7
CHC004_libmerged	1652102	1652128		YPO_RS08285	26
CHC004_libmerged	1652512	1652514		YPO_RS08285	2
CHC004_libmerged	1652962	1652966		YPO_RS08290	4
CHC004_libmerged	1653811	1653827		YPO_RS08295	16
CHC004_libmerged	1654371	1654384		YPO_RS08300	13
CHC004_libmerged	1658263	1658265		tssC	2
CHC004_libmerged	1658414	1658418		tssC	4
CHC004_libmerged	1658768	1658773		tssK	5
CHC004_libmerged	1661374	1661377		YPO_RS08330	3
CHC004_libmerged	1663218	1663220		tssH	2
CHC004_libmerged	1666067	1666071		YPO_RS08345	4
CHC004_libmerged	1666147	1666148		YPO_RS08345	1
CHC004_libmerged	1668162	1668163		YPO_RS08350	1
CHC004_libmerged	1668236	1668238		YPO_RS08350	2
CHC004_libmerged	1669977	1669981		YPO_RS08350	4
CHC004_libmerged	1670202	1670218		YPO_RS08350	16
CHC004_libmerged	1670476	1670489		YPO_RS08355	13
CHC004_libmerged	1671075	1671083		YPO_RS08355	8
CHC004_libmerged	1672725	1672726		YPO_RS08365	1
CHC004_libmerged	1673336	1673361		YPO_RS08365	25
CHC004_libmerged	1673813	1673845		YPO_RS08365	32
CHC004_libmerged	1674235	1674242		YPO_RS08370	7
CHC004_libmerged	1674331	1674337		YPO_RS08370	6
CHC004_libmerged	1674414	1674434		YPO_RS08370	20
CHC004_libmerged	1677002	1677011		YPO_RS08380	9
CHC004_libmerged	1677083	1677086		YPO_RS08380	3
CHC004_libmerged	1681292	1681304		YPO_RS08385	12
CHC004_libmerged	1683445	1683459		YPO_RS08395	14
CHC004_libmerged	1684040	1684135		YPO_RS08400	95
CHC004_libmerged	1684297	1684303		YPO_RS08400	6
CHC004_libmerged	1684390	1684495		YPO_RS08400	105
CHC004_libmerged	1687764	1687765		tssJ	1
CHC004_libmerged	1688484	1688487		tssE	3
CHC004_libmerged	1688646	1688657		YPO_RS08425	11
CHC004_libmerged	1690207	1690221		YPO_RS08430	14
CHC004_libmerged	1690427	1690433		YPO_RS08430	6
CHC004_libmerged	1690650	1690656		YPO_RS08430	6
CHC004_libmerged	1693921	1693922		YPO_RS08440	1
CHC004_libmerged	1695889	1695919		moeB	30
CHC004_libmerged	1698453	1698471		darE	18
CHC004_libmerged	1698666	1698672		darE	6
CHC004_libmerged	1699592	1699624		darD	32
CHC004_libmerged	1700033	1700056		darC	23
CHC004_libmerged	1700286	1700423		darC	137
CHC004_libmerged	1700484	1700499		darC	15
CHC004_libmerged	1700753	1700755		darC	2
CHC004_libmerged	1701104	1701141		darC	37
CHC004_libmerged	1701244	1701292		darB	48
CHC004_libmerged	1701332	1701382		darB	50
CHC004_libmerged	1701518	1701566		darB	48
CHC004_libmerged	1701725	1701729		darB	4
CHC004_libmerged	1701766	1701768		darB	2
CHC004_libmerged	1702598	1702628		darB	30
CHC004_libmerged	1702808	1702809		darB	1
CHC004_libmerged	1703374	1703379		darB	5
CHC004_libmerged	1703640	1703648		darA-c	8
CHC004_libmerged	1713232	1713243		mglA	11
CHC004_libmerged	1719205	1719206		cdd	1
CHC004_libmerged	1721887	1721897		YPO_RS08555	10
CHC004_libmerged	1726220	1726249		YPO_RS08570	29
CHC004_libmerged	1726292	1726327		YPO_RS08570	35
CHC004_libmerged	1734466	1734479		asmA	13
CHC004_libmerged	1735068	1735073		asmA	5
CHC004_libmerged	1738574	1738580		fhuF	6
CHC004_libmerged	1739303	1739312		YPO_RS08625	9
CHC004_libmerged	1739372	1739377		YPO_RS08625	5
CHC004_libmerged	1739477	1739494		YPO_RS08625	17
CHC004_libmerged	1739589	1739592		YPO_RS08625	3
CHC004_libmerged	1746345	1746346		YPO_RS08650	1
CHC004_libmerged	1747767	1747782		YPO_RS08660	15
CHC004_libmerged	1751046	1751050		YPO_RS08665	4
CHC004_libmerged	1766079	1766085		YPO_RS08735	6
CHC004_libmerged	1767756	1767769		YPO_RS08745	13
CHC004_libmerged	1767808	1767814		YPO_RS08745	6
CHC004_libmerged	1771594	1771598		YPO_RS08765	4
CHC004_libmerged	1772295	1772300		YPO_RS08770	5
CHC004_libmerged	1775805	1775819		YPO_RS08785	14
CHC004_libmerged	1779346	1779352		YPO_RS08800	6
CHC004_libmerged	1780005	1780022		YPO_RS08800	17
CHC004_libmerged	1780711	1780712		YPO_RS08800	1
CHC004_libmerged	1781407	1781416		YPO_RS08800	9
CHC004_libmerged	1785465	1785469		YPO_RS08815	4
CHC004_libmerged	1789159	1789171		lldD	12
CHC004_libmerged	1794717	1794738		YPO_RS08850	21
CHC004_libmerged	1795931	1795985		YPO_RS08855	54
CHC004_libmerged	1796138	1796146		YPO_RS08855	8
CHC004_libmerged	1796968	1796998		YPO_RS08860	30
CHC004_libmerged	1799928	1799933		YPO_RS08875	5
CHC004_libmerged	1806989	1806999		YPO_RS08905	10
CHC004_libmerged	1808308	1808345		bssS	37
CHC004_libmerged	1809242	1809247		dinI	5
CHC004_libmerged	1810003	1810008		pyrC	5
CHC004_libmerged	1823836	1823837		fabG	1
CHC004_libmerged	1834764	1834769		YPO_RS09045	5
CHC004_libmerged	1835926	1835954		YPO_RS09055	28
CHC004_libmerged	1837728	1837765		nagZ	37
CHC004_libmerged	1838264	1838266		nagZ	2
CHC004_libmerged	1842125	1842127		YPO_RS09090	2
CHC004_libmerged	1848694	1848728		mfd	34
CHC004_libmerged	1851847	1851871		lolD	24
CHC004_libmerged	1852977	1852984		lolE	7
CHC004_libmerged	1853397	1853417		lolE	20
CHC004_libmerged	1855310	1855313		cobB	3
CHC004_libmerged	1862006	1862009		purB	3
CHC004_libmerged	1864072	1864098		mnmA	26
CHC004_libmerged	1864133	1864139		mnmA	6
CHC004_libmerged	1866012	1866026		rluE	14
CHC004_libmerged	1868283	1868291		YPO_RS09200	8
CHC004_libmerged	1878295	1878350		YPO_RS09250	55
CHC004_libmerged	1896486	1896489		cheA	3
CHC004_libmerged	1897058	1897059		cheA	1
CHC004_libmerged	1904870	1904877		yapJ	7
CHC004_libmerged	1910109	1910110		YPO_RS09350	1
CHC004_libmerged	1915009	1915014		cheR	5
CHC004_libmerged	1918796	1918799		YPO_RS09385	3
CHC004_libmerged	1919639	1919668		YPO_RS09390	29
CHC004_libmerged	1924156	1924157		YPO_RS09405	1
CHC004_libmerged	1926238	1926262		YPO_RS09415	24
CHC004_libmerged	1927122	1927129		YPO_RS09420	7
CHC004_libmerged	1932645	1932653		YPO_RS09450	8
CHC004_libmerged	1932715	1932728		YPO_RS09450	13
CHC004_libmerged	1933448	1933465		YPO_RS09455	17
CHC004_libmerged	1933830	1933859		YPO_RS09455	29
CHC004_libmerged	1935550	1935558		YPO_RS09455	8
CHC004_libmerged	1936614	1936644		YPO_RS09460	30
CHC004_libmerged	1937935	1937949		YPO_RS09475	14
CHC004_libmerged	1938353	1938374		YPO_RS09475	21
CHC004_libmerged	1942629	1942630		yebS	1
CHC004_libmerged	1943663	1943673		proQ	10
CHC004_libmerged	1947091	1947092		htpX	1
CHC004_libmerged	1949332	1949335		YPO_RS09515	3
CHC004_libmerged	1949710	1949713		YPO_RS09515	3
CHC004_libmerged	1950912	1950914		YPO_RS09520	2
CHC004_libmerged	1951975	1951985		YPO_RS09520	10
CHC004_libmerged	1952778	1952784		YPO_RS09525	6
CHC004_libmerged	1963153	1963167		YPO_RS09565	14
CHC004_libmerged	1963465	1963474		YPO_RS09570	9
CHC004_libmerged	1964077	1964080		YPO_RS09570	3
CHC004_libmerged	1969048	1969049		YPO_RS09590	1
CHC004_libmerged	1969880	1969884		kduD	4
CHC004_libmerged	1970988	1970989		kduI	1
CHC004_libmerged	1978593	1978606		YPO_RS09645	13
CHC004_libmerged	1979663	1979677		YPO_RS09650	14
CHC004_libmerged	1985809	1985811		YPO_RS09695	2
CHC004_libmerged	1986198	1986210		YPO_RS09700	12
CHC004_libmerged	1986461	1986464		YPO_RS09700	3
CHC004_libmerged	1997237	1997241		YPO_RS09750	4
CHC004_libmerged	1999862	1999880		mntP	18
CHC004_libmerged	2000361	2000373		YPO_RS09760	12
CHC004_libmerged	2000467	2000486		YPO_RS09760	19
CHC004_libmerged	2002782	2002795		manX	13
CHC004_libmerged	2005246	2005254		YPO_RS09780	8
CHC004_libmerged	2012191	2012204		hpaI	13
CHC004_libmerged	2018935	2018937		YPO_RS09845	2
CHC004_libmerged	2023957	2023959		dbpA	2
CHC004_libmerged	2027354	2027359		YPO_RS09885	5
CHC004_libmerged	2033183	2033245		YPO_RS09920	62
CHC004_libmerged	2037394	2037427		flhA	33
CHC004_libmerged	2049796	2049803		YPO_RS10010	7
CHC004_libmerged	2055994	2055998		YPO_RS10030	4
CHC004_libmerged	2059789	2059793		YPO_RS10040	4
CHC004_libmerged	2059944	2059977		YPO_RS10045	33
CHC004_libmerged	2060342	2060344		YPO_RS10045	2
CHC004_libmerged	2061156	2061169		YPO_RS10050	13
CHC004_libmerged	2061826	2061835		YPO_RS10050	9
CHC004_libmerged	2067960	2067963		fliO	3
CHC004_libmerged	2070363	2070395		YPO_RS10110	32
CHC004_libmerged	2070457	2070487		YPO_RS10110	30
CHC004_libmerged	2077434	2077450		fliE	16
CHC004_libmerged	2080242	2080261		YPO_RS10165	19
CHC004_libmerged	2080823	2080832		YPO_RS10170	9
CHC004_libmerged	2081687	2081693		YPO_RS10170	6
CHC004_libmerged	2085117	2085119		fliD	2
CHC004_libmerged	2085733	2085739		fliD	6
CHC004_libmerged	2088320	2088328		YPO_RS10200	8
CHC004_libmerged	2090319	2090327		YPO_RS10210	8
CHC004_libmerged	2091416	2091429		tcyJ	13
CHC004_libmerged	2096525	2096531		putA	6
CHC004_libmerged	2104690	2104692		wrbA	2
CHC004_libmerged	2107432	2107442		cycA	10
CHC004_libmerged	2109269	2109278		YPO_RS10290	9
CHC004_libmerged	2110340	2110345		YPO_RS10295	5
CHC004_libmerged	2110778	2110783		YPO_RS10300	5
CHC004_libmerged	2112092	2112095		uvrY	3
CHC004_libmerged	2112368	2112373		uvrY	5
CHC004_libmerged	2112496	2112498		uvrC	2
CHC004_libmerged	2117239	2117250		YPO_RS10350	11
CHC004_libmerged	2117604	2117622		YPO_RS10355	18
CHC004_libmerged	2117682	2117689		YPO_RS10355	7
CHC004_libmerged	2117725	2117786		YPO_RS10355	61
CHC004_libmerged	2118040	2118126		hcp	86
CHC004_libmerged	2118332	2118347		hcp	15
CHC004_libmerged	2122634	2122654		YPO_RS10395	20
CHC004_libmerged	2123278	2123285		YPO_RS10405	7
CHC004_libmerged	2123436	2123458		YPO_RS10405	22
CHC004_libmerged	2124125	2124128		YPO_RS10405	3
CHC004_libmerged	2126520	2126552		YPO_RS10415	32
CHC004_libmerged	2126564	2126568		YPO_RS10420	4
CHC004_libmerged	2126652	2126698		YPO_RS10420	46
CHC004_libmerged	2126731	2126803		YPO_RS10420	72
CHC004_libmerged	2126902	2126906		YPO_RS10420	4
CHC004_libmerged	2128631	2128633		YPO_RS10430	2
CHC004_libmerged	2143224	2143228		ybtE	4
CHC004_libmerged	2145623	2145624		ybtU	1
CHC004_libmerged	2146040	2146046		ybtU	6
CHC004_libmerged	2146997	2147001		irp1	4
CHC004_libmerged	2147169	2147174		irp1	5
CHC004_libmerged	2150839	2150885		irp1	46
CHC004_libmerged	2152263	2152269		irp1	6
CHC004_libmerged	2152637	2152651		irp1	14
CHC004_libmerged	2153210	2153220		irp1	10
CHC004_libmerged	2153701	2153722		irp1	21
CHC004_libmerged	2154283	2154296		irp1	13
CHC004_libmerged	2154334	2154338		irp1	4
CHC004_libmerged	2157459	2157460		irp2	1
CHC004_libmerged	2160016	2160021		irp2	5
CHC004_libmerged	2161416	2161420		irp2	4
CHC004_libmerged	2164132	2164135		ybtP	3
CHC004_libmerged	2164465	2164495		ybtP	30
CHC004_libmerged	2164602	2164612		ybtP	10
CHC004_libmerged	2165509	2165518		ybtQ	9
CHC004_libmerged	2166013	2166015		ybtQ	2
CHC004_libmerged	2166601	2166603		ybtQ	2
CHC004_libmerged	2167180	2167219		ybtX	39
CHC004_libmerged	2167363	2167389		ybtX	26
CHC004_libmerged	2169663	2169665		ybtS	2
CHC004_libmerged	2170865	2170873		YPO_RS10570	8
CHC004_libmerged	2171009	2171011		YPO_RS10570	2
CHC004_libmerged	2173374	2173383		YPO_RS10585	9
CHC004_libmerged	2174602	2174604		YPO_RS10590	2
CHC004_libmerged	2176435	2176436		YPO_RS10595	1
CHC004_libmerged	2176614	2176616		YPO_RS10595	2
CHC004_libmerged	2176672	2176675		YPO_RS10595	3
CHC004_libmerged	2177318	2177321		YPO_RS10600	3
CHC004_libmerged	2178531	2178533		YPO_RS10605	2
CHC004_libmerged	2179002	2179003		YPO_RS10605	1
CHC004_libmerged	2183625	2183628		YPO_RS10620	3
CHC004_libmerged	2183750	2183752		YPO_RS10620	2
CHC004_libmerged	2187157	2187177		YPO_RS10635	20
CHC004_libmerged	2187795	2187812		YPO_RS10645	17
CHC004_libmerged	2190626	2190628		YPO_RS10655	2
CHC004_libmerged	2192541	2192542		nqrE	1
CHC004_libmerged	2219367	2219369		pgaD	2
CHC004_libmerged	2222931	2222939		chaA	8
CHC004_libmerged	2223209	2223216		chaA	7
CHC004_libmerged	2237356	2237376		YPO_RS10835	20
CHC004_libmerged	2248321	2248330		YPO_RS10885	9
CHC004_libmerged	2250007	2250021		YPO_RS10895	14
CHC004_libmerged	2250899	2250901		YPO_RS10900	2
CHC004_libmerged	2256111	2256144		YPO_RS10925	33
CHC004_libmerged	2256540	2256552		YPO_RS10925	12
CHC004_libmerged	2256606	2256613		YPO_RS10925	7
CHC004_libmerged	2258636	2258673		YPO_RS10935	37
CHC004_libmerged	2259191	2259197		YPO_RS10935	6
CHC004_libmerged	2259753	2259756		YPO_RS10935	3
CHC004_libmerged	2260320	2260327		YPO_RS10935	7
CHC004_libmerged	2260721	2260736		YPO_RS10935	15
CHC004_libmerged	2260779	2260784		YPO_RS10935	5
CHC004_libmerged	2266242	2266246		YPO_RS10960	4
CHC004_libmerged	2266292	2266299		YPO_RS10965	7
CHC004_libmerged	2267506	2267517		YPO_RS10970	11
CHC004_libmerged	2268682	2268686		YPO_RS10975	4
CHC004_libmerged	2268870	2268877		YPO_RS10975	7
CHC004_libmerged	2269863	2269875		YPO_RS10980	12
CHC004_libmerged	2270736	2270745		YPO_RS10980	9
CHC004_libmerged	2272034	2272042		YPO_RS10990	8
CHC004_libmerged	2275250	2275255		YPO_RS11005	5
CHC004_libmerged	2276768	2276769		YPO_RS11015	1
CHC004_libmerged	2277263	2277274		YPO_RS11015	11
CHC004_libmerged	2277376	2277383		YPO_RS11015	7
CHC004_libmerged	2282339	2282342		ychF	3
CHC004_libmerged	2286197	2286207		ispE	10
CHC004_libmerged	2286460	2286463		ispE	3
CHC004_libmerged	2291025	2291033		prmC	8
CHC004_libmerged	2291550	2291562		YPO_RS11090	12
CHC004_libmerged	2294432	2294443		YPO_RS11110	11
CHC004_libmerged	2299981	2300030		YPO_RS11135	49
CHC004_libmerged	2300536	2300540		YPO_RS11140	4
CHC004_libmerged	2303895	2303905		YPO_RS11155	10
CHC004_libmerged	2306899	2306906		YPO_RS11175	7
CHC004_libmerged	2313238	2313248		YPO_RS11210	10
CHC004_libmerged	2316441	2316506		YPO_RS11220	65
CHC004_libmerged	2317116	2317130		YPO_RS11220	14
CHC004_libmerged	2318081	2318102		YPO_RS11220	21
CHC004_libmerged	2318132	2318133		YPO_RS11225	1
CHC004_libmerged	2318976	2318988		YPO_RS11225	12
CHC004_libmerged	2319468	2319564		YPO_RS11225	96
CHC004_libmerged	2320648	2320654		YPO_RS11225	6
CHC004_libmerged	2321175	2321184		YPO_RS11225	9
CHC004_libmerged	2321848	2321851		YPO_RS11225	3
CHC004_libmerged	2322435	2322437		YPO_RS11225	2
CHC004_libmerged	2334038	2334045		YPO_RS11275	7
CHC004_libmerged	2338432	2338449		znuC	17
CHC004_libmerged	2353768	2353771		YPO_RS11365	3
CHC004_libmerged	2355316	2355319		fadD	3
CHC004_libmerged	2360711	2360716		YPO_RS11405	5
CHC004_libmerged	2360768	2360773		YPO_RS11405	5
CHC004_libmerged	2374915	2374921		YPO_RS11505	6
CHC004_libmerged	2375441	2375445		YPO_RS11510	4
CHC004_libmerged	2376967	2376968		YPO_RS11520	1
CHC004_libmerged	2381189	2381192		YPO_RS11540	3
CHC004_libmerged	2385539	2385543		YPO_RS11575	4
CHC004_libmerged	2386124	2386128		YPO_RS11585	4
CHC004_libmerged	2395768	2395771		YPO_RS11635	3
CHC004_libmerged	2399583	2399584		YPO_RS11660	1
CHC004_libmerged	2400715	2400741		YPO_RS11665	26
CHC004_libmerged	2405310	2405329		YPO_RS11685	19
CHC004_libmerged	2410037	2410038		dsbB	1
CHC004_libmerged	2410714	2410719		nhaB	5
CHC004_libmerged	2414397	2414398		YPO_RS11720	1
CHC004_libmerged	2418259	2418260		YPO_RS11735	1
CHC004_libmerged	2420359	2420374		YPO_RS11745	15
CHC004_libmerged	2423136	2423137		yeaG	1
CHC004_libmerged	2426209	2426212		YPO_RS11765	3
CHC004_libmerged	2428009	2428016		gapA	7
CHC004_libmerged	2430218	2430220		ansA	2
CHC004_libmerged	2432256	2432259		sppA	3
CHC004_libmerged	2436943	2436946		YPO_RS11810	3
CHC004_libmerged	2437384	2437385		YPO_RS11820	1
CHC004_libmerged	2439685	2439703		YPO_RS11830	18
CHC004_libmerged	2439748	2439787		YPO_RS11830	39
CHC004_libmerged	2439904	2439937		YPO_RS11830	33
CHC004_libmerged	2440149	2440184		YPO_RS11830	35
CHC004_libmerged	2440231	2440259		YPO_RS11830	28
CHC004_libmerged	2442374	2442377		purU	3
CHC004_libmerged	2445264	2445295		rssB	31
CHC004_libmerged	2446846	2446857		YPO_RS11870	11
CHC004_libmerged	2448270	2448285		hns	15
CHC004_libmerged	2454435	2454465		adhE	30
CHC004_libmerged	2458601	2458618		oppA	17
CHC004_libmerged	2459172	2459185		oppA	13
CHC004_libmerged	2463709	2463717		YPO_RS11930	8
CHC004_libmerged	2465302	2465305		cls	3
CHC004_libmerged	2467567	2467572		YPO_RS11950	5
CHC004_libmerged	2475842	2475869		YPO_RS12005	27
CHC004_libmerged	2477989	2477991		trpA	2
CHC004_libmerged	2489395	2489433		sohB	38
CHC004_libmerged	2489756	2489759		sohB	3
CHC004_libmerged	2490366	2490372		YPO_RS12085	6
CHC004_libmerged	2490996	2490997		YPO_RS12090	1
CHC004_libmerged	2491203	2491232		topA	29
CHC004_libmerged	2495432	2495443		YPO_RS12105	11
CHC004_libmerged	2495710	2495711		YPO_RS12105	1
CHC004_libmerged	2495862	2495905		YPO_RS12105	43
CHC004_libmerged	2496069	2496101		YPO_RS12105	32
CHC004_libmerged	2496635	2496640		acnA	5
CHC004_libmerged	2503054	2503066		YPO_RS12135	12
CHC004_libmerged	2503192	2503194		YPO_RS12135	2
CHC004_libmerged	2503312	2503317		YPO_RS12135	5
CHC004_libmerged	2504672	2504689		yciH	17
CHC004_libmerged	2508532	2508562		YPO_RS12175	30
CHC004_libmerged	2514555	2514561		YPO_RS12190	6
CHC004_libmerged	2517094	2517095		rsxG	1
CHC004_libmerged	2517140	2517142		rsxG	2
CHC004_libmerged	2519275	2519296		YPO_RS12215	21
CHC004_libmerged	2536900	2536911		YPO_RS12280	11
CHC004_libmerged	2540351	2540384		YPO_RS12295	33
CHC004_libmerged	2541346	2541348		YPO_RS12300	2
CHC004_libmerged	2541581	2541592		YPO_RS12300	11
CHC004_libmerged	2541916	2541933		YPO_RS12300	17
CHC004_libmerged	2547168	2547169		YPO_RS12320	1
CHC004_libmerged	2548340	2548358		YPO_RS12325	18
CHC004_libmerged	2549509	2549510		YPO_RS12330	1
CHC004_libmerged	2550529	2550543		YPO_RS12340	14
CHC004_libmerged	2551198	2551206		YPO_RS12340	8
CHC004_libmerged	2551663	2551670		YPO_RS12340	7
CHC004_libmerged	2554373	2554633		YPO_RS12355	260
CHC004_libmerged	2554658	2555065		YPO_RS12360	407
CHC004_libmerged	2555162	2555608		YPO_RS12365	446
CHC004_libmerged	2555780	2556832		YPO_RS12370	1052
CHC004_libmerged	2556844	2557161		YPO_RS12375	317
CHC004_libmerged	2557164	2557415		YPO_RS12380	251
CHC004_libmerged	2557451	2557684		YPO_RS12385	233
CHC004_libmerged	2557749	2559461		YPO_RS12390	1712
CHC004_libmerged	2559474	2559761		YPO_RS12395	287
CHC004_libmerged	2559765	2560790		YPO_RS12400	1025
CHC004_libmerged	2560790	2562034		YPO_RS12405	1244
CHC004_libmerged	2562123	2562371		YPO_RS12410	248
CHC004_libmerged	2562568	2562765		YPO_RS12415	197
CHC004_libmerged	2565808	2565845		YPO_RS12435	37
CHC004_libmerged	2566838	2566839		YPO_RS12435	1
CHC004_libmerged	2566843	2566854		YPO_RS12440	11
CHC004_libmerged	2569234	2569239		YPO_RS12445	5
CHC004_libmerged	2571556	2571564		YPO_RS12455	8
CHC004_libmerged	2575663	2575678		YPO_RS12460	15
CHC004_libmerged	2577450	2577461		YPO_RS12465	11
CHC004_libmerged	2577791	2577809		YPO_RS12465	18
CHC004_libmerged	2582815	2582829		YPO_RS12495	14
CHC004_libmerged	2588149	2588152		uspE	3
CHC004_libmerged	2593885	2593895		YPO_RS12535	10
CHC004_libmerged	2595727	2595733		rstA	6
CHC004_libmerged	2604455	2604458		YPO_RS12575	3
CHC004_libmerged	2606398	2606415		asr	17
CHC004_libmerged	2606835	2606861		YPO_RS12590	26
CHC004_libmerged	2607427	2607432		YPO_RS12590	5
CHC004_libmerged	2609304	2609307		hrpA	3
CHC004_libmerged	2613469	2613479		azoR	10
CHC004_libmerged	2619657	2619664		YPO_RS12635	7
CHC004_libmerged	2624600	2624607		nifJ	7
CHC004_libmerged	2630108	2630139		YPO_RS12680	31
CHC004_libmerged	2630521	2630540		YPO_RS12680	19
CHC004_libmerged	2630628	2630654		YPO_RS12680	26
CHC004_libmerged	2642071	2642072		YPO_RS12735	1
CHC004_libmerged	2643322	2643329		pspD	7
CHC004_libmerged	2645942	2645970		pspF	28
CHC004_libmerged	2649217	2649220		sapB	3
CHC004_libmerged	2651305	2651327		sapD	22
CHC004_libmerged	2665071	2665076		anmK	5
CHC004_libmerged	2668162	2668163		YPO_RS12865	1
CHC004_libmerged	2669133	2669134		YPO_RS12870	1
CHC004_libmerged	2669558	2669567		eptA	9
CHC004_libmerged	2670541	2670544		eptA	3
CHC004_libmerged	2670912	2670915		eptA	3
CHC004_libmerged	2671720	2671722		YPO_RS12880	2
CHC004_libmerged	2674931	2674935		YPO_RS12890	4
CHC004_libmerged	2675776	2675786		YPO_RS12890	10
CHC004_libmerged	2677030	2677033		rnt	3
CHC004_libmerged	2679055	2679059		YPO_RS12915	4
CHC004_libmerged	2679428	2679432		YPO_RS12915	4
CHC004_libmerged	2681291	2681314		purR	23
CHC004_libmerged	2685789	2685793		cfa	4
CHC004_libmerged	2687116	2687147		YPO_RS12955	31
CHC004_libmerged	2698788	2698798		sufD	10
CHC004_libmerged	2701438	2701441		sufA	3
CHC004_libmerged	2707964	2707986		rprA	22
CHC004_libmerged	2708026	2708028		rprA	2
CHC004_libmerged	2715458	2715488		YPO_RS13075	30
CHC004_libmerged	2715947	2715956		YPO_RS13080	9
CHC004_libmerged	2716606	2716645		arnF	39
CHC004_libmerged	2716950	2716951		arnF	1
CHC004_libmerged	2721724	2721725		arnA	1
CHC004_libmerged	2724882	2724894		btuD	12
CHC004_libmerged	2725879	2725886		btuC	7
CHC004_libmerged	2727430	2727442		YPO_RS13140	12
CHC004_libmerged	2730221	2730231		pheT	10
CHC004_libmerged	2732178	2732184		rplT	6
CHC004_libmerged	2739895	2739898		yfeB	3
CHC004_libmerged	2742956	2742957		YPO_RS13230	1
CHC004_libmerged	2748810	2748815		YPO_RS13255	5
CHC004_libmerged	2749124	2749126		YPO_RS13255	2
CHC004_libmerged	2749823	2749838		YPO_RS13265	15
CHC004_libmerged	2749928	2749944		YPO_RS13265	16
CHC004_libmerged	2754131	2754171		YPO_RS13285	40
CHC004_libmerged	2755006	2755033		YPO_RS13290	27
CHC004_libmerged	2755433	2755489		YPO_RS13290	56
CHC004_libmerged	2760108	2760109		YPO_RS13315	1
CHC004_libmerged	2760244	2760254		YPO_RS13315	10
CHC004_libmerged	2772892	2772898		YPO_RS13355	6
CHC004_libmerged	2773233	2773241		YPO_RS13355	8
CHC004_libmerged	2773429	2773450		YPO_RS13360	21
CHC004_libmerged	2774622	2774624		YPO_RS13365	2
CHC004_libmerged	2778337	2778340		YPO_RS13380	3
CHC004_libmerged	2784305	2784320		YPO_RS13405	15
CHC004_libmerged	2785301	2785310		YPO_RS13415	9
CHC004_libmerged	2786430	2786433		YPO_RS13430	3
CHC004_libmerged	2786690	2786707		YPO_RS13430	17
CHC004_libmerged	2786825	2786826		YPO_RS13430	1
CHC004_libmerged	2788777	2788801		YPO_RS13435	24
CHC004_libmerged	2789821	2789832		YPO_RS13445	11
CHC004_libmerged	2790077	2790099		YPO_RS13445	22
CHC004_libmerged	2794006	2794018		cdiA	12
CHC004_libmerged	2795589	2795599		cdiA	10
CHC004_libmerged	2800576	2800593		YPO_RS13460	17
CHC004_libmerged	2802552	2802559		YPO_RS13470	7
CHC004_libmerged	2806750	2806768		YPO_RS13480	18
CHC004_libmerged	2807958	2807976		YPO_RS13485	18
CHC004_libmerged	2808395	2808401		YPO_RS13490	6
CHC004_libmerged	2808807	2808818		YPO_RS13490	11
CHC004_libmerged	2813712	2813732		YPO_RS13510	20
CHC004_libmerged	2813936	2813953		YPO_RS13510	17
CHC004_libmerged	2813993	2814017		YPO_RS13510	24
CHC004_libmerged	2814180	2814216		YPO_RS13510	36
CHC004_libmerged	2814610	2814614		YPO_RS13515	4
CHC004_libmerged	2814990	2815021		YPO_RS13515	31
CHC004_libmerged	2820818	2820821		YPO_RS13550	3
CHC004_libmerged	2821139	2821172		YPO_RS13550	33
CHC004_libmerged	2831184	2831208		ybiB	24
CHC004_libmerged	2833367	2833370		menC	3
CHC004_libmerged	2836052	2836061		menD	9
CHC004_libmerged	2839931	2839944		YPO_RS13635	13
CHC004_libmerged	2840252	2840253		YPO_RS13635	1
CHC004_libmerged	2843735	2843747		YPO_RS13645	12
CHC004_libmerged	2845094	2845102		YPO_RS13655	8
CHC004_libmerged	2848534	2848537		YPO_RS13665	3
CHC004_libmerged	2853921	2853971		YPO_RS13690	50
CHC004_libmerged	2854181	2854268		YPO_RS13690	87
CHC004_libmerged	2854688	2854694		YPO_RS13690	6
CHC004_libmerged	2855660	2855663		nuoN	3
CHC004_libmerged	2856630	2856646		nuoM	16
CHC004_libmerged	2861905	2861909		nuoH	4
CHC004_libmerged	2867650	2867660		nuoC	10
CHC004_libmerged	2873160	2873162		YPO_RS13765	2
CHC004_libmerged	2879085	2879102		YPO_RS13790	17
CHC004_libmerged	2885772	2885776		YPO_RS13815	4
CHC004_libmerged	2887089	2887932		YPO_RS13825	843
CHC004_libmerged	2887989	2893967		YPO_RS13830	5978
CHC004_libmerged	2894374	2894922		YPO_RS13835	548
CHC004_libmerged	2895617	2896471		YPO_RS13840	854
CHC004_libmerged	2896777	2897241		YPO_RS13845	464
CHC004_libmerged	2897282	2898099		YPO_RS13845	817
CHC004_libmerged	2898137	2898303		YPO_RS13845	166
CHC004_libmerged	2898338	2900263		iolD	1925
CHC004_libmerged	2907554	2907561		iolC	7
CHC004_libmerged	2908147	2908172		iolC	25
CHC004_libmerged	2908875	2908876		iolE	1
CHC004_libmerged	2909024	2909026		iolE	2
CHC004_libmerged	2909752	2909759		iolB	7
CHC004_libmerged	2910036	2910037		iolB	1
CHC004_libmerged	2910281	2910290		iolB	9
CHC004_libmerged	2910493	2910515		YPO_RS13895	22
CHC004_libmerged	2912805	2912828		YPO_RS13905	23
CHC004_libmerged	2914458	2914461		YPO_RS13920	3
CHC004_libmerged	2914699	2914703		YPO_RS13920	4
CHC004_libmerged	2915423	2915476		YPO_RS13925	53
CHC004_libmerged	2923884	2923887		rlpA	3
CHC004_libmerged	2924446	2924453		mrdB	7
CHC004_libmerged	2926661	2926675		mrdA	14
CHC004_libmerged	2930815	2930824		lptE	9
CHC004_libmerged	2935261	2935262		gltK	1
CHC004_libmerged	2976227	2976235		nrdF	8
CHC004_libmerged	2977192	2977196		nrdE	4
CHC004_libmerged	2980342	2980346		YPO_RS14235	4
CHC004_libmerged	2980429	2980554		YPO_RS14235	125
CHC004_libmerged	2981312	2981344		YPO_RS14240	32
CHC004_libmerged	2984317	2984323		cspA	6
CHC004_libmerged	2987756	2987761		YPO_RS14270	5
CHC004_libmerged	2999248	2999275		YPO_RS14330	27
CHC004_libmerged	3000191	3000194		hdeB	3
CHC004_libmerged	3010749	3010769		pgm	20
CHC004_libmerged	3012182	3012220		YPO_RS14405	38
CHC004_libmerged	3013570	3013582		kdbD	12
CHC004_libmerged	3014527	3014532		kdbD	5
CHC004_libmerged	3014594	3014596		kdbD	2
CHC004_libmerged	3021124	3021136		YPO_RS14440	12
CHC004_libmerged	3022285	3022307		YPO_RS14450	22
CHC004_libmerged	3031931	3031940		ung	9
CHC004_libmerged	3035082	3035090		srmB	8
CHC004_libmerged	3037247	3037264		YPO_RS14530	17
CHC004_libmerged	3038764	3038776		nadB	12
CHC004_libmerged	3042221	3042235		YPO_RS14560	14
CHC004_libmerged	3042591	3042617		YPO_RS14560	26
CHC004_libmerged	3045709	3045711		lepB	2
CHC004_libmerged	3054838	3054839		tssM	1
CHC004_libmerged	3056191	3056207		YPO_RS14610	16
CHC004_libmerged	3059801	3059805		YPO_RS14625	4
CHC004_libmerged	3060838	3060841		YPO_RS14630	3
CHC004_libmerged	3063298	3063304		YPO_RS14645	6
CHC004_libmerged	3063818	3063833		YPO_RS14645	15
CHC004_libmerged	3065981	3065992		YPO_RS14660	11
CHC004_libmerged	3077257	3077265		fadI	8
CHC004_libmerged	3085781	3085798		YPO_RS14760	17
CHC004_libmerged	3088206	3088219		mnmC	13
CHC004_libmerged	3114646	3114650		yfcE	4
CHC004_libmerged	3120316	3120561		YPO_RS14920	245
CHC004_libmerged	3121234	3121815		YPO_RS14925	581
CHC004_libmerged	3122083	3122484		YPO_RS14930	401
CHC004_libmerged	3122717	3123118		YPO_RS14935	401
CHC004_libmerged	3123130	3123702		YPO_RS14940	572
CHC004_libmerged	3123726	3123977		YPO_RS14945	251
CHC004_libmerged	3124016	3124255		YPO_RS14950	239
CHC004_libmerged	3125064	3126980		yapC	1916
CHC004_libmerged	3127159	3127226		YPO_RS14960	67
CHC004_libmerged	3127515	3128096		YPO_RS14965	581
CHC004_libmerged	3130158	3132313		YPO_RS14980	2155
CHC004_libmerged	3132386	3132888		YPO_RS14985	502
CHC004_libmerged	3133047	3133598		YPO_RS14990	551
CHC004_libmerged	3133631	3135428		YPO_RS14990	1797
CHC004_libmerged	3135507	3137135		YPO_RS14995	1628
CHC004_libmerged	3137608	3138459		YPO_RS15000	851
CHC004_libmerged	3138485	3138988		YPO_RS15005	503
CHC004_libmerged	3139028	3139474		YPO_RS15005	446
CHC004_libmerged	3139529	3139914		YPO_RS15010	385
CHC004_libmerged	3139945	3140422		YPO_RS15010	477
CHC004_libmerged	3142684	3142989		YPO_RS15025	305
CHC004_libmerged	3143086	3143487		YPO_RS15030	401
CHC004_libmerged	3143469	3144184		YPO_RS15035	715
CHC004_libmerged	3145839	3145854		YPO_RS15040	15
CHC004_libmerged	3147594	3147599		YPO_RS15050	5
CHC004_libmerged	3151676	3151692		YPO_RS15090	16
CHC004_libmerged	3156325	3156334		purN	9
CHC004_libmerged	3160369	3160371		pstA	2
CHC004_libmerged	3165610	3165631		ppk1	21
CHC004_libmerged	3170913	3170915		yegD	2
CHC004_libmerged	3180235	3180259		YPO_RS15205	24
CHC004_libmerged	3183935	3183939		mdtC	4
CHC004_libmerged	3185613	3185619		mdtC	6
CHC004_libmerged	3192273	3192279		YPO_RS15240	6
CHC004_libmerged	3193322	3193323		yegS	1
CHC004_libmerged	3196141	3196163		thiD	22
CHC004_libmerged	3198225	3198237		YPO_RS15270	12
CHC004_libmerged	3200188	3200195		YPO_RS15280	7
CHC004_libmerged	3200192	3200274		YPO_RS15285	82
CHC004_libmerged	3200386	3200444		YPO_RS15285	58
CHC004_libmerged	3200562	3200587		YPO_RS15285	25
CHC004_libmerged	3200735	3200897		YPO_RS15290	162
CHC004_libmerged	3200937	3200949		YPO_RS15290	12
CHC004_libmerged	3201044	3201046		YPO_RS15290	2
CHC004_libmerged	3201158	3201185		YPO_RS15295	27
CHC004_libmerged	3201294	3201365		YPO_RS15295	71
CHC004_libmerged	3201567	3201679		YPO_RS15300	112
CHC004_libmerged	3201729	3201783		YPO_RS15300	54
CHC004_libmerged	3201868	3201885		YPO_RS15300	17
CHC004_libmerged	3202204	3202259		YPO_RS15305	55
CHC004_libmerged	3209366	3209370		YPO_RS15335	4
CHC004_libmerged	3216565	3216588		rodZ	23
CHC004_libmerged	3221666	3221696		YPO_RS15385	30
CHC004_libmerged	3221762	3221855		YPO_RS15385	93
CHC004_libmerged	3221959	3221983		YPO_RS15385	24
CHC004_libmerged	3222340	3222353		YPO_RS15385	13
CHC004_libmerged	3222645	3222651		YPO_RS15385	6
CHC004_libmerged	3224530	3224544		yapA	14
CHC004_libmerged	3225489	3225528		yapA	39
CHC004_libmerged	3225575	3225622		yapA	47
CHC004_libmerged	3228542	3228558		YPO_RS15395	16
CHC004_libmerged	3229849	3229858		YPO_RS15395	9
CHC004_libmerged	3230066	3230076		YPO_RS15395	10
CHC004_libmerged	3231153	3231157		YPO_RS15395	4
CHC004_libmerged	3231857	3231862		YPO_RS15405	5
CHC004_libmerged	3234319	3234324		pepB	5
CHC004_libmerged	3241023	3241037		trmJ	14
CHC004_libmerged	3241562	3241580		trmJ	18
CHC004_libmerged	3243793	3243807		YPO_RS15475	14
CHC004_libmerged	3246441	3246444		csiE	3
CHC004_libmerged	3247617	3247647		YPO_RS15490	30
CHC004_libmerged	3260368	3260382		YPO_RS15550	14
CHC004_libmerged	3262449	3262453		YPO_RS15560	4
CHC004_libmerged	3262676	3262750		YPO_RS15560	74
CHC004_libmerged	3262884	3262898		YPO_RS15560	14
CHC004_libmerged	3267681	3267687		mltF	6
CHC004_libmerged	3278254	3278261		tssK	7
CHC004_libmerged	3279454	3279456		tssJ	2
CHC004_libmerged	3280138	3280152		YPO_RS15645	14
CHC004_libmerged	3281686	3281687		tssC	1
CHC004_libmerged	3283451	3283459		YPO_RS15665	8
CHC004_libmerged	3285816	3285822		YPO_RS15675	6
CHC004_libmerged	3287574	3287575		YPO_RS15680	1
CHC004_libmerged	3293177	3293180		tssF	3
CHC004_libmerged	3294122	3294135		tssF	13
CHC004_libmerged	3294257	3294259		tssF	2
CHC004_libmerged	3296622	3296629		YPO_RS15705	7
CHC004_libmerged	3298446	3298452		YPO_RS15715	6
CHC004_libmerged	3299239	3299240		YPO_RS15720	1
CHC004_libmerged	3301411	3301416		YPO_RS15725	5
CHC004_libmerged	3302827	3302832		YPO_RS15735	5
CHC004_libmerged	3306177	3306186		YPO_RS15745	9
CHC004_libmerged	3307595	3307604		YPO_RS15750	9
CHC004_libmerged	3308120	3308123		YPO_RS15750	3
CHC004_libmerged	3310669	3310670		YPO_RS15765	1
CHC004_libmerged	3311458	3311496		YPO_RS15770	38
CHC004_libmerged	3314069	3314079		YPO_RS15775	10
CHC004_libmerged	3314207	3314219		YPO_RS15775	12
CHC004_libmerged	3317581	3317591		YPO_RS15790	10
CHC004_libmerged	3318863	3318871		YPO_RS15800	8
CHC004_libmerged	3319925	3319927		YPO_RS15810	2
CHC004_libmerged	3320224	3320272		YPO_RS15810	48
CHC004_libmerged	3325043	3325049		glk	6
CHC004_libmerged	3326285	3326310		YPO_RS15840	25
CHC004_libmerged	3329952	3329954		YPO_RS15860	2
CHC004_libmerged	3333884	3333887		gltX	3
CHC004_libmerged	3338769	3338773		ligA	4
CHC004_libmerged	3350501	3350512		macB	11
CHC004_libmerged	3352145	3352167		macB	22
CHC004_libmerged	3354414	3354421		YPO_RS16000	7
CHC004_libmerged	3356088	3356089		YPO_RS16010	1
CHC004_libmerged	3356135	3356147		YPO_RS16010	12
CHC004_libmerged	3356950	3356963		YPO_RS16010	13
CHC004_libmerged	3357276	3357278		YPO_RS16015	2
CHC004_libmerged	3357955	3357958		YPO_RS16020	3
CHC004_libmerged	3358288	3358293		YPO_RS16020	5
CHC004_libmerged	3359225	3359228		YPO_RS16025	3
CHC004_libmerged	3363691	3363693		YPO_RS16040	2
CHC004_libmerged	3363840	3363843		YPO_RS16040	3
CHC004_libmerged	3364189	3364218		YPO_RS16040	29
CHC004_libmerged	3364280	3364289		YPO_RS16040	9
CHC004_libmerged	3364664	3364737		YPO_RS16040	73
CHC004_libmerged	3366127	3366128		cysA	1
CHC004_libmerged	3366789	3366790		cysA	1
CHC004_libmerged	3370396	3370412		YPO_RS16070	16
CHC004_libmerged	3372748	3372780		YPO_RS16075	32
CHC004_libmerged	3381105	3381121		yapL	16
CHC004_libmerged	3383552	3383568		YPO_RS16125	16
CHC004_libmerged	3383653	3383665		YPO_RS16125	12
CHC004_libmerged	3383849	3383872		YPO_RS16125	23
CHC004_libmerged	3385320	3385331		hemF	11
CHC004_libmerged	3391887	3391894		napA	7
CHC004_libmerged	3395822	3395830		YPO_RS16185	8
CHC004_libmerged	3396569	3396583		acrD	14
CHC004_libmerged	3403119	3403123		YPO_RS16205	4
CHC004_libmerged	3404687	3404694		YPO_RS16210	7
CHC004_libmerged	3405494	3405537		YPO_RS16220	43
CHC004_libmerged	3425271	3425285		YPO_RS16315	14
CHC004_libmerged	3432674	3432682		purK	8
CHC004_libmerged	3433072	3433078		purK	6
CHC004_libmerged	3434149	3434166		YPO_RS16360	17
CHC004_libmerged	3435620	3435624		YPO_RS16360	4
CHC004_libmerged	3437889	3437893		YPO_RS16375	4
CHC004_libmerged	3445551	3445564		YPO_RS16405	13
CHC004_libmerged	3446805	3446807		YPO_RS16415	2
CHC004_libmerged	3450517	3450539		YPO_RS16430	22
CHC004_libmerged	3454001	3454038		fepE	37
CHC004_libmerged	3454435	3454444		fepE	9
CHC004_libmerged	3454573	3454589		fepE	16
CHC004_libmerged	3454772	3454774		fepE	2
CHC004_libmerged	3454813	3454853		fepE	40
CHC004_libmerged	3455012	3455029		cpsG	17
CHC004_libmerged	3455261	3455262		cpsG	1
CHC004_libmerged	3455896	3455938		cpsG	42
CHC004_libmerged	3456247	3456252		cpsG	5
CHC004_libmerged	3456560	3456589		YPO_RS16450	29
CHC004_libmerged	3457103	3457112		YPO_RS16450	9
CHC004_libmerged	3457663	3457665		YPO_RS16455	2
CHC004_libmerged	3460849	3460860		YPO_RS16470	11
CHC004_libmerged	3461360	3461367		YPO_RS16470	7
CHC004_libmerged	3461641	3461654		YPO_RS16470	13
CHC004_libmerged	3461838	3461854		YPO_RS16470	16
CHC004_libmerged	3463321	3463349		YPO_RS16480	28
CHC004_libmerged	3463452	3463492		YPO_RS16480	40
CHC004_libmerged	3463711	3463824		YPO_RS16480	113
CHC004_libmerged	3463883	3463986		YPO_RS16480	103
CHC004_libmerged	3464135	3464202		YPO_RS16480	67
CHC004_libmerged	3464843	3464880		YPO_RS16485	37
CHC004_libmerged	3465019	3465113		YPO_RS16485	94
CHC004_libmerged	3465232	3465249		YPO_RS16485	17
CHC004_libmerged	3465317	3465335		YPO_RS16485	18
CHC004_libmerged	3465435	3465465		YPO_RS16485	30
CHC004_libmerged	3465506	3465556		YPO_RS16485	50
CHC004_libmerged	3465567	3465612		YPO_RS16490	45
CHC004_libmerged	3466019	3466044		YPO_RS16490	25
CHC004_libmerged	3466261	3466460		YPO_RS16490	199
CHC004_libmerged	3466524	3466531		YPO_RS16490	7
CHC004_libmerged	3466582	3466657		YPO_RS16490	75
CHC004_libmerged	3466849	3466886		YPO_RS16490	37
CHC004_libmerged	3466984	3467004		YPO_RS16495	20
CHC004_libmerged	3467372	3467373		YPO_RS16495	1
CHC004_libmerged	3467623	3467624		YPO_RS16495	1
CHC004_libmerged	3467800	3467819		YPO_RS16495	19
CHC004_libmerged	3468201	3468203		YPO_RS16495	2
CHC004_libmerged	3468665	3468670		YPO_RS16500	5
CHC004_libmerged	3469124	3469125		YPO_RS16500	1
CHC004_libmerged	3469802	3469803		rfbH	1
CHC004_libmerged	3470514	3470556		rfbG	42
CHC004_libmerged	3472392	3472397		YPO_RS16520	5
CHC004_libmerged	3473049	3473118		YPO_RS16520	69
CHC004_libmerged	3479588	3479590		dnaX	2
CHC004_libmerged	3479759	3479765		dnaX	6
CHC004_libmerged	3485632	3485639		rsmS	7
CHC004_libmerged	3486950	3486964		mscK	14
CHC004_libmerged	3493893	3493914		YPO_RS16605	21
CHC004_libmerged	3495163	3495187		YPO_RS16605	24
CHC004_libmerged	3496960	3497009		YPO_RS16620	49
CHC004_libmerged	3504534	3504548		YPO_RS16665	14
CHC004_libmerged	3505771	3505783		YPO_RS16670	12
CHC004_libmerged	3506474	3506486		YPO_RS16670	12
CHC004_libmerged	3516303	3516304		hupB	1
CHC004_libmerged	3518472	3518494		lon	22
CHC004_libmerged	3520950	3520954		clpP	4
CHC004_libmerged	3527192	3527212		YPO_RS16755	20
CHC004_libmerged	3527253	3527267		YPO_RS16755	14
CHC004_libmerged	3529609	3529625		cyoB	16
CHC004_libmerged	3534625	3534627		YPO_RS16790	2
CHC004_libmerged	3535774	3535780		panE	6
CHC004_libmerged	3543076	3543078		thiL	2
CHC004_libmerged	3547430	3547455		YPO_RS16860	25
CHC004_libmerged	3547488	3547504		YPO_RS16860	16
CHC004_libmerged	3548026	3548108		YPO_RS16865	82
CHC004_libmerged	3548196	3548203		YPO_RS16865	7
CHC004_libmerged	3549727	3549742		secF	15
CHC004_libmerged	3554021	3554025		queA	4
CHC004_libmerged	3555543	3555551		YPO_RS16900	8
CHC004_libmerged	3560232	3560248		YPO_RS16920	16
CHC004_libmerged	3560390	3560395		YPO_RS16925	5
CHC004_libmerged	3560535	3560550		malZ	15
CHC004_libmerged	3562169	3562177		malZ	8
CHC004_libmerged	3565075	3565082		brnQ	7
CHC004_libmerged	3567984	3567991		phoR	7
CHC004_libmerged	3571217	3571220		YPO_RS16965	3
CHC004_libmerged	3572090	3572103		YPO_RS16965	13
CHC004_libmerged	3574416	3574420		YPO_RS16965	4
CHC004_libmerged	3582453	3582458		YPO_RS17005	5
CHC004_libmerged	3583065	3583076		YPO_RS17010	11
CHC004_libmerged	3590096	3590128		YPO_RS17045	32
CHC004_libmerged	3592389	3592406		YPO_RS17055	17
CHC004_libmerged	3592485	3592536		YPO_RS17055	51
CHC004_libmerged	3592602	3592645		YPO_RS17055	43
CHC004_libmerged	3593034	3593114		YPO_RS17055	80
CHC004_libmerged	3593264	3593289		YPO_RS17055	25
CHC004_libmerged	3598493	3598501		YPO_RS17070	8
CHC004_libmerged	3598557	3598558		YPO_RS17070	1
CHC004_libmerged	3600012	3600013		YPO_RS17080	1
CHC004_libmerged	3600206	3600208		YPO_RS17080	2
CHC004_libmerged	3609104	3609114		lpcA	10
CHC004_libmerged	3617937	3617958		YPO_RS17145	21
CHC004_libmerged	3618850	3618896		YPO_RS17145	46
CHC004_libmerged	3619486	3619505		YPO_RS17145	19
CHC004_libmerged	3620029	3620030		YPO_RS17145	1
CHC004_libmerged	3623163	3623168		YPO_RS17155	5
CHC004_libmerged	3643010	3643017		trxC	7
CHC004_libmerged	3644400	3644407		YPO_RS17270	7
CHC004_libmerged	3647146	3647169		pssA	23
CHC004_libmerged	3654007	3654009		YPO_RS17305	2
CHC004_libmerged	3654245	3654248		YPO_RS17310	3
CHC004_libmerged	3654964	3654967		clpB	3
CHC004_libmerged	3657261	3657265		clpB	4
CHC004_libmerged	3658325	3658348		rluD	23
CHC004_libmerged	3666468	3666483		YPO_RS17370	15
CHC004_libmerged	3666845	3666854		YPO_RS17370	9
CHC004_libmerged	3667184	3667186		YPO_RS17370	2
CHC004_libmerged	3667879	3667882		yehT	3
CHC004_libmerged	3672984	3673007		trmD	23
CHC004_libmerged	3682302	3682307		YPO_RS17455	5
CHC004_libmerged	3682639	3682641		YPO_RS17465	2
CHC004_libmerged	3683873	3683875		alaS	2
CHC004_libmerged	3684586	3684591		alaS	5
CHC004_libmerged	3685854	3685857		alaS	3
CHC004_libmerged	3693936	3693939		YPO_RS17520	3
CHC004_libmerged	3697780	3697797		YPO_RS17535	17
CHC004_libmerged	3701199	3701200		YPO_RS17550	1
CHC004_libmerged	3701736	3701757		katG	21
CHC004_libmerged	3704388	3704409		cybC	21
CHC004_libmerged	3704701	3704706		cybB	5
CHC004_libmerged	3705998	3706028		dmsD	30
CHC004_libmerged	3709381	3709386		dmsA	5
CHC004_libmerged	3710924	3710932		YPO_RS17590	8
CHC004_libmerged	3712152	3712166		YPO_RS17595	14
CHC004_libmerged	3713100	3713102		YPO_RS17600	2
CHC004_libmerged	3719057	3719059		YPO_RS17625	2
CHC004_libmerged	3725193	3725226		YPO_RS17650	33
CHC004_libmerged	3728657	3728665		YPO_RS17660	8
CHC004_libmerged	3730698	3730704		YPO_RS17670	6
CHC004_libmerged	3731756	3731758		YPO_RS17675	2
CHC004_libmerged	3732733	3732738		YPO_RS17685	5
CHC004_libmerged	3737436	3737449		YPO_RS17705	13
CHC004_libmerged	3739411	3739416		YPO_RS17715	5
CHC004_libmerged	3746170	3746171		nlpD	1
CHC004_libmerged	3753304	3753306		cysN	2
CHC004_libmerged	3756491	3756493		YPO_RS17800	2
CHC004_libmerged	3759096	3759127		cysI	31
CHC004_libmerged	3760428	3760433		cysJ	5
CHC004_libmerged	3773858	3773868		barA	10
CHC004_libmerged	3776629	3776635		dgt	6
CHC004_libmerged	3776694	3776699		dgt	5
CHC004_libmerged	3777032	3777038		dgt	6
CHC004_libmerged	3779285	3779307		btuF	22
CHC004_libmerged	3779459	3779460		YPO_RS17900	1
CHC004_libmerged	3780847	3780853		clcA	6
CHC004_libmerged	3781837	3781847		clcA	10
CHC004_libmerged	3785889	3785910		fhuB	21
CHC004_libmerged	3793703	3793716		thpR	13
CHC004_libmerged	3797289	3797290		pcnB	1
CHC004_libmerged	3798381	3798385		pcnB	4
CHC004_libmerged	3807006	3807007		cueO	1
CHC004_libmerged	3820051	3820058		aceF	7
CHC004_libmerged	3828228	3828231		ampD	3
CHC004_libmerged	3828892	3828903		nadC	11
CHC004_libmerged	3834478	3834487		coaE	9
CHC004_libmerged	3838866	3838873		YPO_RS18145	7
CHC004_libmerged	3839801	3839805		YPO_RS18145	4
CHC004_libmerged	3841056	3841058		YPO_RS18150	2
CHC004_libmerged	3843055	3843057		YPO_RS18155	2
CHC004_libmerged	3845556	3845557		lptF	1
CHC004_libmerged	3851506	3851512		YPO_RS18190	6
CHC004_libmerged	3858626	3858635		YPO_RS18220	9
CHC004_libmerged	3868550	3868562		phnK	12
CHC004_libmerged	3872579	3872583		YPO_RS18295	4
CHC004_libmerged	3877991	3877994		YPO_RS18325	3
CHC004_libmerged	3878268	3878272		YPO_RS18325	4
CHC004_libmerged	3886134	3886142		YPO_RS18360	8
CHC004_libmerged	3886671	3886680		YPO_RS18360	9
CHC004_libmerged	3904496	3904508		infB	12
CHC004_libmerged	3906366	3906375		infB	9
CHC004_libmerged	3914709	3914711		rlmE	2
CHC004_libmerged	3931506	3931513		YPO_RS18585	7
CHC004_libmerged	3932463	3932468		YPO_RS18585	5
CHC004_libmerged	3932961	3932974		YPO_RS18585	13
CHC004_libmerged	3938215	3938235		YPO_RS18600	20
CHC004_libmerged	3940197	3940232		YPO_RS18610	35
CHC004_libmerged	3946230	3946235		YPO_RS18635	5
CHC004_libmerged	3950379	3950380		yjfP	1
CHC004_libmerged	3958074	3958079		YPO_RS18710	5
CHC004_libmerged	3962036	3962047		elbB	11
CHC004_libmerged	3962297	3962329		elbB	32
CHC004_libmerged	3968462	3968463		gltB	1
CHC004_libmerged	3975594	3975595		YPO_RS18775	1
CHC004_libmerged	3976795	3976798		YPO_RS18790	3
CHC004_libmerged	3987792	3987796		YPO_RS18850	4
CHC004_libmerged	3989531	3989543		kdsD	12
CHC004_libmerged	3990290	3990304		kdsC	14
CHC004_libmerged	3990496	3990510		kdsC	14
CHC004_libmerged	3993692	3993700		rpoN	8
CHC004_libmerged	4003006	4003017		tagH	11
CHC004_libmerged	4004256	4004258		tssJ	2
CHC004_libmerged	4011499	4011517		tssA	18
CHC004_libmerged	4011563	4011580		tssA	17
CHC004_libmerged	4014002	4014004		tssM	2
CHC004_libmerged	4015632	4015639		tssM	7
CHC004_libmerged	4016321	4016324		YPO_RS18990	3
CHC004_libmerged	4016434	4016444		YPO_RS18990	10
CHC004_libmerged	4020350	4020354		YPO_RS19010	4
CHC004_libmerged	4020393	4020398		YPO_RS19010	5
CHC004_libmerged	4026663	4026676		YPO_RS19045	13
CHC004_libmerged	4029320	4029322		YPO_RS19055	2
CHC004_libmerged	4029401	4029439		YPO_RS19055	38
CHC004_libmerged	4031654	4031664		YPO_RS19055	10
CHC004_libmerged	4031914	4031919		YPO_RS19055	5
CHC004_libmerged	4033308	4033317		YPO_RS19055	9
CHC004_libmerged	4033620	4033624		YPO_RS19060	4
CHC004_libmerged	4033661	4033706		YPO_RS19060	45
CHC004_libmerged	4033786	4033805		YPO_RS19060	19
CHC004_libmerged	4033959	4033966		YPO_RS19060	7
CHC004_libmerged	4034678	4034717		YPO_RS19065	39
CHC004_libmerged	4043093	4043096		ssuD	3
CHC004_libmerged	4050625	4050633		YPO_RS19145	8
CHC004_libmerged	4051324	4051344		YPO_RS19145	20
CHC004_libmerged	4060819	4060820		yghU	1
CHC004_libmerged	4063931	4063934		YPO_RS19195	3
CHC004_libmerged	4074043	4074060		dusB	17
CHC004_libmerged	4083957	4083960		YPO_RS19315	3
CHC004_libmerged	4089171	4089172		mreC	1
CHC004_libmerged	4098633	4098674		YPO_RS19365	41
CHC004_libmerged	4098918	4098954		YPO_RS19365	36
CHC004_libmerged	4099411	4099422		YPO_RS19365	11
CHC004_libmerged	4100963	4101046		YPO_RS19365	83
CHC004_libmerged	4101080	4101081		YPO_RS19365	1
CHC004_libmerged	4101304	4101323		YPO_RS19365	19
CHC004_libmerged	4101363	4101491		YPO_RS19365	128
CHC004_libmerged	4101516	4102371		YPO_RS19370	855
CHC004_libmerged	4102423	4102552		YPO_RS19370	129
CHC004_libmerged	4102696	4102822		YPO_RS19370	126
CHC004_libmerged	4102857	4102885		YPO_RS19370	28
CHC004_libmerged	4102931	4102935		YPO_RS19370	4
CHC004_libmerged	4103041	4103052		YPO_RS19370	11
CHC004_libmerged	4103119	4103152		YPO_RS19370	33
CHC004_libmerged	4103212	4103266		YPO_RS19370	54
CHC004_libmerged	4103436	4103442		YPO_RS19370	6
CHC004_libmerged	4106663	4106683		YPO_RS19390	20
CHC004_libmerged	4107182	4107194		YPO_RS19390	12
CHC004_libmerged	4108195	4108198		YPO_RS19390	3
CHC004_libmerged	4110184	4110188		YPO_RS19390	4
CHC004_libmerged	4112683	4112788		YPO_RS19400	105
CHC004_libmerged	4113666	4113669		YPO_RS19400	3
CHC004_libmerged	4113998	4114060		YPO_RS19405	62
CHC004_libmerged	4114225	4114230		YPO_RS19405	5
CHC004_libmerged	4114421	4114422		YPO_RS19405	1
CHC004_libmerged	4115640	4115643		YPO_RS19405	3
CHC004_libmerged	4116829	4116845		YPO_RS19410	16
CHC004_libmerged	4117168	4117188		YPO_RS19410	20
CHC004_libmerged	4117304	4117328		YPO_RS19410	24
CHC004_libmerged	4117798	4117811		aaeR	13
CHC004_libmerged	4120065	4120083		aaeA	18
CHC004_libmerged	4128763	4128768		rnk	5
CHC004_libmerged	4133213	4133216		treR	3
CHC004_libmerged	4142763	4142802		YPO_RS19535	39
CHC004_libmerged	4156562	4156571		YPO_RS19590	9
CHC004_libmerged	4156666	4156673		YPO_RS19590	7
CHC004_libmerged	4182276	4182278		purH	2
CHC004_libmerged	4187205	4187208		hemE	3
CHC004_libmerged	4187365	4187367		hemE	2
CHC004_libmerged	4188631	4188632		YPO_RS19705	1
CHC004_libmerged	4193917	4193931		YPO_RS19730	14
CHC004_libmerged	4198096	4198100		rpoC	4
CHC004_libmerged	4206220	4206247		rplL	27
CHC004_libmerged	4215719	4215730		birA	11
CHC004_libmerged	4217238	4217253		murB	15
CHC004_libmerged	4221480	4221483		YPO_RS19860	3
CHC004_libmerged	4223140	4223146		YPO_RS19870	6
CHC004_libmerged	4226977	4226997		YPO_RS19900	20
CHC004_libmerged	4228299	4228305		pepQ	6
CHC004_libmerged	4230906	4230915		fadB	9
CHC004_libmerged	4235789	4235792		hemB	3
CHC004_libmerged	4240303	4240313		tatB	10
CHC004_libmerged	4240484	4240485		tatB	1
CHC004_libmerged	4242694	4242706		ubiB	12
CHC004_libmerged	4247197	4247200		YPO_RS20000	3
CHC004_libmerged	4248571	4248576		YPO_RS20000	5
CHC004_libmerged	4260426	4260429		ugpA	3
CHC004_libmerged	4263474	4263492		YPO_RS20065	18
CHC004_libmerged	4264094	4264118		YPO_RS20070	24
CHC004_libmerged	4264338	4264359		YPO_RS20070	21
CHC004_libmerged	4268269	4268270		YPO_RS20085	1
CHC004_libmerged	4268305	4268321		YPO_RS20085	16
CHC004_libmerged	4269655	4269671		YPO_RS20095	16
CHC004_libmerged	4281439	4281471		ftsY	32
CHC004_libmerged	4282486	4282489		YPO_RS20160	3
CHC004_libmerged	4284394	4284400		YPO_RS20175	6
CHC004_libmerged	4287766	4287776		tusA	10
CHC004_libmerged	4297450	4297451		yigL	1
CHC004_libmerged	4298034	4298046		pldB	12
CHC004_libmerged	4299648	4299649		rhtB	1
CHC004_libmerged	4301979	4301988		recQ	9
CHC004_libmerged	4307008	4307010		YPO_RS20275	2
CHC004_libmerged	4310443	4310446		uvrD	3
CHC004_libmerged	4313544	4313557		xerC	13
CHC004_libmerged	4314485	4314503		YPO_RS20305	18
CHC004_libmerged	4328877	4328895		wzyE	18
CHC004_libmerged	4332075	4332078		wzxE	3
CHC004_libmerged	4336830	4336833		wecC	3
CHC004_libmerged	4339875	4339881		wzzE	6
CHC004_libmerged	4342012	4342013		rho	1
CHC004_libmerged	4349667	4349699		YPO_RS20480	32
CHC004_libmerged	4350334	4350351		YPO_RS20480	17
CHC004_libmerged	4353156	4353158		YPO_RS20495	2
CHC004_libmerged	4353451	4353452		YPO_RS20495	1
CHC004_libmerged	4353941	4353962		YPO_RS20500	21
CHC004_libmerged	4357749	4357751		stbD	2
CHC004_libmerged	4359333	4359347		YPO_RS20515	14
CHC004_libmerged	4359497	4359540		YPO_RS20515	43
CHC004_libmerged	4360262	4360293		YPO_RS20525	31
CHC004_libmerged	4360685	4360695		YPO_RS20530	10
CHC004_libmerged	4361613	4361617		YPO_RS20530	4
CHC004_libmerged	4363417	4363420		ilvC	3
CHC004_libmerged	4364579	4364580		ilvY	1
CHC004_libmerged	4365282	4365287		YPO_RS20550	5
CHC004_libmerged	4367181	4367188		YPO_RS20565	7
CHC004_libmerged	4367560	4367561		YPO_RS20570	1
CHC004_libmerged	4368058	4368066		YPO_RS20575	8
CHC004_libmerged	4368338	4368384		YPO_RS20575	46
CHC004_libmerged	4374383	4374385		YPO_RS20600	2
CHC004_libmerged	4376181	4376185		YPO_RS20610	4
CHC004_libmerged	4376546	4376561		YPO_RS20610	15
CHC004_libmerged	4400744	4400775		YPO_RS20725	31
CHC004_libmerged	4401529	4401546		YPO_RS20725	17
CHC004_libmerged	4405260	4405266		YPO_RS20740	6
CHC004_libmerged	4405604	4405605		YPO_RS20740	1
CHC004_libmerged	4405893	4405894		YPO_RS20745	1
CHC004_libmerged	4407026	4407032		YPO_RS20745	6
CHC004_libmerged	4408269	4408320		YPO_RS20745	51
CHC004_libmerged	4416319	4416329		ppc	10
CHC004_libmerged	4421260	4421270		glpD	10
CHC004_libmerged	4429295	4429331		glgX	36
CHC004_libmerged	4429730	4429732		glgX	2
CHC004_libmerged	4433876	4433892		YPO_RS20825	16
CHC004_libmerged	4442511	4442526		YPO_RS20830	15
CHC004_libmerged	4446672	4446673		YPO_RS20855	1
CHC004_libmerged	4450269	4450280		YPO_RS20875	11
CHC004_libmerged	4460433	4460439		YPO_RS20930	6
CHC004_libmerged	4464194	4464196		YPO_RS20940	2
CHC004_libmerged	4471626	4471652		gdhA	26
CHC004_libmerged	4472531	4472543		YPO_RS20975	12
CHC004_libmerged	4476314	4476317		prlC	3
CHC004_libmerged	4477822	4477832		YPO_RS20990	10
CHC004_libmerged	4480792	4480794		YPO_RS21005	2
CHC004_libmerged	4483586	4483614		YPO_RS21020	28
CHC004_libmerged	4483808	4483876		YPO_RS21020	68
CHC004_libmerged	4484178	4484240		YPO_RS21025	62
CHC004_libmerged	4484459	4484482		YPO_RS21025	23
CHC004_libmerged	4484592	4484599		YPO_RS21025	7
CHC004_libmerged	4484601	4484612		YPO_RS21030	11
CHC004_libmerged	4484859	4484862		YPO_RS21030	3
CHC004_libmerged	4484964	4485023		YPO_RS21030	59
CHC004_libmerged	4487807	4487817		yapE	10
CHC004_libmerged	4487909	4487913		yapE	4
CHC004_libmerged	4491394	4491405		YPO_RS21050	11
CHC004_libmerged	4501451	4501455		YPO_RS21085	4
CHC004_libmerged	4505302	4505305		hmsP	3
CHC004_libmerged	4511451	4511458		dppB	7
CHC004_libmerged	4515982	4515999		YPO_RS21140	17
CHC004_libmerged	4516072	4516094		YPO_RS21140	22
CHC004_libmerged	4516783	4516801		YPO_RS21140	18
CHC004_libmerged	4519552	4519558		YPO_RS21155	6
CHC004_libmerged	4524367	4524375		eptB	8
CHC004_libmerged	4526435	4526439		YPO_RS21185	4
CHC004_libmerged	4528819	4528820		YPO_RS21190	1
CHC004_libmerged	4533473	4533477		YPO_RS21205	4
CHC004_libmerged	4533640	4533660		YPO_RS21205	20
CHC004_libmerged	4534337	4534356		YPO_RS21205	19
CHC004_libmerged	4534735	4534739		YPO_RS21210	4
CHC004_libmerged	4536738	4536743		YPO_RS21220	5
CHC004_libmerged	4538714	4538719		YPO_RS21230	5
CHC004_libmerged	4540476	4540483		YPO_RS21235	7
CHC004_libmerged	4545797	4545838		YPO_RS21280	41
CHC004_libmerged	4545881	4545938		YPO_RS21280	57
CHC004_libmerged	4546030	4546031		YPO_RS21280	1
CHC004_libmerged	4546407	4546442		YPO_RS21280	35
CHC004_libmerged	4548649	4548660		YPO_RS21295	11
CHC004_libmerged	4552386	4552397		xylF	11
CHC004_libmerged	4553113	4553114		xylF	1
CHC004_libmerged	4558136	4558149		YPO_RS21330	13
CHC004_libmerged	4558508	4558511		YPO_RS21330	3
CHC004_libmerged	4561310	4561316		YPO_RS21340	6
CHC004_libmerged	4563882	4563883		YPO_RS21350	1
CHC004_libmerged	4567680	4567697		YPO_RS21370	17
CHC004_libmerged	4567737	4567791		YPO_RS21370	54
CHC004_libmerged	4568598	4568600		YPO_RS21380	2
CHC004_libmerged	4570821	4570829		selB	8
CHC004_libmerged	4571291	4571293		YPO_RS21395	2
CHC004_libmerged	4573185	4573196		fdhE	11
CHC004_libmerged	4574110	4574112		fdoI	2
CHC004_libmerged	4590989	4590991		YPO_RS21475	2
CHC004_libmerged	4592126	4592131		glyS	5
CHC004_libmerged	4596859	4596863		YPO_RS21505	4
CHC004_libmerged	4601624	4601728		YPO_RS21520	104
CHC004_libmerged	4601894	4601907		YPO_RS21520	13
CHC004_libmerged	4602019	4602023		YPO_RS21520	4
CHC004_libmerged	4604101	4604114		YPO_RS21530	13
CHC004_libmerged	4614249	4614256		gyrB	7
CHC004_libmerged	4617684	4617705		dnaN	21
CHC004_libmerged	4621871	4621916		yidC	45
CHC004_libmerged	4624899	4624915		YPO_RS21620	16
CHC004_libmerged	4625917	4625934		YPO_RS21625	17
CHC004_libmerged	4626181	4626211		YPO_RS21630	30
CHC004_libmerged	4626282	4626331		YPO_RS21630	49
CHC004_libmerged	4629423	4629431		YPO_RS21645	8
CHC004_libmerged	4631706	4631707		YPO_RS21660	1
CHC004_libmerged	4633225	4633228		YPO_RS21670	3
CHC004_libmerged	4635286	4635292		pstB	6
CHC004_libmerged	4649822	4649832		atpB	10
GEN_72	1435	1446		YPO_RS01015	11
GEN_72	4016	4071		ravA	55
GEN_72	4101	4110		ravA	9
GEN_72	5168	5170		ravA	2
GEN_72	10225	10238		YPO_RS01055	13
GEN_72	10673	10693		YPO_RS01055	20
GEN_72	12865	12866		YPO_RS01070	1
GEN_72	19187	19190		mobB	3
GEN_72	19363	19391		mobB	28
GEN_72	22333	22361		dsbA	28
GEN_72	23893	23909		polA	16
GEN_72	29002	29027		hemN	25
GEN_72	29271	29273		hemN	2
GEN_72	30261	30283		hemN	22
GEN_72	41074	41129		YPO_RS01185	55
GEN_72	44824	44832		YPO_RS01200	8
GEN_72	50418	50426		spoT	8
GEN_72	55674	55684		YPO_RS01245	10
GEN_72	56672	56674		YPO_RS01250	2
GEN_72	59559	59561		slmA	2
GEN_72	71943	71945		tdh	2
GEN_72	73925	73927		envC	2
GEN_72	74624	74642		envC	18
GEN_72	76963	76964		YPO_RS01360	1
GEN_72	77284	77287		YPO_RS01360	3
GEN_72	77643	77649		grxC	6
GEN_72	82565	82566		cpxA	1
GEN_72	94703	94708		YPO_RS01460	5
GEN_72	95569	95573		YPO_RS01460	4
GEN_72	97861	97868		YPO_RS01475	7
GEN_72	98819	98823		fpr	4
GEN_72	99114	99115		fpr	1
GEN_72	106560	106584		YPO_RS01520	24
GEN_72	107383	107404		YPO_RS01520	21
GEN_72	108562	108588		YPO_RS01530	26
GEN_72	108928	108950		YPO_RS01530	22
GEN_72	109258	109260		YPO_RS01530	2
GEN_72	112384	112398		YPO_RS01550	14
GEN_72	114988	114992		hslV	4
GEN_72	116442	116472		cytR	30
GEN_72	118988	118990		priA	2
GEN_72	124943	124947		YPO_RS01600	4
GEN_72	127170	127209		YPO_RS01610	39
GEN_72	127632	127638		YPO_RS01610	6
GEN_72	142041	142046		feoB	5
GEN_72	146394	146398		YPO_RS01685	4
GEN_72	147179	147190		YPO_RS01685	11
GEN_72	148146	148149		greB	3
GEN_72	148548	148559		greB	11
GEN_72	150932	150941		pckA	9
GEN_72	152313	152334		pckA	21
GEN_72	155421	155423		YPO_RS01725	2
GEN_72	155919	155920		YPO_RS01725	1
GEN_72	166142	166175		aroB	33
GEN_72	171544	171549		trpS	5
GEN_72	177040	177057		YPO_RS01815	17
GEN_72	180232	180261		tsgA	29
GEN_72	196638	196717		YPO_RS01895	79
GEN_72	196761	196798		YPO_RS01895	37
GEN_72	196886	196930		YPO_RS01895	44
GEN_72	197195	197205		YPO_RS01900	10
GEN_72	197695	197700		YPO_RS01900	5
GEN_72	201793	201799		tauB	6
GEN_72	204269	204288		YPO_RS01940	19
GEN_72	205708	205719		YPO_RS01945	11
GEN_72	236480	236494		YPO_RS02185	14
GEN_72	236795	236822		mscL	27
GEN_72	238504	238514		trkA	10
GEN_72	239850	239866		rsmB	16
GEN_72	241239	241249		def	10
GEN_72	247522	247530		YPO_RS02250	8
GEN_72	252313	252340		acs	27
GEN_72	252523	252530		acs	7
GEN_72	254613	254618		gltP	5
GEN_72	255238	255258		YPO_RS02280	20
GEN_72	257982	258005		YPO_RS02285	23
GEN_72	258190	258221		YPO_RS02285	31
GEN_72	258747	258789		YPO_RS02290	42
GEN_72	258840	258873		YPO_RS02290	33
GEN_72	266392	266403		YPO_RS02340	11
GEN_72	270947	270968		sctR	21
GEN_72	272270	272277		sctT	7
GEN_72	275505	275542		YPO_RS02395	37
GEN_72	275966	275993		YPO_RS02395	27
GEN_72	276169	276180		YPO_RS02395	11
GEN_72	276378	276381		YPO_RS02395	3
GEN_72	276551	276602		YPO_RS02400	51
GEN_72	277761	277763		YPO_RS02400	2
GEN_72	277891	277898		metC	7
GEN_72	278895	278900		metC	5
GEN_72	279205	279217		YPO_RS02410	12
GEN_72	280136	280139		YPO_RS02415	3
GEN_72	282516	282532		YPO_RS02425	16
GEN_72	288450	288454		YPO_RS02455	4
GEN_72	288495	288521		YPO_RS02455	26
GEN_72	288863	288962		YPO_RS02455	99
GEN_72	289442	289448		YPO_RS02460	6
GEN_72	291170	291191		YPO_RS02465	21
GEN_72	291535	291542		YPO_RS02470	7
GEN_72	291835	291841		YPO_RS02470	6
GEN_72	292378	292386		YPO_RS02475	8
GEN_72	295342	295361		YPO_RS02485	19
GEN_72	301786	301787		YPO_RS02525	1
GEN_72	302675	302717		YPO_RS02530	42
GEN_72	303228	303240		YPO_RS02530	12
GEN_72	304116	304136		YPO_RS02530	20
GEN_72	305237	305260		YPO_RS02535	23
GEN_72	305923	305925		YPO_RS02540	2
GEN_72	311701	311711		YPO_RS02555	10
GEN_72	314219	314225		yapK	6
GEN_72	315076	315134		yapK	58
GEN_72	317665	317676		ubiA	11
GEN_72	324021	324035		dusA	14
GEN_72	325619	325642		YPO_RS02605	23
GEN_72	325801	325807		YPO_RS02605	6
GEN_72	331941	331947		uvrA	6
GEN_72	337554	337572		rhaD	18
GEN_72	337714	337715		rhaD	1
GEN_72	345055	345091		YPO_RS02690	36
GEN_72	345767	345774		YPO_RS02695	7
GEN_72	345939	345949		YPO_RS02695	10
GEN_72	346045	346114		YPO_RS02695	69
GEN_72	346402	346418		YPO_RS02695	16
GEN_72	346651	346695		YPO_RS02695	44
GEN_72	347064	347127		YPO_RS02695	63
GEN_72	347192	347273		YPO_RS02695	81
GEN_72	347366	347436		YPO_RS02695	70
GEN_72	347595	347607		YPO_RS02695	12
GEN_72	347730	347769		YPO_RS02695	39
GEN_72	347819	347832		YPO_RS02695	13
GEN_72	347992	348064		YPO_RS02695	72
GEN_72	352590	352597		fdhF	7
GEN_72	360458	360486		fxsA	28
GEN_72	360979	360988		fxsA	9
GEN_72	366957	366960		YPO_RS02780	3
GEN_72	371058	371063		YPO_RS02805	5
GEN_72	371110	371142		YPO_RS02805	32
GEN_72	373589	373633		mscM	44
GEN_72	375052	375054		mscM	2
GEN_72	384482	384494		amiB	12
GEN_72	386180	386187		mutL	7
GEN_72	387200	387230		miaA	30
GEN_72	387406	387416		miaA	10
GEN_72	389627	389634		hflX	7
GEN_72	394694	394706		nsrR	12
GEN_72	401047	401049		YPO_RS02925	2
GEN_72	402851	402859		YPO_RS02935	8
GEN_72	403089	403115		YPO_RS02940	26
GEN_72	405287	405293		YPO_RS02945	6
GEN_72	406401	406403		YPO_RS02945	2
GEN_72	407756	407767		YPO_RS02955	11
GEN_72	407809	407865		YPO_RS02955	56
GEN_72	408155	408351		YPO_RS02955	196
GEN_72	408392	408399		YPO_RS02955	7
GEN_72	408454	408488		YPO_RS02955	34
GEN_72	408638	408665		YPO_RS02955	27
GEN_72	409023	409035		YPO_RS02960	12
GEN_72	409185	409226		YPO_RS02960	41
GEN_72	409295	409306		YPO_RS02960	11
GEN_72	409405	409420		YPO_RS02960	15
GEN_72	409793	409798		YPO_RS02965	5
GEN_72	409863	409893		YPO_RS02965	30
GEN_72	410026	410065		YPO_RS02965	39
GEN_72	410490	410641		YPO_RS02965	151
GEN_72	410708	410712		YPO_RS02965	4
GEN_72	410858	410891		YPO_RS02965	33
GEN_72	409576	409756		YPO_RS02965	180
GEN_72	414528	414529		YPO_RS02985	1
GEN_72	415842	415855		YPO_RS02990	13
GEN_72	416418	416458		YPO_RS02995	40
GEN_72	417080	417101		YPO_RS02995	21
GEN_72	418381	418391		YPO_RS03005	10
GEN_72	426073	426093		lsrF	20
GEN_72	427441	427444		lsrB	3
GEN_72	431280	431387		YPO_RS03065	107
GEN_72	432780	432788		lsrK	8
GEN_72	436092	436098		YPO_RS03085	6
GEN_72	442730	442734		YPO_RS03105	4
GEN_72	446210	446250		YPO_RS03120	40
GEN_72	446306	446388		YPO_RS03120	82
GEN_72	453680	453683		YPO_RS03165	3
GEN_72	454637	454641		YPO_RS03170	4
GEN_72	461546	461557		deoD	11
GEN_72	473584	473588		YPO_RS03245	4
GEN_72	478400	478403		trpR	3
GEN_72	481258	481268		creA	10
GEN_72	489153	489158		yaaA	5
GEN_72	492029	492032		mog	3
GEN_72	492321	492327		YPO_RS03325	6
GEN_72	493618	493634		YPO_RS03330	16
GEN_72	494212	494218		YPO_RS03330	6
GEN_72	494313	494318		YPO_RS03330	5
GEN_72	494463	494488		YPO_RS03330	25
GEN_72	494990	495034		YPO_RS03330	44
GEN_72	495136	495314		YPO_RS03330	178
GEN_72	495387	495406		YPO_RS03330	19
GEN_72	495493	495535		YPO_RS03330	42
GEN_72	495725	495785		YPO_RS03330	60
GEN_72	495822	495899		YPO_RS03330	77
GEN_72	495964	496048		YPO_RS03330	84
GEN_72	500441	500500		dnaJ	59
GEN_72	501051	501062		nhaA	11
GEN_72	502093	502096		nhaR	3
GEN_72	502126	502128		nhaR	2
GEN_72	517070	517074		YPO_RS03420	4
GEN_72	518038	518047		YPO_RS03425	9
GEN_72	519213	519231		folA	18
GEN_72	520227	520231		YPO_RS03440	4
GEN_72	521134	521146		YPO_RS03450	12
GEN_72	528060	528062		lptD	2
GEN_72	528771	528775		djlA	4
GEN_72	529044	529046		djlA	2
GEN_72	531880	531907		YPO_RS03495	27
GEN_72	532168	532232		YPO_RS03495	64
GEN_72	532269	532300		YPO_RS03495	31
GEN_72	533227	533240		YPO_RS03500	13
GEN_72	533365	533380		YPO_RS03500	15
GEN_72	533772	533787		tssB	15
GEN_72	536449	536461		YPO_RS03515	12
GEN_72	540258	540260		tssH	2
GEN_72	542771	542781		vgrG	10
GEN_72	545295	545298		YPO_RS03545	3
GEN_72	551580	551587		YPO_RS03580	7
GEN_72	553143	553150		tssM	7
GEN_72	553951	553957		tssM	6
GEN_72	555550	555557		tssM	7
GEN_72	557436	557438		rapA	2
GEN_72	559483	559485		rapA	2
GEN_72	560314	560324		YPO_RS03600	10
GEN_72	562111	562117		YPO_RS03600	6
GEN_72	562648	562682		YPO_RS03600	34
GEN_72	564012	564029		thiQ	17
GEN_72	564625	564636		thiP	11
GEN_72	572989	573018		YPO_RS03640	29
GEN_72	573140	573142		YPO_RS03645	2
GEN_72	574620	574635		leuC	15
GEN_72	579547	579586		YPO_RS03675	39
GEN_72	589524	589531		YPO_RS03715	7
GEN_72	595319	595366		murF	47
GEN_72	600274	600291		murG	17
GEN_72	600590	600624		murG	34
GEN_72	604373	604375		ftsQ	2
GEN_72	610056	610075		secA	19
GEN_72	612770	612771		mutT	1
GEN_72	614766	614834		YPO_RS03825	68
GEN_72	626927	626929		YPO_RS03895	2
GEN_72	628046	628050		YPO_RS03900	4
GEN_72	628177	628183		YPO_RS03905	6
GEN_72	630658	630662		YPO_RS03915	4
GEN_72	634031	634048		yapG	17
GEN_72	635091	635094		yapG	3
GEN_72	635257	635266		yapG	9
GEN_72	635472	635525		yapG	53
GEN_72	638361	638377		YPO_RS03935	16
GEN_72	639722	639741		YPO_RS03940	19
GEN_72	642538	642542		YPO_RS03950	4
GEN_72	647605	647610		YPO_RS03975	5
GEN_72	647729	647749		YPO_RS03975	20
GEN_72	647807	647837		YPO_RS03975	30
GEN_72	650525	650531		cdiA	6
GEN_72	652450	652455		cdiA	5
GEN_72	654765	654769		cdiA	4
GEN_72	656689	656727		cdiA	38
GEN_72	657247	657250		cdiA	3
GEN_72	658162	658171		cdiA	9
GEN_72	659238	659301		cdiI	63
GEN_72	659353	659428		cdiI	75
GEN_72	660026	660043		YPO_RS04005	17
GEN_72	660159	660176		YPO_RS04005	17
GEN_72	660474	660483		YPO_RS04010	9
GEN_72	663813	663814		yapF	1
GEN_72	664070	664071		YPO_RS04025	1
GEN_72	666286	666298		YPO_RS04030	12
GEN_72	666534	666546		YPO_RS04030	12
GEN_72	667934	667987		YPO_RS04035	53
GEN_72	673028	673030		YPO_RS04050	2
GEN_72	673953	673972		YPO_RS04055	19
GEN_72	674942	674946		YPO_RS04060	4
GEN_72	676613	676620		YPO_RS04070	7
GEN_72	677275	677276		YPO_RS04070	1
GEN_72	681133	681142		YPO_RS04080	9
GEN_72	682285	682302		mdtN	17
GEN_72	683072	683082		YPO_RS04090	10
GEN_72	684416	684428		YPO_RS04100	12
GEN_72	684645	684684		YPO_RS04100	39
GEN_72	685737	685744		YPO_RS04105	7
GEN_72	686053	686058		YPO_RS04105	5
GEN_72	686206	686216		YPO_RS04105	10
GEN_72	686673	686674		YPO_RS04105	1
GEN_72	687065	687115		YPO_RS04110	50
GEN_72	687287	687301		YPO_RS04110	14
GEN_72	687672	687709		YPO_RS04115	37
GEN_72	687951	687974		YPO_RS04115	23
GEN_72	688297	688346		YPO_RS04120	49
GEN_72	688453	688457		YPO_RS04120	4
GEN_72	689072	689078		YPO_RS04125	6
GEN_72	689635	689663		YPO_RS04130	28
GEN_72	693836	693868		YPO_RS04160	32
GEN_72	694134	694142		YPO_RS04160	8
GEN_72	695278	695288		YPO_RS04165	10
GEN_72	704985	705009		plsY	24
GEN_72	720880	720881		YPO_RS04275	1
GEN_72	721743	721744		YPO_RS04280	1
GEN_72	731918	731943		parC	25
GEN_72	733568	733575		YPO_RS04335	7
GEN_72	735222	735223		ftsP	1
GEN_72	738374	738392		dkgA	18
GEN_72	742708	742709		YPO_RS04370	1
GEN_72	746454	746467		YPO_RS04390	13
GEN_72	746828	746917		YPO_RS04390	89
GEN_72	747216	747243		YPO_RS04390	27
GEN_72	747457	747461		YPO_RS04390	4
GEN_72	747587	747605		YPO_RS04390	18
GEN_72	747760	747824		YPO_RS04390	64
GEN_72	749028	749052		YPO_RS04405	24
GEN_72	749310	749359		YPO_RS04405	49
GEN_72	749624	749640		YPO_RS04405	16
GEN_72	749629	749640		YPO_RS04410	11
GEN_72	749993	749996		YPO_RS04410	3
GEN_72	750065	750141		YPO_RS04410	76
GEN_72	750194	750265		YPO_RS04410	71
GEN_72	750374	750379		YPO_RS04410	5
GEN_72	750429	750462		YPO_RS04410	33
GEN_72	750459	750524		YPO_RS04415	65
GEN_72	750683	750695		YPO_RS04415	12
GEN_72	750966	751070		YPO_RS04415	104
GEN_72	751123	751142		YPO_RS04415	19
GEN_72	751179	751219		YPO_RS04415	40
GEN_72	752083	752093		YPO_RS04420	10
GEN_72	752441	752472		YPO_RS04420	31
GEN_72	752629	752700		YPO_RS04425	71
GEN_72	753060	753089		YPO_RS04425	29
GEN_72	753478	753482		YPO_RS04425	4
GEN_72	753522	753756		YPO_RS04425	234
GEN_72	753767	753967		YPO_RS04430	200
GEN_72	754707	754787		YPO_RS04440	80
GEN_72	754828	754856		YPO_RS04440	28
GEN_72	754983	755022		YPO_RS04440	39
GEN_72	755073	755077		YPO_RS04440	4
GEN_72	755310	755372		YPO_RS04440	62
GEN_72	755369	755378		YPO_RS04445	9
GEN_72	755532	755541		YPO_RS04445	9
GEN_72	755663	755673		YPO_RS04445	10
GEN_72	755771	755826		YPO_RS04445	55
GEN_72	755904	755915		YPO_RS04445	11
GEN_72	756197	756234		YPO_RS04445	37
GEN_72	756599	756638		YPO_RS04450	39
GEN_72	756671	756694		YPO_RS04450	23
GEN_72	758453	758460		YPO_RS04465	7
GEN_72	769327	769335		flhB	8
GEN_72	769693	769696		flhB	3
GEN_72	771733	771734		fliP	1
GEN_72	772594	772606		YPO_RS04525	12
GEN_72	772959	773014		YPO_RS04525	55
GEN_72	775924	775927		fliF	3
GEN_72	778077	778082		YPO_RS04550	5
GEN_72	778195	778196		YPO_RS04550	1
GEN_72	780177	780190		fliJ	13
GEN_72	781506	781540		flgA	34
GEN_72	782002	782025		flgA	23
GEN_72	782237	782257		flgA	20
GEN_72	782902	782931		flgC	29
GEN_72	785299	785331		YPO_RS04600	32
GEN_72	786332	786338		flgF	6
GEN_72	787661	787678		flgH	17
GEN_72	789399	789401		flgJ	2
GEN_72	789780	789795		flgK	15
GEN_72	791132	791141		flgK	9
GEN_72	791170	791172		flgL	2
GEN_72	791768	791792		flgL	24
GEN_72	791886	791904		flgL	18
GEN_72	793859	793891		YPO_RS04655	32
GEN_72	796054	796079		YPO_RS04660	25
GEN_72	796134	796143		YPO_RS04660	9
GEN_72	797810	797821		YPO_RS04665	11
GEN_72	801467	801495		fliS	28
GEN_72	803194	803195		YPO_RS04690	1
GEN_72	804205	804217		YPO_RS04700	12
GEN_72	804368	804393		YPO_RS04700	25
GEN_72	805514	805526		lafU	12
GEN_72	806107	806125		lafU	18
GEN_72	806658	806704		YPO_RS04715	46
GEN_72	806868	806874		YPO_RS04715	6
GEN_72	806986	807089		YPO_RS04715	103
GEN_72	807608	807706		YPO_RS04720	98
GEN_72	807690	807707		YPO_RS04725	17
GEN_72	807778	807788		YPO_RS04725	10
GEN_72	808020	808030		YPO_RS04725	10
GEN_72	808984	809068		YPO_RS04735	84
GEN_72	809184	809241		YPO_RS04735	57
GEN_72	810310	810312		YPO_RS04740	2
GEN_72	811115	811125		YPO_RS04740	10
GEN_72	811115	811125		YPO_RS04745	10
GEN_72	816375	816444		YPO_RS04765	69
GEN_72	816695	816737		YPO_RS04765	42
GEN_72	816880	816882		YPO_RS04770	2
GEN_72	822652	822659		vgrG	7
GEN_72	822825	822826		vgrG	1
GEN_72	824644	824650		vgrG	6
GEN_72	833345	833347		YPO_RS04795	2
GEN_72	833835	833876		YPO_RS04800	41
GEN_72	835324	835338		YPO_RS04805	14
GEN_72	835983	835993		YPO_RS04805	10
GEN_72	836415	836416		YPO_RS04805	1
GEN_72	838202	838207		YPO_RS04810	5
GEN_72	838848	838864		YPO_RS04815	16
GEN_72	838903	838905		YPO_RS04815	2
GEN_72	839279	839287		YPO_RS04815	8
GEN_72	842070	842086		YPO_RS04830	16
GEN_72	843440	843450		YPO_RS04835	10
GEN_72	845410	845481		YPO_RS04835	71
GEN_72	845525	845550		YPO_RS04835	25
GEN_72	845587	845616		YPO_RS04835	29
GEN_72	845929	845939		YPO_RS04835	10
GEN_72	850362	850367		YPO_RS04845	5
GEN_72	854091	854095		YPO_RS04845	4
GEN_72	854317	854320		YPO_RS04845	3
GEN_72	857164	857165		YPO_RS04850	1
GEN_72	857722	857726		YPO_RS04850	4
GEN_72	858758	858766		YPO_RS04855	8
GEN_72	863513	863521		ptsP	8
GEN_72	864029	864030		rppH	1
GEN_72	865350	865364		mutH	14
GEN_72	867715	867850		YPO_RS04900	135
GEN_72	881180	881183		YPO_RS04945	3
GEN_72	883484	883495		YPO_RS04955	11
GEN_72	883553	883569		YPO_RS04955	16
GEN_72	883997	884000		YPO_RS04960	3
GEN_72	884194	884261		YPO_RS04965	67
GEN_72	884300	884401		YPO_RS04965	101
GEN_72	884440	884505		YPO_RS04965	65
GEN_72	884776	884810		YPO_RS04965	34
GEN_72	884901	884907		YPO_RS04965	6
GEN_72	885548	885565		YPO_RS04975	17
GEN_72	885636	885710		YPO_RS04975	74
GEN_72	886043	886049		YPO_RS04975	6
GEN_72	886091	886096		YPO_RS04975	5
GEN_72	886163	886219		YPO_RS04975	56
GEN_72	886319	886359		YPO_RS04975	40
GEN_72	886490	886525		YPO_RS04980	35
GEN_72	886603	886661		YPO_RS04980	58
GEN_72	886695	886720		YPO_RS04980	25
GEN_72	886785	886788		YPO_RS04980	3
GEN_72	886986	887073		gspL	87
GEN_72	887124	887152		gspL	28
GEN_72	887342	887367		gspL	25
GEN_72	887459	887481		gspL	22
GEN_72	887736	887840		gspL	104
GEN_72	887882	887933		gspL	51
GEN_72	888120	888217		YPO_RS04990	97
GEN_72	888258	888274		YPO_RS04990	16
GEN_72	888438	888462		YPO_RS04990	24
GEN_72	888620	888630		YPO_RS04990	10
GEN_72	888669	888701		YPO_RS04990	32
GEN_72	888810	888814		YPO_RS04990	4
GEN_72	889183	889319		gspJ	136
GEN_72	889375	889379		gspJ	4
GEN_72	889450	889541		gspJ	91
GEN_72	889778	889801		gspI	23
GEN_72	889936	889970		gspI	34
GEN_72	889984	890017		YPO_RS05005	33
GEN_72	890245	890265		YPO_RS05005	20
GEN_72	893251	893254		gspE	3
GEN_72	893494	893509		gspE	15
GEN_72	893701	893828		gspD	127
GEN_72	893888	893891		gspD	3
GEN_72	893964	893969		gspD	5
GEN_72	894353	894381		gspD	28
GEN_72	894456	894513		gspD	57
GEN_72	894711	894756		gspD	45
GEN_72	894839	894879		gspD	40
GEN_72	894944	894966		gspD	22
GEN_72	895442	895485		gspD	43
GEN_72	895603	895606		gspD	3
GEN_72	895690	895775		YPO_RS05030	85
GEN_72	895910	895963		YPO_RS05030	53
GEN_72	896036	896071		YPO_RS05030	35
GEN_72	896124	896190		YPO_RS05030	66
GEN_72	896258	896267		YPO_RS05035	9
GEN_72	896308	896354		YPO_RS05035	46
GEN_72	896423	896435		YPO_RS05035	12
GEN_72	896529	896576		YPO_RS05035	47
GEN_72	897430	897438		YPO_RS05040	8
GEN_72	902605	902621		yapM	16
GEN_72	907995	908003		YPO_RS05070	8
GEN_72	908127	908138		tnpA	11
GEN_72	910466	910469		YPO_RS05080	3
GEN_72	914836	914855		YPO_RS05100	19
GEN_72	915422	915431		YPO_RS05105	9
GEN_72	919760	919764		YPO_RS05130	4
GEN_72	920203	920204		YPO_RS05130	1
GEN_72	922110	922112		YPO_RS05140	2
GEN_72	924393	924395		YPO_RS05145	2
GEN_72	928610	928623		YPO_RS05165	13
GEN_72	935741	935757		YPO_RS05185	16
GEN_72	937222	937228		YPO_RS05190	6
GEN_72	937518	937521		YPO_RS05190	3
GEN_72	938218	938224		YPO_RS05190	6
GEN_72	939485	939501		YPO_RS05200	16
GEN_72	940554	940580		YPO_RS05205	26
GEN_72	941458	941468		YPO_RS05205	10
GEN_72	946335	946339		YPO_RS05220	4
GEN_72	950104	950185		YPO_RS05235	81
GEN_72	950308	950354		YPO_RS05235	46
GEN_72	953653	953800		YPO_RS05260	147
GEN_72	957882	957902		YPO_RS05270	20
GEN_72	958328	958348		YPO_RS05275	20
GEN_72	959644	959658		YPO_RS05290	14
GEN_72	961525	961529		YPO_RS05295	4
GEN_72	963339	963363		YPO_RS05305	24
GEN_72	963462	963476		YPO_RS05305	14
GEN_72	964110	964130		YPO_RS05315	20
GEN_72	966505	966551		YPO_RS05330	46
GEN_72	968344	968360		YPO_RS05340	16
GEN_72	968581	968587		YPO_RS05345	6
GEN_72	978695	978716		creD	21
GEN_72	980828	980831		creC	3
GEN_72	986180	986183		YPO_RS05440	3
GEN_72	986412	986427		YPO_RS05440	15
GEN_72	993949	993990		gcvP	41
GEN_72	997019	997024		ubiI	5
GEN_72	999747	999757		pepP	10
GEN_72	1000542	1000551		pepP	9
GEN_72	1015341	1015353		YPO_RS05560	12
GEN_72	1028647	1028649		YPO_RS05620	2
GEN_72	1028653	1028654		YPO_RS05620	1
GEN_72	1037627	1037629		YPO_RS05675	2
GEN_72	1039755	1039808		YPO_RS05675	53
GEN_72	1040230	1040233		YPO_RS05675	3
GEN_72	1040484	1040498		YPO_RS05675	14
GEN_72	1040574	1040581		YPO_RS05675	7
GEN_72	1040643	1040665		YPO_RS05675	22
GEN_72	1040970	1040980		YPO_RS05675	10
GEN_72	1041369	1041386		YPO_RS05675	17
GEN_72	1042846	1042856		YPO_RS05675	10
GEN_72	1043749	1043795		YPO_RS05675	46
GEN_72	1043866	1043878		YPO_RS05675	12
GEN_72	1043944	1043984		YPO_RS05675	40
GEN_72	1044239	1044311		YPO_RS05675	72
GEN_72	1044422	1044514		YPO_RS05675	92
GEN_72	1044641	1044658		YPO_RS05675	17
GEN_72	1044728	1044738		YPO_RS05675	10
GEN_72	1044794	1044818		YPO_RS05675	24
GEN_72	1044863	1044891		YPO_RS05675	28
GEN_72	1044978	1045022		YPO_RS05675	44
GEN_72	1045183	1045203		YPO_RS05675	20
GEN_72	1045293	1045330		YPO_RS05675	37
GEN_72	1045493	1045638		YPO_RS05675	145
GEN_72	1045708	1045867		YPO_RS05675	159
GEN_72	1046330	1046337		YPO_RS05675	7
GEN_72	1046490	1046497		YPO_RS05675	7
GEN_72	1046562	1046581		YPO_RS05675	19
GEN_72	1046684	1046729		YPO_RS05675	45
GEN_72	1048583	1048584		glsB	1
GEN_72	1052447	1052456		mltC	9
GEN_72	1054774	1054799		YPO_RS05715	25
GEN_72	1055093	1055106		YPO_RS05720	13
GEN_72	1055399	1055416		YPO_RS05720	17
GEN_72	1056199	1056219		YPO_RS05720	20
GEN_72	1063228	1063252		speF	24
GEN_72	1066703	1066730		YPO_RS05765	27
GEN_72	1066880	1066930		YPO_RS05765	50
GEN_72	1066963	1067011		YPO_RS05765	48
GEN_72	1067202	1067285		YPO_RS05765	83
GEN_72	1067330	1067389		YPO_RS05765	59
GEN_72	1067376	1067400		YPO_RS05770	24
GEN_72	1067542	1067546		YPO_RS05770	4
GEN_72	1067862	1067870		YPO_RS05770	8
GEN_72	1068065	1068179		YPO_RS05770	114
GEN_72	1069496	1069497		YPO_RS05770	1
GEN_72	1069657	1069662		YPO_RS05770	5
GEN_72	1071995	1072012		YPO_RS05790	17
GEN_72	1073114	1073135		YPO_RS05795	21
GEN_72	1077795	1077798		tssH	3
GEN_72	1078373	1078384		tssH	11
GEN_72	1081394	1081407		YPO_RS05815	13
GEN_72	1085646	1085657		tssC	11
GEN_72	1086227	1086250		tssB	23
GEN_72	1088689	1088721		YPO_RS05845	32
GEN_72	1089054	1089082		YPO_RS05845	28
GEN_72	1091363	1091365		YPO_RS05855	2
GEN_72	1092439	1092464		YPO_RS05860	25
GEN_72	1092659	1092677		YPO_RS05860	18
GEN_72	1093931	1093946		YPO_RS05865	15
GEN_72	1095676	1095698		YPO_RS05870	22
GEN_72	1099296	1099301		YPO_RS05890	5
GEN_72	1106422	1106437		YPO_RS05910	15
GEN_72	1107546	1107550		YPO_RS05915	4
GEN_72	1107977	1107981		YPO_RS05915	4
GEN_72	1108797	1108841		YPO_RS05915	44
GEN_72	1110738	1110772		YPO_RS05920	34
GEN_72	1114307	1114314		YPO_RS05935	7
GEN_72	1116920	1117117		YPO_RS05940	197
GEN_72	1117315	1117323		YPO_RS05940	8
GEN_72	1117389	1117400		YPO_RS05940	11
GEN_72	1117483	1117513		YPO_RS05940	30
GEN_72	1117757	1117780		YPO_RS05940	23
GEN_72	1118007	1118016		YPO_RS05940	9
GEN_72	1118069	1118095		YPO_RS05940	26
GEN_72	1121563	1121573		yapH	10
GEN_72	1122614	1122625		yapH	11
GEN_72	1123973	1123988		yapH	15
GEN_72	1125473	1125477		yapH	4
GEN_72	1125801	1125818		yapH	17
GEN_72	1129569	1129582		yapH	13
GEN_72	1133653	1133670		YPO_RS05965	17
GEN_72	1134597	1134623		YPO_RS05970	26
GEN_72	1135083	1135088		YPO_RS05970	5
GEN_72	1135684	1135696		YPO_RS05970	12
GEN_72	1136101	1136111		YPO_RS05970	10
GEN_72	1137299	1137300		YPO_RS05975	1
GEN_72	1140365	1140410		YPO_RS05985	45
GEN_72	1140532	1140565		YPO_RS05985	33
GEN_72	1140719	1140770		YPO_RS05985	51
GEN_72	1141184	1141196		YPO_RS05985	12
GEN_72	1141394	1141443		YPO_RS05985	49
GEN_72	1141493	1141494		YPO_RS05985	1
GEN_72	1142078	1142084		YPO_RS05985	6
GEN_72	1142217	1142218		YPO_RS05985	1
GEN_72	1142430	1142437		YPO_RS05985	7
GEN_72	1150980	1150983		recC	3
GEN_72	1151726	1151731		recC	5
GEN_72	1153496	1153512		ptrA	16
GEN_72	1154162	1154166		ptrA	4
GEN_72	1156044	1156056		recB	12
GEN_72	1164148	1164182		YPO_RS06050	34
GEN_72	1169955	1169958		YPO_RS06090	3
GEN_72	1171392	1171401		YPO_RS06095	9
GEN_72	1171394	1171431		rlmM	37
GEN_72	1171901	1171924		rlmM	23
GEN_72	1173324	1173330		xni	6
GEN_72	1190462	1190465		ispU	3
GEN_72	1192805	1192822		rseP	17
GEN_72	1197383	1197390		lpxD	7
GEN_72	1204542	1204544		accA	2
GEN_72	1214656	1214678		metI	22
GEN_72	1218074	1218077		YPO_RS06330	3
GEN_72	1221218	1221224		YPO_RS06340	6
GEN_72	1221601	1221603		YPO_RS06340	2
GEN_72	1223362	1223372		dkgB	10
GEN_72	1223568	1223573		dkgB	5
GEN_72	1227698	1227699		gloB	1
GEN_72	1234073	1234079		YPO_RS06415	6
GEN_72	1238141	1238156		YPO_RS06445	15
GEN_72	1238284	1238307		YPO_RS06445	23
GEN_72	1240651	1240669		YPO_RS06465	18
GEN_72	1240935	1240962		YPO_RS06465	27
GEN_72	1241026	1241173		YPO_RS06465	147
GEN_72	1241264	1241269		YPO_RS06465	5
GEN_72	1241535	1241557		YPO_RS06465	22
GEN_72	1241693	1241721		YPO_RS06465	28
GEN_72	1241909	1241927		YPO_RS06465	18
GEN_72	1241992	1242066		YPO_RS06465	74
GEN_72	1242247	1242253		YPO_RS06465	6
GEN_72	1242371	1242375		YPO_RS06470	4
GEN_72	1242426	1242432		YPO_RS06470	6
GEN_72	1242470	1242476		YPO_RS06470	6
GEN_72	1242571	1242664		YPO_RS06470	93
GEN_72	1243033	1243060		YPO_RS06470	27
GEN_72	1243170	1243219		YPO_RS06470	49
GEN_72	1246753	1246807		YPO_RS06495	54
GEN_72	1249012	1249047		recN	35
GEN_72	1249707	1249714		nadK	7
GEN_72	1256076	1256079		YPO_RS06545	3
GEN_72	1257685	1257690		sucA	5
GEN_72	1264781	1264788		cydA	7
GEN_72	1269464	1269466		tolA	2
GEN_72	1269572	1269669		tolA	97
GEN_72	1269747	1269756		tolA	9
GEN_72	1277540	1277554		aroG	14
GEN_72	1279797	1279802		YPO_RS06665	5
GEN_72	1280018	1280020		YPO_RS06670	2
GEN_72	1280108	1280114		YPO_RS06670	6
GEN_72	1286116	1286124		galE	8
GEN_72	1291529	1291537		modA	8
GEN_72	1292906	1292937		modC	31
GEN_72	1293999	1294008		YPO_RS06745	9
GEN_72	1299153	1299157		bioF	4
GEN_72	1305186	1305187		YPO_RS06790	1
GEN_72	1314168	1314170		betI	2
GEN_72	1317355	1317382		YPO_RS06850	27
GEN_72	1317445	1317452		YPO_RS06850	7
GEN_72	1317998	1318042		YPO_RS06850	44
GEN_72	1319538	1319547		xapA	9
GEN_72	1322247	1322249		YPO_RS06875	2
GEN_72	1322379	1322402		YPO_RS06875	23
GEN_72	1322739	1322751		YPO_RS06875	12
GEN_72	1322812	1322843		YPO_RS06875	31
GEN_72	1322948	1322983		YPO_RS06875	35
GEN_72	1324269	1324279		dusC	10
GEN_72	1329971	1330001		YPO_RS06910	30
GEN_72	1331062	1331090		phnC	28
GEN_72	1331241	1331252		phnC	11
GEN_72	1331644	1331654		phnC	10
GEN_72	1331718	1331727		phnD	9
GEN_72	1331876	1331910		phnD	34
GEN_72	1332090	1332092		phnD	2
GEN_72	1332177	1332182		phnD	5
GEN_72	1332593	1332622		phnD	29
GEN_72	1334866	1334882		YPO_RS06940	16
GEN_72	1337283	1337287		urtB	4
GEN_72	1337685	1337688		urtB	3
GEN_72	1338599	1338610		urtB	11
GEN_72	1339120	1339125		urtC	5
GEN_72	1339786	1339801		urtD	15
GEN_72	1341160	1341174		urtE	14
GEN_72	1341688	1341720		YPO_RS06970	32
GEN_72	1346720	1346736		YPO_RS06995	16
GEN_72	1350446	1350460		adiC	14
GEN_72	1355747	1355787		ompF2	40
GEN_72	1357203	1357206		dinG	3
GEN_72	1360391	1360395		YPO_RS07040	4
GEN_72	1366780	1366783		nrdB	3
GEN_72	1375203	1375221		rcsC	18
GEN_72	1377543	1377563		YPO_RS07100	20
GEN_72	1378195	1378200		rcsD	5
GEN_72	1382263	1382282		YPO_RS07115	19
GEN_72	1383252	1383277		YPO_RS07115	25
GEN_72	1390676	1390709		YPO_RS07150	33
GEN_72	1392286	1392317		ycoA	31
GEN_72	1395313	1395319		YPO_RS07175	6
GEN_72	1397851	1397852		YPO_RS07190	1
GEN_72	1397886	1397933		YPO_RS07190	47
GEN_72	1399004	1399017		YPO_RS07195	13
GEN_72	1400717	1400727		YPO_RS07210	10
GEN_72	1405596	1405606		YPO_RS07235	10
GEN_72	1406112	1406115		YPO_RS07235	3
GEN_72	1408723	1408741		YPO_RS07255	18
GEN_72	1408976	1408987		YPO_RS07260	11
GEN_72	1409631	1409657		YPO_RS07265	26
GEN_72	1410537	1410542		YPO_RS07270	5
GEN_72	1410594	1410609		YPO_RS07270	15
GEN_72	1410657	1410685		YPO_RS07270	28
GEN_72	1410917	1410937		YPO_RS07270	20
GEN_72	1411152	1411217		YPO_RS07270	65
GEN_72	1413159	1413200		YPO_RS07280	41
GEN_72	1414368	1414374		YPO_RS07285	6
GEN_72	1414898	1414917		YPO_RS07290	19
GEN_72	1415242	1415272		YPO_RS07290	30
GEN_72	1416442	1416445		YPO_RS07295	3
GEN_72	1427555	1427558		yejF	3
GEN_72	1430138	1430159		YPO_RS07360	21
GEN_72	1431591	1431600		YPO_RS07365	9
GEN_72	1431640	1431671		YPO_RS07365	31
GEN_72	1432793	1432802		YPO_RS07370	9
GEN_72	1433304	1433317		YPO_RS07370	13
GEN_72	1433395	1433413		YPO_RS07370	18
GEN_72	1436476	1436479		YPO_RS07385	3
GEN_72	1437420	1437426		YPO_RS07385	6
GEN_72	1438643	1438670		YPO_RS07390	27
GEN_72	1448544	1448548		YPO_RS07435	4
GEN_72	1448663	1448665		YPO_RS07435	2
GEN_72	1450977	1450982		xylB	5
GEN_72	1451300	1451339		xylB	39
GEN_72	1451373	1451374		xylB	1
GEN_72	1453665	1453666		YPO_RS07455	1
GEN_72	1453865	1453876		YPO_RS07455	11
GEN_72	1459344	1459350		fruA	6
GEN_72	1461776	1461837		YPO_RS07490	61
GEN_72	1461904	1461931		YPO_RS07490	27
GEN_72	1462085	1462107		YPO_RS07490	22
GEN_72	1463379	1463422		YPO_RS07500	43
GEN_72	1463524	1463542		YPO_RS07500	18
GEN_72	1463856	1463864		YPO_RS07500	8
GEN_72	1463977	1463988		YPO_RS07500	11
GEN_72	1464025	1464119		YPO_RS07500	94
GEN_72	1464194	1464200		YPO_RS07500	6
GEN_72	1464945	1464950		psaC	5
GEN_72	1465110	1465139		psaC	29
GEN_72	1467181	1467184		nfo	3
GEN_72	1473094	1473116		YPO_RS07530	22
GEN_72	1473160	1473179		YPO_RS07530	19
GEN_72	1477005	1477018		YPO_RS07545	13
GEN_72	1480341	1480353		YPO_RS07560	12
GEN_72	1482442	1482445		YPO_RS07570	3
GEN_72	1496863	1496888		potF	25
GEN_72	1501749	1501774		rlmC	25
GEN_72	1502847	1502865		YPO_RS07665	18
GEN_72	1505622	1505634		YPO_RS07680	12
GEN_72	1506494	1506520		YPO_RS07685	26
GEN_72	1506762	1506769		YPO_RS07685	7
GEN_72	1507627	1507631		YPO_RS07690	4
GEN_72	1514830	1514856		artJ	26
GEN_72	1515524	1515527		artJ	3
GEN_72	1517037	1517063		YPO_RS07755	26
GEN_72	1519642	1519643		YPO_RS07770	1
GEN_72	1524758	1524763		hcr	5
GEN_72	1527508	1527527		YPO_RS07795	19
GEN_72	1530069	1530078		YPO_RS07805	9
GEN_72	1530774	1530785		YPO_RS07805	11
GEN_72	1536243	1536246		clpA	3
GEN_72	1539723	1539728		aat	5
GEN_72	1539760	1539768		aat	8
GEN_72	1544917	1544929		trxB	12
GEN_72	1545754	1545775		lrp	21
GEN_72	1551355	1551356		YPO_RS07880	1
GEN_72	1557461	1557487		YPO_RS07900	26
GEN_72	1557683	1557694		YPO_RS07900	11
GEN_72	1557698	1557699		YPO_RS07900	1
GEN_72	1563515	1563530		YPO_RS07915	15
GEN_72	1563625	1563631		YPO_RS07915	6
GEN_72	1563862	1563873		ansB	11
GEN_72	1564289	1564301		ansB	12
GEN_72	1565885	1565905		YPO_RS07925	20
GEN_72	1566015	1566032		YPO_RS07925	17
GEN_72	1566091	1566092		YPO_RS07925	1
GEN_72	1566366	1566374		YPO_RS07930	8
GEN_72	1566677	1566683		YPO_RS07930	6
GEN_72	1567515	1567537		YPO_RS07930	22
GEN_72	1567687	1567800		YPO_RS07930	113
GEN_72	1567843	1567896		YPO_RS07930	53
GEN_72	1569498	1569501		serC	3
GEN_72	1571610	1571615		cmk	5
GEN_72	1578638	1578660		msbA	22
GEN_72	1580184	1580188		YPO_RS07975	4
GEN_72	1580762	1580767		YPO_RS07975	5
GEN_72	1580956	1580969		YPO_RS07975	13
GEN_72	1581190	1581193		YPO_RS07975	3
GEN_72	1583658	1583662		kdsB	4
GEN_72	1595089	1595104		ldtD	15
GEN_72	1595731	1595746		ldtD	15
GEN_72	1597049	1597052		YPO_RS08035	3
GEN_72	1599251	1599266		ompF	15
GEN_72	1600861	1600862		asnS	1
GEN_72	1605299	1605322		pepN	23
GEN_72	1607961	1607968		pyrD	7
GEN_72	1608051	1608088		pyrD	37
GEN_72	1622220	1622237		YPO_RS08130	17
GEN_72	1626560	1626564		YPO_RS08160	4
GEN_72	1632406	1632426		YPO_RS08185	20
GEN_72	1637539	1637540		rlmI	1
GEN_72	1646384	1646385		YPO_RS08250	1
GEN_72	1647598	1647601		YPO_RS08260	3
GEN_72	1647643	1647671		YPO_RS08260	28
GEN_72	1649304	1649323		YPO_RS08265	19
GEN_72	1649980	1649983		YPO_RS08270	3
GEN_72	1650022	1650032		YPO_RS08270	10
GEN_72	1650922	1650930		YPO_RS08275	8
GEN_72	1652092	1652100		YPO_RS08280	8
GEN_72	1652102	1652127		YPO_RS08285	25
GEN_72	1652423	1652430		YPO_RS08285	7
GEN_72	1654361	1654371		YPO_RS08300	10
GEN_72	1655257	1655260		YPO_RS08305	3
GEN_72	1656565	1656579		tssB	14
GEN_72	1657151	1657154		tssC	3
GEN_72	1658262	1658265		tssC	3
GEN_72	1659312	1659327		tssK	15
GEN_72	1666946	1666948		YPO_RS08345	2
GEN_72	1668170	1668176		YPO_RS08350	6
GEN_72	1668237	1668239		YPO_RS08350	2
GEN_72	1668336	1668338		YPO_RS08350	2
GEN_72	1669660	1669668		YPO_RS08350	8
GEN_72	1669974	1669984		YPO_RS08350	10
GEN_72	1670166	1670211		YPO_RS08350	45
GEN_72	1670469	1670510		YPO_RS08355	41
GEN_72	1670559	1670579		YPO_RS08355	20
GEN_72	1670732	1670733		YPO_RS08355	1
GEN_72	1670936	1670962		YPO_RS08355	26
GEN_72	1671211	1671227		YPO_RS08355	16
GEN_72	1671642	1671646		YPO_RS08360	4
GEN_72	1673125	1673128		YPO_RS08365	3
GEN_72	1673320	1673340		YPO_RS08365	20
GEN_72	1673387	1673429		YPO_RS08365	42
GEN_72	1673750	1673772		YPO_RS08365	22
GEN_72	1674327	1674341		YPO_RS08370	14
GEN_72	1677058	1677085		YPO_RS08380	27
GEN_72	1677512	1677535		YPO_RS08380	23
GEN_72	1678184	1678185		YPO_RS08385	1
GEN_72	1678440	1678441		YPO_RS08385	1
GEN_72	1679175	1679198		YPO_RS08385	23
GEN_72	1679478	1679493		YPO_RS08385	15
GEN_72	1679883	1679884		YPO_RS08385	1
GEN_72	1680186	1680194		YPO_RS08385	8
GEN_72	1682340	1682348		tssA	8
GEN_72	1683398	1683460		YPO_RS08395	62
GEN_72	1683655	1683693		YPO_RS08395	38
GEN_72	1684040	1684213		YPO_RS08400	173
GEN_72	1684390	1684456		YPO_RS08400	66
GEN_72	1684844	1684862		tssF	18
GEN_72	1685256	1685280		tssF	24
GEN_72	1685796	1685840		tssF	44
GEN_72	1687576	1687587		tssJ	11
GEN_72	1687843	1687851		tssJ	8
GEN_72	1688632	1688637		YPO_RS08425	5
GEN_72	1689203	1689205		YPO_RS08425	2
GEN_72	1690140	1690255		YPO_RS08430	115
GEN_72	1690318	1690387		YPO_RS08430	69
GEN_72	1690426	1690448		YPO_RS08430	22
GEN_72	1690623	1690636		YPO_RS08430	13
GEN_72	1692180	1692182		YPO_RS08435	2
GEN_72	1692442	1692459		YPO_RS08435	17
GEN_72	1693019	1693041		YPO_RS08435	22
GEN_72	1693450	1693473		YPO_RS08440	23
GEN_72	1693728	1693733		YPO_RS08440	5
GEN_72	1693869	1693922		YPO_RS08440	53
GEN_72	1693966	1693989		YPO_RS08445	23
GEN_72	1698337	1698363		darE	26
GEN_72	1698456	1698471		darE	15
GEN_72	1698545	1698581		darE	36
GEN_72	1698667	1698724		darE	57
GEN_72	1699071	1699164		darE	93
GEN_72	1699616	1699618		darD	2
GEN_72	1699799	1699875		darD	76
GEN_72	1700022	1700104		darC	82
GEN_72	1700295	1700362		darC	67
GEN_72	1700498	1700588		darC	90
GEN_72	1700638	1700654		darC	16
GEN_72	1700893	1700900		darC	7
GEN_72	1701019	1701143		darC	124
GEN_72	1701145	1701148		darB	3
GEN_72	1701249	1701286		darB	37
GEN_72	1701345	1701407		darB	62
GEN_72	1701516	1701532		darB	16
GEN_72	1701712	1701720		darB	8
GEN_72	1702077	1702086		darB	9
GEN_72	1702165	1702176		darB	11
GEN_72	1702555	1702668		darB	113
GEN_72	1703138	1703149		darB	11
GEN_72	1703349	1703366		darB	17
GEN_72	1703683	1703740		darA-c	57
GEN_72	1708932	1708935		folE	3
GEN_72	1711412	1711416		mglB	4
GEN_72	1712734	1712775		mglA	41
GEN_72	1714175	1714185		mglC	10
GEN_72	1717426	1717437		YPO_RS08535	11
GEN_72	1722701	1722708		YPO_RS08560	7
GEN_72	1722845	1722848		YPO_RS08560	3
GEN_72	1725927	1725948		YPO_RS08570	21
GEN_72	1726228	1726302		YPO_RS08570	74
GEN_72	1728384	1728385		YPO_RS08580	1
GEN_72	1729380	1729414		metG	34
GEN_72	1730840	1730841		metG	1
GEN_72	1735127	1735138		asmA	11
GEN_72	1738545	1738569		fhuF	24
GEN_72	1738965	1738966		fhuF	1
GEN_72	1739303	1739323		YPO_RS08625	20
GEN_72	1739367	1739381		YPO_RS08625	14
GEN_72	1739485	1739489		YPO_RS08625	4
GEN_72	1740323	1740340		YPO_RS08625	17
GEN_72	1743354	1743375		YPO_RS08640	21
GEN_72	1746798	1746830		YPO_RS08655	32
GEN_72	1751017	1751050		YPO_RS08665	33
GEN_72	1751949	1751960		YPO_RS08670	11
GEN_72	1752060	1752088		YPO_RS08670	28
GEN_72	1752522	1752523		YPO_RS08670	1
GEN_72	1754245	1754247		galU	2
GEN_72	1757885	1757887		YPO_RS08690	2
GEN_72	1766997	1767011		YPO_RS08740	14
GEN_72	1775666	1775718		YPO_RS08785	52
GEN_72	1793804	1793807		YPO_RS08845	3
GEN_72	1794380	1794396		YPO_RS08845	16
GEN_72	1795956	1795977		YPO_RS08855	21
GEN_72	1796042	1796062		YPO_RS08855	20
GEN_72	1796115	1796178		YPO_RS08855	63
GEN_72	1796957	1796990		YPO_RS08860	33
GEN_72	1803168	1803176		YPO_RS08890	8
GEN_72	1803920	1803931		YPO_RS08900	11
GEN_72	1806996	1806997		YPO_RS08905	1
GEN_72	1808305	1808319		bssS	14
GEN_72	1809240	1809246		dinI	6
GEN_72	1815805	1815817		rne	12
GEN_72	1816282	1816285		rne	3
GEN_72	1820854	1820857		plsX	3
GEN_72	1825971	1825983		YPO_RS09005	12
GEN_72	1831347	1831353		YPO_RS09030	6
GEN_72	1835640	1835652		YPO_RS09055	12
GEN_72	1835935	1835940		YPO_RS09055	5
GEN_72	1837419	1837422		thiK	3
GEN_72	1837727	1837757		nagZ	30
GEN_72	1841814	1841831		YPO_RS09085	17
GEN_72	1841995	1842019		YPO_RS09090	24
GEN_72	1842266	1842288		YPO_RS09090	22
GEN_72	1845827	1845844		YPO_RS09105	17
GEN_72	1852691	1852693		lolE	2
GEN_72	1859251	1859256		phoQ	5
GEN_72	1866016	1866023		rluE	7
GEN_72	1870614	1870628		YPO_RS09210	14
GEN_72	1872625	1872638		YPO_RS09215	13
GEN_72	1873446	1873452		YPO_RS09225	6
GEN_72	1878290	1878350		YPO_RS09250	60
GEN_72	1888548	1888564		mgtA	16
GEN_72	1892924	1892927		flhC	3
GEN_72	1899505	1899511		YPO_RS09320	6
GEN_72	1900125	1900129		YPO_RS09325	4
GEN_72	1901682	1901690		YPO_RS09335	8
GEN_72	1904870	1904871		yapJ	1
GEN_72	1905594	1905602		yapJ	8
GEN_72	1905691	1905700		yapJ	9
GEN_72	1907152	1907156		YPO_RS09345	4
GEN_72	1907423	1907444		YPO_RS09345	21
GEN_72	1918291	1918301		YPO_RS09385	10
GEN_72	1918385	1918409		YPO_RS09385	24
GEN_72	1918569	1918574		YPO_RS09385	5
GEN_72	1919054	1919055		YPO_RS09385	1
GEN_72	1919643	1919649		YPO_RS09390	6
GEN_72	1921279	1921301		YPO_RS09390	22
GEN_72	1921508	1921514		YPO_RS09390	6
GEN_72	1922898	1922928		YPO_RS09400	30
GEN_72	1924750	1924757		YPO_RS09405	7
GEN_72	1930594	1930606		YPO_RS09435	12
GEN_72	1930692	1930694		YPO_RS09435	2
GEN_72	1933841	1933851		YPO_RS09455	10
GEN_72	1934343	1934352		YPO_RS09455	9
GEN_72	1936652	1936675		YPO_RS09460	23
GEN_72	1938372	1938374		YPO_RS09475	2
GEN_72	1939320	1939333		YPO_RS09480	13
GEN_72	1943989	1944000		proQ	11
GEN_72	1949826	1949837		YPO_RS09515	11
GEN_72	1957023	1957026		YPO_RS09540	3
GEN_72	1961582	1961588		YPO_RS09560	6
GEN_72	1963146	1963167		YPO_RS09565	21
GEN_72	1963465	1963471		YPO_RS09570	6
GEN_72	1966953	1966965		YPO_RS09585	12
GEN_72	1967586	1967606		YPO_RS09585	20
GEN_72	1967758	1967762		YPO_RS09590	4
GEN_72	1968948	1968960		YPO_RS09590	12
GEN_72	1969841	1969858		kduD	17
GEN_72	1974788	1974837		YPO_RS09620	49
GEN_72	1974894	1974911		YPO_RS09620	17
GEN_72	1978587	1978627		YPO_RS09645	40
GEN_72	1979657	1979674		YPO_RS09650	17
GEN_72	1981315	1981318		YPO_RS09655	3
GEN_72	1983477	1983482		YPO_RS09670	5
GEN_72	1986591	1986612		YPO_RS09700	21
GEN_72	1992197	1992227		YPO_RS09730	30
GEN_72	1992705	1992712		YPO_RS09735	7
GEN_72	1999863	1999880		mntP	17
GEN_72	2000336	2000379		YPO_RS09760	43
GEN_72	2000480	2000505		YPO_RS09760	25
GEN_72	2002782	2002791		manX	9
GEN_72	2004651	2004653		YPO_RS09780	2
GEN_72	2008775	2008779		YPO_RS09800	4
GEN_72	2009435	2009441		YPO_RS09800	6
GEN_72	2010156	2010165		hpaD	9
GEN_72	2011701	2011707		hpaH	6
GEN_72	2011871	2011879		hpaI	8
GEN_72	2012177	2012199		hpaI	22
GEN_72	2013328	2013329		hpaX	1
GEN_72	2013957	2013958		hpaX	1
GEN_72	2014024	2014049		hpaX	25
GEN_72	2015852	2015866		hpaC	14
GEN_72	2019414	2019420		pabB	6
GEN_72	2019661	2019667		pabB	6
GEN_72	2024465	2024475		YPO_RS09875	10
GEN_72	2027154	2027155		YPO_RS09885	1
GEN_72	2027356	2027360		YPO_RS09885	4
GEN_72	2028778	2028790		pip	12
GEN_72	2029962	2029964		ftnA	2
GEN_72	2033175	2033236		YPO_RS09920	61
GEN_72	2036823	2036826		flhA	3
GEN_72	2044898	2044913		flgC	15
GEN_72	2049260	2049264		flgH	4
GEN_72	2050019	2050031		YPO_RS10010	12
GEN_72	2053335	2053338		flgK	3
GEN_72	2054148	2054158		flgK	10
GEN_72	2055535	2055553		YPO_RS10030	18
GEN_72	2059784	2059793		YPO_RS10040	9
GEN_72	2060010	2060023		YPO_RS10045	13
GEN_72	2062921	2062927		YPO_RS10055	6
GEN_72	2063625	2063626		YPO_RS10060	1
GEN_72	2064283	2064294		YPO_RS10060	11
GEN_72	2067977	2067981		fliO	4
GEN_72	2070464	2070474		YPO_RS10110	10
GEN_72	2071186	2071213		YPO_RS10110	27
GEN_72	2071629	2071634		YPO_RS10110	5
GEN_72	2073720	2073732		fliH	12
GEN_72	2075997	2076007		fliF	10
GEN_72	2077443	2077444		fliE	1
GEN_72	2080241	2080275		YPO_RS10165	34
GEN_72	2080882	2080913		YPO_RS10170	31
GEN_72	2081775	2081782		YPO_RS10170	7
GEN_72	2083878	2083881		YPO_RS10175	3
GEN_72	2089061	2089086		fliZ	25
GEN_72	2090036	2090042		YPO_RS10210	6
GEN_72	2090843	2090851		YPO_RS10210	8
GEN_72	2092214	2092217		tcyL	3
GEN_72	2094157	2094158		YPO_RS10235	1
GEN_72	2101603	2101616		YPO_RS10255	13
GEN_72	2103070	2103076		efeB	6
GEN_72	2103750	2103752		efeB	2
GEN_72	2105025	2105032		wrbA	7
GEN_72	2106325	2106333		YPO_RS10275	8
GEN_72	2107442	2107443		cycA	1
GEN_72	2109269	2109275		YPO_RS10290	6
GEN_72	2109508	2109516		YPO_RS10290	8
GEN_72	2112089	2112100		uvrY	11
GEN_72	2117239	2117284		YPO_RS10350	45
GEN_72	2117325	2117358		YPO_RS10350	33
GEN_72	2117604	2117623		YPO_RS10355	19
GEN_72	2117724	2117773		YPO_RS10355	49
GEN_72	2118003	2118123		hcp	120
GEN_72	2118337	2118347		hcp	10
GEN_72	2122634	2122657		YPO_RS10395	23
GEN_72	2123431	2123471		YPO_RS10405	40
GEN_72	2124140	2124149		YPO_RS10405	9
GEN_72	2126052	2126059		YPO_RS10415	7
GEN_72	2126327	2126383		YPO_RS10415	56
GEN_72	2126454	2126552		YPO_RS10415	98
GEN_72	2126653	2126692		YPO_RS10420	39
GEN_72	2126769	2126801		YPO_RS10420	32
GEN_72	2128111	2128115		YPO_RS10430	4
GEN_72	2135575	2135608		YPO_RS10475	33
GEN_72	2135684	2135696		YPO_RS10475	12
GEN_72	2139283	2139284		YPO_RS10505	1
GEN_72	2139392	2139401		YPO_RS10505	9
GEN_72	2142670	2142674		fyuA	4
GEN_72	2143541	2143543		ybtE	2
GEN_72	2145623	2145642		ybtU	19
GEN_72	2146026	2146053		ybtU	27
GEN_72	2146342	2146346		ybtU	4
GEN_72	2146983	2146997		irp1	14
GEN_72	2147151	2147170		irp1	19
GEN_72	2147682	2147684		irp1	2
GEN_72	2148855	2148873		irp1	18
GEN_72	2150864	2150867		irp1	3
GEN_72	2152387	2152394		irp1	7
GEN_72	2153209	2153221		irp1	12
GEN_72	2153716	2153743		irp1	27
GEN_72	2154346	2154349		irp1	3
GEN_72	2154387	2154392		irp1	5
GEN_72	2154540	2154564		irp1	24
GEN_72	2154602	2154603		irp1	1
GEN_72	2155625	2155636		irp1	11
GEN_72	2156587	2156600		irp2	13
GEN_72	2157105	2157111		irp2	6
GEN_72	2158482	2158486		irp2	4
GEN_72	2159094	2159098		irp2	4
GEN_72	2159339	2159352		irp2	13
GEN_72	2160160	2160173		irp2	13
GEN_72	2160540	2160543		irp2	3
GEN_72	2161528	2161529		irp2	1
GEN_72	2162793	2162796		ybtA	3
GEN_72	2163596	2163601		ybtP	5
GEN_72	2164602	2164608		ybtP	6
GEN_72	2164807	2164818		ybtP	11
GEN_72	2165495	2165506		ybtQ	11
GEN_72	2165819	2165857		ybtQ	38
GEN_72	2165963	2165989		ybtQ	26
GEN_72	2166617	2166631		ybtQ	14
GEN_72	2166692	2166725		ybtQ	33
GEN_72	2167011	2167015		ybtQ	4
GEN_72	2167188	2167193		ybtX	5
GEN_72	2167279	2167293		ybtX	14
GEN_72	2167346	2167356		ybtX	10
GEN_72	2169078	2169089		ybtS	11
GEN_72	2169462	2169470		ybtS	8
GEN_72	2176671	2176695		YPO_RS10595	24
GEN_72	2178526	2178536		YPO_RS10605	10
GEN_72	2180456	2180463		YPO_RS10605	7
GEN_72	2181455	2181456		YPO_RS10610	1
GEN_72	2182092	2182105		YPO_RS10615	13
GEN_72	2182501	2182505		YPO_RS10615	4
GEN_72	2186189	2186190		YPO_RS10630	1
GEN_72	2187708	2187770		YPO_RS10640	62
GEN_72	2187795	2187807		YPO_RS10645	12
GEN_72	2188003	2188004		YPO_RS10645	1
GEN_72	2189870	2189878		YPO_RS10655	8
GEN_72	2198185	2198205		YPO_RS10685	20
GEN_72	2209471	2209472		YPO_RS10725	1
GEN_72	2216960	2216964		pgaB	4
GEN_72	2218038	2218039		YPO_RS10760	1
GEN_72	2220286	2220328		YPO_RS10770	42
GEN_72	2227754	2227757		YPO_RS10800	3
GEN_72	2229498	2229502		YPO_RS10805	4
GEN_72	2232450	2232452		astB	2
GEN_72	2237356	2237375		YPO_RS10835	19
GEN_72	2251417	2251421		YPO_RS10900	4
GEN_72	2252952	2252971		YPO_RS10905	19
GEN_72	2252968	2252998		YPO_RS10910	30
GEN_72	2253270	2253307		YPO_RS10910	37
GEN_72	2253383	2253393		YPO_RS10910	10
GEN_72	2254007	2254019		YPO_RS10915	12
GEN_72	2254324	2254337		YPO_RS10915	13
GEN_72	2254943	2254953		YPO_RS10920	10
GEN_72	2255359	2255361		YPO_RS10920	2
GEN_72	2256101	2256185		YPO_RS10925	84
GEN_72	2256523	2256552		YPO_RS10925	29
GEN_72	2258176	2258177		YPO_RS10930	1
GEN_72	2258636	2258652		YPO_RS10935	16
GEN_72	2258986	2259007		YPO_RS10935	21
GEN_72	2259049	2259056		YPO_RS10935	7
GEN_72	2259152	2259165		YPO_RS10935	13
GEN_72	2259750	2259776		YPO_RS10935	26
GEN_72	2259875	2259903		YPO_RS10935	28
GEN_72	2260121	2260152		YPO_RS10935	31
GEN_72	2260791	2260798		YPO_RS10935	7
GEN_72	2263293	2263327		YPO_RS10940	34
GEN_72	2265668	2265672		YPO_RS10955	4
GEN_72	2266227	2266246		YPO_RS10960	19
GEN_72	2266354	2266363		YPO_RS10965	9
GEN_72	2266835	2266841		YPO_RS10965	6
GEN_72	2267194	2267197		YPO_RS10965	3
GEN_72	2267465	2267477		YPO_RS10970	12
GEN_72	2268849	2268869		YPO_RS10975	20
GEN_72	2268921	2268945		YPO_RS10975	24
GEN_72	2269863	2269937		YPO_RS10980	74
GEN_72	2271550	2271553		YPO_RS10985	3
GEN_72	2273865	2273870		YPO_RS11000	5
GEN_72	2274727	2274776		YPO_RS11005	49
GEN_72	2275806	2275818		YPO_RS11005	12
GEN_72	2277258	2277296		YPO_RS11015	38
GEN_72	2277593	2277597		YPO_RS11020	4
GEN_72	2279230	2279235		YPO_RS11025	5
GEN_72	2280591	2280612		YPO_RS11035	21
GEN_72	2280760	2280769		YPO_RS11035	9
GEN_72	2283603	2283607		pth	4
GEN_72	2286923	2286929		ispE	6
GEN_72	2290986	2291017		prmC	31
GEN_72	2294283	2294290		YPO_RS11105	7
GEN_72	2294432	2294433		YPO_RS11110	1
GEN_72	2296659	2296713		YPO_RS11120	54
GEN_72	2299747	2299786		YPO_RS11135	39
GEN_72	2299974	2300030		YPO_RS11135	56
GEN_72	2300860	2300876		YPO_RS11140	16
GEN_72	2303887	2303926		YPO_RS11155	39
GEN_72	2305975	2305976		YPO_RS11175	1
GEN_72	2306897	2306904		YPO_RS11175	7
GEN_72	2316441	2316525		YPO_RS11220	84
GEN_72	2316648	2316658		YPO_RS11220	10
GEN_72	2316937	2316939		YPO_RS11220	2
GEN_72	2317080	2317084		YPO_RS11220	4
GEN_72	2317185	2317219		YPO_RS11220	34
GEN_72	2317322	2317325		YPO_RS11220	3
GEN_72	2317638	2317699		YPO_RS11220	61
GEN_72	2318132	2318163		YPO_RS11225	31
GEN_72	2318933	2318979		YPO_RS11225	46
GEN_72	2319494	2319570		YPO_RS11225	76
GEN_72	2319783	2319805		YPO_RS11225	22
GEN_72	2320057	2320083		YPO_RS11225	26
GEN_72	2320126	2320138		YPO_RS11225	12
GEN_72	2320176	2320181		YPO_RS11225	5
GEN_72	2320424	2320464		YPO_RS11225	40
GEN_72	2320496	2320501		YPO_RS11225	5
GEN_72	2320646	2320651		YPO_RS11225	5
GEN_72	2320742	2320744		YPO_RS11225	2
GEN_72	2321189	2321190		YPO_RS11225	1
GEN_72	2321736	2321737		YPO_RS11225	1
GEN_72	2322184	2322191		YPO_RS11225	7
GEN_72	2322806	2322838		YPO_RS11225	32
GEN_72	2324747	2324766		argS	19
GEN_72	2326781	2326787		cutC	6
GEN_72	2329186	2329198		YPO_RS11255	12
GEN_72	2333426	2333433		nudB	7
GEN_72	2344156	2344180		pyk	24
GEN_72	2355606	2355608		fadD	2
GEN_72	2357261	2357263		rnd	2
GEN_72	2357452	2357461		rnd	9
GEN_72	2360977	2360987		YPO_RS11405	10
GEN_72	2364374	2364390		YPO_RS11425	16
GEN_72	2364455	2364458		YPO_RS11425	3
GEN_72	2364658	2364660		YPO_RS11425	2
GEN_72	2372032	2372038		YPO_RS11490	6
GEN_72	2374002	2374004		YPO_RS11500	2
GEN_72	2376964	2376975		YPO_RS11520	11
GEN_72	2377036	2377044		YPO_RS11520	8
GEN_72	2381197	2381202		YPO_RS11540	5
GEN_72	2381299	2381304		YPO_RS11540	5
GEN_72	2383293	2383300		YPO_RS11555	7
GEN_72	2387916	2387923		YPO_RS11590	7
GEN_72	2388717	2388723		YPO_RS11590	6
GEN_72	2391727	2391732		YPO_RS11605	5
GEN_72	2392082	2392087		YPO_RS11610	5
GEN_72	2395800	2395810		YPO_RS11635	10
GEN_72	2396186	2396230		YPO_RS11640	44
GEN_72	2401524	2401549		YPO_RS11665	25
GEN_72	2401682	2401699		YPO_RS11665	17
GEN_72	2403307	2403312		YPO_RS11680	5
GEN_72	2405320	2405328		YPO_RS11685	8
GEN_72	2409022	2409040		YPO_RS11700	18
GEN_72	2412909	2412922		fadR	13
GEN_72	2416695	2416713		YPO_RS11730	18
GEN_72	2421935	2421936		YPO_RS11750	1
GEN_72	2424439	2424442		yeaG	3
GEN_72	2432926	2432934		sppA	8
GEN_72	2434022	2434069		selD	47
GEN_72	2435670	2435674		YPO_RS11810	4
GEN_72	2439662	2439838		YPO_RS11830	176
GEN_72	2439895	2439929		YPO_RS11830	34
GEN_72	2439993	2440001		YPO_RS11830	8
GEN_72	2440155	2440259		YPO_RS11830	104
GEN_72	2442320	2442321		YPO_RS11850	1
GEN_72	2442320	2442321		purU	1
GEN_72	2442366	2442372		purU	6
GEN_72	2446844	2446848		YPO_RS11870	4
GEN_72	2447286	2447299		YPO_RS11870	13
GEN_72	2450545	2450550		YPO_RS11885	5
GEN_72	2455021	2455063		adhE	42
GEN_72	2457712	2457713		oppA	1
GEN_72	2457831	2457842		oppA	11
GEN_72	2463709	2463775		YPO_RS11930	66
GEN_72	2465291	2465321		cls	30
GEN_72	2468352	2468373		YPO_RS11960	21
GEN_72	2470172	2470173		tonB	1
GEN_72	2472953	2472958		YPO_RS11990	5
GEN_72	2474512	2474518		YPO_RS11995	6
GEN_72	2475824	2475869		YPO_RS12005	45
GEN_72	2477543	2477554		trpA	11
GEN_72	2477600	2477605		trpA	5
GEN_72	2489419	2489432		sohB	13
GEN_72	2490357	2490370		YPO_RS12085	13
GEN_72	2490936	2490942		YPO_RS12090	6
GEN_72	2490980	2490997		YPO_RS12090	17
GEN_72	2491161	2491229		topA	68
GEN_72	2492454	2492457		topA	3
GEN_72	2495006	2495010		cysB	4
GEN_72	2495434	2495450		YPO_RS12105	16
GEN_72	2495832	2495906		YPO_RS12105	74
GEN_72	2495971	2495987		YPO_RS12105	16
GEN_72	2496197	2496203		YPO_RS12105	6
GEN_72	2503060	2503085		YPO_RS12135	25
GEN_72	2503311	2503327		YPO_RS12135	16
GEN_72	2514631	2514635		YPO_RS12190	4
GEN_72	2519275	2519322		YPO_RS12215	47
GEN_72	2523245	2523246		rsxA	1
GEN_72	2529602	2529603		YPO_RS12255	1
GEN_72	2533857	2533862		YPO_RS12270	5
GEN_72	2536848	2536856		YPO_RS12280	8
GEN_72	2541907	2541933		YPO_RS12300	26
GEN_72	2546845	2546851		YPO_RS12320	6
GEN_72	2546937	2546944		YPO_RS12320	7
GEN_72	2547528	2547531		YPO_RS12320	3
GEN_72	2547611	2547654		YPO_RS12320	43
GEN_72	2548340	2548350		YPO_RS12325	10
GEN_72	2549447	2549452		YPO_RS12330	5
GEN_72	2549500	2549512		YPO_RS12330	12
GEN_72	2550506	2550511		YPO_RS12340	5
GEN_72	2551983	2551989		bioD	6
GEN_72	2553149	2553157		clcB	8
GEN_72	2553243	2553254		clcB	11
GEN_72	2554373	2554633		YPO_RS12355	260
GEN_72	2554658	2555065		YPO_RS12360	407
GEN_72	2555162	2555608		YPO_RS12365	446
GEN_72	2555780	2556832		YPO_RS12370	1052
GEN_72	2556844	2557161		YPO_RS12375	317
GEN_72	2557164	2557415		YPO_RS12380	251
GEN_72	2557451	2557684		YPO_RS12385	233
GEN_72	2557749	2559461		YPO_RS12390	1712
GEN_72	2559474	2559761		YPO_RS12395	287
GEN_72	2559765	2560790		YPO_RS12400	1025
GEN_72	2560790	2562034		YPO_RS12405	1244
GEN_72	2562123	2562371		YPO_RS12410	248
GEN_72	2562568	2562765		YPO_RS12415	197
GEN_72	2565808	2565853		YPO_RS12435	45
GEN_72	2565984	2566007		YPO_RS12435	23
GEN_72	2567283	2567286		YPO_RS12440	3
GEN_72	2568165	2568166		YPO_RS12445	1
GEN_72	2576606	2576625		YPO_RS12460	19
GEN_72	2577459	2577464		YPO_RS12465	5
GEN_72	2577513	2577530		YPO_RS12465	17
GEN_72	2577756	2577796		YPO_RS12465	40
GEN_72	2579766	2579780		ilvB	14
GEN_72	2582814	2582869		YPO_RS12495	55
GEN_72	2582956	2582969		YPO_RS12495	13
GEN_72	2606379	2606416		asr	37
GEN_72	2606835	2606844		YPO_RS12590	9
GEN_72	2610047	2610051		hrpA	4
GEN_72	2610620	2610645		hrpA	25
GEN_72	2627897	2627904		ttcA	7
GEN_72	2629228	2629267		YPO_RS12675	39
GEN_72	2630107	2630148		YPO_RS12680	41
GEN_72	2630503	2630534		YPO_RS12680	31
GEN_72	2630644	2630666		YPO_RS12680	22
GEN_72	2630713	2630729		YPO_RS12680	16
GEN_72	2632546	2632563		YPO_RS12690	17
GEN_72	2633316	2633327		YPO_RS12690	11
GEN_72	2638988	2638997		tyrR	9
GEN_72	2651312	2651331		sapD	19
GEN_72	2656395	2656398		dtpA	3
GEN_72	2660579	2660589		gstA	10
GEN_72	2660690	2660709		gstA	19
GEN_72	2662627	2662636		tyrS	9
GEN_72	2662896	2662897		tyrS	1
GEN_72	2665077	2665079		anmK	2
GEN_72	2666686	2666695		rovA	9
GEN_72	2669355	2669368		eptA	13
GEN_72	2669534	2669573		eptA	39
GEN_72	2669830	2669888		eptA	58
GEN_72	2670013	2670049		eptA	36
GEN_72	2675788	2675795		YPO_RS12890	7
GEN_72	2677007	2677013		rnt	6
GEN_72	2677630	2677633		YPO_RS12905	3
GEN_72	2679548	2679552		YPO_RS12915	4
GEN_72	2682868	2682882		YPO_RS12935	14
GEN_72	2687111	2687125		YPO_RS12955	14
GEN_72	2687695	2687698		YPO_RS12960	3
GEN_72	2691802	2691804		YPO_RS12985	2
GEN_72	2699654	2699661		sufC	7
GEN_72	2707932	2707957		rprA	25
GEN_72	2708037	2708038		rprA	1
GEN_72	2710380	2710389		ppsA	9
GEN_72	2715374	2715379		YPO_RS13075	5
GEN_72	2716582	2716602		arnF	20
GEN_72	2723294	2723295		arnB	1
GEN_72	2725883	2725897		btuC	14
GEN_72	2727429	2727442		YPO_RS13140	13
GEN_72	2732528	2732531		rpmI	3
GEN_72	2736546	2736548		YPO_RS13190	2
GEN_72	2738742	2738766		yfeA	24
GEN_72	2745576	2745590		YPO_RS13245	14
GEN_72	2748813	2748832		YPO_RS13255	19
GEN_72	2749106	2749126		YPO_RS13255	20
GEN_72	2754131	2754153		YPO_RS13285	22
GEN_72	2754635	2754641		YPO_RS13285	6
GEN_72	2754964	2755063		YPO_RS13290	99
GEN_72	2755131	2755171		YPO_RS13290	40
GEN_72	2755433	2755505		YPO_RS13290	72
GEN_72	2756817	2756840		YPO_RS13295	23
GEN_72	2757050	2757051		YPO_RS13300	1
GEN_72	2763382	2763404		csy1	22
GEN_72	2763745	2763761		csy1	16
GEN_72	2763972	2763990		csy1	18
GEN_72	2764205	2764217		csy1	12
GEN_72	2772096	2772130		YPO_RS13355	34
GEN_72	2772888	2772900		YPO_RS13355	12
GEN_72	2773230	2773241		YPO_RS13355	11
GEN_72	2773280	2773301		YPO_RS13360	21
GEN_72	2773426	2773452		YPO_RS13360	26
GEN_72	2774519	2774554		YPO_RS13365	35
GEN_72	2774638	2774733		YPO_RS13365	95
GEN_72	2778323	2778379		YPO_RS13380	56
GEN_72	2779772	2779780		YPO_RS13385	8
GEN_72	2780998	2781039		YPO_RS13390	41
GEN_72	2784304	2784331		YPO_RS13405	27
GEN_72	2784809	2784891		YPO_RS13410	82
GEN_72	2785300	2785320		YPO_RS13415	20
GEN_72	2785400	2785418		YPO_RS13415	18
GEN_72	2785618	2785622		YPO_RS13415	4
GEN_72	2786212	2786225		YPO_RS13425	13
GEN_72	2786433	2786463		YPO_RS13430	30
GEN_72	2788753	2788900		YPO_RS13435	147
GEN_72	2789654	2789688		YPO_RS13445	34
GEN_72	2789800	2789853		YPO_RS13445	53
GEN_72	2789900	2789931		YPO_RS13445	31
GEN_72	2790080	2790099		YPO_RS13445	19
GEN_72	2794472	2794476		cdiA	4
GEN_72	2795982	2795989		cdiA	7
GEN_72	2805318	2805325		YPO_RS13475	7
GEN_72	2807251	2807271		YPO_RS13485	20
GEN_72	2807813	2807823		YPO_RS13485	10
GEN_72	2807951	2807966		YPO_RS13485	15
GEN_72	2810255	2810257		YPO_RS13495	2
GEN_72	2810759	2810771		YPO_RS13495	12
GEN_72	2811702	2811728		YPO_RS13500	26
GEN_72	2811903	2811909		YPO_RS13505	6
GEN_72	2813936	2813955		YPO_RS13510	19
GEN_72	2813996	2814070		YPO_RS13510	74
GEN_72	2814135	2814174		YPO_RS13510	39
GEN_72	2814285	2814323		YPO_RS13510	38
GEN_72	2814985	2814995		YPO_RS13515	10
GEN_72	2817749	2817768		rhtA	19
GEN_72	2820818	2820823		YPO_RS13550	5
GEN_72	2821144	2821184		YPO_RS13550	40
GEN_72	2821588	2821616		YPO_RS13550	28
GEN_72	2822638	2822640		glnH	2
GEN_72	2826173	2826177		YPO_RS13570	4
GEN_72	2826323	2826327		YPO_RS13575	4
GEN_72	2829695	2829703		rlmF	8
GEN_72	2829863	2829886		rlmF	23
GEN_72	2830469	2830483		YPO_RS13595	14
GEN_72	2831183	2831223		ybiB	40
GEN_72	2833232	2833248		menE	16
GEN_72	2838150	2838174		menF	24
GEN_72	2838839	2838874		menF	35
GEN_72	2843544	2843559		YPO_RS13645	15
GEN_72	2845071	2845081		YPO_RS13655	10
GEN_72	2845757	2845775		YPO_RS13655	18
GEN_72	2846500	2846503		YPO_RS13660	3
GEN_72	2850218	2850224		YPO_RS13670	6
GEN_72	2852846	2852854		YPO_RS13685	8
GEN_72	2853912	2853971		YPO_RS13690	59
GEN_72	2854046	2854078		YPO_RS13690	32
GEN_72	2854136	2854187		YPO_RS13690	51
GEN_72	2854283	2854300		YPO_RS13690	17
GEN_72	2854385	2854427		YPO_RS13690	42
GEN_72	2854654	2854713		YPO_RS13690	59
GEN_72	2856907	2856916		nuoM	9
GEN_72	2857319	2857336		nuoM	17
GEN_72	2865657	2865673		nuoF	16
GEN_72	2871021	2871057		lrhA	36
GEN_72	2877390	2877396		YPO_RS13780	6
GEN_72	2880457	2880458		ackA	1
GEN_72	2880928	2880936		ackA	8
GEN_72	2885549	2885554		YPO_RS13815	5
GEN_72	2885775	2885788		YPO_RS13815	13
GEN_72	2886124	2886138		YPO_RS13820	14
GEN_72	2886313	2886318		YPO_RS13820	5
GEN_72	2886361	2886364		YPO_RS13820	3
GEN_72	2890734	2890736		YPO_RS13830	2
GEN_72	2893863	2893864		YPO_RS13830	1
GEN_72	2894374	2894375		YPO_RS13835	1
GEN_72	2899033	2899034		iolD	1
GEN_72	2908152	2908159		iolC	7
GEN_72	2910238	2910290		iolB	52
GEN_72	2910493	2910494		YPO_RS13895	1
GEN_72	2910929	2910945		YPO_RS13900	16
GEN_72	2911754	2911784		YPO_RS13900	30
GEN_72	2912807	2912852		YPO_RS13905	45
GEN_72	2913548	2913558		YPO_RS13910	10
GEN_72	2913706	2913710		YPO_RS13915	4
GEN_72	2913975	2913976		YPO_RS13920	1
GEN_72	2914696	2914745		YPO_RS13920	49
GEN_72	2915463	2915481		YPO_RS13925	18
GEN_72	2915570	2915576		YPO_RS13925	6
GEN_72	2915964	2915977		YPO_RS13925	13
GEN_72	2920514	2920515		lipB	1
GEN_72	2921957	2921958		dacA	1
GEN_72	2922466	2922476		dacA	10
GEN_72	2926650	2926665		mrdA	15
GEN_72	2936751	2936756		YPO_RS14035	5
GEN_72	2938836	2938845		lnt	9
GEN_72	2941407	2941411		YPO_RS14055	4
GEN_72	2947056	2947064		asnB	8
GEN_72	2951753	2951757		nagA	4
GEN_72	2954504	2954529		YPO_RS14120	25
GEN_72	2954750	2954796		YPO_RS14120	46
GEN_72	2954893	2954937		YPO_RS14120	44
GEN_72	2957481	2957492		glnS	11
GEN_72	2967681	2967690		YPO_RS14165	9
GEN_72	2975124	2975196		proV	72
GEN_72	2976346	2976364		nrdF	18
GEN_72	2977625	2977626		nrdE	1
GEN_72	2978220	2978221		nrdE	1
GEN_72	2979359	2979366		nrdI	7
GEN_72	2979448	2979460		nrdI	12
GEN_72	2980433	2980491		YPO_RS14235	58
GEN_72	2980544	2980590		YPO_RS14235	46
GEN_72	2981100	2981117		YPO_RS14240	17
GEN_72	2981309	2981334		YPO_RS14240	25
GEN_72	2981739	2981768		YPO_RS14245	29
GEN_72	2982996	2983004		YPO_RS14250	8
GEN_72	2984316	2984321		cspA	5
GEN_72	2989728	2989733		YPO_RS14285	5
GEN_72	2999247	2999279		YPO_RS14330	32
GEN_72	2999779	2999814		YPO_RS14330	35
GEN_72	3000024	3000077		hdeB	53
GEN_72	3000187	3000192		hdeB	5
GEN_72	3001041	3001065		kch	24
GEN_72	3003133	3003173		YPO_RS14355	40
GEN_72	3003238	3003241		YPO_RS14355	3
GEN_72	3003290	3003299		YPO_RS14355	9
GEN_72	3004089	3004095		YPO_RS14360	6
GEN_72	3006644	3006649		chbR	5
GEN_72	3009811	3009818		pgm	7
GEN_72	3010439	3010451		pgm	12
GEN_72	3011081	3011089		pgm	8
GEN_72	3012175	3012221		YPO_RS14405	46
GEN_72	3013570	3013584		kdbD	14
GEN_72	3013672	3013677		kdbD	5
GEN_72	3014525	3014533		kdbD	8
GEN_72	3021092	3021152		YPO_RS14440	60
GEN_72	3024107	3024108		YPO_RS14460	1
GEN_72	3026206	3026220		YPO_RS14470	14
GEN_72	3029189	3029192		YPO_RS14490	3
GEN_72	3030648	3030652		YPO_RS14495	4
GEN_72	3037255	3037264		YPO_RS14530	9
GEN_72	3042138	3042146		YPO_RS14560	8
GEN_72	3042219	3042231		YPO_RS14560	12
GEN_72	3042577	3042660		YPO_RS14560	83
GEN_72	3049050	3049072		YPO_RS14590	22
GEN_72	3051372	3051382		tssL	10
GEN_72	3053081	3053101		tssM	20
GEN_72	3054656	3054663		tssM	7
GEN_72	3054775	3054778		tssM	3
GEN_72	3055087	3055095		tssM	8
GEN_72	3056183	3056206		YPO_RS14610	23
GEN_72	3056264	3056275		YPO_RS14610	11
GEN_72	3059010	3059029		YPO_RS14620	19
GEN_72	3059676	3059697		YPO_RS14620	21
GEN_72	3059796	3059803		YPO_RS14625	7
GEN_72	3060352	3060373		YPO_RS14625	21
GEN_72	3063285	3063316		YPO_RS14645	31
GEN_72	3072330	3072333		YPO_RS14700	3
GEN_72	3073576	3073578		ccmI	2
GEN_72	3074052	3074058		mlaA	6
GEN_72	3077266	3077273		fadI	7
GEN_72	3078862	3078888		fadJ	26
GEN_72	3079921	3079940		fadJ	19
GEN_72	3084138	3084150		aroC	12
GEN_72	3085743	3085774		YPO_RS14760	31
GEN_72	3087660	3087668		mnmC	8
GEN_72	3093489	3093505		YPO_RS14790	16
GEN_72	3096826	3096835		YPO_RS14805	9
GEN_72	3109373	3109375		hisJ	2
GEN_72	3111406	3111408		hisP	2
GEN_72	3113722	3113726		YPO_RS14890	4
GEN_72	3114641	3114652		yfcE	11
GEN_72	3118194	3118213		YPO_RS14910	19
GEN_72	3121234	3121281		YPO_RS14925	47
GEN_72	3122259	3122290		YPO_RS14930	31
GEN_72	3122469	3122484		YPO_RS14930	15
GEN_72	3122810	3122830		YPO_RS14935	20
GEN_72	3122895	3122919		YPO_RS14935	24
GEN_72	3123145	3123215		YPO_RS14940	70
GEN_72	3123308	3123328		YPO_RS14940	20
GEN_72	3123379	3123454		YPO_RS14940	75
GEN_72	3123952	3123977		YPO_RS14945	25
GEN_72	3125110	3125112		yapC	2
GEN_72	3125454	3125460		yapC	6
GEN_72	3126239	3126242		yapC	3
GEN_72	3127177	3127225		YPO_RS14960	48
GEN_72	3128498	3128504		YPO_RS14975	6
GEN_72	3130716	3130721		YPO_RS14980	5
GEN_72	3133371	3133386		YPO_RS14990	15
GEN_72	3140554	3140572		YPO_RS15015	18
GEN_72	3140652	3140665		YPO_RS15015	13
GEN_72	3143540	3143553		YPO_RS15035	13
GEN_72	3145713	3145716		YPO_RS15040	3
GEN_72	3146316	3146320		YPO_RS15040	4
GEN_72	3148010	3148048		YPO_RS15050	38
GEN_72	3151676	3151691		YPO_RS15090	15
GEN_72	3157132	3157133		speG	1
GEN_72	3163684	3163686		YPO_RS15145	2
GEN_72	3164584	3164650		ppk1	66
GEN_72	3165590	3165618		ppk1	28
GEN_72	3165907	3165935		ppk1	28
GEN_72	3173715	3173720		YPO_RS15185	5
GEN_72	3176992	3176994		YPO_RS15195	2
GEN_72	3178014	3178015		YPO_RS15200	1
GEN_72	3180955	3180966		YPO_RS15210	11
GEN_72	3181958	3181983		YPO_RS15210	25
GEN_72	3184173	3184179		mdtC	6
GEN_72	3187751	3187769		YPO_RS15220	18
GEN_72	3194940	3194942		YPO_RS15250	2
GEN_72	3197458	3197492		YPO_RS15265	34
GEN_72	3197538	3197590		YPO_RS15265	52
GEN_72	3197622	3197634		YPO_RS15265	12
GEN_72	3197685	3197713		YPO_RS15265	28
GEN_72	3197827	3197885		YPO_RS15265	58
GEN_72	3198224	3198232		YPO_RS15270	8
GEN_72	3200205	3200229		YPO_RS15285	24
GEN_72	3200275	3200434		YPO_RS15285	159
GEN_72	3200561	3200587		YPO_RS15285	26
GEN_72	3200680	3200969		YPO_RS15290	289
GEN_72	3201023	3201046		YPO_RS15290	23
GEN_72	3201108	3201162		YPO_RS15295	54
GEN_72	3201285	3201356		YPO_RS15295	71
GEN_72	3201480	3201503		YPO_RS15295	23
GEN_72	3201567	3201797		YPO_RS15300	230
GEN_72	3201846	3201881		YPO_RS15300	35
GEN_72	3202231	3202294		YPO_RS15305	63
GEN_72	3209357	3209364		YPO_RS15335	7
GEN_72	3216015	3216016		ispG	1
GEN_72	3216195	3216196		rodZ	1
GEN_72	3218410	3218421		trmG/rlmN	11
GEN_72	3220231	3220237		YPO_RS15385	6
GEN_72	3220292	3220389		YPO_RS15385	97
GEN_72	3221482	3221490		YPO_RS15385	8
GEN_72	3221633	3221857		YPO_RS15385	224
GEN_72	3221922	3221996		YPO_RS15385	74
GEN_72	3222083	3222101		YPO_RS15385	18
GEN_72	3222146	3222166		YPO_RS15385	20
GEN_72	3222321	3222355		YPO_RS15385	34
GEN_72	3222629	3222651		YPO_RS15385	22
GEN_72	3223351	3223352		yapA	1
GEN_72	3223947	3223992		yapA	45
GEN_72	3224182	3224216		yapA	34
GEN_72	3227106	3227108		yapA	2
GEN_72	3228541	3228576		YPO_RS15395	35
GEN_72	3228716	3228755		YPO_RS15395	39
GEN_72	3229197	3229224		YPO_RS15395	27
GEN_72	3229445	3229447		YPO_RS15395	2
GEN_72	3230072	3230079		YPO_RS15395	7
GEN_72	3231856	3231862		YPO_RS15405	6
GEN_72	3241005	3241014		trmJ	9
GEN_72	3246417	3246444		csiE	27
GEN_72	3246584	3246604		YPO_RS15490	20
GEN_72	3247643	3247657		YPO_RS15490	14
GEN_72	3260280	3260332		YPO_RS15550	52
GEN_72	3262449	3262461		YPO_RS15560	12
GEN_72	3262648	3262787		YPO_RS15560	139
GEN_72	3262828	3262898		YPO_RS15560	70
GEN_72	3265835	3265856		purL	21
GEN_72	3270031	3270032		yfhb	1
GEN_72	3276873	3276896		YPO_RS15625	23
GEN_72	3277734	3277745		tssK	11
GEN_72	3278196	3278202		tssK	6
GEN_72	3278232	3278263		tssK	31
GEN_72	3281873	3281877		tssC	4
GEN_72	3282765	3282769		YPO_RS15660	4
GEN_72	3284504	3284505		YPO_RS15665	1
GEN_72	3285804	3285813		YPO_RS15675	9
GEN_72	3287288	3287302		YPO_RS15675	14
GEN_72	3287481	3287492		YPO_RS15680	11
GEN_72	3287545	3287565		YPO_RS15680	20
GEN_72	3287630	3287645		YPO_RS15680	15
GEN_72	3288012	3288016		YPO_RS15680	4
GEN_72	3289234	3289256		tssH	22
GEN_72	3289695	3289724		tssH	29
GEN_72	3292810	3292819		tssF	9
GEN_72	3294580	3294588		tssG	8
GEN_72	3294703	3294709		tssG	6
GEN_72	3295723	3295733		YPO_RS15705	10
GEN_72	3297796	3297826		YPO_RS15710	30
GEN_72	3297888	3297911		YPO_RS15715	23
GEN_72	3297961	3298002		YPO_RS15715	41
GEN_72	3298447	3298454		YPO_RS15715	7
GEN_72	3298919	3298922		YPO_RS15715	3
GEN_72	3299223	3299240		YPO_RS15720	17
GEN_72	3302652	3302711		YPO_RS15735	59
GEN_72	3302804	3302824		YPO_RS15735	20
GEN_72	3306426	3306446		YPO_RS15745	20
GEN_72	3307169	3307172		YPO_RS15750	3
GEN_72	3310564	3310566		YPO_RS15765	2
GEN_72	3310668	3310674		YPO_RS15765	6
GEN_72	3310712	3310728		YPO_RS15765	16
GEN_72	3311437	3311474		YPO_RS15770	37
GEN_72	3311646	3311651		YPO_RS15770	5
GEN_72	3311858	3311897		YPO_RS15770	39
GEN_72	3314067	3314082		YPO_RS15775	15
GEN_72	3314225	3314237		YPO_RS15775	12
GEN_72	3314719	3314723		YPO_RS15775	4
GEN_72	3315962	3315963		YPO_RS15785	1
GEN_72	3320231	3320272		YPO_RS15810	41
GEN_72	3323316	3323317		alaC	1
GEN_72	3324008	3324042		YPO_RS15830	34
GEN_72	3325063	3325072		glk	9
GEN_72	3329953	3329957		YPO_RS15860	4
GEN_72	3344008	3344009		ptsI	1
GEN_72	3352764	3352776		YPO_RS15995	12
GEN_72	3353100	3353115		YPO_RS15995	15
GEN_72	3354062	3354064		YPO_RS15995	2
GEN_72	3354115	3354147		YPO_RS15995	32
GEN_72	3354286	3354333		YPO_RS16000	47
GEN_72	3355622	3355624		YPO_RS16000	2
GEN_72	3355721	3355729		YPO_RS16000	8
GEN_72	3356083	3356146		YPO_RS16010	63
GEN_72	3357579	3357598		YPO_RS16020	19
GEN_72	3358285	3358309		YPO_RS16020	24
GEN_72	3363505	3363549		YPO_RS16040	44
GEN_72	3363714	3363748		YPO_RS16040	34
GEN_72	3363958	3363959		YPO_RS16040	1
GEN_72	3364049	3364052		YPO_RS16040	3
GEN_72	3364158	3364289		YPO_RS16040	131
GEN_72	3364646	3364737		YPO_RS16040	91
GEN_72	3365076	3365134		cysM	58
GEN_72	3373376	3373380		YPO_RS16080	4
GEN_72	3381105	3381131		yapL	26
GEN_72	3383521	3383530		YPO_RS16125	9
GEN_72	3383582	3383629		YPO_RS16125	47
GEN_72	3383757	3383892		YPO_RS16125	135
GEN_72	3385321	3385330		hemF	9
GEN_72	3385577	3385595		hemF	18
GEN_72	3385917	3385921		hemF	4
GEN_72	3388471	3388472		maeB	1
GEN_72	3388809	3388810		maeB	1
GEN_72	3389617	3389664		nudK	47
GEN_72	3393117	3393129		napA	12
GEN_72	3393498	3393503		napA	5
GEN_72	3395754	3395759		YPO_RS16180	5
GEN_72	3399433	3399442		acrD	9
GEN_72	3400344	3400368		YPO_RS16195	24
GEN_72	3402565	3402569		YPO_RS16205	4
GEN_72	3402927	3402931		YPO_RS16205	4
GEN_72	3403243	3403287		YPO_RS16210	44
GEN_72	3403405	3403417		YPO_RS16210	12
GEN_72	3405647	3405654		YPO_RS16220	7
GEN_72	3408097	3408103		YPO_RS16225	6
GEN_72	3409397	3409401		YPO_RS16230	4
GEN_72	3411962	3411968		YPO_RS16250	6
GEN_72	3426923	3426928		hda	5
GEN_72	3430271	3430302		ppiB	31
GEN_72	3430777	3430818		YPO_RS16345	41
GEN_72	3433929	3433933		YPO_RS16360	4
GEN_72	3435316	3435317		YPO_RS16360	1
GEN_72	3437080	3437084		tesA	4
GEN_72	3438650	3438651		YPO_RS16380	1
GEN_72	3445969	3445975		ybaK	6
GEN_72	3449805	3449815		YPO_RS16425	10
GEN_72	3454006	3454025		fepE	19
GEN_72	3454434	3454470		fepE	36
GEN_72	3454574	3454590		fepE	16
GEN_72	3454816	3454853		fepE	37
GEN_72	3454890	3454898		fepE	8
GEN_72	3455885	3455946		cpsG	61
GEN_72	3456548	3456664		YPO_RS16450	116
GEN_72	3456726	3456741		YPO_RS16450	15
GEN_72	3456942	3456949		YPO_RS16450	7
GEN_72	3457107	3457117		YPO_RS16450	10
GEN_72	3457541	3457544		YPO_RS16455	3
GEN_72	3460841	3460865		YPO_RS16470	24
GEN_72	3461370	3461376		YPO_RS16470	6
GEN_72	3461640	3461707		YPO_RS16470	67
GEN_72	3461835	3461854		YPO_RS16470	19
GEN_72	3463321	3463378		YPO_RS16480	57
GEN_72	3463451	3463489		YPO_RS16480	38
GEN_72	3463730	3463971		YPO_RS16480	241
GEN_72	3464072	3464224		YPO_RS16480	152
GEN_72	3464312	3464317		YPO_RS16480	5
GEN_72	3464443	3464463		YPO_RS16480	20
GEN_72	3464843	3464877		YPO_RS16485	34
GEN_72	3465009	3465105		YPO_RS16485	96
GEN_72	3465220	3465248		YPO_RS16485	28
GEN_72	3465309	3465343		YPO_RS16485	34
GEN_72	3465445	3465556		YPO_RS16485	111
GEN_72	3465567	3465603		YPO_RS16490	36
GEN_72	3465715	3465725		YPO_RS16490	10
GEN_72	3465809	3465811		YPO_RS16490	2
GEN_72	3465921	3465926		YPO_RS16490	5
GEN_72	3465956	3465975		YPO_RS16490	19
GEN_72	3466021	3466051		YPO_RS16490	30
GEN_72	3466246	3466460		YPO_RS16490	214
GEN_72	3466591	3466648		YPO_RS16490	57
GEN_72	3466862	3466867		YPO_RS16490	5
GEN_72	3466984	3467007		YPO_RS16495	23
GEN_72	3467529	3467532		YPO_RS16495	3
GEN_72	3467615	3467634		YPO_RS16495	19
GEN_72	3468023	3468052		YPO_RS16495	29
GEN_72	3468137	3468157		YPO_RS16495	20
GEN_72	3468533	3468576		YPO_RS16500	43
GEN_72	3468627	3468715		YPO_RS16500	88
GEN_72	3469102	3469125		YPO_RS16500	23
GEN_72	3469505	3469521		rfbH	16
GEN_72	3469621	3469634		rfbH	13
GEN_72	3470497	3470521		rfbG	24
GEN_72	3472319	3472321		rfbF	2
GEN_72	3472807	3472815		YPO_RS16520	8
GEN_72	3472956	3472967		YPO_RS16520	11
GEN_72	3473066	3473132		YPO_RS16520	66
GEN_72	3473318	3473373		YPO_RS16520	55
GEN_72	3479584	3479596		dnaX	12
GEN_72	3480632	3480640		dnaX	8
GEN_72	3481681	3481691		apt	10
GEN_72	3482090	3482105		apt	15
GEN_72	3483273	3483274		YPO_RS16560	1
GEN_72	3490236	3490269		acrR	33
GEN_72	3492253	3492274		YPO_RS16605	21
GEN_72	3496951	3497030		YPO_RS16620	79
GEN_72	3499373	3499374		YPO_RS16645	1
GEN_72	3509071	3509072		cof	1
GEN_72	3513567	3513571		YPO_RS16705	4
GEN_72	3513702	3513708		YPO_RS16705	6
GEN_72	3516263	3516284		hupB	21
GEN_72	3518213	3518219		lon	6
GEN_72	3518455	3518459		lon	4
GEN_72	3520950	3520977		clpP	27
GEN_72	3527237	3527267		YPO_RS16755	30
GEN_72	3527660	3527664		cyoA	4
GEN_72	3530737	3530742		YPO_RS16770	5
GEN_72	3536313	3536356		yajL	43
GEN_72	3538948	3538949		ispA	1
GEN_72	3547347	3547374		YPO_RS16860	27
GEN_72	3547439	3547574		YPO_RS16860	135
GEN_72	3548001	3548170		YPO_RS16865	169
GEN_72	3551047	3551074		secD	27
GEN_72	3553411	3553412		tgt	1
GEN_72	3557231	3557249		YPO_RS16910	18
GEN_72	3560383	3560414		YPO_RS16925	31
GEN_72	3561097	3561100		malZ	3
GEN_72	3566282	3566305		YPO_RS16945	23
GEN_72	3568253	3568272		phoR	19
GEN_72	3569075	3569084		phoB	9
GEN_72	3574414	3574421		YPO_RS16965	7
GEN_72	3575195	3575198		YPO_RS16970	3
GEN_72	3581021	3581048		YPO_RS17000	27
GEN_72	3583066	3583068		YPO_RS17010	2
GEN_72	3590090	3590128		YPO_RS17045	38
GEN_72	3592389	3592405		YPO_RS17055	16
GEN_72	3592455	3592533		YPO_RS17055	78
GEN_72	3592581	3592657		YPO_RS17055	76
GEN_72	3592915	3592946		YPO_RS17055	31
GEN_72	3592999	3593094		YPO_RS17055	95
GEN_72	3593250	3593300		YPO_RS17055	50
GEN_72	3596067	3596077		pepD	10
GEN_72	3597342	3597360		dinB	18
GEN_72	3598163	3598177		YPO_RS17070	14
GEN_72	3601772	3601777		nqrF	5
GEN_72	3604773	3604774		YPO_RS17105	1
GEN_72	3607251	3607267		YPO_RS17115	16
GEN_72	3610017	3610022		YPO_RS17130	5
GEN_72	3613225	3613247		YPO_RS17140	22
GEN_72	3614488	3614494		YPO_RS17140	6
GEN_72	3615321	3615324		YPO_RS17145	3
GEN_72	3617936	3617958		YPO_RS17145	22
GEN_72	3618865	3618899		YPO_RS17145	34
GEN_72	3619466	3619499		YPO_RS17145	33
GEN_72	3625389	3625413		YPO_RS17170	24
GEN_72	3629927	3629941		YPO_RS17195	14
GEN_72	3632884	3632892		YPO_RS17215	8
GEN_72	3634220	3634226		hpxZ	6
GEN_72	3635272	3635277		YPO_RS17225	5
GEN_72	3636487	3636491		YPO_RS17230	4
GEN_72	3643006	3643027		trxC	21
GEN_72	3644348	3644386		YPO_RS17270	38
GEN_72	3649933	3649936		YPO_RS17290	3
GEN_72	3658830	3658840		rluD	10
GEN_72	3662851	3662916		YPO_RS17350	65
GEN_72	3665916	3665917		tyrA	1
GEN_72	3670303	3670305		YPO_RS17385	2
GEN_72	3670484	3670493		YPO_RS17385	9
GEN_72	3675509	3675518		ffh	9
GEN_72	3679381	3679389		gshA	8
GEN_72	3682300	3682301		YPO_RS17455	1
GEN_72	3682381	3682386		YPO_RS17455	5
GEN_72	3685851	3685856		alaS	5
GEN_72	3700881	3700887		YPO_RS17550	6
GEN_72	3701736	3701743		katG	7
GEN_72	3701886	3701889		katG	3
GEN_72	3703071	3703097		katG	26
GEN_72	3703913	3703949		katG	36
GEN_72	3704382	3704409		cybC	27
GEN_72	3705920	3705928		dmsD	8
GEN_72	3706022	3706037		dmsD	15
GEN_72	3709797	3709803		dmsA	6
GEN_72	3712790	3712811		YPO_RS17595	21
GEN_72	3714664	3714665		YPO_RS17605	1
GEN_72	3725452	3725454		YPO_RS17650	2
GEN_72	3725610	3725615		YPO_RS17650	5
GEN_72	3725690	3725707		YPO_RS17650	17
GEN_72	3728656	3728665		YPO_RS17660	9
GEN_72	3730418	3730423		YPO_RS17670	5
GEN_72	3731748	3731761		YPO_RS17675	13
GEN_72	3732072	3732082		YPO_RS17680	10
GEN_72	3737503	3737515		YPO_RS17705	12
GEN_72	3739408	3739419		YPO_RS17715	11
GEN_72	3751414	3751447		cysC	33
GEN_72	3754889	3754907		cobA	18
GEN_72	3757212	3757214		YPO_RS17810	2
GEN_72	3759113	3759118		cysI	5
GEN_72	3765820	3765827		pyrG	7
GEN_72	3771257	3771258		YPO_RS17870	1
GEN_72	3772095	3772096		barA	1
GEN_72	3779829	3779850		YPO_RS17900	21
GEN_72	3789946	3789955		mrcB	9
GEN_72	3793694	3793699		thpR	5
GEN_72	3796321	3796340		gluQRS	19
GEN_72	3797251	3797254		pcnB	3
GEN_72	3797604	3797608		pcnB	4
GEN_72	3810428	3810437		speD	9
GEN_72	3817422	3817423		lpdA	1
GEN_72	3818801	3818810		aceF	9
GEN_72	3819250	3819271		aceF	21
GEN_72	3820005	3820060		aceF	55
GEN_72	3820301	3820310		aceE	9
GEN_72	3826687	3826688		ampE	1
GEN_72	3830244	3830248		gspE	4
GEN_72	3832214	3832221		hofC	7
GEN_72	3837033	3837054		YPO_RS18135	21
GEN_72	3837119	3837131		YPO_RS18135	12
GEN_72	3844523	3844524		lptG	1
GEN_72	3845738	3845745		lptF	7
GEN_72	3848832	3848846		YPO_RS18185	14
GEN_72	3857034	3857050		YPO_RS18215	16
GEN_72	3858543	3858547		YPO_RS18220	4
GEN_72	3864917	3864924		phnG	7
GEN_72	3868233	3868243		phnK	10
GEN_72	3869246	3869255		phnL	9
GEN_72	3878546	3878551		YPO_RS18325	5
GEN_72	3878777	3878822		YPO_RS18325	45
GEN_72	3879659	3879675		YPO_RS18330	16
GEN_72	3881569	3881580		YPO_RS18335	11
GEN_72	3886517	3886518		YPO_RS18360	1
GEN_72	3887311	3887327		YPO_RS18365	16
GEN_72	3888495	3888497		YPO_RS18370	2
GEN_72	3898034	3898051		nlpI	17
GEN_72	3900893	3900895		YPO_RS18420	2
GEN_72	3901749	3901759		YPO_RS18420	10
GEN_72	3902696	3902704		truB	8
GEN_72	3903560	3903606		truB	46
GEN_72	3906370	3906381		infB	11
GEN_72	3911011	3911013		glmM	2
GEN_72	3917525	3917549		dacB	24
GEN_72	3928675	3928680		mpl	5
GEN_72	3934305	3934309		YPO_RS18585	4
GEN_72	3935165	3935166		YPO_RS18585	1
GEN_72	3938243	3938273		YPO_RS18600	30
GEN_72	3949709	3949740		yjfP	31
GEN_72	3950502	3950529		YPO_RS18675	27
GEN_72	3956671	3956684		rsmI	13
GEN_72	3957193	3957197		YPO_RS18710	4
GEN_72	3958074	3958082		YPO_RS18710	8
GEN_72	3960465	3960466		yraP	1
GEN_72	3963728	3963743		arcB	15
GEN_72	3968466	3968473		gltB	7
GEN_72	3972064	3972077		YPO_RS18755	13
GEN_72	3972722	3972725		YPO_RS18755	3
GEN_72	3975575	3975614		YPO_RS18775	39
GEN_72	3977349	3977352		YPO_RS18790	3
GEN_72	3980188	3980191		degQ	3
GEN_72	3984803	3984819		mlaC	16
GEN_72	3988462	3988466		YPO_RS18850	4
GEN_72	3990507	3990509		kdsC	2
GEN_72	3991135	3991139		lptC	4
GEN_72	3991135	3991139		lptA	4
GEN_72	3993691	3993698		rpoN	7
GEN_72	3997235	3997241		pyrB	6
GEN_72	3998909	3998916		YPO_RS18920	7
GEN_72	4001579	4001580		YPO_RS18935	1
GEN_72	4004069	4004070		tagH	1
GEN_72	4004111	4004118		tagH	7
GEN_72	4005922	4005926		tssK	4
GEN_72	4010352	4010361		tagO	9
GEN_72	4011503	4011569		tssA	66
GEN_72	4014859	4014872		tssM	13
GEN_72	4015063	4015068		tssM	5
GEN_72	4017265	4017266		YPO_RS18995	1
GEN_72	4017815	4017862		YPO_RS19000	47
GEN_72	4018180	4018187		YPO_RS19000	7
GEN_72	4018643	4018660		YPO_RS19000	17
GEN_72	4019098	4019119		YPO_RS19000	21
GEN_72	4019984	4019996		YPO_RS19005	12
GEN_72	4021309	4021311		YPO_RS19010	2
GEN_72	4022056	4022057		YPO_RS19010	1
GEN_72	4024559	4024582		YPO_RS19020	23
GEN_72	4025197	4025206		YPO_RS19025	9
GEN_72	4026658	4026681		YPO_RS19045	23
GEN_72	4027472	4027479		YPO_RS19045	7
GEN_72	4027852	4027870		YPO_RS19045	18
GEN_72	4029401	4029437		YPO_RS19055	36
GEN_72	4033545	4033557		YPO_RS19055	12
GEN_72	4033675	4033714		YPO_RS19060	39
GEN_72	4033767	4033833		YPO_RS19060	66
GEN_72	4033918	4033991		YPO_RS19060	73
GEN_72	4034643	4034714		YPO_RS19065	71
GEN_72	4035254	4035268		YPO_RS19070	14
GEN_72	4036200	4036205		YPO_RS19075	5
GEN_72	4040860	4040861		ssuE	1
GEN_72	4044884	4044905		ssuB	21
GEN_72	4047225	4047226		YPO_RS19135	1
GEN_72	4047588	4047591		YPO_RS19135	3
GEN_72	4050643	4050648		YPO_RS19145	5
GEN_72	4051516	4051524		lpxP	8
GEN_72	4052113	4052114		lpxP	1
GEN_72	4071526	4071539		YPO_RS19240	13
GEN_72	4074065	4074072		dusB	7
GEN_72	4078603	4078609		YPO_RS19285	6
GEN_72	4081761	4081769		msrQ	8
GEN_72	4081932	4081935		msrQ	3
GEN_72	4082220	4082242		msrQ	22
GEN_72	4086444	4086445		csrD	1
GEN_72	4089761	4089765		mreD	4
GEN_72	4093837	4093870		YPO_RS19350	33
GEN_72	4098633	4098681		YPO_RS19365	48
GEN_72	4098828	4098848		YPO_RS19365	20
GEN_72	4098945	4099009		YPO_RS19365	64
GEN_72	4099365	4099448		YPO_RS19365	83
GEN_72	4101627	4101711		YPO_RS19370	84
GEN_72	4101748	4101763		YPO_RS19370	15
GEN_72	4101864	4101909		YPO_RS19370	45
GEN_72	4102136	4102149		YPO_RS19370	13
GEN_72	4104160	4104167		YPO_RS19370	7
GEN_72	4104600	4104622		YPO_RS19375	22
GEN_72	4104961	4104988		YPO_RS19380	27
GEN_72	4110139	4110166		YPO_RS19390	27
GEN_72	4110696	4110700		YPO_RS19395	4
GEN_72	4112300	4112311		YPO_RS19395	11
GEN_72	4112531	4112535		YPO_RS19400	4
GEN_72	4112601	4112625		YPO_RS19400	24
GEN_72	4112690	4112787		YPO_RS19400	97
GEN_72	4112854	4112883		YPO_RS19400	29
GEN_72	4112926	4112942		YPO_RS19400	16
GEN_72	4113064	4113068		YPO_RS19400	4
GEN_72	4113838	4113893		YPO_RS19400	55
GEN_72	4113934	4113940		YPO_RS19405	6
GEN_72	4113983	4114068		YPO_RS19405	85
GEN_72	4114175	4114221		YPO_RS19405	46
GEN_72	4114365	4114367		YPO_RS19405	2
GEN_72	4114539	4114584		YPO_RS19405	45
GEN_72	4116703	4116849		YPO_RS19410	146
GEN_72	4117007	4117008		YPO_RS19410	1
GEN_72	4117262	4117291		YPO_RS19410	29
GEN_72	4117356	4117362		YPO_RS19410	6
GEN_72	4117524	4117537		YPO_RS19410	13
GEN_72	4117884	4117926		aaeR	42
GEN_72	4119152	4119153		YPO_RS19420	1
GEN_72	4125245	4125260		YPO_RS19450	15
GEN_72	4126946	4126948		pmbA	2
GEN_72	4128902	4128933		rnk	31
GEN_72	4131674	4131679		treB	5
GEN_72	4134289	4134314		YPO_RS19490	25
GEN_72	4135526	4135532		YPO_RS19495	6
GEN_72	4135733	4135736		YPO_RS19500	3
GEN_72	4136565	4136571		YPO_RS19500	6
GEN_72	4139204	4139210		tssE	6
GEN_72	4140985	4140992		tssB	7
GEN_72	4141111	4141125		tssB	14
GEN_72	4142761	4142864		YPO_RS19535	103
GEN_72	4142929	4142948		YPO_RS19535	19
GEN_72	4144084	4144085		malM	1
GEN_72	4146326	4146332		malK	6
GEN_72	4147969	4147978		malE	9
GEN_72	4151297	4151308		malG	11
GEN_72	4152815	4152824		pgi	9
GEN_72	4153335	4153336		pgi	1
GEN_72	4156646	4156653		YPO_RS19590	7
GEN_72	4158672	4158676		YPO_RS19595	4
GEN_72	4162433	4162446		YPO_RS19595	13
GEN_72	4162813	4162815		YPO_RS19595	2
GEN_72	4169306	4169309		aceK	3
GEN_72	4169432	4169459		aceK	27
GEN_72	4172080	4172087		aceB	7
GEN_72	4174138	4174153		metA	15
GEN_72	4189933	4189934		rsd	1
GEN_72	4192464	4192471		thiC	7
GEN_72	4193436	4193439		YPO_RS19730	3
GEN_72	4205999	4206003		rplL	4
GEN_72	4212729	4212734		YPO_RS19820	5
GEN_72	4213768	4213775		YPO_RS19825	7
GEN_72	4213921	4213922		YPO_RS19830	1
GEN_72	4215399	4215417		coaA	18
GEN_72	4215668	4215674		birA	6
GEN_72	4215721	4215743		birA	22
GEN_72	4215799	4215808		birA	9
GEN_72	4216389	4216398		birA	9
GEN_72	4216744	4216781		murB	37
GEN_72	4217217	4217218		murB	1
GEN_72	4217457	4217488		murB	31
GEN_72	4223139	4223145		YPO_RS19870	6
GEN_72	4226402	4226406		YPO_RS19895	4
GEN_72	4226956	4226992		YPO_RS19900	36
GEN_72	4233896	4233903		ubiD	7
GEN_72	4240458	4240485		tatB	27
GEN_72	4242454	4242465		ubiB	11
GEN_72	4242670	4242675		ubiB	5
GEN_72	4242757	4242760		ubiB	3
GEN_72	4246201	4246206		YPO_RS19995	5
GEN_72	4251487	4251506		YPO_RS20015	19
GEN_72	4257911	4257932		ugpQ	21
GEN_72	4258492	4258518		YPO_RS20045	26
GEN_72	4258598	4258603		YPO_RS20045	5
GEN_72	4263469	4263485		YPO_RS20065	16
GEN_72	4264100	4264111		YPO_RS20070	11
GEN_72	4264339	4264366		YPO_RS20070	27
GEN_72	4265984	4265991		YPO_RS20070	7
GEN_72	4268250	4268254		YPO_RS20085	4
GEN_72	4269380	4269421		YPO_RS20090	41
GEN_72	4269655	4269673		YPO_RS20095	18
GEN_72	4270019	4270027		YPO_RS20095	8
GEN_72	4271476	4271482		YPO_RS20105	6
GEN_72	4272620	4272629		YPO_RS20110	9
GEN_72	4272838	4272839		YPO_RS20110	1
GEN_72	4280834	4280877		ftsY	43
GEN_72	4281422	4281436		ftsY	14
GEN_72	4283578	4283584		YPO_RS20170	6
GEN_72	4301810	4301812		recQ	2
GEN_72	4301986	4301991		recQ	5
GEN_72	4305449	4305456		corA	7
GEN_72	4305505	4305507		corA	2
GEN_72	4307462	4307466		YPO_RS20275	4
GEN_72	4307895	4307905		YPO_RS20280	10
GEN_72	4310092	4310098		uvrD	6
GEN_72	4310438	4310443		uvrD	5
GEN_72	4315327	4315342		dapF	15
GEN_72	4316910	4316913		YPO_RS20325	3
GEN_72	4319251	4319264		YPO_RS20330	13
GEN_72	4326417	4326429		YPO_RS20380	12
GEN_72	4329845	4329880		wzyE	35
GEN_72	4332357	4332361		rffA	4
GEN_72	4337045	4337051		wecC	6
GEN_72	4337952	4337973		wecB	21
GEN_72	4348449	4348456		rep	7
GEN_72	4349644	4349699		YPO_RS20480	55
GEN_72	4349839	4349843		YPO_RS20480	4
GEN_72	4349927	4350003		YPO_RS20480	76
GEN_72	4350124	4350143		YPO_RS20480	19
GEN_72	4352550	4352558		YPO_RS20490	8
GEN_72	4353474	4353488		YPO_RS20495	14
GEN_72	4353934	4353981		YPO_RS20500	47
GEN_72	4354076	4354087		YPO_RS20500	11
GEN_72	4357560	4357564		stbD	4
GEN_72	4359333	4359372		YPO_RS20515	39
GEN_72	4359439	4359440		YPO_RS20515	1
GEN_72	4360228	4360280		YPO_RS20525	52
GEN_72	4360409	4360432		YPO_RS20530	23
GEN_72	4360797	4360806		YPO_RS20530	9
GEN_72	4364596	4364601		ilvY	5
GEN_72	4366460	4366534		YPO_RS20560	74
GEN_72	4367178	4367186		YPO_RS20565	8
GEN_72	4367236	4367249		YPO_RS20565	13
GEN_72	4367403	4367412		YPO_RS20570	9
GEN_72	4367716	4367741		YPO_RS20570	25
GEN_72	4368044	4368063		YPO_RS20575	19
GEN_72	4368304	4368384		YPO_RS20575	80
GEN_72	4371859	4371860		ilvD	1
GEN_72	4376169	4376173		YPO_RS20610	4
GEN_72	4376528	4376545		YPO_RS20610	17
GEN_72	4398338	4398356		YPO_RS20715	18
GEN_72	4399320	4399323		YPO_RS20720	3
GEN_72	4400743	4400772		YPO_RS20725	29
GEN_72	4401537	4401546		YPO_RS20725	9
GEN_72	4404324	4404334		YPO_RS20735	10
GEN_72	4405594	4405606		YPO_RS20740	12
GEN_72	4405907	4405964		YPO_RS20745	57
GEN_72	4407698	4407706		YPO_RS20745	8
GEN_72	4408265	4408320		YPO_RS20745	55
GEN_72	4408977	4408981		argH	4
GEN_72	4411841	4411847		argC	6
GEN_72	4418025	4418041		YPO_RS20775	16
GEN_72	4418425	4418431		YPO_RS20775	6
GEN_72	4418859	4418870		YPO_RS20775	11
GEN_72	4419786	4419817		YPO_RS20785	31
GEN_72	4420157	4420172		YPO_RS20785	15
GEN_72	4420162	4420172		YPO_RS20790	10
GEN_72	4420300	4420309		YPO_RS20790	9
GEN_72	4421875	4421878		glpD	3
GEN_72	4423419	4423421		glgP	2
GEN_72	4423732	4423751		glgP	19
GEN_72	4423858	4423861		glgP	3
GEN_72	4429294	4429300		glgX	6
GEN_72	4433387	4433394		YPO_RS20825	7
GEN_72	4442708	4442712		YPO_RS20830	4
GEN_72	4443570	4443579		YPO_RS20830	9
GEN_72	4443708	4443718		YPO_RS20830	10
GEN_72	4444003	4444023		YPO_RS20830	20
GEN_72	4445759	4445777		YPO_RS20840	18
GEN_72	4446668	4446676		YPO_RS20855	8
GEN_72	4446757	4446790		YPO_RS20855	33
GEN_72	4446835	4446856		YPO_RS20855	21
GEN_72	4448921	4448929		YPO_RS20865	8
GEN_72	4452730	4452750		gntR	20
GEN_72	4454772	4454775		YPO_RS20900	3
GEN_72	4459406	4459413		YPO_RS20925	7
GEN_72	4472492	4472534		YPO_RS20975	42
GEN_72	4473777	4473780		YPO_RS20975	3
GEN_72	4474085	4474094		rsmJ	9
GEN_72	4474545	4474578		rsmJ	33
GEN_72	4480623	4480682		YPO_RS21000	59
GEN_72	4480652	4480682		YPO_RS21005	30
GEN_72	4480966	4480988		YPO_RS21010	22
GEN_72	4481909	4481963		YPO_RS21010	54
GEN_72	4483588	4483721		YPO_RS21020	133
GEN_72	4483762	4483886		YPO_RS21020	124
GEN_72	4484010	4484019		YPO_RS21020	9
GEN_72	4484193	4484223		YPO_RS21025	30
GEN_72	4484369	4484401		YPO_RS21025	32
GEN_72	4484447	4484480		YPO_RS21025	33
GEN_72	4484583	4484599		YPO_RS21025	16
GEN_72	4484601	4484626		YPO_RS21030	25
GEN_72	4484906	4484988		YPO_RS21030	82
GEN_72	4487420	4487425		yapE	5
GEN_72	4490242	4490243		yhjD	1
GEN_72	4491399	4491403		YPO_RS21050	4
GEN_72	4499629	4499639		YPO_RS21075	10
GEN_72	4502882	4502909		YPO_RS21090	27
GEN_72	4503358	4503366		YPO_RS21090	8
GEN_72	4515982	4516012		YPO_RS21140	30
GEN_72	4516109	4516132		YPO_RS21140	23
GEN_72	4517279	4517332		YPO_RS21140	53
GEN_72	4517692	4517699		YPO_RS21145	7
GEN_72	4518456	4518476		YPO_RS21150	20
GEN_72	4519716	4519723		YPO_RS21155	7
GEN_72	4521847	4521911		YPO_RS21165	64
GEN_72	4526967	4526973		YPO_RS21185	6
GEN_72	4533468	4533482		YPO_RS21205	14
GEN_72	4533668	4533680		YPO_RS21205	12
GEN_72	4533763	4533768		YPO_RS21205	5
GEN_72	4533894	4533945		YPO_RS21205	51
GEN_72	4534350	4534359		YPO_RS21205	9
GEN_72	4534356	4534372		YPO_RS21210	16
GEN_72	4534793	4534893		YPO_RS21210	100
GEN_72	4535141	4535160		YPO_RS21215	19
GEN_72	4540608	4540618		YPO_RS21235	10
GEN_72	4545501	4545520		YPO_RS21280	19
GEN_72	4545598	4545628		YPO_RS21280	30
GEN_72	4545762	4545907		YPO_RS21280	145
GEN_72	4546013	4546015		YPO_RS21280	2
GEN_72	4546287	4546316		YPO_RS21280	29
GEN_72	4546421	4546433		YPO_RS21280	12
GEN_72	4546559	4546626		YPO_RS21280	67
GEN_72	4546613	4546655		YPO_RS21285	42
GEN_72	4551998	4552010		YPO_RS21305	12
GEN_72	4555585	4555590		xylB	5
GEN_72	4557145	4557180		YPO_RS21325	35
GEN_72	4558113	4558141		YPO_RS21330	28
GEN_72	4558506	4558514		YPO_RS21330	8
GEN_72	4561519	4561522		YPO_RS21340	3
GEN_72	4561843	4561867		YPO_RS21340	24
GEN_72	4563867	4563904		YPO_RS21350	37
GEN_72	4564226	4564229		YPO_RS21355	3
GEN_72	4565406	4565425		YPO_RS21355	19
GEN_72	4566126	4566134		YPO_RS21360	8
GEN_72	4567312	4567329		YPO_RS21365	17
GEN_72	4567508	4567512		YPO_RS21365	4
GEN_72	4567665	4567783		YPO_RS21370	118
GEN_72	4568594	4568605		YPO_RS21380	11
GEN_72	4569625	4569640		selB	15
GEN_72	4572507	4572514		YPO_RS21400	7
GEN_72	4573190	4573221		fdhE	31
GEN_72	4574996	4575005		fdxH	9
GEN_72	4581175	4581187		YPO_RS21435	12
GEN_72	4581402	4581406		YPO_RS21435	4
GEN_72	4583325	4583374		YPO_RS21440	49
GEN_72	4583593	4583604		YPO_RS21440	11
GEN_72	4585005	4585033		YPO_RS21450	28
GEN_72	4586399	4586403		YPO_RS21460	4
GEN_72	4588310	4588337		YPO_RS21465	27
GEN_72	4601688	4601731		YPO_RS21520	43
GEN_72	4601877	4601889		YPO_RS21520	12
GEN_72	4612048	4612096		YPO_RS21565	48
GEN_72	4616653	4616654		recF	1
GEN_72	4625932	4625938		YPO_RS21625	6
GEN_72	4626181	4626209		YPO_RS21630	28
GEN_72	4626261	4626325		YPO_RS21630	64
GEN_72	4626524	4626532		YPO_RS21635	8
GEN_72	4626721	4626723		YPO_RS21635	2
GEN_72	4627012	4627030		YPO_RS21635	18
GEN_72	4629422	4629433		YPO_RS21645	11
GEN_72	4633490	4633506		YPO_RS21670	16
GEN_72	4634566	4634571		phoU	5
GEN_72	4641225	4641243		glmU	18
GEN_72	4641376	4641395		glmU	19
GLZ001.A0101_02.YP2.1	1435	1437		YPO_RS01015	2
GLZ001.A0101_02.YP2.1	3996	4077		ravA	81
GLZ001.A0101_02.YP2.1	9168	9175		rbsK	7
GLZ001.A0101_02.YP2.1	10658	10689		YPO_RS01055	31
GLZ001.A0101_02.YP2.1	14916	14918		YPO_RS01080	2
GLZ001.A0101_02.YP2.1	19188	19206		mobB	18
GLZ001.A0101_02.YP2.1	20792	20793		YPO_RS01110	1
GLZ001.A0101_02.YP2.1	23030	23036		polA	6
GLZ001.A0101_02.YP2.1	23896	23914		polA	18
GLZ001.A0101_02.YP2.1	29309	29310		hemN	1
GLZ001.A0101_02.YP2.1	30917	30919		glnG	2
GLZ001.A0101_02.YP2.1	33709	33715		glnA	6
GLZ001.A0101_02.YP2.1	37533	37539		yihX	6
GLZ001.A0101_02.YP2.1	38142	38160		YPO_RS01170	18
GLZ001.A0101_02.YP2.1	41537	41539		fabY	2
GLZ001.A0101_02.YP2.1	44334	44343		YPO_RS01200	9
GLZ001.A0101_02.YP2.1	47792	47803		recG	11
GLZ001.A0101_02.YP2.1	53806	53826		ligB	20
GLZ001.A0101_02.YP2.1	58633	58634		pyrE	1
GLZ001.A0101_02.YP2.1	60401	60407		coaBC	6
GLZ001.A0101_02.YP2.1	62119	62123		YPO_RS01280	4
GLZ001.A0101_02.YP2.1	62235	62240		YPO_RS01280	5
GLZ001.A0101_02.YP2.1	64823	64837		YPO_RS01310	14
GLZ001.A0101_02.YP2.1	68154	68173		rfaF	19
GLZ001.A0101_02.YP2.1	74629	74642		envC	13
GLZ001.A0101_02.YP2.1	74981	74986		gpmM	5
GLZ001.A0101_02.YP2.1	78911	78926		gpsA	15
GLZ001.A0101_02.YP2.1	79219	79237		gpsA	18
GLZ001.A0101_02.YP2.1	82566	82577		cpxA	11
GLZ001.A0101_02.YP2.1	89214	89232		pfkA	18
GLZ001.A0101_02.YP2.1	95576	95589		YPO_RS01460	13
GLZ001.A0101_02.YP2.1	95936	95938		YPO_RS01460	2
GLZ001.A0101_02.YP2.1	96811	96816		tpiA	5
GLZ001.A0101_02.YP2.1	97330	97338		YPO_RS01470	8
GLZ001.A0101_02.YP2.1	102063	102068		YPO_RS01495	5
GLZ001.A0101_02.YP2.1	106581	106588		YPO_RS01520	7
GLZ001.A0101_02.YP2.1	108571	108591		YPO_RS01530	20
GLZ001.A0101_02.YP2.1	111433	111438		rraA	5
GLZ001.A0101_02.YP2.1	112364	112375		YPO_RS01550	11
GLZ001.A0101_02.YP2.1	115467	115472		ftsN	5
GLZ001.A0101_02.YP2.1	116448	116457		cytR	9
GLZ001.A0101_02.YP2.1	123747	123754		YPO_RS01600	7
GLZ001.A0101_02.YP2.1	125792	125796		YPO_RS01600	4
GLZ001.A0101_02.YP2.1	129530	129532		glpG	2
GLZ001.A0101_02.YP2.1	134738	134745		malP	7
GLZ001.A0101_02.YP2.1	142045	142099		feoB	54
GLZ001.A0101_02.YP2.1	142452	142470		feoB	18
GLZ001.A0101_02.YP2.1	146014	146030		YPO_RS01685	16
GLZ001.A0101_02.YP2.1	147199	147227		YPO_RS01685	28
GLZ001.A0101_02.YP2.1	148555	148559		greB	4
GLZ001.A0101_02.YP2.1	151660	151669		pckA	9
GLZ001.A0101_02.YP2.1	152334	152342		pckA	8
GLZ001.A0101_02.YP2.1	153108	153112		hslO	4
GLZ001.A0101_02.YP2.1	155075	155076		YPO_RS01725	1
GLZ001.A0101_02.YP2.1	155173	155174		YPO_RS01725	1
GLZ001.A0101_02.YP2.1	155918	155921		YPO_RS01725	3
GLZ001.A0101_02.YP2.1	159684	159692		mrcA	8
GLZ001.A0101_02.YP2.1	160257	160262		mrcA	5
GLZ001.A0101_02.YP2.1	160830	160838		mrcA	8
GLZ001.A0101_02.YP2.1	163875	163883		hofQ	8
GLZ001.A0101_02.YP2.1	166152	166160		aroB	8
GLZ001.A0101_02.YP2.1	170655	170664		YPO_RS01790	9
GLZ001.A0101_02.YP2.1	170963	170969		trpS	6
GLZ001.A0101_02.YP2.1	177048	177062		YPO_RS01815	14
GLZ001.A0101_02.YP2.1	177511	177531		YPO_RS01815	20
GLZ001.A0101_02.YP2.1	181867	181882		YPO_RS01830	15
GLZ001.A0101_02.YP2.1	183067	183074		YPO_RS01835	7
GLZ001.A0101_02.YP2.1	186313	186315		ppiA	2
GLZ001.A0101_02.YP2.1	194144	194154		YPO_RS01880	10
GLZ001.A0101_02.YP2.1	196677	196711		YPO_RS01895	34
GLZ001.A0101_02.YP2.1	196746	196763		YPO_RS01895	17
GLZ001.A0101_02.YP2.1	198991	198992		YPO_RS01910	1
GLZ001.A0101_02.YP2.1	200867	200878		tauA	11
GLZ001.A0101_02.YP2.1	202484	202489		tauC	5
GLZ001.A0101_02.YP2.1	208378	208391		kefG	13
GLZ001.A0101_02.YP2.1	209268	209269		kefB	1
GLZ001.A0101_02.YP2.1	220821	220824		bfr	3
GLZ001.A0101_02.YP2.1	236346	236366		YPO_RS02185	20
GLZ001.A0101_02.YP2.1	236477	236494		YPO_RS02185	17
GLZ001.A0101_02.YP2.1	236716	236718		mscL	2
GLZ001.A0101_02.YP2.1	236809	236813		mscL	4
GLZ001.A0101_02.YP2.1	238449	238455		trkA	6
GLZ001.A0101_02.YP2.1	240107	240117		fmt	10
GLZ001.A0101_02.YP2.1	240357	240361		fmt	4
GLZ001.A0101_02.YP2.1	242648	242650		dprA	2
GLZ001.A0101_02.YP2.1	251143	251145		acs	2
GLZ001.A0101_02.YP2.1	251532	251551		acs	19
GLZ001.A0101_02.YP2.1	257414	257436		YPO_RS02285	22
GLZ001.A0101_02.YP2.1	257626	257640		YPO_RS02285	14
GLZ001.A0101_02.YP2.1	258002	258006		YPO_RS02285	4
GLZ001.A0101_02.YP2.1	258179	258226		YPO_RS02285	47
GLZ001.A0101_02.YP2.1	258377	258407		YPO_RS02285	30
GLZ001.A0101_02.YP2.1	258770	258775		YPO_RS02290	5
GLZ001.A0101_02.YP2.1	263103	263116		sctI	13
GLZ001.A0101_02.YP2.1	265056	265060		sctL	4
GLZ001.A0101_02.YP2.1	268574	268580		YPO_RS02345	6
GLZ001.A0101_02.YP2.1	275508	275554		YPO_RS02395	46
GLZ001.A0101_02.YP2.1	276959	276985		YPO_RS02400	26
GLZ001.A0101_02.YP2.1	277733	277743		YPO_RS02400	10
GLZ001.A0101_02.YP2.1	278900	278922		metC	22
GLZ001.A0101_02.YP2.1	279365	279370		YPO_RS02410	5
GLZ001.A0101_02.YP2.1	288504	288537		YPO_RS02455	33
GLZ001.A0101_02.YP2.1	288886	288922		YPO_RS02455	36
GLZ001.A0101_02.YP2.1	289432	289447		YPO_RS02460	15
GLZ001.A0101_02.YP2.1	292029	292034		YPO_RS02470	5
GLZ001.A0101_02.YP2.1	292383	292415		YPO_RS02475	32
GLZ001.A0101_02.YP2.1	297447	297463		YPO_RS02500	16
GLZ001.A0101_02.YP2.1	302675	302687		YPO_RS02530	12
GLZ001.A0101_02.YP2.1	304162	304163		YPO_RS02530	1
GLZ001.A0101_02.YP2.1	305738	305741		YPO_RS02535	3
GLZ001.A0101_02.YP2.1	305916	305927		YPO_RS02540	11
GLZ001.A0101_02.YP2.1	307810	307811		YPO_RS02550	1
GLZ001.A0101_02.YP2.1	314212	314214		yapK	2
GLZ001.A0101_02.YP2.1	315078	315118		yapK	40
GLZ001.A0101_02.YP2.1	315860	315864		yapK	4
GLZ001.A0101_02.YP2.1	326035	326040		YPO_RS02605	5
GLZ001.A0101_02.YP2.1	326925	326936		dnaB	11
GLZ001.A0101_02.YP2.1	330050	330062		YPO_RS02620	12
GLZ001.A0101_02.YP2.1	330231	330240		YPO_RS02620	9
GLZ001.A0101_02.YP2.1	331983	331984		uvrA	1
GLZ001.A0101_02.YP2.1	340104	340105		rhaB	1
GLZ001.A0101_02.YP2.1	345041	345119		YPO_RS02690	78
GLZ001.A0101_02.YP2.1	345227	345234		YPO_RS02690	7
GLZ001.A0101_02.YP2.1	346027	346101		YPO_RS02695	74
GLZ001.A0101_02.YP2.1	346655	346679		YPO_RS02695	24
GLZ001.A0101_02.YP2.1	347068	347112		YPO_RS02695	44
GLZ001.A0101_02.YP2.1	347208	347292		YPO_RS02695	84
GLZ001.A0101_02.YP2.1	347386	347408		YPO_RS02695	22
GLZ001.A0101_02.YP2.1	347498	347505		YPO_RS02695	7
GLZ001.A0101_02.YP2.1	347725	347728		YPO_RS02695	3
GLZ001.A0101_02.YP2.1	348009	348044		YPO_RS02695	35
GLZ001.A0101_02.YP2.1	348227	348228		YPO_RS02695	1
GLZ001.A0101_02.YP2.1	350282	350283		aegA	1
GLZ001.A0101_02.YP2.1	351492	351503		aegA	11
GLZ001.A0101_02.YP2.1	355039	355047		YPO_RS02725	8
GLZ001.A0101_02.YP2.1	360798	360803		fxsA	5
GLZ001.A0101_02.YP2.1	360961	360967		fxsA	6
GLZ001.A0101_02.YP2.1	362791	362792		groL	1
GLZ001.A0101_02.YP2.1	371068	371182		YPO_RS02805	114
GLZ001.A0101_02.YP2.1	373596	373627		mscM	31
GLZ001.A0101_02.YP2.1	375050	375059		mscM	9
GLZ001.A0101_02.YP2.1	375274	375275		mscM	1
GLZ001.A0101_02.YP2.1	381876	381880		nnr	4
GLZ001.A0101_02.YP2.1	387203	387215		miaA	12
GLZ001.A0101_02.YP2.1	394691	394695		nsrR	4
GLZ001.A0101_02.YP2.1	396154	396183		rnr	29
GLZ001.A0101_02.YP2.1	397747	397749		rlmB	2
GLZ001.A0101_02.YP2.1	405904	405916		YPO_RS02945	12
GLZ001.A0101_02.YP2.1	407618	407640		YPO_RS02955	22
GLZ001.A0101_02.YP2.1	407803	407817		YPO_RS02955	14
GLZ001.A0101_02.YP2.1	407863	407903		YPO_RS02955	40
GLZ001.A0101_02.YP2.1	408058	408086		YPO_RS02955	28
GLZ001.A0101_02.YP2.1	408129	408226		YPO_RS02955	97
GLZ001.A0101_02.YP2.1	408300	408344		YPO_RS02955	44
GLZ001.A0101_02.YP2.1	408455	408516		YPO_RS02955	61
GLZ001.A0101_02.YP2.1	408638	408696		YPO_RS02955	58
GLZ001.A0101_02.YP2.1	408958	408965		YPO_RS02960	7
GLZ001.A0101_02.YP2.1	409195	409205		YPO_RS02960	10
GLZ001.A0101_02.YP2.1	409309	409322		YPO_RS02960	13
GLZ001.A0101_02.YP2.1	409412	409546		YPO_RS02960	134
GLZ001.A0101_02.YP2.1	409694	409751		YPO_RS02965	57
GLZ001.A0101_02.YP2.1	409793	409916		YPO_RS02965	123
GLZ001.A0101_02.YP2.1	410160	410181		YPO_RS02965	21
GLZ001.A0101_02.YP2.1	410360	410402		YPO_RS02965	42
GLZ001.A0101_02.YP2.1	410538	410624		YPO_RS02965	86
GLZ001.A0101_02.YP2.1	410821	410891		YPO_RS02965	70
GLZ001.A0101_02.YP2.1	409518	409644		YPO_RS02965	126
GLZ001.A0101_02.YP2.1	412242	412252		YPO_RS02980	10
GLZ001.A0101_02.YP2.1	415839	415846		YPO_RS02990	7
GLZ001.A0101_02.YP2.1	416261	416263		YPO_RS02995	2
GLZ001.A0101_02.YP2.1	416427	416459		YPO_RS02995	32
GLZ001.A0101_02.YP2.1	416753	416755		YPO_RS02995	2
GLZ001.A0101_02.YP2.1	419053	419071		YPO_RS03005	18
GLZ001.A0101_02.YP2.1	422448	422449		ptsP	1
GLZ001.A0101_02.YP2.1	423897	423912		ptsP	15
GLZ001.A0101_02.YP2.1	426094	426104		lsrF	10
GLZ001.A0101_02.YP2.1	429110	429124		lsrC	14
GLZ001.A0101_02.YP2.1	431288	431316		YPO_RS03065	28
GLZ001.A0101_02.YP2.1	431374	431379		YPO_RS03065	5
GLZ001.A0101_02.YP2.1	431443	431448		YPO_RS03065	5
GLZ001.A0101_02.YP2.1	432871	432873		lsrK	2
GLZ001.A0101_02.YP2.1	433223	433225		lsrK	2
GLZ001.A0101_02.YP2.1	434122	434124		lsrK	2
GLZ001.A0101_02.YP2.1	435559	435562		rfaQ	3
GLZ001.A0101_02.YP2.1	437966	437980		YPO_RS03090	14
GLZ001.A0101_02.YP2.1	438065	438077		YPO_RS03090	12
GLZ001.A0101_02.YP2.1	442727	442736		YPO_RS03105	9
GLZ001.A0101_02.YP2.1	443238	443239		YPO_RS03110	1
GLZ001.A0101_02.YP2.1	446198	446245		YPO_RS03120	47
GLZ001.A0101_02.YP2.1	446280	446281		YPO_RS03120	1
GLZ001.A0101_02.YP2.1	447860	447861		rsmC	1
GLZ001.A0101_02.YP2.1	449681	449686		rimI	5
GLZ001.A0101_02.YP2.1	451006	451007		prfC	1
GLZ001.A0101_02.YP2.1	454628	454629		YPO_RS03170	1
GLZ001.A0101_02.YP2.1	456154	456160		YPO_RS03175	6
GLZ001.A0101_02.YP2.1	456259	456263		YPO_RS03175	4
GLZ001.A0101_02.YP2.1	459675	459676		deoB	1
GLZ001.A0101_02.YP2.1	465731	465748		nadR	17
GLZ001.A0101_02.YP2.1	470632	470641		YPO_RS03235	9
GLZ001.A0101_02.YP2.1	475412	475426		YPO_RS03245	14
GLZ001.A0101_02.YP2.1	480296	480314		robA	18
GLZ001.A0101_02.YP2.1	481596	481599		arcA	3
GLZ001.A0101_02.YP2.1	491453	491454		mog	1
GLZ001.A0101_02.YP2.1	492239	492250		YPO_RS03325	11
GLZ001.A0101_02.YP2.1	493716	493737		YPO_RS03330	21
GLZ001.A0101_02.YP2.1	494988	495026		YPO_RS03330	38
GLZ001.A0101_02.YP2.1	495124	495237		YPO_RS03330	113
GLZ001.A0101_02.YP2.1	495288	495298		YPO_RS03330	10
GLZ001.A0101_02.YP2.1	495513	495545		YPO_RS03330	32
GLZ001.A0101_02.YP2.1	495673	495807		YPO_RS03330	134
GLZ001.A0101_02.YP2.1	495855	495886		YPO_RS03330	31
GLZ001.A0101_02.YP2.1	495946	495954		YPO_RS03330	8
GLZ001.A0101_02.YP2.1	495987	495995		YPO_RS03330	8
GLZ001.A0101_02.YP2.1	503507	503510		YPO_RS03365	3
GLZ001.A0101_02.YP2.1	504180	504183		ribF	3
GLZ001.A0101_02.YP2.1	504937	504953		ileS	16
GLZ001.A0101_02.YP2.1	518171	518185		YPO_RS03425	14
GLZ001.A0101_02.YP2.1	518850	518854		YPO_RS03430	4
GLZ001.A0101_02.YP2.1	519207	519216		folA	9
GLZ001.A0101_02.YP2.1	522699	522702		apaG	3
GLZ001.A0101_02.YP2.1	529069	529073		djlA	4
GLZ001.A0101_02.YP2.1	530312	530313		rluA	1
GLZ001.A0101_02.YP2.1	532267	532273		YPO_RS03495	6
GLZ001.A0101_02.YP2.1	533203	533234		YPO_RS03500	31
GLZ001.A0101_02.YP2.1	533371	533386		YPO_RS03500	15
GLZ001.A0101_02.YP2.1	533494	533495		YPO_RS03500	1
GLZ001.A0101_02.YP2.1	534623	534632		tssC	9
GLZ001.A0101_02.YP2.1	535077	535110		tssC	33
GLZ001.A0101_02.YP2.1	535207	535214		tssC	7
GLZ001.A0101_02.YP2.1	539954	539964		tssH	10
GLZ001.A0101_02.YP2.1	541832	541836		tssH	4
GLZ001.A0101_02.YP2.1	545277	545281		YPO_RS03545	4
GLZ001.A0101_02.YP2.1	552923	552927		tssM	4
GLZ001.A0101_02.YP2.1	553243	553250		tssM	7
GLZ001.A0101_02.YP2.1	556174	556175		tssM	1
GLZ001.A0101_02.YP2.1	560475	560484		YPO_RS03600	9
GLZ001.A0101_02.YP2.1	562289	562297		YPO_RS03600	8
GLZ001.A0101_02.YP2.1	562640	562654		YPO_RS03600	14
GLZ001.A0101_02.YP2.1	566600	566603		YPO_RS03620	3
GLZ001.A0101_02.YP2.1	566983	566986		YPO_RS03620	3
GLZ001.A0101_02.YP2.1	576132	576140		leuB	8
GLZ001.A0101_02.YP2.1	579535	579552		YPO_RS03675	17
GLZ001.A0101_02.YP2.1	580849	580856		leuO	7
GLZ001.A0101_02.YP2.1	585419	585420		ilvI	1
GLZ001.A0101_02.YP2.1	588029	588068		cra	39
GLZ001.A0101_02.YP2.1	588393	588396		cra	3
GLZ001.A0101_02.YP2.1	588817	588843		YPO_RS03710	26
GLZ001.A0101_02.YP2.1	590596	590606		rsmH	10
GLZ001.A0101_02.YP2.1	592046	592050		YPO_RS03735	4
GLZ001.A0101_02.YP2.1	595320	595369		murF	49
GLZ001.A0101_02.YP2.1	595615	595622		murF	7
GLZ001.A0101_02.YP2.1	598424	598431		murD	7
GLZ001.A0101_02.YP2.1	606761	606762		ftsZ	1
GLZ001.A0101_02.YP2.1	607775	607784		lpxC	9
GLZ001.A0101_02.YP2.1	609202	609204		secM	2
GLZ001.A0101_02.YP2.1	612759	612771		mutT	12
GLZ001.A0101_02.YP2.1	626600	626615		YPO_RS03895	15
GLZ001.A0101_02.YP2.1	631887	631891		YPO_RS03920	4
GLZ001.A0101_02.YP2.1	633937	633940		yapG	3
GLZ001.A0101_02.YP2.1	634241	634248		yapG	7
GLZ001.A0101_02.YP2.1	635489	635517		yapG	28
GLZ001.A0101_02.YP2.1	636246	636247		rlmG	1
GLZ001.A0101_02.YP2.1	642523	642533		YPO_RS03950	10
GLZ001.A0101_02.YP2.1	646390	646396		YPO_RS03970	6
GLZ001.A0101_02.YP2.1	653315	653323		cdiA	8
GLZ001.A0101_02.YP2.1	659220	659226		cdiI	6
GLZ001.A0101_02.YP2.1	659290	659389		cdiI	99
GLZ001.A0101_02.YP2.1	659745	659757		YPO_RS03995	12
GLZ001.A0101_02.YP2.1	660032	660039		YPO_RS04005	7
GLZ001.A0101_02.YP2.1	660145	660182		YPO_RS04005	37
GLZ001.A0101_02.YP2.1	666281	666286		YPO_RS04030	5
GLZ001.A0101_02.YP2.1	667978	667987		YPO_RS04035	9
GLZ001.A0101_02.YP2.1	672503	672515		YPO_RS04045	12
GLZ001.A0101_02.YP2.1	672627	672630		YPO_RS04050	3
GLZ001.A0101_02.YP2.1	673948	673994		YPO_RS04055	46
GLZ001.A0101_02.YP2.1	675965	675985		YPO_RS04065	20
GLZ001.A0101_02.YP2.1	681700	681703		YPO_RS04080	3
GLZ001.A0101_02.YP2.1	685778	685781		YPO_RS04105	3
GLZ001.A0101_02.YP2.1	686077	686082		YPO_RS04105	5
GLZ001.A0101_02.YP2.1	687933	687982		YPO_RS04115	49
GLZ001.A0101_02.YP2.1	688194	688201		YPO_RS04120	7
GLZ001.A0101_02.YP2.1	688310	688342		YPO_RS04120	32
GLZ001.A0101_02.YP2.1	688451	688457		YPO_RS04120	6
GLZ001.A0101_02.YP2.1	696910	696913		YPO_RS04170	3
GLZ001.A0101_02.YP2.1	700109	700112		rpoD	3
GLZ001.A0101_02.YP2.1	702887	702889		dnaG	2
GLZ001.A0101_02.YP2.1	704972	705026		plsY	54
GLZ001.A0101_02.YP2.1	708817	708831		YPO_RS04235	14
GLZ001.A0101_02.YP2.1	712089	712107		glnE	18
GLZ001.A0101_02.YP2.1	715306	715317		hldE	11
GLZ001.A0101_02.YP2.1	723817	723828		tolC	11
GLZ001.A0101_02.YP2.1	728983	728993		YPO_RS04315	10
GLZ001.A0101_02.YP2.1	730476	730487		YPO_RS04320	11
GLZ001.A0101_02.YP2.1	735364	735387		ftsP	23
GLZ001.A0101_02.YP2.1	742709	742724		YPO_RS04370	15
GLZ001.A0101_02.YP2.1	743139	743156		metC	17
GLZ001.A0101_02.YP2.1	743625	743633		metC	8
GLZ001.A0101_02.YP2.1	744806	744821		exbB	15
GLZ001.A0101_02.YP2.1	746429	746430		YPO_RS04390	1
GLZ001.A0101_02.YP2.1	746749	746753		YPO_RS04390	4
GLZ001.A0101_02.YP2.1	746804	746832		YPO_RS04390	28
GLZ001.A0101_02.YP2.1	746915	746949		YPO_RS04390	34
GLZ001.A0101_02.YP2.1	747426	747440		YPO_RS04390	14
GLZ001.A0101_02.YP2.1	747588	747601		YPO_RS04390	13
GLZ001.A0101_02.YP2.1	747765	747808		YPO_RS04390	43
GLZ001.A0101_02.YP2.1	748199	748203		YPO_RS04395	4
GLZ001.A0101_02.YP2.1	748350	748354		YPO_RS04395	4
GLZ001.A0101_02.YP2.1	749064	749075		YPO_RS04405	11
GLZ001.A0101_02.YP2.1	749339	749380		YPO_RS04405	41
GLZ001.A0101_02.YP2.1	749501	749560		YPO_RS04405	59
GLZ001.A0101_02.YP2.1	749610	749645		YPO_RS04405	35
GLZ001.A0101_02.YP2.1	749629	749646		YPO_RS04410	17
GLZ001.A0101_02.YP2.1	749680	749704		YPO_RS04410	24
GLZ001.A0101_02.YP2.1	750055	750127		YPO_RS04410	72
GLZ001.A0101_02.YP2.1	750207	750276		YPO_RS04410	69
GLZ001.A0101_02.YP2.1	750476	750538		YPO_RS04415	62
GLZ001.A0101_02.YP2.1	750613	750618		YPO_RS04415	5
GLZ001.A0101_02.YP2.1	751023	751123		YPO_RS04415	100
GLZ001.A0101_02.YP2.1	751166	751234		YPO_RS04415	68
GLZ001.A0101_02.YP2.1	752014	752023		YPO_RS04420	9
GLZ001.A0101_02.YP2.1	752629	752691		YPO_RS04425	62
GLZ001.A0101_02.YP2.1	753517	753520		YPO_RS04425	3
GLZ001.A0101_02.YP2.1	753729	753756		YPO_RS04425	27
GLZ001.A0101_02.YP2.1	753864	753888		YPO_RS04430	24
GLZ001.A0101_02.YP2.1	753950	753966		YPO_RS04430	16
GLZ001.A0101_02.YP2.1	754566	754569		YPO_RS04440	3
GLZ001.A0101_02.YP2.1	754801	754856		YPO_RS04440	55
GLZ001.A0101_02.YP2.1	755019	755024		YPO_RS04440	5
GLZ001.A0101_02.YP2.1	755174	755186		YPO_RS04440	12
GLZ001.A0101_02.YP2.1	755322	755372		YPO_RS04440	50
GLZ001.A0101_02.YP2.1	755369	755378		YPO_RS04445	9
GLZ001.A0101_02.YP2.1	755512	755533		YPO_RS04445	21
GLZ001.A0101_02.YP2.1	755793	755820		YPO_RS04445	27
GLZ001.A0101_02.YP2.1	755919	755926		YPO_RS04445	7
GLZ001.A0101_02.YP2.1	756199	756235		YPO_RS04445	36
GLZ001.A0101_02.YP2.1	756542	756569		YPO_RS04450	27
GLZ001.A0101_02.YP2.1	756666	756704		YPO_RS04450	38
GLZ001.A0101_02.YP2.1	758924	758925		YPO_RS04465	1
GLZ001.A0101_02.YP2.1	759958	759966		YPO_RS04465	8
GLZ001.A0101_02.YP2.1	761065	761093		YPO_RS04470	28
GLZ001.A0101_02.YP2.1	764048	764053		fepB	5
GLZ001.A0101_02.YP2.1	769115	769133		flhB	18
GLZ001.A0101_02.YP2.1	769859	769867		flhB	8
GLZ001.A0101_02.YP2.1	770359	770364		YPO_RS04505	5
GLZ001.A0101_02.YP2.1	772027	772042		fliN	15
GLZ001.A0101_02.YP2.1	772522	772547		YPO_RS04525	25
GLZ001.A0101_02.YP2.1	772588	772599		YPO_RS04525	11
GLZ001.A0101_02.YP2.1	772956	772995		YPO_RS04525	39
GLZ001.A0101_02.YP2.1	775048	775054		fliE	6
GLZ001.A0101_02.YP2.1	775418	775429		fliF	11
GLZ001.A0101_02.YP2.1	777775	777796		YPO_RS04550	21
GLZ001.A0101_02.YP2.1	782230	782249		flgA	19
GLZ001.A0101_02.YP2.1	782883	782892		flgC	9
GLZ001.A0101_02.YP2.1	783939	783955		flaE	16
GLZ001.A0101_02.YP2.1	785297	785312		YPO_RS04600	15
GLZ001.A0101_02.YP2.1	789853	789856		flgK	3
GLZ001.A0101_02.YP2.1	790311	790326		flgK	15
GLZ001.A0101_02.YP2.1	791128	791141		flgK	13
GLZ001.A0101_02.YP2.1	791200	791218		flgL	18
GLZ001.A0101_02.YP2.1	791349	791358		flgL	9
GLZ001.A0101_02.YP2.1	793738	793765		YPO_RS04655	27
GLZ001.A0101_02.YP2.1	793896	793923		YPO_RS04655	27
GLZ001.A0101_02.YP2.1	796054	796089		YPO_RS04660	35
GLZ001.A0101_02.YP2.1	797795	797827		YPO_RS04665	32
GLZ001.A0101_02.YP2.1	801495	801507		fliS	12
GLZ001.A0101_02.YP2.1	801819	801847		YPO_RS04685	28
GLZ001.A0101_02.YP2.1	802251	802256		YPO_RS04690	5
GLZ001.A0101_02.YP2.1	803438	803444		YPO_RS04695	6
GLZ001.A0101_02.YP2.1	803557	803567		YPO_RS04695	10
GLZ001.A0101_02.YP2.1	803710	803715		YPO_RS04700	5
GLZ001.A0101_02.YP2.1	804361	804396		YPO_RS04700	35
GLZ001.A0101_02.YP2.1	806677	806686		YPO_RS04715	9
GLZ001.A0101_02.YP2.1	807001	807012		YPO_RS04715	11
GLZ001.A0101_02.YP2.1	807071	807093		YPO_RS04715	22
GLZ001.A0101_02.YP2.1	807648	807698		YPO_RS04720	50
GLZ001.A0101_02.YP2.1	807690	807698		YPO_RS04725	8
GLZ001.A0101_02.YP2.1	807788	807792		YPO_RS04725	4
GLZ001.A0101_02.YP2.1	808980	809020		YPO_RS04735	40
GLZ001.A0101_02.YP2.1	809127	809241		YPO_RS04735	114
GLZ001.A0101_02.YP2.1	816384	816417		YPO_RS04765	33
GLZ001.A0101_02.YP2.1	816452	816453		YPO_RS04765	1
GLZ001.A0101_02.YP2.1	816676	816682		YPO_RS04765	6
GLZ001.A0101_02.YP2.1	816731	816737		YPO_RS04765	6
GLZ001.A0101_02.YP2.1	817182	817191		YPO_RS04770	9
GLZ001.A0101_02.YP2.1	819919	819939		YPO_RS04770	20
GLZ001.A0101_02.YP2.1	822645	822648		vgrG	3
GLZ001.A0101_02.YP2.1	833835	833844		YPO_RS04800	9
GLZ001.A0101_02.YP2.1	834088	834113		YPO_RS04800	25
GLZ001.A0101_02.YP2.1	836035	836037		YPO_RS04805	2
GLZ001.A0101_02.YP2.1	836104	836108		YPO_RS04805	4
GLZ001.A0101_02.YP2.1	836184	836203		YPO_RS04805	19
GLZ001.A0101_02.YP2.1	838172	838180		YPO_RS04810	8
GLZ001.A0101_02.YP2.1	838841	838919		YPO_RS04815	78
GLZ001.A0101_02.YP2.1	841221	841224		YPO_RS04825	3
GLZ001.A0101_02.YP2.1	842070	842080		YPO_RS04830	10
GLZ001.A0101_02.YP2.1	843613	843645		YPO_RS04835	32
GLZ001.A0101_02.YP2.1	845405	845616		YPO_RS04835	211
GLZ001.A0101_02.YP2.1	846778	846786		YPO_RS04835	8
GLZ001.A0101_02.YP2.1	848609	848622		YPO_RS04835	13
GLZ001.A0101_02.YP2.1	850376	850381		YPO_RS04845	5
GLZ001.A0101_02.YP2.1	851734	851747		YPO_RS04845	13
GLZ001.A0101_02.YP2.1	854315	854319		YPO_RS04845	4
GLZ001.A0101_02.YP2.1	858884	858887		YPO_RS04860	3
GLZ001.A0101_02.YP2.1	859173	859176		YPO_RS04860	3
GLZ001.A0101_02.YP2.1	872599	872608		YPO_RS04915	9
GLZ001.A0101_02.YP2.1	883209	883212		YPO_RS04955	3
GLZ001.A0101_02.YP2.1	883532	883547		YPO_RS04955	15
GLZ001.A0101_02.YP2.1	883614	883638		YPO_RS04955	24
GLZ001.A0101_02.YP2.1	884208	884243		YPO_RS04965	35
GLZ001.A0101_02.YP2.1	884307	884383		YPO_RS04965	76
GLZ001.A0101_02.YP2.1	884437	884462		YPO_RS04965	25
GLZ001.A0101_02.YP2.1	884819	884823		YPO_RS04965	4
GLZ001.A0101_02.YP2.1	884901	884907		YPO_RS04965	6
GLZ001.A0101_02.YP2.1	885548	885550		YPO_RS04975	2
GLZ001.A0101_02.YP2.1	885666	885717		YPO_RS04975	51
GLZ001.A0101_02.YP2.1	886236	886239		YPO_RS04975	3
GLZ001.A0101_02.YP2.1	886326	886334		YPO_RS04975	8
GLZ001.A0101_02.YP2.1	886575	886679		YPO_RS04980	104
GLZ001.A0101_02.YP2.1	886757	886769		YPO_RS04980	12
GLZ001.A0101_02.YP2.1	886963	887017		gspL	54
GLZ001.A0101_02.YP2.1	887077	887126		gspL	49
GLZ001.A0101_02.YP2.1	887335	887346		gspL	11
GLZ001.A0101_02.YP2.1	887534	887540		gspL	6
GLZ001.A0101_02.YP2.1	887745	887764		gspL	19
GLZ001.A0101_02.YP2.1	887823	887833		gspL	10
GLZ001.A0101_02.YP2.1	888117	888197		YPO_RS04990	80
GLZ001.A0101_02.YP2.1	888230	888290		YPO_RS04990	60
GLZ001.A0101_02.YP2.1	888459	888474		YPO_RS04990	15
GLZ001.A0101_02.YP2.1	888611	888623		YPO_RS04990	12
GLZ001.A0101_02.YP2.1	888744	888746		YPO_RS04990	2
GLZ001.A0101_02.YP2.1	888961	888965		YPO_RS04990	4
GLZ001.A0101_02.YP2.1	889189	889236		gspJ	47
GLZ001.A0101_02.YP2.1	889405	889410		gspJ	5
GLZ001.A0101_02.YP2.1	889625	889628		gspI	3
GLZ001.A0101_02.YP2.1	889878	889884		gspI	6
GLZ001.A0101_02.YP2.1	889942	889943		gspI	1
GLZ001.A0101_02.YP2.1	889984	890042		YPO_RS05005	58
GLZ001.A0101_02.YP2.1	890947	890954		gspG	7
GLZ001.A0101_02.YP2.1	892456	892458		gspE	2
GLZ001.A0101_02.YP2.1	893499	893513		gspE	14
GLZ001.A0101_02.YP2.1	893734	893815		gspD	81
GLZ001.A0101_02.YP2.1	893882	893896		gspD	14
GLZ001.A0101_02.YP2.1	894056	894062		gspD	6
GLZ001.A0101_02.YP2.1	894330	894339		gspD	9
GLZ001.A0101_02.YP2.1	894422	894484		gspD	62
GLZ001.A0101_02.YP2.1	894693	894743		gspD	50
GLZ001.A0101_02.YP2.1	894780	894784		gspD	4
GLZ001.A0101_02.YP2.1	894828	894869		gspD	41
GLZ001.A0101_02.YP2.1	894919	894970		gspD	51
GLZ001.A0101_02.YP2.1	895435	895477		gspD	42
GLZ001.A0101_02.YP2.1	895549	895570		gspD	21
GLZ001.A0101_02.YP2.1	895687	895777		YPO_RS05030	90
GLZ001.A0101_02.YP2.1	895894	895945		YPO_RS05030	51
GLZ001.A0101_02.YP2.1	896123	896190		YPO_RS05030	67
GLZ001.A0101_02.YP2.1	896258	896268		YPO_RS05035	10
GLZ001.A0101_02.YP2.1	896319	896344		YPO_RS05035	25
GLZ001.A0101_02.YP2.1	896625	896674		YPO_RS05035	49
GLZ001.A0101_02.YP2.1	897417	897434		YPO_RS05040	17
GLZ001.A0101_02.YP2.1	900838	900842		yapM	4
GLZ001.A0101_02.YP2.1	901334	901342		yapM	8
GLZ001.A0101_02.YP2.1	902025	902028		yapM	3
GLZ001.A0101_02.YP2.1	902622	902645		yapM	23
GLZ001.A0101_02.YP2.1	904004	904005		YPO_RS05060	1
GLZ001.A0101_02.YP2.1	908126	908128		tnpA	2
GLZ001.A0101_02.YP2.1	912201	912203		kbaZ	2
GLZ001.A0101_02.YP2.1	918874	918877		kduD	3
GLZ001.A0101_02.YP2.1	919224	919227		kduD	3
GLZ001.A0101_02.YP2.1	920176	920196		YPO_RS05130	20
GLZ001.A0101_02.YP2.1	923124	923138		YPO_RS05140	14
GLZ001.A0101_02.YP2.1	923256	923265		YPO_RS05140	9
GLZ001.A0101_02.YP2.1	928724	928726		YPO_RS05165	2
GLZ001.A0101_02.YP2.1	932949	932961		YPO_RS05175	12
GLZ001.A0101_02.YP2.1	934534	934544		YPO_RS05180	10
GLZ001.A0101_02.YP2.1	935011	935013		YPO_RS05180	2
GLZ001.A0101_02.YP2.1	935329	935334		YPO_RS05180	5
GLZ001.A0101_02.YP2.1	937458	937463		YPO_RS05190	5
GLZ001.A0101_02.YP2.1	937847	937854		YPO_RS05190	7
GLZ001.A0101_02.YP2.1	940558	940571		YPO_RS05205	13
GLZ001.A0101_02.YP2.1	945325	945330		YPO_RS05220	5
GLZ001.A0101_02.YP2.1	945562	945572		YPO_RS05220	10
GLZ001.A0101_02.YP2.1	946218	946259		YPO_RS05220	41
GLZ001.A0101_02.YP2.1	946955	946962		YPO_RS05225	7
GLZ001.A0101_02.YP2.1	950082	950107		YPO_RS05235	25
GLZ001.A0101_02.YP2.1	950162	950223		YPO_RS05235	61
GLZ001.A0101_02.YP2.1	950315	950332		YPO_RS05235	17
GLZ001.A0101_02.YP2.1	951505	951508		YPO_RS05240	3
GLZ001.A0101_02.YP2.1	953644	953670		YPO_RS05260	26
GLZ001.A0101_02.YP2.1	953696	953758		YPO_RS05260	62
GLZ001.A0101_02.YP2.1	954317	954326		YPO_RS05260	9
GLZ001.A0101_02.YP2.1	957688	957694		YPO_RS05270	6
GLZ001.A0101_02.YP2.1	957794	957796		YPO_RS05270	2
GLZ001.A0101_02.YP2.1	957889	957904		YPO_RS05270	15
GLZ001.A0101_02.YP2.1	958457	958488		YPO_RS05275	31
GLZ001.A0101_02.YP2.1	959558	959572		YPO_RS05290	14
GLZ001.A0101_02.YP2.1	959635	959637		YPO_RS05290	2
GLZ001.A0101_02.YP2.1	960674	960683		YPO_RS05290	9
GLZ001.A0101_02.YP2.1	963241	963244		YPO_RS05300	3
GLZ001.A0101_02.YP2.1	964231	964242		YPO_RS05320	11
GLZ001.A0101_02.YP2.1	965345	965346		YPO_RS05330	1
GLZ001.A0101_02.YP2.1	968124	968129		YPO_RS05340	5
GLZ001.A0101_02.YP2.1	977000	977004		dsbC	4
GLZ001.A0101_02.YP2.1	978707	978720		creD	13
GLZ001.A0101_02.YP2.1	985867	985878		YPO_RS05435	11
GLZ001.A0101_02.YP2.1	986757	986760		YPO_RS05440	3
GLZ001.A0101_02.YP2.1	987116	987118		YPO_RS05440	2
GLZ001.A0101_02.YP2.1	997702	997707		ubiI	5
GLZ001.A0101_02.YP2.1	1001249	1001263		YPO_RS05490	14
GLZ001.A0101_02.YP2.1	1001931	1001937		zapA	6
GLZ001.A0101_02.YP2.1	1002131	1002133		ssrS	2
GLZ001.A0101_02.YP2.1	1006560	1006561		YPO_RS05520	1
GLZ001.A0101_02.YP2.1	1007801	1007806		argO	5
GLZ001.A0101_02.YP2.1	1015318	1015335		YPO_RS05560	17
GLZ001.A0101_02.YP2.1	1027611	1027612		gshB	1
GLZ001.A0101_02.YP2.1	1032624	1032626		YPO_RS05640	2
GLZ001.A0101_02.YP2.1	1032931	1032939		YPO_RS05645	8
GLZ001.A0101_02.YP2.1	1038503	1038552		YPO_RS05675	49
GLZ001.A0101_02.YP2.1	1038760	1038780		YPO_RS05675	20
GLZ001.A0101_02.YP2.1	1038959	1038964		YPO_RS05675	5
GLZ001.A0101_02.YP2.1	1039304	1039313		YPO_RS05675	9
GLZ001.A0101_02.YP2.1	1039756	1039769		YPO_RS05675	13
GLZ001.A0101_02.YP2.1	1039849	1039865		YPO_RS05675	16
GLZ001.A0101_02.YP2.1	1040060	1040067		YPO_RS05675	7
GLZ001.A0101_02.YP2.1	1040305	1040320		YPO_RS05675	15
GLZ001.A0101_02.YP2.1	1040758	1040766		YPO_RS05675	8
GLZ001.A0101_02.YP2.1	1040850	1040904		YPO_RS05675	54
GLZ001.A0101_02.YP2.1	1040937	1040966		YPO_RS05675	29
GLZ001.A0101_02.YP2.1	1041580	1041591		YPO_RS05675	11
GLZ001.A0101_02.YP2.1	1042057	1042068		YPO_RS05675	11
GLZ001.A0101_02.YP2.1	1042510	1042521		YPO_RS05675	11
GLZ001.A0101_02.YP2.1	1042841	1042875		YPO_RS05675	34
GLZ001.A0101_02.YP2.1	1042937	1042944		YPO_RS05675	7
GLZ001.A0101_02.YP2.1	1043407	1043418		YPO_RS05675	11
GLZ001.A0101_02.YP2.1	1043468	1043469		YPO_RS05675	1
GLZ001.A0101_02.YP2.1	1043763	1043789		YPO_RS05675	26
GLZ001.A0101_02.YP2.1	1043892	1043895		YPO_RS05675	3
GLZ001.A0101_02.YP2.1	1043952	1043979		YPO_RS05675	27
GLZ001.A0101_02.YP2.1	1044045	1044101		YPO_RS05675	56
GLZ001.A0101_02.YP2.1	1044209	1044214		YPO_RS05675	5
GLZ001.A0101_02.YP2.1	1044404	1044531		YPO_RS05675	127
GLZ001.A0101_02.YP2.1	1044615	1044665		YPO_RS05675	50
GLZ001.A0101_02.YP2.1	1044972	1045107		YPO_RS05675	135
GLZ001.A0101_02.YP2.1	1045180	1045223		YPO_RS05675	43
GLZ001.A0101_02.YP2.1	1045534	1045602		YPO_RS05675	68
GLZ001.A0101_02.YP2.1	1046026	1046041		YPO_RS05675	15
GLZ001.A0101_02.YP2.1	1046282	1046283		YPO_RS05675	1
GLZ001.A0101_02.YP2.1	1046488	1046502		YPO_RS05675	14
GLZ001.A0101_02.YP2.1	1046554	1046588		YPO_RS05675	34
GLZ001.A0101_02.YP2.1	1046653	1046726		YPO_RS05675	73
GLZ001.A0101_02.YP2.1	1052420	1052437		mltC	17
GLZ001.A0101_02.YP2.1	1053146	1053182		mltC	36
GLZ001.A0101_02.YP2.1	1053382	1053399		mltC	17
GLZ001.A0101_02.YP2.1	1055118	1055129		YPO_RS05720	11
GLZ001.A0101_02.YP2.1	1056043	1056044		YPO_RS05720	1
GLZ001.A0101_02.YP2.1	1057120	1057132		YPO_RS05725	12
GLZ001.A0101_02.YP2.1	1060368	1060379		YPO_RS05735	11
GLZ001.A0101_02.YP2.1	1064598	1064600		YPO_RS05755	2
GLZ001.A0101_02.YP2.1	1066916	1066929		YPO_RS05765	13
GLZ001.A0101_02.YP2.1	1066988	1066993		YPO_RS05765	5
GLZ001.A0101_02.YP2.1	1067200	1067227		YPO_RS05765	27
GLZ001.A0101_02.YP2.1	1067287	1067387		YPO_RS05765	100
GLZ001.A0101_02.YP2.1	1067376	1067387		YPO_RS05770	11
GLZ001.A0101_02.YP2.1	1068141	1068191		YPO_RS05770	50
GLZ001.A0101_02.YP2.1	1071628	1071666		YPO_RS05785	38
GLZ001.A0101_02.YP2.1	1071907	1071964		YPO_RS05790	57
GLZ001.A0101_02.YP2.1	1072772	1072781		YPO_RS05795	9
GLZ001.A0101_02.YP2.1	1073123	1073150		YPO_RS05795	27
GLZ001.A0101_02.YP2.1	1073190	1073202		YPO_RS05795	12
GLZ001.A0101_02.YP2.1	1075745	1075746		YPO_RS05800	1
GLZ001.A0101_02.YP2.1	1088687	1088735		YPO_RS05845	48
GLZ001.A0101_02.YP2.1	1091536	1091538		YPO_RS05855	2
GLZ001.A0101_02.YP2.1	1091762	1091766		YPO_RS05855	4
GLZ001.A0101_02.YP2.1	1093445	1093447		YPO_RS05865	2
GLZ001.A0101_02.YP2.1	1093766	1093780		YPO_RS05865	14
GLZ001.A0101_02.YP2.1	1095610	1095654		YPO_RS05870	44
GLZ001.A0101_02.YP2.1	1096620	1096622		YPO_RS05880	2
GLZ001.A0101_02.YP2.1	1096972	1096973		YPO_RS05880	1
GLZ001.A0101_02.YP2.1	1107067	1107069		YPO_RS05910	2
GLZ001.A0101_02.YP2.1	1108842	1108845		YPO_RS05915	3
GLZ001.A0101_02.YP2.1	1110740	1110788		YPO_RS05920	48
GLZ001.A0101_02.YP2.1	1116799	1116863		YPO_RS05940	64
GLZ001.A0101_02.YP2.1	1116962	1117005		YPO_RS05940	43
GLZ001.A0101_02.YP2.1	1117079	1117126		YPO_RS05940	47
GLZ001.A0101_02.YP2.1	1117261	1117279		YPO_RS05940	18
GLZ001.A0101_02.YP2.1	1117486	1117497		YPO_RS05940	11
GLZ001.A0101_02.YP2.1	1117741	1117768		YPO_RS05940	27
GLZ001.A0101_02.YP2.1	1117998	1118029		YPO_RS05940	31
GLZ001.A0101_02.YP2.1	1118066	1118085		YPO_RS05940	19
GLZ001.A0101_02.YP2.1	1118388	1118389		YPO_RS05945	1
GLZ001.A0101_02.YP2.1	1118445	1118446		YPO_RS05945	1
GLZ001.A0101_02.YP2.1	1119829	1119836		yapH	7
GLZ001.A0101_02.YP2.1	1120386	1120402		yapH	16
GLZ001.A0101_02.YP2.1	1121139	1121156		yapH	17
GLZ001.A0101_02.YP2.1	1121543	1121548		yapH	5
GLZ001.A0101_02.YP2.1	1123647	1123655		yapH	8
GLZ001.A0101_02.YP2.1	1123886	1123888		yapH	2
GLZ001.A0101_02.YP2.1	1123958	1123998		yapH	40
GLZ001.A0101_02.YP2.1	1124074	1124107		yapH	33
GLZ001.A0101_02.YP2.1	1124166	1124198		yapH	32
GLZ001.A0101_02.YP2.1	1124223	1124235		yapH	12
GLZ001.A0101_02.YP2.1	1124281	1124283		yapH	2
GLZ001.A0101_02.YP2.1	1124387	1124493		yapH	106
GLZ001.A0101_02.YP2.1	1124536	1124541		yapH	5
GLZ001.A0101_02.YP2.1	1124602	1124611		yapH	9
GLZ001.A0101_02.YP2.1	1124685	1124880		yapH	195
GLZ001.A0101_02.YP2.1	1124925	1124936		yapH	11
GLZ001.A0101_02.YP2.1	1124993	1125007		yapH	14
GLZ001.A0101_02.YP2.1	1125120	1125124		yapH	4
GLZ001.A0101_02.YP2.1	1125176	1125261		yapH	85
GLZ001.A0101_02.YP2.1	1125305	1125395		yapH	90
GLZ001.A0101_02.YP2.1	1125435	1125476		yapH	41
GLZ001.A0101_02.YP2.1	1125545	1125606		yapH	61
GLZ001.A0101_02.YP2.1	1125670	1125713		yapH	43
GLZ001.A0101_02.YP2.1	1125806	1125809		yapH	3
GLZ001.A0101_02.YP2.1	1126260	1126262		yapH	2
GLZ001.A0101_02.YP2.1	1131562	1131571		YPO_RS05955	9
GLZ001.A0101_02.YP2.1	1133930	1133951		YPO_RS05965	21
GLZ001.A0101_02.YP2.1	1134364	1134367		YPO_RS05965	3
GLZ001.A0101_02.YP2.1	1135344	1135349		YPO_RS05970	5
GLZ001.A0101_02.YP2.1	1135675	1135689		YPO_RS05970	14
GLZ001.A0101_02.YP2.1	1140365	1140378		YPO_RS05985	13
GLZ001.A0101_02.YP2.1	1140444	1140481		YPO_RS05985	37
GLZ001.A0101_02.YP2.1	1140714	1140735		YPO_RS05985	21
GLZ001.A0101_02.YP2.1	1140852	1140882		YPO_RS05985	30
GLZ001.A0101_02.YP2.1	1141419	1141425		YPO_RS05985	6
GLZ001.A0101_02.YP2.1	1142185	1142221		YPO_RS05985	36
GLZ001.A0101_02.YP2.1	1142304	1142327		YPO_RS05985	23
GLZ001.A0101_02.YP2.1	1151706	1151729		recC	23
GLZ001.A0101_02.YP2.1	1152215	1152227		recC	12
GLZ001.A0101_02.YP2.1	1154169	1154199		ptrA	30
GLZ001.A0101_02.YP2.1	1156059	1156086		recB	27
GLZ001.A0101_02.YP2.1	1159623	1159629		recB	6
GLZ001.A0101_02.YP2.1	1161814	1161831		argA	17
GLZ001.A0101_02.YP2.1	1162949	1162950		argA	1
GLZ001.A0101_02.YP2.1	1166441	1166443		mltA	2
GLZ001.A0101_02.YP2.1	1179177	1179181		truC	4
GLZ001.A0101_02.YP2.1	1180169	1180171		YPO_RS06145	2
GLZ001.A0101_02.YP2.1	1182091	1182093		glnD	2
GLZ001.A0101_02.YP2.1	1183899	1183913		glnD	14
GLZ001.A0101_02.YP2.1	1194728	1194734		bamA	6
GLZ001.A0101_02.YP2.1	1213290	1213305		rcsF	15
GLZ001.A0101_02.YP2.1	1214683	1214686		metI	3
GLZ001.A0101_02.YP2.1	1220120	1220123		YPO_RS06340	3
GLZ001.A0101_02.YP2.1	1221218	1221222		YPO_RS06340	4
GLZ001.A0101_02.YP2.1	1221601	1221604		YPO_RS06340	3
GLZ001.A0101_02.YP2.1	1223370	1223388		dkgB	18
GLZ001.A0101_02.YP2.1	1223711	1223718		dkgB	7
GLZ001.A0101_02.YP2.1	1228480	1228495		YPO_RS06380	15
GLZ001.A0101_02.YP2.1	1235306	1235321		YPO_RS06430	15
GLZ001.A0101_02.YP2.1	1237462	1237464		YPO_RS06440	2
GLZ001.A0101_02.YP2.1	1238692	1238694		YPO_RS06455	2
GLZ001.A0101_02.YP2.1	1239251	1239259		YPO_RS06455	8
GLZ001.A0101_02.YP2.1	1240951	1241132		YPO_RS06465	181
GLZ001.A0101_02.YP2.1	1241174	1241196		YPO_RS06465	22
GLZ001.A0101_02.YP2.1	1241513	1241566		YPO_RS06465	53
GLZ001.A0101_02.YP2.1	1241894	1241908		YPO_RS06465	14
GLZ001.A0101_02.YP2.1	1241995	1242025		YPO_RS06465	30
GLZ001.A0101_02.YP2.1	1242453	1242482		YPO_RS06470	29
GLZ001.A0101_02.YP2.1	1242604	1242618		YPO_RS06470	14
GLZ001.A0101_02.YP2.1	1242814	1242852		YPO_RS06470	38
GLZ001.A0101_02.YP2.1	1243016	1243043		YPO_RS06470	27
GLZ001.A0101_02.YP2.1	1243175	1243241		YPO_RS06470	66
GLZ001.A0101_02.YP2.1	1243313	1243318		YPO_RS06470	5
GLZ001.A0101_02.YP2.1	1243387	1243398		YPO_RS06470	11
GLZ001.A0101_02.YP2.1	1243896	1243903		YPO_RS06475	7
GLZ001.A0101_02.YP2.1	1246798	1246801		YPO_RS06495	3
GLZ001.A0101_02.YP2.1	1246972	1246981		YPO_RS06495	9
GLZ001.A0101_02.YP2.1	1251903	1251917		YPO_RS06525	14
GLZ001.A0101_02.YP2.1	1254271	1254276		sdhA	5
GLZ001.A0101_02.YP2.1	1256002	1256004		YPO_RS06545	2
GLZ001.A0101_02.YP2.1	1260321	1260343		odhB	22
GLZ001.A0101_02.YP2.1	1261611	1261615		sucC	4
GLZ001.A0101_02.YP2.1	1262351	1262359		sucD	8
GLZ001.A0101_02.YP2.1	1262907	1262930		sucD	23
GLZ001.A0101_02.YP2.1	1263191	1263214		sucD	23
GLZ001.A0101_02.YP2.1	1264128	1264134		cydA	6
GLZ001.A0101_02.YP2.1	1266639	1266642		cydB	3
GLZ001.A0101_02.YP2.1	1269589	1269618		tolA	29
GLZ001.A0101_02.YP2.1	1269651	1269662		tolA	11
GLZ001.A0101_02.YP2.1	1269751	1269760		tolA	9
GLZ001.A0101_02.YP2.1	1270540	1270542		tolB	2
GLZ001.A0101_02.YP2.1	1271113	1271115		tolB	2
GLZ001.A0101_02.YP2.1	1277130	1277139		aroG	9
GLZ001.A0101_02.YP2.1	1280068	1280105		YPO_RS06670	37
GLZ001.A0101_02.YP2.1	1280557	1280565		gpmA	8
GLZ001.A0101_02.YP2.1	1280909	1280914		gpmA	5
GLZ001.A0101_02.YP2.1	1285922	1285930		galE	8
GLZ001.A0101_02.YP2.1	1286092	1286122		galE	30
GLZ001.A0101_02.YP2.1	1286701	1286714		YPO_RS06710	13
GLZ001.A0101_02.YP2.1	1292903	1292923		modC	20
GLZ001.A0101_02.YP2.1	1294009	1294019		YPO_RS06745	10
GLZ001.A0101_02.YP2.1	1295225	1295231		pgl	6
GLZ001.A0101_02.YP2.1	1295736	1295739		bioA	3
GLZ001.A0101_02.YP2.1	1298674	1298687		bioF	13
GLZ001.A0101_02.YP2.1	1303149	1303164		uvrB	15
GLZ001.A0101_02.YP2.1	1304150	1304156		uvrB	6
GLZ001.A0101_02.YP2.1	1308552	1308558		moaD	6
GLZ001.A0101_02.YP2.1	1315880	1315887		YPO_RS06845	7
GLZ001.A0101_02.YP2.1	1315937	1315946		YPO_RS06845	9
GLZ001.A0101_02.YP2.1	1317609	1317614		YPO_RS06850	5
GLZ001.A0101_02.YP2.1	1317991	1318008		YPO_RS06850	17
GLZ001.A0101_02.YP2.1	1319620	1319621		xapA	1
GLZ001.A0101_02.YP2.1	1320331	1320336		xapA	5
GLZ001.A0101_02.YP2.1	1322222	1322272		YPO_RS06875	50
GLZ001.A0101_02.YP2.1	1322303	1322308		YPO_RS06875	5
GLZ001.A0101_02.YP2.1	1322380	1322405		YPO_RS06875	25
GLZ001.A0101_02.YP2.1	1322693	1322777		YPO_RS06875	84
GLZ001.A0101_02.YP2.1	1322824	1322871		YPO_RS06875	47
GLZ001.A0101_02.YP2.1	1322962	1322978		YPO_RS06875	16
GLZ001.A0101_02.YP2.1	1323410	1323420		dusC	10
GLZ001.A0101_02.YP2.1	1326410	1326415		dld	5
GLZ001.A0101_02.YP2.1	1329455	1329456		YPO_RS06910	1
GLZ001.A0101_02.YP2.1	1331060	1331085		phnC	25
GLZ001.A0101_02.YP2.1	1331517	1331526		phnC	9
GLZ001.A0101_02.YP2.1	1331855	1331908		phnD	53
GLZ001.A0101_02.YP2.1	1331986	1331992		phnD	6
GLZ001.A0101_02.YP2.1	1332584	1332617		phnD	33
GLZ001.A0101_02.YP2.1	1332894	1332895		phnE	1
GLZ001.A0101_02.YP2.1	1333411	1333412		phnE	1
GLZ001.A0101_02.YP2.1	1333629	1333632		phnE	3
GLZ001.A0101_02.YP2.1	1333733	1333753		phnE	20
GLZ001.A0101_02.YP2.1	1334413	1334422		phnE	9
GLZ001.A0101_02.YP2.1	1334740	1334761		YPO_RS06940	21
GLZ001.A0101_02.YP2.1	1337587	1337591		urtB	4
GLZ001.A0101_02.YP2.1	1338594	1338598		urtB	4
GLZ001.A0101_02.YP2.1	1338992	1338996		urtC	4
GLZ001.A0101_02.YP2.1	1339999	1340011		urtD	12
GLZ001.A0101_02.YP2.1	1340317	1340336		urtD	19
GLZ001.A0101_02.YP2.1	1340658	1340662		urtE	4
GLZ001.A0101_02.YP2.1	1343645	1343648		YPO_RS06975	3
GLZ001.A0101_02.YP2.1	1345785	1345791		YPO_RS06985	6
GLZ001.A0101_02.YP2.1	1348249	1348253		YPO_RS07000	4
GLZ001.A0101_02.YP2.1	1350112	1350164		adiC	52
GLZ001.A0101_02.YP2.1	1351027	1351030		adiC	3
GLZ001.A0101_02.YP2.1	1352725	1352728		YPO_RS07015	3
GLZ001.A0101_02.YP2.1	1355611	1355639		ompF2	28
GLZ001.A0101_02.YP2.1	1358266	1358272		dinG	6
GLZ001.A0101_02.YP2.1	1372177	1372186		gyrA	9
GLZ001.A0101_02.YP2.1	1374001	1374002		rcsC	1
GLZ001.A0101_02.YP2.1	1374772	1374801		rcsC	29
GLZ001.A0101_02.YP2.1	1377474	1377494		YPO_RS07100	20
GLZ001.A0101_02.YP2.1	1377938	1377952		rcsD	14
GLZ001.A0101_02.YP2.1	1379118	1379122		rcsD	4
GLZ001.A0101_02.YP2.1	1379663	1379674		rcsD	11
GLZ001.A0101_02.YP2.1	1380352	1380361		YPO_RS07110	9
GLZ001.A0101_02.YP2.1	1382250	1382259		YPO_RS07115	9
GLZ001.A0101_02.YP2.1	1388201	1388221		YPO_RS07145	20
GLZ001.A0101_02.YP2.1	1388504	1388514		YPO_RS07145	10
GLZ001.A0101_02.YP2.1	1388788	1388794		YPO_RS07145	6
GLZ001.A0101_02.YP2.1	1389190	1389216		YPO_RS07150	26
GLZ001.A0101_02.YP2.1	1390706	1390708		YPO_RS07150	2
GLZ001.A0101_02.YP2.1	1391553	1391561		ycoA	8
GLZ001.A0101_02.YP2.1	1391804	1391815		ycoA	11
GLZ001.A0101_02.YP2.1	1392301	1392317		ycoA	16
GLZ001.A0101_02.YP2.1	1394340	1394350		YPO_RS07170	10
GLZ001.A0101_02.YP2.1	1397910	1397939		YPO_RS07190	29
GLZ001.A0101_02.YP2.1	1398140	1398179		YPO_RS07190	39
GLZ001.A0101_02.YP2.1	1398954	1398960		YPO_RS07195	6
GLZ001.A0101_02.YP2.1	1401083	1401086		YPO_RS07210	3
GLZ001.A0101_02.YP2.1	1402545	1402553		YPO_RS07225	8
GLZ001.A0101_02.YP2.1	1406115	1406128		YPO_RS07235	13
GLZ001.A0101_02.YP2.1	1406994	1407005		YPO_RS07240	11
GLZ001.A0101_02.YP2.1	1410175	1410182		YPO_RS07265	7
GLZ001.A0101_02.YP2.1	1410533	1410549		YPO_RS07270	16
GLZ001.A0101_02.YP2.1	1410763	1410768		YPO_RS07270	5
GLZ001.A0101_02.YP2.1	1410888	1410923		YPO_RS07270	35
GLZ001.A0101_02.YP2.1	1411167	1411209		YPO_RS07270	42
GLZ001.A0101_02.YP2.1	1411511	1411527		YPO_RS07275	16
GLZ001.A0101_02.YP2.1	1413152	1413210		YPO_RS07280	58
GLZ001.A0101_02.YP2.1	1413320	1413323		YPO_RS07280	3
GLZ001.A0101_02.YP2.1	1414376	1414383		YPO_RS07285	7
GLZ001.A0101_02.YP2.1	1421390	1421394		YPO_RS07330	4
GLZ001.A0101_02.YP2.1	1432762	1432786		YPO_RS07370	24
GLZ001.A0101_02.YP2.1	1433309	1433320		YPO_RS07370	11
GLZ001.A0101_02.YP2.1	1433415	1433427		YPO_RS07370	12
GLZ001.A0101_02.YP2.1	1433953	1433962		YPO_RS07370	9
GLZ001.A0101_02.YP2.1	1436307	1436330		YPO_RS07380	23
GLZ001.A0101_02.YP2.1	1436486	1436497		YPO_RS07385	11
GLZ001.A0101_02.YP2.1	1437432	1437442		YPO_RS07385	10
GLZ001.A0101_02.YP2.1	1438626	1438673		YPO_RS07390	47
GLZ001.A0101_02.YP2.1	1439860	1439867		YPO_RS07395	7
GLZ001.A0101_02.YP2.1	1447125	1447136		YPO_RS07430	11
GLZ001.A0101_02.YP2.1	1447801	1447811		YPO_RS07430	10
GLZ001.A0101_02.YP2.1	1450115	1450122		xylB	7
GLZ001.A0101_02.YP2.1	1451370	1451387		xylB	17
GLZ001.A0101_02.YP2.1	1459330	1459333		fruA	3
GLZ001.A0101_02.YP2.1	1461338	1461361		YPO_RS07485	23
GLZ001.A0101_02.YP2.1	1461575	1461586		YPO_RS07485	11
GLZ001.A0101_02.YP2.1	1461791	1461849		YPO_RS07490	58
GLZ001.A0101_02.YP2.1	1461902	1461915		YPO_RS07490	13
GLZ001.A0101_02.YP2.1	1462081	1462128		YPO_RS07490	47
GLZ001.A0101_02.YP2.1	1463113	1463160		psaA	47
GLZ001.A0101_02.YP2.1	1463231	1463252		psaA	21
GLZ001.A0101_02.YP2.1	1463379	1463425		YPO_RS07500	46
GLZ001.A0101_02.YP2.1	1463477	1463484		YPO_RS07500	7
GLZ001.A0101_02.YP2.1	1463552	1463582		YPO_RS07500	30
GLZ001.A0101_02.YP2.1	1463612	1463619		YPO_RS07500	7
GLZ001.A0101_02.YP2.1	1464026	1464040		YPO_RS07500	14
GLZ001.A0101_02.YP2.1	1464160	1464162		YPO_RS07500	2
GLZ001.A0101_02.YP2.1	1464439	1464444		psaC	5
GLZ001.A0101_02.YP2.1	1465912	1465914		psaC	2
GLZ001.A0101_02.YP2.1	1470739	1470743		YPO_RS07525	4
GLZ001.A0101_02.YP2.1	1472562	1472563		YPO_RS07530	1
GLZ001.A0101_02.YP2.1	1473525	1473538		YPO_RS07530	13
GLZ001.A0101_02.YP2.1	1476987	1477020		YPO_RS07545	33
GLZ001.A0101_02.YP2.1	1479652	1479661		YPO_RS07555	9
GLZ001.A0101_02.YP2.1	1493693	1493696		YPO_RS07610	3
GLZ001.A0101_02.YP2.1	1496832	1496851		potF	19
GLZ001.A0101_02.YP2.1	1498747	1498750		potH	3
GLZ001.A0101_02.YP2.1	1499864	1499866		potI	2
GLZ001.A0101_02.YP2.1	1501699	1501700		rlmC	1
GLZ001.A0101_02.YP2.1	1505625	1505634		YPO_RS07680	9
GLZ001.A0101_02.YP2.1	1505975	1505980		YPO_RS07685	5
GLZ001.A0101_02.YP2.1	1506498	1506517		YPO_RS07685	19
GLZ001.A0101_02.YP2.1	1506860	1506875		YPO_RS07685	15
GLZ001.A0101_02.YP2.1	1509114	1509117		YPO_RS07705	3
GLZ001.A0101_02.YP2.1	1511231	1511240		YPO_RS07720	9
GLZ001.A0101_02.YP2.1	1514444	1514468		artQ	24
GLZ001.A0101_02.YP2.1	1517033	1517070		YPO_RS07755	37
GLZ001.A0101_02.YP2.1	1522384	1522387		poxB	3
GLZ001.A0101_02.YP2.1	1526064	1526070		hcp	6
GLZ001.A0101_02.YP2.1	1526812	1526820		YPO_RS07795	8
GLZ001.A0101_02.YP2.1	1529366	1529377		YPO_RS07800	11
GLZ001.A0101_02.YP2.1	1529532	1529543		YPO_RS07800	11
GLZ001.A0101_02.YP2.1	1530102	1530117		YPO_RS07805	15
GLZ001.A0101_02.YP2.1	1530777	1530809		YPO_RS07805	32
GLZ001.A0101_02.YP2.1	1535065	1535074		clpS	9
GLZ001.A0101_02.YP2.1	1536849	1536858		clpA	9
GLZ001.A0101_02.YP2.1	1539742	1539761		aat	19
GLZ001.A0101_02.YP2.1	1552125	1552139		YPO_RS07880	14
GLZ001.A0101_02.YP2.1	1553329	1553333		serS	4
GLZ001.A0101_02.YP2.1	1554925	1554947		YPO_RS07890	22
GLZ001.A0101_02.YP2.1	1557312	1557317		YPO_RS07900	5
GLZ001.A0101_02.YP2.1	1557471	1557476		YPO_RS07900	5
GLZ001.A0101_02.YP2.1	1557625	1557629		YPO_RS07900	4
GLZ001.A0101_02.YP2.1	1557684	1557709		YPO_RS07900	25
GLZ001.A0101_02.YP2.1	1559482	1559483		pflB	1
GLZ001.A0101_02.YP2.1	1565759	1565781		YPO_RS07925	22
GLZ001.A0101_02.YP2.1	1565811	1565826		YPO_RS07925	15
GLZ001.A0101_02.YP2.1	1565882	1565940		YPO_RS07925	58
GLZ001.A0101_02.YP2.1	1565971	1566029		YPO_RS07925	58
GLZ001.A0101_02.YP2.1	1566675	1566690		YPO_RS07930	15
GLZ001.A0101_02.YP2.1	1566879	1566901		YPO_RS07930	22
GLZ001.A0101_02.YP2.1	1567395	1567396		YPO_RS07930	1
GLZ001.A0101_02.YP2.1	1567435	1567447		YPO_RS07930	12
GLZ001.A0101_02.YP2.1	1567515	1567531		YPO_RS07930	16
GLZ001.A0101_02.YP2.1	1567683	1567706		YPO_RS07930	23
GLZ001.A0101_02.YP2.1	1567765	1567870		YPO_RS07930	105
GLZ001.A0101_02.YP2.1	1569075	1569077		serC	2
GLZ001.A0101_02.YP2.1	1571463	1571469		cmk	6
GLZ001.A0101_02.YP2.1	1580958	1580969		YPO_RS07975	11
GLZ001.A0101_02.YP2.1	1582808	1582827		YPO_RS07985	19
GLZ001.A0101_02.YP2.1	1585844	1585855		cmoM	11
GLZ001.A0101_02.YP2.1	1589268	1589280		mukB	12
GLZ001.A0101_02.YP2.1	1591992	1591993		mukB	1
GLZ001.A0101_02.YP2.1	1594414	1594422		ldtD	8
GLZ001.A0101_02.YP2.1	1595730	1595741		ldtD	11
GLZ001.A0101_02.YP2.1	1596164	1596169		YPO_RS08030	5
GLZ001.A0101_02.YP2.1	1597457	1597461		YPO_RS08040	4
GLZ001.A0101_02.YP2.1	1599244	1599249		ompF	5
GLZ001.A0101_02.YP2.1	1605448	1605469		pepN	21
GLZ001.A0101_02.YP2.1	1605611	1605623		pepN	12
GLZ001.A0101_02.YP2.1	1605815	1605829		pepN	14
GLZ001.A0101_02.YP2.1	1613675	1613689		YPO_RS08090	14
GLZ001.A0101_02.YP2.1	1613897	1613899		YPO_RS08090	2
GLZ001.A0101_02.YP2.1	1615995	1615999		pqiA	4
GLZ001.A0101_02.YP2.1	1618072	1618082		pqiC	10
GLZ001.A0101_02.YP2.1	1628002	1628003		ompA	1
GLZ001.A0101_02.YP2.1	1629066	1629075		sulA	9
GLZ001.A0101_02.YP2.1	1632351	1632359		YPO_RS08185	8
GLZ001.A0101_02.YP2.1	1632388	1632412		YPO_RS08185	24
GLZ001.A0101_02.YP2.1	1632680	1632697		YPO_RS08185	17
GLZ001.A0101_02.YP2.1	1635771	1635777		YPO_RS08200	6
GLZ001.A0101_02.YP2.1	1636647	1636648		YPO_RS08205	1
GLZ001.A0101_02.YP2.1	1645018	1645025		YPO_RS08245	7
GLZ001.A0101_02.YP2.1	1646227	1646243		YPO_RS08250	16
GLZ001.A0101_02.YP2.1	1646377	1646385		YPO_RS08250	8
GLZ001.A0101_02.YP2.1	1647598	1647693		YPO_RS08260	95
GLZ001.A0101_02.YP2.1	1647901	1647909		YPO_RS08260	8
GLZ001.A0101_02.YP2.1	1649315	1649321		YPO_RS08265	6
GLZ001.A0101_02.YP2.1	1649382	1649391		YPO_RS08265	9
GLZ001.A0101_02.YP2.1	1651382	1651388		YPO_RS08275	6
GLZ001.A0101_02.YP2.1	1651382	1651388		YPO_RS08280	6
GLZ001.A0101_02.YP2.1	1651469	1651475		YPO_RS08280	6
GLZ001.A0101_02.YP2.1	1652061	1652100		YPO_RS08280	39
GLZ001.A0101_02.YP2.1	1652102	1652134		YPO_RS08285	32
GLZ001.A0101_02.YP2.1	1652416	1652431		YPO_RS08285	15
GLZ001.A0101_02.YP2.1	1652721	1652722		YPO_RS08285	1
GLZ001.A0101_02.YP2.1	1652806	1652848		YPO_RS08285	42
GLZ001.A0101_02.YP2.1	1653029	1653062		YPO_RS08290	33
GLZ001.A0101_02.YP2.1	1654096	1654098		YPO_RS08295	2
GLZ001.A0101_02.YP2.1	1654211	1654232		YPO_RS08300	21
GLZ001.A0101_02.YP2.1	1654387	1654411		YPO_RS08300	24
GLZ001.A0101_02.YP2.1	1655249	1655257		YPO_RS08305	8
GLZ001.A0101_02.YP2.1	1656420	1656423		tssB	3
GLZ001.A0101_02.YP2.1	1656567	1656569		tssB	2
GLZ001.A0101_02.YP2.1	1658264	1658271		tssC	7
GLZ001.A0101_02.YP2.1	1658413	1658415		tssC	2
GLZ001.A0101_02.YP2.1	1658757	1658758		tssK	1
GLZ001.A0101_02.YP2.1	1659358	1659364		tssK	6
GLZ001.A0101_02.YP2.1	1665338	1665344		tssH	6
GLZ001.A0101_02.YP2.1	1668162	1668175		YPO_RS08350	13
GLZ001.A0101_02.YP2.1	1668235	1668238		YPO_RS08350	3
GLZ001.A0101_02.YP2.1	1670176	1670206		YPO_RS08350	30
GLZ001.A0101_02.YP2.1	1670328	1670332		YPO_RS08350	4
GLZ001.A0101_02.YP2.1	1670455	1670462		YPO_RS08350	7
GLZ001.A0101_02.YP2.1	1670459	1670622		YPO_RS08355	163
GLZ001.A0101_02.YP2.1	1670808	1670849		YPO_RS08355	41
GLZ001.A0101_02.YP2.1	1670937	1670951		YPO_RS08355	14
GLZ001.A0101_02.YP2.1	1671627	1671637		YPO_RS08360	10
GLZ001.A0101_02.YP2.1	1673725	1673753		YPO_RS08365	28
GLZ001.A0101_02.YP2.1	1673812	1673845		YPO_RS08365	33
GLZ001.A0101_02.YP2.1	1674221	1674255		YPO_RS08370	34
GLZ001.A0101_02.YP2.1	1674315	1674324		YPO_RS08370	9
GLZ001.A0101_02.YP2.1	1674398	1674404		YPO_RS08370	6
GLZ001.A0101_02.YP2.1	1678981	1678997		YPO_RS08385	16
GLZ001.A0101_02.YP2.1	1680194	1680196		YPO_RS08385	2
GLZ001.A0101_02.YP2.1	1683400	1683442		YPO_RS08395	42
GLZ001.A0101_02.YP2.1	1683582	1683611		YPO_RS08395	29
GLZ001.A0101_02.YP2.1	1683681	1683706		YPO_RS08395	25
GLZ001.A0101_02.YP2.1	1683979	1684025		YPO_RS08395	46
GLZ001.A0101_02.YP2.1	1684040	1684190		YPO_RS08400	150
GLZ001.A0101_02.YP2.1	1684401	1684495		YPO_RS08400	94
GLZ001.A0101_02.YP2.1	1685354	1685372		tssF	18
GLZ001.A0101_02.YP2.1	1685799	1685814		tssF	15
GLZ001.A0101_02.YP2.1	1686160	1686162		tssF	2
GLZ001.A0101_02.YP2.1	1688310	1688312		tssE	2
GLZ001.A0101_02.YP2.1	1689380	1689387		YPO_RS08425	7
GLZ001.A0101_02.YP2.1	1690140	1690170		YPO_RS08430	30
GLZ001.A0101_02.YP2.1	1690209	1690244		YPO_RS08430	35
GLZ001.A0101_02.YP2.1	1690437	1690441		YPO_RS08430	4
GLZ001.A0101_02.YP2.1	1690632	1690677		YPO_RS08430	45
GLZ001.A0101_02.YP2.1	1692175	1692190		YPO_RS08435	15
GLZ001.A0101_02.YP2.1	1692693	1692726		YPO_RS08435	33
GLZ001.A0101_02.YP2.1	1693021	1693041		YPO_RS08435	20
GLZ001.A0101_02.YP2.1	1693422	1693462		YPO_RS08440	40
GLZ001.A0101_02.YP2.1	1693551	1693558		YPO_RS08440	7
GLZ001.A0101_02.YP2.1	1693870	1693922		YPO_RS08440	52
GLZ001.A0101_02.YP2.1	1696348	1696351		moeA	3
GLZ001.A0101_02.YP2.1	1698194	1698195		darE	1
GLZ001.A0101_02.YP2.1	1698372	1698376		darE	4
GLZ001.A0101_02.YP2.1	1698434	1698470		darE	36
GLZ001.A0101_02.YP2.1	1698681	1698720		darE	39
GLZ001.A0101_02.YP2.1	1698970	1698994		darE	24
GLZ001.A0101_02.YP2.1	1699097	1699098		darE	1
GLZ001.A0101_02.YP2.1	1699606	1699622		darD	16
GLZ001.A0101_02.YP2.1	1699818	1699879		darD	61
GLZ001.A0101_02.YP2.1	1699881	1699886		darC	5
GLZ001.A0101_02.YP2.1	1700033	1700046		darC	13
GLZ001.A0101_02.YP2.1	1700309	1700360		darC	51
GLZ001.A0101_02.YP2.1	1700488	1700494		darC	6
GLZ001.A0101_02.YP2.1	1700549	1700560		darC	11
GLZ001.A0101_02.YP2.1	1700658	1700681		darC	23
GLZ001.A0101_02.YP2.1	1700733	1700745		darC	12
GLZ001.A0101_02.YP2.1	1700804	1700805		darC	1
GLZ001.A0101_02.YP2.1	1700894	1700897		darC	3
GLZ001.A0101_02.YP2.1	1701090	1701143		darC	53
GLZ001.A0101_02.YP2.1	1701145	1701152		darB	7
GLZ001.A0101_02.YP2.1	1701290	1701292		darB	2
GLZ001.A0101_02.YP2.1	1701503	1701515		darB	12
GLZ001.A0101_02.YP2.1	1701718	1701726		darB	8
GLZ001.A0101_02.YP2.1	1702151	1702170		darB	19
GLZ001.A0101_02.YP2.1	1702339	1702358		darB	19
GLZ001.A0101_02.YP2.1	1702595	1702669		darB	74
GLZ001.A0101_02.YP2.1	1703238	1703262		darB	24
GLZ001.A0101_02.YP2.1	1703357	1703392		darB	35
GLZ001.A0101_02.YP2.1	1703641	1703692		darA-c	51
GLZ001.A0101_02.YP2.1	1706501	1706516		YPO_RS08495	15
GLZ001.A0101_02.YP2.1	1708933	1708934		folE	1
GLZ001.A0101_02.YP2.1	1712585	1712592		mglA	7
GLZ001.A0101_02.YP2.1	1712773	1712786		mglA	13
GLZ001.A0101_02.YP2.1	1712943	1712952		mglA	9
GLZ001.A0101_02.YP2.1	1714090	1714108		mglC	18
GLZ001.A0101_02.YP2.1	1714181	1714214		mglC	33
GLZ001.A0101_02.YP2.1	1716683	1716684		YPO_RS08535	1
GLZ001.A0101_02.YP2.1	1720145	1720154		YPO_RS08545	9
GLZ001.A0101_02.YP2.1	1722115	1722116		YPO_RS08555	1
GLZ001.A0101_02.YP2.1	1723144	1723151		YPO_RS08560	7
GLZ001.A0101_02.YP2.1	1725929	1725956		YPO_RS08570	27
GLZ001.A0101_02.YP2.1	1726221	1726352		YPO_RS08570	131
GLZ001.A0101_02.YP2.1	1731913	1731919		apbC	6
GLZ001.A0101_02.YP2.1	1732139	1732147		apbC	8
GLZ001.A0101_02.YP2.1	1732829	1732836		udk	7
GLZ001.A0101_02.YP2.1	1734079	1734081		dcd	2
GLZ001.A0101_02.YP2.1	1735123	1735126		asmA	3
GLZ001.A0101_02.YP2.1	1738814	1738831		fhuF	17
GLZ001.A0101_02.YP2.1	1739138	1739151		fhuF	13
GLZ001.A0101_02.YP2.1	1739303	1739330		YPO_RS08625	27
GLZ001.A0101_02.YP2.1	1739580	1739589		YPO_RS08625	9
GLZ001.A0101_02.YP2.1	1740323	1740325		YPO_RS08625	2
GLZ001.A0101_02.YP2.1	1742928	1742930		YPO_RS08640	2
GLZ001.A0101_02.YP2.1	1743064	1743073		YPO_RS08640	9
GLZ001.A0101_02.YP2.1	1750108	1750114		YPO_RS08665	6
GLZ001.A0101_02.YP2.1	1751021	1751041		YPO_RS08665	20
GLZ001.A0101_02.YP2.1	1752003	1752007		YPO_RS08670	4
GLZ001.A0101_02.YP2.1	1752062	1752072		YPO_RS08670	10
GLZ001.A0101_02.YP2.1	1752465	1752467		YPO_RS08670	2
GLZ001.A0101_02.YP2.1	1760784	1760786		hisB	2
GLZ001.A0101_02.YP2.1	1761471	1761473		hisB	2
GLZ001.A0101_02.YP2.1	1763515	1763522		hisD	7
GLZ001.A0101_02.YP2.1	1763894	1763895		hisD	1
GLZ001.A0101_02.YP2.1	1766732	1766753		YPO_RS08740	21
GLZ001.A0101_02.YP2.1	1767004	1767011		YPO_RS08740	7
GLZ001.A0101_02.YP2.1	1767749	1767775		YPO_RS08745	26
GLZ001.A0101_02.YP2.1	1773969	1773973		sbcB	4
GLZ001.A0101_02.YP2.1	1774324	1774329		sbcB	5
GLZ001.A0101_02.YP2.1	1775322	1775325		sbcB	3
GLZ001.A0101_02.YP2.1	1775697	1775727		YPO_RS08785	30
GLZ001.A0101_02.YP2.1	1779054	1779059		YPO_RS08795	5
GLZ001.A0101_02.YP2.1	1779054	1779082		YPO_RS08800	28
GLZ001.A0101_02.YP2.1	1781305	1781306		YPO_RS08800	1
GLZ001.A0101_02.YP2.1	1785939	1785942		YPO_RS08815	3
GLZ001.A0101_02.YP2.1	1789159	1789163		lldD	4
GLZ001.A0101_02.YP2.1	1794384	1794407		YPO_RS08845	23
GLZ001.A0101_02.YP2.1	1795901	1795976		YPO_RS08855	75
GLZ001.A0101_02.YP2.1	1796134	1796188		YPO_RS08855	54
GLZ001.A0101_02.YP2.1	1796235	1796236		YPO_RS08855	1
GLZ001.A0101_02.YP2.1	1799332	1799336		YPO_RS08875	4
GLZ001.A0101_02.YP2.1	1799920	1799922		YPO_RS08875	2
GLZ001.A0101_02.YP2.1	1801190	1801195		YPO_RS08885	5
GLZ001.A0101_02.YP2.1	1803513	1803546		YPO_RS08895	33
GLZ001.A0101_02.YP2.1	1806040	1806046		YPO_RS08905	6
GLZ001.A0101_02.YP2.1	1806989	1807002		YPO_RS08905	13
GLZ001.A0101_02.YP2.1	1808281	1808347		bssS	66
GLZ001.A0101_02.YP2.1	1808448	1808453		bssS	5
GLZ001.A0101_02.YP2.1	1809256	1809277		dinI	21
GLZ001.A0101_02.YP2.1	1818877	1818884		YPO_RS08960	7
GLZ001.A0101_02.YP2.1	1820318	1820339		plsX	21
GLZ001.A0101_02.YP2.1	1822671	1822675		fabD	4
GLZ001.A0101_02.YP2.1	1827122	1827143		pabC	21
GLZ001.A0101_02.YP2.1	1835930	1835959		YPO_RS09055	29
GLZ001.A0101_02.YP2.1	1837014	1837016		thiK	2
GLZ001.A0101_02.YP2.1	1837734	1837764		nagZ	30
GLZ001.A0101_02.YP2.1	1841973	1841980		YPO_RS09085	7
GLZ001.A0101_02.YP2.1	1841988	1842015		YPO_RS09090	27
GLZ001.A0101_02.YP2.1	1842145	1842154		YPO_RS09090	9
GLZ001.A0101_02.YP2.1	1850216	1850217		mfd	1
GLZ001.A0101_02.YP2.1	1851690	1851691		lolC	1
GLZ001.A0101_02.YP2.1	1851690	1851693		lolD	3
GLZ001.A0101_02.YP2.1	1851855	1851861		lolD	6
GLZ001.A0101_02.YP2.1	1858545	1858550		phoQ	5
GLZ001.A0101_02.YP2.1	1861610	1861633		purB	23
GLZ001.A0101_02.YP2.1	1861789	1861791		purB	2
GLZ001.A0101_02.YP2.1	1862399	1862401		purB	2
GLZ001.A0101_02.YP2.1	1865463	1865473		YPO_RS09185	10
GLZ001.A0101_02.YP2.1	1865466	1865474		rluE	8
GLZ001.A0101_02.YP2.1	1866440	1866466		icd	26
GLZ001.A0101_02.YP2.1	1867131	1867132		icd	1
GLZ001.A0101_02.YP2.1	1867290	1867300		icd	10
GLZ001.A0101_02.YP2.1	1875380	1875387		ydfZ	7
GLZ001.A0101_02.YP2.1	1877936	1877975		YPO_RS09250	39
GLZ001.A0101_02.YP2.1	1878289	1878350		YPO_RS09250	61
GLZ001.A0101_02.YP2.1	1883773	1883775		cspE	2
GLZ001.A0101_02.YP2.1	1887434	1887457		YPO_RS09280	23
GLZ001.A0101_02.YP2.1	1888535	1888558		mgtA	23
GLZ001.A0101_02.YP2.1	1889298	1889309		mgtA	11
GLZ001.A0101_02.YP2.1	1898256	1898258		cheW	2
GLZ001.A0101_02.YP2.1	1898901	1898910		YPO_RS09320	9
GLZ001.A0101_02.YP2.1	1899966	1899972		YPO_RS09320	6
GLZ001.A0101_02.YP2.1	1900092	1900097		YPO_RS09320	5
GLZ001.A0101_02.YP2.1	1900258	1900271		YPO_RS09325	13
GLZ001.A0101_02.YP2.1	1901673	1901696		YPO_RS09335	23
GLZ001.A0101_02.YP2.1	1903585	1903607		yapJ	22
GLZ001.A0101_02.YP2.1	1904867	1904871		yapJ	4
GLZ001.A0101_02.YP2.1	1907154	1907166		YPO_RS09345	12
GLZ001.A0101_02.YP2.1	1917477	1917484		cheZ	7
GLZ001.A0101_02.YP2.1	1918291	1918318		YPO_RS09385	27
GLZ001.A0101_02.YP2.1	1918578	1918584		YPO_RS09385	6
GLZ001.A0101_02.YP2.1	1918874	1918878		YPO_RS09385	4
GLZ001.A0101_02.YP2.1	1919052	1919055		YPO_RS09385	3
GLZ001.A0101_02.YP2.1	1919626	1919657		YPO_RS09390	31
GLZ001.A0101_02.YP2.1	1919848	1919851		YPO_RS09390	3
GLZ001.A0101_02.YP2.1	1922257	1922258		YPO_RS09400	1
GLZ001.A0101_02.YP2.1	1922639	1922653		YPO_RS09400	14
GLZ001.A0101_02.YP2.1	1928253	1928257		YPO_RS09425	4
GLZ001.A0101_02.YP2.1	1928399	1928401		YPO_RS09425	2
GLZ001.A0101_02.YP2.1	1931773	1931777		YPO_RS09445	4
GLZ001.A0101_02.YP2.1	1933392	1933403		YPO_RS09455	11
GLZ001.A0101_02.YP2.1	1933849	1933866		YPO_RS09455	17
GLZ001.A0101_02.YP2.1	1934354	1934364		YPO_RS09455	10
GLZ001.A0101_02.YP2.1	1936839	1936842		YPO_RS09465	3
GLZ001.A0101_02.YP2.1	1938371	1938374		YPO_RS09475	3
GLZ001.A0101_02.YP2.1	1939335	1939342		YPO_RS09480	7
GLZ001.A0101_02.YP2.1	1940588	1940598		YPO_RS09480	10
GLZ001.A0101_02.YP2.1	1940901	1940910		YPO_RS09480	9
GLZ001.A0101_02.YP2.1	1944820	1944823		prc	3
GLZ001.A0101_02.YP2.1	1947101	1947104		htpX	3
GLZ001.A0101_02.YP2.1	1947672	1947673		htpX	1
GLZ001.A0101_02.YP2.1	1949922	1949943		YPO_RS09520	21
GLZ001.A0101_02.YP2.1	1953372	1953378		YPO_RS09525	6
GLZ001.A0101_02.YP2.1	1961429	1961439		YPO_RS09560	10
GLZ001.A0101_02.YP2.1	1961561	1961562		YPO_RS09560	1
GLZ001.A0101_02.YP2.1	1962532	1962542		YPO_RS09565	10
GLZ001.A0101_02.YP2.1	1962604	1962610		YPO_RS09565	6
GLZ001.A0101_02.YP2.1	1963142	1963167		YPO_RS09565	25
GLZ001.A0101_02.YP2.1	1963465	1963471		YPO_RS09570	6
GLZ001.A0101_02.YP2.1	1963813	1963814		YPO_RS09570	1
GLZ001.A0101_02.YP2.1	1967850	1967851		YPO_RS09590	1
GLZ001.A0101_02.YP2.1	1967886	1967898		YPO_RS09590	12
GLZ001.A0101_02.YP2.1	1972111	1972133		YPO_RS09605	22
GLZ001.A0101_02.YP2.1	1976636	1976641		YPO_RS09630	5
GLZ001.A0101_02.YP2.1	1976760	1976763		YPO_RS09630	3
GLZ001.A0101_02.YP2.1	1980631	1980632		YPO_RS09655	1
GLZ001.A0101_02.YP2.1	1983851	1983856		YPO_RS09675	5
GLZ001.A0101_02.YP2.1	1986067	1986087		YPO_RS09700	20
GLZ001.A0101_02.YP2.1	1989914	1989917		pgeF	3
GLZ001.A0101_02.YP2.1	1992182	1992233		YPO_RS09730	51
GLZ001.A0101_02.YP2.1	1996031	1996040		YPO_RS09745	9
GLZ001.A0101_02.YP2.1	1997010	1997020		YPO_RS09750	10
GLZ001.A0101_02.YP2.1	1999863	1999875		mntP	12
GLZ001.A0101_02.YP2.1	2000334	2000379		YPO_RS09760	45
GLZ001.A0101_02.YP2.1	2000464	2000480		YPO_RS09760	16
GLZ001.A0101_02.YP2.1	2002779	2002791		manX	12
GLZ001.A0101_02.YP2.1	2004589	2004590		YPO_RS09780	1
GLZ001.A0101_02.YP2.1	2005871	2005878		YPO_RS09780	7
GLZ001.A0101_02.YP2.1	2009632	2009639		YPO_RS09800	7
GLZ001.A0101_02.YP2.1	2009963	2009969		hpaD	6
GLZ001.A0101_02.YP2.1	2012172	2012228		hpaI	56
GLZ001.A0101_02.YP2.1	2013558	2013582		hpaX	24
GLZ001.A0101_02.YP2.1	2015677	2015693		hpaB	16
GLZ001.A0101_02.YP2.1	2015854	2015877		hpaC	23
GLZ001.A0101_02.YP2.1	2015941	2015947		hpaC	6
GLZ001.A0101_02.YP2.1	2018952	2018958		YPO_RS09845	6
GLZ001.A0101_02.YP2.1	2020777	2020778		YPO_RS09855	1
GLZ001.A0101_02.YP2.1	2023016	2023028		dbpA	12
GLZ001.A0101_02.YP2.1	2024709	2024710		YPO_RS09875	1
GLZ001.A0101_02.YP2.1	2029106	2029139		pip	33
GLZ001.A0101_02.YP2.1	2033228	2033290		YPO_RS09920	62
GLZ001.A0101_02.YP2.1	2037970	2037983		YPO_RS09940	13
GLZ001.A0101_02.YP2.1	2045869	2045904		flgD	35
GLZ001.A0101_02.YP2.1	2047207	2047224		YPO_RS09990	17
GLZ001.A0101_02.YP2.1	2050013	2050028		YPO_RS10010	15
GLZ001.A0101_02.YP2.1	2054965	2054968		flgL	3
GLZ001.A0101_02.YP2.1	2056269	2056283		YPO_RS10030	14
GLZ001.A0101_02.YP2.1	2060031	2060038		YPO_RS10045	7
GLZ001.A0101_02.YP2.1	2060385	2060408		YPO_RS10045	23
GLZ001.A0101_02.YP2.1	2067969	2067971		fliO	2
GLZ001.A0101_02.YP2.1	2070466	2070486		YPO_RS10110	20
GLZ001.A0101_02.YP2.1	2071998	2071999		fliJ	1
GLZ001.A0101_02.YP2.1	2072856	2072865		fliI	9
GLZ001.A0101_02.YP2.1	2080753	2080754		YPO_RS10170	1
GLZ001.A0101_02.YP2.1	2081766	2081786		YPO_RS10170	20
GLZ001.A0101_02.YP2.1	2083503	2083505		YPO_RS10175	2
GLZ001.A0101_02.YP2.1	2083663	2083677		YPO_RS10175	14
GLZ001.A0101_02.YP2.1	2085830	2085835		fliD	5
GLZ001.A0101_02.YP2.1	2086723	2086725		YPO_RS10195	2
GLZ001.A0101_02.YP2.1	2087376	2087378		YPO_RS10195	2
GLZ001.A0101_02.YP2.1	2091295	2091300		tcyJ	5
GLZ001.A0101_02.YP2.1	2091801	2091809		tcyL	8
GLZ001.A0101_02.YP2.1	2094026	2094030		YPO_RS10235	4
GLZ001.A0101_02.YP2.1	2096527	2096532		putA	5
GLZ001.A0101_02.YP2.1	2103068	2103074		efeB	6
GLZ001.A0101_02.YP2.1	2106002	2106017		YPO_RS10275	15
GLZ001.A0101_02.YP2.1	2107228	2107232		cycA	4
GLZ001.A0101_02.YP2.1	2109511	2109520		YPO_RS10290	9
GLZ001.A0101_02.YP2.1	2109803	2109820		YPO_RS10290	17
GLZ001.A0101_02.YP2.1	2110341	2110351		YPO_RS10295	10
GLZ001.A0101_02.YP2.1	2110748	2110783		YPO_RS10300	35
GLZ001.A0101_02.YP2.1	2112094	2112095		uvrY	1
GLZ001.A0101_02.YP2.1	2112356	2112364		uvrY	8
GLZ001.A0101_02.YP2.1	2112787	2112788		uvrC	1
GLZ001.A0101_02.YP2.1	2117239	2117288		YPO_RS10350	49
GLZ001.A0101_02.YP2.1	2117731	2117786		YPO_RS10355	55
GLZ001.A0101_02.YP2.1	2118003	2118123		hcp	120
GLZ001.A0101_02.YP2.1	2118337	2118347		hcp	10
GLZ001.A0101_02.YP2.1	2119000	2119001		YPO_RS10365	1
GLZ001.A0101_02.YP2.1	2122653	2122681		YPO_RS10395	28
GLZ001.A0101_02.YP2.1	2123448	2123456		YPO_RS10405	8
GLZ001.A0101_02.YP2.1	2124049	2124051		YPO_RS10405	2
GLZ001.A0101_02.YP2.1	2124129	2124144		YPO_RS10405	15
GLZ001.A0101_02.YP2.1	2124216	2124217		YPO_RS10405	1
GLZ001.A0101_02.YP2.1	2124299	2124310		YPO_RS10405	11
GLZ001.A0101_02.YP2.1	2126365	2126388		YPO_RS10415	23
GLZ001.A0101_02.YP2.1	2126485	2126550		YPO_RS10415	65
GLZ001.A0101_02.YP2.1	2126630	2126633		YPO_RS10420	3
GLZ001.A0101_02.YP2.1	2126679	2126693		YPO_RS10420	14
GLZ001.A0101_02.YP2.1	2126754	2126791		YPO_RS10420	37
GLZ001.A0101_02.YP2.1	2126869	2126908		YPO_RS10420	39
GLZ001.A0101_02.YP2.1	2128451	2128455		YPO_RS10430	4
GLZ001.A0101_02.YP2.1	2129555	2129557		YPO_RS10435	2
GLZ001.A0101_02.YP2.1	2134706	2134711		YPO_RS10465	5
GLZ001.A0101_02.YP2.1	2138810	2138811		YPO_RS10500	1
GLZ001.A0101_02.YP2.1	2139271	2139291		YPO_RS10505	20
GLZ001.A0101_02.YP2.1	2139370	2139412		YPO_RS10505	42
GLZ001.A0101_02.YP2.1	2141001	2141010		fyuA	9
GLZ001.A0101_02.YP2.1	2145533	2145554		ybtU	21
GLZ001.A0101_02.YP2.1	2145617	2145646		ybtU	29
GLZ001.A0101_02.YP2.1	2146033	2146045		ybtU	12
GLZ001.A0101_02.YP2.1	2147159	2147172		irp1	13
GLZ001.A0101_02.YP2.1	2148843	2148850		irp1	7
GLZ001.A0101_02.YP2.1	2149680	2149683		irp1	3
GLZ001.A0101_02.YP2.1	2150858	2150914		irp1	56
GLZ001.A0101_02.YP2.1	2152271	2152287		irp1	16
GLZ001.A0101_02.YP2.1	2152389	2152393		irp1	4
GLZ001.A0101_02.YP2.1	2152645	2152653		irp1	8
GLZ001.A0101_02.YP2.1	2153722	2153727		irp1	5
GLZ001.A0101_02.YP2.1	2154273	2154292		irp1	19
GLZ001.A0101_02.YP2.1	2154329	2154337		irp1	8
GLZ001.A0101_02.YP2.1	2157099	2157103		irp2	4
GLZ001.A0101_02.YP2.1	2159141	2159149		irp2	8
GLZ001.A0101_02.YP2.1	2159633	2159635		irp2	2
GLZ001.A0101_02.YP2.1	2164630	2164636		ybtP	6
GLZ001.A0101_02.YP2.1	2164800	2164806		ybtP	6
GLZ001.A0101_02.YP2.1	2165501	2165508		ybtQ	7
GLZ001.A0101_02.YP2.1	2165592	2165608		ybtQ	16
GLZ001.A0101_02.YP2.1	2166392	2166393		ybtQ	1
GLZ001.A0101_02.YP2.1	2166589	2166607		ybtQ	18
GLZ001.A0101_02.YP2.1	2167194	2167215		ybtX	21
GLZ001.A0101_02.YP2.1	2167277	2167284		ybtX	7
GLZ001.A0101_02.YP2.1	2167352	2167366		ybtX	14
GLZ001.A0101_02.YP2.1	2170511	2170518		YPO_RS10570	7
GLZ001.A0101_02.YP2.1	2171921	2171936		YPO_RS10580	15
GLZ001.A0101_02.YP2.1	2173651	2173656		YPO_RS10585	5
GLZ001.A0101_02.YP2.1	2174347	2174351		YPO_RS10590	4
GLZ001.A0101_02.YP2.1	2176671	2176674		YPO_RS10595	3
GLZ001.A0101_02.YP2.1	2178499	2178519		YPO_RS10605	20
GLZ001.A0101_02.YP2.1	2182492	2182511		YPO_RS10615	19
GLZ001.A0101_02.YP2.1	2183694	2183701		YPO_RS10620	7
GLZ001.A0101_02.YP2.1	2184791	2184795		YPO_RS10620	4
GLZ001.A0101_02.YP2.1	2185539	2185540		YPO_RS10630	1
GLZ001.A0101_02.YP2.1	2187180	2187185		YPO_RS10635	5
GLZ001.A0101_02.YP2.1	2187221	2187222		YPO_RS10635	1
GLZ001.A0101_02.YP2.1	2187759	2187770		YPO_RS10640	11
GLZ001.A0101_02.YP2.1	2187795	2187808		YPO_RS10645	13
GLZ001.A0101_02.YP2.1	2188891	2188898		YPO_RS10650	7
GLZ001.A0101_02.YP2.1	2189870	2189883		YPO_RS10655	13
GLZ001.A0101_02.YP2.1	2195730	2195731		ansP	1
GLZ001.A0101_02.YP2.1	2196676	2196678		YPO_RS10680	2
GLZ001.A0101_02.YP2.1	2202434	2202436		YPO_RS10700	2
GLZ001.A0101_02.YP2.1	2207322	2207327		YPO_RS10715	5
GLZ001.A0101_02.YP2.1	2207443	2207459		YPO_RS10715	16
GLZ001.A0101_02.YP2.1	2207745	2207751		YPO_RS10720	6
GLZ001.A0101_02.YP2.1	2210946	2210960		tehB	14
GLZ001.A0101_02.YP2.1	2217902	2217907		pgaB	5
GLZ001.A0101_02.YP2.1	2217902	2217907		YPO_RS10760	5
GLZ001.A0101_02.YP2.1	2218038	2218048		YPO_RS10760	10
GLZ001.A0101_02.YP2.1	2219327	2219336		pgaD	9
GLZ001.A0101_02.YP2.1	2220418	2220425		YPO_RS10770	7
GLZ001.A0101_02.YP2.1	2224775	2224781		narX	6
GLZ001.A0101_02.YP2.1	2226519	2226551		YPO_RS10800	32
GLZ001.A0101_02.YP2.1	2232010	2232023		astD	13
GLZ001.A0101_02.YP2.1	2237356	2237378		YPO_RS10835	22
GLZ001.A0101_02.YP2.1	2243684	2243694		YPO_RS10870	10
GLZ001.A0101_02.YP2.1	2244184	2244185		YPO_RS10875	1
GLZ001.A0101_02.YP2.1	2245138	2245161		YPO_RS10875	23
GLZ001.A0101_02.YP2.1	2248285	2248320		YPO_RS10885	35
GLZ001.A0101_02.YP2.1	2251106	2251114		YPO_RS10900	8
GLZ001.A0101_02.YP2.1	2251418	2251419		YPO_RS10900	1
GLZ001.A0101_02.YP2.1	2252963	2252971		YPO_RS10905	8
GLZ001.A0101_02.YP2.1	2252968	2252979		YPO_RS10910	11
GLZ001.A0101_02.YP2.1	2254732	2254736		YPO_RS10915	4
GLZ001.A0101_02.YP2.1	2255868	2255878		YPO_RS10925	10
GLZ001.A0101_02.YP2.1	2256117	2256148		YPO_RS10925	31
GLZ001.A0101_02.YP2.1	2256318	2256322		YPO_RS10925	4
GLZ001.A0101_02.YP2.1	2256506	2256572		YPO_RS10925	66
GLZ001.A0101_02.YP2.1	2256752	2256754		YPO_RS10925	2
GLZ001.A0101_02.YP2.1	2258636	2258650		YPO_RS10935	14
GLZ001.A0101_02.YP2.1	2259024	2259053		YPO_RS10935	29
GLZ001.A0101_02.YP2.1	2259144	2259153		YPO_RS10935	9
GLZ001.A0101_02.YP2.1	2259382	2259391		YPO_RS10935	9
GLZ001.A0101_02.YP2.1	2259682	2259686		YPO_RS10935	4
GLZ001.A0101_02.YP2.1	2259745	2259784		YPO_RS10935	39
GLZ001.A0101_02.YP2.1	2259879	2259900		YPO_RS10935	21
GLZ001.A0101_02.YP2.1	2260115	2260135		YPO_RS10935	20
GLZ001.A0101_02.YP2.1	2260488	2260506		YPO_RS10935	18
GLZ001.A0101_02.YP2.1	2260721	2260723		YPO_RS10935	2
GLZ001.A0101_02.YP2.1	2263291	2263301		YPO_RS10940	10
GLZ001.A0101_02.YP2.1	2265694	2265710		YPO_RS10955	16
GLZ001.A0101_02.YP2.1	2265800	2265811		YPO_RS10955	11
GLZ001.A0101_02.YP2.1	2266243	2266246		YPO_RS10960	3
GLZ001.A0101_02.YP2.1	2266396	2266430		YPO_RS10965	34
GLZ001.A0101_02.YP2.1	2267061	2267063		YPO_RS10965	2
GLZ001.A0101_02.YP2.1	2267484	2267491		YPO_RS10970	7
GLZ001.A0101_02.YP2.1	2267593	2267597		YPO_RS10970	4
GLZ001.A0101_02.YP2.1	2267646	2267655		YPO_RS10970	9
GLZ001.A0101_02.YP2.1	2268081	2268088		YPO_RS10970	7
GLZ001.A0101_02.YP2.1	2268553	2268569		YPO_RS10975	16
GLZ001.A0101_02.YP2.1	2268861	2268874		YPO_RS10975	13
GLZ001.A0101_02.YP2.1	2269041	2269042		YPO_RS10975	1
GLZ001.A0101_02.YP2.1	2269863	2269873		YPO_RS10980	10
GLZ001.A0101_02.YP2.1	2274727	2274743		YPO_RS11005	16
GLZ001.A0101_02.YP2.1	2277269	2277305		YPO_RS11015	36
GLZ001.A0101_02.YP2.1	2279511	2279532		YPO_RS11025	21
GLZ001.A0101_02.YP2.1	2280329	2280331		YPO_RS11030	2
GLZ001.A0101_02.YP2.1	2280567	2280611		YPO_RS11035	44
GLZ001.A0101_02.YP2.1	2280760	2280768		YPO_RS11035	8
GLZ001.A0101_02.YP2.1	2283602	2283612		pth	10
GLZ001.A0101_02.YP2.1	2285487	2285493		YPO_RS11060	6
GLZ001.A0101_02.YP2.1	2291031	2291044		prmC	13
GLZ001.A0101_02.YP2.1	2291415	2291419		YPO_RS11090	4
GLZ001.A0101_02.YP2.1	2299746	2299760		YPO_RS11135	14
GLZ001.A0101_02.YP2.1	2299990	2300030		YPO_RS11135	40
GLZ001.A0101_02.YP2.1	2300858	2300870		YPO_RS11140	12
GLZ001.A0101_02.YP2.1	2301741	2301747		YPO_RS11145	6
GLZ001.A0101_02.YP2.1	2301908	2301910		YPO_RS11145	2
GLZ001.A0101_02.YP2.1	2303328	2303339		YPO_RS11155	11
GLZ001.A0101_02.YP2.1	2303913	2303920		YPO_RS11155	7
GLZ001.A0101_02.YP2.1	2306743	2306745		YPO_RS11175	2
GLZ001.A0101_02.YP2.1	2306902	2306910		YPO_RS11175	8
GLZ001.A0101_02.YP2.1	2307056	2307066		YPO_RS11175	10
GLZ001.A0101_02.YP2.1	2308411	2308417		YPO_RS11185	6
GLZ001.A0101_02.YP2.1	2313233	2313244		YPO_RS11210	11
GLZ001.A0101_02.YP2.1	2314998	2315005		murJ	7
GLZ001.A0101_02.YP2.1	2315314	2315319		murJ	5
GLZ001.A0101_02.YP2.1	2316450	2316540		YPO_RS11220	90
GLZ001.A0101_02.YP2.1	2316622	2316644		YPO_RS11220	22
GLZ001.A0101_02.YP2.1	2316732	2316763		YPO_RS11220	31
GLZ001.A0101_02.YP2.1	2316950	2316954		YPO_RS11220	4
GLZ001.A0101_02.YP2.1	2317194	2317222		YPO_RS11220	28
GLZ001.A0101_02.YP2.1	2317255	2317258		YPO_RS11220	3
GLZ001.A0101_02.YP2.1	2317299	2317314		YPO_RS11220	15
GLZ001.A0101_02.YP2.1	2317522	2317530		YPO_RS11220	8
GLZ001.A0101_02.YP2.1	2318132	2318150		YPO_RS11225	18
GLZ001.A0101_02.YP2.1	2318202	2318217		YPO_RS11225	15
GLZ001.A0101_02.YP2.1	2318265	2318274		YPO_RS11225	9
GLZ001.A0101_02.YP2.1	2318463	2318468		YPO_RS11225	5
GLZ001.A0101_02.YP2.1	2318832	2318844		YPO_RS11225	12
GLZ001.A0101_02.YP2.1	2318913	2318953		YPO_RS11225	40
GLZ001.A0101_02.YP2.1	2319023	2319030		YPO_RS11225	7
GLZ001.A0101_02.YP2.1	2319115	2319141		YPO_RS11225	26
GLZ001.A0101_02.YP2.1	2319496	2319550		YPO_RS11225	54
GLZ001.A0101_02.YP2.1	2319763	2319773		YPO_RS11225	10
GLZ001.A0101_02.YP2.1	2320049	2320050		YPO_RS11225	1
GLZ001.A0101_02.YP2.1	2320125	2320129		YPO_RS11225	4
GLZ001.A0101_02.YP2.1	2320288	2320302		YPO_RS11225	14
GLZ001.A0101_02.YP2.1	2320580	2320582		YPO_RS11225	2
GLZ001.A0101_02.YP2.1	2322119	2322136		YPO_RS11225	17
GLZ001.A0101_02.YP2.1	2322190	2322191		YPO_RS11225	1
GLZ001.A0101_02.YP2.1	2322440	2322442		YPO_RS11225	2
GLZ001.A0101_02.YP2.1	2322813	2322825		YPO_RS11225	12
GLZ001.A0101_02.YP2.1	2327789	2327792		cmoB	3
GLZ001.A0101_02.YP2.1	2328789	2328791		cmoA	2
GLZ001.A0101_02.YP2.1	2335718	2335722		ruvA	4
GLZ001.A0101_02.YP2.1	2337590	2337591		znuB	1
GLZ001.A0101_02.YP2.1	2338436	2338442		znuC	6
GLZ001.A0101_02.YP2.1	2339827	2339837		znuA	10
GLZ001.A0101_02.YP2.1	2340712	2340720		mepM	8
GLZ001.A0101_02.YP2.1	2341414	2341417		mepM	3
GLZ001.A0101_02.YP2.1	2342451	2342453		lpxM	2
GLZ001.A0101_02.YP2.1	2345152	2345155		YPO_RS11325	3
GLZ001.A0101_02.YP2.1	2353712	2353714		YPO_RS11365	2
GLZ001.A0101_02.YP2.1	2353821	2353829		YPO_RS11365	8
GLZ001.A0101_02.YP2.1	2354602	2354611		fadD	9
GLZ001.A0101_02.YP2.1	2357452	2357455		rnd	3
GLZ001.A0101_02.YP2.1	2358832	2358834		minC	2
GLZ001.A0101_02.YP2.1	2361031	2361039		YPO_RS11405	8
GLZ001.A0101_02.YP2.1	2370506	2370508		YPO_RS11470	2
GLZ001.A0101_02.YP2.1	2370717	2370722		YPO_RS11475	5
GLZ001.A0101_02.YP2.1	2374917	2374937		YPO_RS11505	20
GLZ001.A0101_02.YP2.1	2375654	2375661		YPO_RS11510	7
GLZ001.A0101_02.YP2.1	2376899	2376936		YPO_RS11515	37
GLZ001.A0101_02.YP2.1	2376941	2376942		YPO_RS11520	1
GLZ001.A0101_02.YP2.1	2376970	2376972		YPO_RS11520	2
GLZ001.A0101_02.YP2.1	2382791	2382807		YPO_RS11550	16
GLZ001.A0101_02.YP2.1	2384352	2384359		YPO_RS11570	7
GLZ001.A0101_02.YP2.1	2387430	2387437		YPO_RS11590	7
GLZ001.A0101_02.YP2.1	2395001	2395010		YPO_RS11630	9
GLZ001.A0101_02.YP2.1	2395386	2395395		YPO_RS11635	9
GLZ001.A0101_02.YP2.1	2395753	2395813		YPO_RS11635	60
GLZ001.A0101_02.YP2.1	2396164	2396207		YPO_RS11640	43
GLZ001.A0101_02.YP2.1	2397301	2397302		YPO_RS11655	1
GLZ001.A0101_02.YP2.1	2400612	2400618		YPO_RS11660	6
GLZ001.A0101_02.YP2.1	2400853	2400855		YPO_RS11665	2
GLZ001.A0101_02.YP2.1	2400987	2400990		YPO_RS11665	3
GLZ001.A0101_02.YP2.1	2401255	2401262		YPO_RS11665	7
GLZ001.A0101_02.YP2.1	2401867	2401869		YPO_RS11670	2
GLZ001.A0101_02.YP2.1	2402833	2402834		YPO_RS11675	1
GLZ001.A0101_02.YP2.1	2409206	2409210		YPO_RS11700	4
GLZ001.A0101_02.YP2.1	2413737	2413741		YPO_RS11720	4
GLZ001.A0101_02.YP2.1	2415563	2415565		YPO_RS11725	2
GLZ001.A0101_02.YP2.1	2415687	2415690		YPO_RS11725	3
GLZ001.A0101_02.YP2.1	2416242	2416248		YPO_RS11725	6
GLZ001.A0101_02.YP2.1	2416704	2416718		YPO_RS11730	14
GLZ001.A0101_02.YP2.1	2420362	2420368		YPO_RS11745	6
GLZ001.A0101_02.YP2.1	2422821	2422823		yeaG	2
GLZ001.A0101_02.YP2.1	2425664	2425678		YPO_RS11760	14
GLZ001.A0101_02.YP2.1	2434218	2434228		selD	10
GLZ001.A0101_02.YP2.1	2434725	2434735		selD	10
GLZ001.A0101_02.YP2.1	2435493	2435512		YPO_RS11810	19
GLZ001.A0101_02.YP2.1	2435722	2435731		YPO_RS11810	9
GLZ001.A0101_02.YP2.1	2437376	2437398		YPO_RS11820	22
GLZ001.A0101_02.YP2.1	2438369	2438370		xthA	1
GLZ001.A0101_02.YP2.1	2439520	2439545		YPO_RS11830	25
GLZ001.A0101_02.YP2.1	2439594	2439615		YPO_RS11830	21
GLZ001.A0101_02.YP2.1	2439679	2439705		YPO_RS11830	26
GLZ001.A0101_02.YP2.1	2439765	2439842		YPO_RS11830	77
GLZ001.A0101_02.YP2.1	2439892	2439997		YPO_RS11830	105
GLZ001.A0101_02.YP2.1	2440156	2440259		YPO_RS11830	103
GLZ001.A0101_02.YP2.1	2440483	2440519		YPO_RS11835	36
GLZ001.A0101_02.YP2.1	2442373	2442378		purU	5
GLZ001.A0101_02.YP2.1	2442454	2442458		purU	4
GLZ001.A0101_02.YP2.1	2445247	2445278		rssB	31
GLZ001.A0101_02.YP2.1	2445691	2445711		rssB	20
GLZ001.A0101_02.YP2.1	2446835	2446852		YPO_RS11870	17
GLZ001.A0101_02.YP2.1	2446963	2446971		YPO_RS11870	8
GLZ001.A0101_02.YP2.1	2447358	2447359		YPO_RS11870	1
GLZ001.A0101_02.YP2.1	2447713	2447722		YPO_RS11870	9
GLZ001.A0101_02.YP2.1	2455046	2455067		adhE	21
GLZ001.A0101_02.YP2.1	2457569	2457574		oppA	5
GLZ001.A0101_02.YP2.1	2457748	2457755		oppA	7
GLZ001.A0101_02.YP2.1	2457819	2457839		oppA	20
GLZ001.A0101_02.YP2.1	2458116	2458121		oppA	5
GLZ001.A0101_02.YP2.1	2458447	2458459		oppA	12
GLZ001.A0101_02.YP2.1	2459201	2459206		oppA	5
GLZ001.A0101_02.YP2.1	2459445	2459468		oppB	23
GLZ001.A0101_02.YP2.1	2460356	2460362		oppC	6
GLZ001.A0101_02.YP2.1	2460414	2460416		oppC	2
GLZ001.A0101_02.YP2.1	2461516	2461525		YPO_RS11920	9
GLZ001.A0101_02.YP2.1	2463709	2463724		YPO_RS11930	15
GLZ001.A0101_02.YP2.1	2464223	2464224		YPO_RS11935	1
GLZ001.A0101_02.YP2.1	2465336	2465339		cls	3
GLZ001.A0101_02.YP2.1	2465655	2465659		cls	4
GLZ001.A0101_02.YP2.1	2467688	2467690		YPO_RS11950	2
GLZ001.A0101_02.YP2.1	2471953	2471956		yciA	3
GLZ001.A0101_02.YP2.1	2472125	2472139		YPO_RS11985	14
GLZ001.A0101_02.YP2.1	2472598	2472604		YPO_RS11985	6
GLZ001.A0101_02.YP2.1	2472978	2472987		YPO_RS11990	9
GLZ001.A0101_02.YP2.1	2474722	2474726		YPO_RS12000	4
GLZ001.A0101_02.YP2.1	2475839	2475869		YPO_RS12005	30
GLZ001.A0101_02.YP2.1	2477029	2477034		YPO_RS12015	5
GLZ001.A0101_02.YP2.1	2477783	2477796		trpA	13
GLZ001.A0101_02.YP2.1	2483450	2483469		YPO_RS12045	19
GLZ001.A0101_02.YP2.1	2485995	2485998		YPO_RS12060	3
GLZ001.A0101_02.YP2.1	2486768	2486780		rluB	12
GLZ001.A0101_02.YP2.1	2487172	2487174		rluB	2
GLZ001.A0101_02.YP2.1	2489397	2489433		sohB	36
GLZ001.A0101_02.YP2.1	2489710	2489713		sohB	3
GLZ001.A0101_02.YP2.1	2490216	2490218		sohB	2
GLZ001.A0101_02.YP2.1	2490384	2490396		YPO_RS12085	12
GLZ001.A0101_02.YP2.1	2490777	2490787		YPO_RS12090	10
GLZ001.A0101_02.YP2.1	2490960	2490997		YPO_RS12090	37
GLZ001.A0101_02.YP2.1	2491162	2491241		topA	79
GLZ001.A0101_02.YP2.1	2494984	2495005		cysB	21
GLZ001.A0101_02.YP2.1	2495427	2495451		YPO_RS12105	24
GLZ001.A0101_02.YP2.1	2495718	2495744		YPO_RS12105	26
GLZ001.A0101_02.YP2.1	2495845	2495847		YPO_RS12105	2
GLZ001.A0101_02.YP2.1	2495886	2495930		YPO_RS12105	44
GLZ001.A0101_02.YP2.1	2496192	2496203		YPO_RS12105	11
GLZ001.A0101_02.YP2.1	2496634	2496638		acnA	4
GLZ001.A0101_02.YP2.1	2501139	2501155		pgpB	16
GLZ001.A0101_02.YP2.1	2502264	2502269		lapB	5
GLZ001.A0101_02.YP2.1	2503056	2503077		YPO_RS12135	21
GLZ001.A0101_02.YP2.1	2503310	2503335		YPO_RS12135	25
GLZ001.A0101_02.YP2.1	2505108	2505110		osmB	2
GLZ001.A0101_02.YP2.1	2508495	2508498		YPO_RS12175	3
GLZ001.A0101_02.YP2.1	2513813	2513815		YPO_RS12185	2
GLZ001.A0101_02.YP2.1	2514625	2514632		YPO_RS12190	7
GLZ001.A0101_02.YP2.1	2515504	2515522		YPO_RS12190	18
GLZ001.A0101_02.YP2.1	2516508	2516514		YPO_RS12200	6
GLZ001.A0101_02.YP2.1	2519275	2519304		YPO_RS12215	29
GLZ001.A0101_02.YP2.1	2521118	2521131		rsxC	13
GLZ001.A0101_02.YP2.1	2521868	2521869		rsxC	1
GLZ001.A0101_02.YP2.1	2528331	2528333		YPO_RS12255	2
GLZ001.A0101_02.YP2.1	2536856	2536881		YPO_RS12280	25
GLZ001.A0101_02.YP2.1	2537985	2538025		araC	40
GLZ001.A0101_02.YP2.1	2538497	2538499		araC	2
GLZ001.A0101_02.YP2.1	2540151	2540157		YPO_RS12295	6
GLZ001.A0101_02.YP2.1	2543290	2543311		YPO_RS12305	21
GLZ001.A0101_02.YP2.1	2545225	2545239		fumC	14
GLZ001.A0101_02.YP2.1	2545446	2545454		fumC	8
GLZ001.A0101_02.YP2.1	2548266	2548269		YPO_RS12325	3
GLZ001.A0101_02.YP2.1	2548333	2548366		YPO_RS12325	33
GLZ001.A0101_02.YP2.1	2549506	2549518		YPO_RS12330	12
GLZ001.A0101_02.YP2.1	2551666	2551670		YPO_RS12340	4
GLZ001.A0101_02.YP2.1	2552286	2552304		bioD	18
GLZ001.A0101_02.YP2.1	2552561	2552562		bioD	1
GLZ001.A0101_02.YP2.1	2554373	2554633		YPO_RS12355	260
GLZ001.A0101_02.YP2.1	2554658	2555065		YPO_RS12360	407
GLZ001.A0101_02.YP2.1	2555162	2555608		YPO_RS12365	446
GLZ001.A0101_02.YP2.1	2555780	2556832		YPO_RS12370	1052
GLZ001.A0101_02.YP2.1	2556844	2557161		YPO_RS12375	317
GLZ001.A0101_02.YP2.1	2557164	2557415		YPO_RS12380	251
GLZ001.A0101_02.YP2.1	2557451	2557684		YPO_RS12385	233
GLZ001.A0101_02.YP2.1	2557749	2559461		YPO_RS12390	1712
GLZ001.A0101_02.YP2.1	2559474	2559761		YPO_RS12395	287
GLZ001.A0101_02.YP2.1	2559765	2560790		YPO_RS12400	1025
GLZ001.A0101_02.YP2.1	2560790	2562034		YPO_RS12405	1244
GLZ001.A0101_02.YP2.1	2562123	2562371		YPO_RS12410	248
GLZ001.A0101_02.YP2.1	2562568	2562765		YPO_RS12415	197
GLZ001.A0101_02.YP2.1	2565808	2565834		YPO_RS12435	26
GLZ001.A0101_02.YP2.1	2565984	2566019		YPO_RS12435	35
GLZ001.A0101_02.YP2.1	2566440	2566457		YPO_RS12435	17
GLZ001.A0101_02.YP2.1	2566855	2566866		YPO_RS12440	11
GLZ001.A0101_02.YP2.1	2570940	2570947		YPO_RS12450	7
GLZ001.A0101_02.YP2.1	2571563	2571570		YPO_RS12455	7
GLZ001.A0101_02.YP2.1	2572437	2572441		YPO_RS12455	4
GLZ001.A0101_02.YP2.1	2573263	2573269		YPO_RS12455	6
GLZ001.A0101_02.YP2.1	2577580	2577588		YPO_RS12465	8
GLZ001.A0101_02.YP2.1	2577735	2577744		YPO_RS12465	9
GLZ001.A0101_02.YP2.1	2582808	2582864		YPO_RS12495	56
GLZ001.A0101_02.YP2.1	2586583	2586584		YPO_RS12510	1
GLZ001.A0101_02.YP2.1	2592698	2592703		YPO_RS12530	5
GLZ001.A0101_02.YP2.1	2596675	2596676		rstB	1
GLZ001.A0101_02.YP2.1	2606354	2606416		asr	62
GLZ001.A0101_02.YP2.1	2606857	2606867		YPO_RS12590	10
GLZ001.A0101_02.YP2.1	2609539	2609552		hrpA	13
GLZ001.A0101_02.YP2.1	2614572	2614577		YPO_RS12615	5
GLZ001.A0101_02.YP2.1	2617202	2617213		YPO_RS12635	11
GLZ001.A0101_02.YP2.1	2622379	2622403		YPO_RS12655	24
GLZ001.A0101_02.YP2.1	2627894	2627903		ttcA	9
GLZ001.A0101_02.YP2.1	2628061	2628073		ttcA	12
GLZ001.A0101_02.YP2.1	2629261	2629283		YPO_RS12675	22
GLZ001.A0101_02.YP2.1	2630107	2630137		YPO_RS12680	30
GLZ001.A0101_02.YP2.1	2630529	2630534		YPO_RS12680	5
GLZ001.A0101_02.YP2.1	2630616	2630631		YPO_RS12680	15
GLZ001.A0101_02.YP2.1	2630664	2630686		YPO_RS12680	22
GLZ001.A0101_02.YP2.1	2632546	2632558		YPO_RS12690	12
GLZ001.A0101_02.YP2.1	2633332	2633342		YPO_RS12690	10
GLZ001.A0101_02.YP2.1	2638978	2638981		tyrR	3
GLZ001.A0101_02.YP2.1	2646129	2646142		pspF	13
GLZ001.A0101_02.YP2.1	2649043	2649055		sapA	12
GLZ001.A0101_02.YP2.1	2650602	2650614		sapC	12
GLZ001.A0101_02.YP2.1	2651400	2651421		sapD	21
GLZ001.A0101_02.YP2.1	2657676	2657678		YPO_RS12810	2
GLZ001.A0101_02.YP2.1	2657847	2657866		YPO_RS12810	19
GLZ001.A0101_02.YP2.1	2662642	2662645		tyrS	3
GLZ001.A0101_02.YP2.1	2666674	2666683		rovA	9
GLZ001.A0101_02.YP2.1	2668202	2668211		YPO_RS12865	9
GLZ001.A0101_02.YP2.1	2670047	2670065		eptA	18
GLZ001.A0101_02.YP2.1	2675774	2675777		YPO_RS12890	3
GLZ001.A0101_02.YP2.1	2677017	2677027		rnt	10
GLZ001.A0101_02.YP2.1	2677053	2677088		rnt	35
GLZ001.A0101_02.YP2.1	2681325	2681330		purR	5
GLZ001.A0101_02.YP2.1	2681994	2681995		purR	1
GLZ001.A0101_02.YP2.1	2684148	2684150		YPO_RS12940	2
GLZ001.A0101_02.YP2.1	2686491	2686497		YPO_RS12950	6
GLZ001.A0101_02.YP2.1	2686998	2687011		YPO_RS12955	13
GLZ001.A0101_02.YP2.1	2687770	2687772		YPO_RS12960	2
GLZ001.A0101_02.YP2.1	2691434	2691437		YPO_RS12980	3
GLZ001.A0101_02.YP2.1	2695389	2695394		YPO_RS13000	5
GLZ001.A0101_02.YP2.1	2699223	2699224		sufC	1
GLZ001.A0101_02.YP2.1	2701419	2701441		sufA	22
GLZ001.A0101_02.YP2.1	2706916	2706924		ydiK	8
GLZ001.A0101_02.YP2.1	2715927	2715946		YPO_RS13080	19
GLZ001.A0101_02.YP2.1	2716582	2716611		arnF	29
GLZ001.A0101_02.YP2.1	2716952	2716955		arnF	3
GLZ001.A0101_02.YP2.1	2717701	2717704		arnT	3
GLZ001.A0101_02.YP2.1	2719477	2719478		YPO_RS13105	1
GLZ001.A0101_02.YP2.1	2723545	2723547		arnB	2
GLZ001.A0101_02.YP2.1	2724343	2724385		btuD	42
GLZ001.A0101_02.YP2.1	2725089	2725090		btuD	1
GLZ001.A0101_02.YP2.1	2738742	2738744		yfeA	2
GLZ001.A0101_02.YP2.1	2748512	2748570		YPO_RS13255	58
GLZ001.A0101_02.YP2.1	2749120	2749126		YPO_RS13255	6
GLZ001.A0101_02.YP2.1	2749934	2749940		YPO_RS13265	6
GLZ001.A0101_02.YP2.1	2754131	2754148		YPO_RS13285	17
GLZ001.A0101_02.YP2.1	2754181	2754184		YPO_RS13285	3
GLZ001.A0101_02.YP2.1	2754549	2754554		YPO_RS13285	5
GLZ001.A0101_02.YP2.1	2754952	2755046		YPO_RS13290	94
GLZ001.A0101_02.YP2.1	2755144	2755168		YPO_RS13290	24
GLZ001.A0101_02.YP2.1	2755258	2755260		YPO_RS13290	2
GLZ001.A0101_02.YP2.1	2755461	2755505		YPO_RS13290	44
GLZ001.A0101_02.YP2.1	2760227	2760262		YPO_RS13315	35
GLZ001.A0101_02.YP2.1	2763974	2764007		csy1	33
GLZ001.A0101_02.YP2.1	2772128	2772137		YPO_RS13355	9
GLZ001.A0101_02.YP2.1	2772900	2772912		YPO_RS13355	12
GLZ001.A0101_02.YP2.1	2773234	2773241		YPO_RS13355	7
GLZ001.A0101_02.YP2.1	2774970	2774979		YPO_RS13365	9
GLZ001.A0101_02.YP2.1	2776996	2777002		YPO_RS13375	6
GLZ001.A0101_02.YP2.1	2777493	2777509		YPO_RS13375	16
GLZ001.A0101_02.YP2.1	2777510	2777519		YPO_RS13380	9
GLZ001.A0101_02.YP2.1	2777854	2777856		YPO_RS13380	2
GLZ001.A0101_02.YP2.1	2778327	2778337		YPO_RS13380	10
GLZ001.A0101_02.YP2.1	2779769	2779780		YPO_RS13385	11
GLZ001.A0101_02.YP2.1	2782739	2782740		ugpC	1
GLZ001.A0101_02.YP2.1	2783052	2783071		ugpC	19
GLZ001.A0101_02.YP2.1	2783941	2783943		YPO_RS13405	2
GLZ001.A0101_02.YP2.1	2784064	2784065		YPO_RS13405	1
GLZ001.A0101_02.YP2.1	2784193	2784208		YPO_RS13405	15
GLZ001.A0101_02.YP2.1	2784325	2784335		YPO_RS13405	10
GLZ001.A0101_02.YP2.1	2784866	2784901		YPO_RS13410	35
GLZ001.A0101_02.YP2.1	2785303	2785325		YPO_RS13415	22
GLZ001.A0101_02.YP2.1	2785618	2785627		YPO_RS13415	9
GLZ001.A0101_02.YP2.1	2786220	2786255		YPO_RS13425	35
GLZ001.A0101_02.YP2.1	2786442	2786460		YPO_RS13430	18
GLZ001.A0101_02.YP2.1	2786719	2786745		YPO_RS13430	26
GLZ001.A0101_02.YP2.1	2786832	2786841		YPO_RS13430	9
GLZ001.A0101_02.YP2.1	2787015	2787036		YPO_RS13430	21
GLZ001.A0101_02.YP2.1	2788796	2788800		YPO_RS13435	4
GLZ001.A0101_02.YP2.1	2788885	2788927		YPO_RS13435	42
GLZ001.A0101_02.YP2.1	2789632	2789641		YPO_RS13445	9
GLZ001.A0101_02.YP2.1	2789783	2789862		YPO_RS13445	79
GLZ001.A0101_02.YP2.1	2789895	2789910		YPO_RS13445	15
GLZ001.A0101_02.YP2.1	2790036	2790045		YPO_RS13445	9
GLZ001.A0101_02.YP2.1	2790100	2790104		YPO_RS13445	4
GLZ001.A0101_02.YP2.1	2795004	2795016		cdiA	12
GLZ001.A0101_02.YP2.1	2795988	2795995		cdiA	7
GLZ001.A0101_02.YP2.1	2800567	2800581		YPO_RS13460	14
GLZ001.A0101_02.YP2.1	2800978	2801016		YPO_RS13460	38
GLZ001.A0101_02.YP2.1	2802545	2802568		YPO_RS13470	23
GLZ001.A0101_02.YP2.1	2804159	2804162		YPO_RS13470	3
GLZ001.A0101_02.YP2.1	2807875	2807877		YPO_RS13485	2
GLZ001.A0101_02.YP2.1	2807934	2807972		YPO_RS13485	38
GLZ001.A0101_02.YP2.1	2810756	2810757		YPO_RS13495	1
GLZ001.A0101_02.YP2.1	2811283	2811317		YPO_RS13500	34
GLZ001.A0101_02.YP2.1	2811619	2811623		YPO_RS13500	4
GLZ001.A0101_02.YP2.1	2813712	2813734		YPO_RS13510	22
GLZ001.A0101_02.YP2.1	2813930	2813966		YPO_RS13510	36
GLZ001.A0101_02.YP2.1	2814030	2814049		YPO_RS13510	19
GLZ001.A0101_02.YP2.1	2814145	2814169		YPO_RS13510	24
GLZ001.A0101_02.YP2.1	2814211	2814241		YPO_RS13510	30
GLZ001.A0101_02.YP2.1	2814291	2814346		YPO_RS13510	55
GLZ001.A0101_02.YP2.1	2814576	2814583		YPO_RS13515	7
GLZ001.A0101_02.YP2.1	2814875	2814877		YPO_RS13515	2
GLZ001.A0101_02.YP2.1	2815517	2815520		YPO_RS13520	3
GLZ001.A0101_02.YP2.1	2821143	2821155		YPO_RS13550	12
GLZ001.A0101_02.YP2.1	2823926	2823940		glnP	14
GLZ001.A0101_02.YP2.1	2825864	2825869		YPO_RS13570	5
GLZ001.A0101_02.YP2.1	2825926	2825955		YPO_RS13570	29
GLZ001.A0101_02.YP2.1	2826176	2826178		YPO_RS13570	2
GLZ001.A0101_02.YP2.1	2831200	2831226		ybiB	26
GLZ001.A0101_02.YP2.1	2842945	2842947		YPO_RS13645	2
GLZ001.A0101_02.YP2.1	2843227	2843252		YPO_RS13645	25
GLZ001.A0101_02.YP2.1	2844147	2844150		YPO_RS13650	3
GLZ001.A0101_02.YP2.1	2845763	2845765		YPO_RS13655	2
GLZ001.A0101_02.YP2.1	2846721	2846736		YPO_RS13660	15
GLZ001.A0101_02.YP2.1	2851550	2851566		idnO	16
GLZ001.A0101_02.YP2.1	2851824	2851850		idnO	26
GLZ001.A0101_02.YP2.1	2853907	2853961		YPO_RS13690	54
GLZ001.A0101_02.YP2.1	2854053	2854065		YPO_RS13690	12
GLZ001.A0101_02.YP2.1	2854196	2854233		YPO_RS13690	37
GLZ001.A0101_02.YP2.1	2854271	2854306		YPO_RS13690	35
GLZ001.A0101_02.YP2.1	2854428	2854445		YPO_RS13690	17
GLZ001.A0101_02.YP2.1	2854669	2854680		YPO_RS13690	11
GLZ001.A0101_02.YP2.1	2855756	2855760		nuoN	4
GLZ001.A0101_02.YP2.1	2857324	2857338		nuoM	14
GLZ001.A0101_02.YP2.1	2857700	2857702		nuoM	2
GLZ001.A0101_02.YP2.1	2862941	2862947		nuoG	6
GLZ001.A0101_02.YP2.1	2868870	2868872		nuoC	2
GLZ001.A0101_02.YP2.1	2874318	2874321		yfbR	3
GLZ001.A0101_02.YP2.1	2879914	2879923		ackA	9
GLZ001.A0101_02.YP2.1	2880449	2880454		ackA	5
GLZ001.A0101_02.YP2.1	2883208	2883209		pta	1
GLZ001.A0101_02.YP2.1	2884286	2884288		YPO_RS13805	2
GLZ001.A0101_02.YP2.1	2885304	2885317		YPO_RS13810	13
GLZ001.A0101_02.YP2.1	2885536	2885558		YPO_RS13815	22
GLZ001.A0101_02.YP2.1	2885775	2885790		YPO_RS13815	15
GLZ001.A0101_02.YP2.1	2887087	2887089		YPO_RS13825	2
GLZ001.A0101_02.YP2.1	2891381	2891401		YPO_RS13830	20
GLZ001.A0101_02.YP2.1	2897406	2897409		YPO_RS13845	3
GLZ001.A0101_02.YP2.1	2897596	2897609		YPO_RS13845	13
GLZ001.A0101_02.YP2.1	2902736	2902759		YPO_RS13865	23
GLZ001.A0101_02.YP2.1	2903054	2903079		YPO_RS13865	25
GLZ001.A0101_02.YP2.1	2907390	2907413		iolC	23
GLZ001.A0101_02.YP2.1	2907529	2907560		iolC	31
GLZ001.A0101_02.YP2.1	2908169	2908190		iolC	21
GLZ001.A0101_02.YP2.1	2908960	2908961		iolE	1
GLZ001.A0101_02.YP2.1	2910287	2910290		iolB	3
GLZ001.A0101_02.YP2.1	2910902	2910907		YPO_RS13900	5
GLZ001.A0101_02.YP2.1	2911761	2911780		YPO_RS13900	19
GLZ001.A0101_02.YP2.1	2914295	2914317		YPO_RS13920	22
GLZ001.A0101_02.YP2.1	2914468	2914470		YPO_RS13920	2
GLZ001.A0101_02.YP2.1	2914683	2914765		YPO_RS13920	82
GLZ001.A0101_02.YP2.1	2915421	2915472		YPO_RS13925	51
GLZ001.A0101_02.YP2.1	2915642	2915653		YPO_RS13925	11
GLZ001.A0101_02.YP2.1	2915961	2915966		YPO_RS13925	5
GLZ001.A0101_02.YP2.1	2920508	2920510		lipB	2
GLZ001.A0101_02.YP2.1	2926654	2926671		mrdA	17
GLZ001.A0101_02.YP2.1	2926712	2926717		mrdA	5
GLZ001.A0101_02.YP2.1	2930711	2930719		lptE	8
GLZ001.A0101_02.YP2.1	2931898	2931906		leuS	8
GLZ001.A0101_02.YP2.1	2933225	2933226		leuS	1
GLZ001.A0101_02.YP2.1	2935092	2935097		YPO_RS14020	5
GLZ001.A0101_02.YP2.1	2935097	2935098		gltK	1
GLZ001.A0101_02.YP2.1	2935136	2935149		gltK	13
GLZ001.A0101_02.YP2.1	2938831	2938832		lnt	1
GLZ001.A0101_02.YP2.1	2949712	2949717		YPO_RS14100	5
GLZ001.A0101_02.YP2.1	2957471	2957484		glnS	13
GLZ001.A0101_02.YP2.1	2959159	2959165		YPO_RS14135	6
GLZ001.A0101_02.YP2.1	2964923	2964925		fldA	2
GLZ001.A0101_02.YP2.1	2976124	2976128		nrdF	4
GLZ001.A0101_02.YP2.1	2976325	2976350		nrdF	25
GLZ001.A0101_02.YP2.1	2980336	2980350		YPO_RS14235	14
GLZ001.A0101_02.YP2.1	2980424	2980600		YPO_RS14235	176
GLZ001.A0101_02.YP2.1	2981210	2981216		YPO_RS14240	6
GLZ001.A0101_02.YP2.1	2981317	2981331		YPO_RS14240	14
GLZ001.A0101_02.YP2.1	2981746	2981754		YPO_RS14245	8
GLZ001.A0101_02.YP2.1	2989809	2989826		YPO_RS14285	17
GLZ001.A0101_02.YP2.1	2995454	2995465		YPO_RS14310	11
GLZ001.A0101_02.YP2.1	2995919	2995920		ureG	1
GLZ001.A0101_02.YP2.1	2999222	2999267		YPO_RS14330	45
GLZ001.A0101_02.YP2.1	2999362	2999368		YPO_RS14330	6
GLZ001.A0101_02.YP2.1	3000170	3000187		hdeB	17
GLZ001.A0101_02.YP2.1	3001417	3001420		kch	3
GLZ001.A0101_02.YP2.1	3001905	3001910		kch	5
GLZ001.A0101_02.YP2.1	3002483	3002484		crcB	1
GLZ001.A0101_02.YP2.1	3003133	3003135		YPO_RS14355	2
GLZ001.A0101_02.YP2.1	3003228	3003312		YPO_RS14355	84
GLZ001.A0101_02.YP2.1	3005042	3005045		chbC	3
GLZ001.A0101_02.YP2.1	3005573	3005584		chbC	11
GLZ001.A0101_02.YP2.1	3006366	3006379		chbR	13
GLZ001.A0101_02.YP2.1	3006618	3006641		chbR	23
GLZ001.A0101_02.YP2.1	3006971	3006976		chbR	5
GLZ001.A0101_02.YP2.1	3010176	3010178		pgm	2
GLZ001.A0101_02.YP2.1	3010348	3010361		pgm	13
GLZ001.A0101_02.YP2.1	3010640	3010643		pgm	3
GLZ001.A0101_02.YP2.1	3010745	3010772		pgm	27
GLZ001.A0101_02.YP2.1	3011944	3011973		YPO_RS14400	29
GLZ001.A0101_02.YP2.1	3012174	3012227		YPO_RS14405	53
GLZ001.A0101_02.YP2.1	3013570	3013576		kdbD	6
GLZ001.A0101_02.YP2.1	3021120	3021164		YPO_RS14440	44
GLZ001.A0101_02.YP2.1	3022378	3022380		YPO_RS14450	2
GLZ001.A0101_02.YP2.1	3024717	3024719		YPO_RS14460	2
GLZ001.A0101_02.YP2.1	3026208	3026220		YPO_RS14470	12
GLZ001.A0101_02.YP2.1	3029164	3029175		YPO_RS14490	11
GLZ001.A0101_02.YP2.1	3031925	3031934		ung	9
GLZ001.A0101_02.YP2.1	3037246	3037264		YPO_RS14530	18
GLZ001.A0101_02.YP2.1	3040779	3040786		rseB	7
GLZ001.A0101_02.YP2.1	3042122	3042130		YPO_RS14560	8
GLZ001.A0101_02.YP2.1	3042208	3042219		YPO_RS14560	11
GLZ001.A0101_02.YP2.1	3042458	3042480		YPO_RS14560	22
GLZ001.A0101_02.YP2.1	3042586	3042592		YPO_RS14560	6
GLZ001.A0101_02.YP2.1	3042815	3042818		YPO_RS14560	3
GLZ001.A0101_02.YP2.1	3048505	3048511		recO	6
GLZ001.A0101_02.YP2.1	3052805	3052808		tssM	3
GLZ001.A0101_02.YP2.1	3054572	3054590		tssM	18
GLZ001.A0101_02.YP2.1	3054661	3054673		tssM	12
GLZ001.A0101_02.YP2.1	3054759	3054776		tssM	17
GLZ001.A0101_02.YP2.1	3056165	3056203		YPO_RS14610	38
GLZ001.A0101_02.YP2.1	3059689	3059699		YPO_RS14620	10
GLZ001.A0101_02.YP2.1	3060591	3060602		YPO_RS14625	11
GLZ001.A0101_02.YP2.1	3061503	3061513		YPO_RS14635	10
GLZ001.A0101_02.YP2.1	3063286	3063325		YPO_RS14645	39
GLZ001.A0101_02.YP2.1	3064408	3064424		YPO_RS14650	16
GLZ001.A0101_02.YP2.1	3065973	3065993		YPO_RS14660	20
GLZ001.A0101_02.YP2.1	3066637	3066654		ccmA	17
GLZ001.A0101_02.YP2.1	3069273	3069275		ccmE	2
GLZ001.A0101_02.YP2.1	3069577	3069597		YPO_RS14690	20
GLZ001.A0101_02.YP2.1	3074246	3074250		mlaA	4
GLZ001.A0101_02.YP2.1	3080008	3080009		fadJ	1
GLZ001.A0101_02.YP2.1	3085751	3085785		YPO_RS14760	34
GLZ001.A0101_02.YP2.1	3090316	3090321		fabB	5
GLZ001.A0101_02.YP2.1	3091055	3091057		fabB	2
GLZ001.A0101_02.YP2.1	3091840	3091857		YPO_RS14785	17
GLZ001.A0101_02.YP2.1	3097370	3097374		pdxB	4
GLZ001.A0101_02.YP2.1	3106351	3106353		purF	2
GLZ001.A0101_02.YP2.1	3109259	3109262		hisJ	3
GLZ001.A0101_02.YP2.1	3109684	3109694		hisJ	10
GLZ001.A0101_02.YP2.1	3110914	3110918		YPO_RS14875	4
GLZ001.A0101_02.YP2.1	3111605	3111616		hisP	11
GLZ001.A0101_02.YP2.1	3112316	3112317		YPO_RS14885	1
GLZ001.A0101_02.YP2.1	3113719	3113736		YPO_RS14890	17
GLZ001.A0101_02.YP2.1	3114523	3114524		yfcE	1
GLZ001.A0101_02.YP2.1	3121234	3121309		YPO_RS14925	75
GLZ001.A0101_02.YP2.1	3121391	3121402		YPO_RS14925	11
GLZ001.A0101_02.YP2.1	3121640	3121683		YPO_RS14925	43
GLZ001.A0101_02.YP2.1	3122267	3122287		YPO_RS14930	20
GLZ001.A0101_02.YP2.1	3122346	3122382		YPO_RS14930	36
GLZ001.A0101_02.YP2.1	3123188	3123209		YPO_RS14940	21
GLZ001.A0101_02.YP2.1	3123576	3123582		YPO_RS14940	6
GLZ001.A0101_02.YP2.1	3123904	3123977		YPO_RS14945	73
GLZ001.A0101_02.YP2.1	3124016	3124030		YPO_RS14950	14
GLZ001.A0101_02.YP2.1	3127188	3127226		YPO_RS14960	38
GLZ001.A0101_02.YP2.1	3134135	3134136		YPO_RS14990	1
GLZ001.A0101_02.YP2.1	3134914	3134921		YPO_RS14990	7
GLZ001.A0101_02.YP2.1	3136744	3136755		YPO_RS14995	11
GLZ001.A0101_02.YP2.1	3144874	3144898		YPO_RS15040	24
GLZ001.A0101_02.YP2.1	3151676	3151684		YPO_RS15090	8
GLZ001.A0101_02.YP2.1	3154864	3154872		purM	8
GLZ001.A0101_02.YP2.1	3155709	3155720		purM	11
GLZ001.A0101_02.YP2.1	3156255	3156258		purN	3
GLZ001.A0101_02.YP2.1	3159649	3159650		pstB	1
GLZ001.A0101_02.YP2.1	3172558	3172561		YPO_RS15180	3
GLZ001.A0101_02.YP2.1	3176717	3176719		YPO_RS15195	2
GLZ001.A0101_02.YP2.1	3178777	3178789		YPO_RS15200	12
GLZ001.A0101_02.YP2.1	3186268	3186275		mdtC	7
GLZ001.A0101_02.YP2.1	3197659	3197660		YPO_RS15265	1
GLZ001.A0101_02.YP2.1	3197702	3197703		YPO_RS15265	1
GLZ001.A0101_02.YP2.1	3197780	3197785		YPO_RS15265	5
GLZ001.A0101_02.YP2.1	3198225	3198226		YPO_RS15270	1
GLZ001.A0101_02.YP2.1	3198278	3198283		YPO_RS15275	5
GLZ001.A0101_02.YP2.1	3199823	3199856		YPO_RS15280	33
GLZ001.A0101_02.YP2.1	3200063	3200104		YPO_RS15280	41
GLZ001.A0101_02.YP2.1	3200209	3200214		YPO_RS15285	5
GLZ001.A0101_02.YP2.1	3200295	3200304		YPO_RS15285	9
GLZ001.A0101_02.YP2.1	3200361	3200426		YPO_RS15285	65
GLZ001.A0101_02.YP2.1	3200503	3200512		YPO_RS15285	9
GLZ001.A0101_02.YP2.1	3200566	3200587		YPO_RS15285	21
GLZ001.A0101_02.YP2.1	3200685	3200692		YPO_RS15290	7
GLZ001.A0101_02.YP2.1	3200738	3200905		YPO_RS15290	167
GLZ001.A0101_02.YP2.1	3200960	3201046		YPO_RS15290	86
GLZ001.A0101_02.YP2.1	3201227	3201353		YPO_RS15295	126
GLZ001.A0101_02.YP2.1	3201498	3201503		YPO_RS15295	5
GLZ001.A0101_02.YP2.1	3201567	3201697		YPO_RS15300	130
GLZ001.A0101_02.YP2.1	3201739	3201786		YPO_RS15300	47
GLZ001.A0101_02.YP2.1	3201925	3201965		YPO_RS15300	40
GLZ001.A0101_02.YP2.1	3202210	3202261		YPO_RS15305	51
GLZ001.A0101_02.YP2.1	3202316	3202317		YPO_RS15305	1
GLZ001.A0101_02.YP2.1	3204873	3204878		guaA	5
GLZ001.A0101_02.YP2.1	3216187	3216203		rodZ	16
GLZ001.A0101_02.YP2.1	3221325	3221366		YPO_RS15385	41
GLZ001.A0101_02.YP2.1	3221622	3221697		YPO_RS15385	75
GLZ001.A0101_02.YP2.1	3221760	3221886		YPO_RS15385	126
GLZ001.A0101_02.YP2.1	3221966	3222000		YPO_RS15385	34
GLZ001.A0101_02.YP2.1	3222116	3222139		YPO_RS15385	23
GLZ001.A0101_02.YP2.1	3222329	3222343		YPO_RS15385	14
GLZ001.A0101_02.YP2.1	3222646	3222651		YPO_RS15385	5
GLZ001.A0101_02.YP2.1	3223346	3223366		yapA	20
GLZ001.A0101_02.YP2.1	3223454	3223457		yapA	3
GLZ001.A0101_02.YP2.1	3223544	3223575		yapA	31
GLZ001.A0101_02.YP2.1	3223803	3223804		yapA	1
GLZ001.A0101_02.YP2.1	3224528	3224550		yapA	22
GLZ001.A0101_02.YP2.1	3225098	3225104		yapA	6
GLZ001.A0101_02.YP2.1	3226898	3226900		yapA	2
GLZ001.A0101_02.YP2.1	3227169	3227179		yapA	10
GLZ001.A0101_02.YP2.1	3228552	3228569		YPO_RS15395	17
GLZ001.A0101_02.YP2.1	3228738	3228748		YPO_RS15395	10
GLZ001.A0101_02.YP2.1	3230068	3230084		YPO_RS15395	16
GLZ001.A0101_02.YP2.1	3231137	3231148		YPO_RS15395	11
GLZ001.A0101_02.YP2.1	3231840	3231862		YPO_RS15405	22
GLZ001.A0101_02.YP2.1	3232983	3232997		sseB	14
GLZ001.A0101_02.YP2.1	3246403	3246405		csiE	2
GLZ001.A0101_02.YP2.1	3250978	3250984		hmpA	6
GLZ001.A0101_02.YP2.1	3260318	3260326		YPO_RS15550	8
GLZ001.A0101_02.YP2.1	3262660	3262750		YPO_RS15560	90
GLZ001.A0101_02.YP2.1	3262864	3262884		YPO_RS15560	20
GLZ001.A0101_02.YP2.1	3265835	3265838		purL	3
GLZ001.A0101_02.YP2.1	3268318	3268331		mltF	13
GLZ001.A0101_02.YP2.1	3268528	3268531		mltF	3
GLZ001.A0101_02.YP2.1	3271220	3271228		murQ	8
GLZ001.A0101_02.YP2.1	3278200	3278265		tssK	65
GLZ001.A0101_02.YP2.1	3280150	3280155		YPO_RS15645	5
GLZ001.A0101_02.YP2.1	3282037	3282041		tssC	4
GLZ001.A0101_02.YP2.1	3282555	3282557		tssB	2
GLZ001.A0101_02.YP2.1	3282765	3282770		YPO_RS15660	5
GLZ001.A0101_02.YP2.1	3283115	3283144		YPO_RS15660	29
GLZ001.A0101_02.YP2.1	3284501	3284511		YPO_RS15665	10
GLZ001.A0101_02.YP2.1	3285769	3285781		YPO_RS15670	12
GLZ001.A0101_02.YP2.1	3285803	3285840		YPO_RS15675	37
GLZ001.A0101_02.YP2.1	3285934	3285936		YPO_RS15675	2
GLZ001.A0101_02.YP2.1	3286084	3286092		YPO_RS15675	8
GLZ001.A0101_02.YP2.1	3286232	3286235		YPO_RS15675	3
GLZ001.A0101_02.YP2.1	3286725	3286727		YPO_RS15675	2
GLZ001.A0101_02.YP2.1	3287239	3287241		YPO_RS15675	2
GLZ001.A0101_02.YP2.1	3287814	3287820		YPO_RS15680	6
GLZ001.A0101_02.YP2.1	3288009	3288030		YPO_RS15680	21
GLZ001.A0101_02.YP2.1	3288230	3288242		YPO_RS15680	12
GLZ001.A0101_02.YP2.1	3289164	3289165		tssH	1
GLZ001.A0101_02.YP2.1	3289729	3289735		tssH	6
GLZ001.A0101_02.YP2.1	3294229	3294240		tssF	11
GLZ001.A0101_02.YP2.1	3295736	3295739		YPO_RS15705	3
GLZ001.A0101_02.YP2.1	3296552	3296570		YPO_RS15705	18
GLZ001.A0101_02.YP2.1	3296851	3296853		YPO_RS15710	2
GLZ001.A0101_02.YP2.1	3297605	3297606		YPO_RS15710	1
GLZ001.A0101_02.YP2.1	3298923	3298932		YPO_RS15715	9
GLZ001.A0101_02.YP2.1	3299208	3299213		YPO_RS15720	5
GLZ001.A0101_02.YP2.1	3299980	3299989		YPO_RS15725	9
GLZ001.A0101_02.YP2.1	3300107	3300122		YPO_RS15725	15
GLZ001.A0101_02.YP2.1	3300455	3300456		YPO_RS15725	1
GLZ001.A0101_02.YP2.1	3301691	3301704		YPO_RS15730	13
GLZ001.A0101_02.YP2.1	3302794	3302819		YPO_RS15735	25
GLZ001.A0101_02.YP2.1	3307342	3307344		YPO_RS15750	2
GLZ001.A0101_02.YP2.1	3309949	3309961		YPO_RS15760	12
GLZ001.A0101_02.YP2.1	3310669	3310670		YPO_RS15765	1
GLZ001.A0101_02.YP2.1	3310751	3310753		YPO_RS15765	2
GLZ001.A0101_02.YP2.1	3311638	3311645		YPO_RS15770	7
GLZ001.A0101_02.YP2.1	3311964	3311999		YPO_RS15770	35
GLZ001.A0101_02.YP2.1	3318062	3318079		YPO_RS15795	17
GLZ001.A0101_02.YP2.1	3318570	3318583		YPO_RS15800	13
GLZ001.A0101_02.YP2.1	3319477	3319490		YPO_RS15805	13
GLZ001.A0101_02.YP2.1	3320259	3320272		YPO_RS15810	13
GLZ001.A0101_02.YP2.1	3323013	3323014		alaC	1
GLZ001.A0101_02.YP2.1	3325077	3325078		glk	1
GLZ001.A0101_02.YP2.1	3327549	3327555		YPO_RS15845	6
GLZ001.A0101_02.YP2.1	3331363	3331365		YPO_RS15865	2
GLZ001.A0101_02.YP2.1	3331530	3331539		YPO_RS15865	9
GLZ001.A0101_02.YP2.1	3332827	3332833		YPO_RS15880	6
GLZ001.A0101_02.YP2.1	3333778	3333783		gltX	5
GLZ001.A0101_02.YP2.1	3336054	3336061		YPO_RS15915	7
GLZ001.A0101_02.YP2.1	3345489	3345504		crr	15
GLZ001.A0101_02.YP2.1	3348222	3348224		YPO_RS15980	2
GLZ001.A0101_02.YP2.1	3353925	3353932		YPO_RS15995	7
GLZ001.A0101_02.YP2.1	3354079	3354112		YPO_RS15995	33
GLZ001.A0101_02.YP2.1	3354286	3354314		YPO_RS16000	28
GLZ001.A0101_02.YP2.1	3355095	3355176		YPO_RS16000	81
GLZ001.A0101_02.YP2.1	3355452	3355472		YPO_RS16000	20
GLZ001.A0101_02.YP2.1	3356138	3356143		YPO_RS16010	5
GLZ001.A0101_02.YP2.1	3356888	3356890		YPO_RS16010	2
GLZ001.A0101_02.YP2.1	3356939	3356942		YPO_RS16010	3
GLZ001.A0101_02.YP2.1	3357160	3357196		YPO_RS16015	36
GLZ001.A0101_02.YP2.1	3357352	3357354		YPO_RS16020	2
GLZ001.A0101_02.YP2.1	3357585	3357611		YPO_RS16020	26
GLZ001.A0101_02.YP2.1	3357747	3357764		YPO_RS16020	17
GLZ001.A0101_02.YP2.1	3358280	3358298		YPO_RS16020	18
GLZ001.A0101_02.YP2.1	3360342	3360355		YPO_RS16025	13
GLZ001.A0101_02.YP2.1	3363673	3363679		YPO_RS16040	6
GLZ001.A0101_02.YP2.1	3363740	3363746		YPO_RS16040	6
GLZ001.A0101_02.YP2.1	3363868	3363879		YPO_RS16040	11
GLZ001.A0101_02.YP2.1	3363957	3363971		YPO_RS16040	14
GLZ001.A0101_02.YP2.1	3364052	3364068		YPO_RS16040	16
GLZ001.A0101_02.YP2.1	3364214	3364226		YPO_RS16040	12
GLZ001.A0101_02.YP2.1	3364277	3364287		YPO_RS16040	10
GLZ001.A0101_02.YP2.1	3364349	3364383		YPO_RS16040	34
GLZ001.A0101_02.YP2.1	3364645	3364737		YPO_RS16040	92
GLZ001.A0101_02.YP2.1	3369048	3369056		YPO_RS16065	8
GLZ001.A0101_02.YP2.1	3370354	3370361		YPO_RS16070	7
GLZ001.A0101_02.YP2.1	3370527	3370528		YPO_RS16070	1
GLZ001.A0101_02.YP2.1	3371414	3371417		YPO_RS16070	3
GLZ001.A0101_02.YP2.1	3372822	3372833		YPO_RS16075	11
GLZ001.A0101_02.YP2.1	3373376	3373397		YPO_RS16080	21
GLZ001.A0101_02.YP2.1	3381105	3381137		yapL	32
GLZ001.A0101_02.YP2.1	3382729	3382749		yapL	20
GLZ001.A0101_02.YP2.1	3383537	3383585		YPO_RS16125	48
GLZ001.A0101_02.YP2.1	3383653	3383678		YPO_RS16125	25
GLZ001.A0101_02.YP2.1	3383729	3383767		YPO_RS16125	38
GLZ001.A0101_02.YP2.1	3383842	3383878		YPO_RS16125	36
GLZ001.A0101_02.YP2.1	3385594	3385595		hemF	1
GLZ001.A0101_02.YP2.1	3385927	3385951		hemF	24
GLZ001.A0101_02.YP2.1	3388529	3388538		maeB	9
GLZ001.A0101_02.YP2.1	3389677	3389680		nudK	3
GLZ001.A0101_02.YP2.1	3393486	3393493		napA	7
GLZ001.A0101_02.YP2.1	3395791	3395801		YPO_RS16185	10
GLZ001.A0101_02.YP2.1	3396598	3396604		acrD	6
GLZ001.A0101_02.YP2.1	3399827	3399843		YPO_RS16195	16
GLZ001.A0101_02.YP2.1	3402512	3402516		YPO_RS16205	4
GLZ001.A0101_02.YP2.1	3402704	3402705		YPO_RS16205	1
GLZ001.A0101_02.YP2.1	3405629	3405651		YPO_RS16220	22
GLZ001.A0101_02.YP2.1	3411022	3411030		dapE	8
GLZ001.A0101_02.YP2.1	3411566	3411576		dapE	10
GLZ001.A0101_02.YP2.1	3412718	3412726		YPO_RS16255	8
GLZ001.A0101_02.YP2.1	3419119	3419127		bamC	8
GLZ001.A0101_02.YP2.1	3422070	3422111		YPO_RS16305	41
GLZ001.A0101_02.YP2.1	3423896	3423898		YPO_RS16310	2
GLZ001.A0101_02.YP2.1	3430313	3430333		ppiB	20
GLZ001.A0101_02.YP2.1	3430779	3430792		YPO_RS16345	13
GLZ001.A0101_02.YP2.1	3433278	3433286		purK	8
GLZ001.A0101_02.YP2.1	3434444	3434450		YPO_RS16360	6
GLZ001.A0101_02.YP2.1	3438063	3438069		YPO_RS16375	6
GLZ001.A0101_02.YP2.1	3439565	3439577		YPO_RS16385	12
GLZ001.A0101_02.YP2.1	3445969	3445974		ybaK	5
GLZ001.A0101_02.YP2.1	3452926	3452929		YPO_RS16435	3
GLZ001.A0101_02.YP2.1	3453975	3453976		fepE	1
GLZ001.A0101_02.YP2.1	3454056	3454057		fepE	1
GLZ001.A0101_02.YP2.1	3454263	3454291		fepE	28
GLZ001.A0101_02.YP2.1	3454569	3454596		fepE	27
GLZ001.A0101_02.YP2.1	3454825	3454901		fepE	76
GLZ001.A0101_02.YP2.1	3455009	3455029		cpsG	20
GLZ001.A0101_02.YP2.1	3455769	3455789		cpsG	20
GLZ001.A0101_02.YP2.1	3455933	3455966		cpsG	33
GLZ001.A0101_02.YP2.1	3456156	3456182		cpsG	26
GLZ001.A0101_02.YP2.1	3456242	3456247		cpsG	5
GLZ001.A0101_02.YP2.1	3456501	3456502		YPO_RS16450	1
GLZ001.A0101_02.YP2.1	3456574	3456591		YPO_RS16450	17
GLZ001.A0101_02.YP2.1	3457104	3457130		YPO_RS16450	26
GLZ001.A0101_02.YP2.1	3457133	3457147		YPO_RS16455	14
GLZ001.A0101_02.YP2.1	3457195	3457198		YPO_RS16455	3
GLZ001.A0101_02.YP2.1	3461349	3461366		YPO_RS16470	17
GLZ001.A0101_02.YP2.1	3461612	3461664		YPO_RS16470	52
GLZ001.A0101_02.YP2.1	3463321	3463354		YPO_RS16480	33
GLZ001.A0101_02.YP2.1	3463474	3463501		YPO_RS16480	27
GLZ001.A0101_02.YP2.1	3463709	3463811		YPO_RS16480	102
GLZ001.A0101_02.YP2.1	3463864	3463972		YPO_RS16480	108
GLZ001.A0101_02.YP2.1	3464125	3464221		YPO_RS16480	96
GLZ001.A0101_02.YP2.1	3464455	3464463		YPO_RS16480	8
GLZ001.A0101_02.YP2.1	3464843	3464882		YPO_RS16485	39
GLZ001.A0101_02.YP2.1	3464931	3464941		YPO_RS16485	10
GLZ001.A0101_02.YP2.1	3465021	3465118		YPO_RS16485	97
GLZ001.A0101_02.YP2.1	3465221	3465237		YPO_RS16485	16
GLZ001.A0101_02.YP2.1	3465300	3465383		YPO_RS16485	83
GLZ001.A0101_02.YP2.1	3465438	3465450		YPO_RS16485	12
GLZ001.A0101_02.YP2.1	3465549	3465556		YPO_RS16485	7
GLZ001.A0101_02.YP2.1	3465567	3465630		YPO_RS16490	63
GLZ001.A0101_02.YP2.1	3465696	3465717		YPO_RS16490	21
GLZ001.A0101_02.YP2.1	3466020	3466042		YPO_RS16490	22
GLZ001.A0101_02.YP2.1	3466253	3466448		YPO_RS16490	195
GLZ001.A0101_02.YP2.1	3466539	3466544		YPO_RS16490	5
GLZ001.A0101_02.YP2.1	3466578	3466677		YPO_RS16490	99
GLZ001.A0101_02.YP2.1	3466813	3466838		YPO_RS16490	25
GLZ001.A0101_02.YP2.1	3466984	3466986		YPO_RS16495	2
GLZ001.A0101_02.YP2.1	3467116	3467149		YPO_RS16495	33
GLZ001.A0101_02.YP2.1	3467203	3467210		YPO_RS16495	7
GLZ001.A0101_02.YP2.1	3467371	3467392		YPO_RS16495	21
GLZ001.A0101_02.YP2.1	3467527	3467562		YPO_RS16495	35
GLZ001.A0101_02.YP2.1	3467612	3467632		YPO_RS16495	20
GLZ001.A0101_02.YP2.1	3468061	3468062		YPO_RS16495	1
GLZ001.A0101_02.YP2.1	3468300	3468304		YPO_RS16500	4
GLZ001.A0101_02.YP2.1	3468543	3468576		YPO_RS16500	33
GLZ001.A0101_02.YP2.1	3468641	3468693		YPO_RS16500	52
GLZ001.A0101_02.YP2.1	3468985	3469000		YPO_RS16500	15
GLZ001.A0101_02.YP2.1	3469624	3469635		rfbH	11
GLZ001.A0101_02.YP2.1	3470114	3470120		rfbH	6
GLZ001.A0101_02.YP2.1	3471099	3471110		rfbG	11
GLZ001.A0101_02.YP2.1	3472549	3472556		YPO_RS16520	7
GLZ001.A0101_02.YP2.1	3472796	3472800		YPO_RS16520	4
GLZ001.A0101_02.YP2.1	3473054	3473109		YPO_RS16520	55
GLZ001.A0101_02.YP2.1	3474717	3474721		hemH	4
GLZ001.A0101_02.YP2.1	3476736	3476744		htpG	8
GLZ001.A0101_02.YP2.1	3485413	3485417		YPO_RS16575	4
GLZ001.A0101_02.YP2.1	3487534	3487554		mscK	20
GLZ001.A0101_02.YP2.1	3489450	3489468		mscK	18
GLZ001.A0101_02.YP2.1	3496943	3496979		YPO_RS16620	36
GLZ001.A0101_02.YP2.1	3497461	3497490		tomB	29
GLZ001.A0101_02.YP2.1	3497542	3497549		tomB	7
GLZ001.A0101_02.YP2.1	3499355	3499372		YPO_RS16645	17
GLZ001.A0101_02.YP2.1	3504118	3504125		YPO_RS16665	7
GLZ001.A0101_02.YP2.1	3506126	3506134		YPO_RS16670	8
GLZ001.A0101_02.YP2.1	3506280	3506300		YPO_RS16670	20
GLZ001.A0101_02.YP2.1	3507449	3507453		YPO_RS16675	4
GLZ001.A0101_02.YP2.1	3508550	3508552		YPO_RS16680	2
GLZ001.A0101_02.YP2.1	3511887	3511896		queC	9
GLZ001.A0101_02.YP2.1	3512416	3512423		queC	7
GLZ001.A0101_02.YP2.1	3513515	3513523		YPO_RS16705	8
GLZ001.A0101_02.YP2.1	3516703	3516705		lon	2
GLZ001.A0101_02.YP2.1	3517966	3517984		lon	18
GLZ001.A0101_02.YP2.1	3519866	3519872		clpX	6
GLZ001.A0101_02.YP2.1	3521703	3521706		tig	3
GLZ001.A0101_02.YP2.1	3521771	3521772		tig	1
GLZ001.A0101_02.YP2.1	3522737	3522759		tig	22
GLZ001.A0101_02.YP2.1	3523459	3523462		bolA	3
GLZ001.A0101_02.YP2.1	3527201	3527267		YPO_RS16755	66
GLZ001.A0101_02.YP2.1	3535826	3535831		panE	5
GLZ001.A0101_02.YP2.1	3535918	3535925		panE	7
GLZ001.A0101_02.YP2.1	3536343	3536362		yajL	19
GLZ001.A0101_02.YP2.1	3538954	3538962		ispA	8
GLZ001.A0101_02.YP2.1	3539830	3539832		dxs	2
GLZ001.A0101_02.YP2.1	3540324	3540332		dxs	8
GLZ001.A0101_02.YP2.1	3541472	3541473		dxs	1
GLZ001.A0101_02.YP2.1	3543354	3543356		thiL	2
GLZ001.A0101_02.YP2.1	3543512	3543520		thiL	8
GLZ001.A0101_02.YP2.1	3547162	3547166		YPO_RS16860	4
GLZ001.A0101_02.YP2.1	3547432	3547465		YPO_RS16860	33
GLZ001.A0101_02.YP2.1	3548023	3548035		YPO_RS16865	12
GLZ001.A0101_02.YP2.1	3548082	3548138		YPO_RS16865	56
GLZ001.A0101_02.YP2.1	3548208	3548212		YPO_RS16865	4
GLZ001.A0101_02.YP2.1	3549430	3549431		secF	1
GLZ001.A0101_02.YP2.1	3549736	3549739		secF	3
GLZ001.A0101_02.YP2.1	3549935	3549938		secF	3
GLZ001.A0101_02.YP2.1	3552486	3552502		yajC	16
GLZ001.A0101_02.YP2.1	3560236	3560247		YPO_RS16920	11
GLZ001.A0101_02.YP2.1	3560380	3560436		YPO_RS16925	56
GLZ001.A0101_02.YP2.1	3560533	3560534		malZ	1
GLZ001.A0101_02.YP2.1	3565659	3565671		brnQ	12
GLZ001.A0101_02.YP2.1	3568246	3568253		phoR	7
GLZ001.A0101_02.YP2.1	3572080	3572160		YPO_RS16965	80
GLZ001.A0101_02.YP2.1	3582678	3582692		YPO_RS17005	14
GLZ001.A0101_02.YP2.1	3583057	3583084		YPO_RS17010	27
GLZ001.A0101_02.YP2.1	3585148	3585150		proA	2
GLZ001.A0101_02.YP2.1	3588194	3588198		frsA	4
GLZ001.A0101_02.YP2.1	3590062	3590128		YPO_RS17045	66
GLZ001.A0101_02.YP2.1	3590325	3590346		YPO_RS17050	21
GLZ001.A0101_02.YP2.1	3590489	3590490		YPO_RS17050	1
GLZ001.A0101_02.YP2.1	3592472	3592489		YPO_RS17055	17
GLZ001.A0101_02.YP2.1	3592593	3592601		YPO_RS17055	8
GLZ001.A0101_02.YP2.1	3593010	3593086		YPO_RS17055	76
GLZ001.A0101_02.YP2.1	3593264	3593275		YPO_RS17055	11
GLZ001.A0101_02.YP2.1	3595760	3595767		pepD	7
GLZ001.A0101_02.YP2.1	3598163	3598193		YPO_RS17070	30
GLZ001.A0101_02.YP2.1	3598829	3598839		YPO_RS17070	10
GLZ001.A0101_02.YP2.1	3600021	3600026		YPO_RS17080	5
GLZ001.A0101_02.YP2.1	3600707	3600747		nqrF	40
GLZ001.A0101_02.YP2.1	3601768	3601799		nqrF	31
GLZ001.A0101_02.YP2.1	3602972	3602976		YPO_RS17095	4
GLZ001.A0101_02.YP2.1	3606488	3606499		YPO_RS17110	11
GLZ001.A0101_02.YP2.1	3607270	3607274		YPO_RS17115	4
GLZ001.A0101_02.YP2.1	3609208	3609210		lpcA	2
GLZ001.A0101_02.YP2.1	3613219	3613221		YPO_RS17140	2
GLZ001.A0101_02.YP2.1	3613305	3613327		YPO_RS17140	22
GLZ001.A0101_02.YP2.1	3614592	3614608		YPO_RS17140	16
GLZ001.A0101_02.YP2.1	3614945	3614947		YPO_RS17145	2
GLZ001.A0101_02.YP2.1	3615531	3615535		YPO_RS17145	4
GLZ001.A0101_02.YP2.1	3616717	3616721		YPO_RS17145	4
GLZ001.A0101_02.YP2.1	3617083	3617099		YPO_RS17145	16
GLZ001.A0101_02.YP2.1	3617167	3617171		YPO_RS17145	4
GLZ001.A0101_02.YP2.1	3617573	3617586		YPO_RS17145	13
GLZ001.A0101_02.YP2.1	3618612	3618613		YPO_RS17145	1
GLZ001.A0101_02.YP2.1	3618867	3618921		YPO_RS17145	54
GLZ001.A0101_02.YP2.1	3619499	3619501		YPO_RS17145	2
GLZ001.A0101_02.YP2.1	3622388	3622391		YPO_RS17150	3
GLZ001.A0101_02.YP2.1	3629925	3629930		YPO_RS17195	5
GLZ001.A0101_02.YP2.1	3633138	3633142		YPO_RS17215	4
GLZ001.A0101_02.YP2.1	3636285	3636286		YPO_RS17230	1
GLZ001.A0101_02.YP2.1	3642998	3643025		trxC	27
GLZ001.A0101_02.YP2.1	3646234	3646260		YPO_RS17270	26
GLZ001.A0101_02.YP2.1	3647792	3647796		pssA	4
GLZ001.A0101_02.YP2.1	3648175	3648186		pssA	11
GLZ001.A0101_02.YP2.1	3649934	3649936		YPO_RS17290	2
GLZ001.A0101_02.YP2.1	3650371	3650388		YPO_RS17290	17
GLZ001.A0101_02.YP2.1	3658814	3658826		rluD	12
GLZ001.A0101_02.YP2.1	3662693	3662694		pheA	1
GLZ001.A0101_02.YP2.1	3665932	3665937		tyrA	5
GLZ001.A0101_02.YP2.1	3670254	3670273		YPO_RS17385	19
GLZ001.A0101_02.YP2.1	3670300	3670304		YPO_RS17385	4
GLZ001.A0101_02.YP2.1	3672990	3673006		trmD	16
GLZ001.A0101_02.YP2.1	3675213	3675222		ffh	9
GLZ001.A0101_02.YP2.1	3675526	3675538		ffh	12
GLZ001.A0101_02.YP2.1	3676077	3676083		YPO_RS17420	6
GLZ001.A0101_02.YP2.1	3676295	3676310		YPO_RS17420	15
GLZ001.A0101_02.YP2.1	3676496	3676502		YPO_RS17420	6
GLZ001.A0101_02.YP2.1	3680246	3680256		gshA	10
GLZ001.A0101_02.YP2.1	3682294	3682304		YPO_RS17455	10
GLZ001.A0101_02.YP2.1	3682377	3682386		YPO_RS17455	9
GLZ001.A0101_02.YP2.1	3682466	3682476		YPO_RS17460	10
GLZ001.A0101_02.YP2.1	3685850	3685858		alaS	8
GLZ001.A0101_02.YP2.1	3687893	3687901		recA	8
GLZ001.A0101_02.YP2.1	3689186	3689189		YPO_RS17505	3
GLZ001.A0101_02.YP2.1	3692070	3692072		YPO_RS17515	2
GLZ001.A0101_02.YP2.1	3696117	3696122		YPO_RS17530	5
GLZ001.A0101_02.YP2.1	3696565	3696567		YPO_RS17530	2
GLZ001.A0101_02.YP2.1	3696608	3696621		YPO_RS17530	13
GLZ001.A0101_02.YP2.1	3700018	3700044		YPO_RS17545	26
GLZ001.A0101_02.YP2.1	3701147	3701150		YPO_RS17550	3
GLZ001.A0101_02.YP2.1	3701198	3701200		YPO_RS17550	2
GLZ001.A0101_02.YP2.1	3701736	3701745		katG	9
GLZ001.A0101_02.YP2.1	3701805	3701816		katG	11
GLZ001.A0101_02.YP2.1	3701918	3701929		katG	11
GLZ001.A0101_02.YP2.1	3704403	3704409		cybC	6
GLZ001.A0101_02.YP2.1	3706449	3706452		YPO_RS17575	3
GLZ001.A0101_02.YP2.1	3710717	3710732		YPO_RS17590	15
GLZ001.A0101_02.YP2.1	3712792	3712811		YPO_RS17595	19
GLZ001.A0101_02.YP2.1	3716266	3716279		YPO_RS17610	13
GLZ001.A0101_02.YP2.1	3722950	3722953		YPO_RS17635	3
GLZ001.A0101_02.YP2.1	3725453	3725459		YPO_RS17650	6
GLZ001.A0101_02.YP2.1	3725612	3725615		YPO_RS17650	3
GLZ001.A0101_02.YP2.1	3728662	3728663		YPO_RS17660	1
GLZ001.A0101_02.YP2.1	3731739	3731809		YPO_RS17675	70
GLZ001.A0101_02.YP2.1	3739387	3739403		YPO_RS17715	16
GLZ001.A0101_02.YP2.1	3740154	3740155		rpiB	1
GLZ001.A0101_02.YP2.1	3745126	3745127		rpoS	1
GLZ001.A0101_02.YP2.1	3745719	3745726		nlpD	7
GLZ001.A0101_02.YP2.1	3745879	3745888		nlpD	9
GLZ001.A0101_02.YP2.1	3747900	3747906		truD	6
GLZ001.A0101_02.YP2.1	3754889	3754894		cobA	5
GLZ001.A0101_02.YP2.1	3755398	3755431		cobA	33
GLZ001.A0101_02.YP2.1	3755558	3755566		cobA	8
GLZ001.A0101_02.YP2.1	3757050	3757054		YPO_RS17805	4
GLZ001.A0101_02.YP2.1	3759108	3759119		cysI	11
GLZ001.A0101_02.YP2.1	3760427	3760430		cysJ	3
GLZ001.A0101_02.YP2.1	3761351	3761352		cysJ	1
GLZ001.A0101_02.YP2.1	3762183	3762196		queD	13
GLZ001.A0101_02.YP2.1	3768497	3768506		mazG	9
GLZ001.A0101_02.YP2.1	3768844	3768846		relA	2
GLZ001.A0101_02.YP2.1	3769574	3769576		relA	2
GLZ001.A0101_02.YP2.1	3772416	3772420		barA	4
GLZ001.A0101_02.YP2.1	3773761	3773797		barA	36
GLZ001.A0101_02.YP2.1	3775332	3775334		degP	2
GLZ001.A0101_02.YP2.1	3781391	3781397		clcA	6
GLZ001.A0101_02.YP2.1	3782687	3782700		hemL	13
GLZ001.A0101_02.YP2.1	3785654	3785666		fhuB	12
GLZ001.A0101_02.YP2.1	3786898	3786907		fhuD	9
GLZ001.A0101_02.YP2.1	3795324	3795333		dksA	9
GLZ001.A0101_02.YP2.1	3802908	3802915		YPO_RS17990	7
GLZ001.A0101_02.YP2.1	3804264	3804268		YPO_RS18000	4
GLZ001.A0101_02.YP2.1	3804366	3804375		YPO_RS18000	9
GLZ001.A0101_02.YP2.1	3805088	3805089		YPO_RS18000	1
GLZ001.A0101_02.YP2.1	3808455	3808477		cueO	22
GLZ001.A0101_02.YP2.1	3812280	3812283		YPO_RS18035	3
GLZ001.A0101_02.YP2.1	3815634	3815661		acnB	27
GLZ001.A0101_02.YP2.1	3819721	3819726		aceF	5
GLZ001.A0101_02.YP2.1	3820041	3820046		aceF	5
GLZ001.A0101_02.YP2.1	3822462	3822464		aceE	2
GLZ001.A0101_02.YP2.1	3829992	3829998		gspE	6
GLZ001.A0101_02.YP2.1	3832213	3832221		hofC	8
GLZ001.A0101_02.YP2.1	3832706	3832710		hofC	4
GLZ001.A0101_02.YP2.1	3835055	3835073		coaE	18
GLZ001.A0101_02.YP2.1	3877944	3877946		YPO_RS18325	2
GLZ001.A0101_02.YP2.1	3878794	3878801		YPO_RS18325	7
GLZ001.A0101_02.YP2.1	3886196	3886206		YPO_RS18360	10
GLZ001.A0101_02.YP2.1	3888262	3888266		YPO_RS18370	4
GLZ001.A0101_02.YP2.1	3896317	3896321		YPO_RS18400	4
GLZ001.A0101_02.YP2.1	3903923	3903934		rbfA	11
GLZ001.A0101_02.YP2.1	3906328	3906384		infB	56
GLZ001.A0101_02.YP2.1	3911722	3911725		folP	3
GLZ001.A0101_02.YP2.1	3914798	3914799		rlmE	1
GLZ001.A0101_02.YP2.1	3915367	3915376		greA	9
GLZ001.A0101_02.YP2.1	3921268	3921269		YPO_RS18520	1
GLZ001.A0101_02.YP2.1	3931158	3931164		YPO_RS18580	6
GLZ001.A0101_02.YP2.1	3935207	3935218		YPO_RS18585	11
GLZ001.A0101_02.YP2.1	3941277	3941288		cysQ	11
GLZ001.A0101_02.YP2.1	3946140	3946147		YPO_RS18635	7
GLZ001.A0101_02.YP2.1	3949709	3949715		yjfP	6
GLZ001.A0101_02.YP2.1	3961897	3961913		elbB	16
GLZ001.A0101_02.YP2.1	3962035	3962039		elbB	4
GLZ001.A0101_02.YP2.1	3963747	3963748		arcB	1
GLZ001.A0101_02.YP2.1	3967260	3967264		gltB	4
GLZ001.A0101_02.YP2.1	3975582	3975598		YPO_RS18775	16
GLZ001.A0101_02.YP2.1	3977868	3977881		YPO_RS18790	13
GLZ001.A0101_02.YP2.1	3983723	3983731		ibaG	8
GLZ001.A0101_02.YP2.1	3983930	3983931		ibaG	1
GLZ001.A0101_02.YP2.1	3984417	3984428		mlaC	11
GLZ001.A0101_02.YP2.1	3990499	3990512		kdsC	13
GLZ001.A0101_02.YP2.1	3991109	3991123		lptC	14
GLZ001.A0101_02.YP2.1	3993798	3993801		rpoN	3
GLZ001.A0101_02.YP2.1	3995233	3995239		rapZ	6
GLZ001.A0101_02.YP2.1	3996107	3996136		npr	29
GLZ001.A0101_02.YP2.1	4001620	4001626		YPO_RS18935	6
GLZ001.A0101_02.YP2.1	4009420	4009428		tssH	8
GLZ001.A0101_02.YP2.1	4009921	4009927		YPO_RS18970	6
GLZ001.A0101_02.YP2.1	4016445	4016450		YPO_RS18990	5
GLZ001.A0101_02.YP2.1	4017854	4017867		YPO_RS19000	13
GLZ001.A0101_02.YP2.1	4020002	4020014		YPO_RS19005	12
GLZ001.A0101_02.YP2.1	4024047	4024052		YPO_RS19015	5
GLZ001.A0101_02.YP2.1	4024526	4024549		YPO_RS19020	23
GLZ001.A0101_02.YP2.1	4024715	4024720		YPO_RS19020	5
GLZ001.A0101_02.YP2.1	4024934	4024937		YPO_RS19020	3
GLZ001.A0101_02.YP2.1	4025710	4025729		YPO_RS19035	19
GLZ001.A0101_02.YP2.1	4027003	4027007		YPO_RS19045	4
GLZ001.A0101_02.YP2.1	4027658	4027667		YPO_RS19045	9
GLZ001.A0101_02.YP2.1	4029426	4029429		YPO_RS19055	3
GLZ001.A0101_02.YP2.1	4033524	4033580		YPO_RS19055	56
GLZ001.A0101_02.YP2.1	4033676	4033709		YPO_RS19060	33
GLZ001.A0101_02.YP2.1	4033782	4033838		YPO_RS19060	56
GLZ001.A0101_02.YP2.1	4033913	4033937		YPO_RS19060	24
GLZ001.A0101_02.YP2.1	4034558	4034573		YPO_RS19065	15
GLZ001.A0101_02.YP2.1	4034676	4034680		YPO_RS19065	4
GLZ001.A0101_02.YP2.1	4038923	4038927		YPO_RS19090	4
GLZ001.A0101_02.YP2.1	4040828	4040874		ssuE	46
GLZ001.A0101_02.YP2.1	4044883	4044895		ssuB	12
GLZ001.A0101_02.YP2.1	4050692	4050704		YPO_RS19145	12
GLZ001.A0101_02.YP2.1	4051213	4051227		YPO_RS19145	14
GLZ001.A0101_02.YP2.1	4072281	4072282		YPO_RS19245	1
GLZ001.A0101_02.YP2.1	4078603	4078611		YPO_RS19285	8
GLZ001.A0101_02.YP2.1	4078648	4078678		YPO_RS19285	30
GLZ001.A0101_02.YP2.1	4081761	4081766		msrQ	5
GLZ001.A0101_02.YP2.1	4082228	4082246		msrQ	18
GLZ001.A0101_02.YP2.1	4083403	4083418		msrP	15
GLZ001.A0101_02.YP2.1	4093800	4093812		YPO_RS19350	12
GLZ001.A0101_02.YP2.1	4093852	4093855		YPO_RS19350	3
GLZ001.A0101_02.YP2.1	4098633	4098690		YPO_RS19365	57
GLZ001.A0101_02.YP2.1	4098838	4098860		YPO_RS19365	22
GLZ001.A0101_02.YP2.1	4098938	4099006		YPO_RS19365	68
GLZ001.A0101_02.YP2.1	4099396	4099476		YPO_RS19365	80
GLZ001.A0101_02.YP2.1	4101403	4101405		YPO_RS19365	2
GLZ001.A0101_02.YP2.1	4101519	4101548		YPO_RS19370	29
GLZ001.A0101_02.YP2.1	4101625	4101709		YPO_RS19370	84
GLZ001.A0101_02.YP2.1	4101783	4101796		YPO_RS19370	13
GLZ001.A0101_02.YP2.1	4101908	4101915		YPO_RS19370	7
GLZ001.A0101_02.YP2.1	4102122	4102142		YPO_RS19370	20
GLZ001.A0101_02.YP2.1	4104158	4104160		YPO_RS19370	2
GLZ001.A0101_02.YP2.1	4104593	4104594		YPO_RS19375	1
GLZ001.A0101_02.YP2.1	4106643	4106661		YPO_RS19390	18
GLZ001.A0101_02.YP2.1	4107828	4107835		YPO_RS19390	7
GLZ001.A0101_02.YP2.1	4110160	4110168		YPO_RS19390	8
GLZ001.A0101_02.YP2.1	4112061	4112066		YPO_RS19395	5
GLZ001.A0101_02.YP2.1	4112534	4112544		YPO_RS19400	10
GLZ001.A0101_02.YP2.1	4112612	4112631		YPO_RS19400	19
GLZ001.A0101_02.YP2.1	4112692	4112797		YPO_RS19400	105
GLZ001.A0101_02.YP2.1	4113193	4113198		YPO_RS19400	5
GLZ001.A0101_02.YP2.1	4113296	4113303		YPO_RS19400	7
GLZ001.A0101_02.YP2.1	4113375	4113420		YPO_RS19400	45
GLZ001.A0101_02.YP2.1	4113974	4114091		YPO_RS19405	117
GLZ001.A0101_02.YP2.1	4114169	4114175		YPO_RS19405	6
GLZ001.A0101_02.YP2.1	4114209	4114231		YPO_RS19405	22
GLZ001.A0101_02.YP2.1	4114639	4114674		YPO_RS19405	35
GLZ001.A0101_02.YP2.1	4116763	4116787		YPO_RS19410	24
GLZ001.A0101_02.YP2.1	4117002	4117030		YPO_RS19410	28
GLZ001.A0101_02.YP2.1	4117174	4117175		YPO_RS19410	1
GLZ001.A0101_02.YP2.1	4117524	4117527		YPO_RS19410	3
GLZ001.A0101_02.YP2.1	4117898	4117900		aaeR	2
GLZ001.A0101_02.YP2.1	4120424	4120428		aaeB	4
GLZ001.A0101_02.YP2.1	4125063	4125086		YPO_RS19450	23
GLZ001.A0101_02.YP2.1	4126885	4126894		pmbA	9
GLZ001.A0101_02.YP2.1	4134291	4134294		YPO_RS19490	3
GLZ001.A0101_02.YP2.1	4142758	4142765		YPO_RS19535	7
GLZ001.A0101_02.YP2.1	4142813	4142845		YPO_RS19535	32
GLZ001.A0101_02.YP2.1	4142904	4142905		YPO_RS19535	1
GLZ001.A0101_02.YP2.1	4152543	4152545		pgi	2
GLZ001.A0101_02.YP2.1	4152819	4152822		pgi	3
GLZ001.A0101_02.YP2.1	4156565	4156570		YPO_RS19590	5
GLZ001.A0101_02.YP2.1	4156666	4156687		YPO_RS19590	21
GLZ001.A0101_02.YP2.1	4158356	4158359		YPO_RS19595	3
GLZ001.A0101_02.YP2.1	4158668	4158670		YPO_RS19595	2
GLZ001.A0101_02.YP2.1	4158894	4158902		YPO_RS19595	8
GLZ001.A0101_02.YP2.1	4160199	4160214		YPO_RS19595	15
GLZ001.A0101_02.YP2.1	4162352	4162359		YPO_RS19595	7
GLZ001.A0101_02.YP2.1	4172070	4172077		aceB	7
GLZ001.A0101_02.YP2.1	4173662	4173665		metA	3
GLZ001.A0101_02.YP2.1	4176214	4176220		YPO_RS19645	6
GLZ001.A0101_02.YP2.1	4176660	4176669		YPO_RS19645	9
GLZ001.A0101_02.YP2.1	4188582	4188591		YPO_RS19705	9
GLZ001.A0101_02.YP2.1	4189087	4189088		nudC	1
GLZ001.A0101_02.YP2.1	4192464	4192467		thiC	3
GLZ001.A0101_02.YP2.1	4205984	4206002		rplL	18
GLZ001.A0101_02.YP2.1	4206218	4206238		rplL	20
GLZ001.A0101_02.YP2.1	4215544	4215562		coaA	18
GLZ001.A0101_02.YP2.1	4215668	4215669		birA	1
GLZ001.A0101_02.YP2.1	4216420	4216423		birA	3
GLZ001.A0101_02.YP2.1	4216787	4216789		murB	2
GLZ001.A0101_02.YP2.1	4219521	4219533		YPO_RS19855	12
GLZ001.A0101_02.YP2.1	4223144	4223147		YPO_RS19870	3
GLZ001.A0101_02.YP2.1	4227000	4227005		YPO_RS19900	5
GLZ001.A0101_02.YP2.1	4227126	4227129		YPO_RS19900	3
GLZ001.A0101_02.YP2.1	4230189	4230197		fadB	8
GLZ001.A0101_02.YP2.1	4232673	4232677		fre	4
GLZ001.A0101_02.YP2.1	4234851	4234872		rfaH	21
GLZ001.A0101_02.YP2.1	4236787	4236789		YPO_RS19940	2
GLZ001.A0101_02.YP2.1	4242457	4242474		ubiB	17
GLZ001.A0101_02.YP2.1	4243339	4243340		YPO_RS19980	1
GLZ001.A0101_02.YP2.1	4251493	4251496		YPO_RS20015	3
GLZ001.A0101_02.YP2.1	4256139	4256169		YPO_RS20030	30
GLZ001.A0101_02.YP2.1	4260959	4260963		ugpA	4
GLZ001.A0101_02.YP2.1	4263389	4263397		YPO_RS20065	8
GLZ001.A0101_02.YP2.1	4263472	4263482		YPO_RS20065	10
GLZ001.A0101_02.YP2.1	4264335	4264375		YPO_RS20070	40
GLZ001.A0101_02.YP2.1	4264448	4264456		YPO_RS20070	8
GLZ001.A0101_02.YP2.1	4265115	4265119		YPO_RS20070	4
GLZ001.A0101_02.YP2.1	4268313	4268321		YPO_RS20085	8
GLZ001.A0101_02.YP2.1	4269655	4269685		YPO_RS20095	30
GLZ001.A0101_02.YP2.1	4270018	4270020		YPO_RS20095	2
GLZ001.A0101_02.YP2.1	4271478	4271481		YPO_RS20105	3
GLZ001.A0101_02.YP2.1	4272278	4272280		YPO_RS20110	2
GLZ001.A0101_02.YP2.1	4273353	4273354		livH	1
GLZ001.A0101_02.YP2.1	4274244	4274255		YPO_RS20120	11
GLZ001.A0101_02.YP2.1	4280831	4280914		ftsY	83
GLZ001.A0101_02.YP2.1	4281808	4281823		rsmD	15
GLZ001.A0101_02.YP2.1	4283024	4283032		YPO_RS20165	8
GLZ001.A0101_02.YP2.1	4290118	4290136		glpC	18
GLZ001.A0101_02.YP2.1	4294562	4294566		glpQ	4
GLZ001.A0101_02.YP2.1	4294624	4294625		glpQ	1
GLZ001.A0101_02.YP2.1	4295515	4295525		glpQ	10
GLZ001.A0101_02.YP2.1	4297434	4297449		yigL	15
GLZ001.A0101_02.YP2.1	4298026	4298066		pldB	40
GLZ001.A0101_02.YP2.1	4301992	4302005		recQ	13
GLZ001.A0101_02.YP2.1	4307893	4307904		YPO_RS20280	11
GLZ001.A0101_02.YP2.1	4310445	4310455		uvrD	10
GLZ001.A0101_02.YP2.1	4314475	4314477		YPO_RS20305	2
GLZ001.A0101_02.YP2.1	4314631	4314641		YPO_RS20305	10
GLZ001.A0101_02.YP2.1	4319034	4319036		YPO_RS20325	2
GLZ001.A0101_02.YP2.1	4328282	4328286		rffM	4
GLZ001.A0101_02.YP2.1	4332486	4332487		rffA	1
GLZ001.A0101_02.YP2.1	4334999	4335005		rfbA	6
GLZ001.A0101_02.YP2.1	4337629	4337631		wecB	2
GLZ001.A0101_02.YP2.1	4341199	4341211		wecA	12
GLZ001.A0101_02.YP2.1	4342897	4342903		rho	6
GLZ001.A0101_02.YP2.1	4347407	4347408		rep	1
GLZ001.A0101_02.YP2.1	4348271	4348277		rep	6
GLZ001.A0101_02.YP2.1	4348991	4349017		YPO_RS20470	26
GLZ001.A0101_02.YP2.1	4349927	4350002		YPO_RS20480	75
GLZ001.A0101_02.YP2.1	4350129	4350152		YPO_RS20480	23
GLZ001.A0101_02.YP2.1	4350343	4350354		YPO_RS20480	11
GLZ001.A0101_02.YP2.1	4353505	4353507		YPO_RS20495	2
GLZ001.A0101_02.YP2.1	4353945	4353986		YPO_RS20500	41
GLZ001.A0101_02.YP2.1	4355059	4355065		YPO_RS20500	6
GLZ001.A0101_02.YP2.1	4358295	4358301		YPO_RS20510	6
GLZ001.A0101_02.YP2.1	4359333	4359366		YPO_RS20515	33
GLZ001.A0101_02.YP2.1	4359521	4359555		YPO_RS20515	34
GLZ001.A0101_02.YP2.1	4360166	4360167		YPO_RS20525	1
GLZ001.A0101_02.YP2.1	4360211	4360290		YPO_RS20525	79
GLZ001.A0101_02.YP2.1	4364581	4364603		ilvY	22
GLZ001.A0101_02.YP2.1	4366120	4366126		YPO_RS20560	6
GLZ001.A0101_02.YP2.1	4366509	4366511		YPO_RS20560	2
GLZ001.A0101_02.YP2.1	4367177	4367207		YPO_RS20565	30
GLZ001.A0101_02.YP2.1	4367556	4367572		YPO_RS20570	16
GLZ001.A0101_02.YP2.1	4367718	4367748		YPO_RS20570	30
GLZ001.A0101_02.YP2.1	4368044	4368062		YPO_RS20575	18
GLZ001.A0101_02.YP2.1	4368273	4368289		YPO_RS20575	16
GLZ001.A0101_02.YP2.1	4368334	4368349		YPO_RS20575	15
GLZ001.A0101_02.YP2.1	4369990	4369991		ilvA	1
GLZ001.A0101_02.YP2.1	4370095	4370099		ilvD	4
GLZ001.A0101_02.YP2.1	4370918	4370923		ilvD	5
GLZ001.A0101_02.YP2.1	4376845	4376849		YPO_RS20610	4
GLZ001.A0101_02.YP2.1	4380271	4380276		YPO_RS20630	5
GLZ001.A0101_02.YP2.1	4381549	4381557		YPO_RS20635	8
GLZ001.A0101_02.YP2.1	4381807	4381811		YPO_RS20635	4
GLZ001.A0101_02.YP2.1	4388486	4388487		YPO_RS20670	1
GLZ001.A0101_02.YP2.1	4389733	4389760		YPO_RS20670	27
GLZ001.A0101_02.YP2.1	4389766	4389773		YPO_RS20675	7
GLZ001.A0101_02.YP2.1	4392137	4392142		btuB	5
GLZ001.A0101_02.YP2.1	4392361	4392370		btuB	9
GLZ001.A0101_02.YP2.1	4392890	4392901		btuB	11
GLZ001.A0101_02.YP2.1	4400886	4400892		YPO_RS20725	6
GLZ001.A0101_02.YP2.1	4401524	4401546		YPO_RS20725	22
GLZ001.A0101_02.YP2.1	4405006	4405031		YPO_RS20740	25
GLZ001.A0101_02.YP2.1	4405901	4405916		YPO_RS20745	15
GLZ001.A0101_02.YP2.1	4406434	4406451		YPO_RS20745	17
GLZ001.A0101_02.YP2.1	4407941	4407943		YPO_RS20745	2
GLZ001.A0101_02.YP2.1	4408276	4408320		YPO_RS20745	44
GLZ001.A0101_02.YP2.1	4412918	4412919		argE	1
GLZ001.A0101_02.YP2.1	4419449	4419477		YPO_RS20780	28
GLZ001.A0101_02.YP2.1	4420166	4420171		YPO_RS20785	5
GLZ001.A0101_02.YP2.1	4420166	4420171		YPO_RS20790	5
GLZ001.A0101_02.YP2.1	4420318	4420326		YPO_RS20790	8
GLZ001.A0101_02.YP2.1	4421957	4421975		glpD	18
GLZ001.A0101_02.YP2.1	4429291	4429292		glgX	1
GLZ001.A0101_02.YP2.1	4429833	4429836		glgX	3
GLZ001.A0101_02.YP2.1	4429983	4429987		glgX	4
GLZ001.A0101_02.YP2.1	4433278	4433288		YPO_RS20825	10
GLZ001.A0101_02.YP2.1	4437130	4437159		YPO_RS20830	29
GLZ001.A0101_02.YP2.1	4439281	4439286		YPO_RS20830	5
GLZ001.A0101_02.YP2.1	4439562	4439563		YPO_RS20830	1
GLZ001.A0101_02.YP2.1	4442496	4442506		YPO_RS20830	10
GLZ001.A0101_02.YP2.1	4442685	4442698		YPO_RS20830	13
GLZ001.A0101_02.YP2.1	4442988	4443001		YPO_RS20830	13
GLZ001.A0101_02.YP2.1	4443563	4443581		YPO_RS20830	18
GLZ001.A0101_02.YP2.1	4446300	4446315		YPO_RS20845	15
GLZ001.A0101_02.YP2.1	4446668	4446692		YPO_RS20855	24
GLZ001.A0101_02.YP2.1	4446768	4446770		YPO_RS20855	2
GLZ001.A0101_02.YP2.1	4448579	4448586		YPO_RS20865	7
GLZ001.A0101_02.YP2.1	4448912	4448927		YPO_RS20865	15
GLZ001.A0101_02.YP2.1	4449541	4449552		YPO_RS20870	11
GLZ001.A0101_02.YP2.1	4463212	4463219		YPO_RS20940	7
GLZ001.A0101_02.YP2.1	4464182	4464184		YPO_RS20940	2
GLZ001.A0101_02.YP2.1	4474571	4474589		rsmJ	18
GLZ001.A0101_02.YP2.1	4478926	4478934		gorA	8
GLZ001.A0101_02.YP2.1	4480655	4480665		YPO_RS21000	10
GLZ001.A0101_02.YP2.1	4480655	4480665		YPO_RS21005	10
GLZ001.A0101_02.YP2.1	4481959	4481960		YPO_RS21010	1
GLZ001.A0101_02.YP2.1	4482149	4482157		YPO_RS21015	8
GLZ001.A0101_02.YP2.1	4483591	4483635		YPO_RS21020	44
GLZ001.A0101_02.YP2.1	4483727	4483738		YPO_RS21020	11
GLZ001.A0101_02.YP2.1	4483791	4483837		YPO_RS21020	46
GLZ001.A0101_02.YP2.1	4483869	4483890		YPO_RS21020	21
GLZ001.A0101_02.YP2.1	4484181	4484224		YPO_RS21025	43
GLZ001.A0101_02.YP2.1	4484374	4484381		YPO_RS21025	7
GLZ001.A0101_02.YP2.1	4484441	4484472		YPO_RS21025	31
GLZ001.A0101_02.YP2.1	4484567	4484598		YPO_RS21025	31
GLZ001.A0101_02.YP2.1	4484665	4484666		YPO_RS21030	1
GLZ001.A0101_02.YP2.1	4485004	4485063		YPO_RS21030	59
GLZ001.A0101_02.YP2.1	4485115	4485117		YPO_RS21030	2
GLZ001.A0101_02.YP2.1	4487557	4487567		yapE	10
GLZ001.A0101_02.YP2.1	4487848	4487868		yapE	20
GLZ001.A0101_02.YP2.1	4488335	4488338		yapE	3
GLZ001.A0101_02.YP2.1	4490433	4490456		yhjD	23
GLZ001.A0101_02.YP2.1	4491249	4491262		YPO_RS21045	13
GLZ001.A0101_02.YP2.1	4491826	4491828		YPO_RS21050	2
GLZ001.A0101_02.YP2.1	4491855	4491856		YPO_RS21050	1
GLZ001.A0101_02.YP2.1	4498889	4498896		YPO_RS21075	7
GLZ001.A0101_02.YP2.1	4501500	4501510		YPO_RS21085	10
GLZ001.A0101_02.YP2.1	4502858	4502870		YPO_RS21090	12
GLZ001.A0101_02.YP2.1	4503100	4503108		YPO_RS21090	8
GLZ001.A0101_02.YP2.1	4503359	4503366		YPO_RS21090	7
GLZ001.A0101_02.YP2.1	4505796	4505817		hmsP	21
GLZ001.A0101_02.YP2.1	4515991	4516013		YPO_RS21140	22
GLZ001.A0101_02.YP2.1	4516083	4516128		YPO_RS21140	45
GLZ001.A0101_02.YP2.1	4516281	4516307		YPO_RS21140	26
GLZ001.A0101_02.YP2.1	4516799	4516801		YPO_RS21140	2
GLZ001.A0101_02.YP2.1	4519053	4519056		YPO_RS21150	3
GLZ001.A0101_02.YP2.1	4527111	4527114		YPO_RS21185	3
GLZ001.A0101_02.YP2.1	4533461	4533489		YPO_RS21205	28
GLZ001.A0101_02.YP2.1	4533889	4533913		YPO_RS21205	24
GLZ001.A0101_02.YP2.1	4534800	4534906		YPO_RS21210	106
GLZ001.A0101_02.YP2.1	4535133	4535173		YPO_RS21215	40
GLZ001.A0101_02.YP2.1	4537051	4537064		YPO_RS21220	13
GLZ001.A0101_02.YP2.1	4539724	4539728		YPO_RS21235	4
GLZ001.A0101_02.YP2.1	4541314	4541322		YPO_RS21240	8
GLZ001.A0101_02.YP2.1	4543373	4543394		YPO_RS21265	21
GLZ001.A0101_02.YP2.1	4545287	4545304		YPO_RS21280	17
GLZ001.A0101_02.YP2.1	4545384	4545403		YPO_RS21280	19
GLZ001.A0101_02.YP2.1	4545611	4545679		YPO_RS21280	68
GLZ001.A0101_02.YP2.1	4545808	4545866		YPO_RS21280	58
GLZ001.A0101_02.YP2.1	4546035	4546042		YPO_RS21280	7
GLZ001.A0101_02.YP2.1	4557422	4557426		YPO_RS21325	4
GLZ001.A0101_02.YP2.1	4558112	4558141		YPO_RS21330	29
GLZ001.A0101_02.YP2.1	4561590	4561595		YPO_RS21340	5
GLZ001.A0101_02.YP2.1	4561825	4561867		YPO_RS21340	42
GLZ001.A0101_02.YP2.1	4563871	4563886		YPO_RS21350	15
GLZ001.A0101_02.YP2.1	4567665	4567790		YPO_RS21370	125
GLZ001.A0101_02.YP2.1	4568306	4568310		YPO_RS21375	4
GLZ001.A0101_02.YP2.1	4568448	4568451		YPO_RS21375	3
GLZ001.A0101_02.YP2.1	4568465	4568476		YPO_RS21380	11
GLZ001.A0101_02.YP2.1	4568758	4568784		YPO_RS21380	26
GLZ001.A0101_02.YP2.1	4572551	4572569		YPO_RS21400	18
GLZ001.A0101_02.YP2.1	4574657	4574673		fdoI	16
GLZ001.A0101_02.YP2.1	4575009	4575037		fdxH	28
GLZ001.A0101_02.YP2.1	4575355	4575372		fdxH	17
GLZ001.A0101_02.YP2.1	4578594	4578625		fdnG	31
GLZ001.A0101_02.YP2.1	4581372	4581402		YPO_RS21435	30
GLZ001.A0101_02.YP2.1	4583337	4583350		YPO_RS21440	13
GLZ001.A0101_02.YP2.1	4583564	4583605		YPO_RS21440	41
GLZ001.A0101_02.YP2.1	4590029	4590035		YPO_RS21470	6
GLZ001.A0101_02.YP2.1	4593325	4593351		glyQ	26
GLZ001.A0101_02.YP2.1	4598466	4598470		ghrB	4
GLZ001.A0101_02.YP2.1	4601669	4601739		YPO_RS21520	70
GLZ001.A0101_02.YP2.1	4601823	4601826		YPO_RS21520	3
GLZ001.A0101_02.YP2.1	4601966	4601976		YPO_RS21520	10
GLZ001.A0101_02.YP2.1	4602012	4602052		YPO_RS21520	40
GLZ001.A0101_02.YP2.1	4608997	4609006		YPO_RS21555	9
GLZ001.A0101_02.YP2.1	4609850	4609861		YPO_RS21560	11
GLZ001.A0101_02.YP2.1	4612519	4612524		yidA	5
GLZ001.A0101_02.YP2.1	4615078	4615081		gyrB	3
GLZ001.A0101_02.YP2.1	4615151	4615161		gyrB	10
GLZ001.A0101_02.YP2.1	4616190	4616214		recF	24
GLZ001.A0101_02.YP2.1	4623758	4623778		mnmE	20
GLZ001.A0101_02.YP2.1	4625901	4625905		YPO_RS21625	4
GLZ001.A0101_02.YP2.1	4626083	4626089		YPO_RS21625	6
GLZ001.A0101_02.YP2.1	4626263	4626313		YPO_RS21630	50
GLZ001.A0101_02.YP2.1	4626524	4626530		YPO_RS21635	6
GLZ001.A0101_02.YP2.1	4626592	4626595		YPO_RS21635	3
GLZ001.A0101_02.YP2.1	4627800	4627817		YPO_RS21640	17
GLZ001.A0101_02.YP2.1	4628765	4628768		YPO_RS21640	3
GLZ001.A0101_02.YP2.1	4629424	4629435		YPO_RS21645	11
GLZ001.A0101_02.YP2.1	4629686	4629697		yieH	11
GLZ001.A0101_02.YP2.1	4632027	4632031		YPO_RS21665	4
GLZ001.A0101_02.YP2.1	4633479	4633507		YPO_RS21670	28
GLZ001.A0101_02.YP2.1	4635638	4635642		pstA	4
GLZ001.A0101_02.YP2.1	4641404	4641410		glmU	6
GLZ002.A0101_2.YP2.1	1440	1453		YPO_RS01015	13
GLZ002.A0101_2.YP2.1	1766	1780		YPO_RS01015	14
GLZ002.A0101_2.YP2.1	4019	4066		ravA	47
GLZ002.A0101_2.YP2.1	10221	10224		YPO_RS01055	3
GLZ002.A0101_2.YP2.1	14905	14918		YPO_RS01080	13
GLZ002.A0101_2.YP2.1	20109	20116		mobA	7
GLZ002.A0101_2.YP2.1	22380	22394		dsbA	14
GLZ002.A0101_2.YP2.1	24702	24703		polA	1
GLZ002.A0101_2.YP2.1	33133	33135		glnA	2
GLZ002.A0101_2.YP2.1	37830	37837		yihX	7
GLZ002.A0101_2.YP2.1	47793	47820		recG	27
GLZ002.A0101_2.YP2.1	74275	74278		envC	3
GLZ002.A0101_2.YP2.1	74630	74650		envC	20
GLZ002.A0101_2.YP2.1	106578	106588		YPO_RS01520	10
GLZ002.A0101_2.YP2.1	109485	109500		YPO_RS01530	15
GLZ002.A0101_2.YP2.1	127511	127523		YPO_RS01610	12
GLZ002.A0101_2.YP2.1	131421	131429		malT	8
GLZ002.A0101_2.YP2.1	163874	163875		hofQ	1
GLZ002.A0101_2.YP2.1	183067	183073		YPO_RS01835	6
GLZ002.A0101_2.YP2.1	190183	190184		YPO_RS01865	1
GLZ002.A0101_2.YP2.1	196660	196697		YPO_RS01895	37
GLZ002.A0101_2.YP2.1	236485	236494		YPO_RS02185	9
GLZ002.A0101_2.YP2.1	258201	258202		YPO_RS02285	1
GLZ002.A0101_2.YP2.1	258414	258448		YPO_RS02285	34
GLZ002.A0101_2.YP2.1	258747	258777		YPO_RS02290	30
GLZ002.A0101_2.YP2.1	268556	268559		YPO_RS02345	3
GLZ002.A0101_2.YP2.1	275952	275980		YPO_RS02395	28
GLZ002.A0101_2.YP2.1	276370	276381		YPO_RS02395	11
GLZ002.A0101_2.YP2.1	277891	277894		metC	3
GLZ002.A0101_2.YP2.1	288516	288517		YPO_RS02455	1
GLZ002.A0101_2.YP2.1	288867	288917		YPO_RS02455	50
GLZ002.A0101_2.YP2.1	292031	292042		YPO_RS02470	11
GLZ002.A0101_2.YP2.1	302675	302686		YPO_RS02530	11
GLZ002.A0101_2.YP2.1	303249	303260		YPO_RS02530	11
GLZ002.A0101_2.YP2.1	315054	315098		yapK	44
GLZ002.A0101_2.YP2.1	342550	342561		rhaR	11
GLZ002.A0101_2.YP2.1	345937	345981		YPO_RS02695	44
GLZ002.A0101_2.YP2.1	347715	347759		YPO_RS02695	44
GLZ002.A0101_2.YP2.1	347990	348029		YPO_RS02695	39
GLZ002.A0101_2.YP2.1	360460	360461		fxsA	1
GLZ002.A0101_2.YP2.1	360978	360988		fxsA	10
GLZ002.A0101_2.YP2.1	371096	371131		YPO_RS02805	35
GLZ002.A0101_2.YP2.1	404312	404333		YPO_RS02940	21
GLZ002.A0101_2.YP2.1	407787	407827		YPO_RS02955	40
GLZ002.A0101_2.YP2.1	407880	407896		YPO_RS02955	16
GLZ002.A0101_2.YP2.1	408063	408082		YPO_RS02955	19
GLZ002.A0101_2.YP2.1	408154	408205		YPO_RS02955	51
GLZ002.A0101_2.YP2.1	408309	408312		YPO_RS02955	3
GLZ002.A0101_2.YP2.1	408458	408487		YPO_RS02955	29
GLZ002.A0101_2.YP2.1	409036	409043		YPO_RS02960	7
GLZ002.A0101_2.YP2.1	409210	409233		YPO_RS02960	23
GLZ002.A0101_2.YP2.1	409409	409438		YPO_RS02960	29
GLZ002.A0101_2.YP2.1	409495	409509		YPO_RS02960	14
GLZ002.A0101_2.YP2.1	409680	409704		YPO_RS02965	24
GLZ002.A0101_2.YP2.1	409841	409873		YPO_RS02965	32
GLZ002.A0101_2.YP2.1	410046	410092		YPO_RS02965	46
GLZ002.A0101_2.YP2.1	410374	410387		YPO_RS02965	13
GLZ002.A0101_2.YP2.1	410558	410584		YPO_RS02965	26
GLZ002.A0101_2.YP2.1	410818	410822		YPO_RS02965	4
GLZ002.A0101_2.YP2.1	410877	410891		YPO_RS02965	14
GLZ002.A0101_2.YP2.1	409580	409647		YPO_RS02965	67
GLZ002.A0101_2.YP2.1	415851	415853		YPO_RS02990	2
GLZ002.A0101_2.YP2.1	426051	426058		lsrF	7
GLZ002.A0101_2.YP2.1	431315	431375		YPO_RS03065	60
GLZ002.A0101_2.YP2.1	435108	435114		rfaQ	6
GLZ002.A0101_2.YP2.1	446201	446233		YPO_RS03120	32
GLZ002.A0101_2.YP2.1	446403	446405		YPO_RS03120	2
GLZ002.A0101_2.YP2.1	453372	453376		YPO_RS03165	4
GLZ002.A0101_2.YP2.1	463627	463631		serB	4
GLZ002.A0101_2.YP2.1	475410	475416		YPO_RS03245	6
GLZ002.A0101_2.YP2.1	493542	493548		YPO_RS03325	6
GLZ002.A0101_2.YP2.1	494483	494492		YPO_RS03330	9
GLZ002.A0101_2.YP2.1	495286	495304		YPO_RS03330	18
GLZ002.A0101_2.YP2.1	495389	495420		YPO_RS03330	31
GLZ002.A0101_2.YP2.1	495759	495804		YPO_RS03330	45
GLZ002.A0101_2.YP2.1	495978	495985		YPO_RS03330	7
GLZ002.A0101_2.YP2.1	496042	496053		YPO_RS03330	11
GLZ002.A0101_2.YP2.1	520821	520861		YPO_RS03445	40
GLZ002.A0101_2.YP2.1	521134	521159		YPO_RS03450	25
GLZ002.A0101_2.YP2.1	526543	526545		lptD	2
GLZ002.A0101_2.YP2.1	532933	532938		YPO_RS03500	5
GLZ002.A0101_2.YP2.1	562651	562659		YPO_RS03600	8
GLZ002.A0101_2.YP2.1	573140	573142		YPO_RS03645	2
GLZ002.A0101_2.YP2.1	575344	575357		leuC	13
GLZ002.A0101_2.YP2.1	579371	579388		YPO_RS03675	17
GLZ002.A0101_2.YP2.1	595327	595339		murF	12
GLZ002.A0101_2.YP2.1	612756	612767		mutT	11
GLZ002.A0101_2.YP2.1	635492	635532		yapG	40
GLZ002.A0101_2.YP2.1	653735	653746		cdiA	11
GLZ002.A0101_2.YP2.1	659235	659243		cdiI	8
GLZ002.A0101_2.YP2.1	659297	659316		cdiI	19
GLZ002.A0101_2.YP2.1	659351	659413		cdiI	62
GLZ002.A0101_2.YP2.1	660142	660161		YPO_RS04005	19
GLZ002.A0101_2.YP2.1	666286	666304		YPO_RS04030	18
GLZ002.A0101_2.YP2.1	667977	667987		YPO_RS04035	10
GLZ002.A0101_2.YP2.1	673972	673998		YPO_RS04055	26
GLZ002.A0101_2.YP2.1	675964	675973		YPO_RS04065	9
GLZ002.A0101_2.YP2.1	684446	684470		YPO_RS04100	24
GLZ002.A0101_2.YP2.1	685194	685196		YPO_RS04100	2
GLZ002.A0101_2.YP2.1	686669	686683		YPO_RS04105	14
GLZ002.A0101_2.YP2.1	687263	687301		YPO_RS04110	38
GLZ002.A0101_2.YP2.1	687941	687972		YPO_RS04115	31
GLZ002.A0101_2.YP2.1	704983	705019		plsY	36
GLZ002.A0101_2.YP2.1	712084	712105		glnE	21
GLZ002.A0101_2.YP2.1	730479	730488		YPO_RS04320	9
GLZ002.A0101_2.YP2.1	747787	747802		YPO_RS04390	15
GLZ002.A0101_2.YP2.1	750085	750105		YPO_RS04410	20
GLZ002.A0101_2.YP2.1	750182	750266		YPO_RS04410	84
GLZ002.A0101_2.YP2.1	750367	750378		YPO_RS04410	11
GLZ002.A0101_2.YP2.1	750411	750462		YPO_RS04410	51
GLZ002.A0101_2.YP2.1	750459	750522		YPO_RS04415	63
GLZ002.A0101_2.YP2.1	750968	751061		YPO_RS04415	93
GLZ002.A0101_2.YP2.1	751126	751135		YPO_RS04415	9
GLZ002.A0101_2.YP2.1	752439	752473		YPO_RS04420	34
GLZ002.A0101_2.YP2.1	752629	752675		YPO_RS04425	46
GLZ002.A0101_2.YP2.1	753533	753536		YPO_RS04425	3
GLZ002.A0101_2.YP2.1	753729	753756		YPO_RS04425	27
GLZ002.A0101_2.YP2.1	753767	753795		YPO_RS04430	28
GLZ002.A0101_2.YP2.1	754036	754038		YPO_RS04430	2
GLZ002.A0101_2.YP2.1	754759	754892		YPO_RS04440	133
GLZ002.A0101_2.YP2.1	755319	755360		YPO_RS04440	41
GLZ002.A0101_2.YP2.1	755733	755744		YPO_RS04445	11
GLZ002.A0101_2.YP2.1	755907	755936		YPO_RS04445	29
GLZ002.A0101_2.YP2.1	756532	756576		YPO_RS04450	44
GLZ002.A0101_2.YP2.1	756678	756705		YPO_RS04450	27
GLZ002.A0101_2.YP2.1	769864	769865		flhB	1
GLZ002.A0101_2.YP2.1	772005	772022		fliN	17
GLZ002.A0101_2.YP2.1	772825	772833		YPO_RS04525	8
GLZ002.A0101_2.YP2.1	782240	782266		flgA	26
GLZ002.A0101_2.YP2.1	785300	785341		YPO_RS04600	41
GLZ002.A0101_2.YP2.1	791717	791726		flgL	9
GLZ002.A0101_2.YP2.1	796069	796094		YPO_RS04660	25
GLZ002.A0101_2.YP2.1	801480	801498		fliS	18
GLZ002.A0101_2.YP2.1	803234	803254		YPO_RS04695	20
GLZ002.A0101_2.YP2.1	804372	804390		YPO_RS04700	18
GLZ002.A0101_2.YP2.1	806683	806691		YPO_RS04715	8
GLZ002.A0101_2.YP2.1	807180	807183		YPO_RS04715	3
GLZ002.A0101_2.YP2.1	807614	807686		YPO_RS04720	72
GLZ002.A0101_2.YP2.1	807778	807798		YPO_RS04725	20
GLZ002.A0101_2.YP2.1	808992	809011		YPO_RS04735	19
GLZ002.A0101_2.YP2.1	809148	809222		YPO_RS04735	74
GLZ002.A0101_2.YP2.1	811230	811240		YPO_RS04745	10
GLZ002.A0101_2.YP2.1	816430	816431		YPO_RS04765	1
GLZ002.A0101_2.YP2.1	816736	816737		YPO_RS04765	1
GLZ002.A0101_2.YP2.1	816868	816878		YPO_RS04770	10
GLZ002.A0101_2.YP2.1	836652	836661		YPO_RS04805	9
GLZ002.A0101_2.YP2.1	838842	838883		YPO_RS04815	41
GLZ002.A0101_2.YP2.1	845405	845607		YPO_RS04835	202
GLZ002.A0101_2.YP2.1	872583	872587		YPO_RS04915	4
GLZ002.A0101_2.YP2.1	883478	883485		YPO_RS04955	7
GLZ002.A0101_2.YP2.1	883527	883551		YPO_RS04955	24
GLZ002.A0101_2.YP2.1	883980	883981		YPO_RS04960	1
GLZ002.A0101_2.YP2.1	884064	884122		YPO_RS04960	58
GLZ002.A0101_2.YP2.1	884449	884466		YPO_RS04965	17
GLZ002.A0101_2.YP2.1	885675	885698		YPO_RS04975	23
GLZ002.A0101_2.YP2.1	886091	886094		YPO_RS04975	3
GLZ002.A0101_2.YP2.1	886505	886523		YPO_RS04980	18
GLZ002.A0101_2.YP2.1	886609	886666		YPO_RS04980	57
GLZ002.A0101_2.YP2.1	887062	887108		gspL	46
GLZ002.A0101_2.YP2.1	887771	887775		gspL	4
GLZ002.A0101_2.YP2.1	888145	888200		YPO_RS04990	55
GLZ002.A0101_2.YP2.1	888454	888489		YPO_RS04990	35
GLZ002.A0101_2.YP2.1	888707	888715		YPO_RS04990	8
GLZ002.A0101_2.YP2.1	888762	888794		YPO_RS04990	32
GLZ002.A0101_2.YP2.1	889190	889209		gspJ	19
GLZ002.A0101_2.YP2.1	889302	889310		gspJ	8
GLZ002.A0101_2.YP2.1	889509	889519		gspJ	10
GLZ002.A0101_2.YP2.1	889984	890030		YPO_RS05005	46
GLZ002.A0101_2.YP2.1	890234	890248		YPO_RS05005	14
GLZ002.A0101_2.YP2.1	893271	893275		gspE	4
GLZ002.A0101_2.YP2.1	893739	893816		gspD	77
GLZ002.A0101_2.YP2.1	893876	893891		gspD	15
GLZ002.A0101_2.YP2.1	894344	894360		gspD	16
GLZ002.A0101_2.YP2.1	894703	894724		gspD	21
GLZ002.A0101_2.YP2.1	894843	894880		gspD	37
GLZ002.A0101_2.YP2.1	894941	894964		gspD	23
GLZ002.A0101_2.YP2.1	895451	895489		gspD	38
GLZ002.A0101_2.YP2.1	895687	895752		YPO_RS05030	65
GLZ002.A0101_2.YP2.1	895890	895922		YPO_RS05030	32
GLZ002.A0101_2.YP2.1	896127	896190		YPO_RS05030	63
GLZ002.A0101_2.YP2.1	896258	896291		YPO_RS05035	33
GLZ002.A0101_2.YP2.1	896448	896467		YPO_RS05035	19
GLZ002.A0101_2.YP2.1	896672	896674		YPO_RS05035	2
GLZ002.A0101_2.YP2.1	897417	897431		YPO_RS05040	14
GLZ002.A0101_2.YP2.1	900326	900342		YPO_RS05050	16
GLZ002.A0101_2.YP2.1	900699	900705		yapM	6
GLZ002.A0101_2.YP2.1	904002	904015		YPO_RS05060	13
GLZ002.A0101_2.YP2.1	908130	908132		tnpA	2
GLZ002.A0101_2.YP2.1	924392	924409		YPO_RS05145	17
GLZ002.A0101_2.YP2.1	940560	940569		YPO_RS05205	9
GLZ002.A0101_2.YP2.1	950175	950196		YPO_RS05235	21
GLZ002.A0101_2.YP2.1	953030	953033		YPO_RS05250	3
GLZ002.A0101_2.YP2.1	953749	953757		YPO_RS05260	8
GLZ002.A0101_2.YP2.1	954132	954144		YPO_RS05260	12
GLZ002.A0101_2.YP2.1	963355	963356		YPO_RS05305	1
GLZ002.A0101_2.YP2.1	964445	964446		YPO_RS05325	1
GLZ002.A0101_2.YP2.1	973989	973990		prfB	1
GLZ002.A0101_2.YP2.1	993951	993964		gcvP	13
GLZ002.A0101_2.YP2.1	1015340	1015349		YPO_RS05560	9
GLZ002.A0101_2.YP2.1	1039189	1039204		YPO_RS05675	15
GLZ002.A0101_2.YP2.1	1039706	1039708		YPO_RS05675	2
GLZ002.A0101_2.YP2.1	1039762	1039772		YPO_RS05675	10
GLZ002.A0101_2.YP2.1	1039867	1039887		YPO_RS05675	20
GLZ002.A0101_2.YP2.1	1042737	1042740		YPO_RS05675	3
GLZ002.A0101_2.YP2.1	1043955	1043984		YPO_RS05675	29
GLZ002.A0101_2.YP2.1	1044257	1044270		YPO_RS05675	13
GLZ002.A0101_2.YP2.1	1044405	1044536		YPO_RS05675	131
GLZ002.A0101_2.YP2.1	1044633	1044659		YPO_RS05675	26
GLZ002.A0101_2.YP2.1	1044736	1044742		YPO_RS05675	6
GLZ002.A0101_2.YP2.1	1044798	1044802		YPO_RS05675	4
GLZ002.A0101_2.YP2.1	1045008	1045071		YPO_RS05675	63
GLZ002.A0101_2.YP2.1	1045512	1045563		YPO_RS05675	51
GLZ002.A0101_2.YP2.1	1046479	1046497		YPO_RS05675	18
GLZ002.A0101_2.YP2.1	1046555	1046562		YPO_RS05675	7
GLZ002.A0101_2.YP2.1	1046683	1046713		YPO_RS05675	30
GLZ002.A0101_2.YP2.1	1057127	1057134		YPO_RS05725	7
GLZ002.A0101_2.YP2.1	1066868	1066924		YPO_RS05765	56
GLZ002.A0101_2.YP2.1	1066988	1066993		YPO_RS05765	5
GLZ002.A0101_2.YP2.1	1067241	1067249		YPO_RS05765	8
GLZ002.A0101_2.YP2.1	1067329	1067389		YPO_RS05765	60
GLZ002.A0101_2.YP2.1	1067376	1067402		YPO_RS05770	26
GLZ002.A0101_2.YP2.1	1068152	1068173		YPO_RS05770	21
GLZ002.A0101_2.YP2.1	1073121	1073148		YPO_RS05795	27
GLZ002.A0101_2.YP2.1	1084044	1084049		tssK	5
GLZ002.A0101_2.YP2.1	1088696	1088715		YPO_RS05845	19
GLZ002.A0101_2.YP2.1	1089069	1089082		YPO_RS05845	13
GLZ002.A0101_2.YP2.1	1092429	1092476		YPO_RS05860	47
GLZ002.A0101_2.YP2.1	1095839	1095841		YPO_RS05870	2
GLZ002.A0101_2.YP2.1	1106445	1106466		YPO_RS05910	21
GLZ002.A0101_2.YP2.1	1116789	1116829		YPO_RS05940	40
GLZ002.A0101_2.YP2.1	1116978	1116979		YPO_RS05940	1
GLZ002.A0101_2.YP2.1	1117062	1117084		YPO_RS05940	22
GLZ002.A0101_2.YP2.1	1117254	1117300		YPO_RS05940	46
GLZ002.A0101_2.YP2.1	1117403	1117421		YPO_RS05940	18
GLZ002.A0101_2.YP2.1	1118081	1118109		YPO_RS05940	28
GLZ002.A0101_2.YP2.1	1121557	1121574		yapH	17
GLZ002.A0101_2.YP2.1	1121621	1121625		yapH	4
GLZ002.A0101_2.YP2.1	1123649	1123651		yapH	2
GLZ002.A0101_2.YP2.1	1124075	1124110		yapH	35
GLZ002.A0101_2.YP2.1	1124165	1124190		yapH	25
GLZ002.A0101_2.YP2.1	1124225	1124228		yapH	3
GLZ002.A0101_2.YP2.1	1124277	1124284		yapH	7
GLZ002.A0101_2.YP2.1	1124384	1124397		yapH	13
GLZ002.A0101_2.YP2.1	1124477	1124483		yapH	6
GLZ002.A0101_2.YP2.1	1124532	1124542		yapH	10
GLZ002.A0101_2.YP2.1	1124608	1124615		yapH	7
GLZ002.A0101_2.YP2.1	1124693	1124877		yapH	184
GLZ002.A0101_2.YP2.1	1124925	1124935		yapH	10
GLZ002.A0101_2.YP2.1	1124991	1125006		yapH	15
GLZ002.A0101_2.YP2.1	1125122	1125148		yapH	26
GLZ002.A0101_2.YP2.1	1125179	1125183		yapH	4
GLZ002.A0101_2.YP2.1	1125210	1125256		yapH	46
GLZ002.A0101_2.YP2.1	1125305	1125398		yapH	93
GLZ002.A0101_2.YP2.1	1125446	1125478		yapH	32
GLZ002.A0101_2.YP2.1	1125543	1125597		yapH	54
GLZ002.A0101_2.YP2.1	1125674	1125675		yapH	1
GLZ002.A0101_2.YP2.1	1134058	1134090		YPO_RS05965	32
GLZ002.A0101_2.YP2.1	1134575	1134600		YPO_RS05970	25
GLZ002.A0101_2.YP2.1	1136112	1136123		YPO_RS05970	11
GLZ002.A0101_2.YP2.1	1136391	1136392		YPO_RS05970	1
GLZ002.A0101_2.YP2.1	1140551	1140573		YPO_RS05985	22
GLZ002.A0101_2.YP2.1	1140841	1140846		YPO_RS05985	5
GLZ002.A0101_2.YP2.1	1141607	1141628		YPO_RS05985	21
GLZ002.A0101_2.YP2.1	1142250	1142264		YPO_RS05985	14
GLZ002.A0101_2.YP2.1	1156060	1156072		recB	12
GLZ002.A0101_2.YP2.1	1162094	1162101		argA	7
GLZ002.A0101_2.YP2.1	1178521	1178532		YPO_RS06130	11
GLZ002.A0101_2.YP2.1	1191332	1191346		cdsA	14
GLZ002.A0101_2.YP2.1	1198545	1198554		lpxA	9
GLZ002.A0101_2.YP2.1	1214659	1214684		metI	25
GLZ002.A0101_2.YP2.1	1218461	1218462		YPO_RS06330	1
GLZ002.A0101_2.YP2.1	1220115	1220121		YPO_RS06340	6
GLZ002.A0101_2.YP2.1	1221217	1221222		YPO_RS06340	5
GLZ002.A0101_2.YP2.1	1221599	1221602		YPO_RS06340	3
GLZ002.A0101_2.YP2.1	1226737	1226740		mltD	3
GLZ002.A0101_2.YP2.1	1227222	1227224		gloB	2
GLZ002.A0101_2.YP2.1	1237284	1237295		YPO_RS06440	11
GLZ002.A0101_2.YP2.1	1239115	1239116		YPO_RS06455	1
GLZ002.A0101_2.YP2.1	1240665	1240666		YPO_RS06465	1
GLZ002.A0101_2.YP2.1	1240998	1241150		YPO_RS06465	152
GLZ002.A0101_2.YP2.1	1241541	1241549		YPO_RS06465	8
GLZ002.A0101_2.YP2.1	1241687	1241716		YPO_RS06465	29
GLZ002.A0101_2.YP2.1	1241908	1241940		YPO_RS06465	32
GLZ002.A0101_2.YP2.1	1242014	1242046		YPO_RS06465	32
GLZ002.A0101_2.YP2.1	1242385	1242416		YPO_RS06470	31
GLZ002.A0101_2.YP2.1	1242767	1242773		YPO_RS06470	6
GLZ002.A0101_2.YP2.1	1243194	1243263		YPO_RS06470	69
GLZ002.A0101_2.YP2.1	1243574	1243575		YPO_RS06475	1
GLZ002.A0101_2.YP2.1	1247728	1247743		bamE	15
GLZ002.A0101_2.YP2.1	1251904	1251910		YPO_RS06525	6
GLZ002.A0101_2.YP2.1	1269604	1269626		tolA	22
GLZ002.A0101_2.YP2.1	1269939	1269948		tolA	9
GLZ002.A0101_2.YP2.1	1271112	1271122		tolB	10
GLZ002.A0101_2.YP2.1	1280084	1280092		YPO_RS06670	8
GLZ002.A0101_2.YP2.1	1301587	1301590		YPO_RS06780	3
GLZ002.A0101_2.YP2.1	1315935	1315937		YPO_RS06845	2
GLZ002.A0101_2.YP2.1	1322220	1322289		YPO_RS06875	69
GLZ002.A0101_2.YP2.1	1323418	1323425		dusC	7
GLZ002.A0101_2.YP2.1	1330980	1330984		phnC	4
GLZ002.A0101_2.YP2.1	1331062	1331082		phnC	20
GLZ002.A0101_2.YP2.1	1331643	1331653		phnC	10
GLZ002.A0101_2.YP2.1	1332172	1332181		phnD	9
GLZ002.A0101_2.YP2.1	1338601	1338602		urtB	1
GLZ002.A0101_2.YP2.1	1355602	1355624		ompF2	22
GLZ002.A0101_2.YP2.1	1355744	1355751		ompF2	7
GLZ002.A0101_2.YP2.1	1364800	1364801		YPO_RS07055	1
GLZ002.A0101_2.YP2.1	1376916	1376934		rcsB	18
GLZ002.A0101_2.YP2.1	1377369	1377373		YPO_RS07100	4
GLZ002.A0101_2.YP2.1	1382266	1382278		YPO_RS07115	12
GLZ002.A0101_2.YP2.1	1390689	1390694		YPO_RS07150	5
GLZ002.A0101_2.YP2.1	1397906	1397919		YPO_RS07190	13
GLZ002.A0101_2.YP2.1	1402068	1402070		YPO_RS07220	2
GLZ002.A0101_2.YP2.1	1410512	1410561		YPO_RS07270	49
GLZ002.A0101_2.YP2.1	1413169	1413171		YPO_RS07280	2
GLZ002.A0101_2.YP2.1	1419012	1419013		yejK	1
GLZ002.A0101_2.YP2.1	1422637	1422640		YPO_RS07330	3
GLZ002.A0101_2.YP2.1	1430526	1430551		YPO_RS07360	25
GLZ002.A0101_2.YP2.1	1433412	1433420		YPO_RS07370	8
GLZ002.A0101_2.YP2.1	1438655	1438676		YPO_RS07390	21
GLZ002.A0101_2.YP2.1	1445521	1445534		YPO_RS07420	13
GLZ002.A0101_2.YP2.1	1449281	1449298		YPO_RS07435	17
GLZ002.A0101_2.YP2.1	1451361	1451378		xylB	17
GLZ002.A0101_2.YP2.1	1461359	1461368		YPO_RS07485	9
GLZ002.A0101_2.YP2.1	1461809	1461813		YPO_RS07490	4
GLZ002.A0101_2.YP2.1	1462091	1462113		YPO_RS07490	22
GLZ002.A0101_2.YP2.1	1463379	1463442		YPO_RS07500	63
GLZ002.A0101_2.YP2.1	1463840	1463869		YPO_RS07500	29
GLZ002.A0101_2.YP2.1	1464660	1464662		psaC	2
GLZ002.A0101_2.YP2.1	1476989	1477030		YPO_RS07545	41
GLZ002.A0101_2.YP2.1	1501695	1501698		rlmC	3
GLZ002.A0101_2.YP2.1	1507313	1507324		YPO_RS07690	11
GLZ002.A0101_2.YP2.1	1557263	1557266		YPO_RS07900	3
GLZ002.A0101_2.YP2.1	1563526	1563527		YPO_RS07915	1
GLZ002.A0101_2.YP2.1	1563862	1563877		ansB	15
GLZ002.A0101_2.YP2.1	1566676	1566707		YPO_RS07930	31
GLZ002.A0101_2.YP2.1	1567514	1567547		YPO_RS07930	33
GLZ002.A0101_2.YP2.1	1567692	1567725		YPO_RS07930	33
GLZ002.A0101_2.YP2.1	1567767	1567773		YPO_RS07930	6
GLZ002.A0101_2.YP2.1	1567846	1567854		YPO_RS07930	8
GLZ002.A0101_2.YP2.1	1580128	1580132		YPO_RS07975	4
GLZ002.A0101_2.YP2.1	1595714	1595775		ldtD	61
GLZ002.A0101_2.YP2.1	1599280	1599284		ompF	4
GLZ002.A0101_2.YP2.1	1605470	1605471		pepN	1
GLZ002.A0101_2.YP2.1	1615986	1615991		pqiA	5
GLZ002.A0101_2.YP2.1	1622241	1622263		YPO_RS08130	22
GLZ002.A0101_2.YP2.1	1626355	1626357		matP	2
GLZ002.A0101_2.YP2.1	1629076	1629085		sulA	9
GLZ002.A0101_2.YP2.1	1632412	1632418		YPO_RS08185	6
GLZ002.A0101_2.YP2.1	1637522	1637530		rlmI	8
GLZ002.A0101_2.YP2.1	1647598	1647668		YPO_RS08260	70
GLZ002.A0101_2.YP2.1	1651528	1651533		YPO_RS08280	5
GLZ002.A0101_2.YP2.1	1651865	1651904		YPO_RS08280	39
GLZ002.A0101_2.YP2.1	1652065	1652100		YPO_RS08280	35
GLZ002.A0101_2.YP2.1	1652102	1652121		YPO_RS08285	19
GLZ002.A0101_2.YP2.1	1652414	1652417		YPO_RS08285	3
GLZ002.A0101_2.YP2.1	1653818	1653822		YPO_RS08295	4
GLZ002.A0101_2.YP2.1	1658263	1658265		tssC	2
GLZ002.A0101_2.YP2.1	1661114	1661122		YPO_RS08330	8
GLZ002.A0101_2.YP2.1	1661375	1661377		YPO_RS08330	2
GLZ002.A0101_2.YP2.1	1668236	1668238		YPO_RS08350	2
GLZ002.A0101_2.YP2.1	1669970	1669976		YPO_RS08350	6
GLZ002.A0101_2.YP2.1	1670162	1670182		YPO_RS08350	20
GLZ002.A0101_2.YP2.1	1670451	1670462		YPO_RS08350	11
GLZ002.A0101_2.YP2.1	1670459	1670564		YPO_RS08355	105
GLZ002.A0101_2.YP2.1	1671633	1671645		YPO_RS08360	12
GLZ002.A0101_2.YP2.1	1673345	1673383		YPO_RS08365	38
GLZ002.A0101_2.YP2.1	1673836	1673845		YPO_RS08365	9
GLZ002.A0101_2.YP2.1	1674229	1674247		YPO_RS08370	18
GLZ002.A0101_2.YP2.1	1680195	1680197		YPO_RS08385	2
GLZ002.A0101_2.YP2.1	1681288	1681304		YPO_RS08385	16
GLZ002.A0101_2.YP2.1	1684060	1684171		YPO_RS08400	111
GLZ002.A0101_2.YP2.1	1684421	1684495		YPO_RS08400	74
GLZ002.A0101_2.YP2.1	1690140	1690146		YPO_RS08430	6
GLZ002.A0101_2.YP2.1	1690380	1690388		YPO_RS08430	8
GLZ002.A0101_2.YP2.1	1690621	1690656		YPO_RS08430	35
GLZ002.A0101_2.YP2.1	1693921	1693922		YPO_RS08440	1
GLZ002.A0101_2.YP2.1	1698455	1698456		darE	1
GLZ002.A0101_2.YP2.1	1698527	1698530		darE	3
GLZ002.A0101_2.YP2.1	1698675	1698696		darE	21
GLZ002.A0101_2.YP2.1	1699101	1699115		darE	14
GLZ002.A0101_2.YP2.1	1699591	1699601		darD	10
GLZ002.A0101_2.YP2.1	1700034	1700045		darC	11
GLZ002.A0101_2.YP2.1	1701031	1701143		darC	112
GLZ002.A0101_2.YP2.1	1701145	1701155		darB	10
GLZ002.A0101_2.YP2.1	1701354	1701415		darB	61
GLZ002.A0101_2.YP2.1	1701521	1701534		darB	13
GLZ002.A0101_2.YP2.1	1702587	1702621		darB	34
GLZ002.A0101_2.YP2.1	1703385	1703409		darB	24
GLZ002.A0101_2.YP2.1	1703684	1703700		darA-c	16
GLZ002.A0101_2.YP2.1	1714084	1714092		mglC	8
GLZ002.A0101_2.YP2.1	1714200	1714203		mglC	3
GLZ002.A0101_2.YP2.1	1725936	1725949		YPO_RS08570	13
GLZ002.A0101_2.YP2.1	1726219	1726295		YPO_RS08570	76
GLZ002.A0101_2.YP2.1	1735126	1735136		asmA	10
GLZ002.A0101_2.YP2.1	1738543	1738559		fhuF	16
GLZ002.A0101_2.YP2.1	1739024	1739033		fhuF	9
GLZ002.A0101_2.YP2.1	1739303	1739397		YPO_RS08625	94
GLZ002.A0101_2.YP2.1	1763883	1763886		hisD	3
GLZ002.A0101_2.YP2.1	1781297	1781298		YPO_RS08800	1
GLZ002.A0101_2.YP2.1	1785925	1785950		YPO_RS08815	25
GLZ002.A0101_2.YP2.1	1791856	1791857		YPO_RS08840	1
GLZ002.A0101_2.YP2.1	1795901	1795970		YPO_RS08855	69
GLZ002.A0101_2.YP2.1	1796135	1796146		YPO_RS08855	11
GLZ002.A0101_2.YP2.1	1808283	1808330		bssS	47
GLZ002.A0101_2.YP2.1	1832779	1832785		ptsG	6
GLZ002.A0101_2.YP2.1	1835940	1835959		YPO_RS09055	19
GLZ002.A0101_2.YP2.1	1837747	1837767		nagZ	20
GLZ002.A0101_2.YP2.1	1839816	1839821		YPO_RS09080	5
GLZ002.A0101_2.YP2.1	1842251	1842264		YPO_RS09090	13
GLZ002.A0101_2.YP2.1	1878305	1878350		YPO_RS09250	45
GLZ002.A0101_2.YP2.1	1899967	1899968		YPO_RS09320	1
GLZ002.A0101_2.YP2.1	1904870	1904872		yapJ	2
GLZ002.A0101_2.YP2.1	1907147	1907165		YPO_RS09345	18
GLZ002.A0101_2.YP2.1	1918291	1918309		YPO_RS09385	18
GLZ002.A0101_2.YP2.1	1919043	1919054		YPO_RS09385	11
GLZ002.A0101_2.YP2.1	1921262	1921276		YPO_RS09390	14
GLZ002.A0101_2.YP2.1	1922897	1922900		YPO_RS09400	3
GLZ002.A0101_2.YP2.1	1928287	1928289		YPO_RS09425	2
GLZ002.A0101_2.YP2.1	1932626	1932630		YPO_RS09450	4
GLZ002.A0101_2.YP2.1	1933377	1933404		YPO_RS09455	27
GLZ002.A0101_2.YP2.1	1933848	1933872		YPO_RS09455	24
GLZ002.A0101_2.YP2.1	1934366	1934367		YPO_RS09455	1
GLZ002.A0101_2.YP2.1	1936649	1936661		YPO_RS09460	12
GLZ002.A0101_2.YP2.1	1937820	1937829		YPO_RS09475	9
GLZ002.A0101_2.YP2.1	1938133	1938136		YPO_RS09475	3
GLZ002.A0101_2.YP2.1	1938337	1938374		YPO_RS09475	37
GLZ002.A0101_2.YP2.1	1943992	1943996		proQ	4
GLZ002.A0101_2.YP2.1	1949083	1949095		YPO_RS09515	12
GLZ002.A0101_2.YP2.1	1959948	1959949		YPO_RS09555	1
GLZ002.A0101_2.YP2.1	1962653	1962657		YPO_RS09565	4
GLZ002.A0101_2.YP2.1	1963161	1963167		YPO_RS09565	6
GLZ002.A0101_2.YP2.1	1967710	1967717		YPO_RS09585	7
GLZ002.A0101_2.YP2.1	1987791	1987805		YPO_RS09705	14
GLZ002.A0101_2.YP2.1	1992205	1992219		YPO_RS09730	14
GLZ002.A0101_2.YP2.1	1999861	1999879		mntP	18
GLZ002.A0101_2.YP2.1	2000335	2000368		YPO_RS09760	33
GLZ002.A0101_2.YP2.1	2015679	2015689		hpaB	10
GLZ002.A0101_2.YP2.1	2018949	2018956		YPO_RS09845	7
GLZ002.A0101_2.YP2.1	2020788	2020791		YPO_RS09855	3
GLZ002.A0101_2.YP2.1	2034420	2034437		flhB	17
GLZ002.A0101_2.YP2.1	2045643	2045650		flgD	7
GLZ002.A0101_2.YP2.1	2050019	2050022		YPO_RS10010	3
GLZ002.A0101_2.YP2.1	2070450	2070460		YPO_RS10110	10
GLZ002.A0101_2.YP2.1	2080250	2080257		YPO_RS10165	7
GLZ002.A0101_2.YP2.1	2080753	2080754		YPO_RS10170	1
GLZ002.A0101_2.YP2.1	2085726	2085738		fliD	12
GLZ002.A0101_2.YP2.1	2099151	2099163		YPO_RS10245	12
GLZ002.A0101_2.YP2.1	2109799	2109820		YPO_RS10290	21
GLZ002.A0101_2.YP2.1	2113609	2113626		uvrC	17
GLZ002.A0101_2.YP2.1	2117604	2117607		YPO_RS10355	3
GLZ002.A0101_2.YP2.1	2117718	2117786		YPO_RS10355	68
GLZ002.A0101_2.YP2.1	2118082	2118094		hcp	12
GLZ002.A0101_2.YP2.1	2118330	2118347		hcp	17
GLZ002.A0101_2.YP2.1	2124142	2124161		YPO_RS10405	19
GLZ002.A0101_2.YP2.1	2126372	2126416		YPO_RS10415	44
GLZ002.A0101_2.YP2.1	2126548	2126552		YPO_RS10415	4
GLZ002.A0101_2.YP2.1	2126755	2126798		YPO_RS10420	43
GLZ002.A0101_2.YP2.1	2135591	2135597		YPO_RS10475	6
GLZ002.A0101_2.YP2.1	2145542	2145558		ybtU	16
GLZ002.A0101_2.YP2.1	2145631	2145649		ybtU	18
GLZ002.A0101_2.YP2.1	2146053	2146054		ybtU	1
GLZ002.A0101_2.YP2.1	2148522	2148524		irp1	2
GLZ002.A0101_2.YP2.1	2148874	2148881		irp1	7
GLZ002.A0101_2.YP2.1	2152633	2152652		irp1	19
GLZ002.A0101_2.YP2.1	2159336	2159347		irp2	11
GLZ002.A0101_2.YP2.1	2164461	2164478		ybtP	17
GLZ002.A0101_2.YP2.1	2165506	2165508		ybtQ	2
GLZ002.A0101_2.YP2.1	2167198	2167199		ybtX	1
GLZ002.A0101_2.YP2.1	2172679	2172681		YPO_RS10585	2
GLZ002.A0101_2.YP2.1	2182012	2182017		YPO_RS10615	5
GLZ002.A0101_2.YP2.1	2187769	2187770		YPO_RS10640	1
GLZ002.A0101_2.YP2.1	2218049	2218059		YPO_RS10760	10
GLZ002.A0101_2.YP2.1	2220327	2220329		YPO_RS10770	2
GLZ002.A0101_2.YP2.1	2226201	2226205		YPO_RS10795	4
GLZ002.A0101_2.YP2.1	2226601	2226624		YPO_RS10800	23
GLZ002.A0101_2.YP2.1	2237355	2237376		YPO_RS10835	21
GLZ002.A0101_2.YP2.1	2242254	2242256		YPO_RS10865	2
GLZ002.A0101_2.YP2.1	2253370	2253387		YPO_RS10910	17
GLZ002.A0101_2.YP2.1	2256126	2256184		YPO_RS10925	58
GLZ002.A0101_2.YP2.1	2258636	2258637		YPO_RS10935	1
GLZ002.A0101_2.YP2.1	2258981	2258985		YPO_RS10935	4
GLZ002.A0101_2.YP2.1	2259221	2259227		YPO_RS10935	6
GLZ002.A0101_2.YP2.1	2259851	2259909		YPO_RS10935	58
GLZ002.A0101_2.YP2.1	2260128	2260134		YPO_RS10935	6
GLZ002.A0101_2.YP2.1	2263288	2263304		YPO_RS10940	16
GLZ002.A0101_2.YP2.1	2268559	2268569		YPO_RS10975	10
GLZ002.A0101_2.YP2.1	2268861	2268881		YPO_RS10975	20
GLZ002.A0101_2.YP2.1	2269867	2269869		YPO_RS10980	2
GLZ002.A0101_2.YP2.1	2277249	2277308		YPO_RS11015	59
GLZ002.A0101_2.YP2.1	2280756	2280768		YPO_RS11035	12
GLZ002.A0101_2.YP2.1	2291029	2291036		prmC	7
GLZ002.A0101_2.YP2.1	2299490	2299498		YPO_RS11135	8
GLZ002.A0101_2.YP2.1	2316441	2316493		YPO_RS11220	52
GLZ002.A0101_2.YP2.1	2318132	2318161		YPO_RS11225	29
GLZ002.A0101_2.YP2.1	2319537	2319566		YPO_RS11225	29
GLZ002.A0101_2.YP2.1	2319794	2319800		YPO_RS11225	6
GLZ002.A0101_2.YP2.1	2322110	2322133		YPO_RS11225	23
GLZ002.A0101_2.YP2.1	2322815	2322821		YPO_RS11225	6
GLZ002.A0101_2.YP2.1	2375655	2375656		YPO_RS11510	1
GLZ002.A0101_2.YP2.1	2396161	2396212		YPO_RS11640	51
GLZ002.A0101_2.YP2.1	2400839	2400844		YPO_RS11665	5
GLZ002.A0101_2.YP2.1	2403299	2403300		YPO_RS11680	1
GLZ002.A0101_2.YP2.1	2439613	2439616		YPO_RS11830	3
GLZ002.A0101_2.YP2.1	2439738	2439778		YPO_RS11830	40
GLZ002.A0101_2.YP2.1	2439891	2439952		YPO_RS11830	61
GLZ002.A0101_2.YP2.1	2440011	2440014		YPO_RS11830	3
GLZ002.A0101_2.YP2.1	2440151	2440228		YPO_RS11830	77
GLZ002.A0101_2.YP2.1	2440671	2440678		YPO_RS11840	7
GLZ002.A0101_2.YP2.1	2440707	2440721		YPO_RS11840	14
GLZ002.A0101_2.YP2.1	2442369	2442379		purU	10
GLZ002.A0101_2.YP2.1	2442606	2442610		purU	4
GLZ002.A0101_2.YP2.1	2445717	2445719		rssB	2
GLZ002.A0101_2.YP2.1	2453777	2453789		adhE	12
GLZ002.A0101_2.YP2.1	2455052	2455071		adhE	19
GLZ002.A0101_2.YP2.1	2458447	2458459		oppA	12
GLZ002.A0101_2.YP2.1	2463709	2463769		YPO_RS11930	60
GLZ002.A0101_2.YP2.1	2465294	2465315		cls	21
GLZ002.A0101_2.YP2.1	2468035	2468038		YPO_RS11955	3
GLZ002.A0101_2.YP2.1	2475834	2475869		YPO_RS12005	35
GLZ002.A0101_2.YP2.1	2489401	2489436		sohB	35
GLZ002.A0101_2.YP2.1	2490354	2490366		YPO_RS12085	12
GLZ002.A0101_2.YP2.1	2491166	2491209		topA	43
GLZ002.A0101_2.YP2.1	2495434	2495477		YPO_RS12105	43
GLZ002.A0101_2.YP2.1	2495906	2495946		YPO_RS12105	40
GLZ002.A0101_2.YP2.1	2496069	2496090		YPO_RS12105	21
GLZ002.A0101_2.YP2.1	2498680	2498689		acnA	9
GLZ002.A0101_2.YP2.1	2503065	2503079		YPO_RS12135	14
GLZ002.A0101_2.YP2.1	2513254	2513256		YPO_RS12185	2
GLZ002.A0101_2.YP2.1	2514627	2514646		YPO_RS12190	19
GLZ002.A0101_2.YP2.1	2519275	2519321		YPO_RS12215	46
GLZ002.A0101_2.YP2.1	2541472	2541474		YPO_RS12300	2
GLZ002.A0101_2.YP2.1	2547282	2547299		YPO_RS12320	17
GLZ002.A0101_2.YP2.1	2548325	2548336		YPO_RS12325	11
GLZ002.A0101_2.YP2.1	2551668	2551670		YPO_RS12340	2
GLZ002.A0101_2.YP2.1	2554373	2554633		YPO_RS12355	260
GLZ002.A0101_2.YP2.1	2554658	2555065		YPO_RS12360	407
GLZ002.A0101_2.YP2.1	2555162	2555608		YPO_RS12365	446
GLZ002.A0101_2.YP2.1	2555780	2556832		YPO_RS12370	1052
GLZ002.A0101_2.YP2.1	2556844	2557161		YPO_RS12375	317
GLZ002.A0101_2.YP2.1	2557164	2557415		YPO_RS12380	251
GLZ002.A0101_2.YP2.1	2557451	2557684		YPO_RS12385	233
GLZ002.A0101_2.YP2.1	2557749	2559461		YPO_RS12390	1712
GLZ002.A0101_2.YP2.1	2559474	2559761		YPO_RS12395	287
GLZ002.A0101_2.YP2.1	2559765	2560790		YPO_RS12400	1025
GLZ002.A0101_2.YP2.1	2560790	2562034		YPO_RS12405	1244
GLZ002.A0101_2.YP2.1	2562167	2562371		YPO_RS12410	204
GLZ002.A0101_2.YP2.1	2562123	2562143		YPO_RS12410	20
GLZ002.A0101_2.YP2.1	2562568	2562765		YPO_RS12415	197
GLZ002.A0101_2.YP2.1	2565808	2565865		YPO_RS12435	57
GLZ002.A0101_2.YP2.1	2567653	2567664		YPO_RS12440	11
GLZ002.A0101_2.YP2.1	2577753	2577804		YPO_RS12465	51
GLZ002.A0101_2.YP2.1	2582811	2582821		YPO_RS12495	10
GLZ002.A0101_2.YP2.1	2582955	2582983		YPO_RS12495	28
GLZ002.A0101_2.YP2.1	2587467	2587468		uspE	1
GLZ002.A0101_2.YP2.1	2593877	2593893		YPO_RS12535	16
GLZ002.A0101_2.YP2.1	2606357	2606399		asr	42
GLZ002.A0101_2.YP2.1	2609374	2609375		hrpA	1
GLZ002.A0101_2.YP2.1	2628057	2628058		ttcA	1
GLZ002.A0101_2.YP2.1	2628354	2628371		ttcA	17
GLZ002.A0101_2.YP2.1	2630107	2630147		YPO_RS12680	40
GLZ002.A0101_2.YP2.1	2630640	2630647		YPO_RS12680	7
GLZ002.A0101_2.YP2.1	2640270	2640282		YPO_RS12725	12
GLZ002.A0101_2.YP2.1	2640505	2640516		YPO_RS12725	11
GLZ002.A0101_2.YP2.1	2666674	2666688		rovA	14
GLZ002.A0101_2.YP2.1	2673322	2673342		YPO_RS12890	20
GLZ002.A0101_2.YP2.1	2687101	2687103		YPO_RS12955	2
GLZ002.A0101_2.YP2.1	2687492	2687494		YPO_RS12960	2
GLZ002.A0101_2.YP2.1	2691417	2691424		YPO_RS12980	7
GLZ002.A0101_2.YP2.1	2694634	2694636		YPO_RS13000	2
GLZ002.A0101_2.YP2.1	2718598	2718608		arnT	10
GLZ002.A0101_2.YP2.1	2723274	2723284		arnB	10
GLZ002.A0101_2.YP2.1	2724343	2724395		btuD	52
GLZ002.A0101_2.YP2.1	2727410	2727442		YPO_RS13140	32
GLZ002.A0101_2.YP2.1	2737729	2737746		YPO_RS13195	17
GLZ002.A0101_2.YP2.1	2749101	2749126		YPO_RS13255	25
GLZ002.A0101_2.YP2.1	2754180	2754194		YPO_RS13285	14
GLZ002.A0101_2.YP2.1	2755024	2755035		YPO_RS13290	11
GLZ002.A0101_2.YP2.1	2755171	2755180		YPO_RS13290	9
GLZ002.A0101_2.YP2.1	2755444	2755505		YPO_RS13290	61
GLZ002.A0101_2.YP2.1	2774383	2774387		YPO_RS13360	4
GLZ002.A0101_2.YP2.1	2775483	2775494		YPO_RS13370	11
GLZ002.A0101_2.YP2.1	2784887	2784899		YPO_RS13410	12
GLZ002.A0101_2.YP2.1	2785302	2785303		YPO_RS13415	1
GLZ002.A0101_2.YP2.1	2786227	2786232		YPO_RS13425	5
GLZ002.A0101_2.YP2.1	2788768	2788801		YPO_RS13435	33
GLZ002.A0101_2.YP2.1	2789809	2789816		YPO_RS13445	7
GLZ002.A0101_2.YP2.1	2792623	2792644		cdiA	21
GLZ002.A0101_2.YP2.1	2795213	2795224		cdiA	11
GLZ002.A0101_2.YP2.1	2801764	2801772		YPO_RS13465	8
GLZ002.A0101_2.YP2.1	2802552	2802562		YPO_RS13470	10
GLZ002.A0101_2.YP2.1	2807621	2807623		YPO_RS13485	2
GLZ002.A0101_2.YP2.1	2807952	2807966		YPO_RS13485	14
GLZ002.A0101_2.YP2.1	2813931	2813969		YPO_RS13510	38
GLZ002.A0101_2.YP2.1	2814094	2814152		YPO_RS13510	58
GLZ002.A0101_2.YP2.1	2821143	2821179		YPO_RS13550	36
GLZ002.A0101_2.YP2.1	2830463	2830482		YPO_RS13595	19
GLZ002.A0101_2.YP2.1	2831200	2831227		ybiB	27
GLZ002.A0101_2.YP2.1	2833243	2833248		menE	5
GLZ002.A0101_2.YP2.1	2833790	2833791		menC	1
GLZ002.A0101_2.YP2.1	2845770	2845793		YPO_RS13655	23
GLZ002.A0101_2.YP2.1	2853929	2853934		YPO_RS13690	5
GLZ002.A0101_2.YP2.1	2854054	2854068		YPO_RS13690	14
GLZ002.A0101_2.YP2.1	2854203	2854233		YPO_RS13690	30
GLZ002.A0101_2.YP2.1	2854295	2854328		YPO_RS13690	33
GLZ002.A0101_2.YP2.1	2854666	2854722		YPO_RS13690	56
GLZ002.A0101_2.YP2.1	2854802	2854807		YPO_RS13690	5
GLZ002.A0101_2.YP2.1	2857553	2857567		nuoM	14
GLZ002.A0101_2.YP2.1	2860033	2860035		nuoK	2
GLZ002.A0101_2.YP2.1	2871691	2871700		lrhA	9
GLZ002.A0101_2.YP2.1	2885548	2885558		YPO_RS13815	10
GLZ002.A0101_2.YP2.1	2885771	2885781		YPO_RS13815	10
GLZ002.A0101_2.YP2.1	2887082	2887085		YPO_RS13825	3
GLZ002.A0101_2.YP2.1	2910228	2910290		iolB	62
GLZ002.A0101_2.YP2.1	2914210	2914213		YPO_RS13920	3
GLZ002.A0101_2.YP2.1	2914581	2914582		YPO_RS13920	1
GLZ002.A0101_2.YP2.1	2954920	2954937		YPO_RS14120	17
GLZ002.A0101_2.YP2.1	2980429	2980579		YPO_RS14235	150
GLZ002.A0101_2.YP2.1	2987752	2987755		YPO_RS14270	3
GLZ002.A0101_2.YP2.1	2999232	2999269		YPO_RS14330	37
GLZ002.A0101_2.YP2.1	2999787	2999806		YPO_RS14330	19
GLZ002.A0101_2.YP2.1	3000175	3000182		hdeB	7
GLZ002.A0101_2.YP2.1	3002950	3002951		crcB	1
GLZ002.A0101_2.YP2.1	3003145	3003157		YPO_RS14355	12
GLZ002.A0101_2.YP2.1	3004085	3004086		YPO_RS14360	1
GLZ002.A0101_2.YP2.1	3010737	3010758		pgm	21
GLZ002.A0101_2.YP2.1	3012178	3012220		YPO_RS14405	42
GLZ002.A0101_2.YP2.1	3014526	3014528		kdbD	2
GLZ002.A0101_2.YP2.1	3021098	3021172		YPO_RS14440	74
GLZ002.A0101_2.YP2.1	3022482	3022490		YPO_RS14450	8
GLZ002.A0101_2.YP2.1	3024035	3024045		phrB	10
GLZ002.A0101_2.YP2.1	3026152	3026160		YPO_RS14470	8
GLZ002.A0101_2.YP2.1	3031189	3031217		pcp	28
GLZ002.A0101_2.YP2.1	3042217	3042235		YPO_RS14560	18
GLZ002.A0101_2.YP2.1	3042366	3042376		YPO_RS14560	10
GLZ002.A0101_2.YP2.1	3042581	3042617		YPO_RS14560	36
GLZ002.A0101_2.YP2.1	3045717	3045724		lepB	7
GLZ002.A0101_2.YP2.1	3049052	3049057		YPO_RS14590	5
GLZ002.A0101_2.YP2.1	3056200	3056201		YPO_RS14610	1
GLZ002.A0101_2.YP2.1	3065868	3065872		YPO_RS14660	4
GLZ002.A0101_2.YP2.1	3093504	3093505		YPO_RS14790	1
GLZ002.A0101_2.YP2.1	3110764	3110769		YPO_RS14875	5
GLZ002.A0101_2.YP2.1	3121234	3121280		YPO_RS14925	46
GLZ002.A0101_2.YP2.1	3123089	3123098		YPO_RS14935	9
GLZ002.A0101_2.YP2.1	3123201	3123214		YPO_RS14940	13
GLZ002.A0101_2.YP2.1	3123929	3123977		YPO_RS14945	48
GLZ002.A0101_2.YP2.1	3127210	3127211		YPO_RS14960	1
GLZ002.A0101_2.YP2.1	3142969	3142971		YPO_RS15025	2
GLZ002.A0101_2.YP2.1	3143376	3143388		YPO_RS15030	12
GLZ002.A0101_2.YP2.1	3144879	3144904		YPO_RS15040	25
GLZ002.A0101_2.YP2.1	3145277	3145283		YPO_RS15040	6
GLZ002.A0101_2.YP2.1	3151676	3151700		YPO_RS15090	24
GLZ002.A0101_2.YP2.1	3197810	3197820		YPO_RS15265	10
GLZ002.A0101_2.YP2.1	3197859	3197879		YPO_RS15265	20
GLZ002.A0101_2.YP2.1	3198228	3198238		YPO_RS15270	10
GLZ002.A0101_2.YP2.1	3200382	3200425		YPO_RS15285	43
GLZ002.A0101_2.YP2.1	3200485	3200489		YPO_RS15285	4
GLZ002.A0101_2.YP2.1	3200576	3200587		YPO_RS15285	11
GLZ002.A0101_2.YP2.1	3200683	3200771		YPO_RS15290	88
GLZ002.A0101_2.YP2.1	3200822	3200885		YPO_RS15290	63
GLZ002.A0101_2.YP2.1	3200929	3200950		YPO_RS15290	21
GLZ002.A0101_2.YP2.1	3201035	3201046		YPO_RS15290	11
GLZ002.A0101_2.YP2.1	3201306	3201339		YPO_RS15295	33
GLZ002.A0101_2.YP2.1	3201567	3201654		YPO_RS15300	87
GLZ002.A0101_2.YP2.1	3201757	3201796		YPO_RS15300	39
GLZ002.A0101_2.YP2.1	3201942	3201965		YPO_RS15300	23
GLZ002.A0101_2.YP2.1	3202207	3202262		YPO_RS15305	55
GLZ002.A0101_2.YP2.1	3221767	3221829		YPO_RS15385	62
GLZ002.A0101_2.YP2.1	3221974	3221979		YPO_RS15385	5
GLZ002.A0101_2.YP2.1	3222343	3222351		YPO_RS15385	8
GLZ002.A0101_2.YP2.1	3223950	3223986		yapA	36
GLZ002.A0101_2.YP2.1	3228569	3228572		YPO_RS15395	3
GLZ002.A0101_2.YP2.1	3231855	3231862		YPO_RS15405	7
GLZ002.A0101_2.YP2.1	3235426	3235439		hscA	13
GLZ002.A0101_2.YP2.1	3236848	3236855		hscA	7
GLZ002.A0101_2.YP2.1	3260321	3260328		YPO_RS15550	7
GLZ002.A0101_2.YP2.1	3262449	3262462		YPO_RS15560	13
GLZ002.A0101_2.YP2.1	3262687	3262693		YPO_RS15560	6
GLZ002.A0101_2.YP2.1	3262762	3262781		YPO_RS15560	19
GLZ002.A0101_2.YP2.1	3262871	3262898		YPO_RS15560	27
GLZ002.A0101_2.YP2.1	3265837	3265848		purL	11
GLZ002.A0101_2.YP2.1	3280149	3280150		YPO_RS15645	1
GLZ002.A0101_2.YP2.1	3282627	3282660		tssB	33
GLZ002.A0101_2.YP2.1	3282765	3282777		YPO_RS15660	12
GLZ002.A0101_2.YP2.1	3284499	3284513		YPO_RS15665	14
GLZ002.A0101_2.YP2.1	3285815	3285819		YPO_RS15675	4
GLZ002.A0101_2.YP2.1	3287229	3287257		YPO_RS15675	28
GLZ002.A0101_2.YP2.1	3287481	3287493		YPO_RS15680	12
GLZ002.A0101_2.YP2.1	3288407	3288410		YPO_RS15685	3
GLZ002.A0101_2.YP2.1	3299230	3299241		YPO_RS15720	11
GLZ002.A0101_2.YP2.1	3302795	3302831		YPO_RS15735	36
GLZ002.A0101_2.YP2.1	3310669	3310670		YPO_RS15765	1
GLZ002.A0101_2.YP2.1	3311448	3311470		YPO_RS15770	22
GLZ002.A0101_2.YP2.1	3315995	3316009		YPO_RS15785	14
GLZ002.A0101_2.YP2.1	3320244	3320272		YPO_RS15810	28
GLZ002.A0101_2.YP2.1	3335906	3335908		YPO_RS15910	2
GLZ002.A0101_2.YP2.1	3353969	3353975		YPO_RS15995	6
GLZ002.A0101_2.YP2.1	3355110	3355140		YPO_RS16000	30
GLZ002.A0101_2.YP2.1	3355421	3355470		YPO_RS16000	49
GLZ002.A0101_2.YP2.1	3355707	3355735		YPO_RS16000	28
GLZ002.A0101_2.YP2.1	3355895	3355908		YPO_RS16005	13
GLZ002.A0101_2.YP2.1	3356083	3356091		YPO_RS16010	8
GLZ002.A0101_2.YP2.1	3357920	3357922		YPO_RS16020	2
GLZ002.A0101_2.YP2.1	3361576	3361581		YPO_RS16030	5
GLZ002.A0101_2.YP2.1	3364209	3364230		YPO_RS16040	21
GLZ002.A0101_2.YP2.1	3364275	3364281		YPO_RS16040	6
GLZ002.A0101_2.YP2.1	3364691	3364737		YPO_RS16040	46
GLZ002.A0101_2.YP2.1	3371408	3371419		YPO_RS16070	11
GLZ002.A0101_2.YP2.1	3372704	3372721		YPO_RS16075	17
GLZ002.A0101_2.YP2.1	3372770	3372792		YPO_RS16075	22
GLZ002.A0101_2.YP2.1	3376381	3376384		YPO_RS16095	3
GLZ002.A0101_2.YP2.1	3383539	3383548		YPO_RS16125	9
GLZ002.A0101_2.YP2.1	3383593	3383594		YPO_RS16125	1
GLZ002.A0101_2.YP2.1	3383671	3383691		YPO_RS16125	20
GLZ002.A0101_2.YP2.1	3383834	3383879		YPO_RS16125	45
GLZ002.A0101_2.YP2.1	3389642	3389656		nudK	14
GLZ002.A0101_2.YP2.1	3393383	3393385		napA	2
GLZ002.A0101_2.YP2.1	3395751	3395759		YPO_RS16180	8
GLZ002.A0101_2.YP2.1	3403402	3403413		YPO_RS16210	11
GLZ002.A0101_2.YP2.1	3432119	3432135		purE	16
GLZ002.A0101_2.YP2.1	3453999	3454024		fepE	25
GLZ002.A0101_2.YP2.1	3454807	3454880		fepE	73
GLZ002.A0101_2.YP2.1	3455886	3455949		cpsG	63
GLZ002.A0101_2.YP2.1	3456552	3456594		YPO_RS16450	42
GLZ002.A0101_2.YP2.1	3457112	3457130		YPO_RS16450	18
GLZ002.A0101_2.YP2.1	3457632	3457673		YPO_RS16455	41
GLZ002.A0101_2.YP2.1	3460855	3460874		YPO_RS16470	19
GLZ002.A0101_2.YP2.1	3461638	3461663		YPO_RS16470	25
GLZ002.A0101_2.YP2.1	3461829	3461834		YPO_RS16470	5
GLZ002.A0101_2.YP2.1	3463321	3463344		YPO_RS16480	23
GLZ002.A0101_2.YP2.1	3463454	3463480		YPO_RS16480	26
GLZ002.A0101_2.YP2.1	3463719	3463819		YPO_RS16480	100
GLZ002.A0101_2.YP2.1	3463897	3463970		YPO_RS16480	73
GLZ002.A0101_2.YP2.1	3464127	3464205		YPO_RS16480	78
GLZ002.A0101_2.YP2.1	3464843	3464873		YPO_RS16485	30
GLZ002.A0101_2.YP2.1	3465043	3465111		YPO_RS16485	68
GLZ002.A0101_2.YP2.1	3465221	3465229		YPO_RS16485	8
GLZ002.A0101_2.YP2.1	3465326	3465329		YPO_RS16485	3
GLZ002.A0101_2.YP2.1	3465419	3465430		YPO_RS16485	11
GLZ002.A0101_2.YP2.1	3465481	3465556		YPO_RS16485	75
GLZ002.A0101_2.YP2.1	3465567	3465609		YPO_RS16490	42
GLZ002.A0101_2.YP2.1	3466021	3466046		YPO_RS16490	25
GLZ002.A0101_2.YP2.1	3466247	3466406		YPO_RS16490	159
GLZ002.A0101_2.YP2.1	3466589	3466667		YPO_RS16490	78
GLZ002.A0101_2.YP2.1	3466984	3467014		YPO_RS16495	30
GLZ002.A0101_2.YP2.1	3467574	3467604		YPO_RS16495	30
GLZ002.A0101_2.YP2.1	3467962	3467990		YPO_RS16495	28
GLZ002.A0101_2.YP2.1	3468056	3468066		YPO_RS16495	10
GLZ002.A0101_2.YP2.1	3468687	3468703		YPO_RS16500	16
GLZ002.A0101_2.YP2.1	3468846	3468853		YPO_RS16500	7
GLZ002.A0101_2.YP2.1	3470493	3470514		rfbG	21
GLZ002.A0101_2.YP2.1	3472630	3472632		YPO_RS16520	2
GLZ002.A0101_2.YP2.1	3473071	3473121		YPO_RS16520	50
GLZ002.A0101_2.YP2.1	3473984	3474003		hemH	19
GLZ002.A0101_2.YP2.1	3492814	3492816		YPO_RS16605	2
GLZ002.A0101_2.YP2.1	3496953	3496958		YPO_RS16620	5
GLZ002.A0101_2.YP2.1	3497072	3497077		YPO_RS16620	5
GLZ002.A0101_2.YP2.1	3527241	3527267		YPO_RS16755	26
GLZ002.A0101_2.YP2.1	3534266	3534274		YPO_RS16785	8
GLZ002.A0101_2.YP2.1	3545411	3545422		ribD	11
GLZ002.A0101_2.YP2.1	3547449	3547529		YPO_RS16860	80
GLZ002.A0101_2.YP2.1	3548036	3548213		YPO_RS16865	177
GLZ002.A0101_2.YP2.1	3552010	3552026		secD	16
GLZ002.A0101_2.YP2.1	3560385	3560429		YPO_RS16925	44
GLZ002.A0101_2.YP2.1	3572072	3572109		YPO_RS16965	37
GLZ002.A0101_2.YP2.1	3582249	3582257		YPO_RS17005	8
GLZ002.A0101_2.YP2.1	3589920	3589923		YPO_RS17045	3
GLZ002.A0101_2.YP2.1	3590106	3590128		YPO_RS17045	22
GLZ002.A0101_2.YP2.1	3592490	3592524		YPO_RS17055	34
GLZ002.A0101_2.YP2.1	3592591	3592606		YPO_RS17055	15
GLZ002.A0101_2.YP2.1	3592648	3592656		YPO_RS17055	8
GLZ002.A0101_2.YP2.1	3592909	3592913		YPO_RS17055	4
GLZ002.A0101_2.YP2.1	3593082	3593090		YPO_RS17055	8
GLZ002.A0101_2.YP2.1	3598997	3598999		YPO_RS17070	2
GLZ002.A0101_2.YP2.1	3607047	3607054		YPO_RS17115	7
GLZ002.A0101_2.YP2.1	3617571	3617588		YPO_RS17145	17
GLZ002.A0101_2.YP2.1	3617947	3617952		YPO_RS17145	5
GLZ002.A0101_2.YP2.1	3618889	3618907		YPO_RS17145	18
GLZ002.A0101_2.YP2.1	3619215	3619222		YPO_RS17145	7
GLZ002.A0101_2.YP2.1	3647315	3647325		pssA	10
GLZ002.A0101_2.YP2.1	3649933	3649936		YPO_RS17290	3
GLZ002.A0101_2.YP2.1	3652340	3652341		YPO_RS17295	1
GLZ002.A0101_2.YP2.1	3665930	3665939		tyrA	9
GLZ002.A0101_2.YP2.1	3672560	3672561		trmD	1
GLZ002.A0101_2.YP2.1	3702739	3702745		katG	6
GLZ002.A0101_2.YP2.1	3706045	3706050		dmsD	5
GLZ002.A0101_2.YP2.1	3725760	3725778		YPO_RS17650	18
GLZ002.A0101_2.YP2.1	3728638	3728660		YPO_RS17660	22
GLZ002.A0101_2.YP2.1	3731799	3731802		YPO_RS17675	3
GLZ002.A0101_2.YP2.1	3745132	3745133		rpoS	1
GLZ002.A0101_2.YP2.1	3746857	3746858		YPO_RS17740	1
GLZ002.A0101_2.YP2.1	3758312	3758326		cysI	14
GLZ002.A0101_2.YP2.1	3759110	3759120		cysI	10
GLZ002.A0101_2.YP2.1	3761351	3761362		cysJ	11
GLZ002.A0101_2.YP2.1	3773761	3773793		barA	32
GLZ002.A0101_2.YP2.1	3784517	3784527		fhuB	10
GLZ002.A0101_2.YP2.1	3789342	3789343		mrcB	1
GLZ002.A0101_2.YP2.1	3812287	3812294		YPO_RS18035	7
GLZ002.A0101_2.YP2.1	3830248	3830253		gspE	5
GLZ002.A0101_2.YP2.1	3879642	3879672		YPO_RS18330	30
GLZ002.A0101_2.YP2.1	3903567	3903572		truB	5
GLZ002.A0101_2.YP2.1	3906361	3906387		infB	26
GLZ002.A0101_2.YP2.1	3911579	3911582		folP	3
GLZ002.A0101_2.YP2.1	3919378	3919384		cgtA	6
GLZ002.A0101_2.YP2.1	3949231	3949249		rpsF	18
GLZ002.A0101_2.YP2.1	3949709	3949734		yjfP	25
GLZ002.A0101_2.YP2.1	3962033	3962046		elbB	13
GLZ002.A0101_2.YP2.1	3968466	3968469		gltB	3
GLZ002.A0101_2.YP2.1	3975594	3975596		YPO_RS18775	2
GLZ002.A0101_2.YP2.1	3994747	3994762		ptsN	15
GLZ002.A0101_2.YP2.1	4011526	4011532		tssA	6
GLZ002.A0101_2.YP2.1	4025040	4025049		YPO_RS19025	9
GLZ002.A0101_2.YP2.1	4033307	4033312		YPO_RS19055	5
GLZ002.A0101_2.YP2.1	4033574	4033587		YPO_RS19055	13
GLZ002.A0101_2.YP2.1	4033596	4033613		YPO_RS19060	17
GLZ002.A0101_2.YP2.1	4033659	4033694		YPO_RS19060	35
GLZ002.A0101_2.YP2.1	4033786	4033803		YPO_RS19060	17
GLZ002.A0101_2.YP2.1	4033914	4033966		YPO_RS19060	52
GLZ002.A0101_2.YP2.1	4034665	4034679		YPO_RS19065	14
GLZ002.A0101_2.YP2.1	4043084	4043099		ssuD	15
GLZ002.A0101_2.YP2.1	4062929	4062931		YPO_RS19195	2
GLZ002.A0101_2.YP2.1	4065293	4065295		cspA	2
GLZ002.A0101_2.YP2.1	4091489	4091492		rng	3
GLZ002.A0101_2.YP2.1	4098633	4098664		YPO_RS19365	31
GLZ002.A0101_2.YP2.1	4098842	4098870		YPO_RS19365	28
GLZ002.A0101_2.YP2.1	4098948	4099021		YPO_RS19365	73
GLZ002.A0101_2.YP2.1	4099417	4099461		YPO_RS19365	44
GLZ002.A0101_2.YP2.1	4101527	4101529		YPO_RS19370	2
GLZ002.A0101_2.YP2.1	4101630	4101699		YPO_RS19370	69
GLZ002.A0101_2.YP2.1	4101868	4101902		YPO_RS19370	34
GLZ002.A0101_2.YP2.1	4104590	4104607		YPO_RS19375	17
GLZ002.A0101_2.YP2.1	4112308	4112324		YPO_RS19395	16
GLZ002.A0101_2.YP2.1	4112694	4112789		YPO_RS19400	95
GLZ002.A0101_2.YP2.1	4113216	4113220		YPO_RS19400	4
GLZ002.A0101_2.YP2.1	4113992	4114048		YPO_RS19405	56
GLZ002.A0101_2.YP2.1	4114199	4114232		YPO_RS19405	33
GLZ002.A0101_2.YP2.1	4115221	4115229		YPO_RS19405	8
GLZ002.A0101_2.YP2.1	4116762	4116833		YPO_RS19410	71
GLZ002.A0101_2.YP2.1	4117271	4117294		YPO_RS19410	23
GLZ002.A0101_2.YP2.1	4117502	4117528		YPO_RS19410	26
GLZ002.A0101_2.YP2.1	4134305	4134314		YPO_RS19490	9
GLZ002.A0101_2.YP2.1	4142754	4142797		YPO_RS19535	43
GLZ002.A0101_2.YP2.1	4155787	4155789		lysC	2
GLZ002.A0101_2.YP2.1	4156662	4156666		YPO_RS19590	4
GLZ002.A0101_2.YP2.1	4158684	4158691		YPO_RS19595	7
GLZ002.A0101_2.YP2.1	4176218	4176220		YPO_RS19645	2
GLZ002.A0101_2.YP2.1	4178618	4178627		YPO_RS19650	9
GLZ002.A0101_2.YP2.1	4188314	4188318		YPO_RS19705	4
GLZ002.A0101_2.YP2.1	4188587	4188615		YPO_RS19705	28
GLZ002.A0101_2.YP2.1	4192452	4192454		thiC	2
GLZ002.A0101_2.YP2.1	4206203	4206233		rplL	30
GLZ002.A0101_2.YP2.1	4216761	4216764		murB	3
GLZ002.A0101_2.YP2.1	4223143	4223147		YPO_RS19870	4
GLZ002.A0101_2.YP2.1	4226974	4226995		YPO_RS19900	21
GLZ002.A0101_2.YP2.1	4235784	4235791		hemB	7
GLZ002.A0101_2.YP2.1	4243423	4243435		YPO_RS19980	12
GLZ002.A0101_2.YP2.1	4264102	4264106		YPO_RS20070	4
GLZ002.A0101_2.YP2.1	4264326	4264369		YPO_RS20070	43
GLZ002.A0101_2.YP2.1	4268718	4268722		YPO_RS20090	4
GLZ002.A0101_2.YP2.1	4269655	4269676		YPO_RS20095	21
GLZ002.A0101_2.YP2.1	4270112	4270116		YPO_RS20095	4
GLZ002.A0101_2.YP2.1	4280853	4280895		ftsY	42
GLZ002.A0101_2.YP2.1	4281476	4281479		ftsY	3
GLZ002.A0101_2.YP2.1	4283671	4283675		YPO_RS20170	4
GLZ002.A0101_2.YP2.1	4298034	4298053		pldB	19
GLZ002.A0101_2.YP2.1	4320863	4320864		hemD	1
GLZ002.A0101_2.YP2.1	4331826	4331831		wzxE	5
GLZ002.A0101_2.YP2.1	4332496	4332498		rffA	2
GLZ002.A0101_2.YP2.1	4349975	4350002		YPO_RS20480	27
GLZ002.A0101_2.YP2.1	4353076	4353080		YPO_RS20490	4
GLZ002.A0101_2.YP2.1	4359333	4359334		YPO_RS20515	1
GLZ002.A0101_2.YP2.1	4359531	4359549		YPO_RS20515	18
GLZ002.A0101_2.YP2.1	4360238	4360252		YPO_RS20525	14
GLZ002.A0101_2.YP2.1	4360417	4360422		YPO_RS20530	5
GLZ002.A0101_2.YP2.1	4364580	4364586		ilvY	6
GLZ002.A0101_2.YP2.1	4367175	4367200		YPO_RS20565	25
GLZ002.A0101_2.YP2.1	4367716	4367724		YPO_RS20570	8
GLZ002.A0101_2.YP2.1	4368053	4368070		YPO_RS20575	17
GLZ002.A0101_2.YP2.1	4368334	4368354		YPO_RS20575	20
GLZ002.A0101_2.YP2.1	4388486	4388489		YPO_RS20670	3
GLZ002.A0101_2.YP2.1	4389733	4389748		YPO_RS20670	15
GLZ002.A0101_2.YP2.1	4394319	4394321		trmA	2
GLZ002.A0101_2.YP2.1	4405947	4405969		YPO_RS20745	22
GLZ002.A0101_2.YP2.1	4408265	4408320		YPO_RS20745	55
GLZ002.A0101_2.YP2.1	4420018	4420019		YPO_RS20785	1
GLZ002.A0101_2.YP2.1	4420294	4420309		YPO_RS20790	15
GLZ002.A0101_2.YP2.1	4421984	4421985		glpD	1
GLZ002.A0101_2.YP2.1	4442496	4442505		YPO_RS20830	9
GLZ002.A0101_2.YP2.1	4443576	4443578		YPO_RS20830	2
GLZ002.A0101_2.YP2.1	4464535	4464546		YPO_RS20940	11
GLZ002.A0101_2.YP2.1	4480627	4480663		YPO_RS21000	36
GLZ002.A0101_2.YP2.1	4480652	4480663		YPO_RS21005	11
GLZ002.A0101_2.YP2.1	4481946	4481950		YPO_RS21010	4
GLZ002.A0101_2.YP2.1	4483589	4483632		YPO_RS21020	43
GLZ002.A0101_2.YP2.1	4483705	4483728		YPO_RS21020	23
GLZ002.A0101_2.YP2.1	4483785	4483830		YPO_RS21020	45
GLZ002.A0101_2.YP2.1	4483889	4483903		YPO_RS21020	14
GLZ002.A0101_2.YP2.1	4484186	4484222		YPO_RS21025	36
GLZ002.A0101_2.YP2.1	4484374	4484481		YPO_RS21025	107
GLZ002.A0101_2.YP2.1	4484957	4485029		YPO_RS21030	72
GLZ002.A0101_2.YP2.1	4490449	4490472		yhjD	23
GLZ002.A0101_2.YP2.1	4491264	4491287		YPO_RS21045	23
GLZ002.A0101_2.YP2.1	4502873	4502886		YPO_RS21090	13
GLZ002.A0101_2.YP2.1	4515982	4515992		YPO_RS21140	10
GLZ002.A0101_2.YP2.1	4516291	4516310		YPO_RS21140	19
GLZ002.A0101_2.YP2.1	4516795	4516800		YPO_RS21140	5
GLZ002.A0101_2.YP2.1	4517310	4517335		YPO_RS21140	25
GLZ002.A0101_2.YP2.1	4525174	4525176		eptB	2
GLZ002.A0101_2.YP2.1	4527107	4527113		YPO_RS21185	6
GLZ002.A0101_2.YP2.1	4533462	4533475		YPO_RS21205	13
GLZ002.A0101_2.YP2.1	4534350	4534359		YPO_RS21205	9
GLZ002.A0101_2.YP2.1	4534356	4534366		YPO_RS21210	10
GLZ002.A0101_2.YP2.1	4534634	4534644		YPO_RS21210	10
GLZ002.A0101_2.YP2.1	4534818	4534873		YPO_RS21210	55
GLZ002.A0101_2.YP2.1	4540639	4540640		YPO_RS21240	1
GLZ002.A0101_2.YP2.1	4545799	4545875		YPO_RS21280	76
GLZ002.A0101_2.YP2.1	4546305	4546316		YPO_RS21280	11
GLZ002.A0101_2.YP2.1	4546382	4546409		YPO_RS21280	27
GLZ002.A0101_2.YP2.1	4558092	4558135		YPO_RS21330	43
GLZ002.A0101_2.YP2.1	4563899	4563902		YPO_RS21350	3
GLZ002.A0101_2.YP2.1	4565417	4565423		YPO_RS21355	6
GLZ002.A0101_2.YP2.1	4567717	4567777		YPO_RS21370	60
GLZ002.A0101_2.YP2.1	4583584	4583605		YPO_RS21440	21
GLZ002.A0101_2.YP2.1	4593340	4593351		glyQ	11
GLZ002.A0101_2.YP2.1	4601700	4601737		YPO_RS21520	37
GLZ002.A0101_2.YP2.1	4601876	4601901		YPO_RS21520	25
GLZ002.A0101_2.YP2.1	4601943	4601968		YPO_RS21520	25
GLZ002.A0101_2.YP2.1	4602027	4602046		YPO_RS21520	19
GLZ002.A0101_2.YP2.1	4626181	4626182		YPO_RS21630	1
GLZ002.A0101_2.YP2.1	4626270	4626318		YPO_RS21630	48
GLZ002.A0101_2.YP2.1	4629620	4629622		yieH	2
GLZ002.A0101_2.YP2.1	4630858	4630859		YPO_RS21655	1
GLZ002.A0101_2.YP2.1	4633480	4633512		YPO_RS21670	32
GLZ002.A0101_2.YP2.1	4642495	4642497		glmU	2
GLZ002.A0101_2.YP2.1	4647286	4647300		atpA	14
GRH001.A0202_rmdup	1549	1556		YPO_RS01015	7
GRH001.A0202_rmdup	2886	2899		viaA	13
GRH001.A0202_rmdup	3271	3284		viaA	13
GRH001.A0202_rmdup	3984	3992		viaA	8
GRH001.A0202_rmdup	3996	4091		ravA	95
GRH001.A0202_rmdup	4233	4243		ravA	10
GRH001.A0202_rmdup	7226	7237		kup	11
GRH001.A0202_rmdup	9196	9200		rbsK	4
GRH001.A0202_rmdup	10854	10858		YPO_RS01055	4
GRH001.A0202_rmdup	21485	21494		YPO_RS01110	9
GRH001.A0202_rmdup	24911	24912		polA	1
GRH001.A0202_rmdup	27409	27416		YPO_RS01130	7
GRH001.A0202_rmdup	29281	29317		hemN	36
GRH001.A0202_rmdup	29914	29929		hemN	15
GRH001.A0202_rmdup	31281	31304		glnG	23
GRH001.A0202_rmdup	33906	33909		glnA	3
GRH001.A0202_rmdup	33960	33973		glnA	13
GRH001.A0202_rmdup	35532	35537		typA	5
GRH001.A0202_rmdup	41551	41566		fabY	15
GRH001.A0202_rmdup	42706	42713		YPO_RS01195	7
GRH001.A0202_rmdup	44451	44455		YPO_RS01200	4
GRH001.A0202_rmdup	45425	45426		YPO_RS01200	1
GRH001.A0202_rmdup	46088	46106		gltS	18
GRH001.A0202_rmdup	47815	47844		recG	29
GRH001.A0202_rmdup	48360	48363		recG	3
GRH001.A0202_rmdup	48631	48652		recG	21
GRH001.A0202_rmdup	49720	49730		trmH	10
GRH001.A0202_rmdup	51474	51478		spoT	4
GRH001.A0202_rmdup	51567	51568		spoT	1
GRH001.A0202_rmdup	53836	53846		ligB	10
GRH001.A0202_rmdup	54137	54146		ligB	9
GRH001.A0202_rmdup	54181	54183		ligB	2
GRH001.A0202_rmdup	54672	54688		ligB	16
GRH001.A0202_rmdup	55282	55325		ligB	43
GRH001.A0202_rmdup	58758	58766		pyrE	8
GRH001.A0202_rmdup	59323	59324		slmA	1
GRH001.A0202_rmdup	63090	63095		rpmG	5
GRH001.A0202_rmdup	64840	64844		YPO_RS01310	4
GRH001.A0202_rmdup	66444	66446		waaA	2
GRH001.A0202_rmdup	67078	67082		rfaC	4
GRH001.A0202_rmdup	71956	71961		tdh	5
GRH001.A0202_rmdup	73864	73879		envC	15
GRH001.A0202_rmdup	77268	77284		YPO_RS01360	16
GRH001.A0202_rmdup	78821	78927		gpsA	106
GRH001.A0202_rmdup	79070	79071		gpsA	1
GRH001.A0202_rmdup	81496	81516		ada	20
GRH001.A0202_rmdup	81773	81803		ada	30
GRH001.A0202_rmdup	83794	83798		cpxR	4
GRH001.A0202_rmdup	85576	85577		YPO_RS01415	1
GRH001.A0202_rmdup	91407	91410		YPO_RS01440	3
GRH001.A0202_rmdup	91461	91464		YPO_RS01440	3
GRH001.A0202_rmdup	91859	91865		YPO_RS01445	6
GRH001.A0202_rmdup	94478	94494		YPO_RS01455	16
GRH001.A0202_rmdup	96811	96821		tpiA	10
GRH001.A0202_rmdup	98916	98919		fpr	3
GRH001.A0202_rmdup	101783	101805		YPO_RS01495	22
GRH001.A0202_rmdup	101840	101849		YPO_RS01495	9
GRH001.A0202_rmdup	101994	101998		YPO_RS01495	4
GRH001.A0202_rmdup	106553	106577		YPO_RS01520	24
GRH001.A0202_rmdup	108528	108557		YPO_RS01530	29
GRH001.A0202_rmdup	111070	111074		YPO_RS01540	4
GRH001.A0202_rmdup	112408	112420		YPO_RS01550	12
GRH001.A0202_rmdup	113678	113699		hslU	21
GRH001.A0202_rmdup	114758	114761		hslV	3
GRH001.A0202_rmdup	116554	116569		cytR	15
GRH001.A0202_rmdup	118508	118523		priA	15
GRH001.A0202_rmdup	124080	124086		YPO_RS01600	6
GRH001.A0202_rmdup	125773	125796		YPO_RS01600	23
GRH001.A0202_rmdup	127196	127206		YPO_RS01610	10
GRH001.A0202_rmdup	129631	129634		glpG	3
GRH001.A0202_rmdup	130241	130254		glpG	13
GRH001.A0202_rmdup	133120	133128		malT	8
GRH001.A0202_rmdup	133570	133605		malT	35
GRH001.A0202_rmdup	135771	135802		malP	31
GRH001.A0202_rmdup	137104	137115		malQ	11
GRH001.A0202_rmdup	138448	138470		malQ	22
GRH001.A0202_rmdup	139614	139658		gntX	44
GRH001.A0202_rmdup	139752	139770		gntX	18
GRH001.A0202_rmdup	140628	140630		bioH	2
GRH001.A0202_rmdup	140867	140898		bioH	31
GRH001.A0202_rmdup	142143	142167		feoB	24
GRH001.A0202_rmdup	142211	142214		feoB	3
GRH001.A0202_rmdup	142383	142398		feoB	15
GRH001.A0202_rmdup	142810	142812		feoB	2
GRH001.A0202_rmdup	143706	143708		feoB	2
GRH001.A0202_rmdup	146814	146828		YPO_RS01685	14
GRH001.A0202_rmdup	150761	150763		envZ	2
GRH001.A0202_rmdup	150931	150939		pckA	8
GRH001.A0202_rmdup	151671	151672		pckA	1
GRH001.A0202_rmdup	154067	154071		hslR	4
GRH001.A0202_rmdup	159839	159848		mrcA	9
GRH001.A0202_rmdup	160074	160081		mrcA	7
GRH001.A0202_rmdup	160835	160840		mrcA	5
GRH001.A0202_rmdup	161148	161164		YPO_RS01740	16
GRH001.A0202_rmdup	162086	162121		YPO_RS01745	35
GRH001.A0202_rmdup	163423	163437		YPO_RS01755	14
GRH001.A0202_rmdup	166917	166920		aroB	3
GRH001.A0202_rmdup	169757	169779		rpe	22
GRH001.A0202_rmdup	171198	171209		trpS	11
GRH001.A0202_rmdup	173758	173761		nirC	3
GRH001.A0202_rmdup	175906	175907		YPO_RS01815	1
GRH001.A0202_rmdup	177078	177085		YPO_RS01815	7
GRH001.A0202_rmdup	177280	177281		YPO_RS01815	1
GRH001.A0202_rmdup	177527	177531		YPO_RS01815	4
GRH001.A0202_rmdup	179375	179389		tsgA	14
GRH001.A0202_rmdup	181944	181972		YPO_RS01830	28
GRH001.A0202_rmdup	183067	183087		YPO_RS01835	20
GRH001.A0202_rmdup	183571	183575		YPO_RS01835	4
GRH001.A0202_rmdup	183852	183862		YPO_RS01835	10
GRH001.A0202_rmdup	187611	187628		YPO_RS01850	17
GRH001.A0202_rmdup	188045	188047		YPO_RS01850	2
GRH001.A0202_rmdup	194618	194626		YPO_RS01880	8
GRH001.A0202_rmdup	194739	194758		YPO_RS01880	19
GRH001.A0202_rmdup	196573	196666		YPO_RS01895	93
GRH001.A0202_rmdup	197718	197750		YPO_RS01900	32
GRH001.A0202_rmdup	199004	199019		YPO_RS01910	15
GRH001.A0202_rmdup	200867	200874		tauA	7
GRH001.A0202_rmdup	201785	201799		tauB	14
GRH001.A0202_rmdup	202472	202494		tauC	22
GRH001.A0202_rmdup	203951	203963		YPO_RS01940	12
GRH001.A0202_rmdup	204943	204948		YPO_RS01945	5
GRH001.A0202_rmdup	205208	205236		YPO_RS01945	28
GRH001.A0202_rmdup	211369	211422		slyD	53
GRH001.A0202_rmdup	220563	220570		bfd	7
GRH001.A0202_rmdup	229014	229015		rplF	1
GRH001.A0202_rmdup	236814	236815		mscL	1
GRH001.A0202_rmdup	238938	238950		rsmB	12
GRH001.A0202_rmdup	239835	239845		rsmB	10
GRH001.A0202_rmdup	245432	245443		YPO_RS02240	11
GRH001.A0202_rmdup	248253	248284		YPO_RS02255	31
GRH001.A0202_rmdup	249207	249218		actP	11
GRH001.A0202_rmdup	249512	249532		actP	20
GRH001.A0202_rmdup	251735	251739		acs	4
GRH001.A0202_rmdup	254613	254619		gltP	6
GRH001.A0202_rmdup	255185	255192		YPO_RS02280	7
GRH001.A0202_rmdup	260410	260433		sctD	23
GRH001.A0202_rmdup	261019	261030		sctD	11
GRH001.A0202_rmdup	261516	261523		YPO_RS02300	7
GRH001.A0202_rmdup	262565	262572		sctF	7
GRH001.A0202_rmdup	262761	262767		YPO_RS02315	6
GRH001.A0202_rmdup	263064	263077		sctI	13
GRH001.A0202_rmdup	263113	263119		sctI	6
GRH001.A0202_rmdup	263979	263984		YPO_RS02325	5
GRH001.A0202_rmdup	264540	264550		YPO_RS02330	10
GRH001.A0202_rmdup	264653	264669		YPO_RS02330	16
GRH001.A0202_rmdup	264755	264757		YPO_RS02330	2
GRH001.A0202_rmdup	264936	264937		sctL	1
GRH001.A0202_rmdup	265016	265051		sctL	35
GRH001.A0202_rmdup	265726	265728		YPO_RS02340	2
GRH001.A0202_rmdup	266012	266028		YPO_RS02340	16
GRH001.A0202_rmdup	266297	266299		YPO_RS02340	2
GRH001.A0202_rmdup	266468	266504		YPO_RS02340	36
GRH001.A0202_rmdup	266670	266674		YPO_RS02340	4
GRH001.A0202_rmdup	266853	266876		YPO_RS02340	23
GRH001.A0202_rmdup	269011	269024		YPO_RS02350	13
GRH001.A0202_rmdup	269874	269895		YPO_RS02360	21
GRH001.A0202_rmdup	270281	270295		YPO_RS02360	14
GRH001.A0202_rmdup	270960	270965		sctR	5
GRH001.A0202_rmdup	272505	272515		YPO_RS02380	10
GRH001.A0202_rmdup	278910	278923		metC	13
GRH001.A0202_rmdup	279232	279238		YPO_RS02410	6
GRH001.A0202_rmdup	281325	281366		YPO_RS02420	41
GRH001.A0202_rmdup	281533	281542		YPO_RS02420	9
GRH001.A0202_rmdup	283949	283952		YPO_RS02430	3
GRH001.A0202_rmdup	287012	287018		YPO_RS02450	6
GRH001.A0202_rmdup	287257	287262		YPO_RS02450	5
GRH001.A0202_rmdup	288900	288935		YPO_RS02455	35
GRH001.A0202_rmdup	291820	291850		YPO_RS02470	30
GRH001.A0202_rmdup	292028	292057		YPO_RS02470	29
GRH001.A0202_rmdup	292190	292196		YPO_RS02470	6
GRH001.A0202_rmdup	294095	294118		YPO_RS02480	23
GRH001.A0202_rmdup	295355	295361		YPO_RS02485	6
GRH001.A0202_rmdup	300034	300040		YPO_RS02515	6
GRH001.A0202_rmdup	300132	300137		YPO_RS02515	5
GRH001.A0202_rmdup	302341	302360		YPO_RS02525	19
GRH001.A0202_rmdup	305415	305422		YPO_RS02535	7
GRH001.A0202_rmdup	307560	307580		YPO_RS02550	20
GRH001.A0202_rmdup	311683	311711		YPO_RS02555	28
GRH001.A0202_rmdup	312486	312549		yapK	63
GRH001.A0202_rmdup	312847	312866		yapK	19
GRH001.A0202_rmdup	312955	313031		yapK	76
GRH001.A0202_rmdup	313115	313160		yapK	45
GRH001.A0202_rmdup	313957	313958		yapK	1
GRH001.A0202_rmdup	318140	318171		ubiA	31
GRH001.A0202_rmdup	319028	319033		plsB	5
GRH001.A0202_rmdup	320195	320196		plsB	1
GRH001.A0202_rmdup	326932	326938		dnaB	6
GRH001.A0202_rmdup	327441	327522		dnaB	81
GRH001.A0202_rmdup	328811	328823		alr	12
GRH001.A0202_rmdup	329642	329643		YPO_RS02620	1
GRH001.A0202_rmdup	330187	330193		YPO_RS02620	6
GRH001.A0202_rmdup	332281	332282		uvrA	1
GRH001.A0202_rmdup	332585	332601		uvrA	16
GRH001.A0202_rmdup	335057	335077		ssb1	20
GRH001.A0202_rmdup	336069	336084		fucO	15
GRH001.A0202_rmdup	336216	336219		fucO	3
GRH001.A0202_rmdup	336421	336446		fucO	25
GRH001.A0202_rmdup	336518	336531		fucO	13
GRH001.A0202_rmdup	337568	337611		rhaD	43
GRH001.A0202_rmdup	338279	338324		YPO_RS02655	45
GRH001.A0202_rmdup	338740	338771		YPO_RS02655	31
GRH001.A0202_rmdup	339941	340025		rhaB	84
GRH001.A0202_rmdup	340308	340329		rhaB	21
GRH001.A0202_rmdup	342346	342356		rhaR	10
GRH001.A0202_rmdup	343776	343783		rhaT	7
GRH001.A0202_rmdup	346044	346045		YPO_RS02695	1
GRH001.A0202_rmdup	351406	351493		aegA	87
GRH001.A0202_rmdup	351932	351936		aegA	4
GRH001.A0202_rmdup	352085	352088		YPO_RS02715	3
GRH001.A0202_rmdup	352536	352566		YPO_RS02715	30
GRH001.A0202_rmdup	353461	353470		fdhF	9
GRH001.A0202_rmdup	354181	354190		fdhF	9
GRH001.A0202_rmdup	357209	357253		YPO_RS02735	44
GRH001.A0202_rmdup	359263	359273		aspA	10
GRH001.A0202_rmdup	360483	360508		fxsA	25
GRH001.A0202_rmdup	372815	372822		mscM	7
GRH001.A0202_rmdup	373546	373620		mscM	74
GRH001.A0202_rmdup	376068	376121		psd	53
GRH001.A0202_rmdup	378522	378534		orn	12
GRH001.A0202_rmdup	378653	378662		orn	9
GRH001.A0202_rmdup	380347	380360		queG	13
GRH001.A0202_rmdup	380860	380862		queG	2
GRH001.A0202_rmdup	381844	381881		nnr	37
GRH001.A0202_rmdup	381965	381971		nnr	6
GRH001.A0202_rmdup	382727	382738		tsaE	11
GRH001.A0202_rmdup	383535	383574		amiB	39
GRH001.A0202_rmdup	386843	386857		mutL	14
GRH001.A0202_rmdup	389085	389086		hflX	1
GRH001.A0202_rmdup	389230	389247		hflX	17
GRH001.A0202_rmdup	390715	390716		hflK	1
GRH001.A0202_rmdup	391921	391929		hflC	8
GRH001.A0202_rmdup	394431	394448		nsrR	17
GRH001.A0202_rmdup	395629	395650		rnr	21
GRH001.A0202_rmdup	396148	396201		rnr	53
GRH001.A0202_rmdup	396836	396868		rnr	32
GRH001.A0202_rmdup	397754	397767		rlmB	13
GRH001.A0202_rmdup	398848	398876		YPO_RS02915	28
GRH001.A0202_rmdup	403315	403329		YPO_RS02940	14
GRH001.A0202_rmdup	404305	404308		YPO_RS02940	3
GRH001.A0202_rmdup	405288	405289		YPO_RS02945	1
GRH001.A0202_rmdup	405639	405661		YPO_RS02945	22
GRH001.A0202_rmdup	405911	405931		YPO_RS02945	20
GRH001.A0202_rmdup	408331	408340		YPO_RS02955	9
GRH001.A0202_rmdup	409196	409212		YPO_RS02960	16
GRH001.A0202_rmdup	409752	409766		YPO_RS02965	14
GRH001.A0202_rmdup	410814	410875		YPO_RS02965	61
GRH001.A0202_rmdup	412260	412280		YPO_RS02980	20
GRH001.A0202_rmdup	413276	413295		YPO_RS02980	19
GRH001.A0202_rmdup	415614	415618		YPO_RS02990	4
GRH001.A0202_rmdup	415844	415874		YPO_RS02990	30
GRH001.A0202_rmdup	421152	421158		YPO_RS03020	6
GRH001.A0202_rmdup	422047	422074		ptsP	27
GRH001.A0202_rmdup	422423	422470		ptsP	47
GRH001.A0202_rmdup	422876	422881		ptsP	5
GRH001.A0202_rmdup	424251	424265		ptsP	14
GRH001.A0202_rmdup	426072	426091		lsrF	19
GRH001.A0202_rmdup	428843	428844		lsrC	1
GRH001.A0202_rmdup	429377	429382		lsrC	5
GRH001.A0202_rmdup	430025	430063		lsrA	38
GRH001.A0202_rmdup	430229	430231		lsrA	2
GRH001.A0202_rmdup	431323	431357		YPO_RS03065	34
GRH001.A0202_rmdup	432739	432787		lsrK	48
GRH001.A0202_rmdup	433230	433253		lsrK	23
GRH001.A0202_rmdup	433343	433361		lsrK	18
GRH001.A0202_rmdup	433703	433735		lsrK	32
GRH001.A0202_rmdup	436627	436655		YPO_RS03085	28
GRH001.A0202_rmdup	439353	439370		YPO_RS03100	17
GRH001.A0202_rmdup	439812	439842		YPO_RS03100	30
GRH001.A0202_rmdup	440316	440321		YPO_RS03100	5
GRH001.A0202_rmdup	440402	440429		YPO_RS03100	27
GRH001.A0202_rmdup	440789	440791		YPO_RS03100	2
GRH001.A0202_rmdup	442000	442015		YPO_RS03100	15
GRH001.A0202_rmdup	444663	444670		YPO_RS03115	7
GRH001.A0202_rmdup	446201	446240		YPO_RS03120	39
GRH001.A0202_rmdup	448908	448919		YPO_RS03140	11
GRH001.A0202_rmdup	449139	449176		YPO_RS03140	37
GRH001.A0202_rmdup	450973	451001		prfC	28
GRH001.A0202_rmdup	453363	453415		YPO_RS03165	52
GRH001.A0202_rmdup	454146	454161		YPO_RS03170	15
GRH001.A0202_rmdup	454599	454639		YPO_RS03170	40
GRH001.A0202_rmdup	455492	455501		YPO_RS03175	9
GRH001.A0202_rmdup	455568	455614		YPO_RS03175	46
GRH001.A0202_rmdup	456149	456173		YPO_RS03175	24
GRH001.A0202_rmdup	460109	460112		deoB	3
GRH001.A0202_rmdup	465047	465062		radA	15
GRH001.A0202_rmdup	470092	470113		YPO_RS03230	21
GRH001.A0202_rmdup	471755	471786		YPO_RS03240	31
GRH001.A0202_rmdup	473284	473288		YPO_RS03245	4
GRH001.A0202_rmdup	475410	475414		YPO_RS03245	4
GRH001.A0202_rmdup	482074	482092		arcA	18
GRH001.A0202_rmdup	484411	484422		thrA	11
GRH001.A0202_rmdup	490261	490266		tal	5
GRH001.A0202_rmdup	491538	491549		mog	11
GRH001.A0202_rmdup	492557	492565		YPO_RS03325	8
GRH001.A0202_rmdup	493546	493548		YPO_RS03325	2
GRH001.A0202_rmdup	493751	493780		YPO_RS03330	29
GRH001.A0202_rmdup	494216	494229		YPO_RS03330	13
GRH001.A0202_rmdup	495300	495341		YPO_RS03330	41
GRH001.A0202_rmdup	495743	495799		YPO_RS03330	56
GRH001.A0202_rmdup	498456	498468		dnaK	12
GRH001.A0202_rmdup	499879	499906		dnaJ	27
GRH001.A0202_rmdup	501052	501118		nhaA	66
GRH001.A0202_rmdup	506747	506771		ileS	24
GRH001.A0202_rmdup	507505	507506		ileS	1
GRH001.A0202_rmdup	508682	508719		ispH	37
GRH001.A0202_rmdup	513974	513983		carB	9
GRH001.A0202_rmdup	515264	515274		carB	10
GRH001.A0202_rmdup	521248	521252		YPO_RS03450	4
GRH001.A0202_rmdup	522366	522373		apaH	7
GRH001.A0202_rmdup	523626	523630		rsmA	4
GRH001.A0202_rmdup	524205	524222		pdxA	17
GRH001.A0202_rmdup	524656	524744		pdxA	88
GRH001.A0202_rmdup	524287	524308		pdxA	21
GRH001.A0202_rmdup	526738	526744		lptD	6
GRH001.A0202_rmdup	526991	527000		lptD	9
GRH001.A0202_rmdup	528876	528889		djlA	13
GRH001.A0202_rmdup	529212	529228		djlA	16
GRH001.A0202_rmdup	534421	534424		tssC	3
GRH001.A0202_rmdup	535220	535229		tssC	9
GRH001.A0202_rmdup	536080	536087		YPO_RS03515	7
GRH001.A0202_rmdup	537586	537596		tssF	10
GRH001.A0202_rmdup	538617	538678		tssF	61
GRH001.A0202_rmdup	540244	540259		tssH	15
GRH001.A0202_rmdup	540904	540917		tssH	13
GRH001.A0202_rmdup	541952	541958		tssH	6
GRH001.A0202_rmdup	542748	542784		vgrG	36
GRH001.A0202_rmdup	543808	543822		vgrG	14
GRH001.A0202_rmdup	543881	543888		vgrG	7
GRH001.A0202_rmdup	544621	544649		vgrG	28
GRH001.A0202_rmdup	544791	544797		vgrG	6
GRH001.A0202_rmdup	545290	545293		YPO_RS03545	3
GRH001.A0202_rmdup	545699	545719		YPO_RS03550	20
GRH001.A0202_rmdup	547460	547490		YPO_RS03555	30
GRH001.A0202_rmdup	549468	549488		tssJ	20
GRH001.A0202_rmdup	550079	550083		tssK	4
GRH001.A0202_rmdup	550817	550818		tssK	1
GRH001.A0202_rmdup	552359	552363		YPO_RS03580	4
GRH001.A0202_rmdup	553235	553244		tssM	9
GRH001.A0202_rmdup	553355	553356		tssM	1
GRH001.A0202_rmdup	554297	554299		tssM	2
GRH001.A0202_rmdup	554847	554870		tssM	23
GRH001.A0202_rmdup	556612	556615		YPO_RS03590	3
GRH001.A0202_rmdup	557916	557936		rapA	20
GRH001.A0202_rmdup	558570	558601		rapA	31
GRH001.A0202_rmdup	558995	559002		rapA	7
GRH001.A0202_rmdup	560582	560594		YPO_RS03600	12
GRH001.A0202_rmdup	561117	561121		YPO_RS03600	4
GRH001.A0202_rmdup	562293	562296		YPO_RS03600	3
GRH001.A0202_rmdup	562653	562682		YPO_RS03600	29
GRH001.A0202_rmdup	563323	563343		YPO_RS03605	20
GRH001.A0202_rmdup	563769	563785		thiQ	16
GRH001.A0202_rmdup	564024	564028		thiQ	4
GRH001.A0202_rmdup	565454	565457		thiP	3
GRH001.A0202_rmdup	565634	565658		thiP	24
GRH001.A0202_rmdup	568435	568453		YPO_RS03625	18
GRH001.A0202_rmdup	573986	573989		leuD	3
GRH001.A0202_rmdup	574609	574611		leuC	2
GRH001.A0202_rmdup	574923	574927		leuC	4
GRH001.A0202_rmdup	575322	575348		leuC	26
GRH001.A0202_rmdup	582493	582498		YPO_RS03685	5
GRH001.A0202_rmdup	591623	591626		ftsL	3
GRH001.A0202_rmdup	592052	592055		YPO_RS03735	3
GRH001.A0202_rmdup	592198	592199		YPO_RS03735	1
GRH001.A0202_rmdup	594063	594068		murE	5
GRH001.A0202_rmdup	594878	594947		murE	69
GRH001.A0202_rmdup	595206	595222		murF	16
GRH001.A0202_rmdup	595336	595360		murF	24
GRH001.A0202_rmdup	595709	595801		murF	92
GRH001.A0202_rmdup	596039	596044		murF	5
GRH001.A0202_rmdup	598418	598419		murD	1
GRH001.A0202_rmdup	598940	598957		ftsW	17
GRH001.A0202_rmdup	599610	599623		ftsW	13
GRH001.A0202_rmdup	600775	600785		murG	10
GRH001.A0202_rmdup	600877	600881		murG	4
GRH001.A0202_rmdup	601578	601583		murC	5
GRH001.A0202_rmdup	602358	602379		murC	21
GRH001.A0202_rmdup	602528	602553		murC	25
GRH001.A0202_rmdup	603196	603207		YPO_RS03775	11
GRH001.A0202_rmdup	603496	603499		YPO_RS03775	3
GRH001.A0202_rmdup	603553	603592		YPO_RS03775	39
GRH001.A0202_rmdup	606068	606092		ftsZ	24
GRH001.A0202_rmdup	608237	608243		YPO_RS03800	6
GRH001.A0202_rmdup	609996	610014		secA	18
GRH001.A0202_rmdup	616442	616464		YPO_RS03845	22
GRH001.A0202_rmdup	618089	618132		YPO_RS03865	43
GRH001.A0202_rmdup	627041	627052		YPO_RS03895	11
GRH001.A0202_rmdup	627771	627777		YPO_RS03900	6
GRH001.A0202_rmdup	629171	629182		sstT	11
GRH001.A0202_rmdup	630618	631556		YPO_RS03915	938
GRH001.A0202_rmdup	631816	632130		YPO_RS03920	314
GRH001.A0202_rmdup	632206	632325		YPO_RS03920	119
GRH001.A0202_rmdup	632564	635548		yapG	2984
GRH001.A0202_rmdup	636183	637204		rlmG	1021
GRH001.A0202_rmdup	637320	637591		YPO_RS03935	271
GRH001.A0202_rmdup	637643	639341		YPO_RS03935	1698
GRH001.A0202_rmdup	639554	640123		YPO_RS03940	569
GRH001.A0202_rmdup	640514	642013		YPO_RS03945	1499
GRH001.A0202_rmdup	642045	642206		YPO_RS03950	161
GRH001.A0202_rmdup	642282	643478		YPO_RS03950	1196
GRH001.A0202_rmdup	643554	643778		YPO_RS03950	224
GRH001.A0202_rmdup	643834	644817		YPO_RS03955	983
GRH001.A0202_rmdup	644919	645206		YPO_RS03960	287
GRH001.A0202_rmdup	645282	645557		YPO_RS03960	275
GRH001.A0202_rmdup	645559	646200		YPO_RS03965	641
GRH001.A0202_rmdup	646233	646871		YPO_RS03970	638
GRH001.A0202_rmdup	647586	648000		YPO_RS03975	414
GRH001.A0202_rmdup	648051	648577		YPO_RS03975	526
GRH001.A0202_rmdup	648652	648807		YPO_RS03975	155
GRH001.A0202_rmdup	648880	649274		YPO_RS03975	394
GRH001.A0202_rmdup	649319	649650		cdiA	331
GRH001.A0202_rmdup	649693	649935		cdiA	242
GRH001.A0202_rmdup	649983	650058		cdiA	75
GRH001.A0202_rmdup	657900	657944		cdiA	44
GRH001.A0202_rmdup	658016	658729		cdiA	713
GRH001.A0202_rmdup	658774	659206		cdiA	432
GRH001.A0202_rmdup	650127	657852		cdiA	7725
GRH001.A0202_rmdup	659203	659436		cdiI	233
GRH001.A0202_rmdup	659498	659647		YPO_RS03990	149
GRH001.A0202_rmdup	659702	659929		YPO_RS03995	227
GRH001.A0202_rmdup	659865	660023		YPO_RS04000	158
GRH001.A0202_rmdup	660025	660441		YPO_RS04005	416
GRH001.A0202_rmdup	660474	661229		YPO_RS04010	755
GRH001.A0202_rmdup	661293	661457		YPO_RS04015	164
GRH001.A0202_rmdup	661725	662433		yapF	708
GRH001.A0202_rmdup	662508	662991		yapF	483
GRH001.A0202_rmdup	663066	664010		yapF	944
GRH001.A0202_rmdup	664070	664337		YPO_RS04025	267
GRH001.A0202_rmdup	664413	664590		YPO_RS04025	177
GRH001.A0202_rmdup	664666	665065		YPO_RS04025	399
GRH001.A0202_rmdup	665167	666546		YPO_RS04030	1379
GRH001.A0202_rmdup	666872	667234		YPO_RS04035	362
GRH001.A0202_rmdup	667305	667346		YPO_RS04035	41
GRH001.A0202_rmdup	667386	667445		YPO_RS04035	59
GRH001.A0202_rmdup	667501	667987		YPO_RS04035	486
GRH001.A0202_rmdup	668070	668507		YPO_RS04040	437
GRH001.A0202_rmdup	668582	669033		YPO_RS04040	451
GRH001.A0202_rmdup	669077	669241		YPO_RS04040	164
GRH001.A0202_rmdup	669316	671423		YPO_RS04040	2107
GRH001.A0202_rmdup	671532	672518		YPO_RS04045	986
GRH001.A0202_rmdup	672595	673839		YPO_RS04050	1244
GRH001.A0202_rmdup	673893	674774		YPO_RS04055	881
GRH001.A0202_rmdup	674774	675592		YPO_RS04060	818
GRH001.A0202_rmdup	675949	675989		YPO_RS04065	40
GRH001.A0202_rmdup	675589	675912		YPO_RS04065	323
GRH001.A0202_rmdup	676471	676548		YPO_RS04070	77
GRH001.A0202_rmdup	677087	677088		YPO_RS04070	1
GRH001.A0202_rmdup	677657	677674		YPO_RS04070	17
GRH001.A0202_rmdup	680269	680315		YPO_RS04080	46
GRH001.A0202_rmdup	680966	680973		YPO_RS04080	7
GRH001.A0202_rmdup	681018	681063		YPO_RS04080	45
GRH001.A0202_rmdup	681228	681236		YPO_RS04080	8
GRH001.A0202_rmdup	682276	682280		mdtN	4
GRH001.A0202_rmdup	682408	682453		mdtN	45
GRH001.A0202_rmdup	682501	682506		mdtN	5
GRH001.A0202_rmdup	682750	682768		mdtN	18
GRH001.A0202_rmdup	684406	684479		YPO_RS04100	73
GRH001.A0202_rmdup	686066	686072		YPO_RS04105	6
GRH001.A0202_rmdup	690603	690616		YPO_RS04135	13
GRH001.A0202_rmdup	696026	696036		YPO_RS04170	10
GRH001.A0202_rmdup	696929	696935		YPO_RS04170	6
GRH001.A0202_rmdup	704027	704029		tsaD	2
GRH001.A0202_rmdup	704986	705010		plsY	24
GRH001.A0202_rmdup	707999	708000		YPO_RS04230	1
GRH001.A0202_rmdup	708614	708619		YPO_RS04230	5
GRH001.A0202_rmdup	709276	709280		YPO_RS04235	4
GRH001.A0202_rmdup	711650	711659		glnE	9
GRH001.A0202_rmdup	712103	712105		glnE	2
GRH001.A0202_rmdup	712982	712985		glnE	3
GRH001.A0202_rmdup	715228	715231		hldE	3
GRH001.A0202_rmdup	715635	715638		hldE	3
GRH001.A0202_rmdup	719576	719602		ygiD	26
GRH001.A0202_rmdup	721850	721862		YPO_RS04280	12
GRH001.A0202_rmdup	724525	724554		nudF	29
GRH001.A0202_rmdup	726455	726465		yqiA	10
GRH001.A0202_rmdup	727867	727869		parE	2
GRH001.A0202_rmdup	728992	728994		YPO_RS04315	2
GRH001.A0202_rmdup	730269	730281		YPO_RS04320	12
GRH001.A0202_rmdup	731085	731101		parC	16
GRH001.A0202_rmdup	731251	731260		parC	9
GRH001.A0202_rmdup	733707	733716		YPO_RS04335	9
GRH001.A0202_rmdup	734644	734651		ftsP	7
GRH001.A0202_rmdup	735196	735200		ftsP	4
GRH001.A0202_rmdup	740216	740241		yqhD	25
GRH001.A0202_rmdup	743669	743734		metC	65
GRH001.A0202_rmdup	743884	743912		metC	28
GRH001.A0202_rmdup	744023	744033		metC	10
GRH001.A0202_rmdup	744795	744849		exbB	54
GRH001.A0202_rmdup	745932	745956		exbD	24
GRH001.A0202_rmdup	746169	746171		exbD	2
GRH001.A0202_rmdup	746376	746382		YPO_RS04390	6
GRH001.A0202_rmdup	747789	747797		YPO_RS04390	8
GRH001.A0202_rmdup	747915	747932		YPO_RS04395	17
GRH001.A0202_rmdup	749303	749360		YPO_RS04405	57
GRH001.A0202_rmdup	749644	749645		YPO_RS04405	1
GRH001.A0202_rmdup	749644	749648		YPO_RS04410	4
GRH001.A0202_rmdup	750106	750122		YPO_RS04410	16
GRH001.A0202_rmdup	750238	750259		YPO_RS04410	21
GRH001.A0202_rmdup	750432	750462		YPO_RS04410	30
GRH001.A0202_rmdup	750459	750537		YPO_RS04415	78
GRH001.A0202_rmdup	750954	750971		YPO_RS04415	17
GRH001.A0202_rmdup	751118	751128		YPO_RS04415	10
GRH001.A0202_rmdup	752646	752660		YPO_RS04425	14
GRH001.A0202_rmdup	753737	753740		YPO_RS04425	3
GRH001.A0202_rmdup	754419	754442		YPO_RS04435	23
GRH001.A0202_rmdup	754850	754888		YPO_RS04440	38
GRH001.A0202_rmdup	755050	755054		YPO_RS04440	4
GRH001.A0202_rmdup	755334	755371		YPO_RS04440	37
GRH001.A0202_rmdup	755369	755371		YPO_RS04445	2
GRH001.A0202_rmdup	758430	759747		YPO_RS04465	1317
GRH001.A0202_rmdup	759805	760017		YPO_RS04465	212
GRH001.A0202_rmdup	760052	760684		YPO_RS04465	632
GRH001.A0202_rmdup	760718	760910		YPO_RS04465	192
GRH001.A0202_rmdup	760928	761647		YPO_RS04470	719
GRH001.A0202_rmdup	761672	761701		YPO_RS04475	29
GRH001.A0202_rmdup	761741	762642		YPO_RS04475	901
GRH001.A0202_rmdup	762718	762778		YPO_RS04475	60
GRH001.A0202_rmdup	762990	763258		fepB	268
GRH001.A0202_rmdup	763330	763741		fepB	411
GRH001.A0202_rmdup	763777	763869		fepB	92
GRH001.A0202_rmdup	763945	764069		fepB	124
GRH001.A0202_rmdup	764925	765920		YPO_RS04485	995
GRH001.A0202_rmdup	766012	766581		YPO_RS04490	569
GRH001.A0202_rmdup	768877	769288		flhB	411
GRH001.A0202_rmdup	769364	770010		flhB	646
GRH001.A0202_rmdup	770010	770783		YPO_RS04505	773
GRH001.A0202_rmdup	771037	771062		fliQ	25
GRH001.A0202_rmdup	770790	770961		fliQ	171
GRH001.A0202_rmdup	771064	771214		fliP	150
GRH001.A0202_rmdup	771271	771834		fliP	563
GRH001.A0202_rmdup	771831	772244		fliN	413
GRH001.A0202_rmdup	772237	772316		YPO_RS04525	79
GRH001.A0202_rmdup	772390	773136		YPO_RS04525	746
GRH001.A0202_rmdup	773659	774687		YPO_RS04530	1028
GRH001.A0202_rmdup	774704	775084		fliE	380
GRH001.A0202_rmdup	775094	776598		fliF	1504
GRH001.A0202_rmdup	776673	776734		fliF	61
GRH001.A0202_rmdup	776706	777010		YPO_RS04545	304
GRH001.A0202_rmdup	777084	777749		YPO_RS04545	665
GRH001.A0202_rmdup	777754	778470		YPO_RS04550	716
GRH001.A0202_rmdup	778463	779029		fliI	566
GRH001.A0202_rmdup	779082	779803		fliI	721
GRH001.A0202_rmdup	779807	780190		fliJ	383
GRH001.A0202_rmdup	780518	780943		YPO_RS04565	425
GRH001.A0202_rmdup	780950	780987		flgM	37
GRH001.A0202_rmdup	781051	781216		flgM	165
GRH001.A0202_rmdup	781445	782293		flgA	848
GRH001.A0202_rmdup	782351	782797		flgB	446
GRH001.A0202_rmdup	782800	783225		flgC	425
GRH001.A0202_rmdup	783228	783884		flgD	656
GRH001.A0202_rmdup	783939	785133		flaE	1194
GRH001.A0202_rmdup	785207	785316		YPO_RS04600	109
GRH001.A0202_rmdup	786543	786622		flgF	79
GRH001.A0202_rmdup	786029	786475		flgF	446
GRH001.A0202_rmdup	786690	787475		flgG	785
GRH001.A0202_rmdup	787510	788175		flgH	665
GRH001.A0202_rmdup	788222	789364		YPO_RS04625	1142
GRH001.A0202_rmdup	789374	789667		flgJ	293
GRH001.A0202_rmdup	789780	790733		flgK	953
GRH001.A0202_rmdup	790795	791141		flgK	346
GRH001.A0202_rmdup	791170	792093		flgL	923
GRH001.A0202_rmdup	792105	793118		YPO_RS04645	1013
GRH001.A0202_rmdup	793282	793728		YPO_RS04650	446
GRH001.A0202_rmdup	793709	794558		YPO_RS04655	849
GRH001.A0202_rmdup	794622	794755		YPO_RS04655	133
GRH001.A0202_rmdup	795381	795444		YPO_RS04660	63
GRH001.A0202_rmdup	795495	795553		YPO_RS04660	58
GRH001.A0202_rmdup	795617	795686		YPO_RS04660	69
GRH001.A0202_rmdup	795828	796307		YPO_RS04660	479
GRH001.A0202_rmdup	796553	796595		YPO_RS04660	42
GRH001.A0202_rmdup	799306	799335		YPO_RS04670	29
GRH001.A0202_rmdup	801369	801376		fliS	7
GRH001.A0202_rmdup	802195	802198		YPO_RS04690	3
GRH001.A0202_rmdup	802554	802640		YPO_RS04690	86
GRH001.A0202_rmdup	803083	803089		YPO_RS04690	6
GRH001.A0202_rmdup	807374	807379		YPO_RS04720	5
GRH001.A0202_rmdup	807625	807681		YPO_RS04720	56
GRH001.A0202_rmdup	808999	809008		YPO_RS04735	9
GRH001.A0202_rmdup	809185	809241		YPO_RS04735	56
GRH001.A0202_rmdup	809842	809848		YPO_RS04740	6
GRH001.A0202_rmdup	811225	811226		YPO_RS04745	1
GRH001.A0202_rmdup	812068	812074		YPO_RS04745	6
GRH001.A0202_rmdup	813486	813491		YPO_RS04750	5
GRH001.A0202_rmdup	813986	813993		YPO_RS04755	7
GRH001.A0202_rmdup	814061	814064		YPO_RS04755	3
GRH001.A0202_rmdup	816385	816409		YPO_RS04765	24
GRH001.A0202_rmdup	817139	817144		YPO_RS04770	5
GRH001.A0202_rmdup	817903	817915		YPO_RS04770	12
GRH001.A0202_rmdup	818104	818120		YPO_RS04770	16
GRH001.A0202_rmdup	820451	820465		YPO_RS04770	14
GRH001.A0202_rmdup	822209	822226		YPO_RS04775	17
GRH001.A0202_rmdup	823573	823584		vgrG	11
GRH001.A0202_rmdup	830328	830339		gntP	11
GRH001.A0202_rmdup	834328	834373		YPO_RS04800	45
GRH001.A0202_rmdup	835343	835344		YPO_RS04805	1
GRH001.A0202_rmdup	835971	836003		YPO_RS04805	32
GRH001.A0202_rmdup	838868	838882		YPO_RS04815	14
GRH001.A0202_rmdup	839082	839099		YPO_RS04815	17
GRH001.A0202_rmdup	839273	839292		YPO_RS04815	19
GRH001.A0202_rmdup	839436	839446		YPO_RS04815	10
GRH001.A0202_rmdup	839736	839741		YPO_RS04815	5
GRH001.A0202_rmdup	840063	840085		YPO_RS04820	22
GRH001.A0202_rmdup	841174	841206		YPO_RS04825	32
GRH001.A0202_rmdup	842047	842078		YPO_RS04830	31
GRH001.A0202_rmdup	843828	843844		YPO_RS04835	16
GRH001.A0202_rmdup	845403	845474		YPO_RS04835	71
GRH001.A0202_rmdup	845506	845657		YPO_RS04835	151
GRH001.A0202_rmdup	845887	845938		YPO_RS04835	51
GRH001.A0202_rmdup	846122	846160		YPO_RS04835	38
GRH001.A0202_rmdup	846394	846426		YPO_RS04835	32
GRH001.A0202_rmdup	846743	846816		YPO_RS04835	73
GRH001.A0202_rmdup	847039	847072		YPO_RS04835	33
GRH001.A0202_rmdup	849004	849041		YPO_RS04840	37
GRH001.A0202_rmdup	849263	849264		YPO_RS04840	1
GRH001.A0202_rmdup	849541	849557		YPO_RS04840	16
GRH001.A0202_rmdup	849708	849731		YPO_RS04840	23
GRH001.A0202_rmdup	850362	850413		YPO_RS04845	51
GRH001.A0202_rmdup	850491	850495		YPO_RS04845	4
GRH001.A0202_rmdup	851245	851246		YPO_RS04845	1
GRH001.A0202_rmdup	851498	851502		YPO_RS04845	4
GRH001.A0202_rmdup	851578	851581		YPO_RS04845	3
GRH001.A0202_rmdup	852491	852496		YPO_RS04845	5
GRH001.A0202_rmdup	853659	853672		YPO_RS04845	13
GRH001.A0202_rmdup	853783	853784		YPO_RS04845	1
GRH001.A0202_rmdup	856053	856077		YPO_RS04845	24
GRH001.A0202_rmdup	858941	858944		YPO_RS04860	3
GRH001.A0202_rmdup	859678	859684		thyA	6
GRH001.A0202_rmdup	860565	860567		lgt	2
GRH001.A0202_rmdup	861907	861908		ptsP	1
GRH001.A0202_rmdup	862148	862165		ptsP	17
GRH001.A0202_rmdup	863130	863156		ptsP	26
GRH001.A0202_rmdup	863504	863515		ptsP	11
GRH001.A0202_rmdup	865335	865344		mutH	9
GRH001.A0202_rmdup	870732	870785		aas	53
GRH001.A0202_rmdup	877914	877923		YPO_RS04935	9
GRH001.A0202_rmdup	884377	884379		YPO_RS04965	2
GRH001.A0202_rmdup	884433	884448		YPO_RS04965	15
GRH001.A0202_rmdup	886588	886699		YPO_RS04980	111
GRH001.A0202_rmdup	888156	888227		YPO_RS04990	71
GRH001.A0202_rmdup	888482	888494		YPO_RS04990	12
GRH001.A0202_rmdup	888736	888752		YPO_RS04990	16
GRH001.A0202_rmdup	889484	889508		gspJ	24
GRH001.A0202_rmdup	893684	893687		gspE	3
GRH001.A0202_rmdup	893684	893842		gspD	158
GRH001.A0202_rmdup	894841	894873		gspD	32
GRH001.A0202_rmdup	895445	895456		gspD	11
GRH001.A0202_rmdup	896003	896011		YPO_RS05030	8
GRH001.A0202_rmdup	896137	896190		YPO_RS05030	53
GRH001.A0202_rmdup	896641	896644		YPO_RS05035	3
GRH001.A0202_rmdup	900387	900394		YPO_RS05050	7
GRH001.A0202_rmdup	900685	900699		yapM	14
GRH001.A0202_rmdup	900852	900854		yapM	2
GRH001.A0202_rmdup	903761	903767		YPO_RS05060	6
GRH001.A0202_rmdup	903873	903876		YPO_RS05060	3
GRH001.A0202_rmdup	903933	903966		YPO_RS05060	33
GRH001.A0202_rmdup	904447	904450		YPO_RS05060	3
GRH001.A0202_rmdup	904972	905007		YPO_RS05060	35
GRH001.A0202_rmdup	905790	905848		YPO_RS05060	58
GRH001.A0202_rmdup	909135	909160		YPO_RS05080	25
GRH001.A0202_rmdup	910428	910450		YPO_RS05080	22
GRH001.A0202_rmdup	911918	911936		YPO_RS05085	18
GRH001.A0202_rmdup	915408	915481		YPO_RS05105	73
GRH001.A0202_rmdup	916416	916420		YPO_RS05110	4
GRH001.A0202_rmdup	917330	917351		YPO_RS05115	21
GRH001.A0202_rmdup	917690	917737		nagA	47
GRH001.A0202_rmdup	918263	918264		nagA	1
GRH001.A0202_rmdup	918843	918856		kduD	13
GRH001.A0202_rmdup	919530	919538		kduD	8
GRH001.A0202_rmdup	919554	919563		YPO_RS05130	9
GRH001.A0202_rmdup	919739	919758		YPO_RS05130	19
GRH001.A0202_rmdup	920063	920070		YPO_RS05130	7
GRH001.A0202_rmdup	920355	920356		YPO_RS05130	1
GRH001.A0202_rmdup	921698	921706		YPO_RS05135	8
GRH001.A0202_rmdup	922507	922511		YPO_RS05140	4
GRH001.A0202_rmdup	922797	922801		YPO_RS05140	4
GRH001.A0202_rmdup	923133	923141		YPO_RS05140	8
GRH001.A0202_rmdup	923174	923181		YPO_RS05140	7
GRH001.A0202_rmdup	924772	924825		YPO_RS05145	53
GRH001.A0202_rmdup	926485	926502		YPO_RS05155	17
GRH001.A0202_rmdup	927388	927390		YPO_RS05160	2
GRH001.A0202_rmdup	930391	930423		YPO_RS05170	32
GRH001.A0202_rmdup	932081	932094		YPO_RS05170	13
GRH001.A0202_rmdup	932248	932258		YPO_RS05170	10
GRH001.A0202_rmdup	934588	934590		YPO_RS05180	2
GRH001.A0202_rmdup	936333	936346		YPO_RS05190	13
GRH001.A0202_rmdup	936541	936542		YPO_RS05190	1
GRH001.A0202_rmdup	937224	937227		YPO_RS05190	3
GRH001.A0202_rmdup	937876	937880		YPO_RS05190	4
GRH001.A0202_rmdup	939577	939595		YPO_RS05200	18
GRH001.A0202_rmdup	940568	940582		YPO_RS05205	14
GRH001.A0202_rmdup	940659	940670		YPO_RS05205	11
GRH001.A0202_rmdup	942218	942226		YPO_RS05210	8
GRH001.A0202_rmdup	944181	944202		YPO_RS05215	21
GRH001.A0202_rmdup	946643	946648		YPO_RS05225	5
GRH001.A0202_rmdup	946956	946960		YPO_RS05225	4
GRH001.A0202_rmdup	948837	948839		YPO_RS05230	2
GRH001.A0202_rmdup	950094	950108		YPO_RS05235	14
GRH001.A0202_rmdup	950169	950172		YPO_RS05235	3
GRH001.A0202_rmdup	952643	952670		YPO_RS05245	27
GRH001.A0202_rmdup	953252	953255		YPO_RS05255	3
GRH001.A0202_rmdup	953697	953759		YPO_RS05260	62
GRH001.A0202_rmdup	956660	956679		YPO_RS05270	19
GRH001.A0202_rmdup	956836	956837		YPO_RS05270	1
GRH001.A0202_rmdup	957026	957032		YPO_RS05270	6
GRH001.A0202_rmdup	957775	957776		YPO_RS05270	1
GRH001.A0202_rmdup	960219	960277		YPO_RS05290	58
GRH001.A0202_rmdup	963559	963565		YPO_RS05310	6
GRH001.A0202_rmdup	965081	965092		YPO_RS05330	11
GRH001.A0202_rmdup	965240	965252		YPO_RS05330	12
GRH001.A0202_rmdup	965320	965332		YPO_RS05330	12
GRH001.A0202_rmdup	965871	965873		YPO_RS05330	2
GRH001.A0202_rmdup	966040	966058		YPO_RS05330	18
GRH001.A0202_rmdup	966259	966263		YPO_RS05330	4
GRH001.A0202_rmdup	966516	966552		YPO_RS05330	36
GRH001.A0202_rmdup	967036	967049		YPO_RS05330	13
GRH001.A0202_rmdup	970998	971004		YPO_RS05360	6
GRH001.A0202_rmdup	976659	976666		dsbC	7
GRH001.A0202_rmdup	976800	976808		dsbC	8
GRH001.A0202_rmdup	976884	976945		dsbC	61
GRH001.A0202_rmdup	980599	980600		creC	1
GRH001.A0202_rmdup	981366	981388		creC	22
GRH001.A0202_rmdup	982669	982684		YPO_RS05415	15
GRH001.A0202_rmdup	986304	986314		YPO_RS05440	10
GRH001.A0202_rmdup	986713	986766		YPO_RS05440	53
GRH001.A0202_rmdup	987139	987156		YPO_RS05440	17
GRH001.A0202_rmdup	993105	993110		gcvP	5
GRH001.A0202_rmdup	993989	993997		gcvP	8
GRH001.A0202_rmdup	994379	994385		gcvH	6
GRH001.A0202_rmdup	997004	997046		ubiI	42
GRH001.A0202_rmdup	997730	997731		ubiI	1
GRH001.A0202_rmdup	998266	998279		ubiH	13
GRH001.A0202_rmdup	999072	999082		ubiH	10
GRH001.A0202_rmdup	999155	999163		ubiH	8
GRH001.A0202_rmdup	999927	999935		pepP	8
GRH001.A0202_rmdup	1001187	1001220		YPO_RS05490	33
GRH001.A0202_rmdup	1005860	1005868		YPO_RS05520	8
GRH001.A0202_rmdup	1006173	1006177		YPO_RS05520	4
GRH001.A0202_rmdup	1006411	1006433		YPO_RS05520	22
GRH001.A0202_rmdup	1007976	1007990		argO	14
GRH001.A0202_rmdup	1011725	1011727		pgk	2
GRH001.A0202_rmdup	1012940	1012942		epd	2
GRH001.A0202_rmdup	1019295	1019306		YPO_RS05575	11
GRH001.A0202_rmdup	1019809	1019814		YPO_RS05580	5
GRH001.A0202_rmdup	1020704	1020715		speA	11
GRH001.A0202_rmdup	1025848	1025858		endA	10
GRH001.A0202_rmdup	1026539	1026541		rsmE	2
GRH001.A0202_rmdup	1027696	1027700		gshB	4
GRH001.A0202_rmdup	1029034	1029035		ruvX	1
GRH001.A0202_rmdup	1030664	1030686		aguA	22
GRH001.A0202_rmdup	1033287	1033309		YPO_RS05645	22
GRH001.A0202_rmdup	1036488	1036522		hemW	34
GRH001.A0202_rmdup	1038771	1038791		YPO_RS05675	20
GRH001.A0202_rmdup	1038894	1038895		YPO_RS05675	1
GRH001.A0202_rmdup	1039914	1039918		YPO_RS05675	4
GRH001.A0202_rmdup	1040704	1040705		YPO_RS05675	1
GRH001.A0202_rmdup	1040892	1040904		YPO_RS05675	12
GRH001.A0202_rmdup	1044447	1044495		YPO_RS05675	48
GRH001.A0202_rmdup	1045010	1045118		YPO_RS05675	108
GRH001.A0202_rmdup	1045518	1045569		YPO_RS05675	51
GRH001.A0202_rmdup	1046458	1046507		YPO_RS05675	49
GRH001.A0202_rmdup	1046584	1046595		YPO_RS05675	11
GRH001.A0202_rmdup	1046703	1046710		YPO_RS05675	7
GRH001.A0202_rmdup	1049903	1049920		trmB	17
GRH001.A0202_rmdup	1051525	1051538		mutY	13
GRH001.A0202_rmdup	1053166	1053204		mltC	38
GRH001.A0202_rmdup	1053864	1053872		YPO_RS05715	8
GRH001.A0202_rmdup	1054472	1054508		YPO_RS05715	36
GRH001.A0202_rmdup	1055262	1055271		YPO_RS05720	9
GRH001.A0202_rmdup	1055512	1055516		YPO_RS05720	4
GRH001.A0202_rmdup	1055677	1055679		YPO_RS05720	2
GRH001.A0202_rmdup	1056020	1056043		YPO_RS05720	23
GRH001.A0202_rmdup	1056310	1056315		YPO_RS05720	5
GRH001.A0202_rmdup	1056544	1056549		YPO_RS05720	5
GRH001.A0202_rmdup	1060480	1060481		YPO_RS05735	1
GRH001.A0202_rmdup	1061533	1061537		speF	4
GRH001.A0202_rmdup	1065829	1065898		YPO_RS05760	69
GRH001.A0202_rmdup	1065949	1065960		YPO_RS05760	11
GRH001.A0202_rmdup	1066256	1066261		YPO_RS05760	5
GRH001.A0202_rmdup	1066978	1066990		YPO_RS05765	12
GRH001.A0202_rmdup	1067350	1067383		YPO_RS05765	33
GRH001.A0202_rmdup	1067376	1067383		YPO_RS05770	7
GRH001.A0202_rmdup	1068116	1068177		YPO_RS05770	61
GRH001.A0202_rmdup	1068782	1068790		YPO_RS05770	8
GRH001.A0202_rmdup	1069971	1070005		YPO_RS05775	34
GRH001.A0202_rmdup	1071656	1071659		YPO_RS05785	3
GRH001.A0202_rmdup	1075551	1075556		YPO_RS05800	5
GRH001.A0202_rmdup	1075768	1075779		YPO_RS05800	11
GRH001.A0202_rmdup	1075879	1075884		YPO_RS05800	5
GRH001.A0202_rmdup	1075922	1075926		YPO_RS05800	4
GRH001.A0202_rmdup	1076027	1076030		YPO_RS05800	3
GRH001.A0202_rmdup	1076151	1076176		YPO_RS05800	25
GRH001.A0202_rmdup	1076471	1076492		YPO_RS05800	21
GRH001.A0202_rmdup	1076579	1076582		YPO_RS05800	3
GRH001.A0202_rmdup	1077030	1077055		tssH	25
GRH001.A0202_rmdup	1077759	1077791		tssH	32
GRH001.A0202_rmdup	1077850	1077864		tssH	14
GRH001.A0202_rmdup	1078002	1078035		tssH	33
GRH001.A0202_rmdup	1078369	1078407		tssH	38
GRH001.A0202_rmdup	1079560	1079569		tssH	9
GRH001.A0202_rmdup	1080046	1080054		YPO_RS05810	8
GRH001.A0202_rmdup	1080667	1080717		YPO_RS05815	50
GRH001.A0202_rmdup	1080820	1080825		YPO_RS05815	5
GRH001.A0202_rmdup	1080979	1081005		YPO_RS05815	26
GRH001.A0202_rmdup	1081241	1081251		YPO_RS05815	10
GRH001.A0202_rmdup	1081398	1081444		YPO_RS05815	46
GRH001.A0202_rmdup	1081561	1081631		YPO_RS05815	70
GRH001.A0202_rmdup	1081707	1081712		YPO_RS05815	5
GRH001.A0202_rmdup	1081862	1081904		YPO_RS05815	42
GRH001.A0202_rmdup	1082887	1082897		YPO_RS05820	10
GRH001.A0202_rmdup	1083114	1083116		tssK	2
GRH001.A0202_rmdup	1083292	1083318		tssK	26
GRH001.A0202_rmdup	1083850	1083864		tssK	14
GRH001.A0202_rmdup	1083937	1083971		tssK	34
GRH001.A0202_rmdup	1084045	1084050		tssK	5
GRH001.A0202_rmdup	1085028	1085032		tssC	4
GRH001.A0202_rmdup	1085201	1085214		tssC	13
GRH001.A0202_rmdup	1085645	1085669		tssC	24
GRH001.A0202_rmdup	1088716	1088727		YPO_RS05845	11
GRH001.A0202_rmdup	1091415	1091422		YPO_RS05855	7
GRH001.A0202_rmdup	1093556	1093561		YPO_RS05865	5
GRH001.A0202_rmdup	1094214	1094236		YPO_RS05865	22
GRH001.A0202_rmdup	1096358	1096360		YPO_RS05880	2
GRH001.A0202_rmdup	1096630	1096633		YPO_RS05880	3
GRH001.A0202_rmdup	1096806	1096845		YPO_RS05880	39
GRH001.A0202_rmdup	1096892	1096928		YPO_RS05880	36
GRH001.A0202_rmdup	1096968	1096974		YPO_RS05880	6
GRH001.A0202_rmdup	1099954	1099966		YPO_RS05890	12
GRH001.A0202_rmdup	1100463	1100505		iucC	42
GRH001.A0202_rmdup	1100704	1100706		iucC	2
GRH001.A0202_rmdup	1103045	1103047		YPO_RS05900	2
GRH001.A0202_rmdup	1103630	1103641		YPO_RS05905	11
GRH001.A0202_rmdup	1104913	1104933		YPO_RS05905	20
GRH001.A0202_rmdup	1105117	1105125		YPO_RS05905	8
GRH001.A0202_rmdup	1106210	1106219		YPO_RS05910	9
GRH001.A0202_rmdup	1106998	1106999		YPO_RS05910	1
GRH001.A0202_rmdup	1107551	1107555		YPO_RS05915	4
GRH001.A0202_rmdup	1109881	1109883		YPO_RS05920	2
GRH001.A0202_rmdup	1110032	1110034		YPO_RS05920	2
GRH001.A0202_rmdup	1110743	1110752		YPO_RS05920	9
GRH001.A0202_rmdup	1113677	1113685		YPO_RS05935	8
GRH001.A0202_rmdup	1114185	1114189		YPO_RS05935	4
GRH001.A0202_rmdup	1114330	1114375		YPO_RS05935	45
GRH001.A0202_rmdup	1115286	1115303		YPO_RS05935	17
GRH001.A0202_rmdup	1115465	1115484		YPO_RS05935	19
GRH001.A0202_rmdup	1116074	1116075		YPO_RS05935	1
GRH001.A0202_rmdup	1116365	1116372		YPO_RS05935	7
GRH001.A0202_rmdup	1116960	1117066		YPO_RS05940	106
GRH001.A0202_rmdup	1117270	1117288		YPO_RS05940	18
GRH001.A0202_rmdup	1118077	1118091		YPO_RS05940	14
GRH001.A0202_rmdup	1118450	1118452		YPO_RS05945	2
GRH001.A0202_rmdup	1118897	1118899		YPO_RS05945	2
GRH001.A0202_rmdup	1120134	1120135		yapH	1
GRH001.A0202_rmdup	1121102	1121142		yapH	40
GRH001.A0202_rmdup	1121567	1121572		yapH	5
GRH001.A0202_rmdup	1122004	1122014		yapH	10
GRH001.A0202_rmdup	1122175	1122218		yapH	43
GRH001.A0202_rmdup	1122618	1122672		yapH	54
GRH001.A0202_rmdup	1123248	1123263		yapH	15
GRH001.A0202_rmdup	1123626	1123675		yapH	49
GRH001.A0202_rmdup	1123706	1123716		yapH	10
GRH001.A0202_rmdup	1123817	1123838		yapH	21
GRH001.A0202_rmdup	1123967	1124002		yapH	35
GRH001.A0202_rmdup	1124063	1124072		yapH	9
GRH001.A0202_rmdup	1124133	1124292		yapH	159
GRH001.A0202_rmdup	1124346	1124495		yapH	149
GRH001.A0202_rmdup	1124596	1124611		yapH	15
GRH001.A0202_rmdup	1124678	1124907		yapH	229
GRH001.A0202_rmdup	1124979	1124984		yapH	5
GRH001.A0202_rmdup	1125120	1125394		yapH	274
GRH001.A0202_rmdup	1125433	1125603		yapH	170
GRH001.A0202_rmdup	1125638	1125702		yapH	64
GRH001.A0202_rmdup	1125978	1126010		yapH	32
GRH001.A0202_rmdup	1126667	1126671		yapH	4
GRH001.A0202_rmdup	1127127	1127132		yapH	5
GRH001.A0202_rmdup	1127630	1127650		yapH	20
GRH001.A0202_rmdup	1127821	1127822		yapH	1
GRH001.A0202_rmdup	1128114	1128121		yapH	7
GRH001.A0202_rmdup	1129638	1129639		yapH	1
GRH001.A0202_rmdup	1129919	1129921		yapH	2
GRH001.A0202_rmdup	1129987	1130018		yapH	31
GRH001.A0202_rmdup	1130052	1130097		yapH	45
GRH001.A0202_rmdup	1133650	1133669		YPO_RS05965	19
GRH001.A0202_rmdup	1133887	1133936		YPO_RS05965	49
GRH001.A0202_rmdup	1134575	1134621		YPO_RS05970	46
GRH001.A0202_rmdup	1138556	1138569		YPO_RS05975	13
GRH001.A0202_rmdup	1138802	1138817		pepT	15
GRH001.A0202_rmdup	1138954	1138963		pepT	9
GRH001.A0202_rmdup	1140365	1140446		YPO_RS05985	81
GRH001.A0202_rmdup	1141419	1141421		YPO_RS05985	2
GRH001.A0202_rmdup	1142435	1142437		YPO_RS05985	2
GRH001.A0202_rmdup	1150264	1150267		recC	3
GRH001.A0202_rmdup	1153293	1153298		ptrA	5
GRH001.A0202_rmdup	1154164	1154191		ptrA	27
GRH001.A0202_rmdup	1154261	1154263		ptrA	2
GRH001.A0202_rmdup	1154878	1154889		ptrA	11
GRH001.A0202_rmdup	1156043	1156066		recB	23
GRH001.A0202_rmdup	1157828	1157829		recB	1
GRH001.A0202_rmdup	1157978	1157981		recB	3
GRH001.A0202_rmdup	1158772	1158775		recB	3
GRH001.A0202_rmdup	1158851	1158860		recB	9
GRH001.A0202_rmdup	1161849	1161858		argA	9
GRH001.A0202_rmdup	1162723	1162727		argA	4
GRH001.A0202_rmdup	1163093	1163094		argA	1
GRH001.A0202_rmdup	1163768	1163811		YPO_RS06050	43
GRH001.A0202_rmdup	1165673	1165674		mltA	1
GRH001.A0202_rmdup	1166396	1166436		mltA	40
GRH001.A0202_rmdup	1166942	1166951		tcdA	9
GRH001.A0202_rmdup	1167287	1167292		tcdA	5
GRH001.A0202_rmdup	1167632	1167676		csdE	44
GRH001.A0202_rmdup	1171291	1171300		YPO_RS06095	9
GRH001.A0202_rmdup	1173170	1173181		xni	11
GRH001.A0202_rmdup	1173330	1173350		xni	20
GRH001.A0202_rmdup	1179059	1179084		truC	25
GRH001.A0202_rmdup	1179186	1179208		truC	22
GRH001.A0202_rmdup	1181876	1181879		glnD	3
GRH001.A0202_rmdup	1183392	1183407		glnD	15
GRH001.A0202_rmdup	1186666	1186674		tsf	8
GRH001.A0202_rmdup	1187687	1187688		pyrH	1
GRH001.A0202_rmdup	1196357	1196363		skp	6
GRH001.A0202_rmdup	1198462	1198488		lpxA	26
GRH001.A0202_rmdup	1202213	1202245		dnaE	32
GRH001.A0202_rmdup	1202973	1202991		dnaE	18
GRH001.A0202_rmdup	1206338	1206339		tilS	1
GRH001.A0202_rmdup	1206576	1206584		tilS	8
GRH001.A0202_rmdup	1207254	1207255		tilS	1
GRH001.A0202_rmdup	1209407	1209424		arfB	17
GRH001.A0202_rmdup	1209634	1209639		arfB	5
GRH001.A0202_rmdup	1212149	1212199		proS	50
GRH001.A0202_rmdup	1212277	1212288		proS	11
GRH001.A0202_rmdup	1212766	1212768		tsaA	2
GRH001.A0202_rmdup	1212998	1213000		tsaA	2
GRH001.A0202_rmdup	1213111	1213117		tsaA	6
GRH001.A0202_rmdup	1214690	1214724		metI	34
GRH001.A0202_rmdup	1217380	1217414		YPO_RS06325	34
GRH001.A0202_rmdup	1226977	1226995		mltD	18
GRH001.A0202_rmdup	1230572	1230586		YPO_RS06400	14
GRH001.A0202_rmdup	1231213	1231215		YPO_RS06400	2
GRH001.A0202_rmdup	1235041	1235063		YPO_RS06425	22
GRH001.A0202_rmdup	1235077	1235391		YPO_RS06430	314
GRH001.A0202_rmdup	1235740	1236828		YPO_RS06435	1088
GRH001.A0202_rmdup	1236825	1237784		YPO_RS06440	959
GRH001.A0202_rmdup	1237777	1238319		YPO_RS06445	542
GRH001.A0202_rmdup	1238319	1238470		YPO_RS06450	151
GRH001.A0202_rmdup	1238524	1239399		YPO_RS06455	875
GRH001.A0202_rmdup	1240207	1240434		YPO_RS06460	227
GRH001.A0202_rmdup	1240636	1241266		YPO_RS06465	630
GRH001.A0202_rmdup	1241342	1242266		YPO_RS06465	924
GRH001.A0202_rmdup	1242317	1242593		YPO_RS06470	276
GRH001.A0202_rmdup	1242669	1243405		YPO_RS06470	736
GRH001.A0202_rmdup	1243484	1244336		YPO_RS06475	852
GRH001.A0202_rmdup	1244405	1244413		YPO_RS06475	8
GRH001.A0202_rmdup	1244482	1244683		YPO_RS06475	201
GRH001.A0202_rmdup	1246837	1246880		YPO_RS06495	43
GRH001.A0202_rmdup	1248207	1248210		recN	3
GRH001.A0202_rmdup	1249707	1249708		nadK	1
GRH001.A0202_rmdup	1250852	1250859		grpE	7
GRH001.A0202_rmdup	1251906	1251930		YPO_RS06525	24
GRH001.A0202_rmdup	1252059	1252087		YPO_RS06525	28
GRH001.A0202_rmdup	1252505	1252524		YPO_RS06525	19
GRH001.A0202_rmdup	1254245	1254275		sdhA	30
GRH001.A0202_rmdup	1254896	1254898		sdhA	2
GRH001.A0202_rmdup	1255388	1255408		sdhA	20
GRH001.A0202_rmdup	1257706	1257723		sucA	17
GRH001.A0202_rmdup	1257891	1257904		sucA	13
GRH001.A0202_rmdup	1258790	1258802		sucA	12
GRH001.A0202_rmdup	1262800	1262810		sucD	10
GRH001.A0202_rmdup	1267324	1267330		ybgC	6
GRH001.A0202_rmdup	1268591	1268595		tolR	4
GRH001.A0202_rmdup	1269075	1269078		tolA	3
GRH001.A0202_rmdup	1269570	1269649		tolA	79
GRH001.A0202_rmdup	1269941	1269948		tolA	7
GRH001.A0202_rmdup	1273261	1273265		YPO_RS06635	4
GRH001.A0202_rmdup	1274342	1274398		nadA	56
GRH001.A0202_rmdup	1274541	1274550		nadA	9
GRH001.A0202_rmdup	1275733	1275742		zitB	9
GRH001.A0202_rmdup	1275873	1275874		zitB	1
GRH001.A0202_rmdup	1276292	1276320		zitB	28
GRH001.A0202_rmdup	1280100	1280113		YPO_RS06670	13
GRH001.A0202_rmdup	1282978	1282979		YPO_RS06690	1
GRH001.A0202_rmdup	1286064	1286168		galE	104
GRH001.A0202_rmdup	1287926	1287962		modF	36
GRH001.A0202_rmdup	1289680	1289687		modE	7
GRH001.A0202_rmdup	1291765	1291774		modB	9
GRH001.A0202_rmdup	1292384	1292414		modC	30
GRH001.A0202_rmdup	1292907	1292913		modC	6
GRH001.A0202_rmdup	1293013	1293045		modC	32
GRH001.A0202_rmdup	1293249	1293250		modC	1
GRH001.A0202_rmdup	1293842	1293863		YPO_RS06745	21
GRH001.A0202_rmdup	1295343	1295356		pgl	13
GRH001.A0202_rmdup	1296112	1296120		bioA	8
GRH001.A0202_rmdup	1296542	1296550		bioA	8
GRH001.A0202_rmdup	1297767	1297783		bioB	16
GRH001.A0202_rmdup	1298275	1298295		bioF	20
GRH001.A0202_rmdup	1298618	1298628		bioF	10
GRH001.A0202_rmdup	1298697	1298729		bioF	32
GRH001.A0202_rmdup	1298770	1298778		bioF	8
GRH001.A0202_rmdup	1299154	1299166		bioF	12
GRH001.A0202_rmdup	1299263	1299266		bioC	3
GRH001.A0202_rmdup	1300122	1300132		bioD	10
GRH001.A0202_rmdup	1300315	1300320		bioD	5
GRH001.A0202_rmdup	1301537	1301544		YPO_RS06780	7
GRH001.A0202_rmdup	1302815	1302836		uvrB	21
GRH001.A0202_rmdup	1306214	1306228		yvcK	14
GRH001.A0202_rmdup	1307531	1307532		moaA	1
GRH001.A0202_rmdup	1307700	1307704		moaA	4
GRH001.A0202_rmdup	1308253	1308281		moaC	28
GRH001.A0202_rmdup	1308526	1308555		moaD	29
GRH001.A0202_rmdup	1308613	1308638		moaD	25
GRH001.A0202_rmdup	1309343	1309361		YPO_RS06820	18
GRH001.A0202_rmdup	1311088	1311101		betA	13
GRH001.A0202_rmdup	1311873	1311885		betA	12
GRH001.A0202_rmdup	1311959	1311985		betA	26
GRH001.A0202_rmdup	1313362	1313424		betB	62
GRH001.A0202_rmdup	1322397	1322404		YPO_RS06875	7
GRH001.A0202_rmdup	1322840	1322842		YPO_RS06875	2
GRH001.A0202_rmdup	1323432	1323437		dusC	5
GRH001.A0202_rmdup	1326298	1326306		dld	8
GRH001.A0202_rmdup	1329579	1329601		YPO_RS06910	22
GRH001.A0202_rmdup	1331976	1331978		phnD	2
GRH001.A0202_rmdup	1332337	1332383		phnD	46
GRH001.A0202_rmdup	1334080	1334092		phnE	12
GRH001.A0202_rmdup	1334750	1334763		YPO_RS06940	13
GRH001.A0202_rmdup	1335837	1335850		urtA	13
GRH001.A0202_rmdup	1336047	1336050		urtA	3
GRH001.A0202_rmdup	1337583	1337589		urtB	6
GRH001.A0202_rmdup	1339809	1339830		urtD	21
GRH001.A0202_rmdup	1341709	1341741		YPO_RS06970	32
GRH001.A0202_rmdup	1342299	1342314		YPO_RS06970	15
GRH001.A0202_rmdup	1344031	1344039		sseA	8
GRH001.A0202_rmdup	1347222	1347228		YPO_RS06995	6
GRH001.A0202_rmdup	1348633	1348640		YPO_RS07000	7
GRH001.A0202_rmdup	1350137	1350163		adiC	26
GRH001.A0202_rmdup	1350984	1351037		adiC	53
GRH001.A0202_rmdup	1352011	1352017		YPO_RS07015	6
GRH001.A0202_rmdup	1352850	1352860		YPO_RS07015	10
GRH001.A0202_rmdup	1355837	1355839		ompF2	2
GRH001.A0202_rmdup	1355998	1356022		ompF2	24
GRH001.A0202_rmdup	1357668	1357676		dinG	8
GRH001.A0202_rmdup	1360449	1360460		YPO_RS07040	11
GRH001.A0202_rmdup	1361782	1361790		tyrP	8
GRH001.A0202_rmdup	1364479	1364486		YPO_RS07055	7
GRH001.A0202_rmdup	1364538	1364553		YPO_RS07055	15
GRH001.A0202_rmdup	1364934	1364945		eco	11
GRH001.A0202_rmdup	1366270	1366282		nrdB	12
GRH001.A0202_rmdup	1368592	1368603		nrdA	11
GRH001.A0202_rmdup	1371393	1371396		gyrA	3
GRH001.A0202_rmdup	1371808	1371815		gyrA	7
GRH001.A0202_rmdup	1374748	1374761		rcsC	13
GRH001.A0202_rmdup	1380297	1380298		YPO_RS07110	1
GRH001.A0202_rmdup	1380538	1380569		YPO_RS07110	31
GRH001.A0202_rmdup	1384983	1384984		ampH	1
GRH001.A0202_rmdup	1385426	1385454		ampH	28
GRH001.A0202_rmdup	1390106	1390127		YPO_RS07150	21
GRH001.A0202_rmdup	1390204	1390220		YPO_RS07150	16
GRH001.A0202_rmdup	1390798	1390837		YPO_RS07150	39
GRH001.A0202_rmdup	1391987	1392016		ycoA	29
GRH001.A0202_rmdup	1394950	1394956		YPO_RS07175	6
GRH001.A0202_rmdup	1395209	1395217		YPO_RS07175	8
GRH001.A0202_rmdup	1395311	1395313		YPO_RS07175	2
GRH001.A0202_rmdup	1396650	1396652		YPO_RS07185	2
GRH001.A0202_rmdup	1397638	1397644		YPO_RS07190	6
GRH001.A0202_rmdup	1397900	1397950		YPO_RS07190	50
GRH001.A0202_rmdup	1398186	1398200		YPO_RS07190	14
GRH001.A0202_rmdup	1399704	1399705		YPO_RS07200	1
GRH001.A0202_rmdup	1400337	1400359		YPO_RS07210	22
GRH001.A0202_rmdup	1400692	1400695		YPO_RS07210	3
GRH001.A0202_rmdup	1402042	1402069		YPO_RS07220	27
GRH001.A0202_rmdup	1404170	1404176		YPO_RS07230	6
GRH001.A0202_rmdup	1404743	1404756		YPO_RS07230	13
GRH001.A0202_rmdup	1404826	1404867		YPO_RS07230	41
GRH001.A0202_rmdup	1404927	1404935		YPO_RS07230	8
GRH001.A0202_rmdup	1405204	1405208		YPO_RS07230	4
GRH001.A0202_rmdup	1405463	1405475		YPO_RS07235	12
GRH001.A0202_rmdup	1405579	1405607		YPO_RS07235	28
GRH001.A0202_rmdup	1405995	1406011		YPO_RS07235	16
GRH001.A0202_rmdup	1406114	1406117		YPO_RS07235	3
GRH001.A0202_rmdup	1408787	1408794		YPO_RS07255	7
GRH001.A0202_rmdup	1410914	1410947		YPO_RS07270	33
GRH001.A0202_rmdup	1411646	1411657		YPO_RS07275	11
GRH001.A0202_rmdup	1415132	1415135		YPO_RS07290	3
GRH001.A0202_rmdup	1415252	1415277		YPO_RS07290	25
GRH001.A0202_rmdup	1416867	1416874		YPO_RS07305	7
GRH001.A0202_rmdup	1417750	1417753		YPO_RS07305	3
GRH001.A0202_rmdup	1418751	1418754		YPO_RS07310	3
GRH001.A0202_rmdup	1428481	1428492		yejF	11
GRH001.A0202_rmdup	1428494	1428495		YPO_RS07355	1
GRH001.A0202_rmdup	1430512	1430518		YPO_RS07360	6
GRH001.A0202_rmdup	1431835	1431839		YPO_RS07365	4
GRH001.A0202_rmdup	1433400	1433405		YPO_RS07370	5
GRH001.A0202_rmdup	1433928	1433931		YPO_RS07370	3
GRH001.A0202_rmdup	1436056	1436057		YPO_RS07380	1
GRH001.A0202_rmdup	1436370	1436372		YPO_RS07380	2
GRH001.A0202_rmdup	1439857	1439881		YPO_RS07395	24
GRH001.A0202_rmdup	1440046	1440060		YPO_RS07395	14
GRH001.A0202_rmdup	1443387	1443391		mtr	4
GRH001.A0202_rmdup	1445162	1445170		YPO_RS07420	8
GRH001.A0202_rmdup	1445627	1445639		YPO_RS07420	12
GRH001.A0202_rmdup	1446003	1446021		YPO_RS07425	18
GRH001.A0202_rmdup	1446746	1446747		YPO_RS07425	1
GRH001.A0202_rmdup	1446956	1446967		YPO_RS07430	11
GRH001.A0202_rmdup	1447123	1447132		YPO_RS07430	9
GRH001.A0202_rmdup	1447832	1447837		YPO_RS07430	5
GRH001.A0202_rmdup	1448059	1448064		YPO_RS07430	5
GRH001.A0202_rmdup	1448728	1448729		YPO_RS07435	1
GRH001.A0202_rmdup	1448976	1448977		YPO_RS07435	1
GRH001.A0202_rmdup	1449393	1449396		YPO_RS07435	3
GRH001.A0202_rmdup	1449837	1449848		YPO_RS07435	11
GRH001.A0202_rmdup	1450000	1450023		xylB	23
GRH001.A0202_rmdup	1450191	1450205		xylB	14
GRH001.A0202_rmdup	1450669	1450687		xylB	18
GRH001.A0202_rmdup	1450970	1450978		xylB	8
GRH001.A0202_rmdup	1451370	1451423		xylB	53
GRH001.A0202_rmdup	1452031	1452040		rpiA	9
GRH001.A0202_rmdup	1452868	1452876		YPO_RS07450	8
GRH001.A0202_rmdup	1453872	1453883		YPO_RS07455	11
GRH001.A0202_rmdup	1454291	1454342		YPO_RS07455	51
GRH001.A0202_rmdup	1454549	1454617		YPO_RS07455	68
GRH001.A0202_rmdup	1455952	1455969		YPO_RS07460	17
GRH001.A0202_rmdup	1456294	1456314		YPO_RS07465	20
GRH001.A0202_rmdup	1458974	1458978		fruK	4
GRH001.A0202_rmdup	1459120	1459123		fruA	3
GRH001.A0202_rmdup	1459218	1459226		fruA	8
GRH001.A0202_rmdup	1459350	1459361		fruA	11
GRH001.A0202_rmdup	1460393	1460400		fruA	7
GRH001.A0202_rmdup	1460623	1460629		fruA	6
GRH001.A0202_rmdup	1460717	1460736		fruA	19
GRH001.A0202_rmdup	1461349	1461379		YPO_RS07485	30
GRH001.A0202_rmdup	1461542	1461570		YPO_RS07485	28
GRH001.A0202_rmdup	1462125	1462132		YPO_RS07490	7
GRH001.A0202_rmdup	1463156	1463162		psaA	6
GRH001.A0202_rmdup	1463379	1463446		YPO_RS07500	67
GRH001.A0202_rmdup	1465084	1465098		psaC	14
GRH001.A0202_rmdup	1465342	1465422		psaC	80
GRH001.A0202_rmdup	1465977	1466000		psaC	23
GRH001.A0202_rmdup	1467152	1467153		nfo	1
GRH001.A0202_rmdup	1473385	1473386		YPO_RS07530	1
GRH001.A0202_rmdup	1475260	1475266		YPO_RS07540	6
GRH001.A0202_rmdup	1476503	1476516		YPO_RS07545	13
GRH001.A0202_rmdup	1477429	1477431		YPO_RS07545	2
GRH001.A0202_rmdup	1477532	1477534		YPO_RS07545	2
GRH001.A0202_rmdup	1479044	1479056		YPO_RS07555	12
GRH001.A0202_rmdup	1480590	1480595		YPO_RS07560	5
GRH001.A0202_rmdup	1480692	1480700		YPO_RS07560	8
GRH001.A0202_rmdup	1482326	1482336		YPO_RS07570	10
GRH001.A0202_rmdup	1484805	1484817		YPO_RS07580	12
GRH001.A0202_rmdup	1485996	1486008		YPO_RS07585	12
GRH001.A0202_rmdup	1492081	1492092		YPO_RS07610	11
GRH001.A0202_rmdup	1493026	1493040		YPO_RS07610	14
GRH001.A0202_rmdup	1498169	1498194		potG	25
GRH001.A0202_rmdup	1499911	1499951		potI	40
GRH001.A0202_rmdup	1501229	1501232		rlmC	3
GRH001.A0202_rmdup	1502025	1502033		rlmC	8
GRH001.A0202_rmdup	1505619	1505634		YPO_RS07680	15
GRH001.A0202_rmdup	1507487	1507507		YPO_RS07690	20
GRH001.A0202_rmdup	1508009	1508028		YPO_RS07690	19
GRH001.A0202_rmdup	1510143	1510151		YPO_RS07710	8
GRH001.A0202_rmdup	1510631	1510653		YPO_RS07715	22
GRH001.A0202_rmdup	1510944	1511005		YPO_RS07715	61
GRH001.A0202_rmdup	1511081	1511100		YPO_RS07720	19
GRH001.A0202_rmdup	1511409	1511420		YPO_RS07720	11
GRH001.A0202_rmdup	1512236	1512238		YPO_RS07720	2
GRH001.A0202_rmdup	1513781	1513785		artM	4
GRH001.A0202_rmdup	1516812	1516813		YPO_RS07755	1
GRH001.A0202_rmdup	1517058	1517066		YPO_RS07755	8
GRH001.A0202_rmdup	1520151	1520164		YPO_RS07770	13
GRH001.A0202_rmdup	1521001	1521011		ltaE	10
GRH001.A0202_rmdup	1522362	1522402		poxB	40
GRH001.A0202_rmdup	1522433	1522440		poxB	7
GRH001.A0202_rmdup	1524175	1524194		hcr	19
GRH001.A0202_rmdup	1524648	1524652		hcr	4
GRH001.A0202_rmdup	1526040	1526043		hcp	3
GRH001.A0202_rmdup	1528401	1528410		YPO_RS07800	9
GRH001.A0202_rmdup	1532134	1532153		macA	19
GRH001.A0202_rmdup	1534430	1534433		cspD	3
GRH001.A0202_rmdup	1535962	1535964		clpA	2
GRH001.A0202_rmdup	1536968	1536979		clpA	11
GRH001.A0202_rmdup	1539708	1539765		aat	57
GRH001.A0202_rmdup	1541185	1541200		cydC	15
GRH001.A0202_rmdup	1541641	1541647		cydC	6
GRH001.A0202_rmdup	1543019	1543046		cydD	27
GRH001.A0202_rmdup	1543414	1543431		cydD	17
GRH001.A0202_rmdup	1544845	1544852		trxB	7
GRH001.A0202_rmdup	1546510	1546519		YPO_RS07870	9
GRH001.A0202_rmdup	1548620	1548621		YPO_RS07870	1
GRH001.A0202_rmdup	1548891	1548898		YPO_RS07870	7
GRH001.A0202_rmdup	1552038	1552052		YPO_RS07880	14
GRH001.A0202_rmdup	1552268	1552302		YPO_RS07880	34
GRH001.A0202_rmdup	1553156	1553160		serS	4
GRH001.A0202_rmdup	1559248	1559255		pflB	7
GRH001.A0202_rmdup	1564318	1564338		ansB	20
GRH001.A0202_rmdup	1566489	1566496		YPO_RS07930	7
GRH001.A0202_rmdup	1567694	1567711		YPO_RS07930	17
GRH001.A0202_rmdup	1567782	1567783		YPO_RS07930	1
GRH001.A0202_rmdup	1569019	1569026		serC	7
GRH001.A0202_rmdup	1570055	1570063		aroA	8
GRH001.A0202_rmdup	1570226	1570234		aroA	8
GRH001.A0202_rmdup	1570888	1570909		aroA	21
GRH001.A0202_rmdup	1571601	1571606		cmk	5
GRH001.A0202_rmdup	1575200	1575202		YPO_RS07960	2
GRH001.A0202_rmdup	1575946	1575947		YPO_RS07960	1
GRH001.A0202_rmdup	1576464	1576467		YPO_RS07960	3
GRH001.A0202_rmdup	1577125	1577141		msbA	16
GRH001.A0202_rmdup	1577503	1577515		msbA	12
GRH001.A0202_rmdup	1579122	1579123		lpxK	1
GRH001.A0202_rmdup	1579366	1579373		lpxK	7
GRH001.A0202_rmdup	1579450	1579453		lpxK	3
GRH001.A0202_rmdup	1583078	1583095		kdsB	17
GRH001.A0202_rmdup	1584444	1584460		YPO_RS07995	16
GRH001.A0202_rmdup	1588107	1588108		mukE	1
GRH001.A0202_rmdup	1589681	1589702		mukB	21
GRH001.A0202_rmdup	1590242	1590259		mukB	17
GRH001.A0202_rmdup	1590401	1590450		mukB	49
GRH001.A0202_rmdup	1594795	1594798		ldtD	3
GRH001.A0202_rmdup	1594844	1594864		ldtD	20
GRH001.A0202_rmdup	1595629	1595632		ldtD	3
GRH001.A0202_rmdup	1595739	1595776		ldtD	37
GRH001.A0202_rmdup	1598844	1598853		YPO_RS08045	9
GRH001.A0202_rmdup	1610252	1610267		YPO_RS08080	15
GRH001.A0202_rmdup	1611131	1611150		rlmKL	19
GRH001.A0202_rmdup	1611440	1611450		rlmKL	10
GRH001.A0202_rmdup	1613571	1613592		YPO_RS08090	21
GRH001.A0202_rmdup	1614795	1614803		pqiA	8
GRH001.A0202_rmdup	1618623	1618660		rmf	37
GRH001.A0202_rmdup	1622982	1622984		YPO_RS08140	2
GRH001.A0202_rmdup	1624852	1624856		YPO_RS08150	4
GRH001.A0202_rmdup	1627192	1627199		ompA	7
GRH001.A0202_rmdup	1627865	1627876		ompA	11
GRH001.A0202_rmdup	1630283	1630284		yccS	1
GRH001.A0202_rmdup	1633886	1633910		helD	24
GRH001.A0202_rmdup	1634406	1634420		helD	14
GRH001.A0202_rmdup	1634652	1634667		helD	15
GRH001.A0202_rmdup	1635762	1635763		YPO_RS08200	1
GRH001.A0202_rmdup	1636678	1636680		YPO_RS08205	2
GRH001.A0202_rmdup	1637108	1637122		hspQ	14
GRH001.A0202_rmdup	1638905	1638919		yccX	14
GRH001.A0202_rmdup	1644065	1644082		YPO_RS08245	17
GRH001.A0202_rmdup	1644493	1644503		YPO_RS08245	10
GRH001.A0202_rmdup	1647598	1647674		YPO_RS08260	76
GRH001.A0202_rmdup	1647939	1647947		YPO_RS08260	8
GRH001.A0202_rmdup	1648495	1648503		YPO_RS08265	8
GRH001.A0202_rmdup	1649579	1649588		YPO_RS08270	9
GRH001.A0202_rmdup	1649605	1649606		YPO_RS08270	1
GRH001.A0202_rmdup	1651092	1651096		YPO_RS08275	4
GRH001.A0202_rmdup	1653154	1653156		YPO_RS08290	2
GRH001.A0202_rmdup	1654930	1654931		YPO_RS08305	1
GRH001.A0202_rmdup	1655254	1655285		YPO_RS08305	31
GRH001.A0202_rmdup	1656770	1656774		tssB	4
GRH001.A0202_rmdup	1657135	1657143		tssC	8
GRH001.A0202_rmdup	1657609	1657622		tssC	13
GRH001.A0202_rmdup	1658260	1658288		tssC	28
GRH001.A0202_rmdup	1658760	1658781		tssK	21
GRH001.A0202_rmdup	1658839	1658853		tssK	14
GRH001.A0202_rmdup	1658946	1658960		tssK	14
GRH001.A0202_rmdup	1659284	1659310		tssK	26
GRH001.A0202_rmdup	1659521	1659536		tssK	15
GRH001.A0202_rmdup	1659913	1659923		YPO_RS08325	10
GRH001.A0202_rmdup	1660245	1660247		YPO_RS08325	2
GRH001.A0202_rmdup	1660872	1660894		YPO_RS08330	22
GRH001.A0202_rmdup	1661088	1661103		YPO_RS08330	15
GRH001.A0202_rmdup	1661179	1661225		YPO_RS08330	46
GRH001.A0202_rmdup	1661359	1661409		YPO_RS08330	50
GRH001.A0202_rmdup	1661557	1661569		YPO_RS08330	12
GRH001.A0202_rmdup	1661846	1661868		YPO_RS08330	22
GRH001.A0202_rmdup	1662097	1662126		YPO_RS08330	29
GRH001.A0202_rmdup	1662175	1662186		YPO_RS08330	11
GRH001.A0202_rmdup	1662318	1662328		YPO_RS08335	10
GRH001.A0202_rmdup	1663628	1663637		tssH	9
GRH001.A0202_rmdup	1664165	1664177		tssH	12
GRH001.A0202_rmdup	1665326	1665432		tssH	106
GRH001.A0202_rmdup	1665589	1665629		tssH	40
GRH001.A0202_rmdup	1665853	1665871		YPO_RS08345	18
GRH001.A0202_rmdup	1665963	1665974		YPO_RS08345	11
GRH001.A0202_rmdup	1666061	1666073		YPO_RS08345	12
GRH001.A0202_rmdup	1666147	1666173		YPO_RS08345	26
GRH001.A0202_rmdup	1666277	1666309		YPO_RS08345	32
GRH001.A0202_rmdup	1666572	1666620		YPO_RS08345	48
GRH001.A0202_rmdup	1666960	1666961		YPO_RS08345	1
GRH001.A0202_rmdup	1667118	1667123		YPO_RS08345	5
GRH001.A0202_rmdup	1667481	1667482		YPO_RS08345	1
GRH001.A0202_rmdup	1670490	1670491		YPO_RS08355	1
GRH001.A0202_rmdup	1670573	1670592		YPO_RS08355	19
GRH001.A0202_rmdup	1670935	1670941		YPO_RS08355	6
GRH001.A0202_rmdup	1674338	1674357		YPO_RS08370	19
GRH001.A0202_rmdup	1676905	1676918		YPO_RS08380	13
GRH001.A0202_rmdup	1677072	1677083		YPO_RS08380	11
GRH001.A0202_rmdup	1677480	1677544		YPO_RS08380	64
GRH001.A0202_rmdup	1677780	1677828		YPO_RS08380	48
GRH001.A0202_rmdup	1678072	1678077		YPO_RS08385	5
GRH001.A0202_rmdup	1678280	1678350		YPO_RS08385	70
GRH001.A0202_rmdup	1678453	1678462		YPO_RS08385	9
GRH001.A0202_rmdup	1678590	1678650		YPO_RS08385	60
GRH001.A0202_rmdup	1678769	1678791		YPO_RS08385	22
GRH001.A0202_rmdup	1678929	1678970		YPO_RS08385	41
GRH001.A0202_rmdup	1679482	1679506		YPO_RS08385	24
GRH001.A0202_rmdup	1679687	1679697		YPO_RS08385	10
GRH001.A0202_rmdup	1680190	1680200		YPO_RS08385	10
GRH001.A0202_rmdup	1680300	1680323		YPO_RS08385	23
GRH001.A0202_rmdup	1680434	1680465		YPO_RS08385	31
GRH001.A0202_rmdup	1681288	1681304		YPO_RS08385	16
GRH001.A0202_rmdup	1681391	1681393		tssA	2
GRH001.A0202_rmdup	1681585	1681623		tssA	38
GRH001.A0202_rmdup	1681699	1681750		tssA	51
GRH001.A0202_rmdup	1682094	1682100		tssA	6
GRH001.A0202_rmdup	1682326	1682353		tssA	27
GRH001.A0202_rmdup	1682466	1682494		tssA	28
GRH001.A0202_rmdup	1682652	1682685		tssA	33
GRH001.A0202_rmdup	1683458	1683489		YPO_RS08395	31
GRH001.A0202_rmdup	1683903	1683915		YPO_RS08395	12
GRH001.A0202_rmdup	1684015	1684025		YPO_RS08395	10
GRH001.A0202_rmdup	1684040	1684147		YPO_RS08400	107
GRH001.A0202_rmdup	1684227	1684234		YPO_RS08400	7
GRH001.A0202_rmdup	1684425	1684428		YPO_RS08400	3
GRH001.A0202_rmdup	1684825	1684866		tssF	41
GRH001.A0202_rmdup	1685001	1685002		tssF	1
GRH001.A0202_rmdup	1685152	1685228		tssF	76
GRH001.A0202_rmdup	1685275	1685363		tssF	88
GRH001.A0202_rmdup	1685766	1685811		tssF	45
GRH001.A0202_rmdup	1685870	1685895		tssF	25
GRH001.A0202_rmdup	1686033	1686037		tssF	4
GRH001.A0202_rmdup	1686117	1686187		tssF	70
GRH001.A0202_rmdup	1687330	1687348		tssG	18
GRH001.A0202_rmdup	1687614	1687618		tssJ	4
GRH001.A0202_rmdup	1687787	1687791		tssJ	4
GRH001.A0202_rmdup	1687984	1688012		tssJ	28
GRH001.A0202_rmdup	1688285	1688330		tssE	45
GRH001.A0202_rmdup	1688389	1688478		tssE	89
GRH001.A0202_rmdup	1688633	1688670		YPO_RS08425	37
GRH001.A0202_rmdup	1688919	1688953		YPO_RS08425	34
GRH001.A0202_rmdup	1689219	1689222		YPO_RS08425	3
GRH001.A0202_rmdup	1689498	1689512		YPO_RS08425	14
GRH001.A0202_rmdup	1692027	1692040		YPO_RS08435	13
GRH001.A0202_rmdup	1692166	1692169		YPO_RS08435	3
GRH001.A0202_rmdup	1693326	1693336		YPO_RS08440	10
GRH001.A0202_rmdup	1693776	1693778		YPO_RS08440	2
GRH001.A0202_rmdup	1693877	1693883		YPO_RS08440	6
GRH001.A0202_rmdup	1694420	1694439		YPO_RS08445	19
GRH001.A0202_rmdup	1695901	1695903		moeB	2
GRH001.A0202_rmdup	1696246	1696248		moeA	2
GRH001.A0202_rmdup	1696413	1696421		moeA	8
GRH001.A0202_rmdup	1696616	1696638		moeA	22
GRH001.A0202_rmdup	1699110	1699126		darE	16
GRH001.A0202_rmdup	1699893	1699895		darC	2
GRH001.A0202_rmdup	1700329	1700398		darC	69
GRH001.A0202_rmdup	1701116	1701128		darC	12
GRH001.A0202_rmdup	1701548	1701552		darB	4
GRH001.A0202_rmdup	1701864	1701866		darB	2
GRH001.A0202_rmdup	1702481	1702485		darB	4
GRH001.A0202_rmdup	1702613	1702632		darB	19
GRH001.A0202_rmdup	1705774	1705790		YPO_RS08490	16
GRH001.A0202_rmdup	1706493	1706538		YPO_RS08495	45
GRH001.A0202_rmdup	1706862	1706876		YPO_RS08495	14
GRH001.A0202_rmdup	1707163	1707173		YPO_RS08495	10
GRH001.A0202_rmdup	1710234	1710308		YPO_RS08510	74
GRH001.A0202_rmdup	1711360	1711361		mglB	1
GRH001.A0202_rmdup	1712799	1712889		mglA	90
GRH001.A0202_rmdup	1713512	1713527		mglA	15
GRH001.A0202_rmdup	1713764	1713765		mglA	1
GRH001.A0202_rmdup	1715631	1715640		sanA	9
GRH001.A0202_rmdup	1716556	1716563		YPO_RS08535	7
GRH001.A0202_rmdup	1716925	1716927		YPO_RS08535	2
GRH001.A0202_rmdup	1717351	1717415		YPO_RS08535	64
GRH001.A0202_rmdup	1718774	1718775		cdd	1
GRH001.A0202_rmdup	1719196	1719203		cdd	7
GRH001.A0202_rmdup	1719952	1719957		YPO_RS08545	5
GRH001.A0202_rmdup	1720175	1720206		YPO_RS08545	31
GRH001.A0202_rmdup	1722007	1722015		YPO_RS08555	8
GRH001.A0202_rmdup	1723122	1723127		YPO_RS08560	5
GRH001.A0202_rmdup	1723864	1723885		YPO_RS08560	21
GRH001.A0202_rmdup	1724967	1724977		YPO_RS08565	10
GRH001.A0202_rmdup	1726272	1726305		YPO_RS08570	33
GRH001.A0202_rmdup	1729818	1729832		metG	14
GRH001.A0202_rmdup	1734071	1734121		dcd	50
GRH001.A0202_rmdup	1735452	1735453		asmA	1
GRH001.A0202_rmdup	1737002	1737018		YPO_RS08615	16
GRH001.A0202_rmdup	1737300	1737307		YPO_RS08615	7
GRH001.A0202_rmdup	1738692	1738696		fhuF	4
GRH001.A0202_rmdup	1739040	1739054		fhuF	14
GRH001.A0202_rmdup	1739303	1739346		YPO_RS08625	43
GRH001.A0202_rmdup	1745801	1745819		YPO_RS08650	18
GRH001.A0202_rmdup	1746251	1746264		YPO_RS08650	13
GRH001.A0202_rmdup	1746492	1746502		YPO_RS08650	10
GRH001.A0202_rmdup	1746764	1746806		YPO_RS08655	42
GRH001.A0202_rmdup	1747071	1747072		YPO_RS08655	1
GRH001.A0202_rmdup	1747372	1747375		YPO_RS08655	3
GRH001.A0202_rmdup	1747467	1747472		YPO_RS08655	5
GRH001.A0202_rmdup	1748508	1748523		YPO_RS08660	15
GRH001.A0202_rmdup	1750844	1750854		YPO_RS08665	10
GRH001.A0202_rmdup	1751837	1751842		YPO_RS08670	5
GRH001.A0202_rmdup	1752091	1752129		YPO_RS08670	38
GRH001.A0202_rmdup	1758601	1758604		hisF	3
GRH001.A0202_rmdup	1758634	1758639		hisF	5
GRH001.A0202_rmdup	1759816	1759823		hisA	7
GRH001.A0202_rmdup	1760468	1760471		hisH	3
GRH001.A0202_rmdup	1760954	1760959		hisB	5
GRH001.A0202_rmdup	1761016	1761025		hisB	9
GRH001.A0202_rmdup	1762758	1762791		hisC	33
GRH001.A0202_rmdup	1763375	1763422		hisD	47
GRH001.A0202_rmdup	1763530	1763545		hisD	15
GRH001.A0202_rmdup	1763698	1763706		hisD	8
GRH001.A0202_rmdup	1763937	1763942		hisD	5
GRH001.A0202_rmdup	1764005	1764028		hisD	23
GRH001.A0202_rmdup	1764253	1764258		hisG	5
GRH001.A0202_rmdup	1768650	1768658		YPO_RS08750	8
GRH001.A0202_rmdup	1770516	1770586		YPO_RS08760	70
GRH001.A0202_rmdup	1774764	1774773		sbcB	9
GRH001.A0202_rmdup	1775827	1775830		YPO_RS08785	3
GRH001.A0202_rmdup	1776044	1776046		YPO_RS08785	2
GRH001.A0202_rmdup	1778575	1778590		YPO_RS08795	15
GRH001.A0202_rmdup	1782024	1782030		YPO_RS08800	6
GRH001.A0202_rmdup	1783490	1783496		YPO_RS08805	6
GRH001.A0202_rmdup	1786167	1786183		YPO_RS08820	16
GRH001.A0202_rmdup	1787166	1787167		YPO_RS08825	1
GRH001.A0202_rmdup	1787582	1787587		YPO_RS08825	5
GRH001.A0202_rmdup	1789105	1789172		lldD	67
GRH001.A0202_rmdup	1791003	1791009		argG	6
GRH001.A0202_rmdup	1793094	1793098		YPO_RS08845	4
GRH001.A0202_rmdup	1793630	1793638		YPO_RS08845	8
GRH001.A0202_rmdup	1794177	1794181		YPO_RS08845	4
GRH001.A0202_rmdup	1794382	1794387		YPO_RS08845	5
GRH001.A0202_rmdup	1794713	1794730		YPO_RS08850	17
GRH001.A0202_rmdup	1796995	1796996		YPO_RS08860	1
GRH001.A0202_rmdup	1799548	1799590		YPO_RS08875	42
GRH001.A0202_rmdup	1800040	1800077		YPO_RS08875	37
GRH001.A0202_rmdup	1801871	1801872		YPO_RS08885	1
GRH001.A0202_rmdup	1803916	1803971		YPO_RS08900	55
GRH001.A0202_rmdup	1804068	1804087		YPO_RS08900	19
GRH001.A0202_rmdup	1806981	1806985		YPO_RS08905	4
GRH001.A0202_rmdup	1807612	1807614		YPO_RS08910	2
GRH001.A0202_rmdup	1807781	1807788		YPO_RS08910	7
GRH001.A0202_rmdup	1808273	1808277		YPO_RS08910	4
GRH001.A0202_rmdup	1808273	1808331		bssS	58
GRH001.A0202_rmdup	1811445	1811473		YPO_RS08940	28
GRH001.A0202_rmdup	1811913	1811916		YPO_RS08940	3
GRH001.A0202_rmdup	1812853	1812863		rne	10
GRH001.A0202_rmdup	1812937	1812943		rne	6
GRH001.A0202_rmdup	1813192	1813193		rne	1
GRH001.A0202_rmdup	1813643	1813645		rne	2
GRH001.A0202_rmdup	1814689	1814691		rne	2
GRH001.A0202_rmdup	1815203	1815206		rne	3
GRH001.A0202_rmdup	1820309	1820340		plsX	31
GRH001.A0202_rmdup	1821999	1822002		YPO_RS08980	3
GRH001.A0202_rmdup	1824896	1824900		fabF	4
GRH001.A0202_rmdup	1825040	1825041		fabF	1
GRH001.A0202_rmdup	1828359	1828365		mltG	6
GRH001.A0202_rmdup	1828947	1828949		YPO_RS09020	2
GRH001.A0202_rmdup	1830151	1830164		holB	13
GRH001.A0202_rmdup	1831328	1831341		YPO_RS09030	13
GRH001.A0202_rmdup	1834867	1834874		YPO_RS09045	7
GRH001.A0202_rmdup	1835853	1835866		YPO_RS09055	13
GRH001.A0202_rmdup	1836076	1836111		lpoB	35
GRH001.A0202_rmdup	1836585	1836627		thiK	42
GRH001.A0202_rmdup	1836972	1836977		thiK	5
GRH001.A0202_rmdup	1837746	1837769		nagZ	23
GRH001.A0202_rmdup	1839080	1839107		YPO_RS09075	27
GRH001.A0202_rmdup	1843032	1843044		YPO_RS09095	12
GRH001.A0202_rmdup	1843232	1843235		YPO_RS09095	3
GRH001.A0202_rmdup	1843683	1843705		YPO_RS09095	22
GRH001.A0202_rmdup	1847882	1847884		mfd	2
GRH001.A0202_rmdup	1848240	1848258		mfd	18
GRH001.A0202_rmdup	1848609	1848610		mfd	1
GRH001.A0202_rmdup	1851870	1851872		lolD	2
GRH001.A0202_rmdup	1852671	1852677		lolE	6
GRH001.A0202_rmdup	1853393	1853402		lolE	9
GRH001.A0202_rmdup	1853583	1853616		lolE	33
GRH001.A0202_rmdup	1857844	1857854		YPO_RS09150	10
GRH001.A0202_rmdup	1857940	1857945		YPO_RS09150	5
GRH001.A0202_rmdup	1859810	1859823		phoQ	13
GRH001.A0202_rmdup	1861723	1861750		purB	27
GRH001.A0202_rmdup	1864052	1864075		mnmA	23
GRH001.A0202_rmdup	1865541	1865552		rluE	11
GRH001.A0202_rmdup	1865660	1865686		rluE	26
GRH001.A0202_rmdup	1866405	1866414		icd	9
GRH001.A0202_rmdup	1871962	1871967		YPO_RS09215	5
GRH001.A0202_rmdup	1876450	1876460		YPO_RS09240	10
GRH001.A0202_rmdup	1878711	1878715		YPO_RS09255	4
GRH001.A0202_rmdup	1881473	1881509		YPO_RS09260	36
GRH001.A0202_rmdup	1882979	1882990		YPO_RS09260	11
GRH001.A0202_rmdup	1884274	1884287		dsrB	13
GRH001.A0202_rmdup	1888975	1888976		mgtA	1
GRH001.A0202_rmdup	1889282	1889310		mgtA	28
GRH001.A0202_rmdup	1894321	1894322		motA	1
GRH001.A0202_rmdup	1896479	1896481		cheA	2
GRH001.A0202_rmdup	1897720	1897728		cheA	8
GRH001.A0202_rmdup	1899508	1899513		YPO_RS09320	5
GRH001.A0202_rmdup	1899965	1899993		YPO_RS09320	28
GRH001.A0202_rmdup	1903787	1903801		yapJ	14
GRH001.A0202_rmdup	1904197	1904234		yapJ	37
GRH001.A0202_rmdup	1904864	1904878		yapJ	14
GRH001.A0202_rmdup	1905148	1905166		yapJ	18
GRH001.A0202_rmdup	1905467	1905487		yapJ	20
GRH001.A0202_rmdup	1905709	1905724		yapJ	15
GRH001.A0202_rmdup	1905796	1905822		yapJ	26
GRH001.A0202_rmdup	1906138	1906139		yapJ	1
GRH001.A0202_rmdup	1907273	1907277		YPO_RS09345	4
GRH001.A0202_rmdup	1909536	1909570		YPO_RS09345	34
GRH001.A0202_rmdup	1909698	1909699		YPO_RS09345	1
GRH001.A0202_rmdup	1915140	1915141		cheR	1
GRH001.A0202_rmdup	1915246	1915257		cheR	11
GRH001.A0202_rmdup	1916247	1916292		YPO_RS09370	45
GRH001.A0202_rmdup	1916453	1916458		YPO_RS09370	5
GRH001.A0202_rmdup	1919705	1919706		YPO_RS09390	1
GRH001.A0202_rmdup	1920102	1920110		YPO_RS09390	8
GRH001.A0202_rmdup	1920324	1920335		YPO_RS09390	11
GRH001.A0202_rmdup	1920502	1920513		YPO_RS09390	11
GRH001.A0202_rmdup	1920814	1920818		YPO_RS09390	4
GRH001.A0202_rmdup	1921041	1921061		YPO_RS09390	20
GRH001.A0202_rmdup	1921239	1921317		YPO_RS09390	78
GRH001.A0202_rmdup	1921399	1921403		YPO_RS09390	4
GRH001.A0202_rmdup	1921507	1921562		YPO_RS09390	55
GRH001.A0202_rmdup	1922615	1922622		YPO_RS09400	7
GRH001.A0202_rmdup	1933830	1933873		YPO_RS09455	43
GRH001.A0202_rmdup	1935065	1935067		YPO_RS09455	2
GRH001.A0202_rmdup	1937832	1937847		YPO_RS09475	15
GRH001.A0202_rmdup	1938017	1938028		YPO_RS09475	11
GRH001.A0202_rmdup	1938359	1938374		YPO_RS09475	15
GRH001.A0202_rmdup	1939336	1939337		YPO_RS09480	1
GRH001.A0202_rmdup	1940609	1940635		YPO_RS09480	26
GRH001.A0202_rmdup	1941096	1941100		YPO_RS09480	4
GRH001.A0202_rmdup	1942542	1942548		yebS	6
GRH001.A0202_rmdup	1943975	1943979		proQ	4
GRH001.A0202_rmdup	1949096	1949099		YPO_RS09515	3
GRH001.A0202_rmdup	1949336	1949344		YPO_RS09515	8
GRH001.A0202_rmdup	1951264	1951274		YPO_RS09520	10
GRH001.A0202_rmdup	1951959	1951990		YPO_RS09520	31
GRH001.A0202_rmdup	1952037	1952056		YPO_RS09520	19
GRH001.A0202_rmdup	1953030	1953081		YPO_RS09525	51
GRH001.A0202_rmdup	1953513	1953517		YPO_RS09525	4
GRH001.A0202_rmdup	1954318	1954322		YPO_RS09530	4
GRH001.A0202_rmdup	1954592	1954595		YPO_RS09535	3
GRH001.A0202_rmdup	1954717	1954732		YPO_RS09535	15
GRH001.A0202_rmdup	1954845	1954853		YPO_RS09535	8
GRH001.A0202_rmdup	1955477	1955494		YPO_RS09535	17
GRH001.A0202_rmdup	1955534	1955542		YPO_RS09535	8
GRH001.A0202_rmdup	1957126	1957135		YPO_RS09540	9
GRH001.A0202_rmdup	1960507	1960515		YPO_RS09555	8
GRH001.A0202_rmdup	1961598	1961600		YPO_RS09560	2
GRH001.A0202_rmdup	1961685	1961690		YPO_RS09560	5
GRH001.A0202_rmdup	1963148	1963167		YPO_RS09565	19
GRH001.A0202_rmdup	1964636	1964642		YPO_RS09570	6
GRH001.A0202_rmdup	1967000	1967002		YPO_RS09585	2
GRH001.A0202_rmdup	1967840	1967847		YPO_RS09590	7
GRH001.A0202_rmdup	1972919	1972929		YPO_RS09610	10
GRH001.A0202_rmdup	1976644	1976680		YPO_RS09630	36
GRH001.A0202_rmdup	1978591	1978598		YPO_RS09645	7
GRH001.A0202_rmdup	1979691	1979700		YPO_RS09650	9
GRH001.A0202_rmdup	1980863	1980883		YPO_RS09655	20
GRH001.A0202_rmdup	1983495	1983502		YPO_RS09670	7
GRH001.A0202_rmdup	1984411	1984419		mgrB	8
GRH001.A0202_rmdup	1984815	1984826		YPO_RS09685	11
GRH001.A0202_rmdup	1986394	1986400		YPO_RS09700	6
GRH001.A0202_rmdup	1989940	1989945		pgeF	5
GRH001.A0202_rmdup	1990478	1990500		pgeF	22
GRH001.A0202_rmdup	1990969	1990974		rlmA	5
GRH001.A0202_rmdup	1991113	1991176		rlmA	63
GRH001.A0202_rmdup	1991476	1991478		rlmA	2
GRH001.A0202_rmdup	1992271	1992278		YPO_RS09730	7
GRH001.A0202_rmdup	1995170	1995174		YPO_RS09745	4
GRH001.A0202_rmdup	1996006	1996067		YPO_RS09745	61
GRH001.A0202_rmdup	1997593	1997615		YPO_RS09750	22
GRH001.A0202_rmdup	1997812	1997857		YPO_RS09750	45
GRH001.A0202_rmdup	1998359	1998373		YPO_RS09750	14
GRH001.A0202_rmdup	1999859	1999870		mntP	11
GRH001.A0202_rmdup	2000338	2000378		YPO_RS09760	40
GRH001.A0202_rmdup	2001433	2001505		YPO_RS09765	72
GRH001.A0202_rmdup	2001969	2001990		YPO_RS09770	21
GRH001.A0202_rmdup	2002274	2002278		YPO_RS09770	4
GRH001.A0202_rmdup	2004856	2004857		YPO_RS09780	1
GRH001.A0202_rmdup	2005877	2005917		YPO_RS09780	40
GRH001.A0202_rmdup	2007035	2007061		YPO_RS09790	26
GRH001.A0202_rmdup	2007945	2007954		YPO_RS09795	9
GRH001.A0202_rmdup	2008667	2008688		YPO_RS09800	21
GRH001.A0202_rmdup	2010109	2010161		hpaD	52
GRH001.A0202_rmdup	2010843	2010865		YPO_RS09810	22
GRH001.A0202_rmdup	2011167	2011171		hpaH	4
GRH001.A0202_rmdup	2011675	2011693		hpaH	18
GRH001.A0202_rmdup	2012189	2012224		hpaI	35
GRH001.A0202_rmdup	2012431	2012452		hpaI	21
GRH001.A0202_rmdup	2012653	2012655		hpaI	2
GRH001.A0202_rmdup	2013327	2013334		hpaX	7
GRH001.A0202_rmdup	2015418	2015421		hpaB	3
GRH001.A0202_rmdup	2015456	2015500		hpaB	44
GRH001.A0202_rmdup	2015845	2015854		hpaC	9
GRH001.A0202_rmdup	2016204	2016211		hpaC	7
GRH001.A0202_rmdup	2018933	2018937		YPO_RS09845	4
GRH001.A0202_rmdup	2019675	2019683		pabB	8
GRH001.A0202_rmdup	2021232	2021235		purT	3
GRH001.A0202_rmdup	2023315	2023325		dbpA	10
GRH001.A0202_rmdup	2023582	2023601		dbpA	19
GRH001.A0202_rmdup	2024883	2024895		YPO_RS09880	12
GRH001.A0202_rmdup	2026365	2026370		YPO_RS09885	5
GRH001.A0202_rmdup	2026461	2026463		YPO_RS09885	2
GRH001.A0202_rmdup	2027281	2027283		YPO_RS09885	2
GRH001.A0202_rmdup	2033167	2033171		YPO_RS09920	4
GRH001.A0202_rmdup	2033602	2033605		YPO_RS09925	3
GRH001.A0202_rmdup	2036229	2036237		flhA	8
GRH001.A0202_rmdup	2036385	2036436		flhA	51
GRH001.A0202_rmdup	2036881	2036941		flhA	60
GRH001.A0202_rmdup	2037383	2037423		flhA	40
GRH001.A0202_rmdup	2037948	2037965		YPO_RS09940	17
GRH001.A0202_rmdup	2042577	2042585		YPO_RS09960	8
GRH001.A0202_rmdup	2043829	2043832		flgA	3
GRH001.A0202_rmdup	2044894	2044918		flgC	24
GRH001.A0202_rmdup	2044978	2044989		flgC	11
GRH001.A0202_rmdup	2045038	2045076		flgC	38
GRH001.A0202_rmdup	2045643	2045647		flgD	4
GRH001.A0202_rmdup	2045737	2045738		flgD	1
GRH001.A0202_rmdup	2048148	2048151		flgG	3
GRH001.A0202_rmdup	2048418	2048445		flgG	27
GRH001.A0202_rmdup	2048943	2048962		flgH	19
GRH001.A0202_rmdup	2050014	2050034		YPO_RS10010	20
GRH001.A0202_rmdup	2050874	2050876		flgJ	2
GRH001.A0202_rmdup	2051045	2051073		flgJ	28
GRH001.A0202_rmdup	2051326	2051330		flgJ	4
GRH001.A0202_rmdup	2051583	2051584		flgJ	1
GRH001.A0202_rmdup	2053334	2053345		flgK	11
GRH001.A0202_rmdup	2054967	2054976		flgL	9
GRH001.A0202_rmdup	2055342	2055350		YPO_RS10030	8
GRH001.A0202_rmdup	2056251	2056274		YPO_RS10030	23
GRH001.A0202_rmdup	2060611	2060670		YPO_RS10045	59
GRH001.A0202_rmdup	2062202	2062221		YPO_RS10050	19
GRH001.A0202_rmdup	2062929	2062930		YPO_RS10055	1
GRH001.A0202_rmdup	2063372	2063378		YPO_RS10055	6
GRH001.A0202_rmdup	2065818	2065821		fliR	3
GRH001.A0202_rmdup	2066587	2066619		fliQ	32
GRH001.A0202_rmdup	2067167	2067178		fliP	11
GRH001.A0202_rmdup	2067275	2067299		fliP	24
GRH001.A0202_rmdup	2067708	2067720		fliO	12
GRH001.A0202_rmdup	2069940	2069957		fliL	17
GRH001.A0202_rmdup	2070353	2070489		YPO_RS10110	136
GRH001.A0202_rmdup	2071201	2071208		YPO_RS10110	7
GRH001.A0202_rmdup	2072521	2072523		fliI	2
GRH001.A0202_rmdup	2072965	2072967		fliI	2
GRH001.A0202_rmdup	2073169	2073228		fliI	59
GRH001.A0202_rmdup	2073581	2073629		fliI	48
GRH001.A0202_rmdup	2073611	2073629		fliH	18
GRH001.A0202_rmdup	2074458	2074473		fliG	15
GRH001.A0202_rmdup	2075689	2075722		fliF	33
GRH001.A0202_rmdup	2075826	2075851		fliF	25
GRH001.A0202_rmdup	2076104	2076123		fliF	19
GRH001.A0202_rmdup	2076434	2076447		fliF	13
GRH001.A0202_rmdup	2080820	2080867		YPO_RS10170	47
GRH001.A0202_rmdup	2081671	2081685		YPO_RS10170	14
GRH001.A0202_rmdup	2081781	2081782		YPO_RS10170	1
GRH001.A0202_rmdup	2083061	2083082		YPO_RS10175	21
GRH001.A0202_rmdup	2085461	2085470		fliD	9
GRH001.A0202_rmdup	2085708	2085733		fliD	25
GRH001.A0202_rmdup	2085898	2085900		fliD	2
GRH001.A0202_rmdup	2088423	2088444		YPO_RS10200	21
GRH001.A0202_rmdup	2088752	2088754		YPO_RS10200	2
GRH001.A0202_rmdup	2090036	2090065		YPO_RS10210	29
GRH001.A0202_rmdup	2090833	2090851		YPO_RS10210	18
GRH001.A0202_rmdup	2091108	2091109		tcyJ	1
GRH001.A0202_rmdup	2091455	2091457		tcyJ	2
GRH001.A0202_rmdup	2092127	2092132		tcyL	5
GRH001.A0202_rmdup	2096264	2096273		putA	9
GRH001.A0202_rmdup	2096670	2096694		putA	24
GRH001.A0202_rmdup	2096877	2096886		putA	9
GRH001.A0202_rmdup	2097134	2097145		putA	11
GRH001.A0202_rmdup	2099724	2099726		putP	2
GRH001.A0202_rmdup	2101976	2101985		YPO_RS10260	9
GRH001.A0202_rmdup	2103019	2103021		YPO_RS10260	2
GRH001.A0202_rmdup	2103076	2103119		efeB	43
GRH001.A0202_rmdup	2103869	2103872		efeB	3
GRH001.A0202_rmdup	2107212	2107213		cycA	1
GRH001.A0202_rmdup	2109353	2109376		YPO_RS10290	23
GRH001.A0202_rmdup	2110743	2110751		YPO_RS10300	8
GRH001.A0202_rmdup	2112097	2112134		uvrY	37
GRH001.A0202_rmdup	2117720	2117786		YPO_RS10355	66
GRH001.A0202_rmdup	2118097	2118100		hcp	3
GRH001.A0202_rmdup	2118346	2118347		hcp	1
GRH001.A0202_rmdup	2118743	2118766		YPO_RS10365	23
GRH001.A0202_rmdup	2119002	2119029		YPO_RS10365	27
GRH001.A0202_rmdup	2119146	2119155		YPO_RS10365	9
GRH001.A0202_rmdup	2119523	2119525		YPO_RS10365	2
GRH001.A0202_rmdup	2122140	2122148		YPO_RS10385	8
GRH001.A0202_rmdup	2122634	2122645		YPO_RS10395	11
GRH001.A0202_rmdup	2126455	2126552		YPO_RS10415	97
GRH001.A0202_rmdup	2126779	2126787		YPO_RS10420	8
GRH001.A0202_rmdup	2128062	2128076		YPO_RS10430	14
GRH001.A0202_rmdup	2128685	2128694		YPO_RS10430	9
GRH001.A0202_rmdup	2129560	2129575		YPO_RS10435	15
GRH001.A0202_rmdup	2129740	2129743		YPO_RS10435	3
GRH001.A0202_rmdup	2130495	2130501		YPO_RS10440	6
GRH001.A0202_rmdup	2131345	2131356		YPO_RS10440	11
GRH001.A0202_rmdup	2133361	2133379		YPO_RS10450	18
GRH001.A0202_rmdup	2133921	2133922		YPO_RS10455	1
GRH001.A0202_rmdup	2134705	2134712		YPO_RS10465	7
GRH001.A0202_rmdup	2139177	2139178		YPO_RS10505	1
GRH001.A0202_rmdup	2140883	2140926		fyuA	43
GRH001.A0202_rmdup	2141506	2141510		fyuA	4
GRH001.A0202_rmdup	2142203	2142208		fyuA	5
GRH001.A0202_rmdup	2142293	2142313		fyuA	20
GRH001.A0202_rmdup	2142531	2142534		fyuA	3
GRH001.A0202_rmdup	2143537	2143565		ybtE	28
GRH001.A0202_rmdup	2143658	2143689		ybtE	31
GRH001.A0202_rmdup	2143951	2143977		ybtE	26
GRH001.A0202_rmdup	2144024	2144056		ybtE	32
GRH001.A0202_rmdup	2144323	2144330		ybtE	7
GRH001.A0202_rmdup	2144730	2144780		ybtT	50
GRH001.A0202_rmdup	2145071	2145088		ybtT	17
GRH001.A0202_rmdup	2145150	2145165		ybtT	15
GRH001.A0202_rmdup	2145412	2145420		ybtU	8
GRH001.A0202_rmdup	2145607	2145679		ybtU	72
GRH001.A0202_rmdup	2145722	2145741		ybtU	19
GRH001.A0202_rmdup	2146325	2146367		ybtU	42
GRH001.A0202_rmdup	2146545	2146558		irp1	13
GRH001.A0202_rmdup	2146664	2146666		irp1	2
GRH001.A0202_rmdup	2146984	2147044		irp1	60
GRH001.A0202_rmdup	2147662	2147675		irp1	13
GRH001.A0202_rmdup	2147976	2147985		irp1	9
GRH001.A0202_rmdup	2148094	2148162		irp1	68
GRH001.A0202_rmdup	2148509	2148538		irp1	29
GRH001.A0202_rmdup	2148737	2148743		irp1	6
GRH001.A0202_rmdup	2149501	2149502		irp1	1
GRH001.A0202_rmdup	2150275	2150282		irp1	7
GRH001.A0202_rmdup	2150701	2150729		irp1	28
GRH001.A0202_rmdup	2150785	2150797		irp1	12
GRH001.A0202_rmdup	2150859	2150914		irp1	55
GRH001.A0202_rmdup	2150984	2151002		irp1	18
GRH001.A0202_rmdup	2151140	2151196		irp1	56
GRH001.A0202_rmdup	2151380	2151384		irp1	4
GRH001.A0202_rmdup	2151809	2151854		irp1	45
GRH001.A0202_rmdup	2151999	2152021		irp1	22
GRH001.A0202_rmdup	2152243	2152280		irp1	37
GRH001.A0202_rmdup	2152379	2152401		irp1	22
GRH001.A0202_rmdup	2152620	2152663		irp1	43
GRH001.A0202_rmdup	2153119	2153120		irp1	1
GRH001.A0202_rmdup	2153204	2153262		irp1	58
GRH001.A0202_rmdup	2153303	2153321		irp1	18
GRH001.A0202_rmdup	2153370	2153376		irp1	6
GRH001.A0202_rmdup	2153550	2153583		irp1	33
GRH001.A0202_rmdup	2153707	2153712		irp1	5
GRH001.A0202_rmdup	2154125	2154186		irp1	61
GRH001.A0202_rmdup	2154245	2154344		irp1	99
GRH001.A0202_rmdup	2154395	2154441		irp1	46
GRH001.A0202_rmdup	2154511	2154642		irp1	131
GRH001.A0202_rmdup	2155053	2155055		irp1	2
GRH001.A0202_rmdup	2155162	2155196		irp1	34
GRH001.A0202_rmdup	2155280	2155293		irp1	13
GRH001.A0202_rmdup	2155365	2155374		irp1	9
GRH001.A0202_rmdup	2155546	2155652		irp1	106
GRH001.A0202_rmdup	2155697	2155711		irp1	14
GRH001.A0202_rmdup	2156175	2156181		irp2	6
GRH001.A0202_rmdup	2156344	2156370		irp2	26
GRH001.A0202_rmdup	2156777	2156798		irp2	21
GRH001.A0202_rmdup	2157020	2157050		irp2	30
GRH001.A0202_rmdup	2157229	2157244		irp2	15
GRH001.A0202_rmdup	2157401	2157405		irp2	4
GRH001.A0202_rmdup	2157656	2157662		irp2	6
GRH001.A0202_rmdup	2157742	2157747		irp2	5
GRH001.A0202_rmdup	2157905	2157909		irp2	4
GRH001.A0202_rmdup	2158044	2158072		irp2	28
GRH001.A0202_rmdup	2158467	2158502		irp2	35
GRH001.A0202_rmdup	2158941	2158946		irp2	5
GRH001.A0202_rmdup	2159625	2159647		irp2	22
GRH001.A0202_rmdup	2159751	2159794		irp2	43
GRH001.A0202_rmdup	2160333	2160358		irp2	25
GRH001.A0202_rmdup	2160402	2160411		irp2	9
GRH001.A0202_rmdup	2161609	2161610		irp2	1
GRH001.A0202_rmdup	2161815	2161819		irp2	4
GRH001.A0202_rmdup	2162779	2162820		ybtA	41
GRH001.A0202_rmdup	2162919	2162939		ybtA	20
GRH001.A0202_rmdup	2164615	2164663		ybtP	48
GRH001.A0202_rmdup	2164812	2164815		ybtP	3
GRH001.A0202_rmdup	2164950	2165008		ybtP	58
GRH001.A0202_rmdup	2165225	2165257		ybtP	32
GRH001.A0202_rmdup	2165307	2165358		ybtQ	51
GRH001.A0202_rmdup	2165499	2165567		ybtQ	68
GRH001.A0202_rmdup	2165609	2165655		ybtQ	46
GRH001.A0202_rmdup	2165797	2165851		ybtQ	54
GRH001.A0202_rmdup	2165990	2166027		ybtQ	37
GRH001.A0202_rmdup	2166585	2166607		ybtQ	22
GRH001.A0202_rmdup	2166677	2166698		ybtQ	21
GRH001.A0202_rmdup	2167014	2167049		ybtQ	35
GRH001.A0202_rmdup	2167278	2167364		ybtX	86
GRH001.A0202_rmdup	2167653	2167732		ybtX	79
GRH001.A0202_rmdup	2167850	2167852		ybtX	2
GRH001.A0202_rmdup	2167950	2167971		ybtX	21
GRH001.A0202_rmdup	2168011	2168027		ybtX	16
GRH001.A0202_rmdup	2169002	2169025		ybtS	23
GRH001.A0202_rmdup	2173092	2173143		YPO_RS10585	51
GRH001.A0202_rmdup	2173626	2173630		YPO_RS10585	4
GRH001.A0202_rmdup	2174300	2174393		YPO_RS10590	93
GRH001.A0202_rmdup	2174598	2174601		YPO_RS10590	3
GRH001.A0202_rmdup	2176646	2176671		YPO_RS10595	25
GRH001.A0202_rmdup	2179360	2179379		YPO_RS10605	19
GRH001.A0202_rmdup	2182012	2182022		YPO_RS10615	10
GRH001.A0202_rmdup	2184103	2184132		YPO_RS10620	29
GRH001.A0202_rmdup	2184525	2184536		YPO_RS10620	11
GRH001.A0202_rmdup	2184707	2184709		YPO_RS10620	2
GRH001.A0202_rmdup	2185745	2185754		YPO_RS10630	9
GRH001.A0202_rmdup	2187134	2187160		YPO_RS10635	26
GRH001.A0202_rmdup	2187800	2187816		YPO_RS10645	16
GRH001.A0202_rmdup	2188030	2188035		YPO_RS10645	5
GRH001.A0202_rmdup	2191379	2191394		YPO_RS10660	15
GRH001.A0202_rmdup	2194566	2194575		ansP	9
GRH001.A0202_rmdup	2194941	2194973		ansP	32
GRH001.A0202_rmdup	2195254	2195260		ansP	6
GRH001.A0202_rmdup	2200604	2200623		YPO_RS10695	19
GRH001.A0202_rmdup	2204282	2204298		YPO_RS10705	16
GRH001.A0202_rmdup	2205270	2205276		YPO_RS10710	6
GRH001.A0202_rmdup	2207452	2207458		YPO_RS10715	6
GRH001.A0202_rmdup	2207603	2207606		YPO_RS10715	3
GRH001.A0202_rmdup	2207744	2207765		YPO_RS10720	21
GRH001.A0202_rmdup	2208141	2208187		YPO_RS10720	46
GRH001.A0202_rmdup	2209473	2209482		YPO_RS10725	9
GRH001.A0202_rmdup	2209606	2209608		YPO_RS10730	2
GRH001.A0202_rmdup	2213527	2213553		pgaA	26
GRH001.A0202_rmdup	2218038	2218039		YPO_RS10760	1
GRH001.A0202_rmdup	2218068	2218088		YPO_RS10760	20
GRH001.A0202_rmdup	2219526	2219564		pgaD	38
GRH001.A0202_rmdup	2220327	2220357		YPO_RS10770	30
GRH001.A0202_rmdup	2222345	2222362		phoH	17
GRH001.A0202_rmdup	2222608	2222610		chaA	2
GRH001.A0202_rmdup	2223448	2223514		chaA	66
GRH001.A0202_rmdup	2226451	2226457		YPO_RS10800	6
GRH001.A0202_rmdup	2226562	2226573		YPO_RS10800	11
GRH001.A0202_rmdup	2227144	2227145		YPO_RS10800	1
GRH001.A0202_rmdup	2227539	2227601		YPO_RS10800	62
GRH001.A0202_rmdup	2229019	2229023		YPO_RS10805	4
GRH001.A0202_rmdup	2229244	2229299		YPO_RS10805	55
GRH001.A0202_rmdup	2230637	2230654		astA	17
GRH001.A0202_rmdup	2230864	2230888		astD	24
GRH001.A0202_rmdup	2231419	2231430		astD	11
GRH001.A0202_rmdup	2231687	2231689		astD	2
GRH001.A0202_rmdup	2232781	2232786		astB	5
GRH001.A0202_rmdup	2237356	2237376		YPO_RS10835	20
GRH001.A0202_rmdup	2239097	2239134		hutG	37
GRH001.A0202_rmdup	2239299	2239305		hutG	6
GRH001.A0202_rmdup	2240990	2240994		hutC	4
GRH001.A0202_rmdup	2243416	2243433		YPO_RS10870	17
GRH001.A0202_rmdup	2243542	2243551		YPO_RS10870	9
GRH001.A0202_rmdup	2247845	2247868		YPO_RS10885	23
GRH001.A0202_rmdup	2248455	2248491		YPO_RS10885	36
GRH001.A0202_rmdup	2248558	2248559		YPO_RS10885	1
GRH001.A0202_rmdup	2249177	2249182		YPO_RS10890	5
GRH001.A0202_rmdup	2249652	2249654		YPO_RS10895	2
GRH001.A0202_rmdup	2249986	2250010		YPO_RS10895	24
GRH001.A0202_rmdup	2250481	2250487		YPO_RS10895	6
GRH001.A0202_rmdup	2251087	2251110		YPO_RS10900	23
GRH001.A0202_rmdup	2251890	2251917		YPO_RS10905	27
GRH001.A0202_rmdup	2252668	2252669		YPO_RS10905	1
GRH001.A0202_rmdup	2252708	2252718		YPO_RS10905	10
GRH001.A0202_rmdup	2253737	2253753		YPO_RS10915	16
GRH001.A0202_rmdup	2254006	2254022		YPO_RS10915	16
GRH001.A0202_rmdup	2256130	2256132		YPO_RS10925	2
GRH001.A0202_rmdup	2258012	2258026		YPO_RS10930	14
GRH001.A0202_rmdup	2258070	2258074		YPO_RS10930	4
GRH001.A0202_rmdup	2259242	2259244		YPO_RS10935	2
GRH001.A0202_rmdup	2259772	2259803		YPO_RS10935	31
GRH001.A0202_rmdup	2260002	2260007		YPO_RS10935	5
GRH001.A0202_rmdup	2260762	2260781		YPO_RS10935	19
GRH001.A0202_rmdup	2261750	2261754		YPO_RS10940	4
GRH001.A0202_rmdup	2262441	2262498		YPO_RS10940	57
GRH001.A0202_rmdup	2263313	2263314		YPO_RS10940	1
GRH001.A0202_rmdup	2265098	2265119		YPO_RS10950	21
GRH001.A0202_rmdup	2266335	2266363		YPO_RS10965	28
GRH001.A0202_rmdup	2267468	2267470		YPO_RS10970	2
GRH001.A0202_rmdup	2268476	2268489		YPO_RS10975	13
GRH001.A0202_rmdup	2271930	2271955		YPO_RS10990	25
GRH001.A0202_rmdup	2272671	2272701		YPO_RS10995	30
GRH001.A0202_rmdup	2273481	2273496		YPO_RS10995	15
GRH001.A0202_rmdup	2273810	2273812		YPO_RS11000	2
GRH001.A0202_rmdup	2274073	2274079		YPO_RS11000	6
GRH001.A0202_rmdup	2277268	2277281		YPO_RS11015	13
GRH001.A0202_rmdup	2278157	2278164		YPO_RS11020	7
GRH001.A0202_rmdup	2279211	2279239		YPO_RS11025	28
GRH001.A0202_rmdup	2279825	2279835		YPO_RS11030	10
GRH001.A0202_rmdup	2280106	2280133		YPO_RS11030	27
GRH001.A0202_rmdup	2280329	2280342		YPO_RS11030	13
GRH001.A0202_rmdup	2282340	2282343		ychF	3
GRH001.A0202_rmdup	2289437	2289439		prfA	2
GRH001.A0202_rmdup	2289775	2289783		prfA	8
GRH001.A0202_rmdup	2289908	2289963		prfA	55
GRH001.A0202_rmdup	2291027	2291036		prmC	9
GRH001.A0202_rmdup	2292096	2292100		YPO_RS11095	4
GRH001.A0202_rmdup	2294432	2294439		YPO_RS11110	7
GRH001.A0202_rmdup	2299958	2300030		YPO_RS11135	72
GRH001.A0202_rmdup	2300856	2300859		YPO_RS11140	3
GRH001.A0202_rmdup	2301701	2301702		YPO_RS11145	1
GRH001.A0202_rmdup	2301806	2301824		YPO_RS11145	18
GRH001.A0202_rmdup	2301967	2302012		YPO_RS11145	45
GRH001.A0202_rmdup	2303739	2303753		YPO_RS11155	14
GRH001.A0202_rmdup	2303849	2303914		YPO_RS11155	65
GRH001.A0202_rmdup	2305289	2305292		YPO_RS11170	3
GRH001.A0202_rmdup	2306079	2306097		YPO_RS11175	18
GRH001.A0202_rmdup	2306514	2306523		YPO_RS11175	9
GRH001.A0202_rmdup	2306873	2306903		YPO_RS11175	30
GRH001.A0202_rmdup	2308776	2308784		YPO_RS11190	8
GRH001.A0202_rmdup	2310970	2310982		mdtH	12
GRH001.A0202_rmdup	2311295	2311324		mdtH	29
GRH001.A0202_rmdup	2312489	2312501		rimJ	12
GRH001.A0202_rmdup	2313247	2313248		YPO_RS11210	1
GRH001.A0202_rmdup	2313831	2313882		YPO_RS11210	51
GRH001.A0202_rmdup	2313989	2313996		YPO_RS11210	7
GRH001.A0202_rmdup	2315247	2315264		murJ	17
GRH001.A0202_rmdup	2315467	2315487		murJ	20
GRH001.A0202_rmdup	2316441	2316479		YPO_RS11220	38
GRH001.A0202_rmdup	2318974	2318975		YPO_RS11225	1
GRH001.A0202_rmdup	2319034	2319042		YPO_RS11225	8
GRH001.A0202_rmdup	2319513	2319566		YPO_RS11225	53
GRH001.A0202_rmdup	2319786	2319807		YPO_RS11225	21
GRH001.A0202_rmdup	2321507	2321513		YPO_RS11225	6
GRH001.A0202_rmdup	2321704	2321706		YPO_RS11225	2
GRH001.A0202_rmdup	2322832	2322839		YPO_RS11225	7
GRH001.A0202_rmdup	2326352	2326367		cutC	15
GRH001.A0202_rmdup	2326988	2327011		cutC	23
GRH001.A0202_rmdup	2330309	2330337		YPO_RS11260	28
GRH001.A0202_rmdup	2334396	2334447		YPO_RS11275	51
GRH001.A0202_rmdup	2336196	2336197		ruvA	1
GRH001.A0202_rmdup	2337565	2337593		znuB	28
GRH001.A0202_rmdup	2338425	2338439		znuC	14
GRH001.A0202_rmdup	2340708	2340710		mepM	2
GRH001.A0202_rmdup	2341349	2341355		mepM	6
GRH001.A0202_rmdup	2342458	2342484		lpxM	26
GRH001.A0202_rmdup	2343029	2343036		pyk	7
GRH001.A0202_rmdup	2344880	2344886		YPO_RS11325	6
GRH001.A0202_rmdup	2349189	2349195		mdtJ	6
GRH001.A0202_rmdup	2349470	2349478		mdtJ	8
GRH001.A0202_rmdup	2349820	2349826		mdtI	6
GRH001.A0202_rmdup	2350192	2350212		YPO_RS11350	20
GRH001.A0202_rmdup	2350869	2350875		YPO_RS11355	6
GRH001.A0202_rmdup	2351036	2351046		YPO_RS11355	10
GRH001.A0202_rmdup	2351289	2351292		YPO_RS11355	3
GRH001.A0202_rmdup	2351614	2351625		YPO_RS11355	11
GRH001.A0202_rmdup	2353772	2353800		YPO_RS11365	28
GRH001.A0202_rmdup	2354843	2354851		fadD	8
GRH001.A0202_rmdup	2355378	2355383		fadD	5
GRH001.A0202_rmdup	2360682	2360749		YPO_RS11405	67
GRH001.A0202_rmdup	2361070	2361075		YPO_RS11405	5
GRH001.A0202_rmdup	2362353	2362362		YPO_RS11410	9
GRH001.A0202_rmdup	2369193	2369194		YPO_RS11460	1
GRH001.A0202_rmdup	2369243	2369263		YPO_RS11460	20
GRH001.A0202_rmdup	2372957	2372999		YPO_RS11495	42
GRH001.A0202_rmdup	2375074	2375092		YPO_RS11505	18
GRH001.A0202_rmdup	2375644	2375661		YPO_RS11510	17
GRH001.A0202_rmdup	2376961	2376974		YPO_RS11520	13
GRH001.A0202_rmdup	2381399	2381411		YPO_RS11545	12
GRH001.A0202_rmdup	2391607	2391755		YPO_RS11605	148
GRH001.A0202_rmdup	2391758	2391817		YPO_RS11610	59
GRH001.A0202_rmdup	2391916	2391927		YPO_RS11610	11
GRH001.A0202_rmdup	2392097	2392113		YPO_RS11610	16
GRH001.A0202_rmdup	2396718	2396765		YPO_RS11645	47
GRH001.A0202_rmdup	2398040	2398054		YPO_RS11660	14
GRH001.A0202_rmdup	2398938	2398959		YPO_RS11660	21
GRH001.A0202_rmdup	2399990	2400003		YPO_RS11660	13
GRH001.A0202_rmdup	2400834	2400850		YPO_RS11665	16
GRH001.A0202_rmdup	2401497	2401525		YPO_RS11665	28
GRH001.A0202_rmdup	2405322	2405344		YPO_RS11685	22
GRH001.A0202_rmdup	2405712	2405714		YPO_RS11685	2
GRH001.A0202_rmdup	2406457	2406458		YPO_RS11690	1
GRH001.A0202_rmdup	2406534	2406537		YPO_RS11690	3
GRH001.A0202_rmdup	2407828	2407847		YPO_RS11695	19
GRH001.A0202_rmdup	2409357	2409363		YPO_RS11700	6
GRH001.A0202_rmdup	2409990	2409991		dsbB	1
GRH001.A0202_rmdup	2413052	2413059		fadR	7
GRH001.A0202_rmdup	2415710	2415726		YPO_RS11725	16
GRH001.A0202_rmdup	2416094	2416110		YPO_RS11725	16
GRH001.A0202_rmdup	2416703	2416729		YPO_RS11730	26
GRH001.A0202_rmdup	2416847	2416848		YPO_RS11730	1
GRH001.A0202_rmdup	2417506	2417518		YPO_RS11730	12
GRH001.A0202_rmdup	2418251	2418282		YPO_RS11735	31
GRH001.A0202_rmdup	2418607	2418621		YPO_RS11735	14
GRH001.A0202_rmdup	2419247	2419297		YPO_RS11740	50
GRH001.A0202_rmdup	2419443	2419468		YPO_RS11740	25
GRH001.A0202_rmdup	2419891	2419902		YPO_RS11740	11
GRH001.A0202_rmdup	2420365	2420424		YPO_RS11745	59
GRH001.A0202_rmdup	2420935	2420989		YPO_RS11745	54
GRH001.A0202_rmdup	2422362	2422371		YPO_RS11750	9
GRH001.A0202_rmdup	2424326	2424332		yeaG	6
GRH001.A0202_rmdup	2425653	2425680		YPO_RS11760	27
GRH001.A0202_rmdup	2426004	2426013		YPO_RS11765	9
GRH001.A0202_rmdup	2426349	2426355		YPO_RS11765	6
GRH001.A0202_rmdup	2427676	2427691		gapA	15
GRH001.A0202_rmdup	2430193	2430227		ansA	34
GRH001.A0202_rmdup	2430421	2430428		ansA	7
GRH001.A0202_rmdup	2431504	2431509		sppA	5
GRH001.A0202_rmdup	2433576	2433578		YPO_RS11800	2
GRH001.A0202_rmdup	2434023	2434024		selD	1
GRH001.A0202_rmdup	2434147	2434150		selD	3
GRH001.A0202_rmdup	2436480	2436483		YPO_RS11810	3
GRH001.A0202_rmdup	2438436	2438439		xthA	3
GRH001.A0202_rmdup	2439688	2439689		YPO_RS11830	1
GRH001.A0202_rmdup	2439764	2439802		YPO_RS11830	38
GRH001.A0202_rmdup	2440245	2440259		YPO_RS11830	14
GRH001.A0202_rmdup	2442343	2442373		purU	30
GRH001.A0202_rmdup	2443657	2443664		YPO_RS11860	7
GRH001.A0202_rmdup	2445071	2445083		rssB	12
GRH001.A0202_rmdup	2445695	2445715		rssB	20
GRH001.A0202_rmdup	2446695	2446722		YPO_RS11870	27
GRH001.A0202_rmdup	2447398	2447403		YPO_RS11870	5
GRH001.A0202_rmdup	2454382	2454384		adhE	2
GRH001.A0202_rmdup	2454649	2454659		adhE	10
GRH001.A0202_rmdup	2457825	2457830		oppA	5
GRH001.A0202_rmdup	2458622	2458635		oppA	13
GRH001.A0202_rmdup	2458917	2458920		oppA	3
GRH001.A0202_rmdup	2459204	2459206		oppA	2
GRH001.A0202_rmdup	2460892	2460899		oppC	7
GRH001.A0202_rmdup	2463709	2463823		YPO_RS11930	114
GRH001.A0202_rmdup	2465261	2465305		cls	44
GRH001.A0202_rmdup	2469846	2469860		tonB	14
GRH001.A0202_rmdup	2472569	2472579		YPO_RS11985	10
GRH001.A0202_rmdup	2472953	2472955		YPO_RS11990	2
GRH001.A0202_rmdup	2473009	2473016		YPO_RS11990	7
GRH001.A0202_rmdup	2473349	2473368		YPO_RS11990	19
GRH001.A0202_rmdup	2475841	2475865		YPO_RS12005	24
GRH001.A0202_rmdup	2477717	2477719		trpA	2
GRH001.A0202_rmdup	2478605	2478608		trpB	3
GRH001.A0202_rmdup	2480057	2480065		trpCF	8
GRH001.A0202_rmdup	2480101	2480106		trpCF	5
GRH001.A0202_rmdup	2481178	2481194		trpD	16
GRH001.A0202_rmdup	2482807	2482813		YPO_RS12045	6
GRH001.A0202_rmdup	2484686	2484694		YPO_RS12055	8
GRH001.A0202_rmdup	2485016	2485019		YPO_RS12055	3
GRH001.A0202_rmdup	2487482	2487513		rluB	31
GRH001.A0202_rmdup	2489395	2489434		sohB	39
GRH001.A0202_rmdup	2489518	2489541		sohB	23
GRH001.A0202_rmdup	2491178	2491265		topA	87
GRH001.A0202_rmdup	2497247	2497271		acnA	24
GRH001.A0202_rmdup	2497557	2497561		acnA	4
GRH001.A0202_rmdup	2498138	2498143		acnA	5
GRH001.A0202_rmdup	2498688	2498696		acnA	8
GRH001.A0202_rmdup	2500886	2500913		pgpB	27
GRH001.A0202_rmdup	2500967	2501021		pgpB	54
GRH001.A0202_rmdup	2503063	2503069		YPO_RS12135	6
GRH001.A0202_rmdup	2504112	2504114		pyrF	2
GRH001.A0202_rmdup	2504690	2504699		yciH	9
GRH001.A0202_rmdup	2505177	2505179		osmB	2
GRH001.A0202_rmdup	2505950	2505952		araD	2
GRH001.A0202_rmdup	2508411	2508413		YPO_RS12175	2
GRH001.A0202_rmdup	2508899	2508909		YPO_RS12175	10
GRH001.A0202_rmdup	2509947	2509957		YPO_RS12175	10
GRH001.A0202_rmdup	2518482	2518487		rsxD	5
GRH001.A0202_rmdup	2519275	2519281		YPO_RS12215	6
GRH001.A0202_rmdup	2520596	2520623		rsxC	27
GRH001.A0202_rmdup	2521742	2521770		rsxC	28
GRH001.A0202_rmdup	2521872	2521878		rsxC	6
GRH001.A0202_rmdup	2527420	2527440		YPO_RS12245	20
GRH001.A0202_rmdup	2529368	2529380		YPO_RS12255	12
GRH001.A0202_rmdup	2529608	2529621		YPO_RS12255	13
GRH001.A0202_rmdup	2529904	2529915		YPO_RS12255	11
GRH001.A0202_rmdup	2532554	2532576		YPO_RS12265	22
GRH001.A0202_rmdup	2532766	2532782		YPO_RS12265	16
GRH001.A0202_rmdup	2532829	2532855		YPO_RS12265	26
GRH001.A0202_rmdup	2534098	2534103		YPO_RS12270	5
GRH001.A0202_rmdup	2536844	2536897		YPO_RS12280	53
GRH001.A0202_rmdup	2538294	2538346		araC	52
GRH001.A0202_rmdup	2539365	2539379		YPO_RS12290	14
GRH001.A0202_rmdup	2543956	2543958		manA	2
GRH001.A0202_rmdup	2544180	2544192		manA	12
GRH001.A0202_rmdup	2544873	2544884		manA	11
GRH001.A0202_rmdup	2545369	2545371		fumC	2
GRH001.A0202_rmdup	2545418	2545428		fumC	10
GRH001.A0202_rmdup	2545482	2545501		fumC	19
GRH001.A0202_rmdup	2548347	2548387		YPO_RS12325	40
GRH001.A0202_rmdup	2550144	2550147		YPO_RS12335	3
GRH001.A0202_rmdup	2550214	2550218		YPO_RS12335	4
GRH001.A0202_rmdup	2551626	2551640		YPO_RS12340	14
GRH001.A0202_rmdup	2552145	2552152		bioD	7
GRH001.A0202_rmdup	2553227	2553236		clcB	9
GRH001.A0202_rmdup	2554373	2554633		YPO_RS12355	260
GRH001.A0202_rmdup	2554658	2555065		YPO_RS12360	407
GRH001.A0202_rmdup	2555162	2555608		YPO_RS12365	446
GRH001.A0202_rmdup	2555780	2556832		YPO_RS12370	1052
GRH001.A0202_rmdup	2556844	2557161		YPO_RS12375	317
GRH001.A0202_rmdup	2557164	2557415		YPO_RS12380	251
GRH001.A0202_rmdup	2557451	2557684		YPO_RS12385	233
GRH001.A0202_rmdup	2557749	2559461		YPO_RS12390	1712
GRH001.A0202_rmdup	2559474	2559761		YPO_RS12395	287
GRH001.A0202_rmdup	2559765	2560790		YPO_RS12400	1025
GRH001.A0202_rmdup	2560790	2562034		YPO_RS12405	1244
GRH001.A0202_rmdup	2562123	2562371		YPO_RS12410	248
GRH001.A0202_rmdup	2562568	2562765		YPO_RS12415	197
GRH001.A0202_rmdup	2563325	2563940		YPO_RS12420	615
GRH001.A0202_rmdup	2565856	2565911		YPO_RS12435	55
GRH001.A0202_rmdup	2566017	2566020		YPO_RS12435	3
GRH001.A0202_rmdup	2566243	2566250		YPO_RS12435	7
GRH001.A0202_rmdup	2566418	2566425		YPO_RS12435	7
GRH001.A0202_rmdup	2567285	2567288		YPO_RS12440	3
GRH001.A0202_rmdup	2568121	2568122		YPO_RS12445	1
GRH001.A0202_rmdup	2570821	2570825		YPO_RS12450	4
GRH001.A0202_rmdup	2572704	2572706		YPO_RS12455	2
GRH001.A0202_rmdup	2572966	2572987		YPO_RS12455	21
GRH001.A0202_rmdup	2573183	2573186		YPO_RS12455	3
GRH001.A0202_rmdup	2573800	2573802		YPO_RS12455	2
GRH001.A0202_rmdup	2574007	2574022		YPO_RS12455	15
GRH001.A0202_rmdup	2574838	2574849		YPO_RS12460	11
GRH001.A0202_rmdup	2575214	2575215		YPO_RS12460	1
GRH001.A0202_rmdup	2575811	2575820		YPO_RS12460	9
GRH001.A0202_rmdup	2577756	2577777		YPO_RS12465	21
GRH001.A0202_rmdup	2578243	2578258		ivbL	15
GRH001.A0202_rmdup	2583263	2583316		YPO_RS12495	53
GRH001.A0202_rmdup	2583400	2583413		YPO_RS12495	13
GRH001.A0202_rmdup	2585993	2586004		ogt	11
GRH001.A0202_rmdup	2590457	2590460		pntA	3
GRH001.A0202_rmdup	2591047	2591073		pntA	26
GRH001.A0202_rmdup	2595656	2595700		rstA	44
GRH001.A0202_rmdup	2596283	2596294		rstB	11
GRH001.A0202_rmdup	2606354	2606398		asr	44
GRH001.A0202_rmdup	2607985	2607999		YPO_RS12595	14
GRH001.A0202_rmdup	2614938	2614944		YPO_RS12620	6
GRH001.A0202_rmdup	2615649	2615656		YPO_RS12620	7
GRH001.A0202_rmdup	2616306	2616308		YPO_RS12620	2
GRH001.A0202_rmdup	2617252	2617275		YPO_RS12635	23
GRH001.A0202_rmdup	2618924	2618952		YPO_RS12635	28
GRH001.A0202_rmdup	2619509	2619515		YPO_RS12635	6
GRH001.A0202_rmdup	2625466	2625472		nifJ	6
GRH001.A0202_rmdup	2629280	2629287		YPO_RS12675	7
GRH001.A0202_rmdup	2634801	2634806		mpaA	5
GRH001.A0202_rmdup	2635367	2635380		ycjG	13
GRH001.A0202_rmdup	2640515	2640542		YPO_RS12725	27
GRH001.A0202_rmdup	2642007	2642018		YPO_RS12735	11
GRH001.A0202_rmdup	2642165	2642168		YPO_RS12735	3
GRH001.A0202_rmdup	2643648	2643679		pspC	31
GRH001.A0202_rmdup	2644463	2644464		pspA	1
GRH001.A0202_rmdup	2649902	2649950		sapB	48
GRH001.A0202_rmdup	2650144	2650145		sapC	1
GRH001.A0202_rmdup	2650359	2650369		sapC	10
GRH001.A0202_rmdup	2656371	2656415		dtpA	44
GRH001.A0202_rmdup	2661313	2661321		pdxY	8
GRH001.A0202_rmdup	2661960	2661981		tyrS	21
GRH001.A0202_rmdup	2662864	2662869		tyrS	5
GRH001.A0202_rmdup	2669554	2669558		eptA	4
GRH001.A0202_rmdup	2669621	2669624		eptA	3
GRH001.A0202_rmdup	2672721	2672724		YPO_RS12885	3
GRH001.A0202_rmdup	2674920	2675049		YPO_RS12890	129
GRH001.A0202_rmdup	2675230	2675231		YPO_RS12890	1
GRH001.A0202_rmdup	2675425	2675437		YPO_RS12890	12
GRH001.A0202_rmdup	2675756	2675799		YPO_RS12890	43
GRH001.A0202_rmdup	2676034	2676109		YPO_RS12890	75
GRH001.A0202_rmdup	2676625	2676639		gloA	14
GRH001.A0202_rmdup	2676709	2676710		gloA	1
GRH001.A0202_rmdup	2677094	2677118		rnt	24
GRH001.A0202_rmdup	2677233	2677246		rnt	13
GRH001.A0202_rmdup	2679509	2679552		YPO_RS12915	43
GRH001.A0202_rmdup	2686197	2686204		cfa	7
GRH001.A0202_rmdup	2687725	2687740		YPO_RS12960	15
GRH001.A0202_rmdup	2688104	2688109		YPO_RS12960	5
GRH001.A0202_rmdup	2689865	2689869		pykF	4
GRH001.A0202_rmdup	2690302	2690314		pykF	12
GRH001.A0202_rmdup	2690494	2690501		pykF	7
GRH001.A0202_rmdup	2694665	2694689		YPO_RS13000	24
GRH001.A0202_rmdup	2695333	2695357		YPO_RS13000	24
GRH001.A0202_rmdup	2696070	2696078		sufE	8
GRH001.A0202_rmdup	2698550	2698568		sufD	18
GRH001.A0202_rmdup	2698795	2698800		sufD	5
GRH001.A0202_rmdup	2700503	2700510		sufB	7
GRH001.A0202_rmdup	2700576	2700577		sufB	1
GRH001.A0202_rmdup	2702476	2702477		YPO_RS13035	1
GRH001.A0202_rmdup	2703816	2703838		YPO_RS13040	22
GRH001.A0202_rmdup	2706685	2706698		ydiK	13
GRH001.A0202_rmdup	2707243	2707258		ydiK	15
GRH001.A0202_rmdup	2707515	2707520		ydiK	5
GRH001.A0202_rmdup	2710091	2710123		ppsA	32
GRH001.A0202_rmdup	2711628	2711648		YPO_RS13060	20
GRH001.A0202_rmdup	2712661	2712672		YPO_RS13065	11
GRH001.A0202_rmdup	2714924	2714926		YPO_RS13075	2
GRH001.A0202_rmdup	2715367	2715375		YPO_RS13075	8
GRH001.A0202_rmdup	2720560	2720563		arnA	3
GRH001.A0202_rmdup	2721932	2721933		arnC	1
GRH001.A0202_rmdup	2725883	2725901		btuC	18
GRH001.A0202_rmdup	2742194	2742196		yfeD	2
GRH001.A0202_rmdup	2745309	2745310		hxpB	1
GRH001.A0202_rmdup	2748019	2748024		solA	5
GRH001.A0202_rmdup	2750739	2750740		YPO_RS13265	1
GRH001.A0202_rmdup	2753049	2753062		YPO_RS13280	13
GRH001.A0202_rmdup	2754131	2754169		YPO_RS13285	38
GRH001.A0202_rmdup	2754575	2754586		YPO_RS13285	11
GRH001.A0202_rmdup	2754954	2754957		YPO_RS13290	3
GRH001.A0202_rmdup	2755036	2755054		YPO_RS13290	18
GRH001.A0202_rmdup	2755464	2755488		YPO_RS13290	24
GRH001.A0202_rmdup	2756590	2756593		YPO_RS13295	3
GRH001.A0202_rmdup	2757574	2757583		YPO_RS13305	9
GRH001.A0202_rmdup	2764221	2764226		csy1	5
GRH001.A0202_rmdup	2764707	2764711		cas3f	4
GRH001.A0202_rmdup	2765597	2765614		cas3f	17
GRH001.A0202_rmdup	2766235	2766246		cas3f	11
GRH001.A0202_rmdup	2767236	2767314		cas3f	78
GRH001.A0202_rmdup	2768193	2768195		cas1f	2
GRH001.A0202_rmdup	2772113	2772142		YPO_RS13355	29
GRH001.A0202_rmdup	2772640	2772660		YPO_RS13355	20
GRH001.A0202_rmdup	2773163	2773172		YPO_RS13355	9
GRH001.A0202_rmdup	2773878	2773886		YPO_RS13360	8
GRH001.A0202_rmdup	2775576	2775585		YPO_RS13370	9
GRH001.A0202_rmdup	2776534	2776538		YPO_RS13370	4
GRH001.A0202_rmdup	2776685	2776700		YPO_RS13375	15
GRH001.A0202_rmdup	2777258	2777263		YPO_RS13375	5
GRH001.A0202_rmdup	2778352	2778355		YPO_RS13380	3
GRH001.A0202_rmdup	2780208	2780209		YPO_RS13390	1
GRH001.A0202_rmdup	2784358	2784360		YPO_RS13405	2
GRH001.A0202_rmdup	2784900	2784907		YPO_RS13410	7
GRH001.A0202_rmdup	2785607	2785614		YPO_RS13415	7
GRH001.A0202_rmdup	2786486	2786511		YPO_RS13430	25
GRH001.A0202_rmdup	2786793	2786795		YPO_RS13430	2
GRH001.A0202_rmdup	2786848	2786862		YPO_RS13430	14
GRH001.A0202_rmdup	2786937	2786941		YPO_RS13430	4
GRH001.A0202_rmdup	2788028	2788042		YPO_RS13430	14
GRH001.A0202_rmdup	2788480	2788494		YPO_RS13430	14
GRH001.A0202_rmdup	2789698	2789699		YPO_RS13445	1
GRH001.A0202_rmdup	2792573	2792651		cdiA	78
GRH001.A0202_rmdup	2792831	2792835		cdiA	4
GRH001.A0202_rmdup	2792925	2792929		cdiA	4
GRH001.A0202_rmdup	2793228	2793242		cdiA	14
GRH001.A0202_rmdup	2793599	2793610		cdiA	11
GRH001.A0202_rmdup	2793815	2793818		cdiA	3
GRH001.A0202_rmdup	2794211	2794213		cdiA	2
GRH001.A0202_rmdup	2794293	2794299		cdiA	6
GRH001.A0202_rmdup	2794583	2794605		cdiA	22
GRH001.A0202_rmdup	2794793	2794849		cdiA	56
GRH001.A0202_rmdup	2795080	2795095		cdiA	15
GRH001.A0202_rmdup	2795213	2795215		cdiA	2
GRH001.A0202_rmdup	2795264	2795271		cdiA	7
GRH001.A0202_rmdup	2795854	2795873		cdiA	19
GRH001.A0202_rmdup	2795979	2796018		cdiA	39
GRH001.A0202_rmdup	2796198	2796206		cdiA	8
GRH001.A0202_rmdup	2796573	2796620		cdiA	47
GRH001.A0202_rmdup	2797114	2797120		cdiA	6
GRH001.A0202_rmdup	2798641	2798671		YPO_RS13455	30
GRH001.A0202_rmdup	2800447	2800448		YPO_RS13460	1
GRH001.A0202_rmdup	2800581	2800610		YPO_RS13460	29
GRH001.A0202_rmdup	2802879	2802885		YPO_RS13470	6
GRH001.A0202_rmdup	2803563	2803571		YPO_RS13470	8
GRH001.A0202_rmdup	2803729	2803743		YPO_RS13470	14
GRH001.A0202_rmdup	2805280	2805300		YPO_RS13475	20
GRH001.A0202_rmdup	2805510	2805511		YPO_RS13475	1
GRH001.A0202_rmdup	2806019	2806065		YPO_RS13480	46
GRH001.A0202_rmdup	2808831	2808861		YPO_RS13490	30
GRH001.A0202_rmdup	2809091	2809093		YPO_RS13490	2
GRH001.A0202_rmdup	2809976	2810010		YPO_RS13495	34
GRH001.A0202_rmdup	2810405	2810414		YPO_RS13495	9
GRH001.A0202_rmdup	2810490	2810503		YPO_RS13495	13
GRH001.A0202_rmdup	2814288	2814289		YPO_RS13510	1
GRH001.A0202_rmdup	2814608	2814625		YPO_RS13515	17
GRH001.A0202_rmdup	2816254	2816257		YPO_RS13520	3
GRH001.A0202_rmdup	2818049	2818058		rhtA	9
GRH001.A0202_rmdup	2818915	2818923		YPO_RS13535	8
GRH001.A0202_rmdup	2821051	2821061		YPO_RS13550	10
GRH001.A0202_rmdup	2824283	2824284		glnQ	1
GRH001.A0202_rmdup	2825178	2825184		YPO_RS13570	6
GRH001.A0202_rmdup	2830444	2830486		YPO_RS13595	42
GRH001.A0202_rmdup	2831187	2831224		ybiB	37
GRH001.A0202_rmdup	2831579	2831591		ybiB	12
GRH001.A0202_rmdup	2832541	2832575		menE	34
GRH001.A0202_rmdup	2832755	2832763		menE	8
GRH001.A0202_rmdup	2832886	2832904		menE	18
GRH001.A0202_rmdup	2833297	2833308		menE	11
GRH001.A0202_rmdup	2833297	2833341		menC	44
GRH001.A0202_rmdup	2835636	2835665		menH	29
GRH001.A0202_rmdup	2836070	2836092		menD	22
GRH001.A0202_rmdup	2836637	2836656		menD	19
GRH001.A0202_rmdup	2837040	2837045		menD	5
GRH001.A0202_rmdup	2837320	2837322		menD	2
GRH001.A0202_rmdup	2838172	2838203		menF	31
GRH001.A0202_rmdup	2842775	2842812		YPO_RS13645	37
GRH001.A0202_rmdup	2842906	2842915		YPO_RS13645	9
GRH001.A0202_rmdup	2842959	2842974		YPO_RS13645	15
GRH001.A0202_rmdup	2843739	2843742		YPO_RS13645	3
GRH001.A0202_rmdup	2844066	2844068		YPO_RS13645	2
GRH001.A0202_rmdup	2844811	2844824		YPO_RS13655	13
GRH001.A0202_rmdup	2845101	2845104		YPO_RS13655	3
GRH001.A0202_rmdup	2846893	2846929		YPO_RS13660	36
GRH001.A0202_rmdup	2850503	2850520		YPO_RS13670	17
GRH001.A0202_rmdup	2851894	2851909		idnO	15
GRH001.A0202_rmdup	2853945	2853950		YPO_RS13690	5
GRH001.A0202_rmdup	2854161	2854201		YPO_RS13690	40
GRH001.A0202_rmdup	2855752	2855762		nuoN	10
GRH001.A0202_rmdup	2856302	2856303		nuoN	1
GRH001.A0202_rmdup	2856650	2856657		nuoM	7
GRH001.A0202_rmdup	2857315	2857328		nuoM	13
GRH001.A0202_rmdup	2857704	2857706		nuoM	2
GRH001.A0202_rmdup	2858531	2858533		nuoL	2
GRH001.A0202_rmdup	2859284	2859289		nuoL	5
GRH001.A0202_rmdup	2860041	2860042		nuoK	1
GRH001.A0202_rmdup	2861193	2861197		nuoI	4
GRH001.A0202_rmdup	2861896	2861908		nuoH	12
GRH001.A0202_rmdup	2862017	2862021		nuoH	4
GRH001.A0202_rmdup	2862726	2862755		nuoG	29
GRH001.A0202_rmdup	2864390	2864394		nuoG	4
GRH001.A0202_rmdup	2868670	2868674		nuoC	4
GRH001.A0202_rmdup	2873177	2873188		YPO_RS13765	11
GRH001.A0202_rmdup	2880472	2880495		ackA	23
GRH001.A0202_rmdup	2882315	2882319		pta	4
GRH001.A0202_rmdup	2883198	2883208		pta	10
GRH001.A0202_rmdup	2885550	2885586		YPO_RS13815	36
GRH001.A0202_rmdup	2885777	2885783		YPO_RS13815	6
GRH001.A0202_rmdup	2887092	2887681		YPO_RS13825	589
GRH001.A0202_rmdup	2887751	2887932		YPO_RS13825	181
GRH001.A0202_rmdup	2887989	2891292		YPO_RS13830	3303
GRH001.A0202_rmdup	2891352	2892561		YPO_RS13830	1209
GRH001.A0202_rmdup	2892614	2893276		YPO_RS13830	662
GRH001.A0202_rmdup	2893331	2893967		YPO_RS13830	636
GRH001.A0202_rmdup	2894374	2894922		YPO_RS13835	548
GRH001.A0202_rmdup	2895617	2896471		YPO_RS13840	854
GRH001.A0202_rmdup	2896777	2897234		YPO_RS13845	457
GRH001.A0202_rmdup	2897288	2898000		YPO_RS13845	712
GRH001.A0202_rmdup	2898076	2898087		YPO_RS13845	11
GRH001.A0202_rmdup	2898142	2898303		YPO_RS13845	161
GRH001.A0202_rmdup	2898338	2900263		iolD	1925
GRH001.A0202_rmdup	2902899	2902902		YPO_RS13865	3
GRH001.A0202_rmdup	2903053	2903063		YPO_RS13865	10
GRH001.A0202_rmdup	2903438	2903455		YPO_RS13865	17
GRH001.A0202_rmdup	2903675	2903709		YPO_RS13865	34
GRH001.A0202_rmdup	2904647	2904652		YPO_RS13870	5
GRH001.A0202_rmdup	2905323	2905363		YPO_RS13875	40
GRH001.A0202_rmdup	2905439	2905456		YPO_RS13875	17
GRH001.A0202_rmdup	2905511	2905523		YPO_RS13875	12
GRH001.A0202_rmdup	2906269	2906290		YPO_RS13875	21
GRH001.A0202_rmdup	2906736	2906741		iolC	5
GRH001.A0202_rmdup	2906960	2906988		iolC	28
GRH001.A0202_rmdup	2907217	2907273		iolC	56
GRH001.A0202_rmdup	2907334	2907356		iolC	22
GRH001.A0202_rmdup	2907410	2907429		iolC	19
GRH001.A0202_rmdup	2907562	2907573		iolC	11
GRH001.A0202_rmdup	2907688	2907704		iolC	16
GRH001.A0202_rmdup	2908112	2908116		iolC	4
GRH001.A0202_rmdup	2908150	2908202		iolC	52
GRH001.A0202_rmdup	2908966	2908971		iolE	5
GRH001.A0202_rmdup	2909496	2909500		iolB	4
GRH001.A0202_rmdup	2909877	2909879		iolB	2
GRH001.A0202_rmdup	2910132	2910152		iolB	20
GRH001.A0202_rmdup	2915446	2915454		YPO_RS13925	8
GRH001.A0202_rmdup	2922473	2922481		dacA	8
GRH001.A0202_rmdup	2922743	2922745		dacA	2
GRH001.A0202_rmdup	2923855	2923883		rlpA	28
GRH001.A0202_rmdup	2925696	2925708		mrdA	12
GRH001.A0202_rmdup	2925860	2925887		mrdA	27
GRH001.A0202_rmdup	2926154	2926156		mrdA	2
GRH001.A0202_rmdup	2926661	2926681		mrdA	20
GRH001.A0202_rmdup	2927389	2927404		mrdA	15
GRH001.A0202_rmdup	2929401	2929404		holA	3
GRH001.A0202_rmdup	2929633	2929640		holA	7
GRH001.A0202_rmdup	2930026	2930036		holA	10
GRH001.A0202_rmdup	2930489	2930493		lptE	4
GRH001.A0202_rmdup	2930748	2930753		lptE	5
GRH001.A0202_rmdup	2931769	2931776		leuS	7
GRH001.A0202_rmdup	2933756	2933765		YPO_RS14015	9
GRH001.A0202_rmdup	2934052	2934085		YPO_RS14015	33
GRH001.A0202_rmdup	2934708	2934716		YPO_RS14020	8
GRH001.A0202_rmdup	2935253	2935264		gltK	11
GRH001.A0202_rmdup	2935340	2935347		gltK	7
GRH001.A0202_rmdup	2938786	2938822		lnt	36
GRH001.A0202_rmdup	2939018	2939028		lnt	10
GRH001.A0202_rmdup	2941397	2941399		YPO_RS14055	2
GRH001.A0202_rmdup	2942249	2942250		YPO_RS14055	1
GRH001.A0202_rmdup	2945277	2945278		ubiF	1
GRH001.A0202_rmdup	2952569	2952591		nagB	22
GRH001.A0202_rmdup	2954893	2954939		YPO_RS14120	46
GRH001.A0202_rmdup	2955242	2955257		YPO_RS14120	15
GRH001.A0202_rmdup	2957266	2957271		glnS	5
GRH001.A0202_rmdup	2959102	2959105		YPO_RS14135	3
GRH001.A0202_rmdup	2959674	2959709		YPO_RS14135	35
GRH001.A0202_rmdup	2965342	2965352		ybfE	10
GRH001.A0202_rmdup	2972880	2972895		proW	15
GRH001.A0202_rmdup	2975194	2975196		proV	2
GRH001.A0202_rmdup	2979332	2979346		nrdI	14
GRH001.A0202_rmdup	2979402	2979407		nrdI	5
GRH001.A0202_rmdup	2980425	2980612		YPO_RS14235	187
GRH001.A0202_rmdup	2986671	2986675		YPO_RS14265	4
GRH001.A0202_rmdup	2988522	2988523		YPO_RS14275	1
GRH001.A0202_rmdup	2998362	2998414		yut	52
GRH001.A0202_rmdup	2999804	2999806		YPO_RS14330	2
GRH001.A0202_rmdup	3002795	3002803		crcB	8
GRH001.A0202_rmdup	3004226	3004229		YPO_RS14360	3
GRH001.A0202_rmdup	3006662	3006680		chbR	18
GRH001.A0202_rmdup	3010754	3010764		pgm	10
GRH001.A0202_rmdup	3012178	3012236		YPO_RS14405	58
GRH001.A0202_rmdup	3013570	3013584		kdbD	14
GRH001.A0202_rmdup	3014534	3014545		kdbD	11
GRH001.A0202_rmdup	3015414	3015433		kdbD	19
GRH001.A0202_rmdup	3017220	3017221		kdpB	1
GRH001.A0202_rmdup	3017879	3017934		kdpB	55
GRH001.A0202_rmdup	3018340	3018344		kdpB	4
GRH001.A0202_rmdup	3018395	3018429		kdpB	34
GRH001.A0202_rmdup	3018757	3018766		kdpB	9
GRH001.A0202_rmdup	3019891	3019905		kdpA	14
GRH001.A0202_rmdup	3021060	3021140		YPO_RS14440	80
GRH001.A0202_rmdup	3022759	3022764		phrB	5
GRH001.A0202_rmdup	3024217	3024228		YPO_RS14460	11
GRH001.A0202_rmdup	3024590	3024609		YPO_RS14460	19
GRH001.A0202_rmdup	3024685	3024709		YPO_RS14460	24
GRH001.A0202_rmdup	3027505	3027553		YPO_RS14480	48
GRH001.A0202_rmdup	3027982	3027987		YPO_RS14480	5
GRH001.A0202_rmdup	3028641	3028659		pxpA	18
GRH001.A0202_rmdup	3029357	3029360		YPO_RS14490	3
GRH001.A0202_rmdup	3030262	3030277		YPO_RS14495	15
GRH001.A0202_rmdup	3030551	3030566		YPO_RS14495	15
GRH001.A0202_rmdup	3032089	3032094		ung	5
GRH001.A0202_rmdup	3037234	3037264		YPO_RS14530	30
GRH001.A0202_rmdup	3037615	3037630		nadB	15
GRH001.A0202_rmdup	3038754	3038766		nadB	12
GRH001.A0202_rmdup	3044408	3044412		lepA	4
GRH001.A0202_rmdup	3045714	3045743		lepB	29
GRH001.A0202_rmdup	3048426	3048452		recO	26
GRH001.A0202_rmdup	3050888	3050897		tssL	9
GRH001.A0202_rmdup	3051234	3051236		tssL	2
GRH001.A0202_rmdup	3051463	3051481		tssL	18
GRH001.A0202_rmdup	3056174	3056181		YPO_RS14610	7
GRH001.A0202_rmdup	3057247	3057262		YPO_RS14610	15
GRH001.A0202_rmdup	3059759	3059760		YPO_RS14620	1
GRH001.A0202_rmdup	3062507	3062510		YPO_RS14645	3
GRH001.A0202_rmdup	3063280	3063301		YPO_RS14645	21
GRH001.A0202_rmdup	3063421	3063428		YPO_RS14645	7
GRH001.A0202_rmdup	3066931	3066933		ccmA	2
GRH001.A0202_rmdup	3067861	3067867		YPO_RS14675	6
GRH001.A0202_rmdup	3070076	3070085		YPO_RS14690	9
GRH001.A0202_rmdup	3071492	3071493		YPO_RS14695	1
GRH001.A0202_rmdup	3074051	3074053		mlaA	2
GRH001.A0202_rmdup	3077137	3077141		fadI	4
GRH001.A0202_rmdup	3078579	3078599		fadJ	20
GRH001.A0202_rmdup	3080012	3080036		fadJ	24
GRH001.A0202_rmdup	3084874	3084884		mepA	10
GRH001.A0202_rmdup	3085495	3085505		mepA	10
GRH001.A0202_rmdup	3085791	3085792		YPO_RS14760	1
GRH001.A0202_rmdup	3088206	3088215		mnmC	9
GRH001.A0202_rmdup	3088899	3088911		mnmC	12
GRH001.A0202_rmdup	3090532	3090534		fabB	2
GRH001.A0202_rmdup	3093054	3093061		YPO_RS14790	7
GRH001.A0202_rmdup	3098192	3098215		pdxB	23
GRH001.A0202_rmdup	3099889	3099890		YPO_RS14820	1
GRH001.A0202_rmdup	3100333	3100346		truA	13
GRH001.A0202_rmdup	3103495	3103508		folC	13
GRH001.A0202_rmdup	3105257	3105269		dedD	12
GRH001.A0202_rmdup	3106767	3106828		purF	61
GRH001.A0202_rmdup	3110774	3110776		YPO_RS14875	2
GRH001.A0202_rmdup	3114615	3114644		yfcE	29
GRH001.A0202_rmdup	3116121	3116126		YPO_RS14905	5
GRH001.A0202_rmdup	3120316	3120561		YPO_RS14920	245
GRH001.A0202_rmdup	3121234	3121815		YPO_RS14925	581
GRH001.A0202_rmdup	3122083	3122484		YPO_RS14930	401
GRH001.A0202_rmdup	3122717	3123118		YPO_RS14935	401
GRH001.A0202_rmdup	3123130	3123655		YPO_RS14940	525
GRH001.A0202_rmdup	3123782	3123977		YPO_RS14945	195
GRH001.A0202_rmdup	3124016	3124255		YPO_RS14950	239
GRH001.A0202_rmdup	3125064	3125158		yapC	94
GRH001.A0202_rmdup	3125234	3125270		yapC	36
GRH001.A0202_rmdup	3125342	3125721		yapC	379
GRH001.A0202_rmdup	3125791	3126980		yapC	1189
GRH001.A0202_rmdup	3127166	3127226		YPO_RS14960	60
GRH001.A0202_rmdup	3127515	3127680		YPO_RS14965	165
GRH001.A0202_rmdup	3127756	3128096		YPO_RS14965	340
GRH001.A0202_rmdup	3130158	3131956		YPO_RS14980	1798
GRH001.A0202_rmdup	3132032	3132365		YPO_RS14980	333
GRH001.A0202_rmdup	3132358	3132888		YPO_RS14985	530
GRH001.A0202_rmdup	3133047	3135341		YPO_RS14990	2294
GRH001.A0202_rmdup	3135387	3135428		YPO_RS14990	41
GRH001.A0202_rmdup	3135507	3137135		YPO_RS14995	1628
GRH001.A0202_rmdup	3137608	3138304		YPO_RS15000	696
GRH001.A0202_rmdup	3138380	3138459		YPO_RS15000	79
GRH001.A0202_rmdup	3138485	3138985		YPO_RS15005	500
GRH001.A0202_rmdup	3139018	3139354		YPO_RS15005	336
GRH001.A0202_rmdup	3139416	3139474		YPO_RS15005	58
GRH001.A0202_rmdup	3139529	3139912		YPO_RS15010	383
GRH001.A0202_rmdup	3139964	3140422		YPO_RS15010	458
GRH001.A0202_rmdup	3142684	3142919		YPO_RS15025	235
GRH001.A0202_rmdup	3143126	3143487		YPO_RS15030	361
GRH001.A0202_rmdup	3143469	3144190		YPO_RS15035	721
GRH001.A0202_rmdup	3144598	3144664		YPO_RS15035	66
GRH001.A0202_rmdup	3144751	3144754		YPO_RS15035	3
GRH001.A0202_rmdup	3144876	3144971		YPO_RS15040	95
GRH001.A0202_rmdup	3145846	3145855		YPO_RS15040	9
GRH001.A0202_rmdup	3146304	3146321		YPO_RS15040	17
GRH001.A0202_rmdup	3146704	3146710		YPO_RS15045	6
GRH001.A0202_rmdup	3147397	3147409		YPO_RS15050	12
GRH001.A0202_rmdup	3147628	3147673		YPO_RS15050	45
GRH001.A0202_rmdup	3148501	3148514		YPO_RS15055	13
GRH001.A0202_rmdup	3150522	3150524		YPO_RS15075	2
GRH001.A0202_rmdup	3152341	3152346		folD	5
GRH001.A0202_rmdup	3152518	3152519		folD	1
GRH001.A0202_rmdup	3152570	3152582		folD	12
GRH001.A0202_rmdup	3155375	3155380		purM	5
GRH001.A0202_rmdup	3156610	3156623		purN	13
GRH001.A0202_rmdup	3159110	3159113		pstB	3
GRH001.A0202_rmdup	3160027	3160033		pstA	6
GRH001.A0202_rmdup	3160107	3160135		pstA	28
GRH001.A0202_rmdup	3163348	3163369		YPO_RS15145	21
GRH001.A0202_rmdup	3168932	3168934		mgtE	2
GRH001.A0202_rmdup	3171630	3171650		YPO_RS15175	20
GRH001.A0202_rmdup	3172301	3172336		YPO_RS15180	35
GRH001.A0202_rmdup	3175596	3175615		YPO_RS15190	19
GRH001.A0202_rmdup	3176243	3176244		YPO_RS15195	1
GRH001.A0202_rmdup	3176690	3176714		YPO_RS15195	24
GRH001.A0202_rmdup	3176834	3176835		YPO_RS15195	1
GRH001.A0202_rmdup	3178127	3178141		YPO_RS15200	14
GRH001.A0202_rmdup	3178685	3178691		YPO_RS15200	6
GRH001.A0202_rmdup	3178729	3178772		YPO_RS15200	43
GRH001.A0202_rmdup	3178946	3178955		YPO_RS15200	9
GRH001.A0202_rmdup	3179508	3179519		YPO_RS15205	11
GRH001.A0202_rmdup	3179888	3179914		YPO_RS15205	26
GRH001.A0202_rmdup	3180524	3180525		YPO_RS15205	1
GRH001.A0202_rmdup	3180951	3180952		YPO_RS15210	1
GRH001.A0202_rmdup	3181299	3181669		YPO_RS15210	370
GRH001.A0202_rmdup	3181714	3181753		YPO_RS15210	39
GRH001.A0202_rmdup	3181802	3181883		YPO_RS15210	81
GRH001.A0202_rmdup	3181916	3182167		YPO_RS15210	251
GRH001.A0202_rmdup	3182286	3182349		YPO_RS15210	63
GRH001.A0202_rmdup	3182465	3182467		YPO_RS15210	2
GRH001.A0202_rmdup	3183638	3183662		YPO_RS15210	24
GRH001.A0202_rmdup	3183893	3183900		mdtC	7
GRH001.A0202_rmdup	3183976	3183991		mdtC	15
GRH001.A0202_rmdup	3185633	3185657		mdtC	24
GRH001.A0202_rmdup	3186750	3186849		mdtC	99
GRH001.A0202_rmdup	3187647	3187650		YPO_RS15220	3
GRH001.A0202_rmdup	3194804	3194837		YPO_RS15250	33
GRH001.A0202_rmdup	3196287	3196328		thiD	41
GRH001.A0202_rmdup	3196562	3196570		thiD	8
GRH001.A0202_rmdup	3198212	3198232		YPO_RS15270	20
GRH001.A0202_rmdup	3200358	3200420		YPO_RS15285	62
GRH001.A0202_rmdup	3200580	3200587		YPO_RS15285	7
GRH001.A0202_rmdup	3200724	3200738		YPO_RS15290	14
GRH001.A0202_rmdup	3200829	3200864		YPO_RS15290	35
GRH001.A0202_rmdup	3201039	3201041		YPO_RS15290	2
GRH001.A0202_rmdup	3201125	3201168		YPO_RS15295	43
GRH001.A0202_rmdup	3201286	3201416		YPO_RS15295	130
GRH001.A0202_rmdup	3201484	3201503		YPO_RS15295	19
GRH001.A0202_rmdup	3201567	3201676		YPO_RS15300	109
GRH001.A0202_rmdup	3201736	3201786		YPO_RS15300	50
GRH001.A0202_rmdup	3201869	3201910		YPO_RS15300	41
GRH001.A0202_rmdup	3202233	3202255		YPO_RS15305	22
GRH001.A0202_rmdup	3203837	3203844		guaA	7
GRH001.A0202_rmdup	3207254	3207257		xseA	3
GRH001.A0202_rmdup	3208044	3208055		xseA	11
GRH001.A0202_rmdup	3208769	3208773		YPO_RS15335	4
GRH001.A0202_rmdup	3212147	3212153		bamB	6
GRH001.A0202_rmdup	3212306	3212317		bamB	11
GRH001.A0202_rmdup	3216182	3216216		rodZ	34
GRH001.A0202_rmdup	3216351	3216362		rodZ	11
GRH001.A0202_rmdup	3217799	3217801		pilW	2
GRH001.A0202_rmdup	3221809	3221862		YPO_RS15385	53
GRH001.A0202_rmdup	3221972	3221984		YPO_RS15385	12
GRH001.A0202_rmdup	3222085	3222136		YPO_RS15385	51
GRH001.A0202_rmdup	3222637	3222651		YPO_RS15385	14
GRH001.A0202_rmdup	3223551	3223565		yapA	14
GRH001.A0202_rmdup	3224999	3225020		yapA	21
GRH001.A0202_rmdup	3225087	3225134		yapA	47
GRH001.A0202_rmdup	3225266	3225272		yapA	6
GRH001.A0202_rmdup	3225479	3225513		yapA	34
GRH001.A0202_rmdup	3225579	3225642		yapA	63
GRH001.A0202_rmdup	3225809	3225812		yapA	3
GRH001.A0202_rmdup	3226255	3226278		yapA	23
GRH001.A0202_rmdup	3227046	3227050		yapA	4
GRH001.A0202_rmdup	3229558	3229559		YPO_RS15395	1
GRH001.A0202_rmdup	3229651	3229669		YPO_RS15395	18
GRH001.A0202_rmdup	3229834	3229927		YPO_RS15395	93
GRH001.A0202_rmdup	3230068	3230093		YPO_RS15395	25
GRH001.A0202_rmdup	3230206	3230213		YPO_RS15395	7
GRH001.A0202_rmdup	3230507	3230519		YPO_RS15395	12
GRH001.A0202_rmdup	3230872	3230910		YPO_RS15395	38
GRH001.A0202_rmdup	3231144	3231145		YPO_RS15395	1
GRH001.A0202_rmdup	3231517	3231524		YPO_RS15400	7
GRH001.A0202_rmdup	3231837	3231862		YPO_RS15405	25
GRH001.A0202_rmdup	3233215	3233218		pepB	3
GRH001.A0202_rmdup	3233361	3233438		pepB	77
GRH001.A0202_rmdup	3234288	3234313		pepB	25
GRH001.A0202_rmdup	3236076	3236077		hscA	1
GRH001.A0202_rmdup	3236702	3236705		hscA	3
GRH001.A0202_rmdup	3236873	3236880		hscA	7
GRH001.A0202_rmdup	3237755	3237778		hscB	23
GRH001.A0202_rmdup	3239430	3239472		YPO_RS15450	42
GRH001.A0202_rmdup	3240524	3240551		iscR	27
GRH001.A0202_rmdup	3241366	3241418		trmJ	52
GRH001.A0202_rmdup	3244947	3244949		YPO_RS15480	2
GRH001.A0202_rmdup	3257124	3257148		qseG	24
GRH001.A0202_rmdup	3257658	3257692		qseG	34
GRH001.A0202_rmdup	3260336	3260346		YPO_RS15550	10
GRH001.A0202_rmdup	3262683	3262752		YPO_RS15560	69
GRH001.A0202_rmdup	3263378	3263447		purL	69
GRH001.A0202_rmdup	3265096	3265099		purL	3
GRH001.A0202_rmdup	3265846	3265852		purL	6
GRH001.A0202_rmdup	3266013	3266021		purL	8
GRH001.A0202_rmdup	3268107	3268108		mltF	1
GRH001.A0202_rmdup	3268284	3268296		mltF	12
GRH001.A0202_rmdup	3268530	3268531		mltF	1
GRH001.A0202_rmdup	3270017	3270039		yfhb	22
GRH001.A0202_rmdup	3281156	3281158		tssC	2
GRH001.A0202_rmdup	3284284	3284285		YPO_RS15665	1
GRH001.A0202_rmdup	3285803	3285819		YPO_RS15675	16
GRH001.A0202_rmdup	3285987	3285993		YPO_RS15675	6
GRH001.A0202_rmdup	3288013	3288016		YPO_RS15680	3
GRH001.A0202_rmdup	3290607	3290610		tssH	3
GRH001.A0202_rmdup	3291253	3291287		tssH	34
GRH001.A0202_rmdup	3291485	3291510		tssH	25
GRH001.A0202_rmdup	3294183	3294234		tssF	51
GRH001.A0202_rmdup	3294801	3294816		tssG	15
GRH001.A0202_rmdup	3295458	3295459		tssG	1
GRH001.A0202_rmdup	3296304	3296335		YPO_RS15705	31
GRH001.A0202_rmdup	3296557	3296560		YPO_RS15705	3
GRH001.A0202_rmdup	3297918	3297934		YPO_RS15715	16
GRH001.A0202_rmdup	3298048	3298124		YPO_RS15715	76
GRH001.A0202_rmdup	3298451	3298468		YPO_RS15715	17
GRH001.A0202_rmdup	3300867	3300932		YPO_RS15725	65
GRH001.A0202_rmdup	3304712	3304735		mltB	23
GRH001.A0202_rmdup	3305257	3305285		mltB	28
GRH001.A0202_rmdup	3305872	3305878		YPO_RS15745	6
GRH001.A0202_rmdup	3307108	3307141		YPO_RS15750	33
GRH001.A0202_rmdup	3308055	3308101		YPO_RS15750	46
GRH001.A0202_rmdup	3309018	3309037		YPO_RS15755	19
GRH001.A0202_rmdup	3310669	3310670		YPO_RS15765	1
GRH001.A0202_rmdup	3310926	3310933		YPO_RS15765	7
GRH001.A0202_rmdup	3313687	3313689		YPO_RS15775	2
GRH001.A0202_rmdup	3314551	3314558		YPO_RS15775	7
GRH001.A0202_rmdup	3314864	3314870		YPO_RS15775	6
GRH001.A0202_rmdup	3315970	3316005		YPO_RS15785	35
GRH001.A0202_rmdup	3316509	3316510		YPO_RS15785	1
GRH001.A0202_rmdup	3317380	3317381		YPO_RS15790	1
GRH001.A0202_rmdup	3318862	3318891		YPO_RS15800	29
GRH001.A0202_rmdup	3319154	3319168		YPO_RS15800	14
GRH001.A0202_rmdup	3320256	3320272		YPO_RS15810	16
GRH001.A0202_rmdup	3323337	3323343		alaC	6
GRH001.A0202_rmdup	3329176	3329179		YPO_RS15855	3
GRH001.A0202_rmdup	3329698	3329713		YPO_RS15860	15
GRH001.A0202_rmdup	3333564	3333576		gltX	12
GRH001.A0202_rmdup	3334042	3334078		gltX	36
GRH001.A0202_rmdup	3338411	3338419		ligA	8
GRH001.A0202_rmdup	3340543	3340556		zipA	13
GRH001.A0202_rmdup	3342427	3342460		cysK	33
GRH001.A0202_rmdup	3346834	3346835		YPO_RS15975	1
GRH001.A0202_rmdup	3348698	3348707		YPO_RS15980	9
GRH001.A0202_rmdup	3350118	3350124		YPO_RS15985	6
GRH001.A0202_rmdup	3350878	3350896		macB	18
GRH001.A0202_rmdup	3351201	3351203		macB	2
GRH001.A0202_rmdup	3351980	3351991		macB	11
GRH001.A0202_rmdup	3352771	3352823		YPO_RS15995	52
GRH001.A0202_rmdup	3353311	3353326		YPO_RS15995	15
GRH001.A0202_rmdup	3354085	3354096		YPO_RS15995	11
GRH001.A0202_rmdup	3354296	3354305		YPO_RS16000	9
GRH001.A0202_rmdup	3356925	3356933		YPO_RS16010	8
GRH001.A0202_rmdup	3358281	3358285		YPO_RS16020	4
GRH001.A0202_rmdup	3361511	3361521		YPO_RS16030	10
GRH001.A0202_rmdup	3363678	3363725		YPO_RS16040	47
GRH001.A0202_rmdup	3363833	3363839		YPO_RS16040	6
GRH001.A0202_rmdup	3364687	3364737		YPO_RS16040	50
GRH001.A0202_rmdup	3365850	3365860		cysM	10
GRH001.A0202_rmdup	3366145	3366170		cysA	25
GRH001.A0202_rmdup	3366248	3366274		cysA	26
GRH001.A0202_rmdup	3367293	3367304		cysW	11
GRH001.A0202_rmdup	3367400	3367403		cysW	3
GRH001.A0202_rmdup	3369642	3369643		YPO_RS16065	1
GRH001.A0202_rmdup	3371434	3371435		YPO_RS16070	1
GRH001.A0202_rmdup	3371647	3371654		YPO_RS16070	7
GRH001.A0202_rmdup	3372478	3372480		YPO_RS16075	2
GRH001.A0202_rmdup	3372620	3372627		YPO_RS16075	7
GRH001.A0202_rmdup	3372733	3372772		YPO_RS16075	39
GRH001.A0202_rmdup	3373022	3373028		YPO_RS16075	6
GRH001.A0202_rmdup	3374206	3374212		YPO_RS16085	6
GRH001.A0202_rmdup	3376470	3376476		YPO_RS16095	6
GRH001.A0202_rmdup	3377956	3377970		YPO_RS16100	14
GRH001.A0202_rmdup	3378759	3378790		YPO_RS16105	31
GRH001.A0202_rmdup	3381662	3381663		yapL	1
GRH001.A0202_rmdup	3383562	3383571		YPO_RS16125	9
GRH001.A0202_rmdup	3383850	3383889		YPO_RS16125	39
GRH001.A0202_rmdup	3384580	3384594		YPO_RS16130	14
GRH001.A0202_rmdup	3385210	3385221		hemF	11
GRH001.A0202_rmdup	3386719	3386755		maeB	36
GRH001.A0202_rmdup	3387100	3387113		maeB	13
GRH001.A0202_rmdup	3387537	3387544		maeB	7
GRH001.A0202_rmdup	3389315	3389316		nudK	1
GRH001.A0202_rmdup	3392618	3392626		napA	8
GRH001.A0202_rmdup	3396892	3396894		acrD	2
GRH001.A0202_rmdup	3403425	3403443		YPO_RS16210	18
GRH001.A0202_rmdup	3404192	3404193		YPO_RS16210	1
GRH001.A0202_rmdup	3404684	3404707		YPO_RS16210	23
GRH001.A0202_rmdup	3405484	3405530		YPO_RS16220	46
GRH001.A0202_rmdup	3405632	3405675		YPO_RS16220	43
GRH001.A0202_rmdup	3406044	3406065		YPO_RS16220	21
GRH001.A0202_rmdup	3406420	3406424		YPO_RS16220	4
GRH001.A0202_rmdup	3407187	3407194		YPO_RS16225	7
GRH001.A0202_rmdup	3411004	3411022		dapE	18
GRH001.A0202_rmdup	3411957	3411959		YPO_RS16250	2
GRH001.A0202_rmdup	3413043	3413065		YPO_RS16260	22
GRH001.A0202_rmdup	3413687	3413702		YPO_RS16260	15
GRH001.A0202_rmdup	3413742	3413763		YPO_RS16260	21
GRH001.A0202_rmdup	3414454	3414466		YPO_RS16260	12
GRH001.A0202_rmdup	3414566	3414588		YPO_RS16260	22
GRH001.A0202_rmdup	3414655	3414666		YPO_RS16260	11
GRH001.A0202_rmdup	3415240	3415255		YPO_RS16265	15
GRH001.A0202_rmdup	3416364	3416435		YPO_RS16270	71
GRH001.A0202_rmdup	3422453	3422462		YPO_RS16305	9
GRH001.A0202_rmdup	3424778	3424793		YPO_RS16315	15
GRH001.A0202_rmdup	3424885	3424895		YPO_RS16315	10
GRH001.A0202_rmdup	3432091	3432132		purE	41
GRH001.A0202_rmdup	3432645	3432672		purK	27
GRH001.A0202_rmdup	3433456	3433471		YPO_RS16360	15
GRH001.A0202_rmdup	3433633	3433662		YPO_RS16360	29
GRH001.A0202_rmdup	3433768	3433770		YPO_RS16360	2
GRH001.A0202_rmdup	3434161	3434164		YPO_RS16360	3
GRH001.A0202_rmdup	3434438	3434450		YPO_RS16360	12
GRH001.A0202_rmdup	3434609	3434612		YPO_RS16360	3
GRH001.A0202_rmdup	3434790	3434795		YPO_RS16360	5
GRH001.A0202_rmdup	3434889	3434920		YPO_RS16360	31
GRH001.A0202_rmdup	3434999	3435019		YPO_RS16360	20
GRH001.A0202_rmdup	3435443	3435469		YPO_RS16360	26
GRH001.A0202_rmdup	3435573	3435603		YPO_RS16360	30
GRH001.A0202_rmdup	3435688	3435725		YPO_RS16360	37
GRH001.A0202_rmdup	3437812	3438171		YPO_RS16375	359
GRH001.A0202_rmdup	3438205	3438248		YPO_RS16375	43
GRH001.A0202_rmdup	3438325	3438458		YPO_RS16380	133
GRH001.A0202_rmdup	3438518	3439194		YPO_RS16380	676
GRH001.A0202_rmdup	3439389	3439641		YPO_RS16385	252
GRH001.A0202_rmdup	3439748	3439880		YPO_RS16385	132
GRH001.A0202_rmdup	3440936	3440937		cueR	1
GRH001.A0202_rmdup	3442100	3442110		copA	10
GRH001.A0202_rmdup	3442474	3442479		copA	5
GRH001.A0202_rmdup	3443265	3443294		copA	29
GRH001.A0202_rmdup	3443456	3443496		copA	40
GRH001.A0202_rmdup	3444280	3444290		copA	10
GRH001.A0202_rmdup	3445207	3445214		YPO_RS16405	7
GRH001.A0202_rmdup	3445493	3445496		YPO_RS16405	3
GRH001.A0202_rmdup	3449338	3449340		YPO_RS16425	2
GRH001.A0202_rmdup	3450538	3450557		YPO_RS16430	19
GRH001.A0202_rmdup	3450598	3450621		YPO_RS16430	23
GRH001.A0202_rmdup	3451221	3451228		YPO_RS16430	7
GRH001.A0202_rmdup	3451334	3451344		YPO_RS16430	10
GRH001.A0202_rmdup	3451822	3451846		YPO_RS16430	24
GRH001.A0202_rmdup	3453988	3454008		fepE	20
GRH001.A0202_rmdup	3455899	3455948		cpsG	49
GRH001.A0202_rmdup	3456550	3456574		YPO_RS16450	24
GRH001.A0202_rmdup	3457109	3457111		YPO_RS16450	2
GRH001.A0202_rmdup	3458534	3458539		YPO_RS16455	5
GRH001.A0202_rmdup	3461838	3461854		YPO_RS16470	16
GRH001.A0202_rmdup	3463321	3463340		YPO_RS16480	19
GRH001.A0202_rmdup	3463466	3463495		YPO_RS16480	29
GRH001.A0202_rmdup	3463727	3463817		YPO_RS16480	90
GRH001.A0202_rmdup	3464163	3464177		YPO_RS16480	14
GRH001.A0202_rmdup	3464843	3464870		YPO_RS16485	27
GRH001.A0202_rmdup	3465052	3465092		YPO_RS16485	40
GRH001.A0202_rmdup	3465299	3465322		YPO_RS16485	23
GRH001.A0202_rmdup	3465521	3465556		YPO_RS16485	35
GRH001.A0202_rmdup	3465567	3465574		YPO_RS16490	7
GRH001.A0202_rmdup	3466267	3466353		YPO_RS16490	86
GRH001.A0202_rmdup	3466543	3466680		YPO_RS16490	137
GRH001.A0202_rmdup	3466984	3466985		YPO_RS16495	1
GRH001.A0202_rmdup	3467582	3467611		YPO_RS16495	29
GRH001.A0202_rmdup	3468657	3468704		YPO_RS16500	47
GRH001.A0202_rmdup	3469113	3469125		YPO_RS16500	12
GRH001.A0202_rmdup	3471176	3471181		rfbG	5
GRH001.A0202_rmdup	3472542	3472577		YPO_RS16520	35
GRH001.A0202_rmdup	3473359	3473373		YPO_RS16520	14
GRH001.A0202_rmdup	3474280	3474282		hemH	2
GRH001.A0202_rmdup	3479591	3479595		dnaX	4
GRH001.A0202_rmdup	3479767	3479792		dnaX	25
GRH001.A0202_rmdup	3481646	3481661		apt	15
GRH001.A0202_rmdup	3482098	3482108		apt	10
GRH001.A0202_rmdup	3487014	3487018		mscK	4
GRH001.A0202_rmdup	3487203	3487253		mscK	50
GRH001.A0202_rmdup	3488150	3488152		mscK	2
GRH001.A0202_rmdup	3492405	3492409		YPO_RS16605	4
GRH001.A0202_rmdup	3492806	3492816		YPO_RS16605	10
GRH001.A0202_rmdup	3493620	3493624		YPO_RS16605	4
GRH001.A0202_rmdup	3493869	3493882		YPO_RS16605	13
GRH001.A0202_rmdup	3495120	3495185		YPO_RS16605	65
GRH001.A0202_rmdup	3496948	3496949		YPO_RS16620	1
GRH001.A0202_rmdup	3502023	3502028		amtB	5
GRH001.A0202_rmdup	3505503	3505547		YPO_RS16670	44
GRH001.A0202_rmdup	3505819	3505841		YPO_RS16670	22
GRH001.A0202_rmdup	3506090	3506111		YPO_RS16670	21
GRH001.A0202_rmdup	3506475	3506495		YPO_RS16670	20
GRH001.A0202_rmdup	3506815	3506834		YPO_RS16670	19
GRH001.A0202_rmdup	3507410	3507424		YPO_RS16675	14
GRH001.A0202_rmdup	3517087	3517095		lon	8
GRH001.A0202_rmdup	3517776	3517793		lon	17
GRH001.A0202_rmdup	3520941	3520946		clpP	5
GRH001.A0202_rmdup	3524941	3524948		ampG	7
GRH001.A0202_rmdup	3527235	3527267		YPO_RS16755	32
GRH001.A0202_rmdup	3530081	3530089		cyoB	8
GRH001.A0202_rmdup	3531300	3531320		YPO_RS16775	20
GRH001.A0202_rmdup	3531960	3531972		cyoE	12
GRH001.A0202_rmdup	3535850	3535859		panE	9
GRH001.A0202_rmdup	3535911	3535933		panE	22
GRH001.A0202_rmdup	3536328	3536342		yajL	14
GRH001.A0202_rmdup	3537253	3537268		thiI	15
GRH001.A0202_rmdup	3537448	3537454		thiI	6
GRH001.A0202_rmdup	3542901	3542911		pgpA	10
GRH001.A0202_rmdup	3543184	3543186		thiL	2
GRH001.A0202_rmdup	3546204	3546236		ribD	32
GRH001.A0202_rmdup	3548037	3548067		YPO_RS16865	30
GRH001.A0202_rmdup	3551372	3551385		secD	13
GRH001.A0202_rmdup	3552466	3552468		yajC	2
GRH001.A0202_rmdup	3552972	3552975		tgt	3
GRH001.A0202_rmdup	3560254	3560259		YPO_RS16920	5
GRH001.A0202_rmdup	3560404	3560426		YPO_RS16925	22
GRH001.A0202_rmdup	3560548	3560579		malZ	31
GRH001.A0202_rmdup	3561574	3561583		malZ	9
GRH001.A0202_rmdup	3568944	3568951		phoB	7
GRH001.A0202_rmdup	3570093	3570112		sbcD	19
GRH001.A0202_rmdup	3572091	3572125		YPO_RS16965	34
GRH001.A0202_rmdup	3572776	3572781		YPO_RS16965	5
GRH001.A0202_rmdup	3574413	3574420		YPO_RS16965	7
GRH001.A0202_rmdup	3577891	3577893		mak	2
GRH001.A0202_rmdup	3583086	3583093		YPO_RS17010	7
GRH001.A0202_rmdup	3583267	3583270		YPO_RS17010	3
GRH001.A0202_rmdup	3584762	3584781		proA	19
GRH001.A0202_rmdup	3584936	3584958		proA	22
GRH001.A0202_rmdup	3587848	3587854		frsA	6
GRH001.A0202_rmdup	3590090	3590128		YPO_RS17045	38
GRH001.A0202_rmdup	3590392	3590419		YPO_RS17050	27
GRH001.A0202_rmdup	3595726	3595727		pepD	1
GRH001.A0202_rmdup	3596073	3596082		pepD	9
GRH001.A0202_rmdup	3596191	3596199		pepD	8
GRH001.A0202_rmdup	3598221	3598240		YPO_RS17070	19
GRH001.A0202_rmdup	3598512	3598517		YPO_RS17070	5
GRH001.A0202_rmdup	3599058	3599068		YPO_RS17070	10
GRH001.A0202_rmdup	3599993	3600037		YPO_RS17080	44
GRH001.A0202_rmdup	3600165	3600170		YPO_RS17080	5
GRH001.A0202_rmdup	3605333	3605354		YPO_RS17110	21
GRH001.A0202_rmdup	3607048	3607054		YPO_RS17115	6
GRH001.A0202_rmdup	3609217	3609235		lpcA	18
GRH001.A0202_rmdup	3611622	3611634		YPO_RS17130	12
GRH001.A0202_rmdup	3613619	3613620		YPO_RS17140	1
GRH001.A0202_rmdup	3615542	3615571		YPO_RS17145	29
GRH001.A0202_rmdup	3616586	3616603		YPO_RS17145	17
GRH001.A0202_rmdup	3618880	3618904		YPO_RS17145	24
GRH001.A0202_rmdup	3619167	3619214		YPO_RS17145	47
GRH001.A0202_rmdup	3619498	3619501		YPO_RS17145	3
GRH001.A0202_rmdup	3620024	3620032		YPO_RS17145	8
GRH001.A0202_rmdup	3624077	3624087		YPO_RS17160	10
GRH001.A0202_rmdup	3624527	3624535		YPO_RS17160	8
GRH001.A0202_rmdup	3628350	3628367		YPO_RS17185	17
GRH001.A0202_rmdup	3628400	3628414		YPO_RS17185	14
GRH001.A0202_rmdup	3628750	3628756		YPO_RS17185	6
GRH001.A0202_rmdup	3629187	3629198		YPO_RS17190	11
GRH001.A0202_rmdup	3629427	3629442		YPO_RS17190	15
GRH001.A0202_rmdup	3629818	3629832		YPO_RS17195	14
GRH001.A0202_rmdup	3629913	3629935		YPO_RS17195	22
GRH001.A0202_rmdup	3630473	3630483		YPO_RS17200	10
GRH001.A0202_rmdup	3631553	3631593		YPO_RS17205	40
GRH001.A0202_rmdup	3631633	3631667		YPO_RS17205	34
GRH001.A0202_rmdup	3633911	3633931		YPO_RS17215	20
GRH001.A0202_rmdup	3635267	3635315		YPO_RS17225	48
GRH001.A0202_rmdup	3636269	3636276		YPO_RS17230	7
GRH001.A0202_rmdup	3636871	3636883		YPO_RS17230	12
GRH001.A0202_rmdup	3637112	3637146		ygaH	34
GRH001.A0202_rmdup	3637511	3637514		mprA	3
GRH001.A0202_rmdup	3638952	3638958		emrA	6
GRH001.A0202_rmdup	3639040	3639069		emrA	29
GRH001.A0202_rmdup	3641036	3641047		emrB	11
GRH001.A0202_rmdup	3641769	3641781		YPO_RS17255	12
GRH001.A0202_rmdup	3642165	3642180		YPO_RS17255	15
GRH001.A0202_rmdup	3644354	3644395		YPO_RS17270	41
GRH001.A0202_rmdup	3644865	3644885		YPO_RS17270	20
GRH001.A0202_rmdup	3645290	3645299		YPO_RS17270	9
GRH001.A0202_rmdup	3645650	3645655		YPO_RS17270	5
GRH001.A0202_rmdup	3646532	3646553		YPO_RS17270	21
GRH001.A0202_rmdup	3647276	3647279		pssA	3
GRH001.A0202_rmdup	3649933	3649940		YPO_RS17290	7
GRH001.A0202_rmdup	3654004	3654010		YPO_RS17305	6
GRH001.A0202_rmdup	3654246	3654250		YPO_RS17310	4
GRH001.A0202_rmdup	3654821	3654847		clpB	26
GRH001.A0202_rmdup	3655133	3655182		clpB	49
GRH001.A0202_rmdup	3657835	3657839		pgeF	4
GRH001.A0202_rmdup	3658331	3658345		rluD	14
GRH001.A0202_rmdup	3658546	3658581		rluD	35
GRH001.A0202_rmdup	3662470	3662490		pheA	20
GRH001.A0202_rmdup	3662695	3662696		pheA	1
GRH001.A0202_rmdup	3665413	3665443		tyrA	30
GRH001.A0202_rmdup	3670290	3670333		YPO_RS17385	43
GRH001.A0202_rmdup	3681292	3681309		YPO_RS17445	17
GRH001.A0202_rmdup	3681935	3681958		yqaB	23
GRH001.A0202_rmdup	3682313	3682326		YPO_RS17455	13
GRH001.A0202_rmdup	3682485	3682499		YPO_RS17460	14
GRH001.A0202_rmdup	3684203	3684213		alaS	10
GRH001.A0202_rmdup	3684589	3684612		alaS	23
GRH001.A0202_rmdup	3684724	3684729		alaS	5
GRH001.A0202_rmdup	3687364	3687377		recA	13
GRH001.A0202_rmdup	3688759	3688768		pncC	9
GRH001.A0202_rmdup	3689601	3689603		YPO_RS17505	2
GRH001.A0202_rmdup	3690111	3690128		YPO_RS17505	17
GRH001.A0202_rmdup	3692377	3692379		YPO_RS17515	2
GRH001.A0202_rmdup	3693504	3693544		YPO_RS17520	40
GRH001.A0202_rmdup	3693918	3693920		YPO_RS17520	2
GRH001.A0202_rmdup	3694388	3694416		YPO_RS17520	28
GRH001.A0202_rmdup	3694730	3694770		YPO_RS17520	40
GRH001.A0202_rmdup	3695862	3695872		YPO_RS17530	10
GRH001.A0202_rmdup	3697211	3697214		YPO_RS17535	3
GRH001.A0202_rmdup	3697717	3697748		YPO_RS17535	31
GRH001.A0202_rmdup	3698532	3698536		YPO_RS17540	4
GRH001.A0202_rmdup	3698748	3698763		YPO_RS17540	15
GRH001.A0202_rmdup	3699615	3699637		YPO_RS17545	22
GRH001.A0202_rmdup	3702982	3702986		katG	4
GRH001.A0202_rmdup	3704382	3704409		cybC	27
GRH001.A0202_rmdup	3704750	3704773		cybB	23
GRH001.A0202_rmdup	3705410	3705432		dmsD	22
GRH001.A0202_rmdup	3707814	3707828		dmsA	14
GRH001.A0202_rmdup	3709378	3709383		dmsA	5
GRH001.A0202_rmdup	3709481	3709516		dmsA	35
GRH001.A0202_rmdup	3709617	3709620		dmsA	3
GRH001.A0202_rmdup	3709975	3709980		dmsA	5
GRH001.A0202_rmdup	3711090	3711099		YPO_RS17590	9
GRH001.A0202_rmdup	3715308	3715326		YPO_RS17610	18
GRH001.A0202_rmdup	3715362	3715369		YPO_RS17610	7
GRH001.A0202_rmdup	3722291	3722297		YPO_RS17635	6
GRH001.A0202_rmdup	3723200	3723206		YPO_RS17640	6
GRH001.A0202_rmdup	3723993	3724009		map	16
GRH001.A0202_rmdup	3725452	3725465		YPO_RS17650	13
GRH001.A0202_rmdup	3725640	3725690		YPO_RS17650	50
GRH001.A0202_rmdup	3737151	3737179		YPO_RS17705	28
GRH001.A0202_rmdup	3737442	3737453		YPO_RS17705	11
GRH001.A0202_rmdup	3738371	3738380		YPO_RS17710	9
GRH001.A0202_rmdup	3739294	3739296		YPO_RS17715	2
GRH001.A0202_rmdup	3742112	3742127		mutS	15
GRH001.A0202_rmdup	3743098	3743101		mutS	3
GRH001.A0202_rmdup	3744572	3744575		rpoS	3
GRH001.A0202_rmdup	3745874	3745905		nlpD	31
GRH001.A0202_rmdup	3746850	3746874		YPO_RS17740	24
GRH001.A0202_rmdup	3747904	3747906		truD	2
GRH001.A0202_rmdup	3754065	3754091		cysD	26
GRH001.A0202_rmdup	3754472	3754485		cobA	13
GRH001.A0202_rmdup	3754585	3754620		cobA	35
GRH001.A0202_rmdup	3754785	3754803		cobA	18
GRH001.A0202_rmdup	3754872	3754903		cobA	31
GRH001.A0202_rmdup	3758356	3758371		cysI	15
GRH001.A0202_rmdup	3759112	3759118		cysI	6
GRH001.A0202_rmdup	3760433	3760458		cysJ	25
GRH001.A0202_rmdup	3761346	3761350		cysJ	4
GRH001.A0202_rmdup	3761524	3761525		cysJ	1
GRH001.A0202_rmdup	3763701	3763717		YPO_RS17840	16
GRH001.A0202_rmdup	3766131	3766139		pyrG	8
GRH001.A0202_rmdup	3767723	3767724		mazG	1
GRH001.A0202_rmdup	3768810	3768812		relA	2
GRH001.A0202_rmdup	3768925	3768933		relA	8
GRH001.A0202_rmdup	3769300	3769301		relA	1
GRH001.A0202_rmdup	3769726	3769734		relA	8
GRH001.A0202_rmdup	3769963	3769966		relA	3
GRH001.A0202_rmdup	3770685	3770696		relA	11
GRH001.A0202_rmdup	3772798	3772822		barA	24
GRH001.A0202_rmdup	3779272	3779303		btuF	31
GRH001.A0202_rmdup	3779567	3779577		YPO_RS17900	10
GRH001.A0202_rmdup	3779824	3779853		YPO_RS17900	29
GRH001.A0202_rmdup	3781205	3781211		clcA	6
GRH001.A0202_rmdup	3782900	3782914		hemL	14
GRH001.A0202_rmdup	3783346	3783367		hemL	21
GRH001.A0202_rmdup	3784701	3784703		fhuB	2
GRH001.A0202_rmdup	3785664	3785674		fhuB	10
GRH001.A0202_rmdup	3785967	3785972		fhuB	5
GRH001.A0202_rmdup	3786956	3786989		fhuD	33
GRH001.A0202_rmdup	3787590	3787618		fhuC	28
GRH001.A0202_rmdup	3787853	3787894		fhuC	41
GRH001.A0202_rmdup	3788856	3788859		mrcB	3
GRH001.A0202_rmdup	3789164	3789169		mrcB	5
GRH001.A0202_rmdup	3790151	3790152		mrcB	1
GRH001.A0202_rmdup	3791442	3791450		hrpB	8
GRH001.A0202_rmdup	3791837	3791890		hrpB	53
GRH001.A0202_rmdup	3792025	3792073		hrpB	48
GRH001.A0202_rmdup	3792181	3792204		hrpB	23
GRH001.A0202_rmdup	3792287	3792295		hrpB	8
GRH001.A0202_rmdup	3793655	3793712		thpR	57
GRH001.A0202_rmdup	3794011	3794022		thpR	11
GRH001.A0202_rmdup	3796176	3796196		gluQRS	20
GRH001.A0202_rmdup	3796291	3796328		gluQRS	37
GRH001.A0202_rmdup	3799704	3799714		panB	10
GRH001.A0202_rmdup	3799958	3799970		panB	12
GRH001.A0202_rmdup	3800340	3800345		panC	5
GRH001.A0202_rmdup	3801880	3801881		YPO_RS17990	1
GRH001.A0202_rmdup	3804677	3804683		YPO_RS18000	6
GRH001.A0202_rmdup	3805636	3805639		can	3
GRH001.A0202_rmdup	3807312	3807313		cueO	1
GRH001.A0202_rmdup	3807478	3807479		cueO	1
GRH001.A0202_rmdup	3808043	3808079		cueO	36
GRH001.A0202_rmdup	3808134	3808136		cueO	2
GRH001.A0202_rmdup	3809808	3809835		speE	27
GRH001.A0202_rmdup	3812004	3812034		YPO_RS18035	30
GRH001.A0202_rmdup	3812154	3812183		YPO_RS18035	29
GRH001.A0202_rmdup	3812220	3812227		YPO_RS18035	7
GRH001.A0202_rmdup	3813544	3813551		acnB	7
GRH001.A0202_rmdup	3814803	3814809		acnB	6
GRH001.A0202_rmdup	3817476	3817481		lpdA	5
GRH001.A0202_rmdup	3818815	3818835		aceF	20
GRH001.A0202_rmdup	3820051	3820067		aceF	16
GRH001.A0202_rmdup	3820320	3820326		aceE	6
GRH001.A0202_rmdup	3827184	3827189		ampE	5
GRH001.A0202_rmdup	3833280	3833281		YPO_RS18110	1
GRH001.A0202_rmdup	3834039	3834045		YPO_RS18110	6
GRH001.A0202_rmdup	3834608	3834620		coaE	12
GRH001.A0202_rmdup	3835043	3835056		coaE	13
GRH001.A0202_rmdup	3838872	3838906		YPO_RS18145	34
GRH001.A0202_rmdup	3839474	3839518		YPO_RS18145	44
GRH001.A0202_rmdup	3841258	3841259		YPO_RS18150	1
GRH001.A0202_rmdup	3845250	3845253		lptF	3
GRH001.A0202_rmdup	3848475	3848485		YPO_RS18185	10
GRH001.A0202_rmdup	3848949	3848966		YPO_RS18185	17
GRH001.A0202_rmdup	3849550	3849560		YPO_RS18185	10
GRH001.A0202_rmdup	3850760	3850761		YPO_RS18185	1
GRH001.A0202_rmdup	3851298	3851315		YPO_RS18190	17
GRH001.A0202_rmdup	3857007	3857081		YPO_RS18215	74
GRH001.A0202_rmdup	3857422	3857427		YPO_RS18215	5
GRH001.A0202_rmdup	3857665	3857673		YPO_RS18215	8
GRH001.A0202_rmdup	3858130	3858153		YPO_RS18220	23
GRH001.A0202_rmdup	3858527	3858602		YPO_RS18220	75
GRH001.A0202_rmdup	3858763	3858779		YPO_RS18220	16
GRH001.A0202_rmdup	3858953	3858966		YPO_RS18225	13
GRH001.A0202_rmdup	3859679	3859713		YPO_RS18225	34
GRH001.A0202_rmdup	3862053	3862065		nrdD	12
GRH001.A0202_rmdup	3863422	3863435		nrdG	13
GRH001.A0202_rmdup	3864824	3864851		phnG	27
GRH001.A0202_rmdup	3864986	3864995		phnG	9
GRH001.A0202_rmdup	3868090	3868096		phnK	6
GRH001.A0202_rmdup	3868661	3868694		phnK	33
GRH001.A0202_rmdup	3869140	3869149		phnL	9
GRH001.A0202_rmdup	3869246	3869267		phnL	21
GRH001.A0202_rmdup	3869474	3869504		phnL	30
GRH001.A0202_rmdup	3870037	3870049		phnM	12
GRH001.A0202_rmdup	3870163	3870167		phnM	4
GRH001.A0202_rmdup	3870238	3870258		phnM	20
GRH001.A0202_rmdup	3870572	3870577		phnM	5
GRH001.A0202_rmdup	3871024	3871029		phnN	5
GRH001.A0202_rmdup	3871156	3871172		phnN	16
GRH001.A0202_rmdup	3871793	3871805		phnP	12
GRH001.A0202_rmdup	3872032	3872045		phnP	13
GRH001.A0202_rmdup	3874222	3874233		YPO_RS18305	11
GRH001.A0202_rmdup	3874478	3874500		YPO_RS18305	22
GRH001.A0202_rmdup	3877205	3877226		YPO_RS18320	21
GRH001.A0202_rmdup	3877988	3878040		YPO_RS18325	52
GRH001.A0202_rmdup	3878180	3878189		YPO_RS18325	9
GRH001.A0202_rmdup	3878265	3878289		YPO_RS18325	24
GRH001.A0202_rmdup	3878832	3878849		YPO_RS18325	17
GRH001.A0202_rmdup	3879701	3879712		YPO_RS18330	11
GRH001.A0202_rmdup	3881140	3881153		YPO_RS18335	13
GRH001.A0202_rmdup	3881592	3881604		YPO_RS18335	12
GRH001.A0202_rmdup	3882764	3882780		YPO_RS18335	16
GRH001.A0202_rmdup	3883659	3883696		YPO_RS18345	37
GRH001.A0202_rmdup	3883749	3883754		YPO_RS18345	5
GRH001.A0202_rmdup	3883899	3883906		YPO_RS18345	7
GRH001.A0202_rmdup	3885376	3885391		YPO_RS18355	15
GRH001.A0202_rmdup	3885540	3885548		YPO_RS18355	8
GRH001.A0202_rmdup	3887293	3887311		YPO_RS18365	18
GRH001.A0202_rmdup	3887444	3887445		YPO_RS18365	1
GRH001.A0202_rmdup	3888127	3888138		YPO_RS18365	11
GRH001.A0202_rmdup	3888211	3888238		YPO_RS18365	27
GRH001.A0202_rmdup	3889437	3889462		YPO_RS18370	25
GRH001.A0202_rmdup	3891613	3891615		YPO_RS18375	2
GRH001.A0202_rmdup	3892434	3892446		YPO_RS18375	12
GRH001.A0202_rmdup	3893364	3893380		YPO_RS18380	16
GRH001.A0202_rmdup	3893448	3893454		YPO_RS18380	6
GRH001.A0202_rmdup	3895351	3895359		YPO_RS18400	8
GRH001.A0202_rmdup	3895908	3895910		YPO_RS18400	2
GRH001.A0202_rmdup	3902999	3903003		truB	4
GRH001.A0202_rmdup	3906140	3906141		infB	1
GRH001.A0202_rmdup	3906346	3906396		infB	50
GRH001.A0202_rmdup	3910956	3910986		glmM	30
GRH001.A0202_rmdup	3911741	3911752		folP	11
GRH001.A0202_rmdup	3918669	3918670		pmrB	1
GRH001.A0202_rmdup	3922676	3922731		ispB	55
GRH001.A0202_rmdup	3926411	3926414		argR	3
GRH001.A0202_rmdup	3928654	3928692		mpl	38
GRH001.A0202_rmdup	3933108	3933117		YPO_RS18585	9
GRH001.A0202_rmdup	3935100	3935105		YPO_RS18585	5
GRH001.A0202_rmdup	3935795	3935800		YPO_RS18590	5
GRH001.A0202_rmdup	3936931	3936949		YPO_RS18590	18
GRH001.A0202_rmdup	3937402	3937407		msrA	5
GRH001.A0202_rmdup	3937467	3937498		msrA	31
GRH001.A0202_rmdup	3937690	3937694		msrA	4
GRH001.A0202_rmdup	3941256	3941295		cysQ	39
GRH001.A0202_rmdup	3945098	3945108		YPO_RS18630	10
GRH001.A0202_rmdup	3946133	3946142		YPO_RS18635	9
GRH001.A0202_rmdup	3949732	3949742		yjfP	10
GRH001.A0202_rmdup	3953512	3953516		YPO_RS18690	4
GRH001.A0202_rmdup	3954126	3954139		YPO_RS18690	13
GRH001.A0202_rmdup	3955118	3955124		YPO_RS18695	6
GRH001.A0202_rmdup	3958364	3958366		YPO_RS18710	2
GRH001.A0202_rmdup	3959334	3959368		YPO_RS18715	34
GRH001.A0202_rmdup	3960462	3960466		yraP	4
GRH001.A0202_rmdup	3961668	3961678		mtgA	10
GRH001.A0202_rmdup	3963221	3963236		arcB	15
GRH001.A0202_rmdup	3963709	3963737		arcB	28
GRH001.A0202_rmdup	3964827	3964869		arcB	42
GRH001.A0202_rmdup	3968919	3968926		gltB	7
GRH001.A0202_rmdup	3970148	3970159		gltB	11
GRH001.A0202_rmdup	3970218	3970221		gltB	3
GRH001.A0202_rmdup	3971050	3971054		gltB	4
GRH001.A0202_rmdup	3971121	3971160		gltB	39
GRH001.A0202_rmdup	3971875	3971879		YPO_RS18755	4
GRH001.A0202_rmdup	3972056	3972089		YPO_RS18755	33
GRH001.A0202_rmdup	3973686	3973730		YPO_RS18760	44
GRH001.A0202_rmdup	3976954	3976956		YPO_RS18790	2
GRH001.A0202_rmdup	3981746	3981753		degS	7
GRH001.A0202_rmdup	3985087	3985099		mlaD	12
GRH001.A0202_rmdup	3987792	3987806		YPO_RS18850	14
GRH001.A0202_rmdup	3989292	3989295		kdsD	3
GRH001.A0202_rmdup	3990491	3990500		kdsC	9
GRH001.A0202_rmdup	3992076	3992092		lptB	16
GRH001.A0202_rmdup	3992642	3992650		rpoN	8
GRH001.A0202_rmdup	3993788	3993803		rpoN	15
GRH001.A0202_rmdup	3997232	3997242		pyrB	10
GRH001.A0202_rmdup	3997792	3997806		YPO_RS18910	14
GRH001.A0202_rmdup	4000975	4001718		YPO_RS18935	743
GRH001.A0202_rmdup	4001682	4002081		tssG	399
GRH001.A0202_rmdup	4002154	4002770		tssG	616
GRH001.A0202_rmdup	4002896	4003669		tagH	773
GRH001.A0202_rmdup	4003745	4004212		tagH	467
GRH001.A0202_rmdup	4004212	4004757		tssJ	545
GRH001.A0202_rmdup	4004760	4005266		tssK	506
GRH001.A0202_rmdup	4005716	4005730		tssK	14
GRH001.A0202_rmdup	4005915	4005968		tssK	53
GRH001.A0202_rmdup	4006201	4006205		YPO_RS18960	4
GRH001.A0202_rmdup	4008011	4008068		tssH	57
GRH001.A0202_rmdup	4009332	4009339		tssH	7
GRH001.A0202_rmdup	4009422	4009487		tssH	65
GRH001.A0202_rmdup	4009484	4009492		YPO_RS18970	8
GRH001.A0202_rmdup	4010145	4010169		YPO_RS18970	24
GRH001.A0202_rmdup	4010357	4010358		tagO	1
GRH001.A0202_rmdup	4011197	4011254		tssA	57
GRH001.A0202_rmdup	4011489	4011577		tssA	88
GRH001.A0202_rmdup	4011735	4011742		tssA	7
GRH001.A0202_rmdup	4014426	4014441		tssM	15
GRH001.A0202_rmdup	4014525	4014535		tssM	10
GRH001.A0202_rmdup	4014715	4014717		tssM	2
GRH001.A0202_rmdup	4015722	4015727		tssM	5
GRH001.A0202_rmdup	4016428	4016448		YPO_RS18990	20
GRH001.A0202_rmdup	4016623	4016629		YPO_RS18990	6
GRH001.A0202_rmdup	4016666	4016743		YPO_RS18990	77
GRH001.A0202_rmdup	4016776	4016788		YPO_RS18990	12
GRH001.A0202_rmdup	4016886	4016891		YPO_RS18995	5
GRH001.A0202_rmdup	4017020	4017056		YPO_RS18995	36
GRH001.A0202_rmdup	4017853	4017872		YPO_RS19000	19
GRH001.A0202_rmdup	4017966	4017976		YPO_RS19000	10
GRH001.A0202_rmdup	4018178	4018185		YPO_RS19000	7
GRH001.A0202_rmdup	4018776	4018800		YPO_RS19000	24
GRH001.A0202_rmdup	4020188	4020192		YPO_RS19005	4
GRH001.A0202_rmdup	4020355	4020401		YPO_RS19010	46
GRH001.A0202_rmdup	4021452	4021470		YPO_RS19010	18
GRH001.A0202_rmdup	4021987	4022005		YPO_RS19010	18
GRH001.A0202_rmdup	4022620	4022666		YPO_RS19010	46
GRH001.A0202_rmdup	4022740	4022751		YPO_RS19010	11
GRH001.A0202_rmdup	4024737	4024740		YPO_RS19020	3
GRH001.A0202_rmdup	4026914	4026921		YPO_RS19045	7
GRH001.A0202_rmdup	4027031	4027046		YPO_RS19045	15
GRH001.A0202_rmdup	4027345	4027357		YPO_RS19045	12
GRH001.A0202_rmdup	4027606	4027623		YPO_RS19045	17
GRH001.A0202_rmdup	4027802	4027808		YPO_RS19045	6
GRH001.A0202_rmdup	4028896	4028905		YPO_RS19050	9
GRH001.A0202_rmdup	4029388	4029476		YPO_RS19055	88
GRH001.A0202_rmdup	4029532	4029588		YPO_RS19055	56
GRH001.A0202_rmdup	4029769	4029771		YPO_RS19055	2
GRH001.A0202_rmdup	4031279	4031309		YPO_RS19055	30
GRH001.A0202_rmdup	4031779	4031781		YPO_RS19055	2
GRH001.A0202_rmdup	4032091	4032100		YPO_RS19055	9
GRH001.A0202_rmdup	4032177	4032179		YPO_RS19055	2
GRH001.A0202_rmdup	4032646	4032677		YPO_RS19055	31
GRH001.A0202_rmdup	4032707	4032731		YPO_RS19055	24
GRH001.A0202_rmdup	4032804	4032812		YPO_RS19055	8
GRH001.A0202_rmdup	4033058	4033077		YPO_RS19055	19
GRH001.A0202_rmdup	4033693	4033705		YPO_RS19060	12
GRH001.A0202_rmdup	4033761	4033787		YPO_RS19060	26
GRH001.A0202_rmdup	4033942	4033992		YPO_RS19060	50
GRH001.A0202_rmdup	4034652	4034680		YPO_RS19065	28
GRH001.A0202_rmdup	4038743	4038773		YPO_RS19090	30
GRH001.A0202_rmdup	4038915	4038957		YPO_RS19090	42
GRH001.A0202_rmdup	4039315	4039325		YPO_RS19090	10
GRH001.A0202_rmdup	4040864	4040923		ssuE	59
GRH001.A0202_rmdup	4042268	4042270		YPO_RS19105	2
GRH001.A0202_rmdup	4043873	4043897		ssuC	24
GRH001.A0202_rmdup	4045240	4045267		ssuB	27
GRH001.A0202_rmdup	4048594	4048630		YPO_RS19140	36
GRH001.A0202_rmdup	4049857	4049859		YPO_RS19140	2
GRH001.A0202_rmdup	4051641	4051671		lpxP	30
GRH001.A0202_rmdup	4053686	4053690		YPO_RS19155	4
GRH001.A0202_rmdup	4055120	4055123		YPO_RS19160	3
GRH001.A0202_rmdup	4055167	4055183		YPO_RS19160	16
GRH001.A0202_rmdup	4057575	4057579		YPO_RS19170	4
GRH001.A0202_rmdup	4058551	4058562		YPO_RS19175	11
GRH001.A0202_rmdup	4060067	4060070		YPO_RS19180	3
GRH001.A0202_rmdup	4062966	4062968		YPO_RS19195	2
GRH001.A0202_rmdup	4066430	4066436		YPO_RS19215	6
GRH001.A0202_rmdup	4066500	4066509		YPO_RS19215	9
GRH001.A0202_rmdup	4067993	4068017		YPO_RS19220	24
GRH001.A0202_rmdup	4068722	4068740		YPO_RS19225	18
GRH001.A0202_rmdup	4070578	4070581		YPO_RS19235	3
GRH001.A0202_rmdup	4070848	4070876		YPO_RS19235	28
GRH001.A0202_rmdup	4071006	4071044		YPO_RS19235	38
GRH001.A0202_rmdup	4071229	4071270		YPO_RS19240	41
GRH001.A0202_rmdup	4074051	4074059		dusB	8
GRH001.A0202_rmdup	4075461	4075485		prmA	24
GRH001.A0202_rmdup	4075696	4075726		prmA	30
GRH001.A0202_rmdup	4082219	4082225		msrQ	6
GRH001.A0202_rmdup	4083731	4083737		YPO_RS19315	6
GRH001.A0202_rmdup	4088918	4088927		mreC	9
GRH001.A0202_rmdup	4093799	4093856		YPO_RS19350	57
GRH001.A0202_rmdup	4094652	4094694		YPO_RS19350	42
GRH001.A0202_rmdup	4095795	4095804		YPO_RS19350	9
GRH001.A0202_rmdup	4098040	4098045		tldD	5
GRH001.A0202_rmdup	4098155	4098156		tldD	1
GRH001.A0202_rmdup	4098633	4098692		YPO_RS19365	59
GRH001.A0202_rmdup	4098944	4098957		YPO_RS19365	13
GRH001.A0202_rmdup	4100268	4100283		YPO_RS19365	15
GRH001.A0202_rmdup	4100946	4100950		YPO_RS19365	4
GRH001.A0202_rmdup	4100992	4101112		YPO_RS19365	120
GRH001.A0202_rmdup	4101177	4101243		YPO_RS19365	66
GRH001.A0202_rmdup	4101297	4101318		YPO_RS19365	21
GRH001.A0202_rmdup	4101352	4101491		YPO_RS19365	139
GRH001.A0202_rmdup	4101516	4102452		YPO_RS19370	936
GRH001.A0202_rmdup	4102489	4102550		YPO_RS19370	61
GRH001.A0202_rmdup	4102696	4102948		YPO_RS19370	252
GRH001.A0202_rmdup	4103039	4103064		YPO_RS19370	25
GRH001.A0202_rmdup	4103124	4103142		YPO_RS19370	18
GRH001.A0202_rmdup	4103202	4103220		YPO_RS19370	18
GRH001.A0202_rmdup	4103261	4103263		YPO_RS19370	2
GRH001.A0202_rmdup	4103393	4103442		YPO_RS19370	49
GRH001.A0202_rmdup	4104281	4104282		YPO_RS19370	1
GRH001.A0202_rmdup	4104314	4104329		YPO_RS19370	15
GRH001.A0202_rmdup	4107020	4107022		YPO_RS19390	2
GRH001.A0202_rmdup	4108190	4108213		YPO_RS19390	23
GRH001.A0202_rmdup	4109263	4109276		YPO_RS19390	13
GRH001.A0202_rmdup	4110056	4110061		YPO_RS19390	5
GRH001.A0202_rmdup	4110122	4110168		YPO_RS19390	46
GRH001.A0202_rmdup	4112679	4112727		YPO_RS19400	48
GRH001.A0202_rmdup	4113886	4113887		YPO_RS19400	1
GRH001.A0202_rmdup	4114018	4114044		YPO_RS19405	26
GRH001.A0202_rmdup	4116428	4116435		YPO_RS19405	7
GRH001.A0202_rmdup	4117991	4117993		aaeR	2
GRH001.A0202_rmdup	4120911	4120942		aaeB	31
GRH001.A0202_rmdup	4125076	4125080		YPO_RS19450	4
GRH001.A0202_rmdup	4125267	4125269		YPO_RS19450	2
GRH001.A0202_rmdup	4125990	4126027		pmbA	37
GRH001.A0202_rmdup	4128933	4128945		rnk	12
GRH001.A0202_rmdup	4130821	4130833		treC	12
GRH001.A0202_rmdup	4131671	4131733		treB	62
GRH001.A0202_rmdup	4138983	4139423		tssE	440
GRH001.A0202_rmdup	4139430	4140911		tssC	1481
GRH001.A0202_rmdup	4140995	4141476		tssB	481
GRH001.A0202_rmdup	4142000	4142077		YPO_RS19530	77
GRH001.A0202_rmdup	4142153	4142518		YPO_RS19530	365
GRH001.A0202_rmdup	4142670	4142948		YPO_RS19535	278
GRH001.A0202_rmdup	4143740	4143742		malM	2
GRH001.A0202_rmdup	4145938	4145954		malK	16
GRH001.A0202_rmdup	4146475	4146502		malK	27
GRH001.A0202_rmdup	4147898	4147903		malE	5
GRH001.A0202_rmdup	4150627	4150644		malF	17
GRH001.A0202_rmdup	4151038	4151041		malG	3
GRH001.A0202_rmdup	4151304	4151313		malG	9
GRH001.A0202_rmdup	4152832	4152855		pgi	23
GRH001.A0202_rmdup	4156566	4156588		YPO_RS19590	22
GRH001.A0202_rmdup	4156657	4156693		YPO_RS19590	36
GRH001.A0202_rmdup	4157728	4157747		YPO_RS19590	19
GRH001.A0202_rmdup	4159250	4159255		YPO_RS19595	5
GRH001.A0202_rmdup	4161852	4161857		YPO_RS19595	5
GRH001.A0202_rmdup	4166730	4166769		metH	39
GRH001.A0202_rmdup	4169279	4169302		aceK	23
GRH001.A0202_rmdup	4169619	4169620		aceK	1
GRH001.A0202_rmdup	4170940	4170996		aceA	56
GRH001.A0202_rmdup	4176218	4176222		YPO_RS19645	4
GRH001.A0202_rmdup	4181724	4181730		purH	6
GRH001.A0202_rmdup	4181996	4181999		purH	3
GRH001.A0202_rmdup	4183788	4183821		purD	33
GRH001.A0202_rmdup	4187048	4187058		hemE	10
GRH001.A0202_rmdup	4190861	4190874		thiC	13
GRH001.A0202_rmdup	4190924	4190944		thiC	20
GRH001.A0202_rmdup	4192044	4192065		thiC	21
GRH001.A0202_rmdup	4192446	4192459		thiC	13
GRH001.A0202_rmdup	4195064	4195076		YPO_RS19740	12
GRH001.A0202_rmdup	4195263	4195281		thiH	18
GRH001.A0202_rmdup	4195921	4195932		thiH	11
GRH001.A0202_rmdup	4206219	4206227		rplL	8
GRH001.A0202_rmdup	4216752	4216825		murB	73
GRH001.A0202_rmdup	4217435	4217445		murB	10
GRH001.A0202_rmdup	4219516	4219526		YPO_RS19855	10
GRH001.A0202_rmdup	4223140	4223145		YPO_RS19870	5
GRH001.A0202_rmdup	4225617	4225634		trkH	17
GRH001.A0202_rmdup	4226981	4226987		YPO_RS19900	6
GRH001.A0202_rmdup	4227066	4227089		YPO_RS19900	23
GRH001.A0202_rmdup	4233724	4233728		ubiD	4
GRH001.A0202_rmdup	4233886	4233899		ubiD	13
GRH001.A0202_rmdup	4233978	4233981		ubiD	3
GRH001.A0202_rmdup	4235784	4235792		hemB	8
GRH001.A0202_rmdup	4240356	4240369		tatB	13
GRH001.A0202_rmdup	4242691	4242714		ubiB	23
GRH001.A0202_rmdup	4247686	4247694		YPO_RS20000	8
GRH001.A0202_rmdup	4248118	4248158		YPO_RS20000	40
GRH001.A0202_rmdup	4249329	4249360		YPO_RS20005	31
GRH001.A0202_rmdup	4251575	4251587		YPO_RS20015	12
GRH001.A0202_rmdup	4252777	4252782		metE	5
GRH001.A0202_rmdup	4253930	4253941		metE	11
GRH001.A0202_rmdup	4255505	4255510		YPO_RS20030	5
GRH001.A0202_rmdup	4255901	4255911		YPO_RS20030	10
GRH001.A0202_rmdup	4257919	4257920		ugpQ	1
GRH001.A0202_rmdup	4258162	4258166		ugpQ	4
GRH001.A0202_rmdup	4258474	4258492		YPO_RS20045	18
GRH001.A0202_rmdup	4258972	4258973		YPO_RS20045	1
GRH001.A0202_rmdup	4260414	4260415		ugpA	1
GRH001.A0202_rmdup	4261555	4261572		ugpB	17
GRH001.A0202_rmdup	4263475	4263481		YPO_RS20065	6
GRH001.A0202_rmdup	4264356	4264373		YPO_RS20070	17
GRH001.A0202_rmdup	4265477	4265478		YPO_RS20070	1
GRH001.A0202_rmdup	4266023	4266031		YPO_RS20070	8
GRH001.A0202_rmdup	4266533	4266569		YPO_RS20075	36
GRH001.A0202_rmdup	4267183	4267187		YPO_RS20080	4
GRH001.A0202_rmdup	4268191	4268192		YPO_RS20085	1
GRH001.A0202_rmdup	4268934	4268937		YPO_RS20090	3
GRH001.A0202_rmdup	4270007	4270009		YPO_RS20095	2
GRH001.A0202_rmdup	4272877	4272896		YPO_RS20110	19
GRH001.A0202_rmdup	4273654	4273659		livH	5
GRH001.A0202_rmdup	4274758	4274776		YPO_RS20120	18
GRH001.A0202_rmdup	4276155	4276165		panM	10
GRH001.A0202_rmdup	4278620	4278633		ftsX	13
GRH001.A0202_rmdup	4279553	4279567		ftsE	14
GRH001.A0202_rmdup	4280859	4280945		ftsY	86
GRH001.A0202_rmdup	4281038	4281041		ftsY	3
GRH001.A0202_rmdup	4281460	4281470		ftsY	10
GRH001.A0202_rmdup	4281478	4281479		ftsY	1
GRH001.A0202_rmdup	4286493	4286537		YPO_RS20180	44
GRH001.A0202_rmdup	4286701	4286759		YPO_RS20180	58
GRH001.A0202_rmdup	4286852	4286857		YPO_RS20180	5
GRH001.A0202_rmdup	4289650	4289653		glpC	3
GRH001.A0202_rmdup	4290109	4290128		glpC	19
GRH001.A0202_rmdup	4292411	4292415		glpA	4
GRH001.A0202_rmdup	4292878	4292901		glpA	23
GRH001.A0202_rmdup	4293020	4293034		glpA	14
GRH001.A0202_rmdup	4293679	4293687		glpA	8
GRH001.A0202_rmdup	4298117	4298145		pldB	28
GRH001.A0202_rmdup	4299298	4299305		rhtB	7
GRH001.A0202_rmdup	4300045	4300050		rhtC	5
GRH001.A0202_rmdup	4302419	4302426		recQ	7
GRH001.A0202_rmdup	4303259	4303263		pldA	4
GRH001.A0202_rmdup	4304839	4304851		rarD	12
GRH001.A0202_rmdup	4307897	4307916		YPO_RS20280	19
GRH001.A0202_rmdup	4308517	4308529		YPO_RS20280	12
GRH001.A0202_rmdup	4309302	4309308		YPO_RS20285	6
GRH001.A0202_rmdup	4310092	4310116		uvrD	24
GRH001.A0202_rmdup	4310320	4310330		uvrD	10
GRH001.A0202_rmdup	4312107	4312130		uvrD	23
GRH001.A0202_rmdup	4312649	4312663		yigB	14
GRH001.A0202_rmdup	4313510	4313525		xerC	15
GRH001.A0202_rmdup	4313622	4313628		xerC	6
GRH001.A0202_rmdup	4314512	4314515		YPO_RS20305	3
GRH001.A0202_rmdup	4314618	4314630		YPO_RS20305	12
GRH001.A0202_rmdup	4314868	4314898		dapF	30
GRH001.A0202_rmdup	4315375	4315378		dapF	3
GRH001.A0202_rmdup	4320071	4320088		hemC	17
GRH001.A0202_rmdup	4320240	4320242		hemC	2
GRH001.A0202_rmdup	4322735	4322737		hemY	2
GRH001.A0202_rmdup	4322827	4322845		hemY	18
GRH001.A0202_rmdup	4323004	4323010		hemY	6
GRH001.A0202_rmdup	4326359	4326382		YPO_RS20380	23
GRH001.A0202_rmdup	4326695	4326703		YPO_RS20380	8
GRH001.A0202_rmdup	4328254	4328255		rffM	1
GRH001.A0202_rmdup	4328864	4328887		wzyE	23
GRH001.A0202_rmdup	4330010	4330036		YPO_RS20395	26
GRH001.A0202_rmdup	4331572	4331575		wzxE	3
GRH001.A0202_rmdup	4332385	4332420		rffA	35
GRH001.A0202_rmdup	4335647	4335670		rffG	23
GRH001.A0202_rmdup	4347088	4347092		rep	4
GRH001.A0202_rmdup	4348859	4348861		rep	2
GRH001.A0202_rmdup	4349087	4349104		YPO_RS20470	17
GRH001.A0202_rmdup	4349644	4349670		YPO_RS20480	26
GRH001.A0202_rmdup	4355200	4355218		YPO_RS20500	18
GRH001.A0202_rmdup	4357025	4357042		stbD	17
GRH001.A0202_rmdup	4357208	4357210		stbD	2
GRH001.A0202_rmdup	4358265	4358269		YPO_RS20510	4
GRH001.A0202_rmdup	4359333	4359346		YPO_RS20515	13
GRH001.A0202_rmdup	4360237	4360284		YPO_RS20525	47
GRH001.A0202_rmdup	4360662	4360690		YPO_RS20530	28
GRH001.A0202_rmdup	4360790	4360798		YPO_RS20530	8
GRH001.A0202_rmdup	4362155	4362157		YPO_RS20535	2
GRH001.A0202_rmdup	4363257	4363263		ilvC	6
GRH001.A0202_rmdup	4364588	4364613		ilvY	25
GRH001.A0202_rmdup	4370158	4370160		ilvD	2
GRH001.A0202_rmdup	4370915	4370938		ilvD	23
GRH001.A0202_rmdup	4371646	4371652		ilvD	6
GRH001.A0202_rmdup	4372640	4372644		YPO_RS20590	4
GRH001.A0202_rmdup	4372798	4372813		YPO_RS20590	15
GRH001.A0202_rmdup	4374358	4374385		YPO_RS20600	27
GRH001.A0202_rmdup	4374450	4374456		YPO_RS20600	6
GRH001.A0202_rmdup	4374964	4374980		YPO_RS20600	16
GRH001.A0202_rmdup	4375966	4375976		YPO_RS20610	10
GRH001.A0202_rmdup	4376196	4376212		YPO_RS20610	16
GRH001.A0202_rmdup	4376343	4376364		YPO_RS20610	21
GRH001.A0202_rmdup	4376453	4376480		YPO_RS20610	27
GRH001.A0202_rmdup	4376540	4376551		YPO_RS20610	11
GRH001.A0202_rmdup	4376878	4376883		YPO_RS20610	5
GRH001.A0202_rmdup	4377513	4377521		YPO_RS20615	8
GRH001.A0202_rmdup	4377686	4377703		YPO_RS20615	17
GRH001.A0202_rmdup	4380515	4380522		YPO_RS20630	7
GRH001.A0202_rmdup	4386017	4386035		YPO_RS20660	18
GRH001.A0202_rmdup	4392277	4392278		btuB	1
GRH001.A0202_rmdup	4392670	4392680		btuB	10
GRH001.A0202_rmdup	4395167	4395169		fabR	2
GRH001.A0202_rmdup	4399255	4399312		YPO_RS20720	57
GRH001.A0202_rmdup	4400607	4400619		YPO_RS20720	12
GRH001.A0202_rmdup	4401427	4401472		YPO_RS20725	45
GRH001.A0202_rmdup	4401785	4401788		YPO_RS20730	3
GRH001.A0202_rmdup	4403027	4403033		YPO_RS20735	6
GRH001.A0202_rmdup	4404332	4404334		YPO_RS20735	2
GRH001.A0202_rmdup	4406447	4406480		YPO_RS20745	33
GRH001.A0202_rmdup	4407703	4407712		YPO_RS20745	9
GRH001.A0202_rmdup	4407788	4407803		YPO_RS20745	15
GRH001.A0202_rmdup	4408309	4408320		YPO_RS20745	11
GRH001.A0202_rmdup	4409409	4409414		argH	5
GRH001.A0202_rmdup	4411595	4411625		argC	30
GRH001.A0202_rmdup	4418864	4418867		YPO_RS20775	3
GRH001.A0202_rmdup	4421705	4421722		glpD	17
GRH001.A0202_rmdup	4425928	4425946		glgA	18
GRH001.A0202_rmdup	4426194	4426217		glgA	23
GRH001.A0202_rmdup	4428878	4428884		glgX	6
GRH001.A0202_rmdup	4429166	4429168		glgX	2
GRH001.A0202_rmdup	4429298	4429310		glgX	12
GRH001.A0202_rmdup	4429846	4429848		glgX	2
GRH001.A0202_rmdup	4429969	4429976		glgX	7
GRH001.A0202_rmdup	4430211	4430260		glgX	49
GRH001.A0202_rmdup	4430550	4430562		glgB	12
GRH001.A0202_rmdup	4433372	4433380		YPO_RS20825	8
GRH001.A0202_rmdup	4435318	4435386		YPO_RS20830	68
GRH001.A0202_rmdup	4435704	4435722		YPO_RS20830	18
GRH001.A0202_rmdup	4436114	4436118		YPO_RS20830	4
GRH001.A0202_rmdup	4438053	4438061		YPO_RS20830	8
GRH001.A0202_rmdup	4438323	4438364		YPO_RS20830	41
GRH001.A0202_rmdup	4438665	4438696		YPO_RS20830	31
GRH001.A0202_rmdup	4439507	4439528		YPO_RS20830	21
GRH001.A0202_rmdup	4439710	4439721		YPO_RS20830	11
GRH001.A0202_rmdup	4439789	4439832		YPO_RS20830	43
GRH001.A0202_rmdup	4439975	4440022		YPO_RS20830	47
GRH001.A0202_rmdup	4440842	4440873		YPO_RS20830	31
GRH001.A0202_rmdup	4441185	4441194		YPO_RS20830	9
GRH001.A0202_rmdup	4442926	4442949		YPO_RS20830	23
GRH001.A0202_rmdup	4448898	4448933		YPO_RS20865	35
GRH001.A0202_rmdup	4451980	4451981		gntT	1
GRH001.A0202_rmdup	4452398	4452417		gntT	19
GRH001.A0202_rmdup	4452880	4452932		gntR	52
GRH001.A0202_rmdup	4455666	4455725		YPO_RS20905	59
GRH001.A0202_rmdup	4456460	4456491		YPO_RS20910	31
GRH001.A0202_rmdup	4456970	4456972		YPO_RS20910	2
GRH001.A0202_rmdup	4457604	4457612		YPO_RS20915	8
GRH001.A0202_rmdup	4457856	4457889		YPO_RS20915	33
GRH001.A0202_rmdup	4458278	4458295		YPO_RS20920	17
GRH001.A0202_rmdup	4458378	4458379		YPO_RS20920	1
GRH001.A0202_rmdup	4460266	4460267		YPO_RS20930	1
GRH001.A0202_rmdup	4460277	4460281		YPO_RS20930	4
GRH001.A0202_rmdup	4460394	4460407		YPO_RS20930	13
GRH001.A0202_rmdup	4461576	4461601		YPO_RS20935	25
GRH001.A0202_rmdup	4461725	4461746		YPO_RS20935	21
GRH001.A0202_rmdup	4462645	4462737		YPO_RS20940	92
GRH001.A0202_rmdup	4463202	4463213		YPO_RS20940	11
GRH001.A0202_rmdup	4464245	4464252		YPO_RS20940	7
GRH001.A0202_rmdup	4464540	4464542		YPO_RS20940	2
GRH001.A0202_rmdup	4464824	4464830		YPO_RS20940	6
GRH001.A0202_rmdup	4464969	4464977		YPO_RS20940	8
GRH001.A0202_rmdup	4465393	4465441		YPO_RS20945	48
GRH001.A0202_rmdup	4467593	4467610		pitA	17
GRH001.A0202_rmdup	4467703	4467723		pitA	20
GRH001.A0202_rmdup	4472502	4472521		YPO_RS20975	19
GRH001.A0202_rmdup	4474272	4474278		rsmJ	6
GRH001.A0202_rmdup	4474316	4474344		rsmJ	28
GRH001.A0202_rmdup	4476139	4476152		prlC	13
GRH001.A0202_rmdup	4477161	4477198		YPO_RS20990	37
GRH001.A0202_rmdup	4480657	4480666		YPO_RS21000	9
GRH001.A0202_rmdup	4480657	4480666		YPO_RS21005	9
GRH001.A0202_rmdup	4481581	4481583		YPO_RS21010	2
GRH001.A0202_rmdup	4481943	4481953		YPO_RS21010	10
GRH001.A0202_rmdup	4482550	4482568		YPO_RS21015	18
GRH001.A0202_rmdup	4483578	4483591		YPO_RS21020	13
GRH001.A0202_rmdup	4483827	4483858		YPO_RS21020	31
GRH001.A0202_rmdup	4484155	4484198		YPO_RS21025	43
GRH001.A0202_rmdup	4484838	4484841		YPO_RS21030	3
GRH001.A0202_rmdup	4485020	4485026		YPO_RS21030	6
GRH001.A0202_rmdup	4485942	4485948		yapE	6
GRH001.A0202_rmdup	4488556	4488562		yapE	6
GRH001.A0202_rmdup	4488678	4488684		yapE	6
GRH001.A0202_rmdup	4489502	4489508		yhjD	6
GRH001.A0202_rmdup	4489799	4489804		yhjD	5
GRH001.A0202_rmdup	4491260	4491282		YPO_RS21045	22
GRH001.A0202_rmdup	4491395	4491408		YPO_RS21050	13
GRH001.A0202_rmdup	4491834	4491881		YPO_RS21050	47
GRH001.A0202_rmdup	4491923	4491925		YPO_RS21050	2
GRH001.A0202_rmdup	4497642	4497649		YPO_RS21070	7
GRH001.A0202_rmdup	4497701	4497709		YPO_RS21070	8
GRH001.A0202_rmdup	4501487	4501531		YPO_RS21085	44
GRH001.A0202_rmdup	4502704	4502711		YPO_RS21090	7
GRH001.A0202_rmdup	4503307	4503366		YPO_RS21090	59
GRH001.A0202_rmdup	4504273	4504288		hmsP	15
GRH001.A0202_rmdup	4505007	4505012		hmsP	5
GRH001.A0202_rmdup	4505414	4505422		hmsP	8
GRH001.A0202_rmdup	4505512	4505543		hmsP	31
GRH001.A0202_rmdup	4514642	4514647		YPO_RS21135	5
GRH001.A0202_rmdup	4517345	4517357		YPO_RS21140	12
GRH001.A0202_rmdup	4518381	4518386		YPO_RS21150	5
GRH001.A0202_rmdup	4519571	4519589		YPO_RS21155	18
GRH001.A0202_rmdup	4523734	4523737		eptB	3
GRH001.A0202_rmdup	4524365	4524377		eptB	12
GRH001.A0202_rmdup	4528027	4528045		YPO_RS21190	18
GRH001.A0202_rmdup	4528805	4528843		YPO_RS21190	38
GRH001.A0202_rmdup	4530449	4530464		hutH	15
GRH001.A0202_rmdup	4539205	4539242		YPO_RS21230	37
GRH001.A0202_rmdup	4545688	4545714		YPO_RS21280	26
GRH001.A0202_rmdup	4545914	4545917		YPO_RS21280	3
GRH001.A0202_rmdup	4548032	4548035		YPO_RS21290	3
GRH001.A0202_rmdup	4549923	4549934		YPO_RS21300	11
GRH001.A0202_rmdup	4552170	4552177		YPO_RS21305	7
GRH001.A0202_rmdup	4554281	4554282		xylA	1
GRH001.A0202_rmdup	4555970	4555974		xylB	4
GRH001.A0202_rmdup	4558134	4558139		YPO_RS21330	5
GRH001.A0202_rmdup	4561539	4561555		YPO_RS21340	16
GRH001.A0202_rmdup	4561590	4561598		YPO_RS21340	8
GRH001.A0202_rmdup	4563936	4563938		YPO_RS21350	2
GRH001.A0202_rmdup	4566054	4566128		YPO_RS21360	74
GRH001.A0202_rmdup	4567448	4567453		YPO_RS21365	5
GRH001.A0202_rmdup	4567697	4567747		YPO_RS21370	50
GRH001.A0202_rmdup	4569629	4569636		selB	7
GRH001.A0202_rmdup	4570823	4570866		selB	43
GRH001.A0202_rmdup	4570911	4570913		selB	2
GRH001.A0202_rmdup	4571291	4571292		YPO_RS21395	1
GRH001.A0202_rmdup	4571647	4571658		YPO_RS21400	11
GRH001.A0202_rmdup	4572064	4572071		YPO_RS21400	7
GRH001.A0202_rmdup	4572509	4572608		YPO_RS21400	99
GRH001.A0202_rmdup	4574114	4574144		fdoI	30
GRH001.A0202_rmdup	4574981	4574982		fdxH	1
GRH001.A0202_rmdup	4576339	4576348		fdnG	9
GRH001.A0202_rmdup	4577758	4577769		fdnG	11
GRH001.A0202_rmdup	4579406	4579417		fdhD	11
GRH001.A0202_rmdup	4582903	4582910		YPO_RS21435	7
GRH001.A0202_rmdup	4586548	4586554		YPO_RS21460	6
GRH001.A0202_rmdup	4589119	4589133		YPO_RS21465	14
GRH001.A0202_rmdup	4590419	4590424		YPO_RS21470	5
GRH001.A0202_rmdup	4590977	4590980		YPO_RS21475	3
GRH001.A0202_rmdup	4592222	4592233		glyS	11
GRH001.A0202_rmdup	4592444	4592450		glyS	6
GRH001.A0202_rmdup	4595073	4595074		YPO_RS21490	1
GRH001.A0202_rmdup	4596329	4596347		YPO_RS21500	18
GRH001.A0202_rmdup	4596409	4596439		YPO_RS21500	30
GRH001.A0202_rmdup	4598460	4598490		ghrB	30
GRH001.A0202_rmdup	4599455	4599457		YPO_RS21515	2
GRH001.A0202_rmdup	4599499	4599531		YPO_RS21515	32
GRH001.A0202_rmdup	4599931	4599954		YPO_RS21515	23
GRH001.A0202_rmdup	4601710	4601717		YPO_RS21520	7
GRH001.A0202_rmdup	4601895	4601907		YPO_RS21520	12
GRH001.A0202_rmdup	4601997	4602012		YPO_RS21520	15
GRH001.A0202_rmdup	4606928	4606950		ibpA	22
GRH001.A0202_rmdup	4607582	4607621		YPO_RS21545	39
GRH001.A0202_rmdup	4608739	4608741		YPO_RS21555	2
GRH001.A0202_rmdup	4608997	4609002		YPO_RS21555	5
GRH001.A0202_rmdup	4609103	4609130		YPO_RS21555	27
GRH001.A0202_rmdup	4614228	4614247		gyrB	19
GRH001.A0202_rmdup	4615772	4615777		gyrB	5
GRH001.A0202_rmdup	4619492	4619498		dnaA	6
GRH001.A0202_rmdup	4622971	4622979		mnmE	8
GRH001.A0202_rmdup	4623759	4623779		mnmE	20
GRH001.A0202_rmdup	4623861	4623871		mnmE	10
GRH001.A0202_rmdup	4624018	4624062		mnmE	44
GRH001.A0202_rmdup	4625270	4625286		YPO_RS21620	16
GRH001.A0202_rmdup	4626181	4626183		YPO_RS21630	2
GRH001.A0202_rmdup	4630019	4630027		yieH	8
GRH001.A0202_rmdup	4632511	4632513		YPO_RS21665	2
GRH001.A0202_rmdup	4634563	4634570		phoU	7
GRH001.A0202_rmdup	4640781	4640794		glmS	13
GRS004.A0101_rmdup	4028	4053		ravA	25
GRS004.A0101_rmdup	7236	7243		kup	7
GRS004.A0101_rmdup	14914	14923		YPO_RS01080	9
GRS004.A0101_rmdup	29038	29040		hemN	2
GRS004.A0101_rmdup	37827	37837		yihX	10
GRS004.A0101_rmdup	41108	41114		YPO_RS01185	6
GRS004.A0101_rmdup	45948	45953		gltS	5
GRS004.A0101_rmdup	73925	73928		envC	3
GRS004.A0101_rmdup	97350	97352		YPO_RS01470	2
GRS004.A0101_rmdup	106563	106588		YPO_RS01520	25
GRS004.A0101_rmdup	127171	127173		YPO_RS01610	2
GRS004.A0101_rmdup	150599	150602		envZ	3
GRS004.A0101_rmdup	196655	196692		YPO_RS01895	37
GRS004.A0101_rmdup	245399	245451		YPO_RS02240	52
GRS004.A0101_rmdup	259182	259184		YPO_RS02290	2
GRS004.A0101_rmdup	266483	266484		YPO_RS02340	1
GRS004.A0101_rmdup	275501	275546		YPO_RS02395	45
GRS004.A0101_rmdup	278904	278910		metC	6
GRS004.A0101_rmdup	288882	288962		YPO_RS02455	80
GRS004.A0101_rmdup	314224	314234		yapK	10
GRS004.A0101_rmdup	335092	335097		ssb1	5
GRS004.A0101_rmdup	342215	342227		rhaR	12
GRS004.A0101_rmdup	346078	346081		YPO_RS02695	3
GRS004.A0101_rmdup	347066	347080		YPO_RS02695	14
GRS004.A0101_rmdup	347660	347661		YPO_RS02695	1
GRS004.A0101_rmdup	369189	369192		frdA	3
GRS004.A0101_rmdup	373623	373628		mscM	5
GRS004.A0101_rmdup	383564	383572		amiB	8
GRS004.A0101_rmdup	407852	407860		YPO_RS02955	8
GRS004.A0101_rmdup	408479	408497		YPO_RS02955	18
GRS004.A0101_rmdup	409218	409220		YPO_RS02960	2
GRS004.A0101_rmdup	409475	409517		YPO_RS02960	42
GRS004.A0101_rmdup	409681	409723		YPO_RS02965	42
GRS004.A0101_rmdup	410027	410032		YPO_RS02965	5
GRS004.A0101_rmdup	410567	410586		YPO_RS02965	19
GRS004.A0101_rmdup	410840	410891		YPO_RS02965	51
GRS004.A0101_rmdup	409567	409633		YPO_RS02965	66
GRS004.A0101_rmdup	415850	415867		YPO_RS02990	17
GRS004.A0101_rmdup	422870	422872		ptsP	2
GRS004.A0101_rmdup	426083	426090		lsrF	7
GRS004.A0101_rmdup	431301	431369		YPO_RS03065	68
GRS004.A0101_rmdup	449678	449686		rimI	8
GRS004.A0101_rmdup	453362	453389		YPO_RS03165	27
GRS004.A0101_rmdup	494990	494991		YPO_RS03330	1
GRS004.A0101_rmdup	495129	495233		YPO_RS03330	104
GRS004.A0101_rmdup	495764	495798		YPO_RS03330	34
GRS004.A0101_rmdup	521332	521347		YPO_RS03450	15
GRS004.A0101_rmdup	522695	522703		apaG	8
GRS004.A0101_rmdup	524674	524678		pdxA	4
GRS004.A0101_rmdup	535139	535142		tssC	3
GRS004.A0101_rmdup	541828	541837		tssH	9
GRS004.A0101_rmdup	549445	549450		tssJ	5
GRS004.A0101_rmdup	552474	552476		YPO_RS03580	2
GRS004.A0101_rmdup	562660	562682		YPO_RS03600	22
GRS004.A0101_rmdup	573140	573141		YPO_RS03645	1
GRS004.A0101_rmdup	575263	575268		leuC	5
GRS004.A0101_rmdup	575975	575976		leuB	1
GRS004.A0101_rmdup	579544	579586		YPO_RS03675	42
GRS004.A0101_rmdup	595321	595364		murF	43
GRS004.A0101_rmdup	595778	595782		murF	4
GRS004.A0101_rmdup	633078	633081		yapG	3
GRS004.A0101_rmdup	642408	642409		YPO_RS03950	1
GRS004.A0101_rmdup	652478	652480		cdiA	2
GRS004.A0101_rmdup	653728	653744		cdiA	16
GRS004.A0101_rmdup	658660	658670		cdiA	10
GRS004.A0101_rmdup	659249	659268		cdiI	19
GRS004.A0101_rmdup	659361	659389		cdiI	28
GRS004.A0101_rmdup	660157	660161		YPO_RS04005	4
GRS004.A0101_rmdup	666274	666290		YPO_RS04030	16
GRS004.A0101_rmdup	672631	672635		YPO_RS04050	4
GRS004.A0101_rmdup	673947	673984		YPO_RS04055	37
GRS004.A0101_rmdup	686679	686680		YPO_RS04105	1
GRS004.A0101_rmdup	700110	700112		rpoD	2
GRS004.A0101_rmdup	705002	705015		plsY	13
GRS004.A0101_rmdup	708562	708585		YPO_RS04230	23
GRS004.A0101_rmdup	735190	735194		ftsP	4
GRS004.A0101_rmdup	739510	739517		YPO_RS04355	7
GRS004.A0101_rmdup	744820	744824		exbB	4
GRS004.A0101_rmdup	747760	747783		YPO_RS04390	23
GRS004.A0101_rmdup	750435	750462		YPO_RS04410	27
GRS004.A0101_rmdup	750459	750523		YPO_RS04415	64
GRS004.A0101_rmdup	751021	751022		YPO_RS04415	1
GRS004.A0101_rmdup	751153	751154		YPO_RS04415	1
GRS004.A0101_rmdup	751186	751219		YPO_RS04415	33
GRS004.A0101_rmdup	752460	752466		YPO_RS04420	6
GRS004.A0101_rmdup	752607	752617		YPO_RS04420	10
GRS004.A0101_rmdup	752629	752664		YPO_RS04425	35
GRS004.A0101_rmdup	753542	753559		YPO_RS04425	17
GRS004.A0101_rmdup	753939	753945		YPO_RS04430	6
GRS004.A0101_rmdup	754848	754858		YPO_RS04440	10
GRS004.A0101_rmdup	755296	755336		YPO_RS04440	40
GRS004.A0101_rmdup	756589	756604		YPO_RS04450	15
GRS004.A0101_rmdup	758450	758497		YPO_RS04465	47
GRS004.A0101_rmdup	772534	772552		YPO_RS04525	18
GRS004.A0101_rmdup	781496	781521		flgA	25
GRS004.A0101_rmdup	784611	784613		flaE	2
GRS004.A0101_rmdup	785301	785335		YPO_RS04600	34
GRS004.A0101_rmdup	786278	786279		flgF	1
GRS004.A0101_rmdup	793887	793922		YPO_RS04655	35
GRS004.A0101_rmdup	796068	796080		YPO_RS04660	12
GRS004.A0101_rmdup	801482	801495		fliS	13
GRS004.A0101_rmdup	807616	807695		YPO_RS04720	79
GRS004.A0101_rmdup	807690	807695		YPO_RS04725	5
GRS004.A0101_rmdup	809194	809222		YPO_RS04735	28
GRS004.A0101_rmdup	811155	811160		YPO_RS04740	5
GRS004.A0101_rmdup	811155	811160		YPO_RS04745	5
GRS004.A0101_rmdup	811233	811238		YPO_RS04745	5
GRS004.A0101_rmdup	834345	834352		YPO_RS04800	7
GRS004.A0101_rmdup	842077	842079		YPO_RS04830	2
GRS004.A0101_rmdup	845400	845617		YPO_RS04835	217
GRS004.A0101_rmdup	853769	853773		YPO_RS04845	4
GRS004.A0101_rmdup	858881	858885		YPO_RS04860	4
GRS004.A0101_rmdup	886181	886191		YPO_RS04975	10
GRS004.A0101_rmdup	886605	886660		YPO_RS04980	55
GRS004.A0101_rmdup	887096	887104		gspL	8
GRS004.A0101_rmdup	888129	888182		YPO_RS04990	53
GRS004.A0101_rmdup	888928	888944		YPO_RS04990	16
GRS004.A0101_rmdup	889416	889418		gspJ	2
GRS004.A0101_rmdup	889509	889519		gspJ	10
GRS004.A0101_rmdup	889985	890011		YPO_RS05005	26
GRS004.A0101_rmdup	893734	893817		gspD	83
GRS004.A0101_rmdup	894454	894469		gspD	15
GRS004.A0101_rmdup	894857	894873		gspD	16
GRS004.A0101_rmdup	895437	895461		gspD	24
GRS004.A0101_rmdup	895697	895770		YPO_RS05030	73
GRS004.A0101_rmdup	896041	896073		YPO_RS05030	32
GRS004.A0101_rmdup	896156	896190		YPO_RS05030	34
GRS004.A0101_rmdup	907139	907144		YPO_RS05070	5
GRS004.A0101_rmdup	919741	919742		YPO_RS05130	1
GRS004.A0101_rmdup	924397	924398		YPO_RS05145	1
GRS004.A0101_rmdup	950102	950120		YPO_RS05235	18
GRS004.A0101_rmdup	950168	950173		YPO_RS05235	5
GRS004.A0101_rmdup	953693	953761		YPO_RS05260	68
GRS004.A0101_rmdup	966508	966510		YPO_RS05330	2
GRS004.A0101_rmdup	971816	971827		lysS	11
GRS004.A0101_rmdup	993963	993986		gcvP	23
GRS004.A0101_rmdup	1020684	1020690		speA	6
GRS004.A0101_rmdup	1040570	1040577		YPO_RS05675	7
GRS004.A0101_rmdup	1044270	1044280		YPO_RS05675	10
GRS004.A0101_rmdup	1044439	1044492		YPO_RS05675	53
GRS004.A0101_rmdup	1044629	1044648		YPO_RS05675	19
GRS004.A0101_rmdup	1045008	1045079		YPO_RS05675	71
GRS004.A0101_rmdup	1045543	1045635		YPO_RS05675	92
GRS004.A0101_rmdup	1045833	1045838		YPO_RS05675	5
GRS004.A0101_rmdup	1046491	1046496		YPO_RS05675	5
GRS004.A0101_rmdup	1046701	1046717		YPO_RS05675	16
GRS004.A0101_rmdup	1053165	1053173		mltC	8
GRS004.A0101_rmdup	1066928	1066937		YPO_RS05765	9
GRS004.A0101_rmdup	1066980	1067000		YPO_RS05765	20
GRS004.A0101_rmdup	1067245	1067246		YPO_RS05765	1
GRS004.A0101_rmdup	1067365	1067389		YPO_RS05765	24
GRS004.A0101_rmdup	1067376	1067393		YPO_RS05770	17
GRS004.A0101_rmdup	1068114	1068119		YPO_RS05770	5
GRS004.A0101_rmdup	1068162	1068170		YPO_RS05770	8
GRS004.A0101_rmdup	1080684	1080685		YPO_RS05815	1
GRS004.A0101_rmdup	1081396	1081439		YPO_RS05815	43
GRS004.A0101_rmdup	1110739	1110750		YPO_RS05920	11
GRS004.A0101_rmdup	1112254	1112262		YPO_RS05930	8
GRS004.A0101_rmdup	1116818	1116838		YPO_RS05940	20
GRS004.A0101_rmdup	1117063	1117091		YPO_RS05940	28
GRS004.A0101_rmdup	1117253	1117275		YPO_RS05940	22
GRS004.A0101_rmdup	1121599	1121600		yapH	1
GRS004.A0101_rmdup	1123651	1123656		yapH	5
GRS004.A0101_rmdup	1126263	1126289		yapH	26
GRS004.A0101_rmdup	1135692	1135698		YPO_RS05970	6
GRS004.A0101_rmdup	1140865	1140867		YPO_RS05985	2
GRS004.A0101_rmdup	1142202	1142220		YPO_RS05985	18
GRS004.A0101_rmdup	1142433	1142437		YPO_RS05985	4
GRS004.A0101_rmdup	1164158	1164181		YPO_RS06050	23
GRS004.A0101_rmdup	1166403	1166432		mltA	29
GRS004.A0101_rmdup	1202214	1202237		dnaE	23
GRS004.A0101_rmdup	1214663	1214681		metI	18
GRS004.A0101_rmdup	1218461	1218462		YPO_RS06330	1
GRS004.A0101_rmdup	1220120	1220129		YPO_RS06340	9
GRS004.A0101_rmdup	1221211	1221223		YPO_RS06340	12
GRS004.A0101_rmdup	1221601	1221602		YPO_RS06340	1
GRS004.A0101_rmdup	1237272	1237284		YPO_RS06440	12
GRS004.A0101_rmdup	1241049	1241125		YPO_RS06465	76
GRS004.A0101_rmdup	1241992	1242031		YPO_RS06465	39
GRS004.A0101_rmdup	1243209	1243240		YPO_RS06470	31
GRS004.A0101_rmdup	1251893	1251910		YPO_RS06525	17
GRS004.A0101_rmdup	1260316	1260341		odhB	25
GRS004.A0101_rmdup	1269595	1269648		tolA	53
GRS004.A0101_rmdup	1278063	1278076		aroG	13
GRS004.A0101_rmdup	1285518	1285522		galE	4
GRS004.A0101_rmdup	1298654	1298656		bioF	2
GRS004.A0101_rmdup	1311986	1311993		betA	7
GRS004.A0101_rmdup	1322262	1322287		YPO_RS06875	25
GRS004.A0101_rmdup	1322733	1322734		YPO_RS06875	1
GRS004.A0101_rmdup	1341148	1341162		urtE	14
GRS004.A0101_rmdup	1347759	1347771		YPO_RS06995	12
GRS004.A0101_rmdup	1373176	1373181		gyrA	5
GRS004.A0101_rmdup	1388255	1388256		YPO_RS07145	1
GRS004.A0101_rmdup	1392300	1392317		ycoA	17
GRS004.A0101_rmdup	1406118	1406119		YPO_RS07235	1
GRS004.A0101_rmdup	1406998	1406999		YPO_RS07240	1
GRS004.A0101_rmdup	1413163	1413168		YPO_RS07280	5
GRS004.A0101_rmdup	1433941	1433945		YPO_RS07370	4
GRS004.A0101_rmdup	1438651	1438658		YPO_RS07390	7
GRS004.A0101_rmdup	1449279	1449295		YPO_RS07435	16
GRS004.A0101_rmdup	1454608	1454612		YPO_RS07455	4
GRS004.A0101_rmdup	1458959	1458965		fruK	6
GRS004.A0101_rmdup	1462104	1462112		YPO_RS07490	8
GRS004.A0101_rmdup	1463093	1463122		psaA	29
GRS004.A0101_rmdup	1463379	1463384		YPO_RS07500	5
GRS004.A0101_rmdup	1464888	1464916		psaC	28
GRS004.A0101_rmdup	1465138	1465146		psaC	8
GRS004.A0101_rmdup	1476502	1476506		YPO_RS07545	4
GRS004.A0101_rmdup	1476999	1477023		YPO_RS07545	24
GRS004.A0101_rmdup	1505622	1505634		YPO_RS07680	12
GRS004.A0101_rmdup	1508525	1508531		YPO_RS07695	6
GRS004.A0101_rmdup	1512244	1512246		YPO_RS07720	2
GRS004.A0101_rmdup	1514470	1514475		artQ	5
GRS004.A0101_rmdup	1562465	1562469		YPO_RS07915	4
GRS004.A0101_rmdup	1566379	1566404		YPO_RS07930	25
GRS004.A0101_rmdup	1566687	1566721		YPO_RS07930	34
GRS004.A0101_rmdup	1566900	1566906		YPO_RS07930	6
GRS004.A0101_rmdup	1567683	1567799		YPO_RS07930	116
GRS004.A0101_rmdup	1567848	1567852		YPO_RS07930	4
GRS004.A0101_rmdup	1580932	1580937		YPO_RS07975	5
GRS004.A0101_rmdup	1595750	1595759		ldtD	9
GRS004.A0101_rmdup	1595791	1595794		ldtD	3
GRS004.A0101_rmdup	1599866	1599868		ompF	2
GRS004.A0101_rmdup	1625491	1625498		YPO_RS08150	7
GRS004.A0101_rmdup	1633667	1633668		helD	1
GRS004.A0101_rmdup	1647598	1647675		YPO_RS08260	77
GRS004.A0101_rmdup	1651516	1651519		YPO_RS08280	3
GRS004.A0101_rmdup	1652069	1652100		YPO_RS08280	31
GRS004.A0101_rmdup	1652102	1652104		YPO_RS08285	2
GRS004.A0101_rmdup	1652422	1652423		YPO_RS08285	1
GRS004.A0101_rmdup	1653820	1653831		YPO_RS08295	11
GRS004.A0101_rmdup	1654210	1654217		YPO_RS08300	7
GRS004.A0101_rmdup	1658263	1658267		tssC	4
GRS004.A0101_rmdup	1658414	1658418		tssC	4
GRS004.A0101_rmdup	1658594	1658595		tssK	1
GRS004.A0101_rmdup	1658769	1658781		tssK	12
GRS004.A0101_rmdup	1661239	1661254		YPO_RS08330	15
GRS004.A0101_rmdup	1668235	1668239		YPO_RS08350	4
GRS004.A0101_rmdup	1670494	1670513		YPO_RS08355	19
GRS004.A0101_rmdup	1673372	1673411		YPO_RS08365	39
GRS004.A0101_rmdup	1673837	1673839		YPO_RS08365	2
GRS004.A0101_rmdup	1674223	1674243		YPO_RS08370	20
GRS004.A0101_rmdup	1681287	1681304		YPO_RS08385	17
GRS004.A0101_rmdup	1684069	1684197		YPO_RS08400	128
GRS004.A0101_rmdup	1684429	1684495		YPO_RS08400	66
GRS004.A0101_rmdup	1685798	1685823		tssF	25
GRS004.A0101_rmdup	1688346	1688368		tssE	22
GRS004.A0101_rmdup	1688643	1688660		YPO_RS08425	17
GRS004.A0101_rmdup	1693908	1693922		YPO_RS08440	14
GRS004.A0101_rmdup	1698660	1698672		darE	12
GRS004.A0101_rmdup	1699863	1699879		darD	16
GRS004.A0101_rmdup	1699881	1699891		darC	10
GRS004.A0101_rmdup	1700286	1700354		darC	68
GRS004.A0101_rmdup	1701072	1701143		darC	71
GRS004.A0101_rmdup	1701145	1701154		darB	9
GRS004.A0101_rmdup	1701352	1701394		darB	42
GRS004.A0101_rmdup	1701517	1701530		darB	13
GRS004.A0101_rmdup	1701730	1701741		darB	11
GRS004.A0101_rmdup	1704818	1704830		fghA	12
GRS004.A0101_rmdup	1706499	1706508		YPO_RS08495	9
GRS004.A0101_rmdup	1717710	1717736		YPO_RS08535	26
GRS004.A0101_rmdup	1722160	1722163		YPO_RS08555	3
GRS004.A0101_rmdup	1722674	1722698		YPO_RS08560	24
GRS004.A0101_rmdup	1725930	1725954		YPO_RS08570	24
GRS004.A0101_rmdup	1726302	1726317		YPO_RS08570	15
GRS004.A0101_rmdup	1739303	1739320		YPO_RS08625	17
GRS004.A0101_rmdup	1739976	1739977		YPO_RS08625	1
GRS004.A0101_rmdup	1751909	1751917		YPO_RS08670	8
GRS004.A0101_rmdup	1752090	1752119		YPO_RS08670	29
GRS004.A0101_rmdup	1763882	1763885		hisD	3
GRS004.A0101_rmdup	1775716	1775717		YPO_RS08785	1
GRS004.A0101_rmdup	1796125	1796166		YPO_RS08855	41
GRS004.A0101_rmdup	1806995	1806998		YPO_RS08905	3
GRS004.A0101_rmdup	1808269	1808277		YPO_RS08910	8
GRS004.A0101_rmdup	1808269	1808322		bssS	53
GRS004.A0101_rmdup	1818616	1818617		YPO_RS08955	1
GRS004.A0101_rmdup	1820336	1820337		plsX	1
GRS004.A0101_rmdup	1835640	1835650		YPO_RS09055	10
GRS004.A0101_rmdup	1838772	1838778		YPO_RS09075	6
GRS004.A0101_rmdup	1843200	1843216		YPO_RS09095	16
GRS004.A0101_rmdup	1861610	1861613		purB	3
GRS004.A0101_rmdup	1878147	1878167		YPO_RS09250	20
GRS004.A0101_rmdup	1902010	1902013		YPO_RS09335	3
GRS004.A0101_rmdup	1904869	1904871		yapJ	2
GRS004.A0101_rmdup	1905795	1905799		yapJ	4
GRS004.A0101_rmdup	1918291	1918292		YPO_RS09385	1
GRS004.A0101_rmdup	1919643	1919651		YPO_RS09390	8
GRS004.A0101_rmdup	1921836	1921839		YPO_RS09395	3
GRS004.A0101_rmdup	1933830	1933862		YPO_RS09455	32
GRS004.A0101_rmdup	1945764	1945766		prc	2
GRS004.A0101_rmdup	1950463	1950484		YPO_RS09520	21
GRS004.A0101_rmdup	1952755	1952766		YPO_RS09525	11
GRS004.A0101_rmdup	1963163	1963167		YPO_RS09565	4
GRS004.A0101_rmdup	1969761	1969766		kduD	5
GRS004.A0101_rmdup	1970805	1970827		kduI	22
GRS004.A0101_rmdup	1976637	1976644		YPO_RS09630	7
GRS004.A0101_rmdup	1983850	1983851		YPO_RS09675	1
GRS004.A0101_rmdup	1996030	1996065		YPO_RS09745	35
GRS004.A0101_rmdup	1999862	1999874		mntP	12
GRS004.A0101_rmdup	2000350	2000379		YPO_RS09760	29
GRS004.A0101_rmdup	2013335	2013336		hpaX	1
GRS004.A0101_rmdup	2015835	2015848		hpaC	13
GRS004.A0101_rmdup	2023584	2023586		dbpA	2
GRS004.A0101_rmdup	2024882	2024888		YPO_RS09880	6
GRS004.A0101_rmdup	2033311	2033324		YPO_RS09920	13
GRS004.A0101_rmdup	2033436	2033448		YPO_RS09925	12
GRS004.A0101_rmdup	2060609	2060623		YPO_RS10045	14
GRS004.A0101_rmdup	2067961	2067973		fliO	12
GRS004.A0101_rmdup	2070444	2070477		YPO_RS10110	33
GRS004.A0101_rmdup	2072557	2072563		fliI	6
GRS004.A0101_rmdup	2081670	2081673		YPO_RS10170	3
GRS004.A0101_rmdup	2085721	2085744		fliD	23
GRS004.A0101_rmdup	2090846	2090851		YPO_RS10210	5
GRS004.A0101_rmdup	2109809	2109820		YPO_RS10290	11
GRS004.A0101_rmdup	2112105	2112109		uvrY	4
GRS004.A0101_rmdup	2117726	2117779		YPO_RS10355	53
GRS004.A0101_rmdup	2118015	2118017		hcp	2
GRS004.A0101_rmdup	2118076	2118111		hcp	35
GRS004.A0101_rmdup	2123437	2123442		YPO_RS10405	5
GRS004.A0101_rmdup	2126767	2126788		YPO_RS10420	21
GRS004.A0101_rmdup	2126889	2126902		YPO_RS10420	13
GRS004.A0101_rmdup	2129557	2129559		YPO_RS10435	2
GRS004.A0101_rmdup	2142356	2142357		fyuA	1
GRS004.A0101_rmdup	2145541	2145548		ybtU	7
GRS004.A0101_rmdup	2148522	2148527		irp1	5
GRS004.A0101_rmdup	2151833	2151846		irp1	13
GRS004.A0101_rmdup	2152655	2152661		irp1	6
GRS004.A0101_rmdup	2154274	2154298		irp1	24
GRS004.A0101_rmdup	2154541	2154562		irp1	21
GRS004.A0101_rmdup	2156790	2156802		irp2	12
GRS004.A0101_rmdup	2158208	2158220		irp2	12
GRS004.A0101_rmdup	2159766	2159778		irp2	12
GRS004.A0101_rmdup	2160008	2160009		irp2	1
GRS004.A0101_rmdup	2164467	2164476		ybtP	9
GRS004.A0101_rmdup	2165834	2165844		ybtQ	10
GRS004.A0101_rmdup	2166595	2166604		ybtQ	9
GRS004.A0101_rmdup	2167177	2167180		ybtX	3
GRS004.A0101_rmdup	2167211	2167212		ybtX	1
GRS004.A0101_rmdup	2167354	2167377		ybtX	23
GRS004.A0101_rmdup	2172536	2172538		YPO_RS10585	2
GRS004.A0101_rmdup	2174340	2174349		YPO_RS10590	9
GRS004.A0101_rmdup	2176407	2176414		YPO_RS10595	7
GRS004.A0101_rmdup	2178389	2178393		YPO_RS10605	4
GRS004.A0101_rmdup	2187795	2187800		YPO_RS10645	5
GRS004.A0101_rmdup	2189562	2189563		YPO_RS10650	1
GRS004.A0101_rmdup	2195850	2195862		ansP	12
GRS004.A0101_rmdup	2200753	2200771		YPO_RS10695	18
GRS004.A0101_rmdup	2207065	2207066		YPO_RS10715	1
GRS004.A0101_rmdup	2237356	2237375		YPO_RS10835	19
GRS004.A0101_rmdup	2253380	2253385		YPO_RS10910	5
GRS004.A0101_rmdup	2256733	2256737		YPO_RS10925	4
GRS004.A0101_rmdup	2259151	2259169		YPO_RS10935	18
GRS004.A0101_rmdup	2259740	2259755		YPO_RS10935	15
GRS004.A0101_rmdup	2260130	2260138		YPO_RS10935	8
GRS004.A0101_rmdup	2265705	2265710		YPO_RS10955	5
GRS004.A0101_rmdup	2266292	2266311		YPO_RS10965	19
GRS004.A0101_rmdup	2277259	2277270		YPO_RS11015	11
GRS004.A0101_rmdup	2296682	2296685		YPO_RS11120	3
GRS004.A0101_rmdup	2303892	2303907		YPO_RS11155	15
GRS004.A0101_rmdup	2306170	2306172		YPO_RS11175	2
GRS004.A0101_rmdup	2306899	2306903		YPO_RS11175	4
GRS004.A0101_rmdup	2316452	2316515		YPO_RS11220	63
GRS004.A0101_rmdup	2318132	2318136		YPO_RS11225	4
GRS004.A0101_rmdup	2319529	2319551		YPO_RS11225	22
GRS004.A0101_rmdup	2319790	2319796		YPO_RS11225	6
GRS004.A0101_rmdup	2321179	2321181		YPO_RS11225	2
GRS004.A0101_rmdup	2335714	2335715		ruvA	1
GRS004.A0101_rmdup	2338027	2338046		znuB	19
GRS004.A0101_rmdup	2374924	2374931		YPO_RS11505	7
GRS004.A0101_rmdup	2375654	2375656		YPO_RS11510	2
GRS004.A0101_rmdup	2376959	2376970		YPO_RS11520	11
GRS004.A0101_rmdup	2400845	2400853		YPO_RS11665	8
GRS004.A0101_rmdup	2439592	2439594		YPO_RS11830	2
GRS004.A0101_rmdup	2440186	2440221		YPO_RS11830	35
GRS004.A0101_rmdup	2445242	2445257		rssB	15
GRS004.A0101_rmdup	2475850	2475869		YPO_RS12005	19
GRS004.A0101_rmdup	2483907	2483908		YPO_RS12045	1
GRS004.A0101_rmdup	2489395	2489409		sohB	14
GRS004.A0101_rmdup	2491178	2491222		topA	44
GRS004.A0101_rmdup	2495905	2495953		YPO_RS12105	48
GRS004.A0101_rmdup	2501127	2501143		pgpB	16
GRS004.A0101_rmdup	2503051	2503079		YPO_RS12135	28
GRS004.A0101_rmdup	2519275	2519316		YPO_RS12215	41
GRS004.A0101_rmdup	2521114	2521135		rsxC	21
GRS004.A0101_rmdup	2521867	2521873		rsxC	6
GRS004.A0101_rmdup	2541923	2541933		YPO_RS12300	10
GRS004.A0101_rmdup	2545226	2545241		fumC	15
GRS004.A0101_rmdup	2548355	2548361		YPO_RS12325	6
GRS004.A0101_rmdup	2550209	2550212		YPO_RS12335	3
GRS004.A0101_rmdup	2553050	2553058		clcB	8
GRS004.A0101_rmdup	2554373	2554633		YPO_RS12355	260
GRS004.A0101_rmdup	2554658	2555065		YPO_RS12360	407
GRS004.A0101_rmdup	2555162	2555608		YPO_RS12365	446
GRS004.A0101_rmdup	2555780	2556832		YPO_RS12370	1052
GRS004.A0101_rmdup	2556844	2557161		YPO_RS12375	317
GRS004.A0101_rmdup	2557164	2557415		YPO_RS12380	251
GRS004.A0101_rmdup	2557451	2557684		YPO_RS12385	233
GRS004.A0101_rmdup	2557749	2559461		YPO_RS12390	1712
GRS004.A0101_rmdup	2559474	2559761		YPO_RS12395	287
GRS004.A0101_rmdup	2559765	2560790		YPO_RS12400	1025
GRS004.A0101_rmdup	2560790	2562034		YPO_RS12405	1244
GRS004.A0101_rmdup	2562123	2562371		YPO_RS12410	248
GRS004.A0101_rmdup	2562568	2562765		YPO_RS12415	197
GRS004.A0101_rmdup	2565808	2565844		YPO_RS12435	36
GRS004.A0101_rmdup	2565980	2565987		YPO_RS12435	7
GRS004.A0101_rmdup	2606399	2606401		asr	2
GRS004.A0101_rmdup	2630108	2630116		YPO_RS12680	8
GRS004.A0101_rmdup	2640270	2640272		YPO_RS12725	2
GRS004.A0101_rmdup	2640511	2640522		YPO_RS12725	11
GRS004.A0101_rmdup	2665065	2665077		anmK	12
GRS004.A0101_rmdup	2716582	2716590		arnF	8
GRS004.A0101_rmdup	2755010	2755033		YPO_RS13290	23
GRS004.A0101_rmdup	2755147	2755159		YPO_RS13290	12
GRS004.A0101_rmdup	2766970	2766975		cas3f	5
GRS004.A0101_rmdup	2773280	2773284		YPO_RS13360	4
GRS004.A0101_rmdup	2785606	2785617		YPO_RS13415	11
GRS004.A0101_rmdup	2792611	2792646		cdiA	35
GRS004.A0101_rmdup	2796575	2796579		cdiA	4
GRS004.A0101_rmdup	2805331	2805334		YPO_RS13475	3
GRS004.A0101_rmdup	2814139	2814142		YPO_RS13510	3
GRS004.A0101_rmdup	2814183	2814216		YPO_RS13510	33
GRS004.A0101_rmdup	2853933	2853946		YPO_RS13690	13
GRS004.A0101_rmdup	2854070	2854074		YPO_RS13690	4
GRS004.A0101_rmdup	2854178	2854184		YPO_RS13690	6
GRS004.A0101_rmdup	2857131	2857132		nuoM	1
GRS004.A0101_rmdup	2857325	2857338		nuoM	13
GRS004.A0101_rmdup	2871021	2871027		lrhA	6
GRS004.A0101_rmdup	2897593	2897632		YPO_RS13845	39
GRS004.A0101_rmdup	2899443	2899455		iolD	12
GRS004.A0101_rmdup	2907419	2907426		iolC	7
GRS004.A0101_rmdup	2908163	2908199		iolC	36
GRS004.A0101_rmdup	2922185	2922186		dacA	1
GRS004.A0101_rmdup	2926649	2926659		mrdA	10
GRS004.A0101_rmdup	2957487	2957494		glnS	7
GRS004.A0101_rmdup	2972901	2972910		proW	9
GRS004.A0101_rmdup	2980433	2980591		YPO_RS14235	158
GRS004.A0101_rmdup	2983051	2983066		YPO_RS14250	15
GRS004.A0101_rmdup	3006655	3006657		chbR	2
GRS004.A0101_rmdup	3010748	3010760		pgm	12
GRS004.A0101_rmdup	3012185	3012220		YPO_RS14405	35
GRS004.A0101_rmdup	3021105	3021140		YPO_RS14440	35
GRS004.A0101_rmdup	3029374	3029383		YPO_RS14490	9
GRS004.A0101_rmdup	3031198	3031200		pcp	2
GRS004.A0101_rmdup	3032170	3032172		ung	2
GRS004.A0101_rmdup	3037246	3037264		YPO_RS14530	18
GRS004.A0101_rmdup	3042841	3042846		YPO_RS14560	5
GRS004.A0101_rmdup	3055895	3055919		YPO_RS14610	24
GRS004.A0101_rmdup	3075614	3075622		fadL	8
GRS004.A0101_rmdup	3109621	3109622		hisJ	1
GRS004.A0101_rmdup	3111905	3111915		hisP	10
GRS004.A0101_rmdup	3114638	3114646		yfcE	8
GRS004.A0101_rmdup	3121234	3121251		YPO_RS14925	17
GRS004.A0101_rmdup	3121678	3121682		YPO_RS14925	4
GRS004.A0101_rmdup	3122361	3122367		YPO_RS14930	6
GRS004.A0101_rmdup	3122445	3122476		YPO_RS14930	31
GRS004.A0101_rmdup	3123203	3123213		YPO_RS14940	10
GRS004.A0101_rmdup	3123944	3123977		YPO_RS14945	33
GRS004.A0101_rmdup	3124118	3124144		YPO_RS14950	26
GRS004.A0101_rmdup	3127196	3127219		YPO_RS14960	23
GRS004.A0101_rmdup	3141410	3141411		YPO_RS15015	1
GRS004.A0101_rmdup	3179510	3179519		YPO_RS15205	9
GRS004.A0101_rmdup	3180931	3180936		YPO_RS15210	5
GRS004.A0101_rmdup	3183978	3183979		mdtC	1
GRS004.A0101_rmdup	3184475	3184477		mdtC	2
GRS004.A0101_rmdup	3192268	3192272		YPO_RS15240	4
GRS004.A0101_rmdup	3198225	3198247		YPO_RS15270	22
GRS004.A0101_rmdup	3200184	3200195		YPO_RS15280	11
GRS004.A0101_rmdup	3200192	3200228		YPO_RS15285	36
GRS004.A0101_rmdup	3200273	3200289		YPO_RS15285	16
GRS004.A0101_rmdup	3200400	3200438		YPO_RS15285	38
GRS004.A0101_rmdup	3200571	3200587		YPO_RS15285	16
GRS004.A0101_rmdup	3200749	3200753		YPO_RS15290	4
GRS004.A0101_rmdup	3200820	3200970		YPO_RS15290	150
GRS004.A0101_rmdup	3201325	3201351		YPO_RS15295	26
GRS004.A0101_rmdup	3201605	3201727		YPO_RS15300	122
GRS004.A0101_rmdup	3201867	3201874		YPO_RS15300	7
GRS004.A0101_rmdup	3202243	3202285		YPO_RS15305	42
GRS004.A0101_rmdup	3204535	3204537		guaA	2
GRS004.A0101_rmdup	3216202	3216211		rodZ	9
GRS004.A0101_rmdup	3221793	3221834		YPO_RS15385	41
GRS004.A0101_rmdup	3222650	3222651		YPO_RS15385	1
GRS004.A0101_rmdup	3223344	3223349		yapA	5
GRS004.A0101_rmdup	3228361	3228365		YPO_RS15395	4
GRS004.A0101_rmdup	3230071	3230091		YPO_RS15395	20
GRS004.A0101_rmdup	3231860	3231862		YPO_RS15405	2
GRS004.A0101_rmdup	3243784	3243785		YPO_RS15475	1
GRS004.A0101_rmdup	3254256	3254262		YPO_RS15525	6
GRS004.A0101_rmdup	3262704	3262712		YPO_RS15560	8
GRS004.A0101_rmdup	3278098	3278107		tssK	9
GRS004.A0101_rmdup	3278256	3278263		tssK	7
GRS004.A0101_rmdup	3285275	3285276		YPO_RS15670	1
GRS004.A0101_rmdup	3285769	3285781		YPO_RS15670	12
GRS004.A0101_rmdup	3285803	3285813		YPO_RS15675	10
GRS004.A0101_rmdup	3296559	3296570		YPO_RS15705	11
GRS004.A0101_rmdup	3311441	3311452		YPO_RS15770	11
GRS004.A0101_rmdup	3356083	3356105		YPO_RS16010	22
GRS004.A0101_rmdup	3357155	3357167		YPO_RS16015	12
GRS004.A0101_rmdup	3363742	3363748		YPO_RS16040	6
GRS004.A0101_rmdup	3364213	3364221		YPO_RS16040	8
GRS004.A0101_rmdup	3364274	3364284		YPO_RS16040	10
GRS004.A0101_rmdup	3364680	3364737		YPO_RS16040	57
GRS004.A0101_rmdup	3365083	3365132		cysM	49
GRS004.A0101_rmdup	3381105	3381116		yapL	11
GRS004.A0101_rmdup	3383855	3383870		YPO_RS16125	15
GRS004.A0101_rmdup	3398531	3398532		acrD	1
GRS004.A0101_rmdup	3403422	3403427		YPO_RS16210	5
GRS004.A0101_rmdup	3434089	3434090		YPO_RS16360	1
GRS004.A0101_rmdup	3452902	3452907		YPO_RS16435	5
GRS004.A0101_rmdup	3454282	3454287		fepE	5
GRS004.A0101_rmdup	3454834	3454853		fepE	19
GRS004.A0101_rmdup	3455009	3455028		cpsG	19
GRS004.A0101_rmdup	3456555	3456565		YPO_RS16450	10
GRS004.A0101_rmdup	3463321	3463343		YPO_RS16480	22
GRS004.A0101_rmdup	3463471	3463475		YPO_RS16480	4
GRS004.A0101_rmdup	3463755	3463822		YPO_RS16480	67
GRS004.A0101_rmdup	3463909	3463961		YPO_RS16480	52
GRS004.A0101_rmdup	3464163	3464219		YPO_RS16480	56
GRS004.A0101_rmdup	3464843	3464874		YPO_RS16485	31
GRS004.A0101_rmdup	3465037	3465113		YPO_RS16485	76
GRS004.A0101_rmdup	3465306	3465325		YPO_RS16485	19
GRS004.A0101_rmdup	3465435	3465438		YPO_RS16485	3
GRS004.A0101_rmdup	3465500	3465556		YPO_RS16485	56
GRS004.A0101_rmdup	3465567	3465600		YPO_RS16490	33
GRS004.A0101_rmdup	3465711	3465715		YPO_RS16490	4
GRS004.A0101_rmdup	3466245	3466379		YPO_RS16490	134
GRS004.A0101_rmdup	3466637	3466667		YPO_RS16490	30
GRS004.A0101_rmdup	3466815	3466818		YPO_RS16490	3
GRS004.A0101_rmdup	3466984	3466993		YPO_RS16495	9
GRS004.A0101_rmdup	3469111	3469125		YPO_RS16500	14
GRS004.A0101_rmdup	3495159	3495163		YPO_RS16605	4
GRS004.A0101_rmdup	3496986	3497009		YPO_RS16620	23
GRS004.A0101_rmdup	3499342	3499356		YPO_RS16645	14
GRS004.A0101_rmdup	3506489	3506497		YPO_RS16670	8
GRS004.A0101_rmdup	3527200	3527267		YPO_RS16755	67
GRS004.A0101_rmdup	3536340	3536356		yajL	16
GRS004.A0101_rmdup	3547444	3547509		YPO_RS16860	65
GRS004.A0101_rmdup	3552026	3552027		secD	1
GRS004.A0101_rmdup	3561846	3561848		malZ	2
GRS004.A0101_rmdup	3572108	3572128		YPO_RS16965	20
GRS004.A0101_rmdup	3590110	3590128		YPO_RS17045	18
GRS004.A0101_rmdup	3592443	3592478		YPO_RS17055	35
GRS004.A0101_rmdup	3592525	3592531		YPO_RS17055	6
GRS004.A0101_rmdup	3600026	3600032		YPO_RS17080	6
GRS004.A0101_rmdup	3616594	3616596		YPO_RS17145	2
GRS004.A0101_rmdup	3617938	3617941		YPO_RS17145	3
GRS004.A0101_rmdup	3618897	3618902		YPO_RS17145	5
GRS004.A0101_rmdup	3619227	3619241		YPO_RS17145	14
GRS004.A0101_rmdup	3625259	3625260		YPO_RS17165	1
GRS004.A0101_rmdup	3627218	3627227		YPO_RS17180	9
GRS004.A0101_rmdup	3644368	3644400		YPO_RS17270	32
GRS004.A0101_rmdup	3647283	3647293		pssA	10
GRS004.A0101_rmdup	3649934	3649938		YPO_RS17290	4
GRS004.A0101_rmdup	3657830	3657832		pgeF	2
GRS004.A0101_rmdup	3672984	3673011		trmD	27
GRS004.A0101_rmdup	3703941	3703949		katG	8
GRS004.A0101_rmdup	3704715	3704749		cybB	34
GRS004.A0101_rmdup	3731736	3731774		YPO_RS17675	38
GRS004.A0101_rmdup	3737939	3737949		YPO_RS17710	10
GRS004.A0101_rmdup	3754891	3754894		cobA	3
GRS004.A0101_rmdup	3768839	3768840		relA	1
GRS004.A0101_rmdup	3773757	3773764		barA	7
GRS004.A0101_rmdup	3779822	3779841		YPO_RS17900	19
GRS004.A0101_rmdup	3812278	3812293		YPO_RS18035	15
GRS004.A0101_rmdup	3838866	3838881		YPO_RS18145	15
GRS004.A0101_rmdup	3853230	3853239		argF	9
GRS004.A0101_rmdup	3857929	3857931		YPO_RS18215	2
GRS004.A0101_rmdup	3881578	3881587		YPO_RS18335	9
GRS004.A0101_rmdup	3900899	3900922		YPO_RS18420	23
GRS004.A0101_rmdup	3949720	3949763		yjfP	43
GRS004.A0101_rmdup	3950382	3950383		yjfP	1
GRS004.A0101_rmdup	3963739	3963742		arcB	3
GRS004.A0101_rmdup	3968453	3968485		gltB	32
GRS004.A0101_rmdup	3968986	3968987		gltB	1
GRS004.A0101_rmdup	3987791	3987804		YPO_RS18850	13
GRS004.A0101_rmdup	4009426	4009435		tssH	9
GRS004.A0101_rmdup	4011554	4011557		tssA	3
GRS004.A0101_rmdup	4011713	4011722		tssA	9
GRS004.A0101_rmdup	4023135	4023141		YPO_RS19015	6
GRS004.A0101_rmdup	4024722	4024730		YPO_RS19020	8
GRS004.A0101_rmdup	4027885	4027886		YPO_RS19045	1
GRS004.A0101_rmdup	4032708	4032715		YPO_RS19055	7
GRS004.A0101_rmdup	4033663	4033693		YPO_RS19060	30
GRS004.A0101_rmdup	4033811	4033829		YPO_RS19060	18
GRS004.A0101_rmdup	4033940	4033945		YPO_RS19060	5
GRS004.A0101_rmdup	4034676	4034713		YPO_RS19065	37
GRS004.A0101_rmdup	4034956	4034959		YPO_RS19070	3
GRS004.A0101_rmdup	4040863	4040885		ssuE	22
GRS004.A0101_rmdup	4043076	4043083		ssuD	7
GRS004.A0101_rmdup	4072383	4072384		YPO_RS19245	1
GRS004.A0101_rmdup	4082223	4082227		msrQ	4
GRS004.A0101_rmdup	4098633	4098656		YPO_RS19365	23
GRS004.A0101_rmdup	4098801	4098805		YPO_RS19365	4
GRS004.A0101_rmdup	4098940	4098960		YPO_RS19365	20
GRS004.A0101_rmdup	4099361	4099406		YPO_RS19365	45
GRS004.A0101_rmdup	4101635	4101747		YPO_RS19370	112
GRS004.A0101_rmdup	4104593	4104600		YPO_RS19375	7
GRS004.A0101_rmdup	4112761	4112771		YPO_RS19400	10
GRS004.A0101_rmdup	4116820	4116840		YPO_RS19410	20
GRS004.A0101_rmdup	4142804	4142845		YPO_RS19535	41
GRS004.A0101_rmdup	4155025	4155038		lysC	13
GRS004.A0101_rmdup	4155782	4155789		lysC	7
GRS004.A0101_rmdup	4176218	4176220		YPO_RS19645	2
GRS004.A0101_rmdup	4188593	4188621		YPO_RS19705	28
GRS004.A0101_rmdup	4206217	4206230		rplL	13
GRS004.A0101_rmdup	4216794	4216796		murB	2
GRS004.A0101_rmdup	4217224	4217234		murB	10
GRS004.A0101_rmdup	4221489	4221491		YPO_RS19860	2
GRS004.A0101_rmdup	4223143	4223148		YPO_RS19870	5
GRS004.A0101_rmdup	4226976	4226990		YPO_RS19900	14
GRS004.A0101_rmdup	4233890	4233906		ubiD	16
GRS004.A0101_rmdup	4236790	4236794		YPO_RS19940	4
GRS004.A0101_rmdup	4268313	4268321		YPO_RS20085	8
GRS004.A0101_rmdup	4269655	4269676		YPO_RS20095	21
GRS004.A0101_rmdup	4270104	4270116		YPO_RS20095	12
GRS004.A0101_rmdup	4281433	4281468		ftsY	35
GRS004.A0101_rmdup	4298042	4298057		pldB	15
GRS004.A0101_rmdup	4304852	4304856		rarD	4
GRS004.A0101_rmdup	4313636	4313637		xerC	1
GRS004.A0101_rmdup	4321405	4321410		hemX	5
GRS004.A0101_rmdup	4322998	4323021		hemY	23
GRS004.A0101_rmdup	4349644	4349679		YPO_RS20480	35
GRS004.A0101_rmdup	4354097	4354102		YPO_RS20500	5
GRS004.A0101_rmdup	4359333	4359369		YPO_RS20515	36
GRS004.A0101_rmdup	4359540	4359565		YPO_RS20515	25
GRS004.A0101_rmdup	4360225	4360270		YPO_RS20525	45
GRS004.A0101_rmdup	4365257	4365287		YPO_RS20550	30
GRS004.A0101_rmdup	4374386	4374389		YPO_RS20600	3
GRS004.A0101_rmdup	4376447	4376448		YPO_RS20610	1
GRS004.A0101_rmdup	4388485	4388487		YPO_RS20670	2
GRS004.A0101_rmdup	4389732	4389736		YPO_RS20670	4
GRS004.A0101_rmdup	4401545	4401546		YPO_RS20725	1
GRS004.A0101_rmdup	4405933	4405936		YPO_RS20745	3
GRS004.A0101_rmdup	4406440	4406442		YPO_RS20745	2
GRS004.A0101_rmdup	4408270	4408320		YPO_RS20745	50
GRS004.A0101_rmdup	4421869	4421872		glpD	3
GRS004.A0101_rmdup	4421969	4421976		glpD	7
GRS004.A0101_rmdup	4437160	4437161		YPO_RS20830	1
GRS004.A0101_rmdup	4462721	4462725		YPO_RS20940	4
GRS004.A0101_rmdup	4483592	4483674		YPO_RS21020	82
GRS004.A0101_rmdup	4483785	4483814		YPO_RS21020	29
GRS004.A0101_rmdup	4484188	4484209		YPO_RS21025	21
GRS004.A0101_rmdup	4484980	4485022		YPO_RS21030	42
GRS004.A0101_rmdup	4490297	4490311		yhjD	14
GRS004.A0101_rmdup	4527097	4527111		YPO_RS21185	14
GRS004.A0101_rmdup	4545365	4545400		YPO_RS21280	35
GRS004.A0101_rmdup	4545651	4545685		YPO_RS21280	34
GRS004.A0101_rmdup	4557412	4557413		YPO_RS21325	1
GRS004.A0101_rmdup	4558120	4558139		YPO_RS21330	19
GRS004.A0101_rmdup	4563888	4563891		YPO_RS21350	3
GRS004.A0101_rmdup	4565424	4565428		YPO_RS21355	4
GRS004.A0101_rmdup	4567733	4567784		YPO_RS21370	51
GRS004.A0101_rmdup	4601693	4601740		YPO_RS21520	47
GRS004.A0101_rmdup	4601892	4601911		YPO_RS21520	19
GRS004.A0101_rmdup	4608762	4608765		YPO_RS21555	3
GRS004.A0101_rmdup	4614241	4614249		gyrB	8
GRS004.A0101_rmdup	4624188	4624195		mnmE	7
GRS004.A0101_rmdup	4625906	4625915		YPO_RS21625	9
GRS004.A0101_rmdup	4634579	4634585		phoU	6
GRS004.A0101_rmdup	4652819	4652820		mnmG	1
GRS004.A0101_rmdup	4653550	4653554		mnmG	4
Gok2_libmerged	328	412		mioC	84
Gok2_libmerged	690	691		mioC	1
Gok2_libmerged	804	826		asnC	22
Gok2_libmerged	908	933		asnC	25
Gok2_libmerged	1435	1464		YPO_RS01015	29
Gok2_libmerged	1603	1679		YPO_RS01015	76
Gok2_libmerged	1763	1797		YPO_RS01015	34
Gok2_libmerged	1999	2001		YPO_RS01015	2
Gok2_libmerged	2272	2340		YPO_RS01015	68
Gok2_libmerged	2402	2427		YPO_RS01015	25
Gok2_libmerged	2589	2618		viaA	29
Gok2_libmerged	2752	2783		viaA	31
Gok2_libmerged	2885	2887		viaA	2
Gok2_libmerged	3165	3180		viaA	15
Gok2_libmerged	3920	3992		viaA	72
Gok2_libmerged	3996	4049		ravA	53
Gok2_libmerged	4102	4134		ravA	32
Gok2_libmerged	4321	4343		ravA	22
Gok2_libmerged	4420	4431		ravA	11
Gok2_libmerged	4546	4593		ravA	47
Gok2_libmerged	5546	5549		ravA	3
Gok2_libmerged	6079	6087		kup	8
Gok2_libmerged	6446	6449		kup	3
Gok2_libmerged	6770	6797		kup	27
Gok2_libmerged	7055	7083		kup	28
Gok2_libmerged	7139	7146		kup	7
Gok2_libmerged	7290	7328		kup	38
Gok2_libmerged	8184	8189		rbsD	5
Gok2_libmerged	8429	8498		rbsK	69
Gok2_libmerged	9140	9155		rbsK	15
Gok2_libmerged	9284	9286		rbsK	2
Gok2_libmerged	9624	9675		YPO_RS01055	51
Gok2_libmerged	9791	9929		YPO_RS01055	138
Gok2_libmerged	10236	10254		YPO_RS01055	18
Gok2_libmerged	10320	10333		YPO_RS01055	13
Gok2_libmerged	10427	10467		YPO_RS01055	40
Gok2_libmerged	10591	10634		YPO_RS01055	43
Gok2_libmerged	11045	11183		YPO_RS01060	138
Gok2_libmerged	11256	11276		YPO_RS01060	20
Gok2_libmerged	11601	11604		YPO_RS01060	3
Gok2_libmerged	11700	11705		YPO_RS01060	5
Gok2_libmerged	12178	12182		YPO_RS01065	4
Gok2_libmerged	14919	14925		YPO_RS01080	6
Gok2_libmerged	17100	17103		YPO_RS01080	3
Gok2_libmerged	18179	18210		YPO_RS01090	31
Gok2_libmerged	18916	18976		YPO_RS01090	60
Gok2_libmerged	19186	19188		mobB	2
Gok2_libmerged	19779	19924		mobA	145
Gok2_libmerged	20190	20241		mobA	51
Gok2_libmerged	20792	20868		YPO_RS01110	76
Gok2_libmerged	21052	21062		YPO_RS01110	10
Gok2_libmerged	21463	21470		YPO_RS01110	7
Gok2_libmerged	21806	21810		dsbA	4
Gok2_libmerged	22019	22030		dsbA	11
Gok2_libmerged	22134	22174		dsbA	40
Gok2_libmerged	22378	22429		dsbA	51
Gok2_libmerged	22964	22981		polA	17
Gok2_libmerged	23264	23377		polA	113
Gok2_libmerged	23565	23668		polA	103
Gok2_libmerged	24394	24409		polA	15
Gok2_libmerged	24681	24691		polA	10
Gok2_libmerged	24868	24896		polA	28
Gok2_libmerged	24945	24959		polA	14
Gok2_libmerged	25010	25021		polA	11
Gok2_libmerged	26184	26237		YPO_RS01125	53
Gok2_libmerged	26304	26362		YPO_RS01125	58
Gok2_libmerged	26517	26530		YPO_RS01125	13
Gok2_libmerged	27412	27488		YPO_RS01130	76
Gok2_libmerged	29150	29163		hemN	13
Gok2_libmerged	29332	29344		hemN	12
Gok2_libmerged	29951	29963		hemN	12
Gok2_libmerged	31830	31858		glnL	28
Gok2_libmerged	31934	31972		glnL	38
Gok2_libmerged	32074	32080		glnL	6
Gok2_libmerged	33525	33527		glnA	2
Gok2_libmerged	33615	33627		glnA	12
Gok2_libmerged	33821	33828		glnA	7
Gok2_libmerged	34031	34053		glnA	22
Gok2_libmerged	34112	34128		glnA	16
Gok2_libmerged	34478	34539		glnA	61
Gok2_libmerged	35214	35222		typA	8
Gok2_libmerged	35389	35396		typA	7
Gok2_libmerged	35596	35745		typA	149
Gok2_libmerged	36006	36020		typA	14
Gok2_libmerged	36671	36688		typA	17
Gok2_libmerged	36794	36799		typA	5
Gok2_libmerged	37316	37331		yihX	15
Gok2_libmerged	37520	37525		yihX	5
Gok2_libmerged	38203	38219		YPO_RS01170	16
Gok2_libmerged	38665	38704		YPO_RS01170	39
Gok2_libmerged	38943	38993		dtd	50
Gok2_libmerged	39236	39262		dtd	26
Gok2_libmerged	39647	39704		YPO_RS01180	57
Gok2_libmerged	39804	39833		YPO_RS01180	29
Gok2_libmerged	39934	39953		YPO_RS01180	19
Gok2_libmerged	40002	40016		YPO_RS01180	14
Gok2_libmerged	40412	40418		YPO_RS01185	6
Gok2_libmerged	40741	40767		YPO_RS01185	26
Gok2_libmerged	41109	41137		YPO_RS01185	28
Gok2_libmerged	41482	41495		fabY	13
Gok2_libmerged	41883	41890		fabY	7
Gok2_libmerged	42763	42777		YPO_RS01195	14
Gok2_libmerged	44038	44051		YPO_RS01195	13
Gok2_libmerged	44864	44873		YPO_RS01200	9
Gok2_libmerged	45125	45131		YPO_RS01200	6
Gok2_libmerged	45452	45496		YPO_RS01200	44
Gok2_libmerged	45945	45963		gltS	18
Gok2_libmerged	46114	46134		gltS	20
Gok2_libmerged	46284	46293		gltS	9
Gok2_libmerged	47525	47531		recG	6
Gok2_libmerged	48258	48296		recG	38
Gok2_libmerged	48499	48555		recG	56
Gok2_libmerged	48682	48716		recG	34
Gok2_libmerged	49259	49273		recG	14
Gok2_libmerged	49400	49450		recG	50
Gok2_libmerged	49699	49760		trmH	61
Gok2_libmerged	50001	50046		trmH	45
Gok2_libmerged	50078	50096		trmH	18
Gok2_libmerged	50743	50801		spoT	58
Gok2_libmerged	50865	50893		spoT	28
Gok2_libmerged	51368	51394		spoT	26
Gok2_libmerged	51806	51839		spoT	33
Gok2_libmerged	52303	52314		spoT	11
Gok2_libmerged	52501	52518		rpoZ	17
Gok2_libmerged	53099	53121		gmk	22
Gok2_libmerged	53787	53791		ligB	4
Gok2_libmerged	53932	53949		ligB	17
Gok2_libmerged	53980	53996		ligB	16
Gok2_libmerged	54086	54105		ligB	19
Gok2_libmerged	54301	54326		ligB	25
Gok2_libmerged	54549	54664		ligB	115
Gok2_libmerged	54745	54750		ligB	5
Gok2_libmerged	54895	54905		ligB	10
Gok2_libmerged	54987	54996		ligB	9
Gok2_libmerged	55170	55179		ligB	9
Gok2_libmerged	55349	55351		ligB	2
Gok2_libmerged	55700	55747		YPO_RS01245	47
Gok2_libmerged	56720	56753		YPO_RS01250	33
Gok2_libmerged	56881	56889		YPO_RS01250	8
Gok2_libmerged	56976	56980		YPO_RS01250	4
Gok2_libmerged	57141	57150		YPO_RS01250	9
Gok2_libmerged	57706	57711		rph	5
Gok2_libmerged	57873	57894		rph	21
Gok2_libmerged	58521	58539		pyrE	18
Gok2_libmerged	58762	58765		pyrE	3
Gok2_libmerged	59426	59472		slmA	46
Gok2_libmerged	59532	59608		slmA	76
Gok2_libmerged	60086	60102		dut	16
Gok2_libmerged	60342	60360		dut	18
Gok2_libmerged	60342	60405		coaBC	63
Gok2_libmerged	60486	60488		coaBC	2
Gok2_libmerged	60543	60555		coaBC	12
Gok2_libmerged	61037	61088		coaBC	51
Gok2_libmerged	61269	61304		coaBC	35
Gok2_libmerged	61413	61426		coaBC	13
Gok2_libmerged	61913	61970		YPO_RS01280	57
Gok2_libmerged	62865	62871		rpmB	6
Gok2_libmerged	63012	63075		rpmG	63
Gok2_libmerged	63241	63252		mutM	11
Gok2_libmerged	63591	63620		mutM	29
Gok2_libmerged	63843	63888		mutM	45
Gok2_libmerged	64026	64089		coaD	63
Gok2_libmerged	64172	64188		coaD	16
Gok2_libmerged	64606	64618		YPO_RS01310	12
Gok2_libmerged	64786	64840		YPO_RS01310	54
Gok2_libmerged	65627	65709		waaA	82
Gok2_libmerged	66102	66108		waaA	6
Gok2_libmerged	66949	66968		rfaC	19
Gok2_libmerged	67320	67321		rfaC	1
Gok2_libmerged	67610	67683		rfaC	73
Gok2_libmerged	67763	67781		rfaC	18
Gok2_libmerged	67898	67914		rfaC	16
Gok2_libmerged	67914	67919		rfaF	5
Gok2_libmerged	67985	68006		rfaF	21
Gok2_libmerged	68186	68196		rfaF	10
Gok2_libmerged	68380	68416		rfaF	36
Gok2_libmerged	69157	69220		rfaD	63
Gok2_libmerged	69667	69672		rfaD	5
Gok2_libmerged	69755	69760		rfaD	5
Gok2_libmerged	70192	70268		YPO_RS01335	76
Gok2_libmerged	70650	70693		YPO_RS01335	43
Gok2_libmerged	71545	71546		tdh	1
Gok2_libmerged	71862	71876		tdh	14
Gok2_libmerged	72161	72177		tdh	16
Gok2_libmerged	72244	72267		tdh	23
Gok2_libmerged	72301	72302		tdh	1
Gok2_libmerged	73685	73703		envC	18
Gok2_libmerged	74415	74419		envC	4
Gok2_libmerged	74635	74663		envC	28
Gok2_libmerged	74838	74855		envC	17
Gok2_libmerged	75549	75571		gpmM	22
Gok2_libmerged	76120	76179		gpmM	59
Gok2_libmerged	76281	76286		gpmM	5
Gok2_libmerged	76853	76878		YPO_RS01360	25
Gok2_libmerged	77545	77580		grxC	35
Gok2_libmerged	77742	77748		secB	6
Gok2_libmerged	77842	77881		secB	39
Gok2_libmerged	78108	78132		secB	24
Gok2_libmerged	78330	78352		gpsA	22
Gok2_libmerged	78952	78980		gpsA	28
Gok2_libmerged	79645	79661		cysE	16
Gok2_libmerged	79865	79866		cysE	1
Gok2_libmerged	79912	79933		cysE	21
Gok2_libmerged	80181	80182		cysE	1
Gok2_libmerged	80622	80644		trmL	22
Gok2_libmerged	80877	80880		trmL	3
Gok2_libmerged	81124	81133		ada	9
Gok2_libmerged	81196	81217		ada	21
Gok2_libmerged	81248	81254		ada	6
Gok2_libmerged	82044	82105		ada	61
Gok2_libmerged	81919	81961		ada	42
Gok2_libmerged	82455	82470		cpxA	15
Gok2_libmerged	84049	84169		cpxR	120
Gok2_libmerged	84849	84872		YPO_RS01405	23
Gok2_libmerged	85878	85887		YPO_RS01420	9
Gok2_libmerged	86169	86196		YPO_RS01420	27
Gok2_libmerged	87579	87717		fieF	138
Gok2_libmerged	88289	88292		pfkA	3
Gok2_libmerged	88397	88450		pfkA	53
Gok2_libmerged	88524	88601		pfkA	77
Gok2_libmerged	88648	88664		pfkA	16
Gok2_libmerged	88749	88809		pfkA	60
Gok2_libmerged	89144	89160		pfkA	16
Gok2_libmerged	89228	89251		pfkA	23
Gok2_libmerged	89515	89602		YPO_RS01435	87
Gok2_libmerged	90809	90838		YPO_RS01440	29
Gok2_libmerged	91291	91346		YPO_RS01440	55
Gok2_libmerged	91408	91413		YPO_RS01440	5
Gok2_libmerged	91495	91508		YPO_RS01440	13
Gok2_libmerged	91740	91744		YPO_RS01445	4
Gok2_libmerged	91823	91930		YPO_RS01445	107
Gok2_libmerged	92099	92190		YPO_RS01445	91
Gok2_libmerged	92280	92354		YPO_RS01445	74
Gok2_libmerged	92498	92528		YPO_RS01445	30
Gok2_libmerged	92773	92788		YPO_RS01445	15
Gok2_libmerged	92838	92846		YPO_RS01445	8
Gok2_libmerged	92984	93041		YPO_RS01445	57
Gok2_libmerged	93343	93372		ligK	29
Gok2_libmerged	93420	93422		ligK	2
Gok2_libmerged	93686	93698		ligK	12
Gok2_libmerged	93818	93825		ligK	7
Gok2_libmerged	93993	94086		YPO_RS01455	93
Gok2_libmerged	94454	94457		YPO_RS01455	3
Gok2_libmerged	94720	94760		YPO_RS01460	40
Gok2_libmerged	94924	94940		YPO_RS01460	16
Gok2_libmerged	94994	95003		YPO_RS01460	9
Gok2_libmerged	96306	96311		tpiA	5
Gok2_libmerged	96411	96415		tpiA	4
Gok2_libmerged	97113	97166		YPO_RS01470	53
Gok2_libmerged	97577	97579		YPO_RS01470	2
Gok2_libmerged	98145	98178		YPO_RS01475	33
Gok2_libmerged	99132	99136		fpr	4
Gok2_libmerged	99188	99211		fpr	23
Gok2_libmerged	101532	101554		YPO_RS01495	22
Gok2_libmerged	101813	101844		YPO_RS01495	31
Gok2_libmerged	102111	102158		YPO_RS01495	47
Gok2_libmerged	102222	102285		YPO_RS01495	63
Gok2_libmerged	103490	103524		YPO_RS01505	34
Gok2_libmerged	103720	103725		YPO_RS01505	5
Gok2_libmerged	103907	103913		YPO_RS01505	6
Gok2_libmerged	106274	106288		YPO_RS01515	14
Gok2_libmerged	106411	106424		YPO_RS01515	13
Gok2_libmerged	106424	106460		YPO_RS01520	36
Gok2_libmerged	106739	106771		YPO_RS01520	32
Gok2_libmerged	106900	106918		YPO_RS01520	18
Gok2_libmerged	107033	107055		YPO_RS01520	22
Gok2_libmerged	107149	107176		YPO_RS01520	27
Gok2_libmerged	108447	108477		YPO_RS01530	30
Gok2_libmerged	108924	109004		YPO_RS01530	80
Gok2_libmerged	109369	109442		YPO_RS01530	73
Gok2_libmerged	109986	109991		YPO_RS01535	5
Gok2_libmerged	110088	110102		YPO_RS01535	14
Gok2_libmerged	111766	111833		rraA	67
Gok2_libmerged	111890	111896		rraA	6
Gok2_libmerged	112128	112130		YPO_RS01550	2
Gok2_libmerged	112193	112196		YPO_RS01550	3
Gok2_libmerged	112337	112427		YPO_RS01550	90
Gok2_libmerged	112792	112813		YPO_RS01550	21
Gok2_libmerged	113413	113429		hslU	16
Gok2_libmerged	113766	113864		hslU	98
Gok2_libmerged	114039	114056		hslU	17
Gok2_libmerged	114364	114381		hslU	17
Gok2_libmerged	114494	114544		hslU	50
Gok2_libmerged	114615	114659		hslV	44
Gok2_libmerged	114943	114960		hslV	17
Gok2_libmerged	115049	115078		hslV	29
Gok2_libmerged	116423	116431		cytR	8
Gok2_libmerged	116519	116544		cytR	25
Gok2_libmerged	116658	116670		cytR	12
Gok2_libmerged	116955	116994		cytR	39
Gok2_libmerged	117130	117178		cytR	48
Gok2_libmerged	117581	117590		priA	9
Gok2_libmerged	117732	117753		priA	21
Gok2_libmerged	117835	117847		priA	12
Gok2_libmerged	118119	118188		priA	69
Gok2_libmerged	118398	118421		priA	23
Gok2_libmerged	118600	118603		priA	3
Gok2_libmerged	118667	118672		priA	5
Gok2_libmerged	119452	119500		priA	48
Gok2_libmerged	119536	119543		priA	7
Gok2_libmerged	119623	119650		priA	27
Gok2_libmerged	119723	119729		priA	6
Gok2_libmerged	119972	119975		rpmE	3
Gok2_libmerged	120063	120105		rpmE	42
Gok2_libmerged	120766	120792		YPO_RS01585	26
Gok2_libmerged	120916	120975		YPO_RS01585	59
Gok2_libmerged	121571	121649		metJ	78
Gok2_libmerged	123503	123516		YPO_RS01600	13
Gok2_libmerged	123990	123996		YPO_RS01600	6
Gok2_libmerged	124135	124159		YPO_RS01600	24
Gok2_libmerged	124245	124264		YPO_RS01600	19
Gok2_libmerged	125525	125529		YPO_RS01600	4
Gok2_libmerged	125773	125835		YPO_RS01600	62
Gok2_libmerged	126136	126138		metF	2
Gok2_libmerged	126473	126474		metF	1
Gok2_libmerged	126610	126665		metF	55
Gok2_libmerged	127209	127236		YPO_RS01610	27
Gok2_libmerged	127298	127377		YPO_RS01610	79
Gok2_libmerged	127440	127478		YPO_RS01610	38
Gok2_libmerged	127606	127659		YPO_RS01610	53
Gok2_libmerged	127814	127817		YPO_RS01610	3
Gok2_libmerged	128148	128152		YPO_RS01610	4
Gok2_libmerged	128772	128784		YPO_RS01615	12
Gok2_libmerged	128901	128925		YPO_RS01615	24
Gok2_libmerged	129143	129202		YPO_RS01615	59
Gok2_libmerged	129406	129407		YPO_RS01615	1
Gok2_libmerged	129938	129952		glpG	14
Gok2_libmerged	130010	130021		glpG	11
Gok2_libmerged	131725	131732		malT	7
Gok2_libmerged	132043	132100		malT	57
Gok2_libmerged	132231	132258		malT	27
Gok2_libmerged	132724	132731		malT	7
Gok2_libmerged	132775	132777		malT	2
Gok2_libmerged	133173	133186		malT	13
Gok2_libmerged	133372	133422		malT	50
Gok2_libmerged	133540	133554		malT	14
Gok2_libmerged	134961	134987		malP	26
Gok2_libmerged	135110	135112		malP	2
Gok2_libmerged	135383	135400		malP	17
Gok2_libmerged	135579	135596		malP	17
Gok2_libmerged	135693	135708		malP	15
Gok2_libmerged	135742	135756		malP	14
Gok2_libmerged	135853	135869		malP	16
Gok2_libmerged	136711	136713		malQ	2
Gok2_libmerged	136833	136850		malQ	17
Gok2_libmerged	136979	136997		malQ	18
Gok2_libmerged	137079	137083		malQ	4
Gok2_libmerged	137183	137207		malQ	24
Gok2_libmerged	137307	137360		malQ	53
Gok2_libmerged	138003	138013		malQ	10
Gok2_libmerged	138561	138564		malQ	3
Gok2_libmerged	139369	139438		nfuA	69
Gok2_libmerged	140028	140064		gntX	36
Gok2_libmerged	140377	140418		bioH	41
Gok2_libmerged	140654	140661		bioH	7
Gok2_libmerged	140932	140961		bioH	29
Gok2_libmerged	141084	141107		bioH	23
Gok2_libmerged	141461	141493		YPO_RS01665	32
Gok2_libmerged	141684	141690		YPO_RS01670	6
Gok2_libmerged	142089	142098		feoB	9
Gok2_libmerged	142488	142575		feoB	87
Gok2_libmerged	142772	142790		feoB	18
Gok2_libmerged	143194	143220		feoB	26
Gok2_libmerged	143291	143298		feoB	7
Gok2_libmerged	143441	143448		feoB	7
Gok2_libmerged	143524	143550		feoB	26
Gok2_libmerged	143622	143633		feoB	11
Gok2_libmerged	143847	143883		feoB	36
Gok2_libmerged	144575	144611		feoA	36
Gok2_libmerged	146015	146029		YPO_RS01685	14
Gok2_libmerged	146081	146089		YPO_RS01685	8
Gok2_libmerged	146316	146319		YPO_RS01685	3
Gok2_libmerged	146809	146836		YPO_RS01685	27
Gok2_libmerged	148490	148559		greB	69
Gok2_libmerged	149037	149088		ompR	51
Gok2_libmerged	149915	149927		envZ	12
Gok2_libmerged	150489	150539		envZ	50
Gok2_libmerged	151494	151525		pckA	31
Gok2_libmerged	151844	151869		pckA	25
Gok2_libmerged	152328	152364		pckA	36
Gok2_libmerged	152443	152446		pckA	3
Gok2_libmerged	152916	152978		hslO	62
Gok2_libmerged	153380	153435		hslO	55
Gok2_libmerged	153502	153508		hslO	6
Gok2_libmerged	153758	153815		hslR	57
Gok2_libmerged	155453	155472		YPO_RS01725	19
Gok2_libmerged	155691	155693		YPO_RS01725	2
Gok2_libmerged	155836	155859		YPO_RS01725	23
Gok2_libmerged	155954	155968		YPO_RS01725	14
Gok2_libmerged	156172	156297		YPO_RS01725	125
Gok2_libmerged	156848	156901		YPO_RS01725	53
Gok2_libmerged	157929	157994		nudE	65
Gok2_libmerged	158111	158153		nudE	42
Gok2_libmerged	158433	158502		mrcA	69
Gok2_libmerged	158565	158572		mrcA	7
Gok2_libmerged	158894	158907		mrcA	13
Gok2_libmerged	159065	159076		mrcA	11
Gok2_libmerged	159234	159242		mrcA	8
Gok2_libmerged	159639	159683		mrcA	44
Gok2_libmerged	159895	159925		mrcA	30
Gok2_libmerged	160068	160084		mrcA	16
Gok2_libmerged	160148	160161		mrcA	13
Gok2_libmerged	160471	160511		mrcA	40
Gok2_libmerged	160564	160582		mrcA	18
Gok2_libmerged	161108	161119		YPO_RS01740	11
Gok2_libmerged	161915	161982		YPO_RS01740	67
Gok2_libmerged	162133	162146		YPO_RS01745	13
Gok2_libmerged	162943	162957		YPO_RS01750	14
Gok2_libmerged	163145	163161		YPO_RS01750	16
Gok2_libmerged	163321	163348		YPO_RS01755	27
Gok2_libmerged	163666	163683		hofQ	17
Gok2_libmerged	163717	163756		hofQ	39
Gok2_libmerged	164406	164415		hofQ	9
Gok2_libmerged	163792	163944		hofQ	152
Gok2_libmerged	165900	165903		aroK	3
Gok2_libmerged	166145	166148		aroB	3
Gok2_libmerged	166263	166276		aroB	13
Gok2_libmerged	166347	166348		aroB	1
Gok2_libmerged	167012	167039		aroB	27
Gok2_libmerged	167119	167143		aroB	24
Gok2_libmerged	167437	167456		YPO_RS01775	19
Gok2_libmerged	167506	167545		YPO_RS01775	39
Gok2_libmerged	167585	167609		YPO_RS01775	24
Gok2_libmerged	167853	167867		YPO_RS01775	14
Gok2_libmerged	168221	168270		YPO_RS01775	49
Gok2_libmerged	168384	168386		YPO_RS01775	2
Gok2_libmerged	168501	168510		dam	9
Gok2_libmerged	168623	168679		dam	56
Gok2_libmerged	169230	169232		dam	2
Gok2_libmerged	169588	169616		rpe	28
Gok2_libmerged	169670	169672		rpe	2
Gok2_libmerged	169958	169960		rpe	2
Gok2_libmerged	170081	170112		rpe	31
Gok2_libmerged	170271	170283		YPO_RS01790	12
Gok2_libmerged	171388	171422		trpS	34
Gok2_libmerged	171717	171727		trpS	10
Gok2_libmerged	172201	172236		cobA	35
Gok2_libmerged	172518	172576		cobA	58
Gok2_libmerged	172824	172922		cobA	98
Gok2_libmerged	173113	173239		cobA	126
Gok2_libmerged	173748	173769		nirC	21
Gok2_libmerged	174132	174162		nirC	30
Gok2_libmerged	174684	174711		nirD	27
Gok2_libmerged	174874	174879		nirD	5
Gok2_libmerged	174973	174982		nirD	9
Gok2_libmerged	175299	175300		YPO_RS01815	1
Gok2_libmerged	175542	175546		YPO_RS01815	4
Gok2_libmerged	175753	175783		YPO_RS01815	30
Gok2_libmerged	175978	175982		YPO_RS01815	4
Gok2_libmerged	176092	176098		YPO_RS01815	6
Gok2_libmerged	176204	176241		YPO_RS01815	37
Gok2_libmerged	176734	176742		YPO_RS01815	8
Gok2_libmerged	176991	176995		YPO_RS01815	4
Gok2_libmerged	178737	178771		YPO_RS01820	34
Gok2_libmerged	178880	178917		YPO_RS01820	37
Gok2_libmerged	179290	179292		tsgA	2
Gok2_libmerged	179477	179483		tsgA	6
Gok2_libmerged	179854	179892		tsgA	38
Gok2_libmerged	180028	180036		tsgA	8
Gok2_libmerged	180122	180134		tsgA	12
Gok2_libmerged	180410	180420		tsgA	10
Gok2_libmerged	180183	180274		tsgA	91
Gok2_libmerged	181217	181269		YPO_RS01830	52
Gok2_libmerged	181605	181633		YPO_RS01830	28
Gok2_libmerged	181815	181871		YPO_RS01830	56
Gok2_libmerged	182058	182106		YPO_RS01830	48
Gok2_libmerged	182188	182215		YPO_RS01830	27
Gok2_libmerged	182403	182427		YPO_RS01830	24
Gok2_libmerged	183131	183164		YPO_RS01835	33
Gok2_libmerged	183521	183623		YPO_RS01835	102
Gok2_libmerged	183953	183982		YPO_RS01835	29
Gok2_libmerged	184866	184870		YPO_RS01840	4
Gok2_libmerged	185058	185116		YPO_RS01840	58
Gok2_libmerged	185178	185278		YPO_RS01840	100
Gok2_libmerged	185545	185596		YPO_RS01840	51
Gok2_libmerged	186392	186426		ppiA	34
Gok2_libmerged	186472	186530		ppiA	58
Gok2_libmerged	187140	187197		YPO_RS01850	57
Gok2_libmerged	187540	187586		YPO_RS01850	46
Gok2_libmerged	188046	188053		YPO_RS01850	7
Gok2_libmerged	188131	188175		YPO_RS01850	44
Gok2_libmerged	188355	188373		YPO_RS01850	18
Gok2_libmerged	190392	190414		YPO_RS01865	22
Gok2_libmerged	190470	190491		YPO_RS01865	21
Gok2_libmerged	190601	190611		YPO_RS01865	10
Gok2_libmerged	191008	191028		YPO_RS01865	20
Gok2_libmerged	191294	191358		YPO_RS01870	64
Gok2_libmerged	191395	191408		YPO_RS01870	13
Gok2_libmerged	191549	191551		YPO_RS01870	2
Gok2_libmerged	191820	191856		YPO_RS01870	36
Gok2_libmerged	193292	193295		YPO_RS01880	3
Gok2_libmerged	193578	193582		YPO_RS01880	4
Gok2_libmerged	193628	193667		YPO_RS01880	39
Gok2_libmerged	193704	193711		YPO_RS01880	7
Gok2_libmerged	194077	194082		YPO_RS01880	5
Gok2_libmerged	194172	194191		YPO_RS01880	19
Gok2_libmerged	194564	194634		YPO_RS01880	70
Gok2_libmerged	195005	195025		YPO_RS01880	20
Gok2_libmerged	195144	195190		crp	46
Gok2_libmerged	195700	195701		crp	1
Gok2_libmerged	196190	196253		YPO_RS01890	63
Gok2_libmerged	196580	196587		YPO_RS01895	7
Gok2_libmerged	196687	196820		YPO_RS01895	133
Gok2_libmerged	196919	196980		YPO_RS01895	61
Gok2_libmerged	197504	197522		YPO_RS01900	18
Gok2_libmerged	197573	197656		YPO_RS01900	83
Gok2_libmerged	197749	197771		YPO_RS01900	22
Gok2_libmerged	197960	197964		YPO_RS01900	4
Gok2_libmerged	198384	198430		YPO_RS01905	46
Gok2_libmerged	198952	198956		YPO_RS01910	4
Gok2_libmerged	199576	199600		YPO_RS01915	24
Gok2_libmerged	199697	199698		YPO_RS01915	1
Gok2_libmerged	199790	199799		YPO_RS01915	9
Gok2_libmerged	199847	199869		YPO_RS01915	22
Gok2_libmerged	200834	200859		tauA	25
Gok2_libmerged	200918	200943		tauA	25
Gok2_libmerged	201609	201625		tauB	16
Gok2_libmerged	201783	201790		tauB	7
Gok2_libmerged	202275	202296		tauC	21
Gok2_libmerged	202520	202525		tauC	5
Gok2_libmerged	203047	203065		tauD	18
Gok2_libmerged	203883	203943		YPO_RS01940	60
Gok2_libmerged	204153	204177		YPO_RS01940	24
Gok2_libmerged	204314	204351		YPO_RS01940	37
Gok2_libmerged	205285	205362		YPO_RS01945	77
Gok2_libmerged	205450	205472		YPO_RS01945	22
Gok2_libmerged	205574	205629		YPO_RS01945	55
Gok2_libmerged	205909	205928		YPO_RS01945	19
Gok2_libmerged	208334	208425		kefG	91
Gok2_libmerged	209424	209446		kefB	22
Gok2_libmerged	210095	210107		kefB	12
Gok2_libmerged	210541	210592		kefB	51
Gok2_libmerged	210608	210641		YPO_RS01965	33
Gok2_libmerged	210963	211016		slyD	53
Gok2_libmerged	211474	211484		slyD	10
Gok2_libmerged	211732	211743		YPO_RS01975	11
Gok2_libmerged	211842	211871		YPO_RS01975	29
Gok2_libmerged	212387	212403		fkpA	16
Gok2_libmerged	212574	212594		fkpA	20
Gok2_libmerged	213319	213354		YPO_RS01985	35
Gok2_libmerged	213581	213601		YPO_RS01985	20
Gok2_libmerged	213713	213743		YPO_RS01985	30
Gok2_libmerged	213845	213994		YPO_RS01985	149
Gok2_libmerged	214061	214070		tusD	9
Gok2_libmerged	214477	214511		tusC	34
Gok2_libmerged	214970	214991		tusB	21
Gok2_libmerged	215079	215108		tusB	29
Gok2_libmerged	217794	217872		fusA	78
Gok2_libmerged	218338	218341		fusA	3
Gok2_libmerged	218462	218490		tuf	28
Gok2_libmerged	218649	218661		tuf	12
Gok2_libmerged	219473	219484		tuf	11
Gok2_libmerged	219984	219999		YPO_RS02025	15
Gok2_libmerged	220251	220302		YPO_RS02025	51
Gok2_libmerged	220495	220507		bfd	12
Gok2_libmerged	220868	220909		bfr	41
Gok2_libmerged	220965	220973		bfr	8
Gok2_libmerged	221190	221234		bfr	44
Gok2_libmerged	222148	222160		rplC	12
Gok2_libmerged	222878	222882		rplD	4
Gok2_libmerged	223415	223421		rplW	6
Gok2_libmerged	223642	223679		rplB	37
Gok2_libmerged	224228	224234		rplB	6
Gok2_libmerged	224354	224390		rplB	36
Gok2_libmerged	224405	224415		rpsS	10
Gok2_libmerged	225936	225981		rplP	45
Gok2_libmerged	227017	227039		rplN	22
Gok2_libmerged	227260	227288		rplX	28
Gok2_libmerged	227453	227491		rplX	38
Gok2_libmerged	227506	227553		rplE	47
Gok2_libmerged	227623	227629		rplE	6
Gok2_libmerged	227927	227980		rplE	53
Gok2_libmerged	228078	228084		rpsN	6
Gok2_libmerged	228572	228588		rpsH	16
Gok2_libmerged	228893	228913		rplF	20
Gok2_libmerged	229493	229508		rplR	15
Gok2_libmerged	229544	229558		rplR	14
Gok2_libmerged	229628	229629		rplR	1
Gok2_libmerged	229975	229978		rpsE	3
Gok2_libmerged	230405	230445		rplO	40
Gok2_libmerged	231009	231029		secY	20
Gok2_libmerged	231360	231388		secY	28
Gok2_libmerged	231458	231466		secY	8
Gok2_libmerged	231544	231563		secY	19
Gok2_libmerged	231921	231975		secY	54
Gok2_libmerged	232050	232057		secY	7
Gok2_libmerged	232849	232871		rpsK	22
Gok2_libmerged	232959	233008		rpsK	49
Gok2_libmerged	233456	233462		rpsD	6
Gok2_libmerged	233602	233641		rpsD	39
Gok2_libmerged	233877	233881		rpsD	4
Gok2_libmerged	234305	234316		rpoA	11
Gok2_libmerged	235311	235316		rplQ	5
Gok2_libmerged	236311	236406		YPO_RS02185	95
Gok2_libmerged	236618	236669		mscL	51
Gok2_libmerged	236752	236882		mscL	130
Gok2_libmerged	236961	237017		mscL	56
Gok2_libmerged	237156	237159		trkA	3
Gok2_libmerged	237239	237285		trkA	46
Gok2_libmerged	237441	237453		trkA	12
Gok2_libmerged	237561	237562		trkA	1
Gok2_libmerged	238007	238013		trkA	6
Gok2_libmerged	238228	238250		trkA	22
Gok2_libmerged	238384	238390		trkA	6
Gok2_libmerged	238885	238961		rsmB	76
Gok2_libmerged	238999	239029		rsmB	30
Gok2_libmerged	239487	239555		rsmB	68
Gok2_libmerged	239850	239877		rsmB	27
Gok2_libmerged	240527	240528		fmt	1
Gok2_libmerged	240616	240802		fmt	186
Gok2_libmerged	241036	241066		def	30
Gok2_libmerged	241259	241266		def	7
Gok2_libmerged	241334	241363		def	29
Gok2_libmerged	241452	241455		def	3
Gok2_libmerged	241610	241631		dprA	21
Gok2_libmerged	241681	241684		dprA	3
Gok2_libmerged	241779	241801		dprA	22
Gok2_libmerged	241931	241936		dprA	5
Gok2_libmerged	242343	242396		dprA	53
Gok2_libmerged	242537	242550		dprA	13
Gok2_libmerged	243272	243328		YPO_RS02225	56
Gok2_libmerged	243484	243547		YPO_RS02225	63
Gok2_libmerged	243612	243626		YPO_RS02225	14
Gok2_libmerged	243716	243736		YPO_RS02225	20
Gok2_libmerged	243738	243752		tsaC	14
Gok2_libmerged	244113	244126		tsaC	13
Gok2_libmerged	244242	244248		tsaC	6
Gok2_libmerged	244332	244396		aroE	64
Gok2_libmerged	244750	244764		aroE	14
Gok2_libmerged	244805	244823		aroE	18
Gok2_libmerged	244935	244976		aroE	41
Gok2_libmerged	245314	245429		YPO_RS02240	115
Gok2_libmerged	245536	245572		YPO_RS02240	36
Gok2_libmerged	245631	245680		YPO_RS02240	49
Gok2_libmerged	246348	246428		YPO_RS02245	80
Gok2_libmerged	246586	246643		YPO_RS02250	57
Gok2_libmerged	247205	247252		YPO_RS02250	47
Gok2_libmerged	247416	247446		YPO_RS02250	30
Gok2_libmerged	247558	247593		YPO_RS02250	35
Gok2_libmerged	247893	247906		YPO_RS02255	13
Gok2_libmerged	248067	248078		YPO_RS02255	11
Gok2_libmerged	248294	248299		YPO_RS02255	5
Gok2_libmerged	248616	248617		YPO_RS02255	1
Gok2_libmerged	248832	248948		actP	116
Gok2_libmerged	249407	249494		actP	87
Gok2_libmerged	250004	250019		actP	15
Gok2_libmerged	250200	250204		actP	4
Gok2_libmerged	250331	250364		actP	33
Gok2_libmerged	250750	250756		acs	6
Gok2_libmerged	251627	251644		acs	17
Gok2_libmerged	251885	251889		acs	4
Gok2_libmerged	251927	251938		acs	11
Gok2_libmerged	252307	252315		acs	8
Gok2_libmerged	252675	252690		acs	15
Gok2_libmerged	253545	253568		gltP	23
Gok2_libmerged	253622	253667		gltP	45
Gok2_libmerged	253704	253741		gltP	37
Gok2_libmerged	253934	253944		gltP	10
Gok2_libmerged	254035	254149		gltP	114
Gok2_libmerged	254397	254418		gltP	21
Gok2_libmerged	254475	254478		gltP	3
Gok2_libmerged	254788	254799		gltP	11
Gok2_libmerged	255101	255117		YPO_RS02280	16
Gok2_libmerged	255184	255189		YPO_RS02280	5
Gok2_libmerged	255483	255559		YPO_RS02280	76
Gok2_libmerged	255760	255769		YPO_RS02285	9
Gok2_libmerged	255853	255854		YPO_RS02285	1
Gok2_libmerged	256578	256582		YPO_RS02285	4
Gok2_libmerged	256806	256827		YPO_RS02285	21
Gok2_libmerged	256905	256932		YPO_RS02285	27
Gok2_libmerged	257188	257209		YPO_RS02285	21
Gok2_libmerged	257388	257391		YPO_RS02285	3
Gok2_libmerged	257652	257713		YPO_RS02285	61
Gok2_libmerged	257811	257845		YPO_RS02285	34
Gok2_libmerged	257921	258007		YPO_RS02285	86
Gok2_libmerged	258093	258120		YPO_RS02285	27
Gok2_libmerged	258190	258233		YPO_RS02285	43
Gok2_libmerged	258387	258488		YPO_RS02285	101
Gok2_libmerged	258747	258800		YPO_RS02290	53
Gok2_libmerged	258875	258891		YPO_RS02290	16
Gok2_libmerged	258972	258977		YPO_RS02290	5
Gok2_libmerged	259161	259178		YPO_RS02290	17
Gok2_libmerged	259495	259510		YPO_RS02290	15
Gok2_libmerged	259750	259757		YPO_RS02290	7
Gok2_libmerged	259817	259829		YPO_RS02290	12
Gok2_libmerged	260223	260239		YPO_RS02290	16
Gok2_libmerged	260587	260608		sctD	21
Gok2_libmerged	260845	260863		sctD	18
Gok2_libmerged	260967	260976		sctD	9
Gok2_libmerged	262524	262562		sctF	38
Gok2_libmerged	262756	262774		YPO_RS02315	18
Gok2_libmerged	263214	263250		sctI	36
Gok2_libmerged	263414	263415		YPO_RS02325	1
Gok2_libmerged	263675	263723		YPO_RS02325	48
Gok2_libmerged	263933	263949		YPO_RS02325	16
Gok2_libmerged	264005	264043		YPO_RS02325	38
Gok2_libmerged	264360	264373		YPO_RS02330	13
Gok2_libmerged	264684	264730		YPO_RS02330	46
Gok2_libmerged	264862	264885		sctL	23
Gok2_libmerged	265140	265177		sctL	37
Gok2_libmerged	265696	265712		YPO_RS02340	16
Gok2_libmerged	265916	265930		YPO_RS02340	14
Gok2_libmerged	266195	266237		YPO_RS02340	42
Gok2_libmerged	266473	266489		YPO_RS02340	16
Gok2_libmerged	266559	266684		YPO_RS02340	125
Gok2_libmerged	266748	266750		YPO_RS02340	2
Gok2_libmerged	266987	267008		YPO_RS02340	21
Gok2_libmerged	267071	267072		YPO_RS02340	1
Gok2_libmerged	267311	267318		YPO_RS02340	7
Gok2_libmerged	267394	267430		YPO_RS02340	36
Gok2_libmerged	267510	267513		YPO_RS02345	3
Gok2_libmerged	267614	267631		YPO_RS02345	17
Gok2_libmerged	267713	267715		YPO_RS02345	2
Gok2_libmerged	267853	267856		YPO_RS02345	3
Gok2_libmerged	268312	268325		YPO_RS02345	13
Gok2_libmerged	269065	269073		YPO_RS02350	8
Gok2_libmerged	269431	269443		YPO_RS02355	12
Gok2_libmerged	269635	269698		YPO_RS02360	63
Gok2_libmerged	269765	269783		YPO_RS02360	18
Gok2_libmerged	270159	270213		YPO_RS02360	54
Gok2_libmerged	270252	270266		YPO_RS02360	14
Gok2_libmerged	270664	270680		sctR	16
Gok2_libmerged	270721	270772		sctR	51
Gok2_libmerged	271518	271542		YPO_RS02370	24
Gok2_libmerged	271909	272002		sctT	93
Gok2_libmerged	272455	272498		YPO_RS02380	43
Gok2_libmerged	274230	274260		yedE	30
Gok2_libmerged	274705	274765		yedE	60
Gok2_libmerged	275071	275077		yedF	6
Gok2_libmerged	275430	275621		YPO_RS02395	191
Gok2_libmerged	275902	276007		YPO_RS02395	105
Gok2_libmerged	276055	276086		YPO_RS02395	31
Gok2_libmerged	276278	276381		YPO_RS02395	103
Gok2_libmerged	276605	276867		YPO_RS02400	262
Gok2_libmerged	276941	276978		YPO_RS02400	37
Gok2_libmerged	277008	277112		YPO_RS02400	104
Gok2_libmerged	277163	277228		YPO_RS02400	65
Gok2_libmerged	277291	277295		YPO_RS02400	4
Gok2_libmerged	277459	277548		YPO_RS02400	89
Gok2_libmerged	277701	277793		YPO_RS02400	92
Gok2_libmerged	277828	277837		YPO_RS02400	9
Gok2_libmerged	277883	277905		metC	22
Gok2_libmerged	278067	278086		metC	19
Gok2_libmerged	278207	278235		metC	28
Gok2_libmerged	278294	278303		metC	9
Gok2_libmerged	278874	278910		metC	36
Gok2_libmerged	279042	279062		metC	20
Gok2_libmerged	278506	278568		metC	62
Gok2_libmerged	279954	279961		YPO_RS02410	7
Gok2_libmerged	280188	280242		YPO_RS02415	54
Gok2_libmerged	280407	280414		YPO_RS02415	7
Gok2_libmerged	280509	280550		YPO_RS02415	41
Gok2_libmerged	280676	280700		YPO_RS02415	24
Gok2_libmerged	280989	281002		YPO_RS02415	13
Gok2_libmerged	280999	281032		YPO_RS02420	33
Gok2_libmerged	281075	281128		YPO_RS02420	53
Gok2_libmerged	281318	281355		YPO_RS02420	37
Gok2_libmerged	282071	282080		YPO_RS02425	9
Gok2_libmerged	282169	282174		YPO_RS02425	5
Gok2_libmerged	282371	282378		YPO_RS02425	7
Gok2_libmerged	282450	282468		YPO_RS02425	18
Gok2_libmerged	282714	282717		YPO_RS02425	3
Gok2_libmerged	282813	282821		YPO_RS02425	8
Gok2_libmerged	283069	283097		YPO_RS02430	28
Gok2_libmerged	283447	283458		YPO_RS02430	11
Gok2_libmerged	283796	283804		YPO_RS02430	8
Gok2_libmerged	284227	284256		YPO_RS02430	29
Gok2_libmerged	284303	284356		YPO_RS02430	53
Gok2_libmerged	284628	284630		YPO_RS02430	2
Gok2_libmerged	284907	284958		YPO_RS02430	51
Gok2_libmerged	285436	285454		YPO_RS02440	18
Gok2_libmerged	285548	285561		YPO_RS02440	13
Gok2_libmerged	285802	285821		YPO_RS02440	19
Gok2_libmerged	285896	285924		YPO_RS02440	28
Gok2_libmerged	286245	286271		hutX	26
Gok2_libmerged	286433	286506		hutX	73
Gok2_libmerged	286843	286847		YPO_RS02450	4
Gok2_libmerged	286997	287007		YPO_RS02450	10
Gok2_libmerged	287227	287230		YPO_RS02450	3
Gok2_libmerged	287347	287358		YPO_RS02450	11
Gok2_libmerged	287489	287494		YPO_RS02450	5
Gok2_libmerged	287814	287862		YPO_RS02450	48
Gok2_libmerged	287938	287975		YPO_RS02450	37
Gok2_libmerged	288485	288500		YPO_RS02455	15
Gok2_libmerged	288759	288774		YPO_RS02455	15
Gok2_libmerged	288858	289116		YPO_RS02455	258
Gok2_libmerged	289484	289512		YPO_RS02460	28
Gok2_libmerged	290938	291023		YPO_RS02465	85
Gok2_libmerged	291294	291306		YPO_RS02470	12
Gok2_libmerged	291723	291727		YPO_RS02470	4
Gok2_libmerged	291993	291997		YPO_RS02470	4
Gok2_libmerged	293003	293028		YPO_RS02475	25
Gok2_libmerged	293094	293159		YPO_RS02475	65
Gok2_libmerged	293152	293164		YPO_RS02480	12
Gok2_libmerged	293284	293294		YPO_RS02480	10
Gok2_libmerged	293854	293878		YPO_RS02480	24
Gok2_libmerged	294273	294278		YPO_RS02480	5
Gok2_libmerged	294988	295001		YPO_RS02485	13
Gok2_libmerged	295326	295361		YPO_RS02485	35
Gok2_libmerged	295927	295931		YPO_RS02490	4
Gok2_libmerged	296950	296953		YPO_RS02495	3
Gok2_libmerged	297199	297218		YPO_RS02495	19
Gok2_libmerged	297318	297333		YPO_RS02495	15
Gok2_libmerged	297493	297497		YPO_RS02500	4
Gok2_libmerged	297854	297902		YPO_RS02500	48
Gok2_libmerged	297924	297936		YPO_RS02505	12
Gok2_libmerged	299025	299031		YPO_RS02510	6
Gok2_libmerged	299157	299182		YPO_RS02510	25
Gok2_libmerged	299218	299236		YPO_RS02510	18
Gok2_libmerged	299937	299996		YPO_RS02515	59
Gok2_libmerged	300127	300162		YPO_RS02515	35
Gok2_libmerged	300577	300586		YPO_RS02520	9
Gok2_libmerged	300914	300936		YPO_RS02520	22
Gok2_libmerged	302194	302202		YPO_RS02525	8
Gok2_libmerged	302358	302424		YPO_RS02525	66
Gok2_libmerged	302675	302737		YPO_RS02530	62
Gok2_libmerged	303197	303209		YPO_RS02530	12
Gok2_libmerged	303826	303842		YPO_RS02530	16
Gok2_libmerged	303890	303910		YPO_RS02530	20
Gok2_libmerged	304041	304130		YPO_RS02530	89
Gok2_libmerged	304317	304341		YPO_RS02530	24
Gok2_libmerged	304676	304712		YPO_RS02530	36
Gok2_libmerged	304821	304856		YPO_RS02530	35
Gok2_libmerged	305125	305244		YPO_RS02535	119
Gok2_libmerged	305712	305757		YPO_RS02535	45
Gok2_libmerged	305921	305925		YPO_RS02540	4
Gok2_libmerged	305973	306008		YPO_RS02540	35
Gok2_libmerged	307326	307353		YPO_RS02550	27
Gok2_libmerged	307611	307642		YPO_RS02550	31
Gok2_libmerged	307773	307782		YPO_RS02550	9
Gok2_libmerged	307884	307927		YPO_RS02550	43
Gok2_libmerged	308211	308215		YPO_RS02550	4
Gok2_libmerged	308563	308645		YPO_RS02550	82
Gok2_libmerged	309654	309697		YPO_RS02555	43
Gok2_libmerged	310022	310121		YPO_RS02555	99
Gok2_libmerged	311056	311173		YPO_RS02555	117
Gok2_libmerged	311337	311344		YPO_RS02555	7
Gok2_libmerged	312253	312325		yapK	72
Gok2_libmerged	312665	312668		yapK	3
Gok2_libmerged	312698	312724		yapK	26
Gok2_libmerged	312948	312952		yapK	4
Gok2_libmerged	313430	313455		yapK	25
Gok2_libmerged	313826	313840		yapK	14
Gok2_libmerged	314284	314299		yapK	15
Gok2_libmerged	314378	314388		yapK	10
Gok2_libmerged	314668	314764		yapK	96
Gok2_libmerged	315077	315089		yapK	12
Gok2_libmerged	315338	315340		yapK	2
Gok2_libmerged	315846	315864		yapK	18
Gok2_libmerged	316845	316884		ubiC	39
Gok2_libmerged	316939	316955		ubiC	16
Gok2_libmerged	317207	317217		ubiC	10
Gok2_libmerged	317502	317587		ubiA	85
Gok2_libmerged	317707	317716		ubiA	9
Gok2_libmerged	317916	317945		ubiA	29
Gok2_libmerged	318503	318539		plsB	36
Gok2_libmerged	318828	318830		plsB	2
Gok2_libmerged	318940	318948		plsB	8
Gok2_libmerged	319594	319696		plsB	102
Gok2_libmerged	320518	320537		plsB	19
Gok2_libmerged	320866	320909		plsB	43
Gok2_libmerged	321238	321289		YPO_RS02580	51
Gok2_libmerged	321769	321799		lexA	30
Gok2_libmerged	321915	321994		lexA	79
Gok2_libmerged	322469	322476		zur	7
Gok2_libmerged	324098	324103		dusA	5
Gok2_libmerged	324619	324644		pspG	25
Gok2_libmerged	324763	324772		pspG	9
Gok2_libmerged	325265	325294		YPO_RS02605	29
Gok2_libmerged	326159	326165		YPO_RS02605	6
Gok2_libmerged	326632	326633		dnaB	1
Gok2_libmerged	326790	326797		dnaB	7
Gok2_libmerged	327333	327388		dnaB	55
Gok2_libmerged	327756	327814		dnaB	58
Gok2_libmerged	327853	327861		dnaB	8
Gok2_libmerged	328000	328020		alr	20
Gok2_libmerged	328726	328733		alr	7
Gok2_libmerged	328920	328930		alr	10
Gok2_libmerged	329609	329637		YPO_RS02620	28
Gok2_libmerged	329853	329903		YPO_RS02620	50
Gok2_libmerged	331078	331094		YPO_RS02625	16
Gok2_libmerged	331220	331225		YPO_RS02625	5
Gok2_libmerged	331302	331344		YPO_RS02625	42
Gok2_libmerged	331562	331610		uvrA	48
Gok2_libmerged	331871	331890		uvrA	19
Gok2_libmerged	331925	331936		uvrA	11
Gok2_libmerged	331971	332003		uvrA	32
Gok2_libmerged	332419	332429		uvrA	10
Gok2_libmerged	332555	332663		uvrA	108
Gok2_libmerged	333150	333227		uvrA	77
Gok2_libmerged	333548	333591		uvrA	43
Gok2_libmerged	333674	333677		uvrA	3
Gok2_libmerged	335202	335217		ssb1	15
Gok2_libmerged	335580	335623		rhaM	43
Gok2_libmerged	335688	335694		rhaM	6
Gok2_libmerged	335788	335847		rhaM	59
Gok2_libmerged	335861	335904		fucO	43
Gok2_libmerged	336057	336085		fucO	28
Gok2_libmerged	336389	336392		fucO	3
Gok2_libmerged	336529	336567		fucO	38
Gok2_libmerged	337885	337900		rhaD	15
Gok2_libmerged	337913	337927		YPO_RS02655	14
Gok2_libmerged	339162	339169		YPO_RS02655	7
Gok2_libmerged	339166	339284		rhaB	118
Gok2_libmerged	339538	339577		rhaB	39
Gok2_libmerged	340121	340123		rhaB	2
Gok2_libmerged	340176	340276		rhaB	100
Gok2_libmerged	340581	340583		rhaB	2
Gok2_libmerged	340683	340736		YPO_RS02665	53
Gok2_libmerged	341188	341221		rhaS	33
Gok2_libmerged	341572	341631		rhaS	59
Gok2_libmerged	342675	342678		rhaR	3
Gok2_libmerged	343325	343344		rhaT	19
Gok2_libmerged	343420	343423		rhaT	3
Gok2_libmerged	343666	343692		rhaT	26
Gok2_libmerged	344058	344059		rhaT	1
Gok2_libmerged	344915	344923		YPO_RS02690	8
Gok2_libmerged	345010	345105		YPO_RS02690	95
Gok2_libmerged	345199	345272		YPO_RS02690	73
Gok2_libmerged	345331	345340		YPO_RS02690	9
Gok2_libmerged	345767	345776		YPO_RS02695	9
Gok2_libmerged	345844	346078		YPO_RS02695	234
Gok2_libmerged	346582	346647		YPO_RS02695	65
Gok2_libmerged	346692	346694		YPO_RS02695	2
Gok2_libmerged	346773	346800		YPO_RS02695	27
Gok2_libmerged	346868	346916		YPO_RS02695	48
Gok2_libmerged	347057	347343		YPO_RS02695	286
Gok2_libmerged	347375	347426		YPO_RS02695	51
Gok2_libmerged	347514	347726		YPO_RS02695	212
Gok2_libmerged	347814	347816		YPO_RS02695	2
Gok2_libmerged	347897	347989		YPO_RS02695	92
Gok2_libmerged	348036	348261		YPO_RS02695	225
Gok2_libmerged	349193	349200		YPO_RS02705	7
Gok2_libmerged	349971	349977		aegA	6
Gok2_libmerged	350047	350078		aegA	31
Gok2_libmerged	350215	350222		aegA	7
Gok2_libmerged	351064	351080		aegA	16
Gok2_libmerged	351375	351388		aegA	13
Gok2_libmerged	351540	351700		aegA	160
Gok2_libmerged	352076	352084		YPO_RS02715	8
Gok2_libmerged	352551	352566		YPO_RS02715	15
Gok2_libmerged	353234	353291		fdhF	57
Gok2_libmerged	353600	353613		fdhF	13
Gok2_libmerged	353915	353942		fdhF	27
Gok2_libmerged	354426	354440		fdhF	14
Gok2_libmerged	354600	354612		fdhF	12
Gok2_libmerged	354735	354736		fdhF	1
Gok2_libmerged	355487	355516		YPO_RS02725	29
Gok2_libmerged	355829	355853		YPO_RS02725	24
Gok2_libmerged	356392	356396		YPO_RS02725	4
Gok2_libmerged	356611	356648		cutA	37
Gok2_libmerged	356792	356802		cutA	10
Gok2_libmerged	356844	356884		cutA	40
Gok2_libmerged	357494	357504		YPO_RS02735	10
Gok2_libmerged	357640	357671		YPO_RS02735	31
Gok2_libmerged	358256	358271		YPO_RS02735	15
Gok2_libmerged	358532	358605		aspA	73
Gok2_libmerged	358883	358914		aspA	31
Gok2_libmerged	359293	359305		aspA	12
Gok2_libmerged	359463	359504		aspA	41
Gok2_libmerged	359755	359762		aspA	7
Gok2_libmerged	359961	359962		aspA	1
Gok2_libmerged	360527	360601		fxsA	74
Gok2_libmerged	360919	360988		fxsA	69
Gok2_libmerged	361243	361269		YPO_RS02750	26
Gok2_libmerged	361812	361816		groL	4
Gok2_libmerged	363907	363908		YPO_RS02760	1
Gok2_libmerged	364032	364050		YPO_RS02760	18
Gok2_libmerged	364206	364228		YPO_RS02760	22
Gok2_libmerged	364865	364880		epmB	15
Gok2_libmerged	365558	365559		epmB	1
Gok2_libmerged	365971	365980		efp	9
Gok2_libmerged	366983	367074		YPO_RS02780	91
Gok2_libmerged	367151	367183		YPO_RS02780	32
Gok2_libmerged	367615	367624		frdD	9
Gok2_libmerged	367697	367733		frdD	36
Gok2_libmerged	367881	367887		frdD	6
Gok2_libmerged	368342	368357		frdC	15
Gok2_libmerged	368730	368767		YPO_RS02795	37
Gok2_libmerged	369172	369174		frdA	2
Gok2_libmerged	369508	369540		frdA	32
Gok2_libmerged	370563	370581		frdA	18
Gok2_libmerged	370628	370634		frdA	6
Gok2_libmerged	371041	371148		YPO_RS02805	107
Gok2_libmerged	371180	371232		YPO_RS02805	52
Gok2_libmerged	371392	371407		epmA	15
Gok2_libmerged	371698	371705		epmA	7
Gok2_libmerged	371975	371992		epmA	17
Gok2_libmerged	372809	372822		mscM	13
Gok2_libmerged	373419	373421		mscM	2
Gok2_libmerged	373578	373585		mscM	7
Gok2_libmerged	373627	373664		mscM	37
Gok2_libmerged	373826	373848		mscM	22
Gok2_libmerged	373885	373894		mscM	9
Gok2_libmerged	373951	373980		mscM	29
Gok2_libmerged	374396	374419		mscM	23
Gok2_libmerged	374612	374616		mscM	4
Gok2_libmerged	374755	374768		mscM	13
Gok2_libmerged	374819	374899		mscM	80
Gok2_libmerged	375774	375780		mscM	6
Gok2_libmerged	375874	375908		psd	34
Gok2_libmerged	376021	376022		psd	1
Gok2_libmerged	376102	376111		psd	9
Gok2_libmerged	376273	376356		psd	83
Gok2_libmerged	376746	376753		psd	7
Gok2_libmerged	378119	378121		rsgA	2
Gok2_libmerged	378518	378555		orn	37
Gok2_libmerged	380035	380046		queG	11
Gok2_libmerged	380310	380330		queG	20
Gok2_libmerged	380546	380564		queG	18
Gok2_libmerged	381010	381020		queG	10
Gok2_libmerged	381093	381147		nnr	54
Gok2_libmerged	381500	381520		nnr	20
Gok2_libmerged	382003	382004		nnr	1
Gok2_libmerged	382268	382278		nnr	10
Gok2_libmerged	382908	382928		tsaE	20
Gok2_libmerged	383003	383018		tsaE	15
Gok2_libmerged	383384	383391		amiB	7
Gok2_libmerged	383465	383475		amiB	10
Gok2_libmerged	383556	383568		amiB	12
Gok2_libmerged	384030	384082		amiB	52
Gok2_libmerged	384962	384971		amiB	9
Gok2_libmerged	385017	385097		mutL	80
Gok2_libmerged	385301	385327		mutL	26
Gok2_libmerged	385381	385383		mutL	2
Gok2_libmerged	385994	386032		mutL	38
Gok2_libmerged	386341	386351		mutL	10
Gok2_libmerged	386517	386527		mutL	10
Gok2_libmerged	386563	386654		mutL	91
Gok2_libmerged	386731	386756		mutL	25
Gok2_libmerged	386850	386894		mutL	44
Gok2_libmerged	386887	386934		miaA	47
Gok2_libmerged	387152	387155		miaA	3
Gok2_libmerged	387314	387316		miaA	2
Gok2_libmerged	387418	387471		miaA	53
Gok2_libmerged	387631	387663		miaA	32
Gok2_libmerged	387818	387828		miaA	10
Gok2_libmerged	388030	388043		hfq	13
Gok2_libmerged	389230	389233		hflX	3
Gok2_libmerged	389276	389293		hflX	17
Gok2_libmerged	389551	389560		hflX	9
Gok2_libmerged	390055	390108		hflK	53
Gok2_libmerged	390855	390890		hflK	35
Gok2_libmerged	390956	391042		hflK	86
Gok2_libmerged	391363	391364		hflC	1
Gok2_libmerged	391445	391446		hflC	1
Gok2_libmerged	392314	392342		YPO_RS02890	28
Gok2_libmerged	392476	392514		YPO_RS02890	38
Gok2_libmerged	392779	392811		YPO_RS02895	32
Gok2_libmerged	392930	392945		YPO_RS02895	15
Gok2_libmerged	393131	393135		YPO_RS02895	4
Gok2_libmerged	393426	393427		YPO_RS02895	1
Gok2_libmerged	393642	393662		YPO_RS02895	20
Gok2_libmerged	393747	393762		YPO_RS02895	15
Gok2_libmerged	394281	394342		nsrR	61
Gok2_libmerged	394542	394558		nsrR	16
Gok2_libmerged	394668	394706		nsrR	38
Gok2_libmerged	396409	396459		rnr	50
Gok2_libmerged	396535	396575		rnr	40
Gok2_libmerged	396661	396711		rnr	50
Gok2_libmerged	396856	396897		rnr	41
Gok2_libmerged	397153	397172		rnr	19
Gok2_libmerged	397600	397616		rlmB	16
Gok2_libmerged	397891	397922		rlmB	31
Gok2_libmerged	398261	398314		rlmB	53
Gok2_libmerged	398861	398900		YPO_RS02915	39
Gok2_libmerged	399355	399357		YPO_RS02915	2
Gok2_libmerged	399594	399609		YPO_RS02915	15
Gok2_libmerged	399924	399935		YPO_RS02915	11
Gok2_libmerged	400309	400313		YPO_RS02915	4
Gok2_libmerged	400771	400774		bsmA	3
Gok2_libmerged	400959	401063		YPO_RS02925	104
Gok2_libmerged	401680	401794		YPO_RS02930	114
Gok2_libmerged	402239	402270		YPO_RS02935	31
Gok2_libmerged	402409	402433		YPO_RS02935	24
Gok2_libmerged	402496	402542		YPO_RS02935	46
Gok2_libmerged	402837	402915		YPO_RS02935	78
Gok2_libmerged	403049	403099		YPO_RS02940	50
Gok2_libmerged	403370	403400		YPO_RS02940	30
Gok2_libmerged	403596	403605		YPO_RS02940	9
Gok2_libmerged	403725	403781		YPO_RS02940	56
Gok2_libmerged	403931	403942		YPO_RS02940	11
Gok2_libmerged	404225	404300		YPO_RS02940	75
Gok2_libmerged	404654	404812		YPO_RS02940	158
Gok2_libmerged	405137	405178		YPO_RS02945	41
Gok2_libmerged	405783	405796		YPO_RS02945	13
Gok2_libmerged	405892	405903		YPO_RS02945	11
Gok2_libmerged	406079	406087		YPO_RS02945	8
Gok2_libmerged	407576	407577		YPO_RS02955	1
Gok2_libmerged	407773	408002		YPO_RS02955	229
Gok2_libmerged	408060	408140		YPO_RS02955	80
Gok2_libmerged	408181	408385		YPO_RS02955	204
Gok2_libmerged	408470	408631		YPO_RS02955	161
Gok2_libmerged	408690	408774		YPO_RS02955	84
Gok2_libmerged	408824	408827		YPO_RS02960	3
Gok2_libmerged	408921	409113		YPO_RS02960	192
Gok2_libmerged	409148	409330		YPO_RS02960	182
Gok2_libmerged	409397	409546		YPO_RS02960	149
Gok2_libmerged	410083	410124		YPO_RS02965	41
Gok2_libmerged	410327	410433		YPO_RS02965	106
Gok2_libmerged	410482	410684		YPO_RS02965	202
Gok2_libmerged	410775	410836		YPO_RS02965	61
Gok2_libmerged	410869	410891		YPO_RS02965	22
Gok2_libmerged	409518	409967		YPO_RS02965	449
Gok2_libmerged	411256	411262		YPO_RS02970	6
Gok2_libmerged	411847	411881		YPO_RS02975	34
Gok2_libmerged	412187	412189		YPO_RS02980	2
Gok2_libmerged	412261	412267		YPO_RS02980	6
Gok2_libmerged	412396	412398		YPO_RS02980	2
Gok2_libmerged	412845	412872		YPO_RS02980	27
Gok2_libmerged	413309	413354		YPO_RS02980	45
Gok2_libmerged	413502	413551		YPO_RS02980	49
Gok2_libmerged	413548	413584		YPO_RS02985	36
Gok2_libmerged	413805	413808		YPO_RS02985	3
Gok2_libmerged	413932	413934		YPO_RS02985	2
Gok2_libmerged	414086	414119		YPO_RS02985	33
Gok2_libmerged	414202	414227		YPO_RS02985	25
Gok2_libmerged	414265	414316		YPO_RS02985	51
Gok2_libmerged	414911	414913		YPO_RS02990	2
Gok2_libmerged	415159	415167		YPO_RS02990	8
Gok2_libmerged	415230	415242		YPO_RS02990	12
Gok2_libmerged	415507	415516		YPO_RS02990	9
Gok2_libmerged	416149	416169		YPO_RS02995	20
Gok2_libmerged	416251	416399		YPO_RS02995	148
Gok2_libmerged	416450	416493		YPO_RS02995	43
Gok2_libmerged	416735	416781		YPO_RS02995	46
Gok2_libmerged	417001	417005		YPO_RS02995	4
Gok2_libmerged	417091	417101		YPO_RS02995	10
Gok2_libmerged	418039	418064		YPO_RS03000	25
Gok2_libmerged	418329	418343		YPO_RS03000	14
Gok2_libmerged	418345	418346		YPO_RS03005	1
Gok2_libmerged	418402	418409		YPO_RS03005	7
Gok2_libmerged	418489	418543		YPO_RS03005	54
Gok2_libmerged	418654	418714		YPO_RS03005	60
Gok2_libmerged	419086	419220		YPO_RS03005	134
Gok2_libmerged	419213	419224		YPO_RS03010	11
Gok2_libmerged	419452	419544		YPO_RS03010	92
Gok2_libmerged	419850	419883		YPO_RS03015	33
Gok2_libmerged	420695	420740		YPO_RS03020	45
Gok2_libmerged	420793	420816		YPO_RS03020	23
Gok2_libmerged	420879	420920		YPO_RS03020	41
Gok2_libmerged	421762	421786		ptsP	24
Gok2_libmerged	422007	422065		ptsP	58
Gok2_libmerged	422097	422106		ptsP	9
Gok2_libmerged	422178	422210		ptsP	32
Gok2_libmerged	422994	423046		ptsP	52
Gok2_libmerged	423331	423344		ptsP	13
Gok2_libmerged	423612	423661		ptsP	49
Gok2_libmerged	423720	423727		ptsP	7
Gok2_libmerged	423800	423809		ptsP	9
Gok2_libmerged	423917	423935		ptsP	18
Gok2_libmerged	424543	424706		YPO_RS03030	163
Gok2_libmerged	425441	425460		lsrG	19
Gok2_libmerged	425575	425609		lsrF	34
Gok2_libmerged	425723	425748		lsrF	25
Gok2_libmerged	426908	426934		lsrB	26
Gok2_libmerged	427069	427116		lsrB	47
Gok2_libmerged	427176	427183		lsrB	7
Gok2_libmerged	427292	427306		lsrB	14
Gok2_libmerged	427464	427474		lsrB	10
Gok2_libmerged	427716	427726		lsrD	10
Gok2_libmerged	428035	428042		lsrD	7
Gok2_libmerged	428186	428211		lsrD	25
Gok2_libmerged	428423	428462		lsrD	39
Gok2_libmerged	429133	429140		lsrC	7
Gok2_libmerged	429416	429437		lsrC	21
Gok2_libmerged	429629	429637		lsrA	8
Gok2_libmerged	429731	429775		lsrA	44
Gok2_libmerged	429815	429848		lsrA	33
Gok2_libmerged	430001	430006		lsrA	5
Gok2_libmerged	430239	430268		lsrA	29
Gok2_libmerged	430389	430405		lsrA	16
Gok2_libmerged	430559	430590		lsrA	31
Gok2_libmerged	430864	430870		lsrA	6
Gok2_libmerged	431325	431486		YPO_RS03065	161
Gok2_libmerged	433053	433061		lsrK	8
Gok2_libmerged	433114	433118		lsrK	4
Gok2_libmerged	433173	433180		lsrK	7
Gok2_libmerged	433544	433596		lsrK	52
Gok2_libmerged	435262	435265		rfaQ	3
Gok2_libmerged	435876	435954		YPO_RS03085	78
Gok2_libmerged	436347	436357		YPO_RS03085	10
Gok2_libmerged	437993	438026		YPO_RS03090	33
Gok2_libmerged	438276	438288		YPO_RS03095	12
Gok2_libmerged	438387	438422		YPO_RS03095	35
Gok2_libmerged	438835	438843		YPO_RS03095	8
Gok2_libmerged	439076	439119		YPO_RS03095	43
Gok2_libmerged	439484	439519		YPO_RS03100	35
Gok2_libmerged	440030	440040		YPO_RS03100	10
Gok2_libmerged	440090	440132		YPO_RS03100	42
Gok2_libmerged	440185	440198		YPO_RS03100	13
Gok2_libmerged	440553	440588		YPO_RS03100	35
Gok2_libmerged	440818	440826		YPO_RS03100	8
Gok2_libmerged	440928	440957		YPO_RS03100	29
Gok2_libmerged	441800	441839		YPO_RS03100	39
Gok2_libmerged	441892	441940		YPO_RS03100	48
Gok2_libmerged	442678	442679		YPO_RS03105	1
Gok2_libmerged	442878	442886		YPO_RS03105	8
Gok2_libmerged	442966	442974		YPO_RS03105	8
Gok2_libmerged	443157	443166		YPO_RS03110	9
Gok2_libmerged	443238	443275		YPO_RS03110	37
Gok2_libmerged	443367	443384		YPO_RS03110	17
Gok2_libmerged	443820	443824		YPO_RS03115	4
Gok2_libmerged	444305	444323		YPO_RS03115	18
Gok2_libmerged	444397	444438		YPO_RS03115	41
Gok2_libmerged	444684	444713		YPO_RS03115	29
Gok2_libmerged	445444	445464		YPO_RS03120	20
Gok2_libmerged	446038	446231		YPO_RS03120	193
Gok2_libmerged	446316	446348		YPO_RS03120	32
Gok2_libmerged	446471	446475		YPO_RS03120	4
Gok2_libmerged	446605	446611		YPO_RS03120	6
Gok2_libmerged	446993	447024		YPO_RS03125	31
Gok2_libmerged	447362	447380		YPO_RS03130	18
Gok2_libmerged	448017	448037		rsmC	20
Gok2_libmerged	448153	448186		rsmC	33
Gok2_libmerged	448288	448297		rsmC	9
Gok2_libmerged	448714	448748		rsmC	34
Gok2_libmerged	449083	449110		YPO_RS03140	27
Gok2_libmerged	450119	450135		prfC	16
Gok2_libmerged	450808	450810		prfC	2
Gok2_libmerged	451000	451027		prfC	27
Gok2_libmerged	451269	451289		prfC	20
Gok2_libmerged	451781	451790		osmY	9
Gok2_libmerged	452234	452298		osmY	64
Gok2_libmerged	452612	452722		YPO_RS03160	110
Gok2_libmerged	452810	452833		YPO_RS03165	23
Gok2_libmerged	453103	453250		YPO_RS03165	147
Gok2_libmerged	453770	453798		YPO_RS03165	28
Gok2_libmerged	453830	453854		YPO_RS03165	24
Gok2_libmerged	455422	455473		YPO_RS03175	51
Gok2_libmerged	456520	456558		YPO_RS03175	38
Gok2_libmerged	457432	457462		deoC	30
Gok2_libmerged	457626	457651		deoC	25
Gok2_libmerged	457815	457839		deoC	24
Gok2_libmerged	459650	459690		deoB	40
Gok2_libmerged	460674	460720		deoB	46
Gok2_libmerged	460991	460994		deoD	3
Gok2_libmerged	461322	461350		deoD	28
Gok2_libmerged	461449	461500		deoD	51
Gok2_libmerged	461627	461679		deoD	52
Gok2_libmerged	461822	461855		YPO_RS03200	33
Gok2_libmerged	462180	462183		YPO_RS03200	3
Gok2_libmerged	462450	462523		YPO_RS03200	73
Gok2_libmerged	462755	462777		serB	22
Gok2_libmerged	463154	463160		serB	6
Gok2_libmerged	463375	463386		serB	11
Gok2_libmerged	463461	463519		serB	58
Gok2_libmerged	463681	463697		serB	16
Gok2_libmerged	464263	464271		radA	8
Gok2_libmerged	465005	465021		radA	16
Gok2_libmerged	465127	465128		radA	1
Gok2_libmerged	465662	465663		nadR	1
Gok2_libmerged	465727	465743		nadR	16
Gok2_libmerged	466087	466093		nadR	6
Gok2_libmerged	466163	466176		nadR	13
Gok2_libmerged	466290	466302		nadR	12
Gok2_libmerged	466390	466393		nadR	3
Gok2_libmerged	467132	467141		YPO_RS03220	9
Gok2_libmerged	467467	467501		YPO_RS03220	34
Gok2_libmerged	467769	467780		YPO_RS03220	11
Gok2_libmerged	470132	470195		YPO_RS03230	63
Gok2_libmerged	470306	470330		YPO_RS03230	24
Gok2_libmerged	470405	470418		YPO_RS03230	13
Gok2_libmerged	470655	470665		YPO_RS03235	10
Gok2_libmerged	471339	471397		YPO_RS03235	58
Gok2_libmerged	471723	471727		YPO_RS03235	4
Gok2_libmerged	471724	471743		YPO_RS03240	19
Gok2_libmerged	472048	472054		YPO_RS03240	6
Gok2_libmerged	472795	472796		YPO_RS03245	1
Gok2_libmerged	473112	473177		YPO_RS03245	65
Gok2_libmerged	473218	473251		YPO_RS03245	33
Gok2_libmerged	473413	473481		YPO_RS03245	68
Gok2_libmerged	473668	473698		YPO_RS03245	30
Gok2_libmerged	474090	474092		YPO_RS03245	2
Gok2_libmerged	474144	474189		YPO_RS03245	45
Gok2_libmerged	474232	474265		YPO_RS03245	33
Gok2_libmerged	474634	474668		YPO_RS03245	34
Gok2_libmerged	474890	474916		YPO_RS03245	26
Gok2_libmerged	475108	475174		YPO_RS03245	66
Gok2_libmerged	476874	476881		sltY	7
Gok2_libmerged	477166	477183		sltY	17
Gok2_libmerged	477661	477669		sltY	8
Gok2_libmerged	478173	478200		trpR	27
Gok2_libmerged	478484	478486		trpR	2
Gok2_libmerged	478621	478640		yjjX	19
Gok2_libmerged	479056	479064		yjjX	8
Gok2_libmerged	479204	479218		gpmB	14
Gok2_libmerged	479309	479357		gpmB	48
Gok2_libmerged	479442	479455		gpmB	13
Gok2_libmerged	479656	479670		gpmB	14
Gok2_libmerged	479977	479979		robA	2
Gok2_libmerged	480231	480303		robA	72
Gok2_libmerged	480934	480984		creA	50
Gok2_libmerged	481041	481105		creA	64
Gok2_libmerged	481214	481217		creA	3
Gok2_libmerged	481309	481340		creA	31
Gok2_libmerged	481679	481705		arcA	26
Gok2_libmerged	481818	481845		arcA	27
Gok2_libmerged	481878	481895		arcA	17
Gok2_libmerged	482002	482026		arcA	24
Gok2_libmerged	483208	483229		thrL	21
Gok2_libmerged	483395	483402		thrA	7
Gok2_libmerged	483521	483547		thrA	26
Gok2_libmerged	484255	484280		thrA	25
Gok2_libmerged	484322	484349		thrA	27
Gok2_libmerged	484805	484848		thrA	43
Gok2_libmerged	484917	484919		thrA	2
Gok2_libmerged	485022	485060		thrA	38
Gok2_libmerged	485221	485231		thrA	10
Gok2_libmerged	485296	485333		thrA	37
Gok2_libmerged	485457	485502		thrA	45
Gok2_libmerged	485949	485953		thrB	4
Gok2_libmerged	486084	486099		thrB	15
Gok2_libmerged	486672	486685		thrB	13
Gok2_libmerged	486790	486822		thrC	32
Gok2_libmerged	486989	486994		thrC	5
Gok2_libmerged	487085	487122		thrC	37
Gok2_libmerged	487564	487581		thrC	17
Gok2_libmerged	487622	487649		thrC	27
Gok2_libmerged	487723	487725		thrC	2
Gok2_libmerged	489650	489672		yaaA	22
Gok2_libmerged	490204	490228		tal	24
Gok2_libmerged	490544	490557		tal	13
Gok2_libmerged	490654	490658		tal	4
Gok2_libmerged	490760	490784		tal	24
Gok2_libmerged	490858	490870		tal	12
Gok2_libmerged	491445	491509		mog	64
Gok2_libmerged	491805	491816		mog	11
Gok2_libmerged	491878	491880		mog	2
Gok2_libmerged	491949	492032		mog	83
Gok2_libmerged	492811	492817		YPO_RS03325	6
Gok2_libmerged	493059	493100		YPO_RS03325	41
Gok2_libmerged	493854	493862		YPO_RS03330	8
Gok2_libmerged	494132	494238		YPO_RS03330	106
Gok2_libmerged	494293	494298		YPO_RS03330	5
Gok2_libmerged	494554	494558		YPO_RS03330	4
Gok2_libmerged	494686	494850		YPO_RS03330	164
Gok2_libmerged	494956	495291		YPO_RS03330	335
Gok2_libmerged	495401	495488		YPO_RS03330	87
Gok2_libmerged	495527	495560		YPO_RS03330	33
Gok2_libmerged	495694	495864		YPO_RS03330	170
Gok2_libmerged	495988	496065		YPO_RS03330	77
Gok2_libmerged	496522	496575		satP	53
Gok2_libmerged	496622	496692		satP	70
Gok2_libmerged	497365	497418		dnaK	53
Gok2_libmerged	497970	497991		dnaK	21
Gok2_libmerged	498051	498059		dnaK	8
Gok2_libmerged	498490	498680		dnaK	190
Gok2_libmerged	498755	498761		dnaK	6
Gok2_libmerged	498999	499013		dnaK	14
Gok2_libmerged	499167	499168		dnaK	1
Gok2_libmerged	499211	499222		dnaK	11
Gok2_libmerged	499743	499745		dnaJ	2
Gok2_libmerged	499860	499875		dnaJ	15
Gok2_libmerged	500054	500079		dnaJ	25
Gok2_libmerged	500242	500258		dnaJ	16
Gok2_libmerged	500947	500980		nhaA	33
Gok2_libmerged	501171	501174		nhaA	3
Gok2_libmerged	501232	501275		nhaA	43
Gok2_libmerged	501603	501634		nhaA	31
Gok2_libmerged	501763	501768		nhaA	5
Gok2_libmerged	501919	501927		nhaA	8
Gok2_libmerged	502057	502066		nhaR	9
Gok2_libmerged	502291	502298		nhaR	7
Gok2_libmerged	502955	502956		nhaR	1
Gok2_libmerged	503849	503869		ribF	20
Gok2_libmerged	504422	504446		ribF	24
Gok2_libmerged	504505	504507		ribF	2
Gok2_libmerged	504657	504662		ribF	5
Gok2_libmerged	504955	504962		ileS	7
Gok2_libmerged	505824	505841		ileS	17
Gok2_libmerged	506930	506938		ileS	8
Gok2_libmerged	507068	507144		ileS	76
Gok2_libmerged	507524	507540		ileS	16
Gok2_libmerged	507788	507795		lspA	7
Gok2_libmerged	508053	508060		lspA	7
Gok2_libmerged	507874	507951		lspA	77
Gok2_libmerged	508330	508362		fkpB	32
Gok2_libmerged	508493	508529		fkpB	36
Gok2_libmerged	508648	508665		ispH	17
Gok2_libmerged	508920	508945		ispH	25
Gok2_libmerged	509079	509088		ispH	9
Gok2_libmerged	509961	509998		YPO_RS03400	37
Gok2_libmerged	510268	510308		YPO_RS03400	40
Gok2_libmerged	511218	511220		dapB	2
Gok2_libmerged	512182	512188		carA	6
Gok2_libmerged	512387	512401		carA	14
Gok2_libmerged	512666	512684		carA	18
Gok2_libmerged	513279	513282		carA	3
Gok2_libmerged	513298	513302		carB	4
Gok2_libmerged	513801	513834		carB	33
Gok2_libmerged	514067	514110		carB	43
Gok2_libmerged	514338	514358		carB	20
Gok2_libmerged	514471	514477		carB	6
Gok2_libmerged	514551	514559		carB	8
Gok2_libmerged	515089	515099		carB	10
Gok2_libmerged	515419	515454		carB	35
Gok2_libmerged	515549	515603		carB	54
Gok2_libmerged	515957	515969		carB	12
Gok2_libmerged	516334	516342		carB	8
Gok2_libmerged	516444	516452		carB	8
Gok2_libmerged	516509	516531		carB	22
Gok2_libmerged	517114	517117		YPO_RS03420	3
Gok2_libmerged	517230	517250		YPO_RS03420	20
Gok2_libmerged	518480	518489		YPO_RS03425	9
Gok2_libmerged	518685	518701		YPO_RS03430	16
Gok2_libmerged	518786	518790		YPO_RS03430	4
Gok2_libmerged	519211	519221		folA	10
Gok2_libmerged	519450	519470		folA	20
Gok2_libmerged	520025	520076		YPO_RS03440	51
Gok2_libmerged	520158	520251		YPO_RS03440	93
Gok2_libmerged	520821	520900		YPO_RS03445	79
Gok2_libmerged	521000	521007		YPO_RS03445	7
Gok2_libmerged	521134	521146		YPO_RS03450	12
Gok2_libmerged	521298	521353		YPO_RS03450	55
Gok2_libmerged	521545	521598		YPO_RS03450	53
Gok2_libmerged	521688	521691		apaH	3
Gok2_libmerged	521794	521859		apaH	65
Gok2_libmerged	522361	522373		apaH	12
Gok2_libmerged	522537	522557		apaH	20
Gok2_libmerged	522723	522736		apaG	13
Gok2_libmerged	523095	523106		rsmA	11
Gok2_libmerged	523843	523885		pdxA	42
Gok2_libmerged	524091	524098		pdxA	7
Gok2_libmerged	524156	524158		pdxA	2
Gok2_libmerged	524197	524208		pdxA	11
Gok2_libmerged	524764	524771		pdxA	7
Gok2_libmerged	524764	524774		surA	10
Gok2_libmerged	525696	525817		surA	121
Gok2_libmerged	525903	525971		surA	68
Gok2_libmerged	526129	526130		lptD	1
Gok2_libmerged	526333	526351		lptD	18
Gok2_libmerged	526618	526642		lptD	24
Gok2_libmerged	526705	526802		lptD	97
Gok2_libmerged	526871	526882		lptD	11
Gok2_libmerged	527298	527333		lptD	35
Gok2_libmerged	527703	527711		lptD	8
Gok2_libmerged	527827	527835		lptD	8
Gok2_libmerged	528443	528469		lptD	26
Gok2_libmerged	528731	528748		djlA	17
Gok2_libmerged	529199	529201		djlA	2
Gok2_libmerged	529826	529831		rluA	5
Gok2_libmerged	529938	530015		rluA	77
Gok2_libmerged	530374	530405		rluA	31
Gok2_libmerged	531860	531916		YPO_RS03495	56
Gok2_libmerged	532015	532248		YPO_RS03495	233
Gok2_libmerged	532788	532805		YPO_RS03500	17
Gok2_libmerged	532932	532956		YPO_RS03500	24
Gok2_libmerged	533200	533300		YPO_RS03500	100
Gok2_libmerged	533340	533341		YPO_RS03500	1
Gok2_libmerged	533408	533460		YPO_RS03500	52
Gok2_libmerged	533604	533651		YPO_RS03500	47
Gok2_libmerged	533687	533714		YPO_RS03500	27
Gok2_libmerged	533816	533851		tssB	35
Gok2_libmerged	534494	534506		tssC	12
Gok2_libmerged	534728	534806		tssC	78
Gok2_libmerged	535084	535090		tssC	6
Gok2_libmerged	535238	535242		tssC	4
Gok2_libmerged	535381	535402		tssC	21
Gok2_libmerged	535594	535604		tssC	10
Gok2_libmerged	536005	536091		YPO_RS03515	86
Gok2_libmerged	536171	536187		YPO_RS03515	16
Gok2_libmerged	536272	536286		YPO_RS03515	14
Gok2_libmerged	536678	536689		YPO_RS03520	11
Gok2_libmerged	537497	537500		tssF	3
Gok2_libmerged	537921	537954		tssF	33
Gok2_libmerged	538094	538130		tssF	36
Gok2_libmerged	538280	538302		tssF	22
Gok2_libmerged	538373	538423		tssF	50
Gok2_libmerged	538687	538695		tssF	8
Gok2_libmerged	538796	538814		tssF	18
Gok2_libmerged	539164	539196		tssG	32
Gok2_libmerged	539545	539547		tssG	2
Gok2_libmerged	539923	539926		tssH	3
Gok2_libmerged	540177	540215		tssH	38
Gok2_libmerged	540258	540261		tssH	3
Gok2_libmerged	540773	540781		tssH	8
Gok2_libmerged	541350	541362		tssH	12
Gok2_libmerged	541414	541430		tssH	16
Gok2_libmerged	541729	541841		tssH	112
Gok2_libmerged	541949	541967		tssH	18
Gok2_libmerged	542047	542083		tssH	36
Gok2_libmerged	542416	542453		tssH	37
Gok2_libmerged	542557	542576		vgrG	19
Gok2_libmerged	542833	542841		vgrG	8
Gok2_libmerged	542904	542995		vgrG	91
Gok2_libmerged	543290	543305		vgrG	15
Gok2_libmerged	543377	543417		vgrG	40
Gok2_libmerged	543506	543534		vgrG	28
Gok2_libmerged	543612	543694		vgrG	82
Gok2_libmerged	544023	544063		vgrG	40
Gok2_libmerged	544235	544294		vgrG	59
Gok2_libmerged	544424	544430		vgrG	6
Gok2_libmerged	545185	545188		YPO_RS03545	3
Gok2_libmerged	545259	545355		YPO_RS03545	96
Gok2_libmerged	545997	546023		YPO_RS03550	26
Gok2_libmerged	546554	546609		YPO_RS03550	55
Gok2_libmerged	546899	546902		YPO_RS03550	3
Gok2_libmerged	547064	547093		YPO_RS03550	29
Gok2_libmerged	547209	547234		YPO_RS03555	25
Gok2_libmerged	547284	547429		YPO_RS03555	145
Gok2_libmerged	548803	548815		YPO_RS03560	12
Gok2_libmerged	549173	549202		YPO_RS03565	29
Gok2_libmerged	549447	549457		tssJ	10
Gok2_libmerged	549487	549507		tssJ	20
Gok2_libmerged	549565	549599		tssJ	34
Gok2_libmerged	549859	549892		tssK	33
Gok2_libmerged	550018	550020		tssK	2
Gok2_libmerged	550152	550167		tssK	15
Gok2_libmerged	550318	550320		tssK	2
Gok2_libmerged	550556	550630		tssK	74
Gok2_libmerged	550965	550999		tssK	34
Gok2_libmerged	551402	551407		YPO_RS03580	5
Gok2_libmerged	551488	551508		YPO_RS03580	20
Gok2_libmerged	551795	551796		YPO_RS03580	1
Gok2_libmerged	552689	552706		YPO_RS03580	17
Gok2_libmerged	552875	552905		tssM	30
Gok2_libmerged	553067	553078		tssM	11
Gok2_libmerged	553582	553638		tssM	56
Gok2_libmerged	553708	553749		tssM	41
Gok2_libmerged	553894	553923		tssM	29
Gok2_libmerged	554087	554105		tssM	18
Gok2_libmerged	554441	554497		tssM	56
Gok2_libmerged	554818	554833		tssM	15
Gok2_libmerged	555084	555090		tssM	6
Gok2_libmerged	555141	555151		tssM	10
Gok2_libmerged	555330	555334		tssM	4
Gok2_libmerged	556048	556066		tssM	18
Gok2_libmerged	556210	556222		tssM	12
Gok2_libmerged	556297	556315		tssM	18
Gok2_libmerged	556337	556340		YPO_RS03590	3
Gok2_libmerged	556488	556506		YPO_RS03590	18
Gok2_libmerged	556651	556653		YPO_RS03590	2
Gok2_libmerged	557476	557538		rapA	62
Gok2_libmerged	557629	557635		rapA	6
Gok2_libmerged	557763	557782		rapA	19
Gok2_libmerged	558750	558785		rapA	35
Gok2_libmerged	558930	558948		rapA	18
Gok2_libmerged	559616	559619		rapA	3
Gok2_libmerged	559763	559766		rapA	3
Gok2_libmerged	560627	560685		YPO_RS03600	58
Gok2_libmerged	561132	561170		YPO_RS03600	38
Gok2_libmerged	561408	561416		YPO_RS03600	8
Gok2_libmerged	562038	562047		YPO_RS03600	9
Gok2_libmerged	563049	563095		YPO_RS03605	46
Gok2_libmerged	563541	563544		YPO_RS03605	3
Gok2_libmerged	563638	563645		YPO_RS03605	7
Gok2_libmerged	563798	563799		thiQ	1
Gok2_libmerged	564017	564103		thiQ	86
Gok2_libmerged	564346	564401		thiQ	55
Gok2_libmerged	564712	564714		thiP	2
Gok2_libmerged	564783	564800		thiP	17
Gok2_libmerged	565097	565098		thiP	1
Gok2_libmerged	565433	565435		thiP	2
Gok2_libmerged	565568	565677		thiP	109
Gok2_libmerged	565767	565774		thiP	7
Gok2_libmerged	565812	565833		thiP	21
Gok2_libmerged	566587	566607		YPO_RS03620	20
Gok2_libmerged	567926	568013		YPO_RS03625	87
Gok2_libmerged	568303	568314		YPO_RS03625	11
Gok2_libmerged	568556	568568		YPO_RS03625	12
Gok2_libmerged	568666	568680		YPO_RS03625	14
Gok2_libmerged	568775	568783		YPO_RS03625	8
Gok2_libmerged	569248	569257		YPO_RS03625	9
Gok2_libmerged	571252	571253		YPO_RS03635	1
Gok2_libmerged	571338	571367		YPO_RS03635	29
Gok2_libmerged	571522	571538		YPO_RS03635	16
Gok2_libmerged	572595	572625		YPO_RS03640	30
Gok2_libmerged	572897	572901		YPO_RS03640	4
Gok2_libmerged	573044	573052		YPO_RS03640	8
Gok2_libmerged	573140	573195		YPO_RS03645	55
Gok2_libmerged	573866	573903		leuD	37
Gok2_libmerged	574250	574266		leuC	16
Gok2_libmerged	574626	574646		leuC	20
Gok2_libmerged	574945	574993		leuC	48
Gok2_libmerged	575458	575482		leuC	24
Gok2_libmerged	575569	575588		leuC	19
Gok2_libmerged	575798	575814		leuB	16
Gok2_libmerged	575966	575978		leuB	12
Gok2_libmerged	576384	576410		leuB	26
Gok2_libmerged	576501	576503		leuB	2
Gok2_libmerged	576849	576858		leuA	9
Gok2_libmerged	577111	577112		leuA	1
Gok2_libmerged	577174	577266		leuA	92
Gok2_libmerged	577374	577423		leuA	49
Gok2_libmerged	577553	577624		leuA	71
Gok2_libmerged	577922	577944		leuA	22
Gok2_libmerged	578182	578188		leuA	6
Gok2_libmerged	578558	578612		YPO_RS03670	54
Gok2_libmerged	578754	578795		YPO_RS03670	41
Gok2_libmerged	578864	578942		YPO_RS03670	78
Gok2_libmerged	579374	579586		YPO_RS03675	212
Gok2_libmerged	580424	580457		leuO	33
Gok2_libmerged	580835	580860		leuO	25
Gok2_libmerged	580967	581008		leuO	41
Gok2_libmerged	581165	581172		leuO	7
Gok2_libmerged	581766	581778		YPO_RS03685	12
Gok2_libmerged	582030	582045		YPO_RS03685	15
Gok2_libmerged	582307	582333		YPO_RS03685	26
Gok2_libmerged	582651	582656		YPO_RS03685	5
Gok2_libmerged	582972	582979		YPO_RS03685	7
Gok2_libmerged	583100	583132		YPO_RS03685	32
Gok2_libmerged	583304	583306		YPO_RS03685	2
Gok2_libmerged	583448	583460		YPO_RS03685	12
Gok2_libmerged	584158	584195		ilvI	37
Gok2_libmerged	584399	584472		ilvI	73
Gok2_libmerged	584799	584907		ilvI	108
Gok2_libmerged	585384	585431		ilvI	47
Gok2_libmerged	585618	585684		ilvI	66
Gok2_libmerged	586542	586566		YPO_RS03700	24
Gok2_libmerged	586681	586689		YPO_RS03700	8
Gok2_libmerged	586757	586784		YPO_RS03700	27
Gok2_libmerged	586815	586850		YPO_RS03700	35
Gok2_libmerged	587542	587567		cra	25
Gok2_libmerged	587828	587863		cra	35
Gok2_libmerged	589504	589531		YPO_RS03715	27
Gok2_libmerged	590216	590234		mraZ	18
Gok2_libmerged	590424	590437		mraZ	13
Gok2_libmerged	590797	590801		rsmH	4
Gok2_libmerged	590831	590873		rsmH	42
Gok2_libmerged	590988	591014		rsmH	26
Gok2_libmerged	591809	591823		ftsL	14
Gok2_libmerged	592153	592168		YPO_RS03735	15
Gok2_libmerged	592300	592321		YPO_RS03735	21
Gok2_libmerged	592503	592526		YPO_RS03735	23
Gok2_libmerged	592844	592847		YPO_RS03735	3
Gok2_libmerged	593121	593124		YPO_RS03735	3
Gok2_libmerged	593224	593238		YPO_RS03735	14
Gok2_libmerged	593582	593614		YPO_RS03735	32
Gok2_libmerged	594106	594128		murE	22
Gok2_libmerged	594278	594295		murE	17
Gok2_libmerged	594394	594401		murE	7
Gok2_libmerged	594665	594693		murE	28
Gok2_libmerged	594816	594820		murE	4
Gok2_libmerged	595054	595063		murE	9
Gok2_libmerged	595232	595234		murF	2
Gok2_libmerged	595333	595338		murF	5
Gok2_libmerged	595571	595643		murF	72
Gok2_libmerged	595984	596012		murF	28
Gok2_libmerged	596142	596206		murF	64
Gok2_libmerged	596478	596489		murF	11
Gok2_libmerged	596775	596845		mraY	70
Gok2_libmerged	597342	597377		mraY	35
Gok2_libmerged	597570	597575		mraY	5
Gok2_libmerged	597578	597593		murD	15
Gok2_libmerged	598260	598262		murD	2
Gok2_libmerged	598352	598378		murD	26
Gok2_libmerged	598898	598972		ftsW	74
Gok2_libmerged	599189	599215		ftsW	26
Gok2_libmerged	599398	599419		ftsW	21
Gok2_libmerged	599477	599496		ftsW	19
Gok2_libmerged	599645	599646		ftsW	1
Gok2_libmerged	599760	599763		ftsW	3
Gok2_libmerged	600010	600022		ftsW	12
Gok2_libmerged	600137	600165		murG	28
Gok2_libmerged	600539	600548		murG	9
Gok2_libmerged	600868	600917		murG	49
Gok2_libmerged	601155	601163		murG	8
Gok2_libmerged	601363	601377		murC	14
Gok2_libmerged	601579	601616		murC	37
Gok2_libmerged	601897	601942		murC	45
Gok2_libmerged	602513	602530		murC	17
Gok2_libmerged	602673	602696		murC	23
Gok2_libmerged	602984	602993		YPO_RS03775	9
Gok2_libmerged	603148	603193		YPO_RS03775	45
Gok2_libmerged	603584	603600		YPO_RS03775	16
Gok2_libmerged	603877	603886		ftsQ	9
Gok2_libmerged	604126	604129		ftsQ	3
Gok2_libmerged	604648	604693		ftsA	45
Gok2_libmerged	604802	604862		ftsA	60
Gok2_libmerged	605064	605089		ftsA	25
Gok2_libmerged	605173	605212		ftsA	39
Gok2_libmerged	605386	605413		ftsA	27
Gok2_libmerged	605797	605801		ftsA	4
Gok2_libmerged	606205	606289		ftsZ	84
Gok2_libmerged	607223	607297		lpxC	74
Gok2_libmerged	607416	607418		lpxC	2
Gok2_libmerged	607461	607476		lpxC	15
Gok2_libmerged	607820	607842		lpxC	22
Gok2_libmerged	607897	607905		lpxC	8
Gok2_libmerged	607977	607989		lpxC	12
Gok2_libmerged	608401	608447		YPO_RS03800	46
Gok2_libmerged	608663	608697		YPO_RS03800	34
Gok2_libmerged	609376	609396		secA	20
Gok2_libmerged	609760	609780		secA	20
Gok2_libmerged	609869	609871		secA	2
Gok2_libmerged	610002	610031		secA	29
Gok2_libmerged	610174	610182		secA	8
Gok2_libmerged	610663	610690		secA	27
Gok2_libmerged	610746	610764		secA	18
Gok2_libmerged	611416	611429		secA	13
Gok2_libmerged	611727	611789		secA	62
Gok2_libmerged	611908	611939		secA	31
Gok2_libmerged	612511	612529		mutT	18
Gok2_libmerged	612613	612614		mutT	1
Gok2_libmerged	613033	613044		YPO_RS03820	11
Gok2_libmerged	613443	613522		YPO_RS03820	79
Gok2_libmerged	613627	613659		YPO_RS03820	32
Gok2_libmerged	613718	613725		YPO_RS03820	7
Gok2_libmerged	613764	613768		YPO_RS03820	4
Gok2_libmerged	614511	614551		YPO_RS03825	40
Gok2_libmerged	614714	614737		YPO_RS03825	23
Gok2_libmerged	614801	614825		YPO_RS03825	24
Gok2_libmerged	615197	615220		YPO_RS03835	23
Gok2_libmerged	616642	616659		YPO_RS03850	17
Gok2_libmerged	616733	616796		YPO_RS03850	63
Gok2_libmerged	616951	616956		YPO_RS03855	5
Gok2_libmerged	617744	617782		mzrA	38
Gok2_libmerged	618061	618094		YPO_RS03865	33
Gok2_libmerged	618276	618314		YPO_RS03865	38
Gok2_libmerged	619701	619748		exuR	47
Gok2_libmerged	619929	619977		exuR	48
Gok2_libmerged	620343	620352		exuR	9
Gok2_libmerged	621060	621173		YPO_RS03880	113
Gok2_libmerged	621343	621374		YPO_RS03880	31
Gok2_libmerged	621587	621626		YPO_RS03880	39
Gok2_libmerged	621733	621745		YPO_RS03880	12
Gok2_libmerged	621999	622003		YPO_RS03880	4
Gok2_libmerged	622868	622957		uxaC	89
Gok2_libmerged	623026	623053		uxaC	27
Gok2_libmerged	623523	623531		uxaC	8
Gok2_libmerged	623588	623649		uxaC	61
Gok2_libmerged	623828	623850		uxaC	22
Gok2_libmerged	624132	624163		uxaC	31
Gok2_libmerged	624534	624544		YPO_RS03890	10
Gok2_libmerged	624579	624600		YPO_RS03890	21
Gok2_libmerged	624768	624784		YPO_RS03890	16
Gok2_libmerged	624865	624868		YPO_RS03890	3
Gok2_libmerged	624983	625022		YPO_RS03890	39
Gok2_libmerged	625115	625163		YPO_RS03890	48
Gok2_libmerged	625695	625714		YPO_RS03890	19
Gok2_libmerged	625852	625866		YPO_RS03890	14
Gok2_libmerged	625877	625916		YPO_RS03895	39
Gok2_libmerged	626049	626076		YPO_RS03895	27
Gok2_libmerged	626187	626193		YPO_RS03895	6
Gok2_libmerged	626240	626254		YPO_RS03895	14
Gok2_libmerged	626676	626729		YPO_RS03895	53
Gok2_libmerged	627361	627367		YPO_RS03895	6
Gok2_libmerged	627641	627655		YPO_RS03900	14
Gok2_libmerged	627888	627928		YPO_RS03900	40
Gok2_libmerged	628047	628050		YPO_RS03900	3
Gok2_libmerged	628283	628376		YPO_RS03905	93
Gok2_libmerged	628960	628965		sstT	5
Gok2_libmerged	629039	629043		sstT	4
Gok2_libmerged	629241	629255		sstT	14
Gok2_libmerged	629339	629370		sstT	31
Gok2_libmerged	629562	629581		sstT	19
Gok2_libmerged	629731	629738		sstT	7
Gok2_libmerged	629797	629824		sstT	27
Gok2_libmerged	629984	630062		sstT	78
Gok2_libmerged	631359	631361		YPO_RS03915	2
Gok2_libmerged	631411	631412		YPO_RS03915	1
Gok2_libmerged	632173	632218		YPO_RS03920	45
Gok2_libmerged	632640	632646		yapG	6
Gok2_libmerged	633049	633071		yapG	22
Gok2_libmerged	633239	633282		yapG	43
Gok2_libmerged	633395	633447		yapG	52
Gok2_libmerged	634358	634503		yapG	145
Gok2_libmerged	634620	634857		yapG	237
Gok2_libmerged	635043	635095		yapG	52
Gok2_libmerged	635177	635297		yapG	120
Gok2_libmerged	635500	635548		yapG	48
Gok2_libmerged	636070	636075		rlmG	5
Gok2_libmerged	636620	636622		rlmG	2
Gok2_libmerged	637039	637067		rlmG	28
Gok2_libmerged	637606	637621		YPO_RS03935	15
Gok2_libmerged	637686	637696		YPO_RS03935	10
Gok2_libmerged	637834	637836		YPO_RS03935	2
Gok2_libmerged	638676	638690		YPO_RS03935	14
Gok2_libmerged	638897	638967		YPO_RS03935	70
Gok2_libmerged	639009	639021		YPO_RS03935	12
Gok2_libmerged	639156	639157		YPO_RS03935	1
Gok2_libmerged	639272	639299		YPO_RS03935	27
Gok2_libmerged	639621	639629		YPO_RS03940	8
Gok2_libmerged	640120	640123		YPO_RS03940	3
Gok2_libmerged	640625	640664		YPO_RS03945	39
Gok2_libmerged	641069	641091		YPO_RS03945	22
Gok2_libmerged	641182	641287		YPO_RS03945	105
Gok2_libmerged	641502	641560		YPO_RS03945	58
Gok2_libmerged	641698	641762		YPO_RS03945	64
Gok2_libmerged	641831	641886		YPO_RS03945	55
Gok2_libmerged	641994	642009		YPO_RS03945	15
Gok2_libmerged	642276	642309		YPO_RS03950	33
Gok2_libmerged	642777	642821		YPO_RS03950	44
Gok2_libmerged	642876	642886		YPO_RS03950	10
Gok2_libmerged	642966	642977		YPO_RS03950	11
Gok2_libmerged	643468	643497		YPO_RS03950	29
Gok2_libmerged	643529	643535		YPO_RS03950	6
Gok2_libmerged	643834	643836		YPO_RS03955	2
Gok2_libmerged	644342	644347		YPO_RS03955	5
Gok2_libmerged	644788	644817		YPO_RS03955	29
Gok2_libmerged	644919	644924		YPO_RS03960	5
Gok2_libmerged	645267	645302		YPO_RS03960	35
Gok2_libmerged	645436	645440		YPO_RS03960	4
Gok2_libmerged	645658	645684		YPO_RS03965	26
Gok2_libmerged	645810	645833		YPO_RS03965	23
Gok2_libmerged	646344	646351		YPO_RS03970	7
Gok2_libmerged	646513	646519		YPO_RS03970	6
Gok2_libmerged	646715	646719		YPO_RS03970	4
Gok2_libmerged	647604	647606		YPO_RS03975	2
Gok2_libmerged	647805	647820		YPO_RS03975	15
Gok2_libmerged	648661	648662		YPO_RS03975	1
Gok2_libmerged	648884	648929		YPO_RS03975	45
Gok2_libmerged	649263	649274		YPO_RS03975	11
Gok2_libmerged	649319	649351		cdiA	32
Gok2_libmerged	649602	649634		cdiA	32
Gok2_libmerged	650142	650201		cdiA	59
Gok2_libmerged	650411	650453		cdiA	42
Gok2_libmerged	650902	650917		cdiA	15
Gok2_libmerged	651203	651232		cdiA	29
Gok2_libmerged	651290	651298		cdiA	8
Gok2_libmerged	651588	651626		cdiA	38
Gok2_libmerged	651661	651687		cdiA	26
Gok2_libmerged	651767	651776		cdiA	9
Gok2_libmerged	652062	652079		cdiA	17
Gok2_libmerged	652201	652243		cdiA	42
Gok2_libmerged	652438	652459		cdiA	21
Gok2_libmerged	652661	652677		cdiA	16
Gok2_libmerged	652728	652776		cdiA	48
Gok2_libmerged	652826	652881		cdiA	55
Gok2_libmerged	653190	653192		cdiA	2
Gok2_libmerged	653912	653974		cdiA	62
Gok2_libmerged	654179	654191		cdiA	12
Gok2_libmerged	654375	654377		cdiA	2
Gok2_libmerged	654429	654447		cdiA	18
Gok2_libmerged	654854	654864		cdiA	10
Gok2_libmerged	654953	654957		cdiA	4
Gok2_libmerged	655341	655342		cdiA	1
Gok2_libmerged	656172	656193		cdiA	21
Gok2_libmerged	656387	656394		cdiA	7
Gok2_libmerged	656638	656674		cdiA	36
Gok2_libmerged	657132	657145		cdiA	13
Gok2_libmerged	658195	658211		cdiA	16
Gok2_libmerged	658547	658601		cdiA	54
Gok2_libmerged	658716	658771		cdiA	55
Gok2_libmerged	658957	659048		cdiA	91
Gok2_libmerged	659169	659206		cdiA	37
Gok2_libmerged	659203	659427		cdiI	224
Gok2_libmerged	659857	659929		YPO_RS03995	72
Gok2_libmerged	659865	659989		YPO_RS04000	124
Gok2_libmerged	660138	660144		YPO_RS04005	6
Gok2_libmerged	660282	660285		YPO_RS04005	3
Gok2_libmerged	661217	661229		YPO_RS04010	12
Gok2_libmerged	661302	661326		YPO_RS04015	24
Gok2_libmerged	661876	661934		yapF	58
Gok2_libmerged	662340	662394		yapF	54
Gok2_libmerged	662476	662486		yapF	10
Gok2_libmerged	662551	662561		yapF	10
Gok2_libmerged	662776	662792		yapF	16
Gok2_libmerged	662886	662892		yapF	6
Gok2_libmerged	663810	663831		yapF	21
Gok2_libmerged	663995	664010		yapF	15
Gok2_libmerged	664070	664134		YPO_RS04025	64
Gok2_libmerged	665390	665413		YPO_RS04030	23
Gok2_libmerged	665459	665470		YPO_RS04030	11
Gok2_libmerged	665556	665606		YPO_RS04030	50
Gok2_libmerged	665670	665685		YPO_RS04030	15
Gok2_libmerged	665755	665774		YPO_RS04030	19
Gok2_libmerged	666105	666116		YPO_RS04030	11
Gok2_libmerged	666872	666938		YPO_RS04035	66
Gok2_libmerged	667088	667155		YPO_RS04035	67
Gok2_libmerged	667650	667659		YPO_RS04035	9
Gok2_libmerged	667934	667979		YPO_RS04035	45
Gok2_libmerged	668525	668624		YPO_RS04040	99
Gok2_libmerged	669139	669261		YPO_RS04040	122
Gok2_libmerged	669615	669618		YPO_RS04040	3
Gok2_libmerged	670223	670227		YPO_RS04040	4
Gok2_libmerged	670602	670617		YPO_RS04040	15
Gok2_libmerged	671203	671207		YPO_RS04040	4
Gok2_libmerged	671992	671994		YPO_RS04045	2
Gok2_libmerged	672172	672182		YPO_RS04045	10
Gok2_libmerged	672482	672518		YPO_RS04045	36
Gok2_libmerged	673477	673495		YPO_RS04050	18
Gok2_libmerged	673986	674004		YPO_RS04055	18
Gok2_libmerged	674568	674620		YPO_RS04055	52
Gok2_libmerged	674935	674972		YPO_RS04060	37
Gok2_libmerged	675132	675182		YPO_RS04060	50
Gok2_libmerged	675924	675926		YPO_RS04065	2
Gok2_libmerged	676495	676500		YPO_RS04070	5
Gok2_libmerged	676594	676604		YPO_RS04070	10
Gok2_libmerged	676778	676791		YPO_RS04070	13
Gok2_libmerged	677484	677491		YPO_RS04070	7
Gok2_libmerged	677903	677970		YPO_RS04070	67
Gok2_libmerged	678305	678310		YPO_RS04070	5
Gok2_libmerged	678402	678438		YPO_RS04075	36
Gok2_libmerged	679556	679573		YPO_RS04075	17
Gok2_libmerged	679609	679623		YPO_RS04075	14
Gok2_libmerged	679667	679689		YPO_RS04075	22
Gok2_libmerged	679816	679838		YPO_RS04075	22
Gok2_libmerged	679913	679915		YPO_RS04075	2
Gok2_libmerged	679992	680003		YPO_RS04080	11
Gok2_libmerged	680402	680422		YPO_RS04080	20
Gok2_libmerged	680632	680640		YPO_RS04080	8
Gok2_libmerged	680739	680741		YPO_RS04080	2
Gok2_libmerged	682055	682206		mdtN	151
Gok2_libmerged	682446	682458		mdtN	12
Gok2_libmerged	682683	682773		mdtN	90
Gok2_libmerged	683354	683374		YPO_RS04095	20
Gok2_libmerged	684175	684272		YPO_RS04100	97
Gok2_libmerged	684400	684475		YPO_RS04100	75
Gok2_libmerged	684572	684578		YPO_RS04100	6
Gok2_libmerged	684664	684717		YPO_RS04100	53
Gok2_libmerged	684787	684808		YPO_RS04100	21
Gok2_libmerged	684876	684897		YPO_RS04100	21
Gok2_libmerged	685283	685341		YPO_RS04100	58
Gok2_libmerged	685554	685591		YPO_RS04105	37
Gok2_libmerged	685632	685642		YPO_RS04105	10
Gok2_libmerged	685841	685924		YPO_RS04105	83
Gok2_libmerged	686218	686275		YPO_RS04105	57
Gok2_libmerged	686368	686411		YPO_RS04105	43
Gok2_libmerged	686636	686672		YPO_RS04105	36
Gok2_libmerged	686822	686851		YPO_RS04105	29
Gok2_libmerged	686864	686883		YPO_RS04110	19
Gok2_libmerged	687036	687061		YPO_RS04110	25
Gok2_libmerged	687112	687173		YPO_RS04110	61
Gok2_libmerged	687261	687301		YPO_RS04110	40
Gok2_libmerged	687435	687464		YPO_RS04115	29
Gok2_libmerged	687552	687580		YPO_RS04115	28
Gok2_libmerged	687733	688061		YPO_RS04115	328
Gok2_libmerged	688077	688088		YPO_RS04120	11
Gok2_libmerged	688188	688391		YPO_RS04120	203
Gok2_libmerged	688742	688761		YPO_RS04125	19
Gok2_libmerged	688809	688885		YPO_RS04125	76
Gok2_libmerged	689071	689090		YPO_RS04125	19
Gok2_libmerged	689361	689432		YPO_RS04130	71
Gok2_libmerged	689592	689649		YPO_RS04130	57
Gok2_libmerged	689985	690013		YPO_RS04135	28
Gok2_libmerged	690156	690182		YPO_RS04135	26
Gok2_libmerged	690374	690377		YPO_RS04135	3
Gok2_libmerged	690452	690458		YPO_RS04135	6
Gok2_libmerged	691231	691283		YPO_RS04140	52
Gok2_libmerged	691585	691597		YPO_RS04140	12
Gok2_libmerged	692821	692835		YPO_RS04150	14
Gok2_libmerged	693406	693427		YPO_RS04155	21
Gok2_libmerged	693461	693484		YPO_RS04155	23
Gok2_libmerged	693931	693938		YPO_RS04160	7
Gok2_libmerged	694119	694177		YPO_RS04160	58
Gok2_libmerged	694237	694260		YPO_RS04160	23
Gok2_libmerged	694318	694327		YPO_RS04160	9
Gok2_libmerged	694752	694800		YPO_RS04160	48
Gok2_libmerged	694940	695015		YPO_RS04165	75
Gok2_libmerged	695328	695353		YPO_RS04165	25
Gok2_libmerged	695730	695775		YPO_RS04170	45
Gok2_libmerged	695858	695890		YPO_RS04170	32
Gok2_libmerged	696377	696405		YPO_RS04170	28
Gok2_libmerged	696792	696828		YPO_RS04170	36
Gok2_libmerged	697024	697110		YPO_RS04170	86
Gok2_libmerged	697119	697143		YPO_RS04175	24
Gok2_libmerged	697432	697589		YPO_RS04175	157
Gok2_libmerged	697616	697619		YPO_RS04180	3
Gok2_libmerged	697657	697762		YPO_RS04180	105
Gok2_libmerged	697956	697959		YPO_RS04180	3
Gok2_libmerged	698003	698071		YPO_RS04180	68
Gok2_libmerged	700178	700217		rpoD	39
Gok2_libmerged	700849	700906		rpoD	57
Gok2_libmerged	701410	701417		dnaG	7
Gok2_libmerged	701605	701640		dnaG	35
Gok2_libmerged	701704	701728		dnaG	24
Gok2_libmerged	701892	701907		dnaG	15
Gok2_libmerged	702099	702108		dnaG	9
Gok2_libmerged	702201	702276		dnaG	75
Gok2_libmerged	702695	702711		dnaG	16
Gok2_libmerged	702805	702807		dnaG	2
Gok2_libmerged	703732	703733		tsaD	1
Gok2_libmerged	703973	704018		tsaD	45
Gok2_libmerged	704052	704133		tsaD	81
Gok2_libmerged	704393	704424		tsaD	31
Gok2_libmerged	704584	704643		tsaD	59
Gok2_libmerged	705310	705317		plsY	7
Gok2_libmerged	706425	706460		bacA	35
Gok2_libmerged	706792	706793		bacA	1
Gok2_libmerged	707024	707042		bacA	18
Gok2_libmerged	707166	707181		bacA	15
Gok2_libmerged	707963	708007		YPO_RS04230	44
Gok2_libmerged	708132	708134		YPO_RS04230	2
Gok2_libmerged	708539	708599		YPO_RS04230	60
Gok2_libmerged	708815	708818		YPO_RS04235	3
Gok2_libmerged	708905	708945		YPO_RS04235	40
Gok2_libmerged	709415	709438		YPO_RS04235	23
Gok2_libmerged	709838	709849		YPO_RS04240	11
Gok2_libmerged	710096	710135		YPO_RS04240	39
Gok2_libmerged	710443	710454		YPO_RS04240	11
Gok2_libmerged	710663	710673		YPO_RS04240	10
Gok2_libmerged	711347	711359		glnE	12
Gok2_libmerged	712081	712155		glnE	74
Gok2_libmerged	712508	712510		glnE	2
Gok2_libmerged	712757	712784		glnE	27
Gok2_libmerged	713393	713418		glnE	25
Gok2_libmerged	713525	713537		glnE	12
Gok2_libmerged	714049	714075		glnE	26
Gok2_libmerged	714270	714278		hldE	8
Gok2_libmerged	715246	715275		hldE	29
Gok2_libmerged	715466	715493		hldE	27
Gok2_libmerged	716037	716058		yjeH	21
Gok2_libmerged	716357	716427		yjeH	70
Gok2_libmerged	716656	716669		yjeH	13
Gok2_libmerged	716810	716825		yjeH	15
Gok2_libmerged	716888	716889		yjeH	1
Gok2_libmerged	718237	718276		ribB	39
Gok2_libmerged	718537	718553		ribB	16
Gok2_libmerged	719592	719600		ygiD	8
Gok2_libmerged	720637	720649		YPO_RS04275	12
Gok2_libmerged	720910	720915		YPO_RS04275	5
Gok2_libmerged	721576	721634		YPO_RS04280	58
Gok2_libmerged	721852	721872		YPO_RS04280	20
Gok2_libmerged	722046	722059		YPO_RS04280	13
Gok2_libmerged	722197	722206		YPO_RS04280	9
Gok2_libmerged	722653	722663		tolC	10
Gok2_libmerged	722772	722783		tolC	11
Gok2_libmerged	722915	723002		tolC	87
Gok2_libmerged	723318	723354		tolC	36
Gok2_libmerged	723708	723710		tolC	2
Gok2_libmerged	724353	724358		nudF	5
Gok2_libmerged	724414	724441		nudF	27
Gok2_libmerged	724651	724674		nudF	23
Gok2_libmerged	724707	724716		nudF	9
Gok2_libmerged	724851	724856		nudF	5
Gok2_libmerged	725036	725142		YPO_RS04295	106
Gok2_libmerged	725943	725964		cpdA	21
Gok2_libmerged	726094	726143		cpdA	49
Gok2_libmerged	726506	726539		yqiA	33
Gok2_libmerged	726631	726654		yqiA	23
Gok2_libmerged	726740	726830		yqiA	90
Gok2_libmerged	726916	726917		yqiA	1
Gok2_libmerged	727157	727186		parE	29
Gok2_libmerged	727846	727873		parE	27
Gok2_libmerged	728344	728353		parE	9
Gok2_libmerged	728477	728478		parE	1
Gok2_libmerged	728675	728681		parE	6
Gok2_libmerged	728779	728837		parE	58
Gok2_libmerged	729959	729998		YPO_RS04320	39
Gok2_libmerged	730144	730147		YPO_RS04320	3
Gok2_libmerged	730226	730246		YPO_RS04320	20
Gok2_libmerged	730596	730602		YPO_RS04325	6
Gok2_libmerged	730686	730695		YPO_RS04325	9
Gok2_libmerged	730956	730962		parC	6
Gok2_libmerged	731100	731111		parC	11
Gok2_libmerged	731198	731204		parC	6
Gok2_libmerged	731783	731803		parC	20
Gok2_libmerged	732461	732500		parC	39
Gok2_libmerged	732689	732785		parC	96
Gok2_libmerged	733581	733588		YPO_RS04335	7
Gok2_libmerged	733815	733840		YPO_RS04335	25
Gok2_libmerged	734765	734893		ftsP	128
Gok2_libmerged	735206	735214		ftsP	8
Gok2_libmerged	735339	735377		ftsP	38
Gok2_libmerged	735433	735503		ftsP	70
Gok2_libmerged	735662	735667		ftsP	5
Gok2_libmerged	738485	738489		dkgA	4
Gok2_libmerged	738531	738556		dkgA	25
Gok2_libmerged	738858	738875		dkgA	17
Gok2_libmerged	738975	738977		dkgA	2
Gok2_libmerged	739342	739343		YPO_RS04355	1
Gok2_libmerged	739490	739491		YPO_RS04355	1
Gok2_libmerged	739614	739628		yqhD	14
Gok2_libmerged	739826	739836		yqhD	10
Gok2_libmerged	740096	740153		yqhD	57
Gok2_libmerged	740523	740548		yqhD	25
Gok2_libmerged	740743	740771		yqhD	28
Gok2_libmerged	741308	741314		YPO_RS04365	6
Gok2_libmerged	741487	741526		YPO_RS04365	39
Gok2_libmerged	741823	741839		YPO_RS04365	16
Gok2_libmerged	742384	742387		YPO_RS04370	3
Gok2_libmerged	742430	742434		YPO_RS04370	4
Gok2_libmerged	742629	742659		YPO_RS04370	30
Gok2_libmerged	743194	743261		metC	67
Gok2_libmerged	743410	743438		metC	28
Gok2_libmerged	743580	743615		metC	35
Gok2_libmerged	744025	744028		metC	3
Gok2_libmerged	744921	744928		exbB	7
Gok2_libmerged	745300	745305		exbB	5
Gok2_libmerged	745811	745812		exbD	1
Gok2_libmerged	745896	745897		exbD	1
Gok2_libmerged	746098	746144		exbD	46
Gok2_libmerged	746395	746472		YPO_RS04390	77
Gok2_libmerged	746560	746562		YPO_RS04390	2
Gok2_libmerged	746699	746959		YPO_RS04390	260
Gok2_libmerged	747044	747109		YPO_RS04390	65
Gok2_libmerged	747443	747514		YPO_RS04390	71
Gok2_libmerged	747594	747622		YPO_RS04390	28
Gok2_libmerged	747715	747823		YPO_RS04390	108
Gok2_libmerged	748173	748222		YPO_RS04395	49
Gok2_libmerged	748339	748364		YPO_RS04395	25
Gok2_libmerged	748427	748504		YPO_RS04400	77
Gok2_libmerged	748812	748877		YPO_RS04400	65
Gok2_libmerged	748875	748877		YPO_RS04405	2
Gok2_libmerged	749053	749060		YPO_RS04405	7
Gok2_libmerged	749256	749259		YPO_RS04405	3
Gok2_libmerged	749313	749403		YPO_RS04405	90
Gok2_libmerged	749477	749556		YPO_RS04405	79
Gok2_libmerged	749617	749645		YPO_RS04405	28
Gok2_libmerged	749629	749736		YPO_RS04410	107
Gok2_libmerged	749821	749896		YPO_RS04410	75
Gok2_libmerged	749975	750383		YPO_RS04410	408
Gok2_libmerged	750448	750462		YPO_RS04410	14
Gok2_libmerged	750459	750480		YPO_RS04415	21
Gok2_libmerged	750580	750637		YPO_RS04415	57
Gok2_libmerged	750736	750779		YPO_RS04415	43
Gok2_libmerged	750933	751242		YPO_RS04415	309
Gok2_libmerged	751469	751539		YPO_RS04420	70
Gok2_libmerged	751612	751645		YPO_RS04420	33
Gok2_libmerged	751698	751704		YPO_RS04420	6
Gok2_libmerged	751759	751779		YPO_RS04420	20
Gok2_libmerged	751992	752000		YPO_RS04420	8
Gok2_libmerged	752093	752198		YPO_RS04420	105
Gok2_libmerged	752466	752501		YPO_RS04420	35
Gok2_libmerged	752591	752617		YPO_RS04420	26
Gok2_libmerged	752668	752895		YPO_RS04425	227
Gok2_libmerged	752969	753184		YPO_RS04425	215
Gok2_libmerged	753345	753392		YPO_RS04425	47
Gok2_libmerged	753520	753542		YPO_RS04425	22
Gok2_libmerged	753634	753756		YPO_RS04425	122
Gok2_libmerged	753767	754039		YPO_RS04430	272
Gok2_libmerged	754157	754188		YPO_RS04435	31
Gok2_libmerged	754370	754462		YPO_RS04435	92
Gok2_libmerged	754552	754590		YPO_RS04440	38
Gok2_libmerged	754700	754716		YPO_RS04440	16
Gok2_libmerged	754760	754795		YPO_RS04440	35
Gok2_libmerged	755013	755052		YPO_RS04440	39
Gok2_libmerged	755183	755184		YPO_RS04440	1
Gok2_libmerged	755599	755798		YPO_RS04445	199
Gok2_libmerged	755892	756023		YPO_RS04445	131
Gok2_libmerged	756113	756150		YPO_RS04445	37
Gok2_libmerged	756508	756530		YPO_RS04450	22
Gok2_libmerged	756567	756650		YPO_RS04450	83
Gok2_libmerged	756694	756709		YPO_RS04450	15
Gok2_libmerged	756909	756920		YPO_RS04455	11
Gok2_libmerged	757311	757343		YPO_RS04455	32
Gok2_libmerged	758043	758051		YPO_RS04460	8
Gok2_libmerged	758430	758652		YPO_RS04465	222
Gok2_libmerged	759598	759647		YPO_RS04465	49
Gok2_libmerged	759891	759899		YPO_RS04465	8
Gok2_libmerged	759934	759949		YPO_RS04465	15
Gok2_libmerged	760070	760078		YPO_RS04465	8
Gok2_libmerged	760206	760232		YPO_RS04465	26
Gok2_libmerged	760708	760718		YPO_RS04465	10
Gok2_libmerged	760997	761085		YPO_RS04470	88
Gok2_libmerged	761927	762051		YPO_RS04475	124
Gok2_libmerged	762165	762176		YPO_RS04475	11
Gok2_libmerged	762226	762250		YPO_RS04475	24
Gok2_libmerged	762367	762396		YPO_RS04475	29
Gok2_libmerged	762653	762655		YPO_RS04475	2
Gok2_libmerged	762990	763003		fepB	13
Gok2_libmerged	763098	763251		fepB	153
Gok2_libmerged	763308	763315		fepB	7
Gok2_libmerged	763601	763621		fepB	20
Gok2_libmerged	763800	763900		fepB	100
Gok2_libmerged	764015	764069		fepB	54
Gok2_libmerged	764925	764967		YPO_RS04485	42
Gok2_libmerged	765018	765020		YPO_RS04485	2
Gok2_libmerged	765109	765115		YPO_RS04485	6
Gok2_libmerged	765503	765518		YPO_RS04485	15
Gok2_libmerged	765681	765697		YPO_RS04485	16
Gok2_libmerged	765762	765920		YPO_RS04485	158
Gok2_libmerged	766099	766100		YPO_RS04490	1
Gok2_libmerged	766181	766202		YPO_RS04490	21
Gok2_libmerged	766288	766370		YPO_RS04490	82
Gok2_libmerged	769194	769220		flhB	26
Gok2_libmerged	769340	769369		flhB	29
Gok2_libmerged	769445	769491		flhB	46
Gok2_libmerged	769622	769653		flhB	31
Gok2_libmerged	769874	769910		flhB	36
Gok2_libmerged	770149	770159		YPO_RS04505	10
Gok2_libmerged	770330	770364		YPO_RS04505	34
Gok2_libmerged	770514	770563		YPO_RS04505	49
Gok2_libmerged	771042	771045		fliQ	3
Gok2_libmerged	771156	771180		fliP	24
Gok2_libmerged	771558	771562		fliP	4
Gok2_libmerged	772130	772177		fliN	47
Gok2_libmerged	772307	772320		YPO_RS04525	13
Gok2_libmerged	772394	772400		YPO_RS04525	6
Gok2_libmerged	772531	772626		YPO_RS04525	95
Gok2_libmerged	772798	772848		YPO_RS04525	50
Gok2_libmerged	772900	773013		YPO_RS04525	113
Gok2_libmerged	773062	773136		YPO_RS04525	74
Gok2_libmerged	773831	773861		YPO_RS04530	30
Gok2_libmerged	774076	774117		YPO_RS04530	41
Gok2_libmerged	774251	774255		YPO_RS04530	4
Gok2_libmerged	774704	774706		fliE	2
Gok2_libmerged	774855	774903		fliE	48
Gok2_libmerged	775264	775310		fliF	46
Gok2_libmerged	775384	775409		fliF	25
Gok2_libmerged	775863	775918		fliF	55
Gok2_libmerged	776572	776584		fliF	12
Gok2_libmerged	776690	776713		fliF	23
Gok2_libmerged	776706	776713		YPO_RS04545	7
Gok2_libmerged	776799	776879		YPO_RS04545	80
Gok2_libmerged	777206	777253		YPO_RS04545	47
Gok2_libmerged	777494	777510		YPO_RS04545	16
Gok2_libmerged	778061	778079		YPO_RS04550	18
Gok2_libmerged	778150	778157		YPO_RS04550	7
Gok2_libmerged	778521	778550		fliI	29
Gok2_libmerged	779024	779029		fliI	5
Gok2_libmerged	779203	779225		fliI	22
Gok2_libmerged	779556	779562		fliI	6
Gok2_libmerged	779659	779668		fliI	9
Gok2_libmerged	779712	779737		fliI	25
Gok2_libmerged	781742	781750		flgA	8
Gok2_libmerged	781979	782029		flgA	50
Gok2_libmerged	782292	782293		flgA	1
Gok2_libmerged	782351	782360		flgB	9
Gok2_libmerged	782418	782427		flgB	9
Gok2_libmerged	782515	782531		flgB	16
Gok2_libmerged	782637	782797		flgB	160
Gok2_libmerged	782800	782801		flgC	1
Gok2_libmerged	783877	783884		flgD	7
Gok2_libmerged	783939	783972		flaE	33
Gok2_libmerged	784313	784323		flaE	10
Gok2_libmerged	784378	784387		flaE	9
Gok2_libmerged	784442	784464		flaE	22
Gok2_libmerged	784577	784611		flaE	34
Gok2_libmerged	784880	784895		flaE	15
Gok2_libmerged	785005	785019		flaE	14
Gok2_libmerged	785283	785334		YPO_RS04600	51
Gok2_libmerged	786029	786053		flgF	24
Gok2_libmerged	786091	786101		flgF	10
Gok2_libmerged	786605	786608		flgF	3
Gok2_libmerged	786690	786697		flgG	7
Gok2_libmerged	786959	786966		flgG	7
Gok2_libmerged	787871	787892		flgH	21
Gok2_libmerged	788007	788025		flgH	18
Gok2_libmerged	788222	788227		YPO_RS04625	5
Gok2_libmerged	788690	788764		YPO_RS04625	74
Gok2_libmerged	789948	789998		flgK	50
Gok2_libmerged	790196	790321		flgK	125
Gok2_libmerged	790365	790434		flgK	69
Gok2_libmerged	790801	790811		flgK	10
Gok2_libmerged	791000	791082		flgK	82
Gok2_libmerged	791337	791380		flgL	43
Gok2_libmerged	791447	791473		flgL	26
Gok2_libmerged	791617	791683		flgL	66
Gok2_libmerged	791841	791854		flgL	13
Gok2_libmerged	792041	792075		flgL	34
Gok2_libmerged	792747	792756		YPO_RS04645	9
Gok2_libmerged	793093	793118		YPO_RS04645	25
Gok2_libmerged	793484	793533		YPO_RS04650	49
Gok2_libmerged	793708	793718		YPO_RS04650	10
Gok2_libmerged	793709	793718		YPO_RS04655	9
Gok2_libmerged	793866	793915		YPO_RS04655	49
Gok2_libmerged	794223	794227		YPO_RS04655	4
Gok2_libmerged	794372	794392		YPO_RS04655	20
Gok2_libmerged	794659	794755		YPO_RS04655	96
Gok2_libmerged	796061	796130		YPO_RS04660	69
Gok2_libmerged	799570	799618		YPO_RS04670	48
Gok2_libmerged	800071	800176		fliD	105
Gok2_libmerged	800343	800466		fliD	123
Gok2_libmerged	800797	800815		fliD	18
Gok2_libmerged	800990	801079		fliD	89
Gok2_libmerged	801166	801294		fliD	128
Gok2_libmerged	801304	801361		fliS	57
Gok2_libmerged	801424	801528		fliS	104
Gok2_libmerged	801744	801759		YPO_RS04685	15
Gok2_libmerged	801986	801992		YPO_RS04685	6
Gok2_libmerged	802355	802377		YPO_RS04690	22
Gok2_libmerged	802426	802439		YPO_RS04690	13
Gok2_libmerged	802550	802593		YPO_RS04690	43
Gok2_libmerged	802858	802969		YPO_RS04690	111
Gok2_libmerged	803025	803028		YPO_RS04690	3
Gok2_libmerged	803084	803086		YPO_RS04690	2
Gok2_libmerged	803173	803187		YPO_RS04690	14
Gok2_libmerged	803242	803326		YPO_RS04695	84
Gok2_libmerged	803393	803418		YPO_RS04695	25
Gok2_libmerged	803574	803578		YPO_RS04695	4
Gok2_libmerged	803670	803686		YPO_RS04695	16
Gok2_libmerged	803789	803810		YPO_RS04700	21
Gok2_libmerged	803892	803900		YPO_RS04700	8
Gok2_libmerged	804591	804598		motA	7
Gok2_libmerged	805004	805006		motA	2
Gok2_libmerged	805128	805145		motA	17
Gok2_libmerged	805612	805706		lafU	94
Gok2_libmerged	805857	805898		lafU	41
Gok2_libmerged	805986	805996		lafU	10
Gok2_libmerged	806131	806145		lafU	14
Gok2_libmerged	807018	807058		YPO_RS04715	40
Gok2_libmerged	807187	807225		YPO_RS04715	38
Gok2_libmerged	807429	807648		YPO_RS04720	219
Gok2_libmerged	807688	807691		YPO_RS04720	3
Gok2_libmerged	807690	807691		YPO_RS04725	1
Gok2_libmerged	808006	808060		YPO_RS04725	54
Gok2_libmerged	808985	809009		YPO_RS04735	24
Gok2_libmerged	809057	809173		YPO_RS04735	116
Gok2_libmerged	809224	809241		YPO_RS04735	17
Gok2_libmerged	809886	809893		YPO_RS04740	7
Gok2_libmerged	810182	810195		YPO_RS04740	13
Gok2_libmerged	811098	811114		YPO_RS04740	16
Gok2_libmerged	811182	811196		YPO_RS04740	14
Gok2_libmerged	811098	811114		YPO_RS04745	16
Gok2_libmerged	811182	811274		YPO_RS04745	92
Gok2_libmerged	811337	811374		YPO_RS04745	37
Gok2_libmerged	811454	811526		YPO_RS04745	72
Gok2_libmerged	811795	811828		YPO_RS04745	33
Gok2_libmerged	811894	811903		YPO_RS04745	9
Gok2_libmerged	812211	812249		YPO_RS04745	38
Gok2_libmerged	812875	812881		YPO_RS04750	6
Gok2_libmerged	812986	812987		YPO_RS04750	1
Gok2_libmerged	813172	813204		YPO_RS04750	32
Gok2_libmerged	813978	813981		YPO_RS04755	3
Gok2_libmerged	814089	814127		YPO_RS04755	38
Gok2_libmerged	814217	814266		YPO_RS04755	49
Gok2_libmerged	814319	814371		YPO_RS04755	52
Gok2_libmerged	814418	814431		YPO_RS04755	13
Gok2_libmerged	816376	816436		YPO_RS04765	60
Gok2_libmerged	816548	816559		YPO_RS04765	11
Gok2_libmerged	816595	816624		YPO_RS04765	29
Gok2_libmerged	816671	816737		YPO_RS04765	66
Gok2_libmerged	816971	817006		YPO_RS04770	35
Gok2_libmerged	817076	817109		YPO_RS04770	33
Gok2_libmerged	817197	817209		YPO_RS04770	12
Gok2_libmerged	817704	817725		YPO_RS04770	21
Gok2_libmerged	817877	817897		YPO_RS04770	20
Gok2_libmerged	818061	818079		YPO_RS04770	18
Gok2_libmerged	818126	818142		YPO_RS04770	16
Gok2_libmerged	818454	818464		YPO_RS04770	10
Gok2_libmerged	819073	819078		YPO_RS04770	5
Gok2_libmerged	819297	819325		YPO_RS04770	28
Gok2_libmerged	819494	819543		YPO_RS04770	49
Gok2_libmerged	820056	820063		YPO_RS04770	7
Gok2_libmerged	820500	820503		YPO_RS04770	3
Gok2_libmerged	820620	820638		YPO_RS04770	18
Gok2_libmerged	820705	820706		YPO_RS04770	1
Gok2_libmerged	821087	821092		YPO_RS04770	5
Gok2_libmerged	822543	822567		vgrG	24
Gok2_libmerged	822821	823071		vgrG	250
Gok2_libmerged	823327	823328		vgrG	1
Gok2_libmerged	824758	824768		vgrG	10
Gok2_libmerged	830230	830241		gntP	11
Gok2_libmerged	830484	830519		gntP	35
Gok2_libmerged	830562	830585		gntP	23
Gok2_libmerged	830725	830752		gntP	27
Gok2_libmerged	830827	830831		gntP	4
Gok2_libmerged	831121	831144		gntP	23
Gok2_libmerged	831417	831436		gntP	19
Gok2_libmerged	833016	833025		YPO_RS04795	9
Gok2_libmerged	833175	833196		YPO_RS04795	21
Gok2_libmerged	833235	833244		YPO_RS04795	9
Gok2_libmerged	833291	833351		YPO_RS04795	60
Gok2_libmerged	834105	834135		YPO_RS04800	30
Gok2_libmerged	834323	834327		YPO_RS04800	4
Gok2_libmerged	835125	835186		YPO_RS04805	61
Gok2_libmerged	835312	835316		YPO_RS04805	4
Gok2_libmerged	835360	835376		YPO_RS04805	16
Gok2_libmerged	835458	835461		YPO_RS04805	3
Gok2_libmerged	835494	835515		YPO_RS04805	21
Gok2_libmerged	835604	835628		YPO_RS04805	24
Gok2_libmerged	835736	835817		YPO_RS04805	81
Gok2_libmerged	835958	835985		YPO_RS04805	27
Gok2_libmerged	836178	836215		YPO_RS04805	37
Gok2_libmerged	836348	836350		YPO_RS04805	2
Gok2_libmerged	836395	836428		YPO_RS04805	33
Gok2_libmerged	836615	836677		YPO_RS04805	62
Gok2_libmerged	836753	836790		YPO_RS04805	37
Gok2_libmerged	836783	836814		YPO_RS04810	31
Gok2_libmerged	837547	837560		YPO_RS04810	13
Gok2_libmerged	837616	837670		YPO_RS04810	54
Gok2_libmerged	837734	837784		YPO_RS04810	50
Gok2_libmerged	837863	837907		YPO_RS04810	44
Gok2_libmerged	838286	838292		YPO_RS04810	6
Gok2_libmerged	838357	838361		YPO_RS04810	4
Gok2_libmerged	838666	838692		YPO_RS04815	26
Gok2_libmerged	838782	838844		YPO_RS04815	62
Gok2_libmerged	838933	838966		YPO_RS04815	33
Gok2_libmerged	839076	839123		YPO_RS04815	47
Gok2_libmerged	839495	839529		YPO_RS04815	34
Gok2_libmerged	839809	839856		YPO_RS04815	47
Gok2_libmerged	839849	839856		YPO_RS04820	7
Gok2_libmerged	840206	840218		YPO_RS04820	12
Gok2_libmerged	840489	840494		YPO_RS04820	5
Gok2_libmerged	840678	840734		YPO_RS04825	56
Gok2_libmerged	840782	840787		YPO_RS04825	5
Gok2_libmerged	841019	841067		YPO_RS04825	48
Gok2_libmerged	841369	841500		YPO_RS04825	131
Gok2_libmerged	841793	841842		YPO_RS04830	49
Gok2_libmerged	841986	842020		YPO_RS04830	34
Gok2_libmerged	842065	842094		YPO_RS04830	29
Gok2_libmerged	842138	842139		YPO_RS04830	1
Gok2_libmerged	842752	842777		YPO_RS04830	25
Gok2_libmerged	842822	842857		YPO_RS04835	35
Gok2_libmerged	843134	843156		YPO_RS04835	22
Gok2_libmerged	843494	843528		YPO_RS04835	34
Gok2_libmerged	843596	843601		YPO_RS04835	5
Gok2_libmerged	844063	844069		YPO_RS04835	6
Gok2_libmerged	844112	844137		YPO_RS04835	25
Gok2_libmerged	844224	844239		YPO_RS04835	15
Gok2_libmerged	844481	844484		YPO_RS04835	3
Gok2_libmerged	844784	844788		YPO_RS04835	4
Gok2_libmerged	844855	844877		YPO_RS04835	22
Gok2_libmerged	844925	844950		YPO_RS04835	25
Gok2_libmerged	845321	845333		YPO_RS04835	12
Gok2_libmerged	845563	845586		YPO_RS04835	23
Gok2_libmerged	845636	845642		YPO_RS04835	6
Gok2_libmerged	845832	845849		YPO_RS04835	17
Gok2_libmerged	845950	845966		YPO_RS04835	16
Gok2_libmerged	846935	846952		YPO_RS04835	17
Gok2_libmerged	846996	847006		YPO_RS04835	10
Gok2_libmerged	847085	847116		YPO_RS04835	31
Gok2_libmerged	847197	847258		YPO_RS04835	61
Gok2_libmerged	847552	847554		YPO_RS04835	2
Gok2_libmerged	848026	848138		YPO_RS04835	112
Gok2_libmerged	848219	848249		YPO_RS04835	30
Gok2_libmerged	848290	848301		YPO_RS04835	11
Gok2_libmerged	848530	848556		YPO_RS04835	26
Gok2_libmerged	848635	848655		YPO_RS04840	20
Gok2_libmerged	849164	849182		YPO_RS04840	18
Gok2_libmerged	849274	849286		YPO_RS04840	12
Gok2_libmerged	849976	849979		YPO_RS04840	3
Gok2_libmerged	850015	850018		YPO_RS04840	3
Gok2_libmerged	850310	850323		YPO_RS04840	13
Gok2_libmerged	850331	850338		YPO_RS04845	7
Gok2_libmerged	850908	850960		YPO_RS04845	52
Gok2_libmerged	851034	851109		YPO_RS04845	75
Gok2_libmerged	851218	851229		YPO_RS04845	11
Gok2_libmerged	851337	851423		YPO_RS04845	86
Gok2_libmerged	851603	851618		YPO_RS04845	15
Gok2_libmerged	852304	852314		YPO_RS04845	10
Gok2_libmerged	852403	852422		YPO_RS04845	19
Gok2_libmerged	852694	852758		YPO_RS04845	64
Gok2_libmerged	852915	852934		YPO_RS04845	19
Gok2_libmerged	853272	853293		YPO_RS04845	21
Gok2_libmerged	853752	853760		YPO_RS04845	8
Gok2_libmerged	854320	854368		YPO_RS04845	48
Gok2_libmerged	854822	854841		YPO_RS04845	19
Gok2_libmerged	855061	855075		YPO_RS04845	14
Gok2_libmerged	855123	855175		YPO_RS04845	52
Gok2_libmerged	855580	855588		YPO_RS04845	8
Gok2_libmerged	855776	855782		YPO_RS04845	6
Gok2_libmerged	856115	856131		YPO_RS04845	16
Gok2_libmerged	856190	856205		YPO_RS04845	15
Gok2_libmerged	856236	856257		YPO_RS04845	21
Gok2_libmerged	856531	856545		YPO_RS04845	14
Gok2_libmerged	856655	856703		YPO_RS04845	48
Gok2_libmerged	857275	857299		YPO_RS04850	24
Gok2_libmerged	857338	857340		YPO_RS04850	2
Gok2_libmerged	857389	857421		YPO_RS04850	32
Gok2_libmerged	857477	857494		YPO_RS04850	17
Gok2_libmerged	857544	857561		YPO_RS04850	17
Gok2_libmerged	857731	857752		YPO_RS04850	21
Gok2_libmerged	857918	857946		YPO_RS04855	28
Gok2_libmerged	858271	858274		YPO_RS04855	3
Gok2_libmerged	858410	858418		YPO_RS04855	8
Gok2_libmerged	858508	858512		YPO_RS04855	4
Gok2_libmerged	858759	858798		YPO_RS04855	39
Gok2_libmerged	859532	859593		thyA	61
Gok2_libmerged	860295	860298		thyA	3
Gok2_libmerged	860887	860970		lgt	83
Gok2_libmerged	861061	861065		lgt	4
Gok2_libmerged	861448	861454		ptsP	6
Gok2_libmerged	861559	861576		ptsP	17
Gok2_libmerged	861811	861860		ptsP	49
Gok2_libmerged	862465	862486		ptsP	21
Gok2_libmerged	863443	863470		ptsP	27
Gok2_libmerged	863517	863548		ptsP	31
Gok2_libmerged	863768	863838		rppH	70
Gok2_libmerged	863897	863952		rppH	55
Gok2_libmerged	864154	864171		rppH	17
Gok2_libmerged	864925	864965		mutH	40
Gok2_libmerged	865256	865279		mutH	23
Gok2_libmerged	865444	865446		mutH	2
Gok2_libmerged	865946	865980		YPO_RS04890	34
Gok2_libmerged	866212	866221		YPO_RS04890	9
Gok2_libmerged	866573	866601		YPO_RS04890	28
Gok2_libmerged	866974	866986		YPO_RS04890	12
Gok2_libmerged	867451	867485		YPO_RS04895	34
Gok2_libmerged	867693	867926		YPO_RS04900	233
Gok2_libmerged	868415	868453		lplT	38
Gok2_libmerged	868692	868756		lplT	64
Gok2_libmerged	868925	868926		lplT	1
Gok2_libmerged	868995	869030		lplT	35
Gok2_libmerged	869133	869136		lplT	3
Gok2_libmerged	869237	869255		aas	18
Gok2_libmerged	869439	869443		aas	4
Gok2_libmerged	869523	869528		aas	5
Gok2_libmerged	869621	869638		aas	17
Gok2_libmerged	870254	870258		aas	4
Gok2_libmerged	870327	870346		aas	19
Gok2_libmerged	870888	870889		aas	1
Gok2_libmerged	871060	871156		aas	96
Gok2_libmerged	871321	871328		aas	7
Gok2_libmerged	871922	871976		YPO_RS04915	54
Gok2_libmerged	872051	872084		YPO_RS04915	33
Gok2_libmerged	872136	872140		YPO_RS04915	4
Gok2_libmerged	872189	872208		YPO_RS04915	19
Gok2_libmerged	872283	872284		YPO_RS04915	1
Gok2_libmerged	872421	872427		YPO_RS04915	6
Gok2_libmerged	872729	872740		YPO_RS04915	11
Gok2_libmerged	872907	872923		YPO_RS04915	16
Gok2_libmerged	872995	872999		YPO_RS04915	4
Gok2_libmerged	873048	873052		YPO_RS04915	4
Gok2_libmerged	873597	873607		YPO_RS04915	10
Gok2_libmerged	873655	873664		YPO_RS04915	9
Gok2_libmerged	873716	873720		YPO_RS04915	4
Gok2_libmerged	873758	873763		YPO_RS04915	5
Gok2_libmerged	873878	873900		YPO_RS04915	22
Gok2_libmerged	874734	874787		galR	53
Gok2_libmerged	875540	875543		lysA	3
Gok2_libmerged	875833	875840		lysA	7
Gok2_libmerged	876157	876193		lysA	36
Gok2_libmerged	876889	876892		YPO_RS04930	3
Gok2_libmerged	877103	877111		YPO_RS04930	8
Gok2_libmerged	877157	877163		YPO_RS04930	6
Gok2_libmerged	877260	877263		YPO_RS04930	3
Gok2_libmerged	877448	877451		YPO_RS04930	3
Gok2_libmerged	877583	877689		YPO_RS04930	106
Gok2_libmerged	877891	877923		YPO_RS04935	32
Gok2_libmerged	878563	878567		YPO_RS04935	4
Gok2_libmerged	878675	878685		YPO_RS04935	10
Gok2_libmerged	878935	878942		YPO_RS04935	7
Gok2_libmerged	879434	879491		YPO_RS04940	57
Gok2_libmerged	879531	879635		YPO_RS04940	104
Gok2_libmerged	880044	880072		YPO_RS04940	28
Gok2_libmerged	880109	880136		YPO_RS04940	27
Gok2_libmerged	880502	880533		YPO_RS04945	31
Gok2_libmerged	880681	880722		YPO_RS04945	41
Gok2_libmerged	880888	880909		YPO_RS04945	21
Gok2_libmerged	881338	881361		YPO_RS04950	23
Gok2_libmerged	881395	881401		YPO_RS04950	6
Gok2_libmerged	881605	881612		YPO_RS04950	7
Gok2_libmerged	881708	881742		YPO_RS04950	34
Gok2_libmerged	882326	882363		YPO_RS04955	37
Gok2_libmerged	882492	882528		YPO_RS04955	36
Gok2_libmerged	882773	882796		YPO_RS04955	23
Gok2_libmerged	883181	883210		YPO_RS04955	29
Gok2_libmerged	883254	883281		YPO_RS04955	27
Gok2_libmerged	883354	883383		YPO_RS04955	29
Gok2_libmerged	883438	883635		YPO_RS04955	197
Gok2_libmerged	883869	883996		YPO_RS04960	127
Gok2_libmerged	884089	884094		YPO_RS04960	5
Gok2_libmerged	884246	884488		YPO_RS04965	242
Gok2_libmerged	884543	884616		YPO_RS04965	73
Gok2_libmerged	884681	884690		YPO_RS04965	9
Gok2_libmerged	884856	884907		YPO_RS04965	51
Gok2_libmerged	885548	885552		YPO_RS04975	4
Gok2_libmerged	885627	885798		YPO_RS04975	171
Gok2_libmerged	886024	886240		YPO_RS04975	216
Gok2_libmerged	886444	886777		YPO_RS04980	333
Gok2_libmerged	886917	887106		gspL	189
Gok2_libmerged	887259	887264		gspL	5
Gok2_libmerged	887348	887370		gspL	22
Gok2_libmerged	887503	887592		gspL	89
Gok2_libmerged	887734	887785		gspL	51
Gok2_libmerged	887816	887983		gspL	167
Gok2_libmerged	888075	888156		YPO_RS04990	81
Gok2_libmerged	888250	888302		YPO_RS04990	52
Gok2_libmerged	888479	888545		YPO_RS04990	66
Gok2_libmerged	888578	888833		YPO_RS04990	255
Gok2_libmerged	888932	889004		YPO_RS04990	72
Gok2_libmerged	889013	889124		gspJ	111
Gok2_libmerged	889168	889532		gspJ	364
Gok2_libmerged	889662	889667		gspI	5
Gok2_libmerged	889912	889970		gspI	58
Gok2_libmerged	889984	890010		YPO_RS05005	26
Gok2_libmerged	890120	890270		YPO_RS05005	150
Gok2_libmerged	890303	890347		YPO_RS05005	44
Gok2_libmerged	890437	890471		YPO_RS05005	34
Gok2_libmerged	890553	890601		gspG	48
Gok2_libmerged	892380	892386		gspE	6
Gok2_libmerged	892551	892567		gspE	16
Gok2_libmerged	892795	892844		gspE	49
Gok2_libmerged	892962	893039		gspE	77
Gok2_libmerged	893144	893244		gspE	100
Gok2_libmerged	893337	893375		gspE	38
Gok2_libmerged	893623	893687		gspE	64
Gok2_libmerged	893684	894075		gspD	391
Gok2_libmerged	894323	894335		gspD	12
Gok2_libmerged	894428	894490		gspD	62
Gok2_libmerged	894598	894608		gspD	10
Gok2_libmerged	894801	894810		gspD	9
Gok2_libmerged	894865	894945		gspD	80
Gok2_libmerged	895198	895229		gspD	31
Gok2_libmerged	895364	895387		gspD	23
Gok2_libmerged	895451	895606		gspD	155
Gok2_libmerged	895687	895838		YPO_RS05030	151
Gok2_libmerged	895887	895898		YPO_RS05030	11
Gok2_libmerged	896052	896190		YPO_RS05030	138
Gok2_libmerged	896258	896370		YPO_RS05035	112
Gok2_libmerged	896410	896568		YPO_RS05035	158
Gok2_libmerged	896663	896674		YPO_RS05035	11
Gok2_libmerged	897417	897605		YPO_RS05040	188
Gok2_libmerged	897708	897719		YPO_RS05040	11
Gok2_libmerged	897814	897828		YPO_RS05040	14
Gok2_libmerged	898007	898062		YPO_RS05040	55
Gok2_libmerged	899459	899479		YPO_RS05050	20
Gok2_libmerged	899863	899881		YPO_RS05050	18
Gok2_libmerged	900045	900069		YPO_RS05050	24
Gok2_libmerged	900282	900323		YPO_RS05050	41
Gok2_libmerged	900400	900409		YPO_RS05050	9
Gok2_libmerged	900524	900530		yapM	6
Gok2_libmerged	900701	900748		yapM	47
Gok2_libmerged	900815	900872		yapM	57
Gok2_libmerged	900929	900935		yapM	6
Gok2_libmerged	901021	901036		yapM	15
Gok2_libmerged	901149	901176		yapM	27
Gok2_libmerged	901295	901328		yapM	33
Gok2_libmerged	901616	901618		yapM	2
Gok2_libmerged	902031	902100		yapM	69
Gok2_libmerged	902184	902227		yapM	43
Gok2_libmerged	902329	902339		yapM	10
Gok2_libmerged	902417	902421		yapM	4
Gok2_libmerged	902671	902707		yapM	36
Gok2_libmerged	902798	902822		YPO_RS05060	24
Gok2_libmerged	903179	903189		YPO_RS05060	10
Gok2_libmerged	903380	903398		YPO_RS05060	18
Gok2_libmerged	903552	903628		YPO_RS05060	76
Gok2_libmerged	903725	903752		YPO_RS05060	27
Gok2_libmerged	903833	903838		YPO_RS05060	5
Gok2_libmerged	903900	903960		YPO_RS05060	60
Gok2_libmerged	904386	904403		YPO_RS05060	17
Gok2_libmerged	904457	904464		YPO_RS05060	7
Gok2_libmerged	904853	904870		YPO_RS05060	17
Gok2_libmerged	904928	904947		YPO_RS05060	19
Gok2_libmerged	905534	905545		YPO_RS05060	11
Gok2_libmerged	905623	905624		YPO_RS05060	1
Gok2_libmerged	906238	906286		YPO_RS05065	48
Gok2_libmerged	906605	906636		YPO_RS05065	31
Gok2_libmerged	906712	906720		YPO_RS05065	8
Gok2_libmerged	906837	906909		YPO_RS05065	72
Gok2_libmerged	907027	907070		YPO_RS05070	43
Gok2_libmerged	907480	907498		YPO_RS05070	18
Gok2_libmerged	907543	907604		YPO_RS05070	61
Gok2_libmerged	907867	907944		YPO_RS05070	77
Gok2_libmerged	908102	908126		tnpA	24
Gok2_libmerged	908292	908298		tnpA	6
Gok2_libmerged	908373	908431		tnpA	58
Gok2_libmerged	909253	909272		YPO_RS05080	19
Gok2_libmerged	909561	909617		YPO_RS05080	56
Gok2_libmerged	909682	909727		YPO_RS05080	45
Gok2_libmerged	909872	909877		YPO_RS05080	5
Gok2_libmerged	909950	909958		YPO_RS05080	8
Gok2_libmerged	910129	910166		YPO_RS05080	37
Gok2_libmerged	910255	910277		YPO_RS05080	22
Gok2_libmerged	910360	910389		YPO_RS05080	29
Gok2_libmerged	911484	911508		YPO_RS05085	24
Gok2_libmerged	911792	911844		YPO_RS05085	52
Gok2_libmerged	911911	911923		YPO_RS05085	12
Gok2_libmerged	912201	912244		kbaZ	43
Gok2_libmerged	912331	912347		kbaZ	16
Gok2_libmerged	912501	912508		kbaZ	7
Gok2_libmerged	913108	913126		kbaZ	18
Gok2_libmerged	913896	913951		YPO_RS05095	55
Gok2_libmerged	914152	914192		YPO_RS05095	40
Gok2_libmerged	914278	914281		YPO_RS05095	3
Gok2_libmerged	914459	914475		YPO_RS05095	16
Gok2_libmerged	914757	914782		YPO_RS05100	25
Gok2_libmerged	915423	915430		YPO_RS05105	7
Gok2_libmerged	915494	915553		YPO_RS05105	59
Gok2_libmerged	915647	915670		YPO_RS05105	23
Gok2_libmerged	915830	915878		YPO_RS05105	48
Gok2_libmerged	915948	916012		YPO_RS05105	64
Gok2_libmerged	916002	916015		YPO_RS05110	13
Gok2_libmerged	916611	916614		YPO_RS05110	3
Gok2_libmerged	916660	916672		YPO_RS05110	12
Gok2_libmerged	917072	917100		YPO_RS05115	28
Gok2_libmerged	917427	917462		nagA	35
Gok2_libmerged	917619	917666		nagA	47
Gok2_libmerged	917822	917882		nagA	60
Gok2_libmerged	918020	918021		nagA	1
Gok2_libmerged	918242	918252		nagA	10
Gok2_libmerged	918286	918332		nagA	46
Gok2_libmerged	919119	919143		kduD	24
Gok2_libmerged	919421	919432		kduD	11
Gok2_libmerged	920351	920357		YPO_RS05130	6
Gok2_libmerged	920909	920920		YPO_RS05135	11
Gok2_libmerged	921130	921136		YPO_RS05135	6
Gok2_libmerged	921227	921280		YPO_RS05135	53
Gok2_libmerged	921580	921617		YPO_RS05135	37
Gok2_libmerged	921839	921847		YPO_RS05135	8
Gok2_libmerged	921959	922082		YPO_RS05135	123
Gok2_libmerged	922480	922514		YPO_RS05140	34
Gok2_libmerged	922803	922821		YPO_RS05140	18
Gok2_libmerged	922934	923030		YPO_RS05140	96
Gok2_libmerged	923106	923109		YPO_RS05140	3
Gok2_libmerged	923405	923462		YPO_RS05140	57
Gok2_libmerged	923558	923566		YPO_RS05140	8
Gok2_libmerged	923841	923859		YPO_RS05145	18
Gok2_libmerged	923890	923938		YPO_RS05145	48
Gok2_libmerged	923982	923984		YPO_RS05145	2
Gok2_libmerged	924179	924219		YPO_RS05145	40
Gok2_libmerged	924546	924582		YPO_RS05145	36
Gok2_libmerged	924808	924811		YPO_RS05145	3
Gok2_libmerged	925053	925112		YPO_RS05145	59
Gok2_libmerged	925754	925790		YPO_RS05150	36
Gok2_libmerged	926386	926406		YPO_RS05155	20
Gok2_libmerged	926708	926720		YPO_RS05155	12
Gok2_libmerged	926869	926885		YPO_RS05155	16
Gok2_libmerged	927126	927140		YPO_RS05160	14
Gok2_libmerged	927206	927209		YPO_RS05160	3
Gok2_libmerged	927630	927673		YPO_RS05160	43
Gok2_libmerged	927958	927961		YPO_RS05160	3
Gok2_libmerged	928183	928208		YPO_RS05160	25
Gok2_libmerged	928724	928761		YPO_RS05165	37
Gok2_libmerged	929141	929204		YPO_RS05165	63
Gok2_libmerged	929397	929444		YPO_RS05165	47
Gok2_libmerged	929815	929826		YPO_RS05165	11
Gok2_libmerged	930060	930149		YPO_RS05170	89
Gok2_libmerged	930203	930214		YPO_RS05170	11
Gok2_libmerged	930578	930587		YPO_RS05170	9
Gok2_libmerged	930706	930708		YPO_RS05170	2
Gok2_libmerged	930798	930823		YPO_RS05170	25
Gok2_libmerged	931296	931354		YPO_RS05170	58
Gok2_libmerged	931537	931567		YPO_RS05170	30
Gok2_libmerged	931837	931941		YPO_RS05170	104
Gok2_libmerged	932898	932905		YPO_RS05175	7
Gok2_libmerged	933293	933311		YPO_RS05175	18
Gok2_libmerged	933385	933417		YPO_RS05175	32
Gok2_libmerged	933490	933576		YPO_RS05175	86
Gok2_libmerged	934145	934155		YPO_RS05180	10
Gok2_libmerged	934477	934482		YPO_RS05180	5
Gok2_libmerged	934601	934603		YPO_RS05180	2
Gok2_libmerged	934668	934677		YPO_RS05180	9
Gok2_libmerged	934844	934846		YPO_RS05180	2
Gok2_libmerged	935008	935018		YPO_RS05180	10
Gok2_libmerged	935120	935160		YPO_RS05180	40
Gok2_libmerged	935266	935334		YPO_RS05180	68
Gok2_libmerged	935741	935781		YPO_RS05185	40
Gok2_libmerged	935914	936006		YPO_RS05185	92
Gok2_libmerged	937045	937059		YPO_RS05190	14
Gok2_libmerged	937406	937472		YPO_RS05190	66
Gok2_libmerged	937867	937887		YPO_RS05190	20
Gok2_libmerged	937979	937996		YPO_RS05190	17
Gok2_libmerged	938275	938388		YPO_RS05195	113
Gok2_libmerged	938428	938485		YPO_RS05195	57
Gok2_libmerged	938835	938839		YPO_RS05195	4
Gok2_libmerged	938978	939036		YPO_RS05195	58
Gok2_libmerged	939637	939666		YPO_RS05200	29
Gok2_libmerged	939732	939814		YPO_RS05200	82
Gok2_libmerged	939967	940109		YPO_RS05200	142
Gok2_libmerged	940252	940333		YPO_RS05200	81
Gok2_libmerged	940345	940351		YPO_RS05205	6
Gok2_libmerged	940447	940448		YPO_RS05205	1
Gok2_libmerged	940572	940642		YPO_RS05205	70
Gok2_libmerged	940758	940827		YPO_RS05205	69
Gok2_libmerged	940970	940989		YPO_RS05205	19
Gok2_libmerged	941096	941178		YPO_RS05205	82
Gok2_libmerged	941545	941571		YPO_RS05205	26
Gok2_libmerged	941966	941986		YPO_RS05210	20
Gok2_libmerged	942068	942097		YPO_RS05210	29
Gok2_libmerged	942146	942151		YPO_RS05210	5
Gok2_libmerged	942526	942528		YPO_RS05210	2
Gok2_libmerged	943045	943047		YPO_RS05210	2
Gok2_libmerged	943419	943429		YPO_RS05215	10
Gok2_libmerged	943459	943473		YPO_RS05215	14
Gok2_libmerged	943619	943647		YPO_RS05215	28
Gok2_libmerged	943680	943690		YPO_RS05215	10
Gok2_libmerged	943741	943775		YPO_RS05215	34
Gok2_libmerged	943968	944009		YPO_RS05215	41
Gok2_libmerged	944179	944238		YPO_RS05215	59
Gok2_libmerged	944352	944367		YPO_RS05215	15
Gok2_libmerged	944446	944510		YPO_RS05215	64
Gok2_libmerged	945059	945155		YPO_RS05220	96
Gok2_libmerged	945267	945268		YPO_RS05220	1
Gok2_libmerged	945724	945727		YPO_RS05220	3
Gok2_libmerged	946026	946179		YPO_RS05220	153
Gok2_libmerged	946340	946363		YPO_RS05220	23
Gok2_libmerged	947186	947203		YPO_RS05225	17
Gok2_libmerged	947599	947601		YPO_RS05225	2
Gok2_libmerged	948156	948259		YPO_RS05230	103
Gok2_libmerged	948323	948350		YPO_RS05230	27
Gok2_libmerged	948723	948734		YPO_RS05230	11
Gok2_libmerged	950100	950185		YPO_RS05235	85
Gok2_libmerged	950275	950360		YPO_RS05235	85
Gok2_libmerged	951509	951555		YPO_RS05240	46
Gok2_libmerged	952174	952191		YPO_RS05245	17
Gok2_libmerged	953031	953033		YPO_RS05250	2
Gok2_libmerged	953228	953252		YPO_RS05255	24
Gok2_libmerged	953638	953666		YPO_RS05260	28
Gok2_libmerged	953714	953716		YPO_RS05260	2
Gok2_libmerged	953781	953842		YPO_RS05260	61
Gok2_libmerged	954015	954104		YPO_RS05260	89
Gok2_libmerged	954148	954206		YPO_RS05260	58
Gok2_libmerged	955234	955255		YPO_RS05265	21
Gok2_libmerged	955494	955535		YPO_RS05265	41
Gok2_libmerged	955667	955693		YPO_RS05265	26
Gok2_libmerged	956039	956077		YPO_RS05270	38
Gok2_libmerged	956311	956375		YPO_RS05270	64
Gok2_libmerged	956656	956692		YPO_RS05270	36
Gok2_libmerged	956869	956871		YPO_RS05270	2
Gok2_libmerged	957360	957443		YPO_RS05270	83
Gok2_libmerged	957618	957805		YPO_RS05270	187
Gok2_libmerged	957882	957891		YPO_RS05270	9
Gok2_libmerged	958380	958386		YPO_RS05275	6
Gok2_libmerged	958463	958472		YPO_RS05275	9
Gok2_libmerged	958591	958601		YPO_RS05275	10
Gok2_libmerged	959289	959429		YPO_RS05285	140
Gok2_libmerged	959426	959430		YPO_RS05290	4
Gok2_libmerged	959521	959631		YPO_RS05290	110
Gok2_libmerged	960334	960378		YPO_RS05290	44
Gok2_libmerged	960517	960577		YPO_RS05290	60
Gok2_libmerged	960630	960686		YPO_RS05290	56
Gok2_libmerged	961619	961663		YPO_RS05295	44
Gok2_libmerged	962039	962095		YPO_RS05295	56
Gok2_libmerged	962268	962282		YPO_RS05295	14
Gok2_libmerged	963073	963094		YPO_RS05300	21
Gok2_libmerged	963334	963388		YPO_RS05305	54
Gok2_libmerged	965203	965207		YPO_RS05330	4
Gok2_libmerged	966335	966365		YPO_RS05330	30
Gok2_libmerged	966458	966502		YPO_RS05330	44
Gok2_libmerged	967689	967895		YPO_RS05335	206
Gok2_libmerged	967933	967950		YPO_RS05335	17
Gok2_libmerged	968092	968130		YPO_RS05340	38
Gok2_libmerged	968323	968383		YPO_RS05340	60
Gok2_libmerged	968547	968549		YPO_RS05345	2
Gok2_libmerged	968658	968690		YPO_RS05345	32
Gok2_libmerged	968972	969023		YPO_RS05350	51
Gok2_libmerged	969068	969080		YPO_RS05350	12
Gok2_libmerged	970125	970146		YPO_RS05360	21
Gok2_libmerged	970415	970421		YPO_RS05360	6
Gok2_libmerged	970461	970470		YPO_RS05360	9
Gok2_libmerged	971262	971267		YPO_RS05360	5
Gok2_libmerged	971866	971879		lysS	13
Gok2_libmerged	972244	972370		lysS	126
Gok2_libmerged	973024	973086		lysS	62
Gok2_libmerged	973444	973451		prfB	7
Gok2_libmerged	973545	973570		prfB	25
Gok2_libmerged	973646	973667		prfB	21
Gok2_libmerged	974681	974690		recJ	9
Gok2_libmerged	974930	974935		recJ	5
Gok2_libmerged	976517	976540		dsbC	23
Gok2_libmerged	976676	976716		dsbC	40
Gok2_libmerged	976941	976944		dsbC	3
Gok2_libmerged	977074	977129		xerD	55
Gok2_libmerged	977551	977590		xerD	39
Gok2_libmerged	977730	977731		xerD	1
Gok2_libmerged	977831	977838		xerD	7
Gok2_libmerged	978089	978094		fldB	5
Gok2_libmerged	978127	978162		fldB	35
Gok2_libmerged	978247	978336		fldB	89
Gok2_libmerged	978430	978468		fldB	38
Gok2_libmerged	978858	978896		creD	38
Gok2_libmerged	979232	979250		creD	18
Gok2_libmerged	979531	979563		creD	32
Gok2_libmerged	979660	979707		creD	47
Gok2_libmerged	979760	979775		creD	15
Gok2_libmerged	980331	980353		creC	22
Gok2_libmerged	980412	980441		creC	29
Gok2_libmerged	980987	980991		creC	4
Gok2_libmerged	981377	981414		creC	37
Gok2_libmerged	981521	981545		creC	24
Gok2_libmerged	981885	981915		creB	30
Gok2_libmerged	981966	981967		creB	1
Gok2_libmerged	981994	981998		creB	4
Gok2_libmerged	982553	982581		YPO_RS05415	28
Gok2_libmerged	982960	982965		sdhE	5
Gok2_libmerged	983824	983878		ygfZ	54
Gok2_libmerged	983923	983958		ygfZ	35
Gok2_libmerged	984084	984140		ygfZ	56
Gok2_libmerged	984462	984464		YPO_RS05430	2
Gok2_libmerged	984637	984660		YPO_RS05430	23
Gok2_libmerged	984846	984895		YPO_RS05430	49
Gok2_libmerged	985177	985198		YPO_RS05435	21
Gok2_libmerged	985844	985853		YPO_RS05435	9
Gok2_libmerged	986192	986193		YPO_RS05440	1
Gok2_libmerged	986286	986314		YPO_RS05440	28
Gok2_libmerged	986394	986404		YPO_RS05440	10
Gok2_libmerged	986552	986597		YPO_RS05440	45
Gok2_libmerged	986756	986835		YPO_RS05440	79
Gok2_libmerged	986952	986972		YPO_RS05440	20
Gok2_libmerged	987064	987065		YPO_RS05440	1
Gok2_libmerged	990647	990680		YPO_RS05455	33
Gok2_libmerged	990766	990771		YPO_RS05455	5
Gok2_libmerged	990845	990846		YPO_RS05455	1
Gok2_libmerged	990908	990910		YPO_RS05455	2
Gok2_libmerged	991375	991406		gcvP	31
Gok2_libmerged	991492	991497		gcvP	5
Gok2_libmerged	991731	991753		gcvP	22
Gok2_libmerged	992294	992312		gcvP	18
Gok2_libmerged	993989	994003		gcvP	14
Gok2_libmerged	995026	995072		gcvT	46
Gok2_libmerged	995130	995140		gcvT	10
Gok2_libmerged	995374	995479		gcvT	105
Gok2_libmerged	995613	995629		gcvT	16
Gok2_libmerged	998847	998860		ubiH	13
Gok2_libmerged	999168	999207		ubiH	39
Gok2_libmerged	999622	999627		pepP	5
Gok2_libmerged	1000313	1000316		pepP	3
Gok2_libmerged	1000922	1000924		YPO_RS05490	2
Gok2_libmerged	1001195	1001232		YPO_RS05490	37
Gok2_libmerged	1001669	1001828		zapA	159
Gok2_libmerged	1001921	1001937		zapA	16
Gok2_libmerged	1002507	1002535		YPO_RS05505	28
Gok2_libmerged	1002872	1002897		YPO_RS05505	25
Gok2_libmerged	1003390	1003404		serA	14
Gok2_libmerged	1003793	1003815		serA	22
Gok2_libmerged	1004270	1004285		serA	15
Gok2_libmerged	1005002	1005006		rpiA	4
Gok2_libmerged	1005128	1005179		rpiA	51
Gok2_libmerged	1006240	1006270		YPO_RS05520	30
Gok2_libmerged	1006322	1006328		YPO_RS05520	6
Gok2_libmerged	1006558	1006616		YPO_RS05520	58
Gok2_libmerged	1006627	1006651		YPO_RS05525	24
Gok2_libmerged	1007338	1007343		YPO_RS05525	5
Gok2_libmerged	1007637	1007642		argO	5
Gok2_libmerged	1007773	1007792		argO	19
Gok2_libmerged	1008688	1008737		mscS	49
Gok2_libmerged	1008791	1008885		mscS	94
Gok2_libmerged	1009243	1009328		mscS	85
Gok2_libmerged	1010006	1010014		fbaA	8
Gok2_libmerged	1010189	1010233		fbaA	44
Gok2_libmerged	1010449	1010526		fbaA	77
Gok2_libmerged	1011107	1011114		pgk	7
Gok2_libmerged	1011230	1011232		pgk	2
Gok2_libmerged	1011624	1011643		pgk	19
Gok2_libmerged	1011903	1011922		pgk	19
Gok2_libmerged	1012144	1012145		pgk	1
Gok2_libmerged	1012464	1012485		epd	21
Gok2_libmerged	1012677	1012689		epd	12
Gok2_libmerged	1012749	1012782		epd	33
Gok2_libmerged	1012867	1012909		epd	42
Gok2_libmerged	1013187	1013190		epd	3
Gok2_libmerged	1013840	1013847		YPO_RS05555	7
Gok2_libmerged	1013878	1013889		YPO_RS05555	11
Gok2_libmerged	1014000	1014088		YPO_RS05555	88
Gok2_libmerged	1014165	1014180		YPO_RS05555	15
Gok2_libmerged	1014350	1014358		YPO_RS05555	8
Gok2_libmerged	1014358	1014367		YPO_RS05560	9
Gok2_libmerged	1014641	1014661		YPO_RS05560	20
Gok2_libmerged	1014853	1014911		YPO_RS05560	58
Gok2_libmerged	1014992	1015090		YPO_RS05560	98
Gok2_libmerged	1015359	1015380		YPO_RS05560	21
Gok2_libmerged	1015620	1015659		YPO_RS05565	39
Gok2_libmerged	1015795	1015804		YPO_RS05565	9
Gok2_libmerged	1015889	1015890		YPO_RS05565	1
Gok2_libmerged	1015970	1015986		YPO_RS05565	16
Gok2_libmerged	1016478	1016499		tkt	21
Gok2_libmerged	1017088	1017103		tkt	15
Gok2_libmerged	1019150	1019220		YPO_RS05575	70
Gok2_libmerged	1019898	1019909		YPO_RS05585	11
Gok2_libmerged	1020459	1020471		speA	12
Gok2_libmerged	1020684	1020717		speA	33
Gok2_libmerged	1021109	1021126		speA	17
Gok2_libmerged	1023654	1023769		metK	115
Gok2_libmerged	1023821	1023822		metK	1
Gok2_libmerged	1024034	1024038		metK	4
Gok2_libmerged	1025259	1025276		YPO_RS05600	17
Gok2_libmerged	1025337	1025382		YPO_RS05600	45
Gok2_libmerged	1026935	1026955		rsmE	20
Gok2_libmerged	1027292	1027326		gshB	34
Gok2_libmerged	1027388	1027405		gshB	17
Gok2_libmerged	1027607	1027608		gshB	1
Gok2_libmerged	1027794	1027864		gshB	70
Gok2_libmerged	1028013	1028015		gshB	2
Gok2_libmerged	1028103	1028155		gshB	52
Gok2_libmerged	1028279	1028345		YPO_RS05620	66
Gok2_libmerged	1028424	1028480		YPO_RS05620	56
Gok2_libmerged	1028797	1028834		YPO_RS05620	37
Gok2_libmerged	1028834	1028836		ruvX	2
Gok2_libmerged	1029436	1029438		aguB	2
Gok2_libmerged	1029564	1029581		aguB	17
Gok2_libmerged	1029656	1029658		aguB	2
Gok2_libmerged	1029911	1029923		aguB	12
Gok2_libmerged	1030412	1030439		aguA	27
Gok2_libmerged	1030727	1030731		aguA	4
Gok2_libmerged	1030981	1030985		aguA	4
Gok2_libmerged	1031076	1031081		aguA	5
Gok2_libmerged	1031915	1031934		YPO_RS05640	19
Gok2_libmerged	1032073	1032078		YPO_RS05640	5
Gok2_libmerged	1032195	1032319		YPO_RS05640	124
Gok2_libmerged	1032498	1032525		YPO_RS05640	27
Gok2_libmerged	1032785	1032816		YPO_RS05645	31
Gok2_libmerged	1032882	1032904		YPO_RS05645	22
Gok2_libmerged	1033341	1033373		YPO_RS05645	32
Gok2_libmerged	1033557	1033563		YPO_RS05650	6
Gok2_libmerged	1033878	1033891		YPO_RS05650	13
Gok2_libmerged	1034879	1034881		YPO_RS05655	2
Gok2_libmerged	1034969	1034971		YPO_RS05655	2
Gok2_libmerged	1035136	1035178		YPO_RS05655	42
Gok2_libmerged	1035227	1035313		YPO_RS05660	86
Gok2_libmerged	1035782	1035828		YPO_RS05665	46
Gok2_libmerged	1035942	1035947		YPO_RS05665	5
Gok2_libmerged	1036253	1036259		hemW	6
Gok2_libmerged	1036925	1036928		hemW	3
Gok2_libmerged	1037021	1037079		hemW	58
Gok2_libmerged	1037158	1037193		hemW	35
Gok2_libmerged	1037286	1037289		hemW	3
Gok2_libmerged	1037762	1037886		YPO_RS05675	124
Gok2_libmerged	1038111	1038141		YPO_RS05675	30
Gok2_libmerged	1038203	1038220		YPO_RS05675	17
Gok2_libmerged	1038275	1038287		YPO_RS05675	12
Gok2_libmerged	1038357	1038365		YPO_RS05675	8
Gok2_libmerged	1038435	1038599		YPO_RS05675	164
Gok2_libmerged	1038716	1038778		YPO_RS05675	62
Gok2_libmerged	1038958	1039039		YPO_RS05675	81
Gok2_libmerged	1039183	1039244		YPO_RS05675	61
Gok2_libmerged	1039396	1039427		YPO_RS05675	31
Gok2_libmerged	1039589	1039641		YPO_RS05675	52
Gok2_libmerged	1039728	1039904		YPO_RS05675	176
Gok2_libmerged	1039945	1040042		YPO_RS05675	97
Gok2_libmerged	1040078	1040091		YPO_RS05675	13
Gok2_libmerged	1040479	1040795		YPO_RS05675	316
Gok2_libmerged	1040836	1040872		YPO_RS05675	36
Gok2_libmerged	1040953	1041208		YPO_RS05675	255
Gok2_libmerged	1041241	1041322		YPO_RS05675	81
Gok2_libmerged	1041385	1041431		YPO_RS05675	46
Gok2_libmerged	1041463	1041497		YPO_RS05675	34
Gok2_libmerged	1041810	1041811		YPO_RS05675	1
Gok2_libmerged	1042213	1042300		YPO_RS05675	87
Gok2_libmerged	1042446	1042503		YPO_RS05675	57
Gok2_libmerged	1042579	1042616		YPO_RS05675	37
Gok2_libmerged	1042683	1042714		YPO_RS05675	31
Gok2_libmerged	1042808	1042897		YPO_RS05675	89
Gok2_libmerged	1042967	1043004		YPO_RS05675	37
Gok2_libmerged	1043073	1043093		YPO_RS05675	20
Gok2_libmerged	1043138	1043144		YPO_RS05675	6
Gok2_libmerged	1043206	1043217		YPO_RS05675	11
Gok2_libmerged	1043453	1043466		YPO_RS05675	13
Gok2_libmerged	1043569	1043991		YPO_RS05675	422
Gok2_libmerged	1044139	1044164		YPO_RS05675	25
Gok2_libmerged	1044227	1044360		YPO_RS05675	133
Gok2_libmerged	1044547	1044903		YPO_RS05675	356
Gok2_libmerged	1044982	1045144		YPO_RS05675	162
Gok2_libmerged	1045322	1045357		YPO_RS05675	35
Gok2_libmerged	1045417	1045436		YPO_RS05675	19
Gok2_libmerged	1045494	1045546		YPO_RS05675	52
Gok2_libmerged	1045617	1045762		YPO_RS05675	145
Gok2_libmerged	1045928	1045973		YPO_RS05675	45
Gok2_libmerged	1046213	1046245		YPO_RS05675	32
Gok2_libmerged	1046313	1046400		YPO_RS05675	87
Gok2_libmerged	1046661	1046664		YPO_RS05675	3
Gok2_libmerged	1046759	1046811		YPO_RS05675	52
Gok2_libmerged	1048357	1048394		glsB	37
Gok2_libmerged	1048523	1048529		glsB	6
Gok2_libmerged	1048719	1048727		glsB	8
Gok2_libmerged	1048958	1048973		glsB	15
Gok2_libmerged	1049375	1049378		YPO_RS05690	3
Gok2_libmerged	1049518	1049533		trmB	15
Gok2_libmerged	1049919	1050000		trmB	81
Gok2_libmerged	1050048	1050077		trmB	29
Gok2_libmerged	1050141	1050156		trmB	15
Gok2_libmerged	1051176	1051207		mutY	31
Gok2_libmerged	1051528	1051567		mutY	39
Gok2_libmerged	1051985	1052002		YPO_RS05705	17
Gok2_libmerged	1052323	1052342		mltC	19
Gok2_libmerged	1052440	1052488		mltC	48
Gok2_libmerged	1053066	1053171		mltC	105
Gok2_libmerged	1053257	1053274		mltC	17
Gok2_libmerged	1054288	1054291		YPO_RS05715	3
Gok2_libmerged	1054722	1054745		YPO_RS05715	23
Gok2_libmerged	1055209	1055271		YPO_RS05720	62
Gok2_libmerged	1055534	1055602		YPO_RS05720	68
Gok2_libmerged	1056138	1056140		YPO_RS05720	2
Gok2_libmerged	1056290	1056328		YPO_RS05720	38
Gok2_libmerged	1056653	1056690		YPO_RS05720	37
Gok2_libmerged	1057100	1057220		YPO_RS05725	120
Gok2_libmerged	1057958	1058002		YPO_RS05725	44
Gok2_libmerged	1058124	1058156		YPO_RS05730	32
Gok2_libmerged	1059580	1059651		YPO_RS05735	71
Gok2_libmerged	1060309	1060362		YPO_RS05735	53
Gok2_libmerged	1061161	1061173		speF	12
Gok2_libmerged	1061249	1061258		speF	9
Gok2_libmerged	1061331	1061375		speF	44
Gok2_libmerged	1061476	1061516		speF	40
Gok2_libmerged	1061912	1061935		speF	23
Gok2_libmerged	1061995	1062124		speF	129
Gok2_libmerged	1062189	1062361		speF	172
Gok2_libmerged	1062578	1062707		speF	129
Gok2_libmerged	1062745	1062760		speF	15
Gok2_libmerged	1063134	1063156		speF	22
Gok2_libmerged	1066622	1066731		YPO_RS05765	109
Gok2_libmerged	1066810	1066990		YPO_RS05765	180
Gok2_libmerged	1067172	1067234		YPO_RS05765	62
Gok2_libmerged	1067271	1067370		YPO_RS05765	99
Gok2_libmerged	1067480	1067572		YPO_RS05770	92
Gok2_libmerged	1067788	1067896		YPO_RS05770	108
Gok2_libmerged	1067964	1067978		YPO_RS05770	14
Gok2_libmerged	1068103	1068137		YPO_RS05770	34
Gok2_libmerged	1068480	1068486		YPO_RS05770	6
Gok2_libmerged	1068931	1068943		YPO_RS05770	12
Gok2_libmerged	1069296	1069351		YPO_RS05770	55
Gok2_libmerged	1069409	1069434		YPO_RS05770	25
Gok2_libmerged	1069541	1069571		YPO_RS05770	30
Gok2_libmerged	1071583	1071743		YPO_RS05785	160
Gok2_libmerged	1071907	1072063		YPO_RS05790	156
Gok2_libmerged	1072159	1072166		YPO_RS05790	7
Gok2_libmerged	1072222	1072254		YPO_RS05790	32
Gok2_libmerged	1072398	1072413		YPO_RS05795	15
Gok2_libmerged	1072488	1072490		YPO_RS05795	2
Gok2_libmerged	1072575	1072640		YPO_RS05795	65
Gok2_libmerged	1072823	1072975		YPO_RS05795	152
Gok2_libmerged	1073097	1073133		YPO_RS05795	36
Gok2_libmerged	1073247	1073266		YPO_RS05795	19
Gok2_libmerged	1073521	1073526		YPO_RS05795	5
Gok2_libmerged	1073659	1073800		YPO_RS05795	141
Gok2_libmerged	1074055	1074062		YPO_RS05795	7
Gok2_libmerged	1074485	1074490		YPO_RS05795	5
Gok2_libmerged	1074590	1074620		YPO_RS05795	30
Gok2_libmerged	1074635	1074663		YPO_RS05800	28
Gok2_libmerged	1074699	1074730		YPO_RS05800	31
Gok2_libmerged	1074949	1074950		YPO_RS05800	1
Gok2_libmerged	1075468	1075470		YPO_RS05800	2
Gok2_libmerged	1075709	1075712		YPO_RS05800	3
Gok2_libmerged	1076213	1076224		YPO_RS05800	11
Gok2_libmerged	1076263	1076288		YPO_RS05800	25
Gok2_libmerged	1077244	1077267		tssH	23
Gok2_libmerged	1077498	1077506		tssH	8
Gok2_libmerged	1077600	1077612		tssH	12
Gok2_libmerged	1079430	1079452		tssH	22
Gok2_libmerged	1079613	1079625		tssH	12
Gok2_libmerged	1080198	1080200		YPO_RS05810	2
Gok2_libmerged	1080451	1080484		YPO_RS05810	33
Gok2_libmerged	1080896	1080908		YPO_RS05815	12
Gok2_libmerged	1080987	1080996		YPO_RS05815	9
Gok2_libmerged	1081038	1081055		YPO_RS05815	17
Gok2_libmerged	1081302	1081307		YPO_RS05815	5
Gok2_libmerged	1081368	1081415		YPO_RS05815	47
Gok2_libmerged	1081509	1081529		YPO_RS05815	20
Gok2_libmerged	1081661	1081699		YPO_RS05815	38
Gok2_libmerged	1082623	1082627		YPO_RS05820	4
Gok2_libmerged	1082907	1082912		YPO_RS05820	5
Gok2_libmerged	1083387	1083395		tssK	8
Gok2_libmerged	1083586	1083591		tssK	5
Gok2_libmerged	1085549	1085552		tssC	3
Gok2_libmerged	1085852	1085868		tssC	16
Gok2_libmerged	1086129	1086149		tssB	20
Gok2_libmerged	1088687	1088774		YPO_RS05845	87
Gok2_libmerged	1088944	1088950		YPO_RS05845	6
Gok2_libmerged	1089020	1089082		YPO_RS05845	62
Gok2_libmerged	1090140	1090183		YPO_RS05850	43
Gok2_libmerged	1091526	1091580		YPO_RS05855	54
Gok2_libmerged	1091707	1091774		YPO_RS05855	67
Gok2_libmerged	1091879	1091978		YPO_RS05855	99
Gok2_libmerged	1092088	1092113		YPO_RS05860	25
Gok2_libmerged	1092381	1092444		YPO_RS05860	63
Gok2_libmerged	1092544	1092551		YPO_RS05860	7
Gok2_libmerged	1092661	1092734		YPO_RS05860	73
Gok2_libmerged	1093299	1093328		YPO_RS05865	29
Gok2_libmerged	1093868	1093911		YPO_RS05865	43
Gok2_libmerged	1094175	1094182		YPO_RS05865	7
Gok2_libmerged	1094637	1094641		YPO_RS05865	4
Gok2_libmerged	1095688	1095726		YPO_RS05870	38
Gok2_libmerged	1095788	1095857		YPO_RS05870	69
Gok2_libmerged	1096157	1096159		YPO_RS05875	2
Gok2_libmerged	1096282	1096286		YPO_RS05880	4
Gok2_libmerged	1096961	1096998		YPO_RS05880	37
Gok2_libmerged	1097194	1097212		YPO_RS05880	18
Gok2_libmerged	1097395	1097398		YPO_RS05880	3
Gok2_libmerged	1099293	1099381		YPO_RS05890	88
Gok2_libmerged	1099653	1099670		YPO_RS05890	17
Gok2_libmerged	1099861	1099875		YPO_RS05890	14
Gok2_libmerged	1100406	1100408		iucC	2
Gok2_libmerged	1101051	1101077		iucC	26
Gok2_libmerged	1101439	1101490		iucC	51
Gok2_libmerged	1101543	1101570		iucC	27
Gok2_libmerged	1102101	1102120		YPO_RS05900	19
Gok2_libmerged	1102559	1102589		YPO_RS05900	30
Gok2_libmerged	1102944	1103036		YPO_RS05900	92
Gok2_libmerged	1103385	1103421		YPO_RS05905	36
Gok2_libmerged	1103780	1103800		YPO_RS05905	20
Gok2_libmerged	1104332	1104353		YPO_RS05905	21
Gok2_libmerged	1104603	1104611		YPO_RS05905	8
Gok2_libmerged	1104709	1104724		YPO_RS05905	15
Gok2_libmerged	1104802	1104829		YPO_RS05905	27
Gok2_libmerged	1105079	1105132		YPO_RS05905	53
Gok2_libmerged	1105824	1105837		YPO_RS05910	13
Gok2_libmerged	1106412	1106506		YPO_RS05910	94
Gok2_libmerged	1106550	1106682		YPO_RS05910	132
Gok2_libmerged	1106829	1107029		YPO_RS05910	200
Gok2_libmerged	1107068	1107069		YPO_RS05910	1
Gok2_libmerged	1107169	1107170		YPO_RS05910	1
Gok2_libmerged	1107799	1107819		YPO_RS05915	20
Gok2_libmerged	1108176	1108220		YPO_RS05915	44
Gok2_libmerged	1108390	1108406		YPO_RS05915	16
Gok2_libmerged	1108707	1108714		YPO_RS05915	7
Gok2_libmerged	1109229	1109242		YPO_RS05920	13
Gok2_libmerged	1109327	1109332		YPO_RS05920	5
Gok2_libmerged	1109498	1109547		YPO_RS05920	49
Gok2_libmerged	1109791	1109820		YPO_RS05920	29
Gok2_libmerged	1110215	1110224		YPO_RS05920	9
Gok2_libmerged	1110442	1110445		YPO_RS05920	3
Gok2_libmerged	1110917	1110922		YPO_RS05920	5
Gok2_libmerged	1111048	1111053		YPO_RS05920	5
Gok2_libmerged	1111288	1111319		YPO_RS05920	31
Gok2_libmerged	1111482	1111536		YPO_RS05925	54
Gok2_libmerged	1112186	1112209		YPO_RS05930	23
Gok2_libmerged	1112357	1112364		YPO_RS05930	7
Gok2_libmerged	1112899	1112913		YPO_RS05930	14
Gok2_libmerged	1113162	1113219		YPO_RS05930	57
Gok2_libmerged	1113366	1113373		YPO_RS05935	7
Gok2_libmerged	1113602	1113647		YPO_RS05935	45
Gok2_libmerged	1113765	1113816		YPO_RS05935	51
Gok2_libmerged	1114348	1114373		YPO_RS05935	25
Gok2_libmerged	1114514	1114573		YPO_RS05935	59
Gok2_libmerged	1114685	1114693		YPO_RS05935	8
Gok2_libmerged	1116051	1116080		YPO_RS05935	29
Gok2_libmerged	1116697	1116833		YPO_RS05940	136
Gok2_libmerged	1116917	1117003		YPO_RS05940	86
Gok2_libmerged	1117035	1117426		YPO_RS05940	391
Gok2_libmerged	1117616	1117628		YPO_RS05940	12
Gok2_libmerged	1117708	1117738		YPO_RS05940	30
Gok2_libmerged	1117897	1118110		YPO_RS05940	213
Gok2_libmerged	1118405	1118480		YPO_RS05945	75
Gok2_libmerged	1118710	1118811		YPO_RS05945	101
Gok2_libmerged	1119829	1119842		yapH	13
Gok2_libmerged	1119927	1119976		yapH	49
Gok2_libmerged	1120435	1120438		yapH	3
Gok2_libmerged	1120575	1120579		yapH	4
Gok2_libmerged	1120877	1120893		yapH	16
Gok2_libmerged	1120997	1121047		yapH	50
Gok2_libmerged	1121480	1121485		yapH	5
Gok2_libmerged	1121692	1121702		yapH	10
Gok2_libmerged	1121887	1121893		yapH	6
Gok2_libmerged	1121995	1122048		yapH	53
Gok2_libmerged	1122096	1122100		yapH	4
Gok2_libmerged	1122222	1122224		yapH	2
Gok2_libmerged	1122645	1122657		yapH	12
Gok2_libmerged	1122764	1122765		yapH	1
Gok2_libmerged	1123261	1123264		yapH	3
Gok2_libmerged	1123660	1123734		yapH	74
Gok2_libmerged	1124462	1124479		yapH	17
Gok2_libmerged	1124777	1124812		yapH	35
Gok2_libmerged	1125213	1125240		yapH	27
Gok2_libmerged	1125879	1125894		yapH	15
Gok2_libmerged	1126178	1126209		yapH	31
Gok2_libmerged	1126683	1126693		yapH	10
Gok2_libmerged	1127222	1127275		yapH	53
Gok2_libmerged	1127683	1127693		yapH	10
Gok2_libmerged	1127912	1127917		yapH	5
Gok2_libmerged	1128242	1128265		yapH	23
Gok2_libmerged	1128326	1128354		yapH	28
Gok2_libmerged	1128802	1128839		yapH	37
Gok2_libmerged	1128915	1128925		yapH	10
Gok2_libmerged	1129041	1129117		yapH	76
Gok2_libmerged	1129231	1129241		yapH	10
Gok2_libmerged	1129529	1129539		yapH	10
Gok2_libmerged	1129587	1129619		yapH	32
Gok2_libmerged	1129964	1129972		yapH	8
Gok2_libmerged	1130248	1130286		yapH	38
Gok2_libmerged	1130405	1130443		yapH	38
Gok2_libmerged	1130543	1130635		yapH	92
Gok2_libmerged	1131143	1131150		YPO_RS05955	7
Gok2_libmerged	1131612	1131631		YPO_RS05955	19
Gok2_libmerged	1131777	1131815		YPO_RS05955	38
Gok2_libmerged	1131968	1131973		YPO_RS05955	5
Gok2_libmerged	1132062	1132079		YPO_RS05955	17
Gok2_libmerged	1132510	1132520		YPO_RS05955	10
Gok2_libmerged	1132603	1132643		YPO_RS05955	40
Gok2_libmerged	1132705	1132792		YPO_RS05955	87
Gok2_libmerged	1132908	1132929		YPO_RS05955	21
Gok2_libmerged	1133638	1133711		YPO_RS05965	73
Gok2_libmerged	1133758	1133759		YPO_RS05965	1
Gok2_libmerged	1134337	1134367		YPO_RS05965	30
Gok2_libmerged	1134844	1134845		YPO_RS05970	1
Gok2_libmerged	1134982	1135063		YPO_RS05970	81
Gok2_libmerged	1135161	1135200		YPO_RS05970	39
Gok2_libmerged	1135324	1135343		YPO_RS05970	19
Gok2_libmerged	1135624	1135661		YPO_RS05970	37
Gok2_libmerged	1135860	1135866		YPO_RS05970	6
Gok2_libmerged	1136016	1136027		YPO_RS05970	11
Gok2_libmerged	1136084	1136111		YPO_RS05970	27
Gok2_libmerged	1137200	1137211		YPO_RS05975	11
Gok2_libmerged	1138194	1138230		YPO_RS05975	36
Gok2_libmerged	1138371	1138395		YPO_RS05975	24
Gok2_libmerged	1138474	1138498		YPO_RS05975	24
Gok2_libmerged	1138534	1138638		YPO_RS05975	104
Gok2_libmerged	1138748	1138763		pepT	15
Gok2_libmerged	1139452	1139477		pepT	25
Gok2_libmerged	1139934	1139959		pepT	25
Gok2_libmerged	1140365	1140606		YPO_RS05985	241
Gok2_libmerged	1140664	1140714		YPO_RS05985	50
Gok2_libmerged	1140841	1141001		YPO_RS05985	160
Gok2_libmerged	1141037	1141041		YPO_RS05985	4
Gok2_libmerged	1141104	1141158		YPO_RS05985	54
Gok2_libmerged	1141224	1141267		YPO_RS05985	43
Gok2_libmerged	1141329	1141338		YPO_RS05985	9
Gok2_libmerged	1141384	1141446		YPO_RS05985	62
Gok2_libmerged	1141544	1141639		YPO_RS05985	95
Gok2_libmerged	1141681	1141787		YPO_RS05985	106
Gok2_libmerged	1141881	1141952		YPO_RS05985	71
Gok2_libmerged	1142032	1142094		YPO_RS05985	62
Gok2_libmerged	1142174	1142314		YPO_RS05985	140
Gok2_libmerged	1146279	1146292		YPO_RS05995	13
Gok2_libmerged	1146513	1146522		YPO_RS05995	9
Gok2_libmerged	1146733	1146796		YPO_RS05995	63
Gok2_libmerged	1147122	1147144		YPO_RS06000	22
Gok2_libmerged	1147401	1147427		YPO_RS06000	26
Gok2_libmerged	1147793	1147816		YPO_RS06000	23
Gok2_libmerged	1147908	1147923		YPO_RS06005	15
Gok2_libmerged	1148012	1148060		YPO_RS06005	48
Gok2_libmerged	1148051	1148085		YPO_RS06010	34
Gok2_libmerged	1148186	1148262		YPO_RS06010	76
Gok2_libmerged	1148312	1148345		YPO_RS06010	33
Gok2_libmerged	1148513	1148539		YPO_RS06010	26
Gok2_libmerged	1149383	1149470		YPO_RS06020	87
Gok2_libmerged	1149516	1149524		YPO_RS06020	8
Gok2_libmerged	1149822	1149868		recC	46
Gok2_libmerged	1149904	1149927		recC	23
Gok2_libmerged	1150316	1150405		recC	89
Gok2_libmerged	1150576	1150605		recC	29
Gok2_libmerged	1150880	1150899		recC	19
Gok2_libmerged	1151219	1151225		recC	6
Gok2_libmerged	1151423	1151479		recC	56
Gok2_libmerged	1151852	1151886		recC	34
Gok2_libmerged	1151971	1151972		recC	1
Gok2_libmerged	1152012	1152018		recC	6
Gok2_libmerged	1152432	1152437		recC	5
Gok2_libmerged	1152936	1152992		recC	56
Gok2_libmerged	1153217	1153259		ptrA	42
Gok2_libmerged	1153395	1153399		ptrA	4
Gok2_libmerged	1153506	1153540		ptrA	34
Gok2_libmerged	1153590	1153605		ptrA	15
Gok2_libmerged	1154017	1154055		ptrA	38
Gok2_libmerged	1154296	1154332		ptrA	36
Gok2_libmerged	1154692	1154709		ptrA	17
Gok2_libmerged	1154915	1154927		ptrA	12
Gok2_libmerged	1155074	1155079		ptrA	5
Gok2_libmerged	1155162	1155188		ptrA	26
Gok2_libmerged	1155415	1155507		ptrA	92
Gok2_libmerged	1155583	1155594		ptrA	11
Gok2_libmerged	1156159	1156179		recB	20
Gok2_libmerged	1156259	1156302		recB	43
Gok2_libmerged	1156578	1156592		recB	14
Gok2_libmerged	1156889	1156894		recB	5
Gok2_libmerged	1157114	1157134		recB	20
Gok2_libmerged	1157228	1157235		recB	7
Gok2_libmerged	1157458	1157474		recB	16
Gok2_libmerged	1158394	1158413		recB	19
Gok2_libmerged	1158450	1158497		recB	47
Gok2_libmerged	1158875	1158916		recB	41
Gok2_libmerged	1159154	1159216		recB	62
Gok2_libmerged	1159644	1159656		recB	12
Gok2_libmerged	1159744	1159775		recD	31
Gok2_libmerged	1160068	1160086		recD	18
Gok2_libmerged	1160489	1160583		recD	94
Gok2_libmerged	1160690	1160746		recD	56
Gok2_libmerged	1160903	1160936		recD	33
Gok2_libmerged	1161145	1161149		recD	4
Gok2_libmerged	1161202	1161221		recD	19
Gok2_libmerged	1161583	1161600		recD	17
Gok2_libmerged	1161769	1161798		argA	29
Gok2_libmerged	1162074	1162089		argA	15
Gok2_libmerged	1162633	1162635		argA	2
Gok2_libmerged	1162935	1162953		argA	18
Gok2_libmerged	1163394	1163417		YPO_RS06050	23
Gok2_libmerged	1163773	1163789		YPO_RS06050	16
Gok2_libmerged	1163894	1163949		YPO_RS06050	55
Gok2_libmerged	1164191	1164279		YPO_RS06050	88
Gok2_libmerged	1164366	1164397		YPO_RS06050	31
Gok2_libmerged	1165680	1165696		mltA	16
Gok2_libmerged	1165821	1165829		mltA	8
Gok2_libmerged	1165869	1165908		mltA	39
Gok2_libmerged	1166803	1166843		tcdA	40
Gok2_libmerged	1166912	1166946		tcdA	34
Gok2_libmerged	1166989	1166997		tcdA	8
Gok2_libmerged	1168316	1168359		csdA	43
Gok2_libmerged	1168498	1168502		csdA	4
Gok2_libmerged	1168689	1168697		csdA	8
Gok2_libmerged	1168944	1168954		csdA	10
Gok2_libmerged	1169313	1169316		YPO_RS06085	3
Gok2_libmerged	1169355	1169459		YPO_RS06085	104
Gok2_libmerged	1170404	1170406		YPO_RS06090	2
Gok2_libmerged	1170494	1170512		YPO_RS06090	18
Gok2_libmerged	1171176	1171210		YPO_RS06095	34
Gok2_libmerged	1171280	1171299		YPO_RS06095	19
Gok2_libmerged	1171728	1171745		rlmM	17
Gok2_libmerged	1171873	1171915		rlmM	42
Gok2_libmerged	1172094	1172117		rlmM	23
Gok2_libmerged	1172196	1172264		rlmM	68
Gok2_libmerged	1172314	1172414		rlmM	100
Gok2_libmerged	1172763	1172770		xni	7
Gok2_libmerged	1172841	1172867		xni	26
Gok2_libmerged	1172918	1172921		xni	3
Gok2_libmerged	1173174	1173216		xni	42
Gok2_libmerged	1173481	1173506		xni	25
Gok2_libmerged	1174036	1174103		YPO_RS06110	67
Gok2_libmerged	1174822	1174861		YPO_RS06110	39
Gok2_libmerged	1175332	1175338		queF	6
Gok2_libmerged	1175393	1175460		queF	67
Gok2_libmerged	1175936	1175938		queF	2
Gok2_libmerged	1176297	1176318		syd	21
Gok2_libmerged	1176440	1176441		syd	1
Gok2_libmerged	1176713	1176717		syd	4
Gok2_libmerged	1177778	1177907		YPO_RS06125	129
Gok2_libmerged	1178342	1178371		YPO_RS06130	29
Gok2_libmerged	1178517	1178524		YPO_RS06130	7
Gok2_libmerged	1178708	1178741		truC	33
Gok2_libmerged	1179062	1179094		truC	32
Gok2_libmerged	1179346	1179421		YPO_RS06140	75
Gok2_libmerged	1179522	1179584		YPO_RS06140	62
Gok2_libmerged	1179650	1179671		YPO_RS06140	21
Gok2_libmerged	1180142	1180194		YPO_RS06145	52
Gok2_libmerged	1180238	1180269		YPO_RS06145	31
Gok2_libmerged	1180398	1180450		dapD	52
Gok2_libmerged	1180979	1180984		dapD	5
Gok2_libmerged	1181554	1181558		glnD	4
Gok2_libmerged	1181750	1181772		glnD	22
Gok2_libmerged	1181995	1181997		glnD	2
Gok2_libmerged	1182358	1182380		glnD	22
Gok2_libmerged	1182524	1182569		glnD	45
Gok2_libmerged	1182979	1183097		glnD	118
Gok2_libmerged	1183192	1183259		glnD	67
Gok2_libmerged	1184138	1184228		map	90
Gok2_libmerged	1185422	1185428		rpsB	6
Gok2_libmerged	1185458	1185490		rpsB	32
Gok2_libmerged	1185884	1185953		rpsB	69
Gok2_libmerged	1186234	1186243		tsf	9
Gok2_libmerged	1186392	1186394		tsf	2
Gok2_libmerged	1187039	1187074		tsf	35
Gok2_libmerged	1187283	1187289		pyrH	6
Gok2_libmerged	1187837	1187865		pyrH	28
Gok2_libmerged	1188268	1188287		frr	19
Gok2_libmerged	1189075	1189093		ispC	18
Gok2_libmerged	1189212	1189252		ispC	40
Gok2_libmerged	1189393	1189402		ispC	9
Gok2_libmerged	1189641	1189664		ispC	23
Gok2_libmerged	1190070	1190097		ispC	27
Gok2_libmerged	1190373	1190382		ispU	9
Gok2_libmerged	1190428	1190443		ispU	15
Gok2_libmerged	1191527	1191665		cdsA	138
Gok2_libmerged	1191824	1191853		cdsA	29
Gok2_libmerged	1191949	1191951		cdsA	2
Gok2_libmerged	1191980	1192001		rseP	21
Gok2_libmerged	1192387	1192443		rseP	56
Gok2_libmerged	1192579	1192580		rseP	1
Gok2_libmerged	1192761	1192772		rseP	11
Gok2_libmerged	1193187	1193200		rseP	13
Gok2_libmerged	1193291	1193306		rseP	15
Gok2_libmerged	1193825	1193827		bamA	2
Gok2_libmerged	1194088	1194150		bamA	62
Gok2_libmerged	1194486	1194508		bamA	22
Gok2_libmerged	1194631	1194642		bamA	11
Gok2_libmerged	1194862	1194863		bamA	1
Gok2_libmerged	1195031	1195032		bamA	1
Gok2_libmerged	1195092	1195126		bamA	34
Gok2_libmerged	1196432	1196439		lpxD	7
Gok2_libmerged	1196590	1196647		lpxD	57
Gok2_libmerged	1196796	1196800		lpxD	4
Gok2_libmerged	1197111	1197154		lpxD	43
Gok2_libmerged	1197229	1197267		lpxD	38
Gok2_libmerged	1197415	1197417		lpxD	2
Gok2_libmerged	1197651	1197654		fabZ	3
Gok2_libmerged	1197802	1197814		fabZ	12
Gok2_libmerged	1198078	1198143		fabZ	65
Gok2_libmerged	1198147	1198240		lpxA	93
Gok2_libmerged	1198290	1198299		lpxA	9
Gok2_libmerged	1198393	1198444		lpxA	51
Gok2_libmerged	1198797	1198810		lpxA	13
Gok2_libmerged	1199146	1199153		lpxB	7
Gok2_libmerged	1199348	1199350		lpxB	2
Gok2_libmerged	1199803	1199840		lpxB	37
Gok2_libmerged	1199915	1199919		lpxB	4
Gok2_libmerged	1200144	1200195		rnhB	51
Gok2_libmerged	1200299	1200320		rnhB	21
Gok2_libmerged	1200410	1200453		rnhB	43
Gok2_libmerged	1201303	1201320		dnaE	17
Gok2_libmerged	1201531	1201564		dnaE	33
Gok2_libmerged	1201938	1201997		dnaE	59
Gok2_libmerged	1202334	1202370		dnaE	36
Gok2_libmerged	1202424	1202464		dnaE	40
Gok2_libmerged	1202546	1202571		dnaE	25
Gok2_libmerged	1202866	1202883		dnaE	17
Gok2_libmerged	1203028	1203042		dnaE	14
Gok2_libmerged	1203120	1203150		dnaE	30
Gok2_libmerged	1203349	1203389		dnaE	40
Gok2_libmerged	1203455	1203528		dnaE	73
Gok2_libmerged	1203716	1203735		dnaE	19
Gok2_libmerged	1204471	1204484		accA	13
Gok2_libmerged	1204655	1204773		accA	118
Gok2_libmerged	1205942	1205964		tilS	22
Gok2_libmerged	1206291	1206323		tilS	32
Gok2_libmerged	1206424	1206432		tilS	8
Gok2_libmerged	1206468	1206509		tilS	41
Gok2_libmerged	1206839	1206910		tilS	71
Gok2_libmerged	1206972	1206977		tilS	5
Gok2_libmerged	1207085	1207090		tilS	5
Gok2_libmerged	1207838	1207851		YPO_RS06260	13
Gok2_libmerged	1208918	1208944		YPO_RS06275	26
Gok2_libmerged	1209484	1209490		arfB	6
Gok2_libmerged	1209960	1209999		nlpE	39
Gok2_libmerged	1210118	1210129		nlpE	11
Gok2_libmerged	1210287	1210340		nlpE	53
Gok2_libmerged	1210541	1210542		nlpE	1
Gok2_libmerged	1210959	1210966		proS	7
Gok2_libmerged	1212578	1212585		tsaA	7
Gok2_libmerged	1212632	1212643		tsaA	11
Gok2_libmerged	1213134	1213205		tsaA	71
Gok2_libmerged	1213202	1213225		rcsF	23
Gok2_libmerged	1213266	1213290		rcsF	24
Gok2_libmerged	1213472	1213480		rcsF	8
Gok2_libmerged	1213525	1213534		rcsF	9
Gok2_libmerged	1213727	1213733		YPO_RS06305	6
Gok2_libmerged	1213770	1213815		YPO_RS06305	45
Gok2_libmerged	1213901	1213905		YPO_RS06305	4
Gok2_libmerged	1214144	1214180		YPO_RS06305	36
Gok2_libmerged	1214276	1214328		YPO_RS06305	52
Gok2_libmerged	1214696	1214708		metI	12
Gok2_libmerged	1215107	1215162		metI	55
Gok2_libmerged	1215265	1215289		metN	24
Gok2_libmerged	1215548	1215550		metN	2
Gok2_libmerged	1215642	1215710		metN	68
Gok2_libmerged	1216470	1216499		gmhB	29
Gok2_libmerged	1216540	1216542		gmhB	2
Gok2_libmerged	1216670	1216728		gmhB	58
Gok2_libmerged	1216825	1216832		gmhB	7
Gok2_libmerged	1217024	1217036		gmhB	12
Gok2_libmerged	1217363	1217365		YPO_RS06325	2
Gok2_libmerged	1219843	1219851		YPO_RS06340	8
Gok2_libmerged	1220118	1220139		YPO_RS06340	21
Gok2_libmerged	1221599	1221602		YPO_RS06340	3
Gok2_libmerged	1222333	1222335		YPO_RS06340	2
Gok2_libmerged	1223358	1223391		dkgB	33
Gok2_libmerged	1223476	1223488		dkgB	12
Gok2_libmerged	1225096	1225114		YPO_RS06365	18
Gok2_libmerged	1225300	1225317		YPO_RS06365	17
Gok2_libmerged	1225559	1225622		YPO_RS06365	63
Gok2_libmerged	1225960	1226035		mltD	75
Gok2_libmerged	1226225	1226265		mltD	40
Gok2_libmerged	1226639	1226650		mltD	11
Gok2_libmerged	1226701	1226773		mltD	72
Gok2_libmerged	1227204	1227297		gloB	93
Gok2_libmerged	1227499	1227537		gloB	38
Gok2_libmerged	1227700	1227746		gloB	46
Gok2_libmerged	1227801	1227879		gloB	78
Gok2_libmerged	1228044	1228047		YPO_RS06380	3
Gok2_libmerged	1228983	1229023		rnhA	40
Gok2_libmerged	1229293	1229331		dnaQ	38
Gok2_libmerged	1229676	1229689		dnaQ	13
Gok2_libmerged	1229881	1229885		dnaQ	4
Gok2_libmerged	1230350	1230384		YPO_RS06400	34
Gok2_libmerged	1230450	1230526		YPO_RS06400	76
Gok2_libmerged	1230655	1230763		YPO_RS06400	108
Gok2_libmerged	1230925	1230945		YPO_RS06400	20
Gok2_libmerged	1231023	1231030		YPO_RS06400	7
Gok2_libmerged	1231193	1231219		YPO_RS06400	26
Gok2_libmerged	1231621	1231696		YPO_RS06400	75
Gok2_libmerged	1232065	1232147		YPO_RS06405	82
Gok2_libmerged	1232283	1232298		YPO_RS06405	15
Gok2_libmerged	1232349	1232351		YPO_RS06410	2
Gok2_libmerged	1232447	1232450		YPO_RS06410	3
Gok2_libmerged	1232627	1232639		YPO_RS06410	12
Gok2_libmerged	1232770	1232810		YPO_RS06410	40
Gok2_libmerged	1233148	1233153		YPO_RS06415	5
Gok2_libmerged	1233399	1233428		YPO_RS06415	29
Gok2_libmerged	1233785	1233806		YPO_RS06415	21
Gok2_libmerged	1233867	1233880		YPO_RS06415	13
Gok2_libmerged	1234128	1234150		YPO_RS06415	22
Gok2_libmerged	1234861	1234925		YPO_RS06425	64
Gok2_libmerged	1235048	1235063		YPO_RS06425	15
Gok2_libmerged	1235077	1235116		YPO_RS06430	39
Gok2_libmerged	1235894	1235896		YPO_RS06435	2
Gok2_libmerged	1236016	1236019		YPO_RS06435	3
Gok2_libmerged	1236144	1236175		YPO_RS06435	31
Gok2_libmerged	1236246	1236272		YPO_RS06435	26
Gok2_libmerged	1236302	1236333		YPO_RS06435	31
Gok2_libmerged	1236700	1236710		YPO_RS06435	10
Gok2_libmerged	1237204	1237223		YPO_RS06440	19
Gok2_libmerged	1237899	1237951		YPO_RS06445	52
Gok2_libmerged	1238051	1238116		YPO_RS06445	65
Gok2_libmerged	1238333	1238470		YPO_RS06450	137
Gok2_libmerged	1239243	1239289		YPO_RS06455	46
Gok2_libmerged	1240233	1240326		YPO_RS06460	93
Gok2_libmerged	1240670	1240765		YPO_RS06465	95
Gok2_libmerged	1240931	1241034		YPO_RS06465	103
Gok2_libmerged	1241219	1241274		YPO_RS06465	55
Gok2_libmerged	1241365	1241452		YPO_RS06465	87
Gok2_libmerged	1241521	1241574		YPO_RS06465	53
Gok2_libmerged	1241618	1241741		YPO_RS06465	123
Gok2_libmerged	1241903	1242036		YPO_RS06465	133
Gok2_libmerged	1242167	1242182		YPO_RS06465	15
Gok2_libmerged	1242248	1242266		YPO_RS06465	18
Gok2_libmerged	1242317	1242374		YPO_RS06470	57
Gok2_libmerged	1242580	1242770		YPO_RS06470	190
Gok2_libmerged	1242830	1242882		YPO_RS06470	52
Gok2_libmerged	1242991	1243038		YPO_RS06470	47
Gok2_libmerged	1243170	1243186		YPO_RS06470	16
Gok2_libmerged	1243284	1243303		YPO_RS06470	19
Gok2_libmerged	1243484	1243518		YPO_RS06475	34
Gok2_libmerged	1243842	1243911		YPO_RS06475	69
Gok2_libmerged	1244046	1244053		YPO_RS06475	7
Gok2_libmerged	1244109	1244136		YPO_RS06475	27
Gok2_libmerged	1244269	1244272		YPO_RS06475	3
Gok2_libmerged	1244642	1244683		YPO_RS06475	41
Gok2_libmerged	1244982	1245022		YPO_RS06480	40
Gok2_libmerged	1245354	1245365		YPO_RS06480	11
Gok2_libmerged	1245157	1245229		YPO_RS06480	72
Gok2_libmerged	1246353	1246356		smpB	3
Gok2_libmerged	1246541	1246553		YPO_RS06495	12
Gok2_libmerged	1246685	1246698		YPO_RS06495	13
Gok2_libmerged	1246751	1246781		YPO_RS06495	30
Gok2_libmerged	1247041	1247044		YPO_RS06495	3
Gok2_libmerged	1247099	1247105		YPO_RS06500	6
Gok2_libmerged	1247228	1247278		YPO_RS06500	50
Gok2_libmerged	1247679	1247721		bamE	42
Gok2_libmerged	1248210	1248251		recN	41
Gok2_libmerged	1248429	1248479		recN	50
Gok2_libmerged	1248980	1249027		recN	47
Gok2_libmerged	1249491	1249495		recN	4
Gok2_libmerged	1249604	1249620		recN	16
Gok2_libmerged	1249707	1249749		nadK	42
Gok2_libmerged	1249938	1249960		nadK	22
Gok2_libmerged	1250118	1250125		nadK	7
Gok2_libmerged	1250956	1250974		grpE	18
Gok2_libmerged	1251045	1251130		grpE	85
Gok2_libmerged	1252360	1252376		YPO_RS06525	16
Gok2_libmerged	1252497	1252502		YPO_RS06525	5
Gok2_libmerged	1252569	1252611		YPO_RS06525	42
Gok2_libmerged	1253410	1253436		sdhC	26
Gok2_libmerged	1253582	1253638		sdhC	56
Gok2_libmerged	1253724	1253763		sdhC	39
Gok2_libmerged	1254012	1254099		sdhD	87
Gok2_libmerged	1254458	1254459		sdhA	1
Gok2_libmerged	1254551	1254552		sdhA	1
Gok2_libmerged	1254768	1254812		sdhA	44
Gok2_libmerged	1254885	1254887		sdhA	2
Gok2_libmerged	1255113	1255190		sdhA	77
Gok2_libmerged	1255328	1255445		sdhA	117
Gok2_libmerged	1255612	1255625		sdhA	13
Gok2_libmerged	1255869	1255885		sdhA	16
Gok2_libmerged	1256212	1256261		YPO_RS06545	49
Gok2_libmerged	1256482	1256486		YPO_RS06545	4
Gok2_libmerged	1257145	1257153		sucA	8
Gok2_libmerged	1257286	1257300		sucA	14
Gok2_libmerged	1257386	1257393		sucA	7
Gok2_libmerged	1257523	1257532		sucA	9
Gok2_libmerged	1258171	1258192		sucA	21
Gok2_libmerged	1258238	1258241		sucA	3
Gok2_libmerged	1258542	1258678		sucA	136
Gok2_libmerged	1258822	1258889		sucA	67
Gok2_libmerged	1258967	1259003		sucA	36
Gok2_libmerged	1259714	1259723		sucA	9
Gok2_libmerged	1260640	1260726		odhB	86
Gok2_libmerged	1260815	1260821		odhB	6
Gok2_libmerged	1261180	1261242		sucC	62
Gok2_libmerged	1261565	1261567		sucC	2
Gok2_libmerged	1262312	1262346		sucC	34
Gok2_libmerged	1262346	1262357		sucD	11
Gok2_libmerged	1264050	1264122		cydA	72
Gok2_libmerged	1264937	1264989		cydA	52
Gok2_libmerged	1265105	1265109		cydA	4
Gok2_libmerged	1265230	1265232		cydA	2
Gok2_libmerged	1265568	1265612		cydB	44
Gok2_libmerged	1266052	1266059		cydB	7
Gok2_libmerged	1266164	1266165		cydB	1
Gok2_libmerged	1266543	1266550		cydB	7
Gok2_libmerged	1266704	1266707		cydB	3
Gok2_libmerged	1266720	1266759		cydX	39
Gok2_libmerged	1266875	1266891		ybgE	16
Gok2_libmerged	1267364	1267425		ybgC	61
Gok2_libmerged	1267570	1267610		ybgC	40
Gok2_libmerged	1267715	1267726		tolQ	11
Gok2_libmerged	1267894	1267912		tolQ	18
Gok2_libmerged	1267950	1267959		tolQ	9
Gok2_libmerged	1268546	1268598		tolR	52
Gok2_libmerged	1268730	1268768		tolR	38
Gok2_libmerged	1269704	1269705		tolA	1
Gok2_libmerged	1270206	1270212		tolB	6
Gok2_libmerged	1270308	1270310		tolB	2
Gok2_libmerged	1270376	1270378		tolB	2
Gok2_libmerged	1271031	1271034		tolB	3
Gok2_libmerged	1272060	1272061		cpoB	1
Gok2_libmerged	1272547	1272574		cpoB	27
Gok2_libmerged	1272665	1272683		cpoB	18
Gok2_libmerged	1274510	1274515		nadA	5
Gok2_libmerged	1274573	1274596		nadA	23
Gok2_libmerged	1275252	1275256		YPO_RS06645	4
Gok2_libmerged	1275845	1275867		zitB	22
Gok2_libmerged	1276399	1276466		zitB	67
Gok2_libmerged	1277207	1277228		aroG	21
Gok2_libmerged	1277449	1277485		aroG	36
Gok2_libmerged	1277788	1277881		aroG	93
Gok2_libmerged	1278043	1278065		aroG	22
Gok2_libmerged	1278486	1278511		YPO_RS06660	25
Gok2_libmerged	1278550	1278590		YPO_RS06660	40
Gok2_libmerged	1278646	1278748		YPO_RS06660	102
Gok2_libmerged	1278923	1278944		YPO_RS06665	21
Gok2_libmerged	1279084	1279108		YPO_RS06665	24
Gok2_libmerged	1279400	1279418		YPO_RS06665	18
Gok2_libmerged	1279455	1279531		YPO_RS06665	76
Gok2_libmerged	1279600	1279619		YPO_RS06665	19
Gok2_libmerged	1279838	1279857		YPO_RS06665	19
Gok2_libmerged	1280009	1280031		YPO_RS06670	22
Gok2_libmerged	1280478	1280486		gpmA	8
Gok2_libmerged	1280748	1280757		gpmA	9
Gok2_libmerged	1281004	1281048		gpmA	44
Gok2_libmerged	1281395	1281418		YPO_RS06680	23
Gok2_libmerged	1282023	1282025		galM	2
Gok2_libmerged	1282253	1282266		galM	13
Gok2_libmerged	1282480	1282484		galM	4
Gok2_libmerged	1282755	1282770		galM	15
Gok2_libmerged	1282861	1282873		galM	12
Gok2_libmerged	1282952	1282997		YPO_RS06690	45
Gok2_libmerged	1283604	1283607		galK	3
Gok2_libmerged	1283884	1283905		galK	21
Gok2_libmerged	1285083	1285141		galT	58
Gok2_libmerged	1285411	1285420		galE	9
Gok2_libmerged	1285576	1285650		galE	74
Gok2_libmerged	1285710	1285740		galE	30
Gok2_libmerged	1285777	1285793		galE	16
Gok2_libmerged	1286123	1286129		galE	6
Gok2_libmerged	1286279	1286282		galE	3
Gok2_libmerged	1286704	1286707		YPO_RS06710	3
Gok2_libmerged	1286751	1286783		YPO_RS06710	32
Gok2_libmerged	1287061	1287087		YPO_RS06710	26
Gok2_libmerged	1287242	1287245		YPO_RS06710	3
Gok2_libmerged	1287354	1287420		YPO_RS06710	66
Gok2_libmerged	1287484	1287490		YPO_RS06710	6
Gok2_libmerged	1288587	1288636		modF	49
Gok2_libmerged	1289183	1289197		modF	14
Gok2_libmerged	1289347	1289355		modE	8
Gok2_libmerged	1290802	1290815		modA	13
Gok2_libmerged	1290939	1290959		modA	20
Gok2_libmerged	1291107	1291121		modA	14
Gok2_libmerged	1291213	1291229		modA	16
Gok2_libmerged	1291287	1291291		modA	4
Gok2_libmerged	1291573	1291580		modA	7
Gok2_libmerged	1291666	1291785		modB	119
Gok2_libmerged	1292263	1292268		modB	5
Gok2_libmerged	1292875	1292880		modC	5
Gok2_libmerged	1293102	1293175		modC	73
Gok2_libmerged	1293300	1293329		modC	29
Gok2_libmerged	1293436	1293438		YPO_RS06745	2
Gok2_libmerged	1293631	1293633		YPO_RS06745	2
Gok2_libmerged	1293906	1293915		YPO_RS06745	9
Gok2_libmerged	1294841	1294849		pgl	8
Gok2_libmerged	1295461	1295521		pgl	60
Gok2_libmerged	1295715	1295805		bioA	90
Gok2_libmerged	1296728	1296735		bioA	7
Gok2_libmerged	1296931	1296974		bioA	43
Gok2_libmerged	1297930	1298078		bioB	148
Gok2_libmerged	1299800	1299826		bioC	26
Gok2_libmerged	1300035	1300048		bioC	13
Gok2_libmerged	1300041	1300080		bioD	39
Gok2_libmerged	1300640	1300690		bioD	50
Gok2_libmerged	1301071	1301093		YPO_RS06780	22
Gok2_libmerged	1301433	1301472		YPO_RS06780	39
Gok2_libmerged	1301571	1301586		YPO_RS06780	15
Gok2_libmerged	1302979	1302996		uvrB	17
Gok2_libmerged	1303148	1303154		uvrB	6
Gok2_libmerged	1303188	1303275		uvrB	87
Gok2_libmerged	1303324	1303325		uvrB	1
Gok2_libmerged	1303524	1303561		uvrB	37
Gok2_libmerged	1303639	1303664		uvrB	25
Gok2_libmerged	1304669	1304678		uvrB	9
Gok2_libmerged	1305527	1305547		yvcK	20
Gok2_libmerged	1306015	1306037		yvcK	22
Gok2_libmerged	1307689	1307696		moaA	7
Gok2_libmerged	1307778	1307794		moaA	16
Gok2_libmerged	1308332	1308368		moaC	36
Gok2_libmerged	1308648	1308655		moaD	7
Gok2_libmerged	1308902	1308913		moaE	11
Gok2_libmerged	1308993	1309019		moaE	26
Gok2_libmerged	1309320	1309327		YPO_RS06820	7
Gok2_libmerged	1309381	1309430		YPO_RS06820	49
Gok2_libmerged	1309917	1309939		YPO_RS06820	22
Gok2_libmerged	1310198	1310209		YPO_RS06825	11
Gok2_libmerged	1310514	1310604		YPO_RS06825	90
Gok2_libmerged	1310892	1310925		betA	33
Gok2_libmerged	1311038	1311104		betA	66
Gok2_libmerged	1311575	1311585		betA	10
Gok2_libmerged	1311876	1311898		betA	22
Gok2_libmerged	1312005	1312014		betA	9
Gok2_libmerged	1312130	1312141		betA	11
Gok2_libmerged	1312717	1312743		betB	26
Gok2_libmerged	1312943	1312948		betB	5
Gok2_libmerged	1312994	1313005		betB	11
Gok2_libmerged	1313446	1313471		betB	25
Gok2_libmerged	1313894	1313906		betB	12
Gok2_libmerged	1314438	1314440		betI	2
Gok2_libmerged	1315189	1315227		YPO_RS06845	38
Gok2_libmerged	1315379	1315381		YPO_RS06845	2
Gok2_libmerged	1315544	1315556		YPO_RS06845	12
Gok2_libmerged	1315959	1315995		YPO_RS06845	36
Gok2_libmerged	1316345	1316367		YPO_RS06845	22
Gok2_libmerged	1316408	1316536		YPO_RS06845	128
Gok2_libmerged	1316705	1316741		YPO_RS06845	36
Gok2_libmerged	1316859	1316872		YPO_RS06845	13
Gok2_libmerged	1317056	1317074		YPO_RS06845	18
Gok2_libmerged	1317355	1317398		YPO_RS06850	43
Gok2_libmerged	1317886	1317917		YPO_RS06850	31
Gok2_libmerged	1318358	1318418		YPO_RS06855	60
Gok2_libmerged	1318968	1318971		YPO_RS06855	3
Gok2_libmerged	1319480	1319510		xapA	30
Gok2_libmerged	1319686	1319703		xapA	17
Gok2_libmerged	1319989	1320017		xapA	28
Gok2_libmerged	1320338	1320343		xapA	5
Gok2_libmerged	1321272	1321349		YPO_RS06870	77
Gok2_libmerged	1321418	1321462		YPO_RS06870	44
Gok2_libmerged	1321496	1321514		YPO_RS06870	18
Gok2_libmerged	1322146	1322168		YPO_RS06875	22
Gok2_libmerged	1322232	1322255		YPO_RS06875	23
Gok2_libmerged	1322344	1322472		YPO_RS06875	128
Gok2_libmerged	1322532	1322539		YPO_RS06875	7
Gok2_libmerged	1322616	1322860		YPO_RS06875	244
Gok2_libmerged	1322932	1322961		YPO_RS06875	29
Gok2_libmerged	1323003	1323004		YPO_RS06875	1
Gok2_libmerged	1323069	1323070		YPO_RS06875	1
Gok2_libmerged	1323398	1323406		dusC	8
Gok2_libmerged	1324140	1324239		dusC	99
Gok2_libmerged	1324478	1324480		YPO_RS06885	2
Gok2_libmerged	1324927	1324982		pbpG	55
Gok2_libmerged	1325083	1325092		pbpG	9
Gok2_libmerged	1325135	1325205		pbpG	70
Gok2_libmerged	1325474	1325482		pbpG	8
Gok2_libmerged	1325545	1325561		pbpG	16
Gok2_libmerged	1326034	1326038		dld	4
Gok2_libmerged	1326165	1326214		dld	49
Gok2_libmerged	1326245	1326268		dld	23
Gok2_libmerged	1326587	1326712		dld	125
Gok2_libmerged	1327359	1327388		dld	29
Gok2_libmerged	1327579	1327585		dld	6
Gok2_libmerged	1327882	1327900		cyaB	18
Gok2_libmerged	1328169	1328179		cyaB	10
Gok2_libmerged	1328236	1328245		cyaB	9
Gok2_libmerged	1328472	1328492		YPO_RS06905	20
Gok2_libmerged	1328780	1328788		YPO_RS06905	8
Gok2_libmerged	1329396	1329419		YPO_RS06910	23
Gok2_libmerged	1329730	1329765		YPO_RS06910	35
Gok2_libmerged	1330462	1330508		YPO_RS06915	46
Gok2_libmerged	1330594	1330601		YPO_RS06915	7
Gok2_libmerged	1330969	1330976		phnC	7
Gok2_libmerged	1331038	1331112		phnC	74
Gok2_libmerged	1331193	1331252		phnC	59
Gok2_libmerged	1331718	1331747		phnD	29
Gok2_libmerged	1331804	1331916		phnD	112
Gok2_libmerged	1332016	1332034		phnD	18
Gok2_libmerged	1332354	1332407		phnD	53
Gok2_libmerged	1332443	1332445		phnD	2
Gok2_libmerged	1332989	1333010		phnE	21
Gok2_libmerged	1333213	1333231		phnE	18
Gok2_libmerged	1333380	1333437		phnE	57
Gok2_libmerged	1333534	1333545		phnE	11
Gok2_libmerged	1333741	1333783		phnE	42
Gok2_libmerged	1333827	1333855		phnE	28
Gok2_libmerged	1334065	1334069		phnE	4
Gok2_libmerged	1334252	1334266		phnE	14
Gok2_libmerged	1334391	1334494		phnE	103
Gok2_libmerged	1334861	1334870		YPO_RS06940	9
Gok2_libmerged	1335881	1335949		urtA	68
Gok2_libmerged	1336405	1336419		urtA	14
Gok2_libmerged	1336653	1336655		urtA	2
Gok2_libmerged	1336740	1336752		urtA	12
Gok2_libmerged	1337917	1337929		urtB	12
Gok2_libmerged	1338287	1338288		urtB	1
Gok2_libmerged	1338392	1338402		urtB	10
Gok2_libmerged	1338463	1338590		urtB	127
Gok2_libmerged	1338728	1338754		urtC	26
Gok2_libmerged	1339459	1339461		urtC	2
Gok2_libmerged	1339910	1340038		urtD	128
Gok2_libmerged	1340292	1340356		urtD	64
Gok2_libmerged	1340510	1340522		urtD	12
Gok2_libmerged	1340738	1340761		urtE	23
Gok2_libmerged	1341457	1341464		YPO_RS06970	7
Gok2_libmerged	1341600	1341618		YPO_RS06970	18
Gok2_libmerged	1341902	1341939		YPO_RS06970	37
Gok2_libmerged	1342248	1342277		YPO_RS06970	29
Gok2_libmerged	1342567	1342608		YPO_RS06975	41
Gok2_libmerged	1342785	1342831		YPO_RS06975	46
Gok2_libmerged	1343035	1343041		YPO_RS06975	6
Gok2_libmerged	1344012	1344014		sseA	2
Gok2_libmerged	1344114	1344148		sseA	34
Gok2_libmerged	1344343	1344351		sseA	8
Gok2_libmerged	1344470	1344478		sseA	8
Gok2_libmerged	1344718	1344762		sseA	44
Gok2_libmerged	1345795	1345803		YPO_RS06985	8
Gok2_libmerged	1345898	1345914		YPO_RS06985	16
Gok2_libmerged	1346691	1346699		YPO_RS06995	8
Gok2_libmerged	1347169	1347190		YPO_RS06995	21
Gok2_libmerged	1347331	1347338		YPO_RS06995	7
Gok2_libmerged	1347710	1347755		YPO_RS06995	45
Gok2_libmerged	1347839	1347845		YPO_RS06995	6
Gok2_libmerged	1347842	1347858		YPO_RS07000	16
Gok2_libmerged	1347921	1347964		YPO_RS07000	43
Gok2_libmerged	1348122	1348123		YPO_RS07000	1
Gok2_libmerged	1348334	1348371		YPO_RS07000	37
Gok2_libmerged	1348597	1348613		YPO_RS07000	16
Gok2_libmerged	1348730	1348780		YPO_RS07000	50
Gok2_libmerged	1348940	1348997		YPO_RS07005	57
Gok2_libmerged	1349225	1349228		YPO_RS07005	3
Gok2_libmerged	1349399	1349405		YPO_RS07005	6
Gok2_libmerged	1350091	1350101		adiC	10
Gok2_libmerged	1350138	1350141		adiC	3
Gok2_libmerged	1350280	1350285		adiC	5
Gok2_libmerged	1350405	1350521		adiC	116
Gok2_libmerged	1351067	1351072		adiC	5
Gok2_libmerged	1351329	1351336		adiC	7
Gok2_libmerged	1351547	1351564		YPO_RS07015	17
Gok2_libmerged	1351602	1351645		YPO_RS07015	43
Gok2_libmerged	1351835	1351855		YPO_RS07015	20
Gok2_libmerged	1352662	1352673		YPO_RS07015	11
Gok2_libmerged	1352735	1352829		YPO_RS07015	94
Gok2_libmerged	1353300	1353453		YPO_RS07015	153
Gok2_libmerged	1353525	1353605		YPO_RS07015	80
Gok2_libmerged	1353684	1353694		YPO_RS07015	10
Gok2_libmerged	1354113	1354122		YPO_RS07020	9
Gok2_libmerged	1354274	1354285		yedA	11
Gok2_libmerged	1354360	1354362		yedA	2
Gok2_libmerged	1354787	1354827		yedA	40
Gok2_libmerged	1355549	1355701		ompF2	152
Gok2_libmerged	1355790	1355850		ompF2	60
Gok2_libmerged	1356302	1356306		ompF2	4
Gok2_libmerged	1356513	1356541		ompF2	28
Gok2_libmerged	1356576	1356664		ompF2	88
Gok2_libmerged	1356934	1356951		dinG	17
Gok2_libmerged	1357426	1357484		dinG	58
Gok2_libmerged	1357662	1357665		dinG	3
Gok2_libmerged	1358215	1358307		dinG	92
Gok2_libmerged	1358433	1358447		dinG	14
Gok2_libmerged	1358528	1358533		dinG	5
Gok2_libmerged	1358620	1358638		dinG	18
Gok2_libmerged	1358755	1358770		dinG	15
Gok2_libmerged	1358930	1358964		dinG	34
Gok2_libmerged	1359448	1359517		YPO_RS07040	69
Gok2_libmerged	1360000	1360034		YPO_RS07040	34
Gok2_libmerged	1361134	1361143		YPO_RS07045	9
Gok2_libmerged	1361331	1361350		YPO_RS07045	19
Gok2_libmerged	1361481	1361497		YPO_RS07045	16
Gok2_libmerged	1361924	1361959		tyrP	35
Gok2_libmerged	1362285	1362303		tyrP	18
Gok2_libmerged	1362363	1362396		tyrP	33
Gok2_libmerged	1362727	1362752		tyrP	25
Gok2_libmerged	1362922	1362976		tyrP	54
Gok2_libmerged	1366263	1366410		nrdB	147
Gok2_libmerged	1366756	1366784		nrdB	28
Gok2_libmerged	1367466	1367497		nrdA	31
Gok2_libmerged	1367672	1367688		nrdA	16
Gok2_libmerged	1368064	1368137		nrdA	73
Gok2_libmerged	1368625	1368662		nrdA	37
Gok2_libmerged	1368880	1368894		nrdA	14
Gok2_libmerged	1368929	1368987		nrdA	58
Gok2_libmerged	1369134	1369175		nrdA	41
Gok2_libmerged	1369761	1369874		YPO_RS07080	113
Gok2_libmerged	1369918	1369949		YPO_RS07080	31
Gok2_libmerged	1370089	1370102		YPO_RS07080	13
Gok2_libmerged	1370439	1370467		YPO_RS07080	28
Gok2_libmerged	1370806	1370816		gyrA	10
Gok2_libmerged	1370927	1370948		gyrA	21
Gok2_libmerged	1371105	1371129		gyrA	24
Gok2_libmerged	1371298	1371341		gyrA	43
Gok2_libmerged	1372323	1372345		gyrA	22
Gok2_libmerged	1372433	1372455		gyrA	22
Gok2_libmerged	1372847	1372907		gyrA	60
Gok2_libmerged	1373003	1373008		gyrA	5
Gok2_libmerged	1373162	1373186		gyrA	24
Gok2_libmerged	1373384	1373394		gyrA	10
Gok2_libmerged	1373616	1373771		rcsC	155
Gok2_libmerged	1374241	1374265		rcsC	24
Gok2_libmerged	1374325	1374362		rcsC	37
Gok2_libmerged	1374750	1374795		rcsC	45
Gok2_libmerged	1374914	1374971		rcsC	57
Gok2_libmerged	1375094	1375098		rcsC	4
Gok2_libmerged	1375182	1375246		rcsC	64
Gok2_libmerged	1375513	1375533		rcsC	20
Gok2_libmerged	1375689	1375698		rcsC	9
Gok2_libmerged	1375891	1375899		rcsC	8
Gok2_libmerged	1376124	1376224		rcsC	100
Gok2_libmerged	1376749	1376785		rcsB	36
Gok2_libmerged	1376906	1377002		rcsB	96
Gok2_libmerged	1377095	1377121		rcsB	26
Gok2_libmerged	1377285	1377290		YPO_RS07100	5
Gok2_libmerged	1377429	1377522		YPO_RS07100	93
Gok2_libmerged	1377593	1377615		YPO_RS07100	22
Gok2_libmerged	1377683	1377684		YPO_RS07100	1
Gok2_libmerged	1377929	1377938		rcsD	9
Gok2_libmerged	1378552	1378605		rcsD	53
Gok2_libmerged	1378888	1378900		rcsD	12
Gok2_libmerged	1379261	1379332		rcsD	71
Gok2_libmerged	1379431	1379461		rcsD	30
Gok2_libmerged	1379669	1379692		rcsD	23
Gok2_libmerged	1379784	1379833		rcsD	49
Gok2_libmerged	1380130	1380143		YPO_RS07110	13
Gok2_libmerged	1380262	1380265		YPO_RS07110	3
Gok2_libmerged	1380678	1380695		YPO_RS07110	17
Gok2_libmerged	1381025	1381034		YPO_RS07110	9
Gok2_libmerged	1382277	1382284		YPO_RS07115	7
Gok2_libmerged	1382578	1382599		YPO_RS07115	21
Gok2_libmerged	1382774	1382783		YPO_RS07115	9
Gok2_libmerged	1382860	1382882		YPO_RS07115	22
Gok2_libmerged	1383061	1383105		YPO_RS07115	44
Gok2_libmerged	1383479	1383499		YPO_RS07120	20
Gok2_libmerged	1383607	1383621		YPO_RS07120	14
Gok2_libmerged	1384740	1384820		ampH	80
Gok2_libmerged	1385214	1385226		ampH	12
Gok2_libmerged	1385278	1385285		ampH	7
Gok2_libmerged	1385420	1385474		ampH	54
Gok2_libmerged	1386350	1386418		YPO_RS07140	68
Gok2_libmerged	1386628	1386638		YPO_RS07140	10
Gok2_libmerged	1386849	1386857		YPO_RS07140	8
Gok2_libmerged	1387130	1387156		YPO_RS07140	26
Gok2_libmerged	1387653	1387675		YPO_RS07140	22
Gok2_libmerged	1388155	1388181		YPO_RS07145	26
Gok2_libmerged	1388443	1388479		YPO_RS07145	36
Gok2_libmerged	1388984	1388990		YPO_RS07145	6
Gok2_libmerged	1389369	1389382		YPO_RS07150	13
Gok2_libmerged	1389910	1389911		YPO_RS07150	1
Gok2_libmerged	1389979	1390007		YPO_RS07150	28
Gok2_libmerged	1390417	1390439		YPO_RS07150	22
Gok2_libmerged	1390620	1390627		YPO_RS07150	7
Gok2_libmerged	1391407	1391455		ycoA	48
Gok2_libmerged	1391552	1391566		ycoA	14
Gok2_libmerged	1391644	1391663		ycoA	19
Gok2_libmerged	1391882	1391909		ycoA	27
Gok2_libmerged	1392011	1392031		ycoA	20
Gok2_libmerged	1392082	1392115		ycoA	33
Gok2_libmerged	1392518	1392521		YPO_RS07160	3
Gok2_libmerged	1392591	1392619		YPO_RS07160	28
Gok2_libmerged	1392708	1392731		YPO_RS07160	23
Gok2_libmerged	1392937	1392994		YPO_RS07165	57
Gok2_libmerged	1394229	1394305		YPO_RS07170	76
Gok2_libmerged	1394389	1394412		YPO_RS07170	23
Gok2_libmerged	1395037	1395040		YPO_RS07175	3
Gok2_libmerged	1395319	1395348		YPO_RS07175	29
Gok2_libmerged	1395618	1395632		YPO_RS07175	14
Gok2_libmerged	1395747	1395748		YPO_RS07175	1
Gok2_libmerged	1396980	1397006		YPO_RS07185	26
Gok2_libmerged	1397823	1397844		YPO_RS07190	21
Gok2_libmerged	1397938	1398010		YPO_RS07190	72
Gok2_libmerged	1398148	1398169		YPO_RS07190	21
Gok2_libmerged	1400051	1400061		YPO_RS07210	10
Gok2_libmerged	1400284	1400336		YPO_RS07210	52
Gok2_libmerged	1400441	1400467		YPO_RS07210	26
Gok2_libmerged	1400536	1400557		YPO_RS07210	21
Gok2_libmerged	1400965	1400968		YPO_RS07210	3
Gok2_libmerged	1401177	1401210		YPO_RS07210	33
Gok2_libmerged	1401318	1401323		YPO_RS07210	5
Gok2_libmerged	1401616	1401659		YPO_RS07215	43
Gok2_libmerged	1401777	1401781		YPO_RS07215	4
Gok2_libmerged	1401937	1401939		YPO_RS07220	2
Gok2_libmerged	1402370	1402387		YPO_RS07225	17
Gok2_libmerged	1402688	1402712		YPO_RS07225	24
Gok2_libmerged	1402872	1402881		YPO_RS07225	9
Gok2_libmerged	1403188	1403193		YPO_RS07225	5
Gok2_libmerged	1403268	1403336		YPO_RS07225	68
Gok2_libmerged	1403468	1403525		YPO_RS07225	57
Gok2_libmerged	1404361	1404390		YPO_RS07230	29
Gok2_libmerged	1404838	1404839		YPO_RS07230	1
Gok2_libmerged	1404925	1404933		YPO_RS07230	8
Gok2_libmerged	1405223	1405247		YPO_RS07230	24
Gok2_libmerged	1405866	1405876		YPO_RS07235	10
Gok2_libmerged	1406436	1406441		YPO_RS07235	5
Gok2_libmerged	1406517	1406554		YPO_RS07240	37
Gok2_libmerged	1406763	1406808		YPO_RS07240	45
Gok2_libmerged	1406870	1406875		YPO_RS07240	5
Gok2_libmerged	1407187	1407188		YPO_RS07245	1
Gok2_libmerged	1407279	1407307		YPO_RS07245	28
Gok2_libmerged	1407456	1407472		YPO_RS07245	16
Gok2_libmerged	1407944	1407948		YPO_RS07250	4
Gok2_libmerged	1408206	1408213		YPO_RS07250	7
Gok2_libmerged	1408351	1408370		YPO_RS07250	19
Gok2_libmerged	1408685	1408705		YPO_RS07250	20
Gok2_libmerged	1408702	1408746		YPO_RS07255	44
Gok2_libmerged	1408931	1408939		YPO_RS07255	8
Gok2_libmerged	1409752	1409828		YPO_RS07265	76
Gok2_libmerged	1409875	1409879		YPO_RS07265	4
Gok2_libmerged	1409942	1409949		YPO_RS07265	7
Gok2_libmerged	1410136	1410182		YPO_RS07265	46
Gok2_libmerged	1410480	1410542		YPO_RS07270	62
Gok2_libmerged	1410668	1410782		YPO_RS07270	114
Gok2_libmerged	1410926	1411000		YPO_RS07270	74
Gok2_libmerged	1411034	1411090		YPO_RS07270	56
Gok2_libmerged	1411167	1411220		YPO_RS07270	53
Gok2_libmerged	1411511	1411534		YPO_RS07275	23
Gok2_libmerged	1411779	1411850		YPO_RS07275	71
Gok2_libmerged	1412154	1412156		YPO_RS07275	2
Gok2_libmerged	1412371	1412372		YPO_RS07275	1
Gok2_libmerged	1412466	1412468		YPO_RS07275	2
Gok2_libmerged	1412608	1412620		YPO_RS07275	12
Gok2_libmerged	1412723	1412945		YPO_RS07275	222
Gok2_libmerged	1413151	1413205		YPO_RS07280	54
Gok2_libmerged	1414135	1414143		YPO_RS07285	8
Gok2_libmerged	1414226	1414284		YPO_RS07285	58
Gok2_libmerged	1414509	1414519		YPO_RS07285	10
Gok2_libmerged	1414699	1414722		YPO_RS07290	23
Gok2_libmerged	1414899	1415040		YPO_RS07290	141
Gok2_libmerged	1415719	1415749		YPO_RS07290	30
Gok2_libmerged	1416176	1416181		YPO_RS07295	5
Gok2_libmerged	1416300	1416340		YPO_RS07295	40
Gok2_libmerged	1416828	1416906		YPO_RS07305	78
Gok2_libmerged	1417297	1417372		YPO_RS07305	75
Gok2_libmerged	1417764	1417771		YPO_RS07305	7
Gok2_libmerged	1418298	1418403		YPO_RS07305	105
Gok2_libmerged	1418755	1418804		YPO_RS07310	49
Gok2_libmerged	1418984	1418992		yejK	8
Gok2_libmerged	1419313	1419390		yejK	77
Gok2_libmerged	1419461	1419530		yejK	69
Gok2_libmerged	1420214	1420241		YPO_RS07320	27
Gok2_libmerged	1420289	1420333		YPO_RS07320	44
Gok2_libmerged	1420559	1420612		YPO_RS07320	53
Gok2_libmerged	1420872	1420873		rplY	1
Gok2_libmerged	1421054	1421062		rplY	8
Gok2_libmerged	1421375	1421388		YPO_RS07330	13
Gok2_libmerged	1421451	1421453		YPO_RS07330	2
Gok2_libmerged	1421839	1421840		YPO_RS07330	1
Gok2_libmerged	1422042	1422066		YPO_RS07330	24
Gok2_libmerged	1422236	1422240		YPO_RS07330	4
Gok2_libmerged	1423731	1423751		rsuA	20
Gok2_libmerged	1424343	1424483		YPO_RS07340	140
Gok2_libmerged	1424885	1424887		YPO_RS07340	2
Gok2_libmerged	1424921	1424961		YPO_RS07340	40
Gok2_libmerged	1425127	1425132		YPO_RS07340	5
Gok2_libmerged	1425471	1425528		YPO_RS07340	57
Gok2_libmerged	1426495	1426503		YPO_RS07345	8
Gok2_libmerged	1426921	1426932		yejF	11
Gok2_libmerged	1427093	1427123		yejF	30
Gok2_libmerged	1427550	1427580		yejF	30
Gok2_libmerged	1427706	1427713		yejF	7
Gok2_libmerged	1427810	1427815		yejF	5
Gok2_libmerged	1428282	1428314		yejF	32
Gok2_libmerged	1428446	1428490		yejF	44
Gok2_libmerged	1428550	1428569		YPO_RS07355	19
Gok2_libmerged	1428690	1428695		YPO_RS07355	5
Gok2_libmerged	1428765	1428907		YPO_RS07355	142
Gok2_libmerged	1428942	1428946		YPO_RS07355	4
Gok2_libmerged	1429274	1429285		YPO_RS07355	11
Gok2_libmerged	1429328	1429341		YPO_RS07355	13
Gok2_libmerged	1429426	1429431		YPO_RS07355	5
Gok2_libmerged	1429522	1429576		YPO_RS07360	54
Gok2_libmerged	1430030	1430105		YPO_RS07360	75
Gok2_libmerged	1430715	1430739		YPO_RS07365	24
Gok2_libmerged	1430806	1430815		YPO_RS07365	9
Gok2_libmerged	1430878	1430912		YPO_RS07365	34
Gok2_libmerged	1431650	1431660		YPO_RS07365	10
Gok2_libmerged	1431838	1431843		YPO_RS07365	5
Gok2_libmerged	1431939	1431964		YPO_RS07365	25
Gok2_libmerged	1432401	1432429		YPO_RS07365	28
Gok2_libmerged	1432522	1432553		YPO_RS07370	31
Gok2_libmerged	1432626	1432645		YPO_RS07370	19
Gok2_libmerged	1432718	1432747		YPO_RS07370	29
Gok2_libmerged	1432948	1432981		YPO_RS07370	33
Gok2_libmerged	1433222	1433262		YPO_RS07370	40
Gok2_libmerged	1433320	1433327		YPO_RS07370	7
Gok2_libmerged	1433396	1433410		YPO_RS07370	14
Gok2_libmerged	1433495	1433502		YPO_RS07370	7
Gok2_libmerged	1433641	1433642		YPO_RS07370	1
Gok2_libmerged	1433920	1433950		YPO_RS07370	30
Gok2_libmerged	1434765	1434795		mepS	30
Gok2_libmerged	1435010	1435051		mepS	41
Gok2_libmerged	1435147	1435156		mepS	9
Gok2_libmerged	1435798	1435807		YPO_RS07380	9
Gok2_libmerged	1435960	1435982		YPO_RS07380	22
Gok2_libmerged	1436037	1436064		YPO_RS07380	27
Gok2_libmerged	1436500	1436523		YPO_RS07385	23
Gok2_libmerged	1436670	1436680		YPO_RS07385	10
Gok2_libmerged	1436830	1436862		YPO_RS07385	32
Gok2_libmerged	1437103	1437191		YPO_RS07385	88
Gok2_libmerged	1438466	1438490		YPO_RS07390	24
Gok2_libmerged	1439867	1439879		YPO_RS07395	12
Gok2_libmerged	1440155	1440158		YPO_RS07395	3
Gok2_libmerged	1440333	1440344		YPO_RS07395	11
Gok2_libmerged	1441295	1441314		uxuA	19
Gok2_libmerged	1441432	1441479		uxuA	47
Gok2_libmerged	1442013	1442025		uxuA	12
Gok2_libmerged	1442162	1442175		uxuA	13
Gok2_libmerged	1442847	1442892		yeiP	45
Gok2_libmerged	1443053	1443056		yeiP	3
Gok2_libmerged	1443231	1443254		mtr	23
Gok2_libmerged	1443287	1443344		mtr	57
Gok2_libmerged	1444452	1444464		mtr	12
Gok2_libmerged	1444914	1444917		YPO_RS07415	3
Gok2_libmerged	1445348	1445355		YPO_RS07420	7
Gok2_libmerged	1445447	1445452		YPO_RS07420	5
Gok2_libmerged	1445546	1445571		YPO_RS07420	25
Gok2_libmerged	1445658	1445662		YPO_RS07420	4
Gok2_libmerged	1446342	1446364		YPO_RS07425	22
Gok2_libmerged	1446676	1446680		YPO_RS07425	4
Gok2_libmerged	1447199	1447203		YPO_RS07430	4
Gok2_libmerged	1447438	1447508		YPO_RS07430	70
Gok2_libmerged	1448453	1448487		YPO_RS07435	34
Gok2_libmerged	1448517	1448568		YPO_RS07435	51
Gok2_libmerged	1448845	1448850		YPO_RS07435	5
Gok2_libmerged	1449298	1449366		YPO_RS07435	68
Gok2_libmerged	1449644	1449724		YPO_RS07435	80
Gok2_libmerged	1450157	1450194		xylB	37
Gok2_libmerged	1450991	1451073		xylB	82
Gok2_libmerged	1452407	1452488		YPO_RS07450	81
Gok2_libmerged	1452729	1452748		YPO_RS07450	19
Gok2_libmerged	1452827	1452858		YPO_RS07450	31
Gok2_libmerged	1452927	1452973		YPO_RS07450	46
Gok2_libmerged	1453185	1453190		YPO_RS07450	5
Gok2_libmerged	1453596	1453600		YPO_RS07455	4
Gok2_libmerged	1453695	1453717		YPO_RS07455	22
Gok2_libmerged	1453822	1453898		YPO_RS07455	76
Gok2_libmerged	1453938	1453945		YPO_RS07455	7
Gok2_libmerged	1454231	1454239		YPO_RS07455	8
Gok2_libmerged	1454300	1454327		YPO_RS07455	27
Gok2_libmerged	1454499	1454506		YPO_RS07455	7
Gok2_libmerged	1454695	1454712		YPO_RS07455	17
Gok2_libmerged	1455056	1455071		YPO_RS07455	15
Gok2_libmerged	1455370	1455387		YPO_RS07460	17
Gok2_libmerged	1455724	1455729		YPO_RS07460	5
Gok2_libmerged	1455954	1455956		YPO_RS07460	2
Gok2_libmerged	1456074	1456141		YPO_RS07460	67
Gok2_libmerged	1456541	1456583		YPO_RS07465	42
Gok2_libmerged	1457160	1457163		YPO_RS07470	3
Gok2_libmerged	1457369	1457386		YPO_RS07470	17
Gok2_libmerged	1457913	1457996		YPO_RS07470	83
Gok2_libmerged	1458276	1458295		fruK	19
Gok2_libmerged	1458372	1458374		fruK	2
Gok2_libmerged	1458722	1458736		fruK	14
Gok2_libmerged	1458956	1458991		fruK	35
Gok2_libmerged	1459396	1459438		fruA	42
Gok2_libmerged	1459618	1459627		fruA	9
Gok2_libmerged	1459665	1459703		fruA	38
Gok2_libmerged	1459809	1459820		fruA	11
Gok2_libmerged	1460075	1460146		fruA	71
Gok2_libmerged	1461145	1461158		YPO_RS07485	13
Gok2_libmerged	1461234	1461417		YPO_RS07485	183
Gok2_libmerged	1461528	1461605		YPO_RS07485	77
Gok2_libmerged	1461703	1461746		YPO_RS07485	43
Gok2_libmerged	1461743	1461841		YPO_RS07490	98
Gok2_libmerged	1461957	1461987		YPO_RS07490	30
Gok2_libmerged	1462057	1462149		YPO_RS07490	92
Gok2_libmerged	1462215	1462231		YPO_RS07490	16
Gok2_libmerged	1462992	1463013		psaA	21
Gok2_libmerged	1463099	1463108		psaA	9
Gok2_libmerged	1463144	1463161		psaA	17
Gok2_libmerged	1463379	1463496		YPO_RS07500	117
Gok2_libmerged	1463751	1463753		YPO_RS07500	2
Gok2_libmerged	1463823	1464024		YPO_RS07500	201
Gok2_libmerged	1464099	1464133		YPO_RS07500	34
Gok2_libmerged	1464284	1464339		psaC	55
Gok2_libmerged	1464899	1464951		psaC	52
Gok2_libmerged	1465017	1465045		psaC	28
Gok2_libmerged	1465127	1465195		psaC	68
Gok2_libmerged	1465630	1465632		psaC	2
Gok2_libmerged	1466095	1466100		psaC	5
Gok2_libmerged	1466176	1466194		psaC	18
Gok2_libmerged	1466283	1466312		psaC	29
Gok2_libmerged	1466565	1466641		psaC	76
Gok2_libmerged	1467863	1467921		YPO_RS07515	58
Gok2_libmerged	1468315	1468379		YPO_RS07515	64
Gok2_libmerged	1468431	1468441		YPO_RS07515	10
Gok2_libmerged	1468890	1468951		YPO_RS07515	61
Gok2_libmerged	1470236	1470247		YPO_RS07520	11
Gok2_libmerged	1471285	1471289		YPO_RS07525	4
Gok2_libmerged	1471423	1471474		YPO_RS07525	51
Gok2_libmerged	1471569	1471570		YPO_RS07525	1
Gok2_libmerged	1471631	1471656		YPO_RS07525	25
Gok2_libmerged	1472101	1472213		YPO_RS07525	112
Gok2_libmerged	1472551	1472564		YPO_RS07530	13
Gok2_libmerged	1472909	1472931		YPO_RS07530	22
Gok2_libmerged	1474086	1474089		YPO_RS07535	3
Gok2_libmerged	1474298	1474302		YPO_RS07535	4
Gok2_libmerged	1474393	1474477		YPO_RS07535	84
Gok2_libmerged	1474793	1474870		YPO_RS07535	77
Gok2_libmerged	1475708	1475743		YPO_RS07540	35
Gok2_libmerged	1476003	1476030		YPO_RS07545	27
Gok2_libmerged	1476083	1476090		YPO_RS07545	7
Gok2_libmerged	1476252	1476261		YPO_RS07545	9
Gok2_libmerged	1476322	1476336		YPO_RS07545	14
Gok2_libmerged	1476407	1476429		YPO_RS07545	22
Gok2_libmerged	1476698	1476702		YPO_RS07545	4
Gok2_libmerged	1476764	1476883		YPO_RS07545	119
Gok2_libmerged	1477003	1477071		YPO_RS07545	68
Gok2_libmerged	1477219	1477242		YPO_RS07545	23
Gok2_libmerged	1477520	1477523		YPO_RS07545	3
Gok2_libmerged	1478491	1478497		YPO_RS07550	6
Gok2_libmerged	1478813	1478829		YPO_RS07550	16
Gok2_libmerged	1479044	1479049		YPO_RS07555	5
Gok2_libmerged	1479221	1479278		YPO_RS07555	57
Gok2_libmerged	1479526	1479536		YPO_RS07555	10
Gok2_libmerged	1479646	1479648		YPO_RS07555	2
Gok2_libmerged	1480562	1480596		YPO_RS07560	34
Gok2_libmerged	1482271	1482277		YPO_RS07565	6
Gok2_libmerged	1482585	1482588		YPO_RS07570	3
Gok2_libmerged	1482942	1482951		YPO_RS07570	9
Gok2_libmerged	1483006	1483021		YPO_RS07570	15
Gok2_libmerged	1483288	1483299		YPO_RS07575	11
Gok2_libmerged	1484601	1484607		YPO_RS07580	6
Gok2_libmerged	1484690	1484716		YPO_RS07580	26
Gok2_libmerged	1484977	1485040		YPO_RS07580	63
Gok2_libmerged	1485462	1485465		YPO_RS07580	3
Gok2_libmerged	1486296	1486371		YPO_RS07585	75
Gok2_libmerged	1486563	1486580		YPO_RS07585	17
Gok2_libmerged	1487088	1487131		YPO_RS07585	43
Gok2_libmerged	1487179	1487184		YPO_RS07585	5
Gok2_libmerged	1487223	1487232		YPO_RS07585	9
Gok2_libmerged	1488332	1488357		deoR	25
Gok2_libmerged	1488559	1488595		deoR	36
Gok2_libmerged	1488867	1488905		deoR	38
Gok2_libmerged	1489554	1489578		YPO_RS07595	24
Gok2_libmerged	1489972	1489997		YPO_RS07595	25
Gok2_libmerged	1490261	1490352		ybjG	91
Gok2_libmerged	1490592	1490598		ybjG	6
Gok2_libmerged	1490692	1490714		ybjG	22
Gok2_libmerged	1491268	1491285		YPO_RS07605	17
Gok2_libmerged	1491421	1491448		YPO_RS07605	27
Gok2_libmerged	1491481	1491531		YPO_RS07605	50
Gok2_libmerged	1492008	1492017		YPO_RS07610	9
Gok2_libmerged	1492165	1492166		YPO_RS07610	1
Gok2_libmerged	1492632	1492644		YPO_RS07610	12
Gok2_libmerged	1493003	1493040		YPO_RS07610	37
Gok2_libmerged	1493572	1493588		YPO_RS07610	16
Gok2_libmerged	1493651	1493696		YPO_RS07610	45
Gok2_libmerged	1494884	1494974		YPO_RS07620	90
Gok2_libmerged	1495008	1495030		YPO_RS07620	22
Gok2_libmerged	1495436	1495442		YPO_RS07625	6
Gok2_libmerged	1495669	1495717		YPO_RS07625	48
Gok2_libmerged	1496504	1496530		potF	26
Gok2_libmerged	1496573	1496609		potF	36
Gok2_libmerged	1496698	1496713		potF	15
Gok2_libmerged	1496893	1496894		potF	1
Gok2_libmerged	1497066	1497076		potF	10
Gok2_libmerged	1497828	1497849		potG	21
Gok2_libmerged	1497964	1497987		potG	23
Gok2_libmerged	1498139	1498234		potG	95
Gok2_libmerged	1498343	1498360		potG	17
Gok2_libmerged	1498574	1498579		potG	5
Gok2_libmerged	1498863	1498888		potH	25
Gok2_libmerged	1499008	1499022		potH	14
Gok2_libmerged	1499228	1499298		potH	70
Gok2_libmerged	1499489	1499507		potH	18
Gok2_libmerged	1499925	1499957		potI	32
Gok2_libmerged	1500361	1500468		potI	107
Gok2_libmerged	1500805	1500864		YPO_RS07650	59
Gok2_libmerged	1500929	1500943		YPO_RS07650	14
Gok2_libmerged	1501104	1501111		YPO_RS07650	7
Gok2_libmerged	1501394	1501404		rlmC	10
Gok2_libmerged	1502185	1502187		rlmC	2
Gok2_libmerged	1502261	1502276		rlmC	15
Gok2_libmerged	1503213	1503255		YPO_RS07665	42
Gok2_libmerged	1503361	1503425		YPO_RS07665	64
Gok2_libmerged	1503545	1503577		YPO_RS07665	32
Gok2_libmerged	1503643	1503673		YPO_RS07665	30
Gok2_libmerged	1504011	1504035		YPO_RS07670	24
Gok2_libmerged	1504208	1504217		YPO_RS07670	9
Gok2_libmerged	1504384	1504421		YPO_RS07670	37
Gok2_libmerged	1505590	1505634		YPO_RS07680	44
Gok2_libmerged	1505975	1506050		YPO_RS07685	75
Gok2_libmerged	1506162	1506372		YPO_RS07685	210
Gok2_libmerged	1506537	1506588		YPO_RS07685	51
Gok2_libmerged	1507477	1507511		YPO_RS07690	34
Gok2_libmerged	1507715	1507753		YPO_RS07690	38
Gok2_libmerged	1507794	1507798		YPO_RS07690	4
Gok2_libmerged	1508039	1508084		YPO_RS07690	45
Gok2_libmerged	1507313	1507335		YPO_RS07690	22
Gok2_libmerged	1508924	1508938		YPO_RS07700	14
Gok2_libmerged	1509033	1509040		YPO_RS07705	7
Gok2_libmerged	1509301	1509310		YPO_RS07705	9
Gok2_libmerged	1509420	1509460		YPO_RS07705	40
Gok2_libmerged	1509457	1509460		YPO_RS07710	3
Gok2_libmerged	1509547	1509558		YPO_RS07710	11
Gok2_libmerged	1509709	1509714		YPO_RS07710	5
Gok2_libmerged	1510001	1510002		YPO_RS07710	1
Gok2_libmerged	1510188	1510217		YPO_RS07710	29
Gok2_libmerged	1510819	1510860		YPO_RS07715	41
Gok2_libmerged	1511071	1511073		YPO_RS07720	2
Gok2_libmerged	1511140	1511143		YPO_RS07720	3
Gok2_libmerged	1511607	1511637		YPO_RS07720	30
Gok2_libmerged	1512031	1512075		YPO_RS07720	44
Gok2_libmerged	1512496	1512548		YPO_RS07725	52
Gok2_libmerged	1512642	1512673		YPO_RS07725	31
Gok2_libmerged	1512802	1512830		YPO_RS07725	28
Gok2_libmerged	1513222	1513232		YPO_RS07725	10
Gok2_libmerged	1513382	1513389		YPO_RS07730	7
Gok2_libmerged	1513475	1513496		artM	21
Gok2_libmerged	1513820	1513822		artM	2
Gok2_libmerged	1513973	1513987		artM	14
Gok2_libmerged	1514050	1514051		artM	1
Gok2_libmerged	1514540	1514549		artQ	9
Gok2_libmerged	1514642	1514669		artQ	27
Gok2_libmerged	1515047	1515060		artJ	13
Gok2_libmerged	1515570	1515571		artP	1
Gok2_libmerged	1515677	1515690		artP	13
Gok2_libmerged	1515846	1515875		artP	29
Gok2_libmerged	1516946	1516995		YPO_RS07755	49
Gok2_libmerged	1517566	1517581		YPO_RS07760	15
Gok2_libmerged	1518142	1518157		YPO_RS07765	15
Gok2_libmerged	1518382	1518396		YPO_RS07765	14
Gok2_libmerged	1519120	1519156		YPO_RS07770	36
Gok2_libmerged	1519249	1519267		YPO_RS07770	18
Gok2_libmerged	1519359	1519365		YPO_RS07770	6
Gok2_libmerged	1519686	1519700		YPO_RS07770	14
Gok2_libmerged	1520046	1520078		YPO_RS07770	32
Gok2_libmerged	1520347	1520372		YPO_RS07770	25
Gok2_libmerged	1520514	1520524		YPO_RS07770	10
Gok2_libmerged	1520677	1520701		ltaE	24
Gok2_libmerged	1520839	1520849		ltaE	10
Gok2_libmerged	1521292	1521402		ltaE	110
Gok2_libmerged	1521957	1522000		poxB	43
Gok2_libmerged	1522213	1522216		poxB	3
Gok2_libmerged	1522252	1522270		poxB	18
Gok2_libmerged	1522732	1522736		poxB	4
Gok2_libmerged	1523220	1523230		poxB	10
Gok2_libmerged	1523400	1523416		poxB	16
Gok2_libmerged	1523535	1523544		poxB	9
Gok2_libmerged	1523909	1523937		hcr	28
Gok2_libmerged	1523994	1524049		hcr	55
Gok2_libmerged	1524670	1524720		hcr	50
Gok2_libmerged	1524786	1524844		hcr	58
Gok2_libmerged	1525245	1525254		hcp	9
Gok2_libmerged	1525394	1525418		hcp	24
Gok2_libmerged	1525574	1525599		hcp	25
Gok2_libmerged	1525829	1525851		hcp	22
Gok2_libmerged	1525994	1526062		hcp	68
Gok2_libmerged	1526466	1526493		hcp	27
Gok2_libmerged	1527079	1527089		YPO_RS07795	10
Gok2_libmerged	1527675	1527708		YPO_RS07795	33
Gok2_libmerged	1528105	1528127		YPO_RS07800	22
Gok2_libmerged	1528346	1528351		YPO_RS07800	5
Gok2_libmerged	1528672	1528691		YPO_RS07800	19
Gok2_libmerged	1528779	1528810		YPO_RS07800	31
Gok2_libmerged	1529031	1529084		YPO_RS07800	53
Gok2_libmerged	1529338	1529425		YPO_RS07800	87
Gok2_libmerged	1530016	1530039		YPO_RS07805	23
Gok2_libmerged	1530282	1530347		YPO_RS07805	65
Gok2_libmerged	1530472	1530474		YPO_RS07805	2
Gok2_libmerged	1530811	1530812		YPO_RS07805	1
Gok2_libmerged	1531139	1531160		macA	21
Gok2_libmerged	1531248	1531275		macA	27
Gok2_libmerged	1531354	1531362		macA	8
Gok2_libmerged	1531646	1531648		macA	2
Gok2_libmerged	1531892	1531897		macA	5
Gok2_libmerged	1532129	1532140		macA	11
Gok2_libmerged	1532477	1532486		macB	9
Gok2_libmerged	1533069	1533154		macB	85
Gok2_libmerged	1533430	1533439		macB	9
Gok2_libmerged	1533538	1533541		macB	3
Gok2_libmerged	1533640	1533654		macB	14
Gok2_libmerged	1535556	1535589		clpA	33
Gok2_libmerged	1536063	1536085		clpA	22
Gok2_libmerged	1537205	1537289		clpA	84
Gok2_libmerged	1538050	1538053		YPO_RS07835	3
Gok2_libmerged	1538147	1538157		YPO_RS07835	10
Gok2_libmerged	1540431	1540467		cydC	36
Gok2_libmerged	1540594	1540627		cydC	33
Gok2_libmerged	1541005	1541030		cydC	25
Gok2_libmerged	1541121	1541170		cydC	49
Gok2_libmerged	1541236	1541255		cydC	19
Gok2_libmerged	1541307	1541323		cydC	16
Gok2_libmerged	1541703	1541743		cydC	40
Gok2_libmerged	1540073	1540208		cydC	135
Gok2_libmerged	1541823	1541825		cydD	2
Gok2_libmerged	1541922	1541955		cydD	33
Gok2_libmerged	1542261	1542301		cydD	40
Gok2_libmerged	1542492	1542505		cydD	13
Gok2_libmerged	1542738	1542782		cydD	44
Gok2_libmerged	1544228	1544248		trxB	20
Gok2_libmerged	1544340	1544343		trxB	3
Gok2_libmerged	1544493	1544494		trxB	1
Gok2_libmerged	1544592	1544597		trxB	5
Gok2_libmerged	1545754	1545770		lrp	16
Gok2_libmerged	1545940	1545959		lrp	19
Gok2_libmerged	1546240	1546248		lrp	8
Gok2_libmerged	1546498	1546506		YPO_RS07870	8
Gok2_libmerged	1546593	1546631		YPO_RS07870	38
Gok2_libmerged	1546824	1546830		YPO_RS07870	6
Gok2_libmerged	1546879	1546907		YPO_RS07870	28
Gok2_libmerged	1547026	1547035		YPO_RS07870	9
Gok2_libmerged	1547793	1547795		YPO_RS07870	2
Gok2_libmerged	1548063	1548090		YPO_RS07870	27
Gok2_libmerged	1548154	1548161		YPO_RS07870	7
Gok2_libmerged	1548396	1548407		YPO_RS07870	11
Gok2_libmerged	1549153	1549179		YPO_RS07870	26
Gok2_libmerged	1549633	1549639		YPO_RS07870	6
Gok2_libmerged	1549775	1549839		YPO_RS07870	64
Gok2_libmerged	1549892	1549925		YPO_RS07870	33
Gok2_libmerged	1549993	1549995		YPO_RS07870	2
Gok2_libmerged	1550038	1550049		YPO_RS07870	11
Gok2_libmerged	1550104	1550117		YPO_RS07870	13
Gok2_libmerged	1550277	1550288		YPO_RS07870	11
Gok2_libmerged	1550730	1550754		lolA	24
Gok2_libmerged	1550809	1550814		lolA	5
Gok2_libmerged	1551025	1551089		lolA	64
Gok2_libmerged	1551100	1551109		YPO_RS07880	9
Gok2_libmerged	1551859	1551956		YPO_RS07880	97
Gok2_libmerged	1552685	1552687		serS	2
Gok2_libmerged	1553011	1553062		serS	51
Gok2_libmerged	1553203	1553222		serS	19
Gok2_libmerged	1553479	1553489		serS	10
Gok2_libmerged	1553922	1553977		serS	55
Gok2_libmerged	1554402	1554472		YPO_RS07890	70
Gok2_libmerged	1554641	1554656		YPO_RS07890	15
Gok2_libmerged	1554924	1554930		YPO_RS07890	6
Gok2_libmerged	1554993	1555100		YPO_RS07890	107
Gok2_libmerged	1555338	1555388		YPO_RS07890	50
Gok2_libmerged	1555847	1555855		pflA	8
Gok2_libmerged	1556032	1556055		pflA	23
Gok2_libmerged	1557263	1557398		YPO_RS07900	135
Gok2_libmerged	1557465	1557541		YPO_RS07900	76
Gok2_libmerged	1557662	1557696		YPO_RS07900	34
Gok2_libmerged	1557786	1557937		YPO_RS07900	151
Gok2_libmerged	1558604	1558652		pflB	48
Gok2_libmerged	1558719	1558774		pflB	55
Gok2_libmerged	1559463	1559518		pflB	55
Gok2_libmerged	1560074	1560131		pflB	57
Gok2_libmerged	1560216	1560218		pflB	2
Gok2_libmerged	1560286	1560297		pflB	11
Gok2_libmerged	1560469	1560470		focA	1
Gok2_libmerged	1560721	1560725		focA	4
Gok2_libmerged	1560815	1560835		focA	20
Gok2_libmerged	1560992	1560995		focA	3
Gok2_libmerged	1561106	1561112		focA	6
Gok2_libmerged	1562219	1562249		YPO_RS07915	30
Gok2_libmerged	1562481	1562491		YPO_RS07915	10
Gok2_libmerged	1562800	1562803		YPO_RS07915	3
Gok2_libmerged	1562968	1563015		YPO_RS07915	47
Gok2_libmerged	1563123	1563180		YPO_RS07915	57
Gok2_libmerged	1563400	1563420		YPO_RS07915	20
Gok2_libmerged	1563564	1563567		YPO_RS07915	3
Gok2_libmerged	1563862	1563988		ansB	126
Gok2_libmerged	1564574	1564610		ansB	36
Gok2_libmerged	1564742	1564899		ansB	157
Gok2_libmerged	1565168	1565191		YPO_RS07925	23
Gok2_libmerged	1565608	1565785		YPO_RS07925	177
Gok2_libmerged	1565870	1566046		YPO_RS07925	176
Gok2_libmerged	1566143	1566201		YPO_RS07925	58
Gok2_libmerged	1566358	1566430		YPO_RS07930	72
Gok2_libmerged	1566698	1566722		YPO_RS07930	24
Gok2_libmerged	1566809	1566912		YPO_RS07930	103
Gok2_libmerged	1567085	1567144		YPO_RS07930	59
Gok2_libmerged	1567211	1567225		YPO_RS07930	14
Gok2_libmerged	1567310	1567334		YPO_RS07930	24
Gok2_libmerged	1567389	1567395		YPO_RS07930	6
Gok2_libmerged	1567525	1567819		YPO_RS07930	294
Gok2_libmerged	1568066	1568071		YPO_RS07930	5
Gok2_libmerged	1568107	1568130		YPO_RS07930	23
Gok2_libmerged	1568553	1568554		serC	1
Gok2_libmerged	1568907	1569072		serC	165
Gok2_libmerged	1569482	1569493		serC	11
Gok2_libmerged	1569878	1569927		aroA	49
Gok2_libmerged	1570365	1570381		aroA	16
Gok2_libmerged	1570525	1570527		aroA	2
Gok2_libmerged	1570838	1570916		aroA	78
Gok2_libmerged	1572790	1572823		rpsA	33
Gok2_libmerged	1573095	1573098		rpsA	3
Gok2_libmerged	1573570	1573618		rpsA	48
Gok2_libmerged	1573944	1573976		ihfB	32
Gok2_libmerged	1574953	1574990		YPO_RS07960	37
Gok2_libmerged	1575419	1575438		YPO_RS07960	19
Gok2_libmerged	1575830	1575851		YPO_RS07960	21
Gok2_libmerged	1575934	1575935		YPO_RS07960	1
Gok2_libmerged	1576038	1576040		YPO_RS07960	2
Gok2_libmerged	1576194	1576205		YPO_RS07960	11
Gok2_libmerged	1576255	1576293		YPO_RS07960	38
Gok2_libmerged	1576558	1576594		YPO_RS07960	36
Gok2_libmerged	1576677	1576705		YPO_RS07960	28
Gok2_libmerged	1576773	1576819		YPO_RS07960	46
Gok2_libmerged	1577023	1577036		YPO_RS07960	13
Gok2_libmerged	1577667	1577702		msbA	35
Gok2_libmerged	1578009	1578036		msbA	27
Gok2_libmerged	1578292	1578294		msbA	2
Gok2_libmerged	1578370	1578410		msbA	40
Gok2_libmerged	1578663	1578683		msbA	20
Gok2_libmerged	1579097	1579142		lpxK	45
Gok2_libmerged	1579509	1579518		lpxK	9
Gok2_libmerged	1579665	1579688		lpxK	23
Gok2_libmerged	1579811	1579833		lpxK	22
Gok2_libmerged	1580130	1580172		YPO_RS07975	42
Gok2_libmerged	1580224	1580238		YPO_RS07975	14
Gok2_libmerged	1580416	1580432		YPO_RS07975	16
Gok2_libmerged	1581214	1581228		YPO_RS07975	14
Gok2_libmerged	1581996	1582115		YPO_RS07980	119
Gok2_libmerged	1583057	1583059		kdsB	2
Gok2_libmerged	1583242	1583262		kdsB	20
Gok2_libmerged	1584139	1584151		YPO_RS07995	12
Gok2_libmerged	1584871	1584882		YPO_RS07995	11
Gok2_libmerged	1586050	1586073		cmoM	23
Gok2_libmerged	1586310	1586373		cmoM	63
Gok2_libmerged	1586649	1586705		mukF	56
Gok2_libmerged	1588030	1588050		mukE	20
Gok2_libmerged	1588246	1588249		mukE	3
Gok2_libmerged	1588289	1588308		mukE	19
Gok2_libmerged	1588771	1588777		mukB	6
Gok2_libmerged	1590597	1590603		mukB	6
Gok2_libmerged	1590714	1590749		mukB	35
Gok2_libmerged	1590996	1591024		mukB	28
Gok2_libmerged	1591289	1591329		mukB	40
Gok2_libmerged	1592043	1592090		mukB	47
Gok2_libmerged	1592398	1592410		mukB	12
Gok2_libmerged	1592680	1592702		mukB	22
Gok2_libmerged	1592791	1592871		mukB	80
Gok2_libmerged	1592963	1592980		mukB	17
Gok2_libmerged	1593383	1593395		YPO_RS08020	12
Gok2_libmerged	1593489	1593498		YPO_RS08020	9
Gok2_libmerged	1593598	1593629		YPO_RS08020	31
Gok2_libmerged	1594703	1594720		ldtD	17
Gok2_libmerged	1595072	1595077		ldtD	5
Gok2_libmerged	1596445	1596447		YPO_RS08030	2
Gok2_libmerged	1597007	1597016		YPO_RS08035	9
Gok2_libmerged	1597207	1597219		YPO_RS08035	12
Gok2_libmerged	1597438	1597468		YPO_RS08040	30
Gok2_libmerged	1597857	1597864		YPO_RS08045	7
Gok2_libmerged	1598122	1598181		YPO_RS08045	59
Gok2_libmerged	1598562	1598580		YPO_RS08045	18
Gok2_libmerged	1598657	1598693		YPO_RS08045	36
Gok2_libmerged	1599282	1599292		ompF	10
Gok2_libmerged	1599581	1599583		ompF	2
Gok2_libmerged	1599815	1599825		ompF	10
Gok2_libmerged	1600068	1600090		ompF	22
Gok2_libmerged	1600884	1600909		asnS	25
Gok2_libmerged	1601379	1601398		asnS	19
Gok2_libmerged	1601530	1601544		asnS	14
Gok2_libmerged	1601725	1601734		asnS	9
Gok2_libmerged	1601888	1601898		asnS	10
Gok2_libmerged	1602563	1602621		pncB	58
Gok2_libmerged	1602692	1602708		pncB	16
Gok2_libmerged	1602838	1602842		pncB	4
Gok2_libmerged	1602936	1603007		pncB	71
Gok2_libmerged	1603041	1603083		pncB	42
Gok2_libmerged	1603264	1603265		pncB	1
Gok2_libmerged	1603361	1603364		pncB	3
Gok2_libmerged	1603556	1603563		pncB	7
Gok2_libmerged	1604619	1604650		pepN	31
Gok2_libmerged	1604952	1605038		pepN	86
Gok2_libmerged	1605145	1605194		pepN	49
Gok2_libmerged	1605470	1605525		pepN	55
Gok2_libmerged	1605697	1605724		pepN	27
Gok2_libmerged	1605834	1605962		pepN	128
Gok2_libmerged	1606083	1606097		pepN	14
Gok2_libmerged	1606298	1606300		pepN	2
Gok2_libmerged	1606337	1606383		pepN	46
Gok2_libmerged	1606621	1606656		pepN	35
Gok2_libmerged	1607682	1607683		pyrD	1
Gok2_libmerged	1607900	1608138		pyrD	238
Gok2_libmerged	1608236	1608316		pyrD	80
Gok2_libmerged	1608360	1608377		pyrD	17
Gok2_libmerged	1609262	1609284		YPO_RS08075	22
Gok2_libmerged	1609464	1609472		YPO_RS08080	8
Gok2_libmerged	1609559	1609573		YPO_RS08080	14
Gok2_libmerged	1609622	1609642		YPO_RS08080	20
Gok2_libmerged	1610429	1610457		YPO_RS08080	28
Gok2_libmerged	1610867	1610878		rlmKL	11
Gok2_libmerged	1611038	1611059		rlmKL	21
Gok2_libmerged	1611495	1611528		rlmKL	33
Gok2_libmerged	1612102	1612114		rlmKL	12
Gok2_libmerged	1612555	1612557		rlmKL	2
Gok2_libmerged	1612844	1612898		YPO_RS08090	54
Gok2_libmerged	1613241	1613255		YPO_RS08090	14
Gok2_libmerged	1613327	1613333		YPO_RS08090	6
Gok2_libmerged	1613664	1613715		YPO_RS08090	51
Gok2_libmerged	1614048	1614065		YPO_RS08090	17
Gok2_libmerged	1614192	1614224		YPO_RS08090	32
Gok2_libmerged	1614342	1614355		YPO_RS08090	13
Gok2_libmerged	1614728	1614741		pqiA	13
Gok2_libmerged	1615063	1615093		pqiA	30
Gok2_libmerged	1615269	1615271		pqiA	2
Gok2_libmerged	1615308	1615332		pqiA	24
Gok2_libmerged	1615467	1615470		pqiA	3
Gok2_libmerged	1615555	1615586		pqiA	31
Gok2_libmerged	1615864	1615936		pqiA	72
Gok2_libmerged	1616106	1616151		pqiB	45
Gok2_libmerged	1616244	1616362		pqiB	118
Gok2_libmerged	1616504	1616524		pqiB	20
Gok2_libmerged	1616763	1616772		pqiB	9
Gok2_libmerged	1617466	1617486		pqiB	20
Gok2_libmerged	1617815	1617823		pqiC	8
Gok2_libmerged	1617870	1617893		pqiC	23
Gok2_libmerged	1618544	1618575		rmf	31
Gok2_libmerged	1618874	1618890		YPO_RS08115	16
Gok2_libmerged	1619076	1619081		YPO_RS08115	5
Gok2_libmerged	1621463	1621469		YPO_RS08130	6
Gok2_libmerged	1621622	1621628		YPO_RS08130	6
Gok2_libmerged	1621661	1621662		YPO_RS08130	1
Gok2_libmerged	1621907	1621917		YPO_RS08130	10
Gok2_libmerged	1622183	1622220		YPO_RS08130	37
Gok2_libmerged	1622277	1622283		YPO_RS08130	6
Gok2_libmerged	1622000	1622020		YPO_RS08130	20
Gok2_libmerged	1623371	1623405		fabA	34
Gok2_libmerged	1623702	1623769		fabA	67
Gok2_libmerged	1623850	1623889		fabA	39
Gok2_libmerged	1624205	1624230		YPO_RS08150	25
Gok2_libmerged	1624496	1624510		YPO_RS08150	14
Gok2_libmerged	1624595	1624626		YPO_RS08150	31
Gok2_libmerged	1625300	1625307		YPO_RS08150	7
Gok2_libmerged	1625429	1625430		YPO_RS08150	1
Gok2_libmerged	1625615	1625709		YPO_RS08150	94
Gok2_libmerged	1626208	1626224		matP	16
Gok2_libmerged	1626316	1626352		matP	36
Gok2_libmerged	1626775	1626777		YPO_RS08160	2
Gok2_libmerged	1626812	1626870		YPO_RS08160	58
Gok2_libmerged	1627276	1627286		ompA	10
Gok2_libmerged	1627763	1627768		ompA	5
Gok2_libmerged	1628127	1628166		ompA	39
Gok2_libmerged	1628611	1628614		sulA	3
Gok2_libmerged	1628700	1628708		sulA	8
Gok2_libmerged	1628915	1628964		sulA	49
Gok2_libmerged	1629068	1629117		sulA	49
Gok2_libmerged	1629653	1629684		YPO_RS08175	31
Gok2_libmerged	1630083	1630094		yccS	11
Gok2_libmerged	1630191	1630195		yccS	4
Gok2_libmerged	1630332	1630358		yccS	26
Gok2_libmerged	1631357	1631363		yccS	6
Gok2_libmerged	1631619	1631637		yccS	18
Gok2_libmerged	1631711	1631829		yccS	118
Gok2_libmerged	1631951	1632047		yccS	96
Gok2_libmerged	1632362	1632369		YPO_RS08185	7
Gok2_libmerged	1632417	1632447		YPO_RS08185	30
Gok2_libmerged	1632519	1632525		YPO_RS08185	6
Gok2_libmerged	1632598	1632622		YPO_RS08185	24
Gok2_libmerged	1632657	1632697		YPO_RS08185	40
Gok2_libmerged	1633695	1633697		helD	2
Gok2_libmerged	1634457	1634482		helD	25
Gok2_libmerged	1634701	1634735		helD	34
Gok2_libmerged	1635033	1635054		YPO_RS08195	21
Gok2_libmerged	1635279	1635286		YPO_RS08195	7
Gok2_libmerged	1635804	1635863		YPO_RS08200	59
Gok2_libmerged	1635984	1635997		YPO_RS08200	13
Gok2_libmerged	1636576	1636588		YPO_RS08205	12
Gok2_libmerged	1636799	1636822		YPO_RS08205	23
Gok2_libmerged	1636859	1636863		YPO_RS08205	4
Gok2_libmerged	1637106	1637120		hspQ	14
Gok2_libmerged	1637404	1637418		hspQ	14
Gok2_libmerged	1637588	1637590		rlmI	2
Gok2_libmerged	1637751	1637756		rlmI	5
Gok2_libmerged	1643127	1643164		YPO_RS08245	37
Gok2_libmerged	1643505	1643529		YPO_RS08245	24
Gok2_libmerged	1643764	1643767		YPO_RS08245	3
Gok2_libmerged	1645168	1645177		YPO_RS08245	9
Gok2_libmerged	1646038	1646041		YPO_RS08250	3
Gok2_libmerged	1646197	1646274		YPO_RS08250	77
Gok2_libmerged	1646378	1646385		YPO_RS08250	7
Gok2_libmerged	1647598	1647713		YPO_RS08260	115
Gok2_libmerged	1647754	1647835		YPO_RS08260	81
Gok2_libmerged	1648124	1648188		YPO_RS08265	64
Gok2_libmerged	1648497	1648502		YPO_RS08265	5
Gok2_libmerged	1649001	1649040		YPO_RS08265	39
Gok2_libmerged	1649170	1649184		YPO_RS08265	14
Gok2_libmerged	1649262	1649332		YPO_RS08265	70
Gok2_libmerged	1649397	1649505		YPO_RS08270	108
Gok2_libmerged	1649713	1649725		YPO_RS08270	12
Gok2_libmerged	1650150	1650172		YPO_RS08275	22
Gok2_libmerged	1650235	1650262		YPO_RS08275	27
Gok2_libmerged	1650321	1650333		YPO_RS08275	12
Gok2_libmerged	1650558	1650574		YPO_RS08275	16
Gok2_libmerged	1650871	1650934		YPO_RS08275	63
Gok2_libmerged	1651084	1651152		YPO_RS08275	68
Gok2_libmerged	1651218	1651223		YPO_RS08275	5
Gok2_libmerged	1651267	1651270		YPO_RS08275	3
Gok2_libmerged	1651735	1651867		YPO_RS08280	132
Gok2_libmerged	1652007	1652033		YPO_RS08280	26
Gok2_libmerged	1652143	1652248		YPO_RS08285	105
Gok2_libmerged	1652319	1652344		YPO_RS08285	25
Gok2_libmerged	1652539	1652597		YPO_RS08285	58
Gok2_libmerged	1652705	1652854		YPO_RS08285	149
Gok2_libmerged	1652857	1652918		YPO_RS08290	61
Gok2_libmerged	1653051	1653144		YPO_RS08290	93
Gok2_libmerged	1653230	1653282		YPO_RS08290	52
Gok2_libmerged	1653487	1653645		YPO_RS08290	158
Gok2_libmerged	1653732	1653749		YPO_RS08295	17
Gok2_libmerged	1653779	1653802		YPO_RS08295	23
Gok2_libmerged	1653972	1654044		YPO_RS08295	72
Gok2_libmerged	1654116	1654172		YPO_RS08295	56
Gok2_libmerged	1654210	1654273		YPO_RS08300	63
Gok2_libmerged	1654557	1654563		YPO_RS08305	6
Gok2_libmerged	1654638	1654654		YPO_RS08305	16
Gok2_libmerged	1654886	1654933		YPO_RS08305	47
Gok2_libmerged	1655017	1655034		YPO_RS08305	17
Gok2_libmerged	1655145	1655324		YPO_RS08305	179
Gok2_libmerged	1655378	1655405		YPO_RS08305	27
Gok2_libmerged	1654751	1654805		YPO_RS08305	54
Gok2_libmerged	1657229	1657234		tssC	5
Gok2_libmerged	1657925	1657932		tssC	7
Gok2_libmerged	1658428	1658429		tssC	1
Gok2_libmerged	1659093	1659121		tssK	28
Gok2_libmerged	1659745	1659746		tssK	1
Gok2_libmerged	1659855	1659914		YPO_RS08325	59
Gok2_libmerged	1660120	1660123		YPO_RS08325	3
Gok2_libmerged	1660183	1660193		YPO_RS08325	10
Gok2_libmerged	1661299	1661301		YPO_RS08330	2
Gok2_libmerged	1661772	1661821		YPO_RS08330	49
Gok2_libmerged	1662213	1662253		YPO_RS08330	40
Gok2_libmerged	1663592	1663604		tssH	12
Gok2_libmerged	1663898	1663988		tssH	90
Gok2_libmerged	1664653	1664659		tssH	6
Gok2_libmerged	1665118	1665128		tssH	10
Gok2_libmerged	1665282	1665283		tssH	1
Gok2_libmerged	1665582	1665647		tssH	65
Gok2_libmerged	1666748	1666757		YPO_RS08345	9
Gok2_libmerged	1667040	1667049		YPO_RS08345	9
Gok2_libmerged	1667206	1667230		YPO_RS08345	24
Gok2_libmerged	1667403	1667406		YPO_RS08345	3
Gok2_libmerged	1667485	1667500		YPO_RS08345	15
Gok2_libmerged	1667816	1667832		YPO_RS08345	16
Gok2_libmerged	1668181	1668261		YPO_RS08350	80
Gok2_libmerged	1668399	1668425		YPO_RS08350	26
Gok2_libmerged	1668483	1668538		YPO_RS08350	55
Gok2_libmerged	1669079	1669083		YPO_RS08350	4
Gok2_libmerged	1669625	1669769		YPO_RS08350	144
Gok2_libmerged	1669855	1669861		YPO_RS08350	6
Gok2_libmerged	1669953	1669982		YPO_RS08350	29
Gok2_libmerged	1670167	1670208		YPO_RS08350	41
Gok2_libmerged	1670248	1670462		YPO_RS08350	214
Gok2_libmerged	1670459	1670521		YPO_RS08355	62
Gok2_libmerged	1670565	1670909		YPO_RS08355	344
Gok2_libmerged	1670945	1671007		YPO_RS08355	62
Gok2_libmerged	1671140	1671232		YPO_RS08355	92
Gok2_libmerged	1671386	1671408		YPO_RS08360	22
Gok2_libmerged	1672025	1672052		YPO_RS08365	27
Gok2_libmerged	1672280	1672295		YPO_RS08365	15
Gok2_libmerged	1672449	1672451		YPO_RS08365	2
Gok2_libmerged	1672568	1672581		YPO_RS08365	13
Gok2_libmerged	1672921	1672998		YPO_RS08365	77
Gok2_libmerged	1673144	1673289		YPO_RS08365	145
Gok2_libmerged	1673360	1673449		YPO_RS08365	89
Gok2_libmerged	1673812	1673845		YPO_RS08365	33
Gok2_libmerged	1674106	1674146		YPO_RS08370	40
Gok2_libmerged	1674235	1674270		YPO_RS08370	35
Gok2_libmerged	1674363	1674367		YPO_RS08370	4
Gok2_libmerged	1674460	1674488		YPO_RS08370	28
Gok2_libmerged	1676653	1676656		YPO_RS08380	3
Gok2_libmerged	1676704	1676709		YPO_RS08380	5
Gok2_libmerged	1677016	1677055		YPO_RS08380	39
Gok2_libmerged	1677268	1677270		YPO_RS08380	2
Gok2_libmerged	1677353	1677386		YPO_RS08380	33
Gok2_libmerged	1677442	1677444		YPO_RS08380	2
Gok2_libmerged	1677516	1677521		YPO_RS08380	5
Gok2_libmerged	1677787	1677842		YPO_RS08380	55
Gok2_libmerged	1678022	1678032		YPO_RS08385	10
Gok2_libmerged	1678446	1678466		YPO_RS08385	20
Gok2_libmerged	1679583	1679636		YPO_RS08385	53
Gok2_libmerged	1679864	1679881		YPO_RS08385	17
Gok2_libmerged	1681005	1681029		YPO_RS08385	24
Gok2_libmerged	1682194	1682196		tssA	2
Gok2_libmerged	1682366	1682505		tssA	139
Gok2_libmerged	1682984	1682989		YPO_RS08395	5
Gok2_libmerged	1683082	1683098		YPO_RS08395	16
Gok2_libmerged	1683250	1683279		YPO_RS08395	29
Gok2_libmerged	1683384	1683388		YPO_RS08395	4
Gok2_libmerged	1683571	1683598		YPO_RS08395	27
Gok2_libmerged	1683726	1683762		YPO_RS08395	36
Gok2_libmerged	1683866	1683868		YPO_RS08395	2
Gok2_libmerged	1683946	1683954		YPO_RS08395	8
Gok2_libmerged	1684048	1684242		YPO_RS08400	194
Gok2_libmerged	1684277	1684299		YPO_RS08400	22
Gok2_libmerged	1684403	1684495		YPO_RS08400	92
Gok2_libmerged	1684966	1684983		tssF	17
Gok2_libmerged	1685032	1685033		tssF	1
Gok2_libmerged	1685419	1685429		tssF	10
Gok2_libmerged	1685481	1685483		tssF	2
Gok2_libmerged	1685707	1685738		tssF	31
Gok2_libmerged	1686319	1686348		tssF	29
Gok2_libmerged	1686907	1686915		tssG	8
Gok2_libmerged	1687043	1687063		tssG	20
Gok2_libmerged	1687531	1687541		tssJ	10
Gok2_libmerged	1687745	1687805		tssJ	60
Gok2_libmerged	1687852	1687904		tssJ	52
Gok2_libmerged	1688394	1688422		tssE	28
Gok2_libmerged	1688637	1688643		YPO_RS08425	6
Gok2_libmerged	1689257	1689276		YPO_RS08425	19
Gok2_libmerged	1689517	1689535		YPO_RS08425	18
Gok2_libmerged	1689642	1689653		YPO_RS08425	11
Gok2_libmerged	1690140	1690150		YPO_RS08430	10
Gok2_libmerged	1690185	1690258		YPO_RS08430	73
Gok2_libmerged	1690369	1690439		YPO_RS08430	70
Gok2_libmerged	1690497	1690529		YPO_RS08430	32
Gok2_libmerged	1690600	1690603		YPO_RS08430	3
Gok2_libmerged	1690716	1690763		YPO_RS08430	47
Gok2_libmerged	1691446	1691452		YPO_RS08435	6
Gok2_libmerged	1691649	1691708		YPO_RS08435	59
Gok2_libmerged	1692013	1692048		YPO_RS08435	35
Gok2_libmerged	1692629	1692632		YPO_RS08435	3
Gok2_libmerged	1692736	1692760		YPO_RS08435	24
Gok2_libmerged	1692886	1692889		YPO_RS08435	3
Gok2_libmerged	1693034	1693041		YPO_RS08435	7
Gok2_libmerged	1693304	1693332		YPO_RS08440	28
Gok2_libmerged	1693426	1693457		YPO_RS08440	31
Gok2_libmerged	1693538	1693557		YPO_RS08440	19
Gok2_libmerged	1693636	1693692		YPO_RS08440	56
Gok2_libmerged	1693758	1693794		YPO_RS08440	36
Gok2_libmerged	1693897	1693922		YPO_RS08440	25
Gok2_libmerged	1693966	1693972		YPO_RS08445	6
Gok2_libmerged	1694056	1694066		YPO_RS08445	10
Gok2_libmerged	1694372	1694385		YPO_RS08445	13
Gok2_libmerged	1694704	1694747		YPO_RS08445	43
Gok2_libmerged	1694870	1694884		YPO_RS08445	14
Gok2_libmerged	1694972	1695006		YPO_RS08445	34
Gok2_libmerged	1695104	1695109		YPO_RS08445	5
Gok2_libmerged	1695374	1695389		moeB	15
Gok2_libmerged	1695792	1695797		moeB	5
Gok2_libmerged	1695950	1695963		moeB	13
Gok2_libmerged	1696027	1696042		moeB	15
Gok2_libmerged	1696135	1696221		moeA	86
Gok2_libmerged	1696583	1696615		moeA	32
Gok2_libmerged	1696697	1696718		moeA	21
Gok2_libmerged	1696844	1696928		moeA	84
Gok2_libmerged	1697891	1697908		darE	17
Gok2_libmerged	1698478	1698592		darE	114
Gok2_libmerged	1698645	1698707		darE	62
Gok2_libmerged	1698742	1698794		darE	52
Gok2_libmerged	1698871	1698919		darE	48
Gok2_libmerged	1699071	1699075		darE	4
Gok2_libmerged	1699163	1699201		darE	38
Gok2_libmerged	1699211	1699228		darD	17
Gok2_libmerged	1699262	1699293		darD	31
Gok2_libmerged	1699371	1699467		darD	96
Gok2_libmerged	1699596	1699636		darD	40
Gok2_libmerged	1699781	1699879		darD	98
Gok2_libmerged	1699881	1699914		darC	33
Gok2_libmerged	1699995	1700079		darC	84
Gok2_libmerged	1700205	1700373		darC	168
Gok2_libmerged	1700440	1700484		darC	44
Gok2_libmerged	1700524	1700574		darC	50
Gok2_libmerged	1700640	1700666		darC	26
Gok2_libmerged	1700797	1700989		darC	192
Gok2_libmerged	1701037	1701116		darC	79
Gok2_libmerged	1701276	1701424		darB	148
Gok2_libmerged	1701534	1701536		darB	2
Gok2_libmerged	1701758	1701767		darB	9
Gok2_libmerged	1701854	1701871		darB	17
Gok2_libmerged	1702058	1702172		darB	114
Gok2_libmerged	1702218	1702291		darB	73
Gok2_libmerged	1702409	1702453		darB	44
Gok2_libmerged	1702524	1702728		darB	204
Gok2_libmerged	1702876	1702890		darB	14
Gok2_libmerged	1703169	1703276		darB	107
Gok2_libmerged	1703353	1703454		darB	101
Gok2_libmerged	1703662	1703672		darA-c	10
Gok2_libmerged	1703718	1703753		darA-c	35
Gok2_libmerged	1704270	1704277		fghA	7
Gok2_libmerged	1704058	1704115		fghA	57
Gok2_libmerged	1704953	1704955		YPO_RS08490	2
Gok2_libmerged	1705177	1705228		YPO_RS08490	51
Gok2_libmerged	1705398	1705448		YPO_RS08490	50
Gok2_libmerged	1705613	1705682		YPO_RS08490	69
Gok2_libmerged	1705810	1705824		YPO_RS08490	14
Gok2_libmerged	1705920	1705935		YPO_RS08490	15
Gok2_libmerged	1706018	1706060		YPO_RS08490	42
Gok2_libmerged	1706334	1706355		YPO_RS08495	21
Gok2_libmerged	1706503	1706513		YPO_RS08495	10
Gok2_libmerged	1706675	1706681		YPO_RS08495	6
Gok2_libmerged	1706784	1706789		YPO_RS08495	5
Gok2_libmerged	1706943	1706949		YPO_RS08495	6
Gok2_libmerged	1707591	1707597		YPO_RS08500	6
Gok2_libmerged	1708251	1708253		YPO_RS08500	2
Gok2_libmerged	1708442	1708450		YPO_RS08500	8
Gok2_libmerged	1708895	1708957		folE	62
Gok2_libmerged	1709060	1709072		folE	12
Gok2_libmerged	1709191	1709208		folE	17
Gok2_libmerged	1709576	1709593		YPO_RS08510	17
Gok2_libmerged	1710106	1710143		YPO_RS08510	37
Gok2_libmerged	1710232	1710258		YPO_RS08510	26
Gok2_libmerged	1710315	1710390		YPO_RS08510	75
Gok2_libmerged	1710495	1710557		YPO_RS08510	62
Gok2_libmerged	1711305	1711352		mglB	47
Gok2_libmerged	1711608	1711683		mglB	75
Gok2_libmerged	1711952	1712014		mglB	62
Gok2_libmerged	1712265	1712312		mglB	47
Gok2_libmerged	1712562	1712579		mglA	17
Gok2_libmerged	1712689	1712847		mglA	158
Gok2_libmerged	1713365	1713390		mglA	25
Gok2_libmerged	1713625	1713652		mglA	27
Gok2_libmerged	1713883	1713968		mglA	85
Gok2_libmerged	1714036	1714062		mglA	26
Gok2_libmerged	1714083	1714163		mglC	80
Gok2_libmerged	1714197	1714233		mglC	36
Gok2_libmerged	1714489	1714512		mglC	23
Gok2_libmerged	1714643	1714696		mglC	53
Gok2_libmerged	1714931	1714932		mglC	1
Gok2_libmerged	1714987	1715011		mglC	24
Gok2_libmerged	1716056	1716073		sanA	17
Gok2_libmerged	1716106	1716118		sanA	12
Gok2_libmerged	1716182	1716256		sanA	74
Gok2_libmerged	1716814	1716896		YPO_RS08535	82
Gok2_libmerged	1716995	1717022		YPO_RS08535	27
Gok2_libmerged	1717594	1717633		YPO_RS08535	39
Gok2_libmerged	1717712	1717778		YPO_RS08535	66
Gok2_libmerged	1718224	1718253		YPO_RS08535	29
Gok2_libmerged	1718771	1718797		cdd	26
Gok2_libmerged	1718958	1718970		cdd	12
Gok2_libmerged	1719025	1719029		cdd	4
Gok2_libmerged	1719214	1719233		cdd	19
Gok2_libmerged	1719864	1719907		YPO_RS08545	43
Gok2_libmerged	1720028	1720053		YPO_RS08545	25
Gok2_libmerged	1720147	1720168		YPO_RS08545	21
Gok2_libmerged	1720230	1720233		YPO_RS08545	3
Gok2_libmerged	1720386	1720413		YPO_RS08545	27
Gok2_libmerged	1720560	1720561		YPO_RS08550	1
Gok2_libmerged	1720702	1720723		YPO_RS08550	21
Gok2_libmerged	1721160	1721222		YPO_RS08555	62
Gok2_libmerged	1721514	1721584		YPO_RS08555	70
Gok2_libmerged	1721735	1721752		YPO_RS08555	17
Gok2_libmerged	1722097	1722158		YPO_RS08555	61
Gok2_libmerged	1722674	1722717		YPO_RS08560	43
Gok2_libmerged	1722875	1722950		YPO_RS08560	75
Gok2_libmerged	1723063	1723086		YPO_RS08560	23
Gok2_libmerged	1723316	1723327		YPO_RS08560	11
Gok2_libmerged	1723383	1723398		YPO_RS08560	15
Gok2_libmerged	1723818	1723856		YPO_RS08560	38
Gok2_libmerged	1723896	1723927		YPO_RS08560	31
Gok2_libmerged	1724238	1724258		YPO_RS08565	20
Gok2_libmerged	1724993	1725021		YPO_RS08565	28
Gok2_libmerged	1726061	1726091		YPO_RS08570	30
Gok2_libmerged	1726173	1726342		YPO_RS08570	169
Gok2_libmerged	1726646	1726678		YPO_RS08575	32
Gok2_libmerged	1726861	1726868		YPO_RS08575	7
Gok2_libmerged	1726994	1727070		YPO_RS08575	76
Gok2_libmerged	1727238	1727326		YPO_RS08575	88
Gok2_libmerged	1727512	1727523		YPO_RS08580	11
Gok2_libmerged	1727597	1727631		YPO_RS08580	34
Gok2_libmerged	1727664	1727683		YPO_RS08580	19
Gok2_libmerged	1727897	1727920		YPO_RS08580	23
Gok2_libmerged	1728071	1728086		YPO_RS08580	15
Gok2_libmerged	1728290	1728295		YPO_RS08580	5
Gok2_libmerged	1728344	1728352		YPO_RS08580	8
Gok2_libmerged	1728558	1728590		YPO_RS08585	32
Gok2_libmerged	1728881	1728890		YPO_RS08585	9
Gok2_libmerged	1729726	1729753		metG	27
Gok2_libmerged	1729877	1729894		metG	17
Gok2_libmerged	1730181	1730188		metG	7
Gok2_libmerged	1730236	1730280		metG	44
Gok2_libmerged	1730416	1730461		metG	45
Gok2_libmerged	1730498	1730501		metG	3
Gok2_libmerged	1731600	1731620		apbC	20
Gok2_libmerged	1731682	1731684		apbC	2
Gok2_libmerged	1731738	1731753		apbC	15
Gok2_libmerged	1732119	1732150		apbC	31
Gok2_libmerged	1732276	1732295		apbC	19
Gok2_libmerged	1732884	1732931		udk	47
Gok2_libmerged	1733022	1733030		udk	8
Gok2_libmerged	1733129	1733186		udk	57
Gok2_libmerged	1733343	1733349		udk	6
Gok2_libmerged	1733797	1733817		dcd	20
Gok2_libmerged	1733991	1734003		dcd	12
Gok2_libmerged	1734076	1734094		dcd	18
Gok2_libmerged	1734343	1734407		asmA	64
Gok2_libmerged	1734581	1734663		asmA	82
Gok2_libmerged	1734893	1734901		asmA	8
Gok2_libmerged	1735108	1735148		asmA	40
Gok2_libmerged	1735241	1735267		asmA	26
Gok2_libmerged	1735500	1735501		asmA	1
Gok2_libmerged	1735583	1735593		asmA	10
Gok2_libmerged	1735682	1735729		asmA	47
Gok2_libmerged	1736030	1736055		asmA	25
Gok2_libmerged	1736128	1736164		asmA	36
Gok2_libmerged	1736381	1736506		YPO_RS08615	125
Gok2_libmerged	1737009	1737073		YPO_RS08615	64
Gok2_libmerged	1737286	1737287		YPO_RS08615	1
Gok2_libmerged	1737852	1737928		YPO_RS08615	76
Gok2_libmerged	1738525	1738534		fhuF	9
Gok2_libmerged	1738566	1738691		fhuF	125
Gok2_libmerged	1738987	1739004		fhuF	17
Gok2_libmerged	1739303	1739365		YPO_RS08625	62
Gok2_libmerged	1739459	1739462		YPO_RS08625	3
Gok2_libmerged	1739519	1739635		YPO_RS08625	116
Gok2_libmerged	1739807	1739809		YPO_RS08625	2
Gok2_libmerged	1739865	1739867		YPO_RS08625	2
Gok2_libmerged	1739936	1739988		YPO_RS08625	52
Gok2_libmerged	1740076	1740077		YPO_RS08625	1
Gok2_libmerged	1740404	1740416		YPO_RS08625	12
Gok2_libmerged	1740568	1740580		YPO_RS08625	12
Gok2_libmerged	1740829	1740834		YPO_RS08625	5
Gok2_libmerged	1740916	1740971		YPO_RS08630	55
Gok2_libmerged	1741023	1741073		YPO_RS08630	50
Gok2_libmerged	1741160	1741199		YPO_RS08630	39
Gok2_libmerged	1741312	1741369		YPO_RS08630	57
Gok2_libmerged	1741487	1741568		YPO_RS08630	81
Gok2_libmerged	1741625	1741642		YPO_RS08630	17
Gok2_libmerged	1741731	1741735		YPO_RS08630	4
Gok2_libmerged	1741886	1741890		YPO_RS08630	4
Gok2_libmerged	1741939	1741941		YPO_RS08630	2
Gok2_libmerged	1742038	1742074		YPO_RS08630	36
Gok2_libmerged	1742931	1742944		YPO_RS08640	13
Gok2_libmerged	1743025	1743090		YPO_RS08640	65
Gok2_libmerged	1743234	1743245		YPO_RS08640	11
Gok2_libmerged	1743284	1743296		YPO_RS08640	12
Gok2_libmerged	1743546	1743594		YPO_RS08640	48
Gok2_libmerged	1743684	1743723		YPO_RS08640	39
Gok2_libmerged	1743859	1743900		YPO_RS08640	41
Gok2_libmerged	1743951	1743981		YPO_RS08640	30
Gok2_libmerged	1744079	1744125		YPO_RS08640	46
Gok2_libmerged	1744845	1744887		YPO_RS08645	42
Gok2_libmerged	1744979	1745029		YPO_RS08645	50
Gok2_libmerged	1745302	1745319		YPO_RS08645	17
Gok2_libmerged	1745528	1745529		YPO_RS08645	1
Gok2_libmerged	1745613	1745657		YPO_RS08650	44
Gok2_libmerged	1745807	1745824		YPO_RS08650	17
Gok2_libmerged	1746361	1746362		YPO_RS08650	1
Gok2_libmerged	1746756	1746763		YPO_RS08655	7
Gok2_libmerged	1747081	1747102		YPO_RS08655	21
Gok2_libmerged	1747381	1747391		YPO_RS08655	10
Gok2_libmerged	1747620	1747623		YPO_RS08655	3
Gok2_libmerged	1747620	1747644		YPO_RS08660	24
Gok2_libmerged	1748129	1748134		YPO_RS08660	5
Gok2_libmerged	1748199	1748217		YPO_RS08660	18
Gok2_libmerged	1748807	1748849		YPO_RS08665	42
Gok2_libmerged	1749064	1749131		YPO_RS08665	67
Gok2_libmerged	1749417	1749514		YPO_RS08665	97
Gok2_libmerged	1749616	1749680		YPO_RS08665	64
Gok2_libmerged	1749851	1749853		YPO_RS08665	2
Gok2_libmerged	1750001	1750012		YPO_RS08665	11
Gok2_libmerged	1750105	1750135		YPO_RS08665	30
Gok2_libmerged	1750536	1750581		YPO_RS08665	45
Gok2_libmerged	1750971	1750989		YPO_RS08665	18
Gok2_libmerged	1752106	1752122		YPO_RS08670	16
Gok2_libmerged	1752481	1752501		YPO_RS08670	20
Gok2_libmerged	1752531	1752571		YPO_RS08670	40
Gok2_libmerged	1752617	1752682		YPO_RS08670	65
Gok2_libmerged	1752852	1752872		YPO_RS08670	20
Gok2_libmerged	1752918	1752940		YPO_RS08670	22
Gok2_libmerged	1753036	1753077		YPO_RS08670	41
Gok2_libmerged	1754470	1754487		galU	17
Gok2_libmerged	1754611	1754613		galU	2
Gok2_libmerged	1754997	1755003		galU	6
Gok2_libmerged	1755182	1755211		galU	29
Gok2_libmerged	1755377	1755390		galU	13
Gok2_libmerged	1756334	1756343		gndA	9
Gok2_libmerged	1756835	1756840		gndA	5
Gok2_libmerged	1756919	1756968		gndA	49
Gok2_libmerged	1757003	1757043		gndA	40
Gok2_libmerged	1757132	1757163		gndA	31
Gok2_libmerged	1757368	1757414		gndA	46
Gok2_libmerged	1757995	1758103		YPO_RS08690	108
Gok2_libmerged	1759813	1759889		hisA	76
Gok2_libmerged	1759984	1759988		hisA	4
Gok2_libmerged	1759994	1760006		hisH	12
Gok2_libmerged	1760171	1760222		hisH	51
Gok2_libmerged	1760448	1760460		hisH	12
Gok2_libmerged	1760496	1760535		hisH	39
Gok2_libmerged	1761838	1761875		hisC	37
Gok2_libmerged	1762115	1762125		hisC	10
Gok2_libmerged	1762231	1762263		hisC	32
Gok2_libmerged	1762702	1762742		hisC	40
Gok2_libmerged	1762944	1762964		hisD	20
Gok2_libmerged	1763313	1763320		hisD	7
Gok2_libmerged	1763362	1763365		hisD	3
Gok2_libmerged	1763432	1763439		hisD	7
Gok2_libmerged	1763511	1763531		hisD	20
Gok2_libmerged	1763713	1763717		hisD	4
Gok2_libmerged	1763851	1763878		hisD	27
Gok2_libmerged	1764244	1764248		hisG	4
Gok2_libmerged	1764295	1764311		hisG	16
Gok2_libmerged	1764611	1764667		hisG	56
Gok2_libmerged	1765003	1765033		hisG	30
Gok2_libmerged	1765316	1765330		hisL	14
Gok2_libmerged	1765739	1765794		YPO_RS08735	55
Gok2_libmerged	1765956	1765964		YPO_RS08735	8
Gok2_libmerged	1766083	1766149		YPO_RS08735	66
Gok2_libmerged	1766186	1766228		YPO_RS08735	42
Gok2_libmerged	1766721	1766780		YPO_RS08740	59
Gok2_libmerged	1767626	1767629		YPO_RS08745	3
Gok2_libmerged	1767746	1767748		YPO_RS08745	2
Gok2_libmerged	1768258	1768262		YPO_RS08745	4
Gok2_libmerged	1768371	1768372		YPO_RS08745	1
Gok2_libmerged	1768415	1768544		YPO_RS08750	129
Gok2_libmerged	1768677	1768693		YPO_RS08750	16
Gok2_libmerged	1769096	1769128		YPO_RS08755	32
Gok2_libmerged	1769171	1769179		YPO_RS08755	8
Gok2_libmerged	1769273	1769286		YPO_RS08755	13
Gok2_libmerged	1769579	1769628		YPO_RS08755	49
Gok2_libmerged	1770436	1770446		YPO_RS08760	10
Gok2_libmerged	1770537	1770565		YPO_RS08760	28
Gok2_libmerged	1770915	1770918		YPO_RS08760	3
Gok2_libmerged	1770977	1770989		YPO_RS08760	12
Gok2_libmerged	1771069	1771097		YPO_RS08760	28
Gok2_libmerged	1771564	1771579		YPO_RS08765	15
Gok2_libmerged	1772084	1772138		YPO_RS08770	54
Gok2_libmerged	1772696	1772697		YPO_RS08770	1
Gok2_libmerged	1772863	1772898		YPO_RS08770	35
Gok2_libmerged	1773003	1773042		YPO_RS08770	39
Gok2_libmerged	1773912	1773924		sbcB	12
Gok2_libmerged	1774207	1774230		sbcB	23
Gok2_libmerged	1774408	1774461		sbcB	53
Gok2_libmerged	1774523	1774540		sbcB	17
Gok2_libmerged	1774608	1774656		sbcB	48
Gok2_libmerged	1774947	1774989		sbcB	42
Gok2_libmerged	1775246	1775248		sbcB	2
Gok2_libmerged	1775700	1775868		YPO_RS08785	168
Gok2_libmerged	1776093	1776157		YPO_RS08785	64
Gok2_libmerged	1776264	1776352		YPO_RS08785	88
Gok2_libmerged	1776454	1776477		YPO_RS08785	23
Gok2_libmerged	1776548	1776595		YPO_RS08785	47
Gok2_libmerged	1777208	1777234		YPO_RS08790	26
Gok2_libmerged	1777332	1777382		YPO_RS08790	50
Gok2_libmerged	1777986	1778006		YPO_RS08795	20
Gok2_libmerged	1778348	1778358		YPO_RS08795	10
Gok2_libmerged	1778622	1778641		YPO_RS08795	19
Gok2_libmerged	1779335	1779358		YPO_RS08800	23
Gok2_libmerged	1779404	1779498		YPO_RS08800	94
Gok2_libmerged	1780130	1780173		YPO_RS08800	43
Gok2_libmerged	1780435	1780469		YPO_RS08800	34
Gok2_libmerged	1780533	1780545		YPO_RS08800	12
Gok2_libmerged	1780620	1780658		YPO_RS08800	38
Gok2_libmerged	1780802	1780804		YPO_RS08800	2
Gok2_libmerged	1781005	1781009		YPO_RS08800	4
Gok2_libmerged	1781107	1781160		YPO_RS08800	53
Gok2_libmerged	1781236	1781294		YPO_RS08800	58
Gok2_libmerged	1781695	1781772		YPO_RS08800	77
Gok2_libmerged	1783244	1783292		YPO_RS08805	48
Gok2_libmerged	1783371	1783384		YPO_RS08805	13
Gok2_libmerged	1783783	1783810		YPO_RS08805	27
Gok2_libmerged	1783887	1783926		YPO_RS08805	39
Gok2_libmerged	1784652	1784753		YPO_RS08810	101
Gok2_libmerged	1786218	1786224		YPO_RS08820	6
Gok2_libmerged	1786449	1786496		YPO_RS08820	47
Gok2_libmerged	1786899	1786928		YPO_RS08820	29
Gok2_libmerged	1787607	1787608		YPO_RS08825	1
Gok2_libmerged	1787756	1787788		YPO_RS08825	32
Gok2_libmerged	1788162	1788211		YPO_RS08825	49
Gok2_libmerged	1788598	1788605		lldD	7
Gok2_libmerged	1788846	1788848		lldD	2
Gok2_libmerged	1789039	1789101		lldD	62
Gok2_libmerged	1789333	1789387		lldD	54
Gok2_libmerged	1789712	1789743		lldD	31
Gok2_libmerged	1790307	1790322		argG	15
Gok2_libmerged	1790911	1790966		argG	55
Gok2_libmerged	1791295	1791307		argG	12
Gok2_libmerged	1791674	1791680		YPO_RS08840	6
Gok2_libmerged	1792195	1792199		YPO_RS08840	4
Gok2_libmerged	1792425	1792461		YPO_RS08840	36
Gok2_libmerged	1792632	1792674		YPO_RS08840	42
Gok2_libmerged	1793095	1793101		YPO_RS08845	6
Gok2_libmerged	1793299	1793313		YPO_RS08845	14
Gok2_libmerged	1793676	1793682		YPO_RS08845	6
Gok2_libmerged	1793890	1793891		YPO_RS08845	1
Gok2_libmerged	1794443	1794447		YPO_RS08850	4
Gok2_libmerged	1794597	1794613		YPO_RS08850	16
Gok2_libmerged	1794687	1794696		YPO_RS08850	9
Gok2_libmerged	1794853	1794908		YPO_RS08850	55
Gok2_libmerged	1795073	1795077		YPO_RS08850	4
Gok2_libmerged	1795182	1795214		YPO_RS08850	32
Gok2_libmerged	1795963	1795983		YPO_RS08855	20
Gok2_libmerged	1796023	1796184		YPO_RS08855	161
Gok2_libmerged	1796270	1796377		YPO_RS08855	107
Gok2_libmerged	1796512	1796532		YPO_RS08855	20
Gok2_libmerged	1796832	1796962		YPO_RS08860	130
Gok2_libmerged	1797205	1797225		YPO_RS08860	20
Gok2_libmerged	1798098	1798138		YPO_RS08870	40
Gok2_libmerged	1798423	1798425		YPO_RS08870	2
Gok2_libmerged	1799336	1799342		YPO_RS08875	6
Gok2_libmerged	1800188	1800194		YPO_RS08875	6
Gok2_libmerged	1800379	1800388		YPO_RS08880	9
Gok2_libmerged	1800542	1800562		YPO_RS08880	20
Gok2_libmerged	1800948	1800953		YPO_RS08885	5
Gok2_libmerged	1801130	1801222		YPO_RS08885	92
Gok2_libmerged	1801280	1801315		YPO_RS08885	35
Gok2_libmerged	1801524	1801634		YPO_RS08885	110
Gok2_libmerged	1801710	1801714		YPO_RS08885	4
Gok2_libmerged	1801766	1801800		YPO_RS08885	34
Gok2_libmerged	1803382	1803392		YPO_RS08895	10
Gok2_libmerged	1803503	1803522		YPO_RS08895	19
Gok2_libmerged	1803759	1803824		YPO_RS08900	65
Gok2_libmerged	1803912	1803939		YPO_RS08900	27
Gok2_libmerged	1804504	1804544		YPO_RS08900	40
Gok2_libmerged	1805229	1805239		YPO_RS08900	10
Gok2_libmerged	1805331	1805335		YPO_RS08900	4
Gok2_libmerged	1805654	1805686		YPO_RS08900	32
Gok2_libmerged	1806043	1806091		YPO_RS08905	48
Gok2_libmerged	1806172	1806187		YPO_RS08905	15
Gok2_libmerged	1806327	1806377		YPO_RS08905	50
Gok2_libmerged	1806624	1806649		YPO_RS08905	25
Gok2_libmerged	1806737	1806739		YPO_RS08905	2
Gok2_libmerged	1806778	1806809		YPO_RS08905	31
Gok2_libmerged	1806972	1807001		YPO_RS08905	29
Gok2_libmerged	1807149	1807163		YPO_RS08910	14
Gok2_libmerged	1807821	1807870		YPO_RS08910	49
Gok2_libmerged	1808109	1808112		YPO_RS08910	3
Gok2_libmerged	1808292	1808310		bssS	18
Gok2_libmerged	1808524	1808536		bssS	12
Gok2_libmerged	1809207	1809228		dinI	21
Gok2_libmerged	1809712	1809756		pyrC	44
Gok2_libmerged	1810086	1810126		pyrC	40
Gok2_libmerged	1810159	1810189		pyrC	30
Gok2_libmerged	1810295	1810314		pyrC	19
Gok2_libmerged	1810546	1810567		pyrC	21
Gok2_libmerged	1810881	1810891		YPO_RS08930	10
Gok2_libmerged	1811077	1811142		YPO_RS08930	65
Gok2_libmerged	1811445	1811471		YPO_RS08940	26
Gok2_libmerged	1811601	1811642		YPO_RS08940	41
Gok2_libmerged	1811701	1811733		YPO_RS08940	32
Gok2_libmerged	1812071	1812081		YPO_RS08940	10
Gok2_libmerged	1812251	1812291		YPO_RS08940	40
Gok2_libmerged	1812490	1812498		YPO_RS08940	8
Gok2_libmerged	1812749	1812753		rne	4
Gok2_libmerged	1812806	1812816		rne	10
Gok2_libmerged	1813091	1813127		rne	36
Gok2_libmerged	1813720	1813788		rne	68
Gok2_libmerged	1814004	1814011		rne	7
Gok2_libmerged	1814184	1814198		rne	14
Gok2_libmerged	1814418	1814450		rne	32
Gok2_libmerged	1814501	1814507		rne	6
Gok2_libmerged	1814636	1814640		rne	4
Gok2_libmerged	1815097	1815115		rne	18
Gok2_libmerged	1815364	1815397		rne	33
Gok2_libmerged	1815446	1815470		rne	24
Gok2_libmerged	1815574	1815618		rne	44
Gok2_libmerged	1815745	1815779		rne	34
Gok2_libmerged	1816162	1816167		rne	5
Gok2_libmerged	1816312	1816328		rne	16
Gok2_libmerged	1817182	1817191		rluC	9
Gok2_libmerged	1817325	1817353		rluC	28
Gok2_libmerged	1817613	1817637		rluC	24
Gok2_libmerged	1817898	1817934		rluC	36
Gok2_libmerged	1818518	1818540		YPO_RS08955	22
Gok2_libmerged	1819031	1819100		YPO_RS08960	69
Gok2_libmerged	1819522	1819557		yceD	35
Gok2_libmerged	1820488	1820493		plsX	5
Gok2_libmerged	1820561	1820563		plsX	2
Gok2_libmerged	1820685	1820717		plsX	32
Gok2_libmerged	1820861	1820906		plsX	45
Gok2_libmerged	1820989	1820992		plsX	3
Gok2_libmerged	1821133	1821140		plsX	7
Gok2_libmerged	1821676	1821678		YPO_RS08980	2
Gok2_libmerged	1822075	1822109		YPO_RS08980	34
Gok2_libmerged	1822289	1822341		fabD	52
Gok2_libmerged	1822449	1822451		fabD	2
Gok2_libmerged	1823035	1823038		fabD	3
Gok2_libmerged	1823784	1823824		fabG	40
Gok2_libmerged	1824312	1824356		acpP	44
Gok2_libmerged	1824639	1824677		fabF	38
Gok2_libmerged	1824983	1825030		fabF	47
Gok2_libmerged	1825180	1825214		fabF	34
Gok2_libmerged	1825339	1825361		fabF	22
Gok2_libmerged	1825428	1825484		fabF	56
Gok2_libmerged	1825603	1825608		fabF	5
Gok2_libmerged	1825927	1825932		YPO_RS09005	5
Gok2_libmerged	1826075	1826105		YPO_RS09005	30
Gok2_libmerged	1826228	1826274		YPO_RS09005	46
Gok2_libmerged	1826766	1826767		pabC	1
Gok2_libmerged	1828372	1828383		mltG	11
Gok2_libmerged	1828484	1828494		mltG	10
Gok2_libmerged	1828568	1828623		mltG	55
Gok2_libmerged	1828805	1828824		mltG	19
Gok2_libmerged	1829884	1829923		holB	39
Gok2_libmerged	1830514	1830536		holB	22
Gok2_libmerged	1830551	1830556		YPO_RS09030	5
Gok2_libmerged	1830925	1830982		YPO_RS09030	57
Gok2_libmerged	1831049	1831082		YPO_RS09030	33
Gok2_libmerged	1831666	1831674		ptsG	8
Gok2_libmerged	1831928	1831930		ptsG	2
Gok2_libmerged	1832580	1832635		ptsG	55
Gok2_libmerged	1832709	1832722		ptsG	13
Gok2_libmerged	1832850	1832860		ptsG	10
Gok2_libmerged	1832930	1832950		ptsG	20
Gok2_libmerged	1833605	1833680		YPO_RS09040	75
Gok2_libmerged	1833729	1833730		YPO_RS09040	1
Gok2_libmerged	1834190	1834221		YPO_RS09045	31
Gok2_libmerged	1834263	1834322		YPO_RS09045	59
Gok2_libmerged	1834433	1834523		YPO_RS09045	90
Gok2_libmerged	1834717	1834762		YPO_RS09045	45
Gok2_libmerged	1835281	1835326		hinT	45
Gok2_libmerged	1835521	1835535		hinT	14
Gok2_libmerged	1835570	1835574		YPO_RS09055	4
Gok2_libmerged	1835810	1835818		YPO_RS09055	8
Gok2_libmerged	1836558	1836564		lpoB	6
Gok2_libmerged	1836558	1836564		thiK	6
Gok2_libmerged	1837050	1837063		thiK	13
Gok2_libmerged	1837829	1837874		nagZ	45
Gok2_libmerged	1838262	1838283		nagZ	21
Gok2_libmerged	1838413	1838427		nagZ	14
Gok2_libmerged	1838523	1838524		nagZ	1
Gok2_libmerged	1838758	1838768		YPO_RS09075	10
Gok2_libmerged	1838880	1838906		YPO_RS09075	26
Gok2_libmerged	1839105	1839194		YPO_RS09075	89
Gok2_libmerged	1839798	1839810		YPO_RS09080	12
Gok2_libmerged	1840332	1840368		YPO_RS09080	36
Gok2_libmerged	1840588	1840613		YPO_RS09080	25
Gok2_libmerged	1840669	1840676		YPO_RS09080	7
Gok2_libmerged	1841451	1841453		YPO_RS09085	2
Gok2_libmerged	1841524	1841530		YPO_RS09085	6
Gok2_libmerged	1841781	1841980		YPO_RS09085	199
Gok2_libmerged	1841988	1842187		YPO_RS09090	199
Gok2_libmerged	1842225	1842401		YPO_RS09090	176
Gok2_libmerged	1842792	1842799		YPO_RS09095	7
Gok2_libmerged	1843185	1843218		YPO_RS09095	33
Gok2_libmerged	1843263	1843270		YPO_RS09095	7
Gok2_libmerged	1844337	1844351		YPO_RS09100	14
Gok2_libmerged	1844423	1844471		YPO_RS09100	48
Gok2_libmerged	1844531	1844581		YPO_RS09100	50
Gok2_libmerged	1844711	1844725		YPO_RS09100	14
Gok2_libmerged	1844906	1844949		YPO_RS09105	43
Gok2_libmerged	1845346	1845366		YPO_RS09105	20
Gok2_libmerged	1845429	1845443		YPO_RS09105	14
Gok2_libmerged	1845501	1845511		YPO_RS09105	10
Gok2_libmerged	1845579	1845623		YPO_RS09105	44
Gok2_libmerged	1846073	1846090		YPO_RS09110	17
Gok2_libmerged	1846316	1846374		YPO_RS09110	58
Gok2_libmerged	1846428	1846479		YPO_RS09110	51
Gok2_libmerged	1847440	1847470		mfd	30
Gok2_libmerged	1847774	1847776		mfd	2
Gok2_libmerged	1848257	1848285		mfd	28
Gok2_libmerged	1848434	1848508		mfd	74
Gok2_libmerged	1848596	1848617		mfd	21
Gok2_libmerged	1849102	1849113		mfd	11
Gok2_libmerged	1849221	1849223		mfd	2
Gok2_libmerged	1849560	1849580		mfd	20
Gok2_libmerged	1849895	1849941		mfd	46
Gok2_libmerged	1850075	1850091		mfd	16
Gok2_libmerged	1850489	1850529		lolC	40
Gok2_libmerged	1850565	1850586		lolC	21
Gok2_libmerged	1850696	1850701		lolC	5
Gok2_libmerged	1850806	1850818		lolC	12
Gok2_libmerged	1850859	1850865		lolC	6
Gok2_libmerged	1850930	1850932		lolC	2
Gok2_libmerged	1851040	1851045		lolC	5
Gok2_libmerged	1851098	1851107		lolC	9
Gok2_libmerged	1851154	1851161		lolC	7
Gok2_libmerged	1851344	1851383		lolC	39
Gok2_libmerged	1851473	1851517		lolC	44
Gok2_libmerged	1852236	1852243		lolD	7
Gok2_libmerged	1852488	1852492		lolE	4
Gok2_libmerged	1852561	1852572		lolE	11
Gok2_libmerged	1852725	1852742		lolE	17
Gok2_libmerged	1852817	1852867		lolE	50
Gok2_libmerged	1853106	1853204		lolE	98
Gok2_libmerged	1853272	1853273		lolE	1
Gok2_libmerged	1854663	1854688		cobB	25
Gok2_libmerged	1854820	1854829		cobB	9
Gok2_libmerged	1854984	1854990		cobB	6
Gok2_libmerged	1855299	1855312		cobB	13
Gok2_libmerged	1856038	1856052		pepT	14
Gok2_libmerged	1856126	1856178		pepT	52
Gok2_libmerged	1856240	1856261		pepT	21
Gok2_libmerged	1856307	1856352		pepT	45
Gok2_libmerged	1856422	1856458		pepT	36
Gok2_libmerged	1856802	1856894		pepT	92
Gok2_libmerged	1858190	1858202		YPO_RS09150	12
Gok2_libmerged	1858514	1858516		phoQ	2
Gok2_libmerged	1858777	1858793		phoQ	16
Gok2_libmerged	1858920	1858972		phoQ	52
Gok2_libmerged	1859517	1859549		phoQ	32
Gok2_libmerged	1859686	1859699		phoQ	13
Gok2_libmerged	1859909	1859911		phoQ	2
Gok2_libmerged	1859917	1859943		phoP	26
Gok2_libmerged	1860153	1860160		phoP	7
Gok2_libmerged	1860924	1860947		YPO_RS09165	23
Gok2_libmerged	1861173	1861176		YPO_RS09165	3
Gok2_libmerged	1861225	1861307		YPO_RS09165	82
Gok2_libmerged	1861723	1861733		purB	10
Gok2_libmerged	1862145	1862147		purB	2
Gok2_libmerged	1862421	1862443		purB	22
Gok2_libmerged	1862660	1862718		purB	58
Gok2_libmerged	1862749	1862788		purB	39
Gok2_libmerged	1863463	1863490		hflD	27
Gok2_libmerged	1863649	1863663		hflD	14
Gok2_libmerged	1864168	1864178		mnmA	10
Gok2_libmerged	1864366	1864391		mnmA	25
Gok2_libmerged	1865209	1865271		YPO_RS09185	62
Gok2_libmerged	1865429	1865473		YPO_RS09185	44
Gok2_libmerged	1865466	1865499		rluE	33
Gok2_libmerged	1865769	1865770		rluE	1
Gok2_libmerged	1865908	1865919		rluE	11
Gok2_libmerged	1866253	1866254		icd	1
Gok2_libmerged	1866312	1866333		icd	21
Gok2_libmerged	1866435	1866532		icd	97
Gok2_libmerged	1866626	1866636		icd	10
Gok2_libmerged	1867011	1867016		icd	5
Gok2_libmerged	1867437	1867476		icd	39
Gok2_libmerged	1867856	1867940		YPO_RS09200	84
Gok2_libmerged	1867978	1868014		YPO_RS09200	36
Gok2_libmerged	1868606	1868625		YPO_RS09200	19
Gok2_libmerged	1869469	1869484		YPO_RS09210	15
Gok2_libmerged	1869792	1869862		YPO_RS09210	70
Gok2_libmerged	1870073	1870075		YPO_RS09210	2
Gok2_libmerged	1870175	1870187		YPO_RS09210	12
Gok2_libmerged	1870557	1870568		YPO_RS09210	11
Gok2_libmerged	1870649	1870654		YPO_RS09210	5
Gok2_libmerged	1872374	1872378		YPO_RS09215	4
Gok2_libmerged	1872838	1872847		YPO_RS09220	9
Gok2_libmerged	1872933	1872939		YPO_RS09220	6
Gok2_libmerged	1873030	1873102		YPO_RS09220	72
Gok2_libmerged	1873279	1873288		YPO_RS09225	9
Gok2_libmerged	1873753	1873758		YPO_RS09230	5
Gok2_libmerged	1874064	1874073		YPO_RS09230	9
Gok2_libmerged	1874602	1874607		YPO_RS09230	5
Gok2_libmerged	1874678	1874709		YPO_RS09230	31
Gok2_libmerged	1874772	1874822		YPO_RS09230	50
Gok2_libmerged	1874901	1874910		YPO_RS09230	9
Gok2_libmerged	1874988	1875013		YPO_RS09230	25
Gok2_libmerged	1875380	1875388		ydfZ	8
Gok2_libmerged	1875543	1875571		ydfZ	28
Gok2_libmerged	1876040	1876090		YPO_RS09240	50
Gok2_libmerged	1876780	1876785		YPO_RS09240	5
Gok2_libmerged	1877178	1877187		YPO_RS09245	9
Gok2_libmerged	1877296	1877326		YPO_RS09245	30
Gok2_libmerged	1877817	1877828		YPO_RS09250	11
Gok2_libmerged	1877929	1877940		YPO_RS09250	11
Gok2_libmerged	1878116	1878195		YPO_RS09250	79
Gok2_libmerged	1878268	1878350		YPO_RS09250	82
Gok2_libmerged	1879157	1879161		YPO_RS09255	4
Gok2_libmerged	1879559	1879567		YPO_RS09255	8
Gok2_libmerged	1879618	1879624		YPO_RS09255	6
Gok2_libmerged	1880186	1880233		YPO_RS09260	47
Gok2_libmerged	1880626	1880634		YPO_RS09260	8
Gok2_libmerged	1880685	1880738		YPO_RS09260	53
Gok2_libmerged	1880846	1880849		YPO_RS09260	3
Gok2_libmerged	1881124	1881131		YPO_RS09260	7
Gok2_libmerged	1881236	1881277		YPO_RS09260	41
Gok2_libmerged	1881470	1881481		YPO_RS09260	11
Gok2_libmerged	1881743	1881781		YPO_RS09260	38
Gok2_libmerged	1881978	1882041		YPO_RS09260	63
Gok2_libmerged	1882206	1882217		YPO_RS09260	11
Gok2_libmerged	1882685	1882707		YPO_RS09260	22
Gok2_libmerged	1882892	1882901		YPO_RS09260	9
Gok2_libmerged	1883780	1883791		cspE	11
Gok2_libmerged	1884171	1884178		dsrB	7
Gok2_libmerged	1884263	1884333		dsrB	70
Gok2_libmerged	1887588	1887590		YPO_RS09280	2
Gok2_libmerged	1888541	1888648		mgtA	107
Gok2_libmerged	1888815	1888875		mgtA	60
Gok2_libmerged	1888930	1888965		mgtA	35
Gok2_libmerged	1889106	1889109		mgtA	3
Gok2_libmerged	1889250	1889263		mgtA	13
Gok2_libmerged	1889506	1889558		mgtA	52
Gok2_libmerged	1890100	1890138		mgtA	38
Gok2_libmerged	1890401	1890436		mgtA	35
Gok2_libmerged	1890507	1890546		mgtA	39
Gok2_libmerged	1890635	1890676		mgtA	41
Gok2_libmerged	1890743	1890755		mgtA	12
Gok2_libmerged	1890798	1890981		mgtA	183
Gok2_libmerged	1891081	1891092		mgtA	11
Gok2_libmerged	1892775	1892842		flhC	67
Gok2_libmerged	1893769	1893784		motA	15
Gok2_libmerged	1893914	1893921		motA	7
Gok2_libmerged	1894379	1894400		motA	21
Gok2_libmerged	1894660	1894674		motB	14
Gok2_libmerged	1894846	1894861		motB	15
Gok2_libmerged	1895071	1895075		motB	4
Gok2_libmerged	1895223	1895261		motB	38
Gok2_libmerged	1895323	1895334		motB	11
Gok2_libmerged	1895375	1895379		motB	4
Gok2_libmerged	1895511	1895527		motB	16
Gok2_libmerged	1895597	1895671		motB	74
Gok2_libmerged	1896003	1896025		cheA	22
Gok2_libmerged	1896113	1896224		cheA	111
Gok2_libmerged	1897812	1897842		cheA	30
Gok2_libmerged	1898073	1898084		cheW	11
Gok2_libmerged	1898172	1898213		cheW	41
Gok2_libmerged	1898315	1898386		cheW	71
Gok2_libmerged	1898534	1898570		cheW	36
Gok2_libmerged	1898862	1898971		YPO_RS09320	109
Gok2_libmerged	1899167	1899254		YPO_RS09320	87
Gok2_libmerged	1899313	1899319		YPO_RS09320	6
Gok2_libmerged	1899450	1899534		YPO_RS09320	84
Gok2_libmerged	1899760	1899767		YPO_RS09320	7
Gok2_libmerged	1899881	1899884		YPO_RS09320	3
Gok2_libmerged	1899981	1900015		YPO_RS09320	34
Gok2_libmerged	1900110	1900138		YPO_RS09325	28
Gok2_libmerged	1900225	1900387		YPO_RS09325	162
Gok2_libmerged	1900499	1900502		YPO_RS09330	3
Gok2_libmerged	1900738	1900745		YPO_RS09330	7
Gok2_libmerged	1900803	1900811		YPO_RS09330	8
Gok2_libmerged	1901660	1901671		YPO_RS09335	11
Gok2_libmerged	1901777	1901840		YPO_RS09335	63
Gok2_libmerged	1902025	1902083		YPO_RS09335	58
Gok2_libmerged	1902140	1902213		YPO_RS09335	73
Gok2_libmerged	1903204	1903219		yapJ	15
Gok2_libmerged	1903292	1903321		yapJ	29
Gok2_libmerged	1903429	1903433		yapJ	4
Gok2_libmerged	1903478	1903522		yapJ	44
Gok2_libmerged	1903616	1903620		yapJ	4
Gok2_libmerged	1904033	1904047		yapJ	14
Gok2_libmerged	1904359	1904412		yapJ	53
Gok2_libmerged	1904518	1904523		yapJ	5
Gok2_libmerged	1904556	1904558		yapJ	2
Gok2_libmerged	1904720	1904727		yapJ	7
Gok2_libmerged	1904832	1904882		yapJ	50
Gok2_libmerged	1905752	1905805		yapJ	53
Gok2_libmerged	1905939	1905948		yapJ	9
Gok2_libmerged	1906258	1906261		yapJ	3
Gok2_libmerged	1906572	1906577		yapJ	5
Gok2_libmerged	1907134	1907161		YPO_RS09345	27
Gok2_libmerged	1907294	1907299		YPO_RS09345	5
Gok2_libmerged	1907351	1907355		YPO_RS09345	4
Gok2_libmerged	1907416	1907419		YPO_RS09345	3
Gok2_libmerged	1907840	1907853		YPO_RS09345	13
Gok2_libmerged	1908454	1908466		YPO_RS09345	12
Gok2_libmerged	1908695	1908726		YPO_RS09345	31
Gok2_libmerged	1908775	1908858		YPO_RS09345	83
Gok2_libmerged	1909394	1909396		YPO_RS09345	2
Gok2_libmerged	1909545	1909570		YPO_RS09345	25
Gok2_libmerged	1909675	1909688		YPO_RS09345	13
Gok2_libmerged	1910079	1910120		YPO_RS09350	41
Gok2_libmerged	1910357	1910395		YPO_RS09350	38
Gok2_libmerged	1911286	1911288		YPO_RS09355	2
Gok2_libmerged	1911465	1911547		YPO_RS09355	82
Gok2_libmerged	1911683	1911703		YPO_RS09355	20
Gok2_libmerged	1912317	1912351		YPO_RS09355	34
Gok2_libmerged	1912447	1912448		YPO_RS09355	1
Gok2_libmerged	1914858	1914868		cheR	10
Gok2_libmerged	1915167	1915172		cheR	5
Gok2_libmerged	1915299	1915372		cheR	73
Gok2_libmerged	1915524	1915533		cheR	9
Gok2_libmerged	1915533	1915586		YPO_RS09370	53
Gok2_libmerged	1915665	1915674		YPO_RS09370	9
Gok2_libmerged	1915827	1915835		YPO_RS09370	8
Gok2_libmerged	1916386	1916396		YPO_RS09370	10
Gok2_libmerged	1916498	1916517		YPO_RS09370	19
Gok2_libmerged	1916683	1916714		cheY	31
Gok2_libmerged	1916854	1916937		cheY	83
Gok2_libmerged	1918291	1918339		YPO_RS09385	48
Gok2_libmerged	1918618	1918645		YPO_RS09385	27
Gok2_libmerged	1918790	1918877		YPO_RS09385	87
Gok2_libmerged	1918996	1918998		YPO_RS09385	2
Gok2_libmerged	1919412	1919437		YPO_RS09390	25
Gok2_libmerged	1919516	1919575		YPO_RS09390	59
Gok2_libmerged	1919763	1919771		YPO_RS09390	8
Gok2_libmerged	1919854	1919855		YPO_RS09390	1
Gok2_libmerged	1920509	1920536		YPO_RS09390	27
Gok2_libmerged	1920636	1920639		YPO_RS09390	3
Gok2_libmerged	1920810	1920811		YPO_RS09390	1
Gok2_libmerged	1920991	1921003		YPO_RS09390	12
Gok2_libmerged	1921594	1921598		YPO_RS09390	4
Gok2_libmerged	1922235	1922275		YPO_RS09400	40
Gok2_libmerged	1922442	1922451		YPO_RS09400	9
Gok2_libmerged	1922612	1922671		YPO_RS09400	59
Gok2_libmerged	1922776	1922787		YPO_RS09400	11
Gok2_libmerged	1922880	1922988		YPO_RS09400	108
Gok2_libmerged	1923715	1923774		YPO_RS09405	59
Gok2_libmerged	1924373	1924413		YPO_RS09405	40
Gok2_libmerged	1924559	1924714		YPO_RS09405	155
Gok2_libmerged	1924877	1924944		YPO_RS09405	67
Gok2_libmerged	1925349	1925350		YPO_RS09410	1
Gok2_libmerged	1925442	1925456		YPO_RS09410	14
Gok2_libmerged	1926175	1926176		YPO_RS09415	1
Gok2_libmerged	1926355	1926367		YPO_RS09415	12
Gok2_libmerged	1927198	1927219		YPO_RS09420	21
Gok2_libmerged	1927302	1927354		YPO_RS09420	52
Gok2_libmerged	1927417	1927431		YPO_RS09420	14
Gok2_libmerged	1927715	1927770		YPO_RS09420	55
Gok2_libmerged	1927822	1927929		YPO_RS09420	107
Gok2_libmerged	1928171	1928222		YPO_RS09425	51
Gok2_libmerged	1929147	1929158		YPO_RS09430	11
Gok2_libmerged	1929257	1929258		YPO_RS09430	1
Gok2_libmerged	1929335	1929362		YPO_RS09430	27
Gok2_libmerged	1929494	1929619		YPO_RS09430	125
Gok2_libmerged	1929728	1929835		YPO_RS09435	107
Gok2_libmerged	1929894	1929901		YPO_RS09435	7
Gok2_libmerged	1930380	1930387		YPO_RS09435	7
Gok2_libmerged	1930418	1930456		YPO_RS09435	38
Gok2_libmerged	1931221	1931235		YPO_RS09440	14
Gok2_libmerged	1931713	1931724		YPO_RS09445	11
Gok2_libmerged	1931828	1931885		YPO_RS09445	57
Gok2_libmerged	1932093	1932105		YPO_RS09450	12
Gok2_libmerged	1932177	1932181		YPO_RS09450	4
Gok2_libmerged	1932255	1932285		YPO_RS09450	30
Gok2_libmerged	1932584	1932597		YPO_RS09450	13
Gok2_libmerged	1932746	1932759		YPO_RS09450	13
Gok2_libmerged	1932968	1933013		YPO_RS09450	45
Gok2_libmerged	1933451	1933465		YPO_RS09455	14
Gok2_libmerged	1933632	1933655		YPO_RS09455	23
Gok2_libmerged	1933733	1933777		YPO_RS09455	44
Gok2_libmerged	1933856	1933865		YPO_RS09455	9
Gok2_libmerged	1933912	1933940		YPO_RS09455	28
Gok2_libmerged	1934076	1934109		YPO_RS09455	33
Gok2_libmerged	1934326	1934375		YPO_RS09455	49
Gok2_libmerged	1934530	1934584		YPO_RS09455	54
Gok2_libmerged	1934713	1934715		YPO_RS09455	2
Gok2_libmerged	1934856	1934936		YPO_RS09455	80
Gok2_libmerged	1935385	1935465		YPO_RS09455	80
Gok2_libmerged	1933302	1933398		YPO_RS09455	96
Gok2_libmerged	1935923	1935938		YPO_RS09460	15
Gok2_libmerged	1936217	1936234		YPO_RS09460	17
Gok2_libmerged	1936599	1936675		YPO_RS09460	76
Gok2_libmerged	1936706	1936757		YPO_RS09465	51
Gok2_libmerged	1937214	1937234		YPO_RS09465	20
Gok2_libmerged	1937557	1937567		YPO_RS09470	10
Gok2_libmerged	1937786	1937814		YPO_RS09470	28
Gok2_libmerged	1937820	1937876		YPO_RS09475	56
Gok2_libmerged	1938048	1938127		YPO_RS09475	79
Gok2_libmerged	1938310	1938320		YPO_RS09475	10
Gok2_libmerged	1938940	1938988		YPO_RS09480	48
Gok2_libmerged	1939039	1939089		YPO_RS09480	50
Gok2_libmerged	1939129	1939136		YPO_RS09480	7
Gok2_libmerged	1939603	1939615		YPO_RS09480	12
Gok2_libmerged	1940453	1940456		YPO_RS09480	3
Gok2_libmerged	1940514	1940517		YPO_RS09480	3
Gok2_libmerged	1940629	1940653		YPO_RS09480	24
Gok2_libmerged	1940851	1940923		YPO_RS09480	72
Gok2_libmerged	1941148	1941155		YPO_RS09480	7
Gok2_libmerged	1941244	1941257		YPO_RS09480	13
Gok2_libmerged	1941681	1941684		yebS	3
Gok2_libmerged	1941744	1941748		yebS	4
Gok2_libmerged	1941867	1941922		yebS	55
Gok2_libmerged	1942046	1942061		yebS	15
Gok2_libmerged	1942097	1942098		yebS	1
Gok2_libmerged	1942952	1943012		YPO_RS09490	60
Gok2_libmerged	1943432	1943449		YPO_RS09490	17
Gok2_libmerged	1943878	1943881		proQ	3
Gok2_libmerged	1944116	1944168		proQ	52
Gok2_libmerged	1944497	1944592		prc	95
Gok2_libmerged	1944961	1945025		prc	64
Gok2_libmerged	1945102	1945135		prc	33
Gok2_libmerged	1945185	1945205		prc	20
Gok2_libmerged	1945394	1945457		prc	63
Gok2_libmerged	1946051	1946058		prc	7
Gok2_libmerged	1946948	1946956		htpX	8
Gok2_libmerged	1947087	1947091		htpX	4
Gok2_libmerged	1947249	1947306		htpX	57
Gok2_libmerged	1947407	1947477		htpX	70
Gok2_libmerged	1947677	1947705		htpX	28
Gok2_libmerged	1948469	1948471		YPO_RS09510	2
Gok2_libmerged	1949058	1949120		YPO_RS09515	62
Gok2_libmerged	1949738	1949800		YPO_RS09515	62
Gok2_libmerged	1949919	1949927		YPO_RS09520	8
Gok2_libmerged	1950532	1950551		YPO_RS09520	19
Gok2_libmerged	1950851	1950890		YPO_RS09520	39
Gok2_libmerged	1951111	1951130		YPO_RS09520	19
Gok2_libmerged	1951237	1951249		YPO_RS09520	12
Gok2_libmerged	1951488	1951501		YPO_RS09520	13
Gok2_libmerged	1951974	1952034		YPO_RS09520	60
Gok2_libmerged	1952228	1952316		YPO_RS09520	88
Gok2_libmerged	1952449	1952463		YPO_RS09520	14
Gok2_libmerged	1952512	1952520		YPO_RS09520	8
Gok2_libmerged	1952546	1952547		YPO_RS09525	1
Gok2_libmerged	1952567	1952620		YPO_RS09525	53
Gok2_libmerged	1952714	1952743		YPO_RS09525	29
Gok2_libmerged	1952792	1952832		YPO_RS09525	40
Gok2_libmerged	1952883	1952890		YPO_RS09525	7
Gok2_libmerged	1953010	1953039		YPO_RS09525	29
Gok2_libmerged	1953386	1953446		YPO_RS09525	60
Gok2_libmerged	1953532	1953588		YPO_RS09525	56
Gok2_libmerged	1953622	1953652		YPO_RS09525	30
Gok2_libmerged	1953756	1953766		YPO_RS09530	10
Gok2_libmerged	1953967	1954023		YPO_RS09530	56
Gok2_libmerged	1954853	1954867		YPO_RS09535	14
Gok2_libmerged	1955352	1955363		YPO_RS09535	11
Gok2_libmerged	1955483	1955530		YPO_RS09535	47
Gok2_libmerged	1955854	1955860		YPO_RS09535	6
Gok2_libmerged	1955893	1955912		YPO_RS09535	19
Gok2_libmerged	1956239	1956371		YPO_RS09540	132
Gok2_libmerged	1956858	1956917		YPO_RS09540	59
Gok2_libmerged	1956999	1957011		YPO_RS09540	12
Gok2_libmerged	1957084	1957130		YPO_RS09540	46
Gok2_libmerged	1957912	1957939		kdgR	27
Gok2_libmerged	1958018	1958035		kdgR	17
Gok2_libmerged	1959242	1959278		YPO_RS09550	36
Gok2_libmerged	1959433	1959468		YPO_RS09550	35
Gok2_libmerged	1959855	1959899		YPO_RS09555	44
Gok2_libmerged	1960151	1960163		YPO_RS09555	12
Gok2_libmerged	1960504	1960525		YPO_RS09555	21
Gok2_libmerged	1960782	1960797		YPO_RS09555	15
Gok2_libmerged	1960879	1960903		YPO_RS09555	24
Gok2_libmerged	1961538	1961546		YPO_RS09560	8
Gok2_libmerged	1961692	1961730		YPO_RS09560	38
Gok2_libmerged	1961973	1961977		YPO_RS09560	4
Gok2_libmerged	1962638	1962723		YPO_RS09565	85
Gok2_libmerged	1962841	1962868		YPO_RS09565	27
Gok2_libmerged	1963071	1963084		YPO_RS09565	13
Gok2_libmerged	1963154	1963167		YPO_RS09565	13
Gok2_libmerged	1963465	1963570		YPO_RS09570	105
Gok2_libmerged	1963868	1963915		YPO_RS09570	47
Gok2_libmerged	1964040	1964259		YPO_RS09570	219
Gok2_libmerged	1964573	1964617		YPO_RS09570	44
Gok2_libmerged	1964773	1964827		YPO_RS09575	54
Gok2_libmerged	1964870	1964872		YPO_RS09575	2
Gok2_libmerged	1965101	1965108		YPO_RS09575	7
Gok2_libmerged	1965240	1965263		YPO_RS09575	23
Gok2_libmerged	1965465	1965516		YPO_RS09575	51
Gok2_libmerged	1966167	1966192		YPO_RS09580	25
Gok2_libmerged	1966718	1966777		YPO_RS09580	59
Gok2_libmerged	1966902	1966912		YPO_RS09585	10
Gok2_libmerged	1966957	1966996		YPO_RS09585	39
Gok2_libmerged	1967175	1967180		YPO_RS09585	5
Gok2_libmerged	1967267	1967297		YPO_RS09585	30
Gok2_libmerged	1967429	1967449		YPO_RS09585	20
Gok2_libmerged	1967663	1967717		YPO_RS09585	54
Gok2_libmerged	1967758	1967861		YPO_RS09590	103
Gok2_libmerged	1968240	1968274		YPO_RS09590	34
Gok2_libmerged	1968645	1968647		YPO_RS09590	2
Gok2_libmerged	1969761	1969781		kduD	20
Gok2_libmerged	1970101	1970104		kduD	3
Gok2_libmerged	1970624	1970654		kduI	30
Gok2_libmerged	1970790	1970897		kduI	107
Gok2_libmerged	1971043	1971061		kduI	18
Gok2_libmerged	1971135	1971170		kduI	35
Gok2_libmerged	1971786	1971826		YPO_RS09605	40
Gok2_libmerged	1972096	1972112		YPO_RS09605	16
Gok2_libmerged	1972266	1972286		YPO_RS09610	20
Gok2_libmerged	1973113	1973162		YPO_RS09610	49
Gok2_libmerged	1975230	1975263		YPO_RS09620	33
Gok2_libmerged	1975436	1975472		YPO_RS09620	36
Gok2_libmerged	1975878	1975883		YPO_RS09625	5
Gok2_libmerged	1975943	1976037		YPO_RS09625	94
Gok2_libmerged	1976139	1976158		YPO_RS09625	19
Gok2_libmerged	1976270	1976320		YPO_RS09625	50
Gok2_libmerged	1976498	1976569		YPO_RS09625	71
Gok2_libmerged	1976585	1976701		YPO_RS09630	116
Gok2_libmerged	1977261	1977264		mtfA	3
Gok2_libmerged	1977497	1977571		mtfA	74
Gok2_libmerged	1977880	1977890		mtfA	10
Gok2_libmerged	1978440	1978442		YPO_RS09645	2
Gok2_libmerged	1978550	1978601		YPO_RS09645	51
Gok2_libmerged	1979122	1979124		YPO_RS09650	2
Gok2_libmerged	1979172	1979192		YPO_RS09650	20
Gok2_libmerged	1979461	1979479		YPO_RS09650	18
Gok2_libmerged	1979936	1979939		YPO_RS09655	3
Gok2_libmerged	1980245	1980278		YPO_RS09655	33
Gok2_libmerged	1980687	1980742		YPO_RS09655	55
Gok2_libmerged	1981105	1981143		YPO_RS09655	38
Gok2_libmerged	1981219	1981223		YPO_RS09655	4
Gok2_libmerged	1981285	1981295		YPO_RS09655	10
Gok2_libmerged	1982350	1982417		YPO_RS09660	67
Gok2_libmerged	1982535	1982537		YPO_RS09665	2
Gok2_libmerged	1982740	1982760		YPO_RS09665	20
Gok2_libmerged	1983477	1983522		YPO_RS09670	45
Gok2_libmerged	1983586	1983589		YPO_RS09670	3
Gok2_libmerged	1984400	1984415		mgrB	15
Gok2_libmerged	1984623	1984630		YPO_RS09685	7
Gok2_libmerged	1984690	1984700		YPO_RS09685	10
Gok2_libmerged	1985239	1985297		YPO_RS09690	58
Gok2_libmerged	1985334	1985390		YPO_RS09690	56
Gok2_libmerged	1985569	1985635		YPO_RS09695	66
Gok2_libmerged	1985770	1985814		YPO_RS09695	44
Gok2_libmerged	1986051	1986089		YPO_RS09700	38
Gok2_libmerged	1986196	1986207		YPO_RS09700	11
Gok2_libmerged	1986364	1986381		YPO_RS09700	17
Gok2_libmerged	1986559	1986572		YPO_RS09700	13
Gok2_libmerged	1986881	1986900		YPO_RS09700	19
Gok2_libmerged	1986971	1986979		YPO_RS09700	8
Gok2_libmerged	1987372	1987389		YPO_RS09700	17
Gok2_libmerged	1987729	1987793		YPO_RS09705	64
Gok2_libmerged	1988061	1988094		YPO_RS09705	33
Gok2_libmerged	1988244	1988248		YPO_RS09705	4
Gok2_libmerged	1988292	1988328		YPO_RS09705	36
Gok2_libmerged	1989415	1989422		YPO_RS09710	7
Gok2_libmerged	1989918	1989960		pgeF	42
Gok2_libmerged	1990941	1990965		rlmA	24
Gok2_libmerged	1992237	1992278		YPO_RS09730	41
Gok2_libmerged	1992646	1992660		YPO_RS09735	14
Gok2_libmerged	1992737	1992781		YPO_RS09735	44
Gok2_libmerged	1993019	1993021		YPO_RS09735	2
Gok2_libmerged	1993199	1993211		YPO_RS09735	12
Gok2_libmerged	1993279	1993438		YPO_RS09735	159
Gok2_libmerged	1993983	1994062		YPO_RS09740	79
Gok2_libmerged	1994139	1994147		YPO_RS09740	8
Gok2_libmerged	1994299	1994317		YPO_RS09740	18
Gok2_libmerged	1994369	1994406		YPO_RS09740	37
Gok2_libmerged	1994498	1994509		YPO_RS09745	11
Gok2_libmerged	1994579	1994638		YPO_RS09745	59
Gok2_libmerged	1995107	1995117		YPO_RS09745	10
Gok2_libmerged	1995251	1995257		YPO_RS09745	6
Gok2_libmerged	1995416	1995429		YPO_RS09745	13
Gok2_libmerged	1995632	1995659		YPO_RS09745	27
Gok2_libmerged	1995814	1995837		YPO_RS09745	23
Gok2_libmerged	1995943	1996067		YPO_RS09745	124
Gok2_libmerged	1996162	1996191		YPO_RS09745	29
Gok2_libmerged	1996275	1996425		YPO_RS09745	150
Gok2_libmerged	1996513	1996540		YPO_RS09745	27
Gok2_libmerged	1997198	1997216		YPO_RS09750	18
Gok2_libmerged	1997623	1997627		YPO_RS09750	4
Gok2_libmerged	1997698	1997701		YPO_RS09750	3
Gok2_libmerged	1997805	1997877		YPO_RS09750	72
Gok2_libmerged	1997949	1997979		YPO_RS09750	30
Gok2_libmerged	1998125	1998139		YPO_RS09750	14
Gok2_libmerged	1998256	1998291		YPO_RS09750	35
Gok2_libmerged	1998345	1998399		YPO_RS09750	54
Gok2_libmerged	1998776	1998853		YPO_RS09750	77
Gok2_libmerged	1999355	1999402		mntP	47
Gok2_libmerged	1999797	1999821		mntP	24
Gok2_libmerged	2000334	2000366		YPO_RS09760	32
Gok2_libmerged	2000466	2000528		YPO_RS09760	62
Gok2_libmerged	2000687	2000765		YPO_RS09760	78
Gok2_libmerged	2001839	2001873		YPO_RS09765	34
Gok2_libmerged	2001889	2001891		YPO_RS09770	2
Gok2_libmerged	2001966	2001999		YPO_RS09770	33
Gok2_libmerged	2002039	2002043		YPO_RS09770	4
Gok2_libmerged	2002674	2002678		YPO_RS09770	4
Gok2_libmerged	2002879	2002939		manX	60
Gok2_libmerged	2003240	2003263		manX	23
Gok2_libmerged	2003506	2003568		manX	62
Gok2_libmerged	2003676	2003691		manX	15
Gok2_libmerged	2004539	2004543		YPO_RS09780	4
Gok2_libmerged	2005178	2005201		YPO_RS09780	23
Gok2_libmerged	2005251	2005260		YPO_RS09780	9
Gok2_libmerged	2005336	2005343		YPO_RS09780	7
Gok2_libmerged	2005399	2005411		YPO_RS09780	12
Gok2_libmerged	2005497	2005504		YPO_RS09780	7
Gok2_libmerged	2005835	2005853		YPO_RS09780	18
Gok2_libmerged	2006019	2006091		hpaR	72
Gok2_libmerged	2006200	2006210		hpaR	10
Gok2_libmerged	2006953	2006960		YPO_RS09790	7
Gok2_libmerged	2007184	2007189		YPO_RS09790	5
Gok2_libmerged	2007258	2007316		YPO_RS09790	58
Gok2_libmerged	2007533	2007578		YPO_RS09795	45
Gok2_libmerged	2007755	2007780		YPO_RS09795	25
Gok2_libmerged	2007893	2007917		YPO_RS09795	24
Gok2_libmerged	2008020	2008033		YPO_RS09795	13
Gok2_libmerged	2008088	2008091		YPO_RS09795	3
Gok2_libmerged	2008269	2008287		YPO_RS09800	18
Gok2_libmerged	2008541	2008554		YPO_RS09800	13
Gok2_libmerged	2008948	2008983		YPO_RS09800	35
Gok2_libmerged	2009158	2009161		YPO_RS09800	3
Gok2_libmerged	2009322	2009324		YPO_RS09800	2
Gok2_libmerged	2009466	2009470		YPO_RS09800	4
Gok2_libmerged	2009986	2010055		hpaD	69
Gok2_libmerged	2010163	2010205		hpaD	42
Gok2_libmerged	2010270	2010284		hpaD	14
Gok2_libmerged	2010344	2010405		hpaD	61
Gok2_libmerged	2010723	2010817		YPO_RS09810	94
Gok2_libmerged	2011071	2011123		hpaH	52
Gok2_libmerged	2011202	2011236		hpaH	34
Gok2_libmerged	2011402	2011403		hpaH	1
Gok2_libmerged	2011831	2011853		hpaH	22
Gok2_libmerged	2011864	2011878		hpaI	14
Gok2_libmerged	2012546	2012554		hpaI	8
Gok2_libmerged	2012657	2012670		hpaI	13
Gok2_libmerged	2012773	2012876		hpaX	103
Gok2_libmerged	2012961	2013025		hpaX	64
Gok2_libmerged	2013317	2013325		hpaX	8
Gok2_libmerged	2013399	2013426		hpaX	27
Gok2_libmerged	2013648	2013660		hpaX	12
Gok2_libmerged	2013825	2013883		hpaX	58
Gok2_libmerged	2014442	2014447		hpaB	5
Gok2_libmerged	2014624	2014671		hpaB	47
Gok2_libmerged	2014948	2015003		hpaB	55
Gok2_libmerged	2015154	2015167		hpaB	13
Gok2_libmerged	2015337	2015356		hpaB	19
Gok2_libmerged	2015533	2015534		hpaB	1
Gok2_libmerged	2015676	2015693		hpaB	17
Gok2_libmerged	2015714	2015722		hpaC	8
Gok2_libmerged	2015861	2015926		hpaC	65
Gok2_libmerged	2016706	2016716		YPO_RS09840	10
Gok2_libmerged	2016952	2016962		YPO_RS09840	10
Gok2_libmerged	2017047	2017078		YPO_RS09840	31
Gok2_libmerged	2017271	2017277		YPO_RS09840	6
Gok2_libmerged	2017412	2017423		YPO_RS09840	11
Gok2_libmerged	2017560	2017608		YPO_RS09840	48
Gok2_libmerged	2018684	2018687		YPO_RS09845	3
Gok2_libmerged	2019024	2019043		YPO_RS09845	19
Gok2_libmerged	2019505	2019524		pabB	19
Gok2_libmerged	2020453	2020465		pabB	12
Gok2_libmerged	2020700	2020707		YPO_RS09855	7
Gok2_libmerged	2020869	2020880		YPO_RS09855	11
Gok2_libmerged	2021941	2021973		purT	32
Gok2_libmerged	2022073	2022088		purT	15
Gok2_libmerged	2023001	2023073		dbpA	72
Gok2_libmerged	2023544	2023545		dbpA	1
Gok2_libmerged	2023592	2023605		dbpA	13
Gok2_libmerged	2023678	2023705		dbpA	27
Gok2_libmerged	2024053	2024060		YPO_RS09870	7
Gok2_libmerged	2024330	2024373		YPO_RS09870	43
Gok2_libmerged	2024413	2024421		YPO_RS09875	8
Gok2_libmerged	2024542	2024563		YPO_RS09875	21
Gok2_libmerged	2024707	2024721		YPO_RS09875	14
Gok2_libmerged	2024948	2024949		YPO_RS09880	1
Gok2_libmerged	2025019	2025056		YPO_RS09880	37
Gok2_libmerged	2025622	2025656		YPO_RS09885	34
Gok2_libmerged	2025732	2025755		YPO_RS09885	23
Gok2_libmerged	2026030	2026132		YPO_RS09885	102
Gok2_libmerged	2026635	2026639		YPO_RS09885	4
Gok2_libmerged	2028724	2028798		pip	74
Gok2_libmerged	2029351	2029357		YPO_RS09895	6
Gok2_libmerged	2030093	2030146		ftnA	53
Gok2_libmerged	2030253	2030266		ftnA	13
Gok2_libmerged	2031452	2031454		copD	2
Gok2_libmerged	2031528	2031559		copD	31
Gok2_libmerged	2031879	2031960		copD	81
Gok2_libmerged	2032029	2032052		copD	23
Gok2_libmerged	2032128	2032134		copD	6
Gok2_libmerged	2032441	2032453		YPO_RS09915	12
Gok2_libmerged	2033177	2033295		YPO_RS09920	118
Gok2_libmerged	2033608	2033625		YPO_RS09925	17
Gok2_libmerged	2034886	2034914		flhB	28
Gok2_libmerged	2035063	2035073		flhB	10
Gok2_libmerged	2035679	2035717		flhA	38
Gok2_libmerged	2035910	2035956		flhA	46
Gok2_libmerged	2036234	2036238		flhA	4
Gok2_libmerged	2036538	2036580		flhA	42
Gok2_libmerged	2036923	2036940		flhA	17
Gok2_libmerged	2037162	2037164		flhA	2
Gok2_libmerged	2037199	2037208		flhA	9
Gok2_libmerged	2037392	2037437		flhA	45
Gok2_libmerged	2037709	2037740		YPO_RS09940	31
Gok2_libmerged	2037936	2038072		YPO_RS09940	136
Gok2_libmerged	2039730	2039735		YPO_RS09950	5
Gok2_libmerged	2039865	2039893		YPO_RS09950	28
Gok2_libmerged	2040056	2040074		YPO_RS09950	18
Gok2_libmerged	2042615	2042622		YPO_RS09960	7
Gok2_libmerged	2042850	2042892		YPO_RS09960	42
Gok2_libmerged	2043014	2043036		flgM	22
Gok2_libmerged	2043688	2043699		flgA	11
Gok2_libmerged	2044665	2044694		flgB	29
Gok2_libmerged	2044810	2044890		flgC	80
Gok2_libmerged	2045414	2045416		flgD	2
Gok2_libmerged	2045669	2045687		flgD	18
Gok2_libmerged	2046403	2046405		YPO_RS09990	2
Gok2_libmerged	2046505	2046593		YPO_RS09990	88
Gok2_libmerged	2047081	2047084		YPO_RS09990	3
Gok2_libmerged	2047207	2047225		YPO_RS09990	18
Gok2_libmerged	2048093	2048111		flgG	18
Gok2_libmerged	2048204	2048256		flgG	52
Gok2_libmerged	2048610	2048671		flgG	61
Gok2_libmerged	2048895	2048926		flgH	31
Gok2_libmerged	2048972	2048973		flgH	1
Gok2_libmerged	2049085	2049098		flgH	13
Gok2_libmerged	2049235	2049296		flgH	61
Gok2_libmerged	2049504	2049555		flgH	51
Gok2_libmerged	2049570	2049612		YPO_RS10010	42
Gok2_libmerged	2050017	2050029		YPO_RS10010	12
Gok2_libmerged	2050254	2050269		YPO_RS10010	15
Gok2_libmerged	2052618	2052625		flgK	7
Gok2_libmerged	2053152	2053158		flgK	6
Gok2_libmerged	2053441	2053451		flgK	10
Gok2_libmerged	2053707	2053778		flgK	71
Gok2_libmerged	2054297	2054327		flgL	30
Gok2_libmerged	2054415	2054446		flgL	31
Gok2_libmerged	2054586	2054611		flgL	25
Gok2_libmerged	2054858	2054862		flgL	4
Gok2_libmerged	2055053	2055080		flgL	27
Gok2_libmerged	2055476	2055525		YPO_RS10030	49
Gok2_libmerged	2055652	2055668		YPO_RS10030	16
Gok2_libmerged	2055771	2055780		YPO_RS10030	9
Gok2_libmerged	2055974	2056016		YPO_RS10030	42
Gok2_libmerged	2056263	2056307		YPO_RS10030	44
Gok2_libmerged	2056591	2056596		YPO_RS10035	5
Gok2_libmerged	2056683	2056736		YPO_RS10035	53
Gok2_libmerged	2057297	2057343		YPO_RS10035	46
Gok2_libmerged	2057477	2057488		YPO_RS10035	11
Gok2_libmerged	2058057	2058066		YPO_RS10035	9
Gok2_libmerged	2058849	2058874		YPO_RS10040	25
Gok2_libmerged	2058943	2058946		YPO_RS10040	3
Gok2_libmerged	2059048	2059058		YPO_RS10040	10
Gok2_libmerged	2059510	2059539		YPO_RS10040	29
Gok2_libmerged	2059604	2059606		YPO_RS10040	2
Gok2_libmerged	2059723	2059790		YPO_RS10040	67
Gok2_libmerged	2060286	2060287		YPO_RS10045	1
Gok2_libmerged	2060416	2060547		YPO_RS10045	131
Gok2_libmerged	2060959	2060979		YPO_RS10050	20
Gok2_libmerged	2061215	2061235		YPO_RS10050	20
Gok2_libmerged	2062121	2062143		YPO_RS10050	22
Gok2_libmerged	2062600	2062604		YPO_RS10055	4
Gok2_libmerged	2062738	2062776		YPO_RS10055	38
Gok2_libmerged	2062956	2062980		YPO_RS10055	24
Gok2_libmerged	2063142	2063144		YPO_RS10055	2
Gok2_libmerged	2063268	2063275		YPO_RS10055	7
Gok2_libmerged	2063369	2063372		YPO_RS10055	3
Gok2_libmerged	2063555	2063606		YPO_RS10060	51
Gok2_libmerged	2063898	2063905		YPO_RS10060	7
Gok2_libmerged	2063977	2064033		YPO_RS10060	56
Gok2_libmerged	2064460	2064514		YPO_RS10060	54
Gok2_libmerged	2064830	2064836		YPO_RS10065	6
Gok2_libmerged	2064903	2064948		YPO_RS10065	45
Gok2_libmerged	2065362	2065368		YPO_RS10070	6
Gok2_libmerged	2065733	2065735		fliR	2
Gok2_libmerged	2065827	2065837		fliR	10
Gok2_libmerged	2065886	2065981		fliR	95
Gok2_libmerged	2066163	2066210		fliR	47
Gok2_libmerged	2066313	2066351		fliR	38
Gok2_libmerged	2066410	2066481		fliQ	71
Gok2_libmerged	2066536	2066546		fliQ	10
Gok2_libmerged	2066785	2066813		fliP	28
Gok2_libmerged	2066938	2066966		fliP	28
Gok2_libmerged	2067153	2067179		fliP	26
Gok2_libmerged	2067709	2067752		fliO	43
Gok2_libmerged	2067947	2067960		fliO	13
Gok2_libmerged	2068182	2068196		fliN	14
Gok2_libmerged	2068575	2068603		fliM	28
Gok2_libmerged	2068650	2068661		fliM	11
Gok2_libmerged	2068755	2068757		fliM	2
Gok2_libmerged	2068988	2069007		fliM	19
Gok2_libmerged	2069552	2069553		fliM	1
Gok2_libmerged	2069647	2069668		fliL	21
Gok2_libmerged	2069867	2069940		fliL	73
Gok2_libmerged	2070299	2070309		YPO_RS10110	10
Gok2_libmerged	2070596	2070605		YPO_RS10110	9
Gok2_libmerged	2070716	2070760		YPO_RS10110	44
Gok2_libmerged	2070981	2070983		YPO_RS10110	2
Gok2_libmerged	2071047	2071124		YPO_RS10110	77
Gok2_libmerged	2071355	2071426		YPO_RS10110	71
Gok2_libmerged	2071602	2071606		YPO_RS10110	4
Gok2_libmerged	2072957	2072972		fliI	15
Gok2_libmerged	2073197	2073305		fliI	108
Gok2_libmerged	2073445	2073455		fliI	10
Gok2_libmerged	2074234	2074244		fliH	10
Gok2_libmerged	2074375	2074410		fliG	35
Gok2_libmerged	2074681	2074685		fliG	4
Gok2_libmerged	2075333	2075349		fliF	16
Gok2_libmerged	2075433	2075444		fliF	11
Gok2_libmerged	2075838	2075841		fliF	3
Gok2_libmerged	2076180	2076181		fliF	1
Gok2_libmerged	2076393	2076428		fliF	35
Gok2_libmerged	2076471	2076479		fliF	8
Gok2_libmerged	2076526	2076559		fliF	33
Gok2_libmerged	2076606	2076628		fliF	22
Gok2_libmerged	2076795	2076799		fliF	4
Gok2_libmerged	2076970	2076980		fliF	10
Gok2_libmerged	2077381	2077387		fliE	6
Gok2_libmerged	2078128	2078149		YPO_RS10150	21
Gok2_libmerged	2079516	2079525		YPO_RS10160	9
Gok2_libmerged	2079729	2079805		YPO_RS10165	76
Gok2_libmerged	2079874	2079875		YPO_RS10165	1
Gok2_libmerged	2079994	2080043		YPO_RS10165	49
Gok2_libmerged	2080097	2080146		YPO_RS10165	49
Gok2_libmerged	2080222	2080261		YPO_RS10165	39
Gok2_libmerged	2080418	2080439		YPO_RS10165	21
Gok2_libmerged	2080753	2080754		YPO_RS10170	1
Gok2_libmerged	2080933	2080993		YPO_RS10170	60
Gok2_libmerged	2081232	2081285		YPO_RS10170	53
Gok2_libmerged	2081366	2081451		YPO_RS10170	85
Gok2_libmerged	2081692	2081758		YPO_RS10170	66
Gok2_libmerged	2082417	2082501		YPO_RS10170	84
Gok2_libmerged	2083165	2083283		YPO_RS10175	118
Gok2_libmerged	2083575	2083588		YPO_RS10175	13
Gok2_libmerged	2084267	2084372		fliT	105
Gok2_libmerged	2084484	2084544		fliT	60
Gok2_libmerged	2084555	2084591		fliS	36
Gok2_libmerged	2084987	2085026		fliD	39
Gok2_libmerged	2085257	2085263		fliD	6
Gok2_libmerged	2085685	2085710		fliD	25
Gok2_libmerged	2085822	2085838		fliD	16
Gok2_libmerged	2085957	2085978		fliD	21
Gok2_libmerged	2086084	2086099		fliD	15
Gok2_libmerged	2086969	2086987		YPO_RS10195	18
Gok2_libmerged	2087057	2087099		YPO_RS10195	42
Gok2_libmerged	2087379	2087392		YPO_RS10195	13
Gok2_libmerged	2088163	2088165		YPO_RS10200	2
Gok2_libmerged	2088529	2088532		YPO_RS10200	3
Gok2_libmerged	2089061	2089078		fliZ	17
Gok2_libmerged	2089190	2089226		fliZ	36
Gok2_libmerged	2089940	2089958		YPO_RS10210	18
Gok2_libmerged	2090240	2090259		YPO_RS10210	19
Gok2_libmerged	2090713	2090715		YPO_RS10210	2
Gok2_libmerged	2090846	2090851		YPO_RS10210	5
Gok2_libmerged	2091423	2091428		tcyJ	5
Gok2_libmerged	2091965	2091972		tcyL	7
Gok2_libmerged	2092115	2092139		tcyL	24
Gok2_libmerged	2092341	2092386		tcyL	45
Gok2_libmerged	2092464	2092482		yecC	18
Gok2_libmerged	2093964	2094050		YPO_RS10235	86
Gok2_libmerged	2094150	2094158		YPO_RS10235	8
Gok2_libmerged	2094701	2094719		putA	18
Gok2_libmerged	2094793	2094796		putA	3
Gok2_libmerged	2094959	2095024		putA	65
Gok2_libmerged	2095379	2095388		putA	9
Gok2_libmerged	2095485	2095498		putA	13
Gok2_libmerged	2095768	2095805		putA	37
Gok2_libmerged	2095907	2095944		putA	37
Gok2_libmerged	2096375	2096379		putA	4
Gok2_libmerged	2096538	2096577		putA	39
Gok2_libmerged	2096911	2096935		putA	24
Gok2_libmerged	2097095	2097120		putA	25
Gok2_libmerged	2097567	2097579		putA	12
Gok2_libmerged	2098461	2098478		putA	17
Gok2_libmerged	2099018	2099056		YPO_RS10245	38
Gok2_libmerged	2099154	2099177		YPO_RS10245	23
Gok2_libmerged	2099357	2099399		putP	42
Gok2_libmerged	2099846	2099868		putP	22
Gok2_libmerged	2100555	2100561		putP	6
Gok2_libmerged	2100652	2100660		putP	8
Gok2_libmerged	2101494	2101503		YPO_RS10255	9
Gok2_libmerged	2101574	2101577		YPO_RS10255	3
Gok2_libmerged	2101709	2101736		YPO_RS10255	27
Gok2_libmerged	2102073	2102106		YPO_RS10260	33
Gok2_libmerged	2102629	2102637		YPO_RS10260	8
Gok2_libmerged	2102959	2102991		YPO_RS10260	32
Gok2_libmerged	2103151	2103186		efeB	35
Gok2_libmerged	2103238	2103244		efeB	6
Gok2_libmerged	2103709	2103740		efeB	31
Gok2_libmerged	2103873	2103887		efeB	14
Gok2_libmerged	2104229	2104270		efeB	41
Gok2_libmerged	2105442	2105526		YPO_RS10275	84
Gok2_libmerged	2105763	2105800		YPO_RS10275	37
Gok2_libmerged	2105933	2105937		YPO_RS10275	4
Gok2_libmerged	2106375	2106382		YPO_RS10275	7
Gok2_libmerged	2106748	2106750		cycA	2
Gok2_libmerged	2107671	2107724		cycA	53
Gok2_libmerged	2107807	2107837		cycA	30
Gok2_libmerged	2107980	2107999		cycA	19
Gok2_libmerged	2108572	2108582		YPO_RS10285	10
Gok2_libmerged	2109269	2109302		YPO_RS10290	33
Gok2_libmerged	2109438	2109523		YPO_RS10290	85
Gok2_libmerged	2109605	2109658		YPO_RS10290	53
Gok2_libmerged	2109727	2109820		YPO_RS10290	93
Gok2_libmerged	2110261	2110288		YPO_RS10295	27
Gok2_libmerged	2110488	2110679		YPO_RS10300	191
Gok2_libmerged	2110740	2110743		YPO_RS10300	3
Gok2_libmerged	2112017	2112035		uvrY	18
Gok2_libmerged	2112428	2112454		uvrY	26
Gok2_libmerged	2112447	2112492		uvrC	45
Gok2_libmerged	2113603	2113659		uvrC	56
Gok2_libmerged	2113725	2113734		uvrC	9
Gok2_libmerged	2113786	2113878		uvrC	92
Gok2_libmerged	2114247	2114279		uvrC	32
Gok2_libmerged	2115469	2115535		YPO_RS10340	66
Gok2_libmerged	2115691	2115693		YPO_RS10340	2
Gok2_libmerged	2117239	2117412		YPO_RS10350	173
Gok2_libmerged	2117604	2117739		YPO_RS10355	135
Gok2_libmerged	2117778	2117786		YPO_RS10355	8
Gok2_libmerged	2118003	2118242		hcp	239
Gok2_libmerged	2118318	2118347		hcp	29
Gok2_libmerged	2118809	2118816		YPO_RS10365	7
Gok2_libmerged	2119066	2119095		YPO_RS10365	29
Gok2_libmerged	2119465	2119492		YPO_RS10365	27
Gok2_libmerged	2119741	2119742		YPO_RS10365	1
Gok2_libmerged	2121644	2121656		YPO_RS10380	12
Gok2_libmerged	2122124	2122172		YPO_RS10385	48
Gok2_libmerged	2122349	2122356		YPO_RS10390	7
Gok2_libmerged	2122634	2122673		YPO_RS10395	39
Gok2_libmerged	2122745	2122748		YPO_RS10395	3
Gok2_libmerged	2122978	2122988		YPO_RS10400	10
Gok2_libmerged	2123164	2123177		YPO_RS10400	13
Gok2_libmerged	2123244	2123492		YPO_RS10405	248
Gok2_libmerged	2123534	2123577		YPO_RS10405	43
Gok2_libmerged	2123711	2123731		YPO_RS10405	20
Gok2_libmerged	2124003	2124319		YPO_RS10405	316
Gok2_libmerged	2126016	2126073		YPO_RS10415	57
Gok2_libmerged	2126194	2126209		YPO_RS10415	15
Gok2_libmerged	2126320	2126358		YPO_RS10415	38
Gok2_libmerged	2126540	2126552		YPO_RS10415	12
Gok2_libmerged	2126564	2126583		YPO_RS10420	19
Gok2_libmerged	2126647	2126756		YPO_RS10420	109
Gok2_libmerged	2126984	2126998		YPO_RS10420	14
Gok2_libmerged	2127967	2128051		YPO_RS10430	84
Gok2_libmerged	2129432	2129480		YPO_RS10435	48
Gok2_libmerged	2129875	2129892		YPO_RS10435	17
Gok2_libmerged	2129973	2129988		YPO_RS10435	15
Gok2_libmerged	2130214	2130263		YPO_RS10435	49
Gok2_libmerged	2131623	2131696		YPO_RS10440	73
Gok2_libmerged	2131982	2132009		YPO_RS10445	27
Gok2_libmerged	2132102	2132156		YPO_RS10445	54
Gok2_libmerged	2132446	2132479		YPO_RS10445	33
Gok2_libmerged	2132656	2132669		YPO_RS10445	13
Gok2_libmerged	2132663	2132669		YPO_RS10450	6
Gok2_libmerged	2132822	2132838		YPO_RS10450	16
Gok2_libmerged	2133017	2133052		YPO_RS10450	35
Gok2_libmerged	2133102	2133155		YPO_RS10450	53
Gok2_libmerged	2133228	2133260		YPO_RS10450	32
Gok2_libmerged	2133396	2133433		YPO_RS10450	37
Gok2_libmerged	2133547	2133610		YPO_RS10455	63
Gok2_libmerged	2134111	2134119		YPO_RS10455	8
Gok2_libmerged	2134415	2134435		YPO_RS10460	20
Gok2_libmerged	2134582	2134622		YPO_RS10460	40
Gok2_libmerged	2134797	2134866		YPO_RS10465	69
Gok2_libmerged	2136042	2136081		YPO_RS10475	39
Gok2_libmerged	2136213	2136222		YPO_RS10475	9
Gok2_libmerged	2136464	2136479		YPO_RS10475	15
Gok2_libmerged	2136530	2136539		YPO_RS10475	9
Gok2_libmerged	2136595	2136614		YPO_RS10480	19
Gok2_libmerged	2136653	2136688		YPO_RS10480	35
Gok2_libmerged	2136747	2136752		YPO_RS10480	5
Gok2_libmerged	2137064	2137068		YPO_RS10480	4
Gok2_libmerged	2137909	2137955		YPO_RS10490	46
Gok2_libmerged	2137945	2137961		YPO_RS10495	16
Gok2_libmerged	2138332	2138410		YPO_RS10495	78
Gok2_libmerged	2138814	2138826		YPO_RS10500	12
Gok2_libmerged	2139123	2139169		YPO_RS10505	46
Gok2_libmerged	2139331	2139432		YPO_RS10505	101
Gok2_libmerged	2139473	2139474		YPO_RS10505	1
Gok2_libmerged	2140914	2140936		fyuA	22
Gok2_libmerged	2141740	2141803		fyuA	63
Gok2_libmerged	2142289	2142317		fyuA	28
Gok2_libmerged	2143425	2143433		ybtE	8
Gok2_libmerged	2143648	2143674		ybtE	26
Gok2_libmerged	2143800	2143823		ybtE	23
Gok2_libmerged	2144199	2144206		ybtE	7
Gok2_libmerged	2144390	2144395		ybtE	5
Gok2_libmerged	2144928	2144937		ybtT	9
Gok2_libmerged	2145015	2145037		ybtT	22
Gok2_libmerged	2145624	2145626		ybtU	2
Gok2_libmerged	2146077	2146108		ybtU	31
Gok2_libmerged	2146289	2146295		ybtU	6
Gok2_libmerged	2146956	2146998		irp1	42
Gok2_libmerged	2147330	2147337		irp1	7
Gok2_libmerged	2147463	2147490		irp1	27
Gok2_libmerged	2147990	2148034		irp1	44
Gok2_libmerged	2148272	2148273		irp1	1
Gok2_libmerged	2148742	2148750		irp1	8
Gok2_libmerged	2149478	2149498		irp1	20
Gok2_libmerged	2149707	2149731		irp1	24
Gok2_libmerged	2149793	2149805		irp1	12
Gok2_libmerged	2151170	2151171		irp1	1
Gok2_libmerged	2151261	2151265		irp1	4
Gok2_libmerged	2151610	2151645		irp1	35
Gok2_libmerged	2152435	2152478		irp1	43
Gok2_libmerged	2153040	2153057		irp1	17
Gok2_libmerged	2153130	2153156		irp1	26
Gok2_libmerged	2153726	2153762		irp1	36
Gok2_libmerged	2154731	2154753		irp1	22
Gok2_libmerged	2154859	2154892		irp1	33
Gok2_libmerged	2155281	2155315		irp1	34
Gok2_libmerged	2156187	2156242		irp2	55
Gok2_libmerged	2156466	2156469		irp2	3
Gok2_libmerged	2156994	2156997		irp2	3
Gok2_libmerged	2158386	2158417		irp2	31
Gok2_libmerged	2158617	2158631		irp2	14
Gok2_libmerged	2158706	2158724		irp2	18
Gok2_libmerged	2158780	2158800		irp2	20
Gok2_libmerged	2158943	2158951		irp2	8
Gok2_libmerged	2159461	2159468		irp2	7
Gok2_libmerged	2159581	2159583		irp2	2
Gok2_libmerged	2159939	2159957		irp2	18
Gok2_libmerged	2160059	2160125		irp2	66
Gok2_libmerged	2160570	2160602		irp2	32
Gok2_libmerged	2160659	2160685		irp2	26
Gok2_libmerged	2160753	2160770		irp2	17
Gok2_libmerged	2161295	2161303		irp2	8
Gok2_libmerged	2161742	2161765		irp2	23
Gok2_libmerged	2163757	2163786		ybtP	29
Gok2_libmerged	2163884	2163887		ybtP	3
Gok2_libmerged	2164368	2164389		ybtP	21
Gok2_libmerged	2164469	2164522		ybtP	53
Gok2_libmerged	2164721	2164728		ybtP	7
Gok2_libmerged	2164813	2164820		ybtP	7
Gok2_libmerged	2165223	2165254		ybtP	31
Gok2_libmerged	2166943	2166951		ybtQ	8
Gok2_libmerged	2167420	2167433		ybtX	13
Gok2_libmerged	2168505	2168535		ybtS	30
Gok2_libmerged	2168655	2168659		ybtS	4
Gok2_libmerged	2169028	2169040		ybtS	12
Gok2_libmerged	2169367	2169381		ybtS	14
Gok2_libmerged	2169863	2169898		YPO_RS10570	35
Gok2_libmerged	2170137	2170189		YPO_RS10570	52
Gok2_libmerged	2170545	2170551		YPO_RS10570	6
Gok2_libmerged	2171711	2171738		YPO_RS10580	27
Gok2_libmerged	2172371	2172380		YPO_RS10580	9
Gok2_libmerged	2172624	2172633		YPO_RS10585	9
Gok2_libmerged	2172896	2172996		YPO_RS10585	100
Gok2_libmerged	2173036	2173049		YPO_RS10585	13
Gok2_libmerged	2173225	2173294		YPO_RS10585	69
Gok2_libmerged	2173535	2173549		YPO_RS10585	14
Gok2_libmerged	2173702	2173704		YPO_RS10585	2
Gok2_libmerged	2173869	2173879		YPO_RS10590	10
Gok2_libmerged	2174410	2174418		YPO_RS10590	8
Gok2_libmerged	2174486	2174494		YPO_RS10590	8
Gok2_libmerged	2174808	2174830		YPO_RS10590	22
Gok2_libmerged	2175084	2175128		YPO_RS10590	44
Gok2_libmerged	2176136	2176189		YPO_RS10590	53
Gok2_libmerged	2176412	2176452		YPO_RS10595	40
Gok2_libmerged	2176634	2176756		YPO_RS10595	122
Gok2_libmerged	2176844	2176889		YPO_RS10595	45
Gok2_libmerged	2177144	2177170		YPO_RS10600	26
Gok2_libmerged	2177360	2177378		YPO_RS10600	18
Gok2_libmerged	2177661	2177674		YPO_RS10600	13
Gok2_libmerged	2178217	2178220		YPO_RS10605	3
Gok2_libmerged	2178682	2178701		YPO_RS10605	19
Gok2_libmerged	2178920	2178999		YPO_RS10605	79
Gok2_libmerged	2179228	2179285		YPO_RS10605	57
Gok2_libmerged	2179395	2179423		YPO_RS10605	28
Gok2_libmerged	2179523	2179536		YPO_RS10605	13
Gok2_libmerged	2180063	2180072		YPO_RS10605	9
Gok2_libmerged	2180264	2180288		YPO_RS10605	24
Gok2_libmerged	2180387	2180497		YPO_RS10605	110
Gok2_libmerged	2180560	2180584		YPO_RS10605	24
Gok2_libmerged	2180790	2180810		YPO_RS10610	20
Gok2_libmerged	2180911	2180944		YPO_RS10610	33
Gok2_libmerged	2181018	2181022		YPO_RS10610	4
Gok2_libmerged	2181234	2181256		YPO_RS10610	22
Gok2_libmerged	2181333	2181342		YPO_RS10610	9
Gok2_libmerged	2181904	2181907		YPO_RS10610	3
Gok2_libmerged	2182012	2182023		YPO_RS10615	11
Gok2_libmerged	2182622	2182644		YPO_RS10615	22
Gok2_libmerged	2183470	2183476		YPO_RS10620	6
Gok2_libmerged	2183752	2183861		YPO_RS10620	109
Gok2_libmerged	2183923	2183966		YPO_RS10620	43
Gok2_libmerged	2184007	2184042		YPO_RS10620	35
Gok2_libmerged	2184451	2184502		YPO_RS10620	51
Gok2_libmerged	2184553	2184655		YPO_RS10620	102
Gok2_libmerged	2184690	2184745		YPO_RS10620	55
Gok2_libmerged	2184859	2184915		YPO_RS10625	56
Gok2_libmerged	2185217	2185222		YPO_RS10625	5
Gok2_libmerged	2185306	2185325		YPO_RS10625	19
Gok2_libmerged	2185458	2185474		YPO_RS10630	16
Gok2_libmerged	2185540	2185583		YPO_RS10630	43
Gok2_libmerged	2185843	2185851		YPO_RS10630	8
Gok2_libmerged	2186344	2186386		YPO_RS10635	42
Gok2_libmerged	2187092	2187120		YPO_RS10635	28
Gok2_libmerged	2187297	2187451		YPO_RS10640	154
Gok2_libmerged	2187481	2187486		YPO_RS10640	5
Gok2_libmerged	2187559	2187596		YPO_RS10640	37
Gok2_libmerged	2187643	2187770		YPO_RS10640	127
Gok2_libmerged	2187795	2188109		YPO_RS10645	314
Gok2_libmerged	2188246	2188330		YPO_RS10645	84
Gok2_libmerged	2188717	2188758		YPO_RS10650	41
Gok2_libmerged	2188900	2188909		YPO_RS10650	9
Gok2_libmerged	2188983	2189012		YPO_RS10650	29
Gok2_libmerged	2189144	2189163		YPO_RS10650	19
Gok2_libmerged	2189225	2189251		YPO_RS10650	26
Gok2_libmerged	2189529	2189577		YPO_RS10650	48
Gok2_libmerged	2190093	2190114		YPO_RS10655	21
Gok2_libmerged	2190255	2190267		YPO_RS10655	12
Gok2_libmerged	2190488	2190519		YPO_RS10655	31
Gok2_libmerged	2190712	2190739		YPO_RS10655	27
Gok2_libmerged	2191116	2191139		YPO_RS10660	23
Gok2_libmerged	2191665	2191671		YPO_RS10660	6
Gok2_libmerged	2192660	2192717		nqrE	57
Gok2_libmerged	2193120	2193121		YPO_RS10670	1
Gok2_libmerged	2193217	2193220		YPO_RS10670	3
Gok2_libmerged	2193861	2193869		YPO_RS10670	8
Gok2_libmerged	2194425	2194460		ansP	35
Gok2_libmerged	2194771	2194805		ansP	34
Gok2_libmerged	2194842	2194879		ansP	37
Gok2_libmerged	2195529	2195542		ansP	13
Gok2_libmerged	2195718	2195721		ansP	3
Gok2_libmerged	2195953	2195954		ansP	1
Gok2_libmerged	2197041	2197120		YPO_RS10680	79
Gok2_libmerged	2197234	2197237		YPO_RS10680	3
Gok2_libmerged	2198015	2198026		YPO_RS10685	11
Gok2_libmerged	2198175	2198205		YPO_RS10685	30
Gok2_libmerged	2198897	2198928		glsA	31
Gok2_libmerged	2199245	2199306		glsA	61
Gok2_libmerged	2199775	2199826		YPO_RS10695	51
Gok2_libmerged	2200587	2200619		YPO_RS10695	32
Gok2_libmerged	2202134	2202164		YPO_RS10700	30
Gok2_libmerged	2202351	2202360		YPO_RS10700	9
Gok2_libmerged	2202694	2202701		YPO_RS10700	7
Gok2_libmerged	2202881	2202884		YPO_RS10700	3
Gok2_libmerged	2202938	2202963		YPO_RS10700	25
Gok2_libmerged	2203361	2203363		YPO_RS10700	2
Gok2_libmerged	2203417	2203439		YPO_RS10700	22
Gok2_libmerged	2203642	2203789		YPO_RS10700	147
Gok2_libmerged	2204343	2204352		YPO_RS10705	9
Gok2_libmerged	2204410	2204488		YPO_RS10705	78
Gok2_libmerged	2204525	2204530		YPO_RS10705	5
Gok2_libmerged	2204947	2205012		YPO_RS10710	65
Gok2_libmerged	2205180	2205192		YPO_RS10710	12
Gok2_libmerged	2205742	2205746		YPO_RS10710	4
Gok2_libmerged	2205816	2205832		YPO_RS10710	16
Gok2_libmerged	2206744	2206756		YPO_RS10715	12
Gok2_libmerged	2207344	2207364		YPO_RS10715	20
Gok2_libmerged	2207547	2207549		YPO_RS10715	2
Gok2_libmerged	2207816	2207898		YPO_RS10720	82
Gok2_libmerged	2208054	2208058		YPO_RS10720	4
Gok2_libmerged	2208117	2208148		YPO_RS10720	31
Gok2_libmerged	2208378	2208379		YPO_RS10720	1
Gok2_libmerged	2208473	2208475		YPO_RS10720	2
Gok2_libmerged	2208825	2208827		YPO_RS10725	2
Gok2_libmerged	2209507	2209510		YPO_RS10725	3
Gok2_libmerged	2209687	2209718		YPO_RS10730	31
Gok2_libmerged	2209838	2209917		YPO_RS10730	79
Gok2_libmerged	2210043	2210084		YPO_RS10735	41
Gok2_libmerged	2210609	2210625		tehB	16
Gok2_libmerged	2210839	2210878		tehB	39
Gok2_libmerged	2210913	2211013		tehB	100
Gok2_libmerged	2211246	2211275		tehB	29
Gok2_libmerged	2211520	2211526		YPO_RS10745	6
Gok2_libmerged	2211733	2211767		YPO_RS10745	34
Gok2_libmerged	2212316	2212325		YPO_RS10745	9
Gok2_libmerged	2212648	2212676		YPO_RS10745	28
Gok2_libmerged	2212730	2212737		YPO_RS10745	7
Gok2_libmerged	2213497	2213506		pgaA	9
Gok2_libmerged	2213797	2213847		pgaA	50
Gok2_libmerged	2214032	2214046		pgaA	14
Gok2_libmerged	2214285	2214295		pgaA	10
Gok2_libmerged	2214508	2214609		pgaA	101
Gok2_libmerged	2214771	2214778		pgaA	7
Gok2_libmerged	2215045	2215097		pgaA	52
Gok2_libmerged	2215144	2215197		pgaA	53
Gok2_libmerged	2215775	2215789		pgaA	14
Gok2_libmerged	2216050	2216062		pgaB	12
Gok2_libmerged	2216230	2216243		pgaB	13
Gok2_libmerged	2216622	2216626		pgaB	4
Gok2_libmerged	2216706	2216711		pgaB	5
Gok2_libmerged	2217150	2217202		pgaB	52
Gok2_libmerged	2218003	2218087		YPO_RS10760	84
Gok2_libmerged	2218192	2218208		YPO_RS10760	16
Gok2_libmerged	2218892	2218929		YPO_RS10760	37
Gok2_libmerged	2218974	2218983		YPO_RS10760	9
Gok2_libmerged	2219097	2219110		YPO_RS10760	13
Gok2_libmerged	2219229	2219232		YPO_RS10760	3
Gok2_libmerged	2219229	2219250		pgaD	21
Gok2_libmerged	2219627	2219640		pgaD	13
Gok2_libmerged	2220276	2220303		YPO_RS10770	27
Gok2_libmerged	2220479	2220504		YPO_RS10770	25
Gok2_libmerged	2220926	2220928		YPO_RS10770	2
Gok2_libmerged	2221802	2221803		phoH	1
Gok2_libmerged	2221974	2221981		phoH	7
Gok2_libmerged	2222342	2222348		phoH	6
Gok2_libmerged	2222485	2222493		phoH	8
Gok2_libmerged	2223028	2223031		chaA	3
Gok2_libmerged	2223091	2223157		chaA	66
Gok2_libmerged	2223212	2223234		chaA	22
Gok2_libmerged	2224262	2224274		narX	12
Gok2_libmerged	2224379	2224389		narX	10
Gok2_libmerged	2224527	2224550		narX	23
Gok2_libmerged	2224656	2224676		narX	20
Gok2_libmerged	2224751	2224762		narX	11
Gok2_libmerged	2225047	2225066		narX	19
Gok2_libmerged	2225484	2225490		narX	6
Gok2_libmerged	2225591	2225624		narX	33
Gok2_libmerged	2225713	2225763		narX	50
Gok2_libmerged	2226020	2226026		narX	6
Gok2_libmerged	2226574	2226587		YPO_RS10800	13
Gok2_libmerged	2226796	2226837		YPO_RS10800	41
Gok2_libmerged	2227092	2227181		YPO_RS10800	89
Gok2_libmerged	2227274	2227330		YPO_RS10800	56
Gok2_libmerged	2227622	2227646		YPO_RS10800	24
Gok2_libmerged	2227744	2227757		YPO_RS10800	13
Gok2_libmerged	2228588	2228599		YPO_RS10805	11
Gok2_libmerged	2229463	2229585		YPO_RS10805	122
Gok2_libmerged	2229899	2229902		astA	3
Gok2_libmerged	2230011	2230029		astA	18
Gok2_libmerged	2230075	2230108		astA	33
Gok2_libmerged	2230493	2230505		astA	12
Gok2_libmerged	2231185	2231290		astD	105
Gok2_libmerged	2231515	2231557		astD	42
Gok2_libmerged	2231749	2231803		astD	54
Gok2_libmerged	2232269	2232342		astB	73
Gok2_libmerged	2232748	2232786		astB	38
Gok2_libmerged	2232921	2232946		astB	25
Gok2_libmerged	2233234	2233290		astB	56
Gok2_libmerged	2233488	2233514		astB	26
Gok2_libmerged	2233752	2233777		astE	25
Gok2_libmerged	2233941	2233965		astE	24
Gok2_libmerged	2234535	2234592		astE	57
Gok2_libmerged	2236709	2236713		YPO_RS10835	4
Gok2_libmerged	2236877	2236928		YPO_RS10835	51
Gok2_libmerged	2237022	2237026		YPO_RS10835	4
Gok2_libmerged	2237155	2237218		YPO_RS10835	63
Gok2_libmerged	2237263	2237302		YPO_RS10835	39
Gok2_libmerged	2237354	2237379		YPO_RS10835	25
Gok2_libmerged	2237545	2237556		YPO_RS10840	11
Gok2_libmerged	2237734	2237738		YPO_RS10840	4
Gok2_libmerged	2237779	2237837		YPO_RS10840	58
Gok2_libmerged	2238726	2238757		hutG	31
Gok2_libmerged	2239212	2239224		hutG	12
Gok2_libmerged	2239799	2239837		YPO_RS10855	38
Gok2_libmerged	2239907	2239920		YPO_RS10855	13
Gok2_libmerged	2240160	2240162		YPO_RS10855	2
Gok2_libmerged	2240302	2240312		YPO_RS10855	10
Gok2_libmerged	2240502	2240572		YPO_RS10855	70
Gok2_libmerged	2241615	2241659		hutC	44
Gok2_libmerged	2242102	2242113		YPO_RS10865	11
Gok2_libmerged	2242235	2242249		YPO_RS10865	14
Gok2_libmerged	2242398	2242401		YPO_RS10865	3
Gok2_libmerged	2242469	2242478		YPO_RS10865	9
Gok2_libmerged	2242549	2242554		YPO_RS10865	5
Gok2_libmerged	2242618	2242624		YPO_RS10865	6
Gok2_libmerged	2242789	2242793		YPO_RS10865	4
Gok2_libmerged	2243049	2243108		YPO_RS10865	59
Gok2_libmerged	2243414	2243420		YPO_RS10870	6
Gok2_libmerged	2243509	2243543		YPO_RS10870	34
Gok2_libmerged	2244445	2244486		YPO_RS10875	41
Gok2_libmerged	2244774	2244819		YPO_RS10875	45
Gok2_libmerged	2244884	2244957		YPO_RS10875	73
Gok2_libmerged	2245143	2245199		YPO_RS10875	56
Gok2_libmerged	2245506	2245507		YPO_RS10875	1
Gok2_libmerged	2244539	2244609		YPO_RS10875	70
Gok2_libmerged	2247864	2247899		YPO_RS10885	35
Gok2_libmerged	2247985	2247989		YPO_RS10885	4
Gok2_libmerged	2248589	2248614		YPO_RS10885	25
Gok2_libmerged	2249364	2249374		YPO_RS10890	10
Gok2_libmerged	2249446	2249469		YPO_RS10895	23
Gok2_libmerged	2249657	2249679		YPO_RS10895	22
Gok2_libmerged	2249794	2249899		YPO_RS10895	105
Gok2_libmerged	2250391	2250400		YPO_RS10895	9
Gok2_libmerged	2250588	2250681		YPO_RS10895	93
Gok2_libmerged	2251639	2251665		YPO_RS10900	26
Gok2_libmerged	2251758	2251808		YPO_RS10900	50
Gok2_libmerged	2251889	2251920		YPO_RS10905	31
Gok2_libmerged	2252135	2252142		YPO_RS10905	7
Gok2_libmerged	2252304	2252319		YPO_RS10905	15
Gok2_libmerged	2252876	2252888		YPO_RS10905	12
Gok2_libmerged	2253313	2253361		YPO_RS10910	48
Gok2_libmerged	2253570	2253577		YPO_RS10915	7
Gok2_libmerged	2253926	2253942		YPO_RS10915	16
Gok2_libmerged	2254502	2254555		YPO_RS10915	53
Gok2_libmerged	2254728	2254731		YPO_RS10915	3
Gok2_libmerged	2254960	2255033		YPO_RS10920	73
Gok2_libmerged	2256066	2256068		YPO_RS10925	2
Gok2_libmerged	2256132	2256164		YPO_RS10925	32
Gok2_libmerged	2256209	2256227		YPO_RS10925	18
Gok2_libmerged	2256366	2256424		YPO_RS10925	58
Gok2_libmerged	2256529	2256624		YPO_RS10925	95
Gok2_libmerged	2257369	2257432		YPO_RS10930	63
Gok2_libmerged	2258102	2258106		YPO_RS10930	4
Gok2_libmerged	2258309	2258321		YPO_RS10930	12
Gok2_libmerged	2258636	2258652		YPO_RS10935	16
Gok2_libmerged	2258981	2258989		YPO_RS10935	8
Gok2_libmerged	2259077	2259109		YPO_RS10935	32
Gok2_libmerged	2259140	2259408		YPO_RS10935	268
Gok2_libmerged	2259716	2259719		YPO_RS10935	3
Gok2_libmerged	2259763	2259874		YPO_RS10935	111
Gok2_libmerged	2260003	2260095		YPO_RS10935	92
Gok2_libmerged	2260643	2260707		YPO_RS10935	64
Gok2_libmerged	2261376	2261409		YPO_RS10940	33
Gok2_libmerged	2261628	2261673		YPO_RS10940	45
Gok2_libmerged	2262191	2262215		YPO_RS10940	24
Gok2_libmerged	2262848	2262878		YPO_RS10940	30
Gok2_libmerged	2263158	2263265		YPO_RS10940	107
Gok2_libmerged	2263371	2263393		YPO_RS10940	22
Gok2_libmerged	2263441	2263451		YPO_RS10940	10
Gok2_libmerged	2263951	2263968		YPO_RS10945	17
Gok2_libmerged	2264239	2264254		YPO_RS10945	15
Gok2_libmerged	2264599	2264606		YPO_RS10950	7
Gok2_libmerged	2265000	2265143		YPO_RS10950	143
Gok2_libmerged	2265271	2265340		YPO_RS10955	69
Gok2_libmerged	2265413	2265435		YPO_RS10955	22
Gok2_libmerged	2265489	2265604		YPO_RS10955	115
Gok2_libmerged	2265749	2265865		YPO_RS10955	116
Gok2_libmerged	2265941	2265951		YPO_RS10955	10
Gok2_libmerged	2266234	2266246		YPO_RS10960	12
Gok2_libmerged	2266292	2266508		YPO_RS10965	216
Gok2_libmerged	2266710	2266839		YPO_RS10965	129
Gok2_libmerged	2266874	2266888		YPO_RS10965	14
Gok2_libmerged	2266976	2267013		YPO_RS10965	37
Gok2_libmerged	2267322	2267331		YPO_RS10970	9
Gok2_libmerged	2267413	2267438		YPO_RS10970	25
Gok2_libmerged	2267520	2267554		YPO_RS10970	34
Gok2_libmerged	2267631	2267661		YPO_RS10970	30
Gok2_libmerged	2267892	2268057		YPO_RS10970	165
Gok2_libmerged	2268151	2268161		YPO_RS10970	10
Gok2_libmerged	2268167	2268178		YPO_RS10975	11
Gok2_libmerged	2268332	2268364		YPO_RS10975	32
Gok2_libmerged	2268547	2268605		YPO_RS10975	58
Gok2_libmerged	2268737	2268834		YPO_RS10975	97
Gok2_libmerged	2269009	2269072		YPO_RS10975	63
Gok2_libmerged	2270182	2270217		YPO_RS10980	35
Gok2_libmerged	2270353	2270355		YPO_RS10980	2
Gok2_libmerged	2270679	2270698		YPO_RS10980	19
Gok2_libmerged	2270800	2270808		YPO_RS10980	8
Gok2_libmerged	2270870	2270915		YPO_RS10980	45
Gok2_libmerged	2271398	2271400		YPO_RS10985	2
Gok2_libmerged	2271674	2271691		YPO_RS10990	17
Gok2_libmerged	2271741	2271745		YPO_RS10990	4
Gok2_libmerged	2274172	2274207		YPO_RS11000	35
Gok2_libmerged	2274257	2274262		YPO_RS11000	5
Gok2_libmerged	2274385	2274445		YPO_RS11000	60
Gok2_libmerged	2274727	2274745		YPO_RS11005	18
Gok2_libmerged	2274848	2274934		YPO_RS11005	86
Gok2_libmerged	2275079	2275129		YPO_RS11005	50
Gok2_libmerged	2275175	2275180		YPO_RS11005	5
Gok2_libmerged	2275248	2275250		YPO_RS11005	2
Gok2_libmerged	2275325	2275372		YPO_RS11005	47
Gok2_libmerged	2275514	2275536		YPO_RS11005	22
Gok2_libmerged	2275758	2275818		YPO_RS11005	60
Gok2_libmerged	2276052	2276072		YPO_RS11010	20
Gok2_libmerged	2276152	2276220		YPO_RS11010	68
Gok2_libmerged	2276488	2276492		YPO_RS11010	4
Gok2_libmerged	2276573	2276620		YPO_RS11010	47
Gok2_libmerged	2276723	2276743		YPO_RS11015	20
Gok2_libmerged	2276912	2276956		YPO_RS11015	44
Gok2_libmerged	2277038	2277085		YPO_RS11015	47
Gok2_libmerged	2277188	2277301		YPO_RS11015	113
Gok2_libmerged	2277593	2277696		YPO_RS11020	103
Gok2_libmerged	2277921	2277940		YPO_RS11020	19
Gok2_libmerged	2277970	2278030		YPO_RS11020	60
Gok2_libmerged	2278386	2278435		YPO_RS11020	49
Gok2_libmerged	2279116	2279158		YPO_RS11025	42
Gok2_libmerged	2279363	2279369		YPO_RS11025	6
Gok2_libmerged	2280350	2280378		YPO_RS11030	28
Gok2_libmerged	2280443	2280445		YPO_RS11030	2
Gok2_libmerged	2280523	2280549		YPO_RS11030	26
Gok2_libmerged	2280557	2280806		YPO_RS11035	249
Gok2_libmerged	2282154	2282167		ychF	13
Gok2_libmerged	2282257	2282275		ychF	18
Gok2_libmerged	2282487	2282491		ychF	4
Gok2_libmerged	2282923	2282926		ychF	3
Gok2_libmerged	2283037	2283046		ychF	9
Gok2_libmerged	2283228	2283232		ychF	4
Gok2_libmerged	2283773	2283802		pth	29
Gok2_libmerged	2283976	2283978		pth	2
Gok2_libmerged	2284405	2284455		ychH	50
Gok2_libmerged	2284587	2284620		ychH	33
Gok2_libmerged	2285180	2285214		YPO_RS11060	34
Gok2_libmerged	2285398	2285399		YPO_RS11060	1
Gok2_libmerged	2285565	2285571		YPO_RS11060	6
Gok2_libmerged	2285615	2285617		YPO_RS11060	2
Gok2_libmerged	2285676	2285738		YPO_RS11060	62
Gok2_libmerged	2286180	2286183		ispE	3
Gok2_libmerged	2286678	2286749		ispE	71
Gok2_libmerged	2286804	2286805		ispE	1
Gok2_libmerged	2287093	2287166		lolB	73
Gok2_libmerged	2287433	2287442		lolB	9
Gok2_libmerged	2287983	2287999		hemA	16
Gok2_libmerged	2288060	2288078		hemA	18
Gok2_libmerged	2288180	2288209		hemA	29
Gok2_libmerged	2288684	2288798		hemA	114
Gok2_libmerged	2288837	2288851		hemA	14
Gok2_libmerged	2288949	2288952		hemA	3
Gok2_libmerged	2289361	2289379		prfA	18
Gok2_libmerged	2289795	2289796		prfA	1
Gok2_libmerged	2289967	2290051		prfA	84
Gok2_libmerged	2290127	2290131		prfA	4
Gok2_libmerged	2290257	2290302		prfA	45
Gok2_libmerged	2290428	2290432		prmC	4
Gok2_libmerged	2290864	2290900		prmC	36
Gok2_libmerged	2291374	2291405		YPO_RS11090	31
Gok2_libmerged	2291848	2291861		YPO_RS11095	13
Gok2_libmerged	2292126	2292140		YPO_RS11095	14
Gok2_libmerged	2292339	2292342		YPO_RS11095	3
Gok2_libmerged	2292578	2292583		kdsA	5
Gok2_libmerged	2293054	2293093		kdsA	39
Gok2_libmerged	2293264	2293269		kdsA	5
Gok2_libmerged	2293357	2293368		kdsA	11
Gok2_libmerged	2293850	2293855		YPO_RS11105	5
Gok2_libmerged	2294017	2294023		YPO_RS11105	6
Gok2_libmerged	2294176	2294277		YPO_RS11105	101
Gok2_libmerged	2294532	2294553		YPO_RS11110	21
Gok2_libmerged	2294650	2294653		YPO_RS11110	3
Gok2_libmerged	2294828	2294854		YPO_RS11110	26
Gok2_libmerged	2294971	2295007		YPO_RS11115	36
Gok2_libmerged	2295338	2295428		YPO_RS11115	90
Gok2_libmerged	2295493	2295561		YPO_RS11115	68
Gok2_libmerged	2295722	2295725		YPO_RS11120	3
Gok2_libmerged	2296202	2296339		YPO_RS11120	137
Gok2_libmerged	2296626	2296632		YPO_RS11120	6
Gok2_libmerged	2296703	2296729		YPO_RS11120	26
Gok2_libmerged	2299171	2299248		YPO_RS11135	77
Gok2_libmerged	2299452	2299498		YPO_RS11135	46
Gok2_libmerged	2299557	2299573		YPO_RS11135	16
Gok2_libmerged	2299769	2299782		YPO_RS11135	13
Gok2_libmerged	2299872	2299944		YPO_RS11135	72
Gok2_libmerged	2300025	2300030		YPO_RS11135	5
Gok2_libmerged	2300338	2300376		YPO_RS11140	38
Gok2_libmerged	2300935	2300980		YPO_RS11140	45
Gok2_libmerged	2301450	2301519		YPO_RS11145	69
Gok2_libmerged	2301580	2301587		YPO_RS11145	7
Gok2_libmerged	2301761	2301767		YPO_RS11145	6
Gok2_libmerged	2301947	2301954		YPO_RS11145	7
Gok2_libmerged	2302011	2302034		YPO_RS11145	23
Gok2_libmerged	2302122	2302123		YPO_RS11145	1
Gok2_libmerged	2302612	2302629		YPO_RS11150	17
Gok2_libmerged	2302698	2302719		YPO_RS11150	21
Gok2_libmerged	2302934	2302937		YPO_RS11150	3
Gok2_libmerged	2303267	2303285		YPO_RS11155	18
Gok2_libmerged	2303431	2303441		YPO_RS11155	10
Gok2_libmerged	2303890	2303897		YPO_RS11155	7
Gok2_libmerged	2304126	2304192		YPO_RS11160	66
Gok2_libmerged	2304417	2304440		YPO_RS11160	23
Gok2_libmerged	2305574	2305584		YPO_RS11170	10
Gok2_libmerged	2306024	2306028		YPO_RS11175	4
Gok2_libmerged	2306392	2306397		YPO_RS11175	5
Gok2_libmerged	2306700	2306720		YPO_RS11175	20
Gok2_libmerged	2307029	2307073		YPO_RS11175	44
Gok2_libmerged	2307352	2307367		YPO_RS11180	15
Gok2_libmerged	2307729	2307779		YPO_RS11185	50
Gok2_libmerged	2307944	2307950		YPO_RS11185	6
Gok2_libmerged	2308187	2308292		YPO_RS11185	105
Gok2_libmerged	2308486	2308506		YPO_RS11190	20
Gok2_libmerged	2309618	2309669		YPO_RS11195	51
Gok2_libmerged	2309732	2309789		YPO_RS11195	57
Gok2_libmerged	2310736	2310773		mdtH	37
Gok2_libmerged	2311086	2311089		mdtH	3
Gok2_libmerged	2311259	2311318		mdtH	59
Gok2_libmerged	2311570	2311573		mdtH	3
Gok2_libmerged	2311628	2311663		mdtH	35
Gok2_libmerged	2312120	2312140		rimJ	20
Gok2_libmerged	2312585	2312611		YPO_RS11210	26
Gok2_libmerged	2312720	2312748		YPO_RS11210	28
Gok2_libmerged	2312982	2313018		YPO_RS11210	36
Gok2_libmerged	2313227	2313241		YPO_RS11210	14
Gok2_libmerged	2313378	2313398		YPO_RS11210	20
Gok2_libmerged	2314499	2314527		murJ	28
Gok2_libmerged	2314700	2314803		murJ	103
Gok2_libmerged	2315005	2315070		murJ	65
Gok2_libmerged	2315283	2315289		murJ	6
Gok2_libmerged	2315472	2315511		murJ	39
Gok2_libmerged	2315579	2315616		murJ	37
Gok2_libmerged	2315878	2315961		murJ	83
Gok2_libmerged	2316441	2316524		YPO_RS11220	83
Gok2_libmerged	2316575	2316633		YPO_RS11220	58
Gok2_libmerged	2316895	2316901		YPO_RS11220	6
Gok2_libmerged	2317081	2317200		YPO_RS11220	119
Gok2_libmerged	2317354	2317479		YPO_RS11220	125
Gok2_libmerged	2317536	2317577		YPO_RS11220	41
Gok2_libmerged	2317779	2317884		YPO_RS11220	105
Gok2_libmerged	2317966	2317989		YPO_RS11220	23
Gok2_libmerged	2318073	2318102		YPO_RS11220	29
Gok2_libmerged	2318132	2318277		YPO_RS11225	145
Gok2_libmerged	2318354	2318414		YPO_RS11225	60
Gok2_libmerged	2318707	2318732		YPO_RS11225	25
Gok2_libmerged	2318805	2318864		YPO_RS11225	59
Gok2_libmerged	2318932	2318968		YPO_RS11225	36
Gok2_libmerged	2319132	2319239		YPO_RS11225	107
Gok2_libmerged	2319353	2319398		YPO_RS11225	45
Gok2_libmerged	2319482	2319537		YPO_RS11225	55
Gok2_libmerged	2319645	2319836		YPO_RS11225	191
Gok2_libmerged	2319963	2320022		YPO_RS11225	59
Gok2_libmerged	2320093	2320134		YPO_RS11225	41
Gok2_libmerged	2320178	2320189		YPO_RS11225	11
Gok2_libmerged	2320340	2320361		YPO_RS11225	21
Gok2_libmerged	2320438	2320674		YPO_RS11225	236
Gok2_libmerged	2320852	2320860		YPO_RS11225	8
Gok2_libmerged	2320925	2320952		YPO_RS11225	27
Gok2_libmerged	2321211	2321216		YPO_RS11225	5
Gok2_libmerged	2321348	2321366		YPO_RS11225	18
Gok2_libmerged	2321494	2321504		YPO_RS11225	10
Gok2_libmerged	2321956	2322048		YPO_RS11225	92
Gok2_libmerged	2322087	2322196		YPO_RS11225	109
Gok2_libmerged	2322419	2322454		YPO_RS11225	35
Gok2_libmerged	2322546	2322570		YPO_RS11225	24
Gok2_libmerged	2322804	2322862		YPO_RS11225	58
Gok2_libmerged	2323399	2323419		argS	20
Gok2_libmerged	2323474	2323476		argS	2
Gok2_libmerged	2323562	2323640		argS	78
Gok2_libmerged	2323850	2323873		argS	23
Gok2_libmerged	2323939	2323975		argS	36
Gok2_libmerged	2324280	2324281		argS	1
Gok2_libmerged	2324665	2324669		argS	4
Gok2_libmerged	2325683	2325686		YPO_RS11235	3
Gok2_libmerged	2325748	2325774		YPO_RS11235	26
Gok2_libmerged	2326385	2326399		cutC	14
Gok2_libmerged	2326557	2326736		cutC	179
Gok2_libmerged	2326933	2326978		cutC	45
Gok2_libmerged	2327269	2327281		cmoB	12
Gok2_libmerged	2327436	2327458		cmoB	22
Gok2_libmerged	2327490	2327502		cmoB	12
Gok2_libmerged	2327567	2327638		cmoB	71
Gok2_libmerged	2327682	2327704		cmoB	22
Gok2_libmerged	2328039	2328045		cmoB	6
Gok2_libmerged	2328117	2328179		cmoB	62
Gok2_libmerged	2328178	2328179		cmoA	1
Gok2_libmerged	2328282	2328290		cmoA	8
Gok2_libmerged	2328365	2328405		cmoA	40
Gok2_libmerged	2328585	2328604		cmoA	19
Gok2_libmerged	2328940	2328949		cmoA	9
Gok2_libmerged	2329210	2329231		YPO_RS11255	21
Gok2_libmerged	2329383	2329474		YPO_RS11255	91
Gok2_libmerged	2329888	2330014		YPO_RS11260	126
Gok2_libmerged	2330460	2330468		YPO_RS11260	8
Gok2_libmerged	2331713	2331741		aspS	28
Gok2_libmerged	2332041	2332086		aspS	45
Gok2_libmerged	2332128	2332175		aspS	47
Gok2_libmerged	2332373	2332424		aspS	51
Gok2_libmerged	2332638	2332694		aspS	56
Gok2_libmerged	2332830	2332856		aspS	26
Gok2_libmerged	2332925	2332951		aspS	26
Gok2_libmerged	2333533	2333544		nudB	11
Gok2_libmerged	2333769	2333780		nudB	11
Gok2_libmerged	2333855	2333859		nudB	4
Gok2_libmerged	2334149	2334152		YPO_RS11275	3
Gok2_libmerged	2334184	2334206		YPO_RS11275	22
Gok2_libmerged	2334280	2334329		YPO_RS11275	49
Gok2_libmerged	2334581	2334588		YPO_RS11275	7
Gok2_libmerged	2335110	2335148		ruvC	38
Gok2_libmerged	2335385	2335390		ruvC	5
Gok2_libmerged	2335989	2336010		ruvA	21
Gok2_libmerged	2336116	2336139		ruvA	23
Gok2_libmerged	2336239	2336248		ruvA	9
Gok2_libmerged	2336281	2336287		ruvA	6
Gok2_libmerged	2336599	2336635		ruvB	36
Gok2_libmerged	2336666	2336682		ruvB	16
Gok2_libmerged	2336952	2336964		ruvB	12
Gok2_libmerged	2337071	2337080		ruvB	9
Gok2_libmerged	2337213	2337234		ruvB	21
Gok2_libmerged	2337367	2337439		ruvB	72
Gok2_libmerged	2338018	2338033		znuB	15
Gok2_libmerged	2338265	2338275		znuB	10
Gok2_libmerged	2338373	2338548		znuC	175
Gok2_libmerged	2339463	2339484		znuA	21
Gok2_libmerged	2339589	2339599		znuA	10
Gok2_libmerged	2339728	2339778		znuA	50
Gok2_libmerged	2339886	2339914		znuA	28
Gok2_libmerged	2340103	2340136		mepM	33
Gok2_libmerged	2340935	2340975		mepM	40
Gok2_libmerged	2341062	2341067		mepM	5
Gok2_libmerged	2341173	2341177		mepM	4
Gok2_libmerged	2343284	2343321		pyk	37
Gok2_libmerged	2343532	2343559		pyk	27
Gok2_libmerged	2344130	2344203		pyk	73
Gok2_libmerged	2345067	2345140		YPO_RS11325	73
Gok2_libmerged	2345364	2345393		YPO_RS11325	29
Gok2_libmerged	2346040	2346047		zwf	7
Gok2_libmerged	2346611	2346640		zwf	29
Gok2_libmerged	2346744	2346759		zwf	15
Gok2_libmerged	2347069	2347073		zwf	4
Gok2_libmerged	2349068	2349102		mdtJ	34
Gok2_libmerged	2349269	2349280		mdtJ	11
Gok2_libmerged	2349448	2349481		mdtJ	33
Gok2_libmerged	2349632	2349639		mdtI	7
Gok2_libmerged	2349958	2349970		YPO_RS11350	12
Gok2_libmerged	2350231	2350294		YPO_RS11350	63
Gok2_libmerged	2350695	2350700		YPO_RS11355	5
Gok2_libmerged	2350778	2350787		YPO_RS11355	9
Gok2_libmerged	2350937	2350940		YPO_RS11355	3
Gok2_libmerged	2351025	2351059		YPO_RS11355	34
Gok2_libmerged	2352011	2352047		YPO_RS11355	36
Gok2_libmerged	2352199	2352252		YPO_RS11355	53
Gok2_libmerged	2353244	2353250		YPO_RS11365	6
Gok2_libmerged	2354696	2354797		fadD	101
Gok2_libmerged	2355051	2355058		fadD	7
Gok2_libmerged	2355136	2355159		fadD	23
Gok2_libmerged	2355443	2355596		fadD	153
Gok2_libmerged	2356066	2356069		fadD	3
Gok2_libmerged	2356649	2356681		rnd	32
Gok2_libmerged	2357229	2357249		rnd	20
Gok2_libmerged	2357442	2357461		rnd	19
Gok2_libmerged	2357698	2357723		minE	25
Gok2_libmerged	2357773	2357801		minE	28
Gok2_libmerged	2358317	2358358		minD	41
Gok2_libmerged	2358525	2358601		minD	76
Gok2_libmerged	2358704	2358707		minD	3
Gok2_libmerged	2358773	2358783		minD	10
Gok2_libmerged	2358808	2358843		minC	35
Gok2_libmerged	2359008	2359053		minC	45
Gok2_libmerged	2361031	2361042		YPO_RS11405	11
Gok2_libmerged	2361088	2361094		YPO_RS11405	6
Gok2_libmerged	2361196	2361205		YPO_RS11405	9
Gok2_libmerged	2361331	2361401		YPO_RS11405	70
Gok2_libmerged	2361804	2361817		YPO_RS11410	13
Gok2_libmerged	2361875	2361898		YPO_RS11410	23
Gok2_libmerged	2362289	2362333		YPO_RS11410	44
Gok2_libmerged	2362375	2362404		YPO_RS11410	29
Gok2_libmerged	2363016	2363061		YPO_RS11420	45
Gok2_libmerged	2363100	2363133		YPO_RS11420	33
Gok2_libmerged	2363214	2363217		YPO_RS11420	3
Gok2_libmerged	2363407	2363415		YPO_RS11420	8
Gok2_libmerged	2363933	2364019		YPO_RS11420	86
Gok2_libmerged	2364105	2364123		YPO_RS11420	18
Gok2_libmerged	2364324	2364357		YPO_RS11425	33
Gok2_libmerged	2364456	2364476		YPO_RS11425	20
Gok2_libmerged	2364521	2364529		YPO_RS11425	8
Gok2_libmerged	2364736	2364767		YPO_RS11425	31
Gok2_libmerged	2365072	2365074		YPO_RS11425	2
Gok2_libmerged	2365226	2365258		YPO_RS11425	32
Gok2_libmerged	2365343	2365346		YPO_RS11425	3
Gok2_libmerged	2365346	2365368		YPO_RS11430	22
Gok2_libmerged	2366378	2366457		YPO_RS11435	79
Gok2_libmerged	2366854	2366865		YPO_RS11440	11
Gok2_libmerged	2367059	2367125		YPO_RS11440	66
Gok2_libmerged	2367367	2367393		YPO_RS11440	26
Gok2_libmerged	2367601	2367602		YPO_RS11440	1
Gok2_libmerged	2367601	2367653		YPO_RS11445	52
Gok2_libmerged	2368098	2368166		YPO_RS11450	68
Gok2_libmerged	2368333	2368337		YPO_RS11450	4
Gok2_libmerged	2368523	2368542		YPO_RS11450	19
Gok2_libmerged	2368572	2368614		YPO_RS11450	42
Gok2_libmerged	2368804	2368808		YPO_RS11455	4
Gok2_libmerged	2368869	2368875		YPO_RS11455	6
Gok2_libmerged	2368970	2368997		YPO_RS11455	27
Gok2_libmerged	2369232	2369234		YPO_RS11460	2
Gok2_libmerged	2370695	2370747		YPO_RS11475	52
Gok2_libmerged	2370829	2370832		YPO_RS11475	3
Gok2_libmerged	2371202	2371228		YPO_RS11480	26
Gok2_libmerged	2371327	2371332		YPO_RS11485	5
Gok2_libmerged	2371566	2371573		YPO_RS11485	7
Gok2_libmerged	2371687	2371734		YPO_RS11485	47
Gok2_libmerged	2372152	2372171		YPO_RS11490	19
Gok2_libmerged	2372220	2372232		YPO_RS11490	12
Gok2_libmerged	2373429	2373461		YPO_RS11495	32
Gok2_libmerged	2374727	2374741		YPO_RS11505	14
Gok2_libmerged	2375004	2375070		YPO_RS11505	66
Gok2_libmerged	2375181	2375187		YPO_RS11510	6
Gok2_libmerged	2375308	2375329		YPO_RS11510	21
Gok2_libmerged	2375630	2375680		YPO_RS11510	50
Gok2_libmerged	2376145	2376239		YPO_RS11515	94
Gok2_libmerged	2376334	2376356		YPO_RS11515	22
Gok2_libmerged	2376702	2376785		YPO_RS11515	83
Gok2_libmerged	2376949	2377009		YPO_RS11520	60
Gok2_libmerged	2377469	2377522		YPO_RS11520	53
Gok2_libmerged	2377637	2377690		YPO_RS11520	53
Gok2_libmerged	2377879	2377911		YPO_RS11520	32
Gok2_libmerged	2377958	2378021		YPO_RS11525	63
Gok2_libmerged	2378174	2378217		YPO_RS11525	43
Gok2_libmerged	2378662	2378671		YPO_RS11530	9
Gok2_libmerged	2378794	2378802		YPO_RS11530	8
Gok2_libmerged	2378865	2378873		YPO_RS11530	8
Gok2_libmerged	2379637	2379687		YPO_RS11535	50
Gok2_libmerged	2379810	2379854		YPO_RS11535	44
Gok2_libmerged	2380068	2380162		YPO_RS11535	94
Gok2_libmerged	2380232	2380241		YPO_RS11535	9
Gok2_libmerged	2380569	2380600		YPO_RS11540	31
Gok2_libmerged	2380884	2380912		YPO_RS11540	28
Gok2_libmerged	2381154	2381165		YPO_RS11540	11
Gok2_libmerged	2381247	2381248		YPO_RS11540	1
Gok2_libmerged	2381325	2381341		YPO_RS11545	16
Gok2_libmerged	2381418	2381431		YPO_RS11545	13
Gok2_libmerged	2381722	2381820		YPO_RS11545	98
Gok2_libmerged	2382272	2382281		YPO_RS11545	9
Gok2_libmerged	2382806	2382874		YPO_RS11550	68
Gok2_libmerged	2383095	2383122		YPO_RS11555	27
Gok2_libmerged	2383560	2383598		YPO_RS11560	38
Gok2_libmerged	2383700	2383757		YPO_RS11565	57
Gok2_libmerged	2384073	2384086		YPO_RS11565	13
Gok2_libmerged	2384216	2384222		YPO_RS11565	6
Gok2_libmerged	2384338	2384356		YPO_RS11570	18
Gok2_libmerged	2384426	2384437		YPO_RS11570	11
Gok2_libmerged	2384571	2384653		YPO_RS11570	82
Gok2_libmerged	2385050	2385064		YPO_RS11575	14
Gok2_libmerged	2385213	2385240		YPO_RS11575	27
Gok2_libmerged	2385311	2385325		YPO_RS11575	14
Gok2_libmerged	2385652	2385657		YPO_RS11580	5
Gok2_libmerged	2386108	2386144		YPO_RS11585	36
Gok2_libmerged	2386485	2386503		YPO_RS11590	18
Gok2_libmerged	2387331	2387360		YPO_RS11590	29
Gok2_libmerged	2387510	2387743		YPO_RS11590	233
Gok2_libmerged	2388180	2388182		YPO_RS11590	2
Gok2_libmerged	2388242	2388299		YPO_RS11590	57
Gok2_libmerged	2388482	2388521		YPO_RS11590	39
Gok2_libmerged	2388622	2388633		YPO_RS11590	11
Gok2_libmerged	2388729	2388751		YPO_RS11590	22
Gok2_libmerged	2388914	2388916		YPO_RS11590	2
Gok2_libmerged	2389589	2389599		YPO_RS11590	10
Gok2_libmerged	2390016	2390021		YPO_RS11595	5
Gok2_libmerged	2390469	2390477		YPO_RS11600	8
Gok2_libmerged	2390655	2390656		YPO_RS11600	1
Gok2_libmerged	2390750	2390846		YPO_RS11600	96
Gok2_libmerged	2391067	2391138		YPO_RS11605	71
Gok2_libmerged	2391359	2391370		YPO_RS11605	11
Gok2_libmerged	2391731	2391733		YPO_RS11605	2
Gok2_libmerged	2391895	2391918		YPO_RS11610	23
Gok2_libmerged	2392802	2392843		YPO_RS11615	41
Gok2_libmerged	2393258	2393281		YPO_RS11615	23
Gok2_libmerged	2393465	2393467		YPO_RS11620	2
Gok2_libmerged	2393995	2394000		YPO_RS11625	5
Gok2_libmerged	2394071	2394113		YPO_RS11625	42
Gok2_libmerged	2394247	2394331		YPO_RS11630	84
Gok2_libmerged	2394434	2394439		YPO_RS11630	5
Gok2_libmerged	2394663	2394685		YPO_RS11630	22
Gok2_libmerged	2394990	2395012		YPO_RS11630	22
Gok2_libmerged	2395170	2395175		YPO_RS11630	5
Gok2_libmerged	2395240	2395243		YPO_RS11630	3
Gok2_libmerged	2395342	2395400		YPO_RS11635	58
Gok2_libmerged	2395495	2395512		YPO_RS11635	17
Gok2_libmerged	2395671	2395808		YPO_RS11635	137
Gok2_libmerged	2395888	2395893		YPO_RS11635	5
Gok2_libmerged	2396149	2396248		YPO_RS11640	99
Gok2_libmerged	2396307	2396353		YPO_RS11645	46
Gok2_libmerged	2396632	2396685		YPO_RS11645	53
Gok2_libmerged	2397160	2397198		YPO_RS11655	38
Gok2_libmerged	2397647	2397707		YPO_RS11660	60
Gok2_libmerged	2397962	2397964		YPO_RS11660	2
Gok2_libmerged	2398299	2398356		YPO_RS11660	57
Gok2_libmerged	2398427	2398446		YPO_RS11660	19
Gok2_libmerged	2398590	2398592		YPO_RS11660	2
Gok2_libmerged	2398890	2398898		YPO_RS11660	8
Gok2_libmerged	2399218	2399257		YPO_RS11660	39
Gok2_libmerged	2399343	2399378		YPO_RS11660	35
Gok2_libmerged	2399525	2399541		YPO_RS11660	16
Gok2_libmerged	2400210	2400236		YPO_RS11660	26
Gok2_libmerged	2400421	2400581		YPO_RS11660	160
Gok2_libmerged	2400719	2400748		YPO_RS11665	29
Gok2_libmerged	2400873	2400884		YPO_RS11665	11
Gok2_libmerged	2401017	2401048		YPO_RS11665	31
Gok2_libmerged	2401161	2401215		YPO_RS11665	54
Gok2_libmerged	2401407	2401434		YPO_RS11665	27
Gok2_libmerged	2401542	2401575		YPO_RS11665	33
Gok2_libmerged	2401632	2401694		YPO_RS11665	62
Gok2_libmerged	2401834	2401998		YPO_RS11670	164
Gok2_libmerged	2402065	2402124		YPO_RS11670	59
Gok2_libmerged	2402375	2402394		YPO_RS11670	19
Gok2_libmerged	2402800	2402804		YPO_RS11675	4
Gok2_libmerged	2402886	2402906		YPO_RS11675	20
Gok2_libmerged	2403375	2403433		YPO_RS11680	58
Gok2_libmerged	2403694	2403704		YPO_RS11680	10
Gok2_libmerged	2403984	2404009		YPO_RS11680	25
Gok2_libmerged	2404898	2404914		YPO_RS11685	16
Gok2_libmerged	2405112	2405137		YPO_RS11685	25
Gok2_libmerged	2405309	2405314		YPO_RS11685	5
Gok2_libmerged	2405522	2405529		YPO_RS11685	7
Gok2_libmerged	2405664	2405713		YPO_RS11685	49
Gok2_libmerged	2405869	2405874		YPO_RS11685	5
Gok2_libmerged	2405996	2406013		YPO_RS11690	17
Gok2_libmerged	2406128	2406149		YPO_RS11690	21
Gok2_libmerged	2406360	2406362		YPO_RS11690	2
Gok2_libmerged	2406528	2406536		YPO_RS11690	8
Gok2_libmerged	2406897	2406931		YPO_RS11690	34
Gok2_libmerged	2407068	2407126		YPO_RS11690	58
Gok2_libmerged	2407340	2407360		YPO_RS11695	20
Gok2_libmerged	2407443	2407454		YPO_RS11695	11
Gok2_libmerged	2407909	2407930		YPO_RS11695	21
Gok2_libmerged	2409146	2409245		YPO_RS11700	99
Gok2_libmerged	2409326	2409336		YPO_RS11700	10
Gok2_libmerged	2409867	2409948		dsbB	81
Gok2_libmerged	2410055	2410072		dsbB	17
Gok2_libmerged	2410582	2410613		nhaB	31
Gok2_libmerged	2410705	2410720		nhaB	15
Gok2_libmerged	2410884	2410907		nhaB	23
Gok2_libmerged	2411197	2411258		nhaB	61
Gok2_libmerged	2411630	2411632		nhaB	2
Gok2_libmerged	2412035	2412038		nhaB	3
Gok2_libmerged	2412107	2412135		nhaB	28
Gok2_libmerged	2412949	2412964		fadR	15
Gok2_libmerged	2413395	2413422		YPO_RS11720	27
Gok2_libmerged	2413739	2413805		YPO_RS11720	66
Gok2_libmerged	2414160	2414191		YPO_RS11720	31
Gok2_libmerged	2414390	2414397		YPO_RS11720	7
Gok2_libmerged	2414486	2414571		YPO_RS11720	85
Gok2_libmerged	2414623	2414709		YPO_RS11720	86
Gok2_libmerged	2414751	2414787		YPO_RS11720	36
Gok2_libmerged	2415316	2415388		YPO_RS11725	72
Gok2_libmerged	2415684	2415727		YPO_RS11725	43
Gok2_libmerged	2415896	2415925		YPO_RS11725	29
Gok2_libmerged	2415988	2416037		YPO_RS11725	49
Gok2_libmerged	2416421	2416425		YPO_RS11725	4
Gok2_libmerged	2416589	2416620		YPO_RS11725	31
Gok2_libmerged	2416663	2416664		YPO_RS11730	1
Gok2_libmerged	2416713	2416722		YPO_RS11730	9
Gok2_libmerged	2417039	2417113		YPO_RS11730	74
Gok2_libmerged	2417145	2417163		YPO_RS11730	18
Gok2_libmerged	2417633	2417653		YPO_RS11730	20
Gok2_libmerged	2418280	2418289		YPO_RS11735	9
Gok2_libmerged	2418343	2418355		YPO_RS11735	12
Gok2_libmerged	2418415	2418509		YPO_RS11735	94
Gok2_libmerged	2418610	2418683		YPO_RS11735	73
Gok2_libmerged	2418866	2418960		YPO_RS11735	94
Gok2_libmerged	2419170	2419180		YPO_RS11740	10
Gok2_libmerged	2419568	2419578		YPO_RS11740	10
Gok2_libmerged	2419676	2419711		YPO_RS11740	35
Gok2_libmerged	2419809	2419846		YPO_RS11740	37
Gok2_libmerged	2419898	2419974		YPO_RS11740	76
Gok2_libmerged	2420173	2420234		YPO_RS11745	61
Gok2_libmerged	2420707	2420710		YPO_RS11745	3
Gok2_libmerged	2421043	2421053		YPO_RS11745	10
Gok2_libmerged	2421132	2421163		YPO_RS11745	31
Gok2_libmerged	2421887	2421924		YPO_RS11750	37
Gok2_libmerged	2422269	2422280		YPO_RS11750	11
Gok2_libmerged	2422760	2422798		yeaG	38
Gok2_libmerged	2422887	2422896		yeaG	9
Gok2_libmerged	2423093	2423112		yeaG	19
Gok2_libmerged	2423182	2423348		yeaG	166
Gok2_libmerged	2423489	2423559		yeaG	70
Gok2_libmerged	2424081	2424104		yeaG	23
Gok2_libmerged	2424517	2424544		yeaG	27
Gok2_libmerged	2425650	2425652		YPO_RS11760	2
Gok2_libmerged	2426048	2426074		YPO_RS11765	26
Gok2_libmerged	2426141	2426147		YPO_RS11765	6
Gok2_libmerged	2426341	2426359		YPO_RS11765	18
Gok2_libmerged	2426460	2426473		YPO_RS11765	13
Gok2_libmerged	2426669	2426689		YPO_RS11765	20
Gok2_libmerged	2427149	2427178		gapA	29
Gok2_libmerged	2427610	2427620		gapA	10
Gok2_libmerged	2428748	2428768		msrB	20
Gok2_libmerged	2428816	2428877		msrB	61
Gok2_libmerged	2429148	2429162		YPO_RS11780	14
Gok2_libmerged	2429508	2429529		pncA	21
Gok2_libmerged	2430404	2430405		ansA	1
Gok2_libmerged	2430654	2430684		ansA	30
Gok2_libmerged	2431637	2431690		sppA	53
Gok2_libmerged	2432098	2432101		sppA	3
Gok2_libmerged	2432287	2432309		sppA	22
Gok2_libmerged	2432449	2432489		sppA	40
Gok2_libmerged	2432657	2432665		sppA	8
Gok2_libmerged	2432742	2432751		sppA	9
Gok2_libmerged	2432833	2432899		sppA	66
Gok2_libmerged	2433020	2433027		sppA	7
Gok2_libmerged	2433237	2433239		YPO_RS11800	2
Gok2_libmerged	2434077	2434117		selD	40
Gok2_libmerged	2434760	2434774		selD	14
Gok2_libmerged	2435141	2435200		YPO_RS11810	59
Gok2_libmerged	2435283	2435285		YPO_RS11810	2
Gok2_libmerged	2436405	2436455		YPO_RS11810	50
Gok2_libmerged	2436951	2436957		YPO_RS11810	6
Gok2_libmerged	2437080	2437082		YPO_RS11815	2
Gok2_libmerged	2437118	2437127		YPO_RS11815	9
Gok2_libmerged	2437636	2437663		YPO_RS11820	27
Gok2_libmerged	2437933	2437934		xthA	1
Gok2_libmerged	2438295	2438314		xthA	19
Gok2_libmerged	2438413	2438491		xthA	78
Gok2_libmerged	2438585	2438589		xthA	4
Gok2_libmerged	2439430	2439431		YPO_RS11830	1
Gok2_libmerged	2439580	2440190		YPO_RS11830	610
Gok2_libmerged	2440595	2440596		YPO_RS11840	1
Gok2_libmerged	2440694	2440721		YPO_RS11840	27
Gok2_libmerged	2441183	2441188		YPO_RS11850	5
Gok2_libmerged	2441564	2441600		YPO_RS11850	36
Gok2_libmerged	2441674	2441675		YPO_RS11850	1
Gok2_libmerged	2441797	2441840		YPO_RS11850	43
Gok2_libmerged	2442185	2442198		YPO_RS11850	13
Gok2_libmerged	2442312	2442339		YPO_RS11850	27
Gok2_libmerged	2442312	2442492		purU	180
Gok2_libmerged	2442622	2442685		purU	63
Gok2_libmerged	2442833	2442894		purU	61
Gok2_libmerged	2443066	2443171		purU	105
Gok2_libmerged	2443480	2443497		YPO_RS11860	17
Gok2_libmerged	2443529	2443536		YPO_RS11860	7
Gok2_libmerged	2445309	2445313		rssB	4
Gok2_libmerged	2445424	2445447		rssB	23
Gok2_libmerged	2445638	2445792		rssB	154
Gok2_libmerged	2445857	2445860		rssB	3
Gok2_libmerged	2446450	2446501		YPO_RS11870	51
Gok2_libmerged	2446594	2446670		YPO_RS11870	76
Gok2_libmerged	2446892	2446983		YPO_RS11870	91
Gok2_libmerged	2447110	2447114		YPO_RS11870	4
Gok2_libmerged	2447202	2447238		YPO_RS11870	36
Gok2_libmerged	2447316	2447368		YPO_RS11870	52
Gok2_libmerged	2447479	2447530		YPO_RS11870	51
Gok2_libmerged	2447595	2447651		YPO_RS11870	56
Gok2_libmerged	2448265	2448313		hns	48
Gok2_libmerged	2449468	2449482		YPO_RS11880	14
Gok2_libmerged	2449521	2449523		YPO_RS11880	2
Gok2_libmerged	2449784	2449820		YPO_RS11880	36
Gok2_libmerged	2450264	2450274		YPO_RS11885	10
Gok2_libmerged	2450575	2450604		YPO_RS11885	29
Gok2_libmerged	2450790	2450794		YPO_RS11885	4
Gok2_libmerged	2450897	2450900		YPO_RS11885	3
Gok2_libmerged	2451155	2451156		YPO_RS11890	1
Gok2_libmerged	2451340	2451346		YPO_RS11890	6
Gok2_libmerged	2451629	2451693		YPO_RS11890	64
Gok2_libmerged	2452060	2452065		YPO_RS11890	5
Gok2_libmerged	2453009	2453020		adhE	11
Gok2_libmerged	2453488	2453562		adhE	74
Gok2_libmerged	2454943	2455117		adhE	174
Gok2_libmerged	2456243	2456268		YPO_RS11900	25
Gok2_libmerged	2456587	2456591		YPO_RS11900	4
Gok2_libmerged	2456631	2456678		YPO_RS11900	47
Gok2_libmerged	2457743	2457812		oppA	69
Gok2_libmerged	2457914	2457939		oppA	25
Gok2_libmerged	2458215	2458311		oppA	96
Gok2_libmerged	2458401	2458572		oppA	171
Gok2_libmerged	2458744	2458748		oppA	4
Gok2_libmerged	2458795	2458818		oppA	23
Gok2_libmerged	2458864	2458874		oppA	10
Gok2_libmerged	2458946	2458958		oppA	12
Gok2_libmerged	2459464	2459485		oppB	21
Gok2_libmerged	2459801	2459853		oppB	52
Gok2_libmerged	2460004	2460024		oppB	20
Gok2_libmerged	2460142	2460191		oppB	49
Gok2_libmerged	2460263	2460275		oppC	12
Gok2_libmerged	2460436	2460443		oppC	7
Gok2_libmerged	2460484	2460492		oppC	8
Gok2_libmerged	2460763	2460792		oppC	29
Gok2_libmerged	2460920	2460995		oppC	75
Gok2_libmerged	2461149	2461218		YPO_RS11920	69
Gok2_libmerged	2461622	2461652		YPO_RS11920	30
Gok2_libmerged	2461758	2461936		YPO_RS11920	178
Gok2_libmerged	2462200	2462245		YPO_RS11925	45
Gok2_libmerged	2462341	2462352		YPO_RS11925	11
Gok2_libmerged	2462640	2462687		YPO_RS11925	47
Gok2_libmerged	2462741	2462745		YPO_RS11925	4
Gok2_libmerged	2462807	2462835		YPO_RS11925	28
Gok2_libmerged	2462882	2462897		YPO_RS11925	15
Gok2_libmerged	2463022	2463032		YPO_RS11925	10
Gok2_libmerged	2463709	2463803		YPO_RS11930	94
Gok2_libmerged	2464883	2464912		cls	29
Gok2_libmerged	2465077	2465128		cls	51
Gok2_libmerged	2465211	2465267		cls	56
Gok2_libmerged	2465324	2465331		cls	7
Gok2_libmerged	2465555	2465585		cls	30
Gok2_libmerged	2465712	2465830		cls	118
Gok2_libmerged	2466725	2466728		YPO_RS11945	3
Gok2_libmerged	2467212	2467282		YPO_RS11950	70
Gok2_libmerged	2467341	2467349		YPO_RS11950	8
Gok2_libmerged	2467456	2467574		YPO_RS11950	118
Gok2_libmerged	2468350	2468412		YPO_RS11960	62
Gok2_libmerged	2468818	2468859		YPO_RS11965	41
Gok2_libmerged	2469079	2469114		YPO_RS11965	35
Gok2_libmerged	2469415	2469433		tonB	18
Gok2_libmerged	2470004	2470042		tonB	38
Gok2_libmerged	2470634	2470635		YPO_RS11975	1
Gok2_libmerged	2470947	2470990		YPO_RS11975	43
Gok2_libmerged	2471325	2471350		YPO_RS11975	25
Gok2_libmerged	2472332	2472374		YPO_RS11985	42
Gok2_libmerged	2472500	2472505		YPO_RS11985	5
Gok2_libmerged	2472633	2472636		YPO_RS11985	3
Gok2_libmerged	2473578	2473605		YPO_RS11990	27
Gok2_libmerged	2473726	2473745		YPO_RS11990	19
Gok2_libmerged	2474168	2474235		YPO_RS11995	67
Gok2_libmerged	2474722	2474762		YPO_RS12000	40
Gok2_libmerged	2474869	2474945		YPO_RS12000	76
Gok2_libmerged	2475071	2475098		YPO_RS12000	27
Gok2_libmerged	2475213	2475239		YPO_RS12000	26
Gok2_libmerged	2475482	2475487		YPO_RS12000	5
Gok2_libmerged	2475654	2475671		YPO_RS12005	17
Gok2_libmerged	2475778	2475859		YPO_RS12005	81
Gok2_libmerged	2476510	2476515		ompW	5
Gok2_libmerged	2477658	2477666		trpA	8
Gok2_libmerged	2477848	2478000		trpA	152
Gok2_libmerged	2478574	2478598		trpB	24
Gok2_libmerged	2478664	2478721		trpB	57
Gok2_libmerged	2478838	2478859		trpB	21
Gok2_libmerged	2479038	2479041		trpB	3
Gok2_libmerged	2479368	2479413		trpB	45
Gok2_libmerged	2479613	2479627		trpCF	14
Gok2_libmerged	2480747	2480786		trpCF	39
Gok2_libmerged	2481347	2481349		trpD	2
Gok2_libmerged	2481450	2481478		trpD	28
Gok2_libmerged	2481865	2481868		trpD	3
Gok2_libmerged	2481933	2481999		trpD	66
Gok2_libmerged	2482170	2482185		YPO_RS12040	15
Gok2_libmerged	2482239	2482247		YPO_RS12040	8
Gok2_libmerged	2482516	2482543		YPO_RS12040	27
Gok2_libmerged	2482789	2482828		YPO_RS12045	39
Gok2_libmerged	2483115	2483119		YPO_RS12045	4
Gok2_libmerged	2483764	2483793		YPO_RS12045	29
Gok2_libmerged	2484273	2484296		trpL	23
Gok2_libmerged	2484854	2484861		YPO_RS12055	7
Gok2_libmerged	2484892	2484900		YPO_RS12055	8
Gok2_libmerged	2484954	2484991		YPO_RS12055	37
Gok2_libmerged	2485269	2485270		YPO_RS12055	1
Gok2_libmerged	2485573	2485608		YPO_RS12060	35
Gok2_libmerged	2485720	2485821		YPO_RS12060	101
Gok2_libmerged	2486690	2486774		rluB	84
Gok2_libmerged	2487017	2487066		rluB	49
Gok2_libmerged	2487649	2487655		cobO	6
Gok2_libmerged	2488256	2488267		YPO_RS12075	11
Gok2_libmerged	2488361	2488369		YPO_RS12075	8
Gok2_libmerged	2488541	2488556		YPO_RS12075	15
Gok2_libmerged	2488603	2488662		YPO_RS12075	59
Gok2_libmerged	2488700	2488766		YPO_RS12075	66
Gok2_libmerged	2489331	2489340		sohB	9
Gok2_libmerged	2489517	2489525		sohB	8
Gok2_libmerged	2490532	2490544		YPO_RS12085	12
Gok2_libmerged	2490354	2490369		YPO_RS12085	15
Gok2_libmerged	2490714	2490738		YPO_RS12090	24
Gok2_libmerged	2491031	2491063		topA	32
Gok2_libmerged	2491216	2491257		topA	41
Gok2_libmerged	2491516	2491560		topA	44
Gok2_libmerged	2491730	2491773		topA	43
Gok2_libmerged	2492048	2492076		topA	28
Gok2_libmerged	2492121	2492147		topA	26
Gok2_libmerged	2492801	2492807		topA	6
Gok2_libmerged	2492872	2492955		topA	83
Gok2_libmerged	2492990	2493030		topA	40
Gok2_libmerged	2493512	2493587		topA	75
Gok2_libmerged	2494095	2494129		cysB	34
Gok2_libmerged	2494241	2494337		cysB	96
Gok2_libmerged	2494762	2494767		cysB	5
Gok2_libmerged	2494884	2494889		cysB	5
Gok2_libmerged	2495346	2495496		YPO_RS12105	150
Gok2_libmerged	2495649	2495656		YPO_RS12105	7
Gok2_libmerged	2495770	2495815		YPO_RS12105	45
Gok2_libmerged	2495879	2496067		YPO_RS12105	188
Gok2_libmerged	2496184	2496195		YPO_RS12105	11
Gok2_libmerged	2497232	2497305		acnA	73
Gok2_libmerged	2497648	2497698		acnA	50
Gok2_libmerged	2497876	2497894		acnA	18
Gok2_libmerged	2498109	2498142		acnA	33
Gok2_libmerged	2498736	2498777		acnA	41
Gok2_libmerged	2498903	2498993		acnA	90
Gok2_libmerged	2499087	2499096		acnA	9
Gok2_libmerged	2499403	2499410		ribA	7
Gok2_libmerged	2499983	2499993		ribA	10
Gok2_libmerged	2500599	2500612		pgpB	13
Gok2_libmerged	2503156	2503184		YPO_RS12135	28
Gok2_libmerged	2504062	2504063		pyrF	1
Gok2_libmerged	2504405	2504458		pyrF	53
Gok2_libmerged	2504679	2504703		yciH	24
Gok2_libmerged	2505145	2505186		osmB	41
Gok2_libmerged	2506172	2506219		araD	47
Gok2_libmerged	2506585	2506612		YPO_RS12160	27
Gok2_libmerged	2506765	2506775		YPO_RS12160	10
Gok2_libmerged	2508434	2508449		YPO_RS12175	15
Gok2_libmerged	2508497	2508517		YPO_RS12175	20
Gok2_libmerged	2508836	2508845		YPO_RS12175	9
Gok2_libmerged	2509215	2509219		YPO_RS12175	4
Gok2_libmerged	2509366	2509381		YPO_RS12175	15
Gok2_libmerged	2509598	2509624		YPO_RS12175	26
Gok2_libmerged	2509986	2510006		YPO_RS12175	20
Gok2_libmerged	2510140	2510189		YPO_RS12175	49
Gok2_libmerged	2510657	2510699		YPO_RS12180	42
Gok2_libmerged	2510989	2511015		YPO_RS12180	26
Gok2_libmerged	2511357	2511393		YPO_RS12180	36
Gok2_libmerged	2511675	2511690		YPO_RS12180	15
Gok2_libmerged	2512428	2512436		YPO_RS12180	8
Gok2_libmerged	2513288	2513319		YPO_RS12185	31
Gok2_libmerged	2513421	2513446		YPO_RS12185	25
Gok2_libmerged	2514168	2514273		YPO_RS12185	105
Gok2_libmerged	2514382	2514383		YPO_RS12185	1
Gok2_libmerged	2514695	2514701		YPO_RS12190	6
Gok2_libmerged	2515132	2515201		YPO_RS12190	69
Gok2_libmerged	2515369	2515373		YPO_RS12190	4
Gok2_libmerged	2515430	2515466		YPO_RS12190	36
Gok2_libmerged	2515811	2515813		nth	2
Gok2_libmerged	2515928	2515939		nth	11
Gok2_libmerged	2516108	2516177		nth	69
Gok2_libmerged	2516637	2516656		YPO_RS12200	19
Gok2_libmerged	2516787	2516821		YPO_RS12200	34
Gok2_libmerged	2516966	2516970		YPO_RS12200	4
Gok2_libmerged	2517112	2517168		rsxG	56
Gok2_libmerged	2517408	2517436		rsxG	28
Gok2_libmerged	2517921	2517932		rsxD	11
Gok2_libmerged	2518263	2518302		rsxD	39
Gok2_libmerged	2518405	2518475		rsxD	70
Gok2_libmerged	2519275	2519371		YPO_RS12215	96
Gok2_libmerged	2519485	2519490		YPO_RS12215	5
Gok2_libmerged	2519863	2520045		YPO_RS12215	182
Gok2_libmerged	2520804	2520825		rsxC	21
Gok2_libmerged	2521096	2521172		rsxC	76
Gok2_libmerged	2521831	2521834		rsxC	3
Gok2_libmerged	2522273	2522421		rsxB	148
Gok2_libmerged	2522825	2522839		rsxA	14
Gok2_libmerged	2522937	2522953		rsxA	16
Gok2_libmerged	2523485	2523511		YPO_RS12235	26
Gok2_libmerged	2526591	2526660		YPO_RS12245	69
Gok2_libmerged	2527450	2527451		YPO_RS12245	1
Gok2_libmerged	2527513	2527519		YPO_RS12250	6
Gok2_libmerged	2527976	2527981		YPO_RS12255	5
Gok2_libmerged	2528363	2528447		YPO_RS12255	84
Gok2_libmerged	2528518	2528622		YPO_RS12255	104
Gok2_libmerged	2528695	2528701		YPO_RS12255	6
Gok2_libmerged	2528960	2528978		YPO_RS12255	18
Gok2_libmerged	2529127	2529144		YPO_RS12255	17
Gok2_libmerged	2529399	2529403		YPO_RS12255	4
Gok2_libmerged	2529832	2529861		YPO_RS12255	29
Gok2_libmerged	2530160	2530177		araA	17
Gok2_libmerged	2530314	2530351		araA	37
Gok2_libmerged	2530610	2530645		araA	35
Gok2_libmerged	2531401	2531444		araA	43
Gok2_libmerged	2531598	2531606		araA	8
Gok2_libmerged	2531800	2531803		YPO_RS12265	3
Gok2_libmerged	2531867	2531897		YPO_RS12265	30
Gok2_libmerged	2531952	2532026		YPO_RS12265	74
Gok2_libmerged	2532141	2532198		YPO_RS12265	57
Gok2_libmerged	2532408	2532430		YPO_RS12265	22
Gok2_libmerged	2532937	2532939		YPO_RS12265	2
Gok2_libmerged	2533071	2533090		YPO_RS12265	19
Gok2_libmerged	2533169	2533181		YPO_RS12265	12
Gok2_libmerged	2534009	2534030		YPO_RS12270	21
Gok2_libmerged	2534686	2534754		YPO_RS12270	68
Gok2_libmerged	2535118	2535137		YPO_RS12275	19
Gok2_libmerged	2535195	2535213		YPO_RS12275	18
Gok2_libmerged	2535599	2535659		YPO_RS12275	60
Gok2_libmerged	2535776	2535877		YPO_RS12275	101
Gok2_libmerged	2536151	2536160		YPO_RS12275	9
Gok2_libmerged	2536217	2536225		YPO_RS12275	8
Gok2_libmerged	2536288	2536326		YPO_RS12275	38
Gok2_libmerged	2536384	2536386		YPO_RS12275	2
Gok2_libmerged	2536708	2536730		YPO_RS12280	22
Gok2_libmerged	2537055	2537071		YPO_RS12280	16
Gok2_libmerged	2537114	2537162		YPO_RS12280	48
Gok2_libmerged	2537208	2537215		YPO_RS12280	7
Gok2_libmerged	2537419	2537521		YPO_RS12280	102
Gok2_libmerged	2537563	2537576		YPO_RS12280	13
Gok2_libmerged	2537912	2537913		araC	1
Gok2_libmerged	2538064	2538084		araC	20
Gok2_libmerged	2538153	2538172		araC	19
Gok2_libmerged	2538454	2538460		araC	6
Gok2_libmerged	2538712	2538718		araC	6
Gok2_libmerged	2538857	2538860		YPO_RS12290	3
Gok2_libmerged	2538950	2538957		YPO_RS12290	7
Gok2_libmerged	2539125	2539130		YPO_RS12290	5
Gok2_libmerged	2539416	2539422		YPO_RS12290	6
Gok2_libmerged	2540100	2540118		YPO_RS12295	18
Gok2_libmerged	2540257	2540274		YPO_RS12295	17
Gok2_libmerged	2540349	2540420		YPO_RS12295	71
Gok2_libmerged	2540531	2540547		YPO_RS12295	16
Gok2_libmerged	2540834	2540835		YPO_RS12295	1
Gok2_libmerged	2541334	2541374		YPO_RS12300	40
Gok2_libmerged	2541545	2541585		YPO_RS12300	40
Gok2_libmerged	2542564	2542591		YPO_RS12305	27
Gok2_libmerged	2542680	2542685		YPO_RS12305	5
Gok2_libmerged	2542806	2542828		YPO_RS12305	22
Gok2_libmerged	2542896	2542907		YPO_RS12305	11
Gok2_libmerged	2543043	2543066		YPO_RS12305	23
Gok2_libmerged	2543165	2543168		YPO_RS12305	3
Gok2_libmerged	2543829	2543968		manA	139
Gok2_libmerged	2544037	2544083		manA	46
Gok2_libmerged	2544129	2544192		manA	63
Gok2_libmerged	2544261	2544267		manA	6
Gok2_libmerged	2544542	2544566		manA	24
Gok2_libmerged	2544608	2544626		manA	18
Gok2_libmerged	2545616	2545640		fumC	24
Gok2_libmerged	2545996	2546010		fumC	14
Gok2_libmerged	2546100	2546126		fumC	26
Gok2_libmerged	2546475	2546503		fumC	28
Gok2_libmerged	2546599	2546617		fumC	18
Gok2_libmerged	2546789	2546790		YPO_RS12320	1
Gok2_libmerged	2546876	2546914		YPO_RS12320	38
Gok2_libmerged	2546981	2547017		YPO_RS12320	36
Gok2_libmerged	2547140	2547146		YPO_RS12320	6
Gok2_libmerged	2547249	2547316		YPO_RS12320	67
Gok2_libmerged	2547455	2547533		YPO_RS12320	78
Gok2_libmerged	2547656	2547676		YPO_RS12320	20
Gok2_libmerged	2548162	2548178		YPO_RS12325	16
Gok2_libmerged	2548249	2548251		YPO_RS12325	2
Gok2_libmerged	2548408	2548417		YPO_RS12325	9
Gok2_libmerged	2548637	2548643		YPO_RS12325	6
Gok2_libmerged	2548857	2548876		YPO_RS12325	19
Gok2_libmerged	2549481	2549512		YPO_RS12330	31
Gok2_libmerged	2549999	2550023		YPO_RS12335	24
Gok2_libmerged	2550507	2550513		YPO_RS12340	6
Gok2_libmerged	2550933	2550954		YPO_RS12340	21
Gok2_libmerged	2551490	2551553		YPO_RS12340	63
Gok2_libmerged	2551627	2551670		YPO_RS12340	43
Gok2_libmerged	2552076	2552145		bioD	69
Gok2_libmerged	2552310	2552361		bioD	51
Gok2_libmerged	2552535	2552562		bioD	27
Gok2_libmerged	2552747	2552757		clcB	10
Gok2_libmerged	2553176	2553181		clcB	5
Gok2_libmerged	2553385	2553390		clcB	5
Gok2_libmerged	2553617	2553620		clcB	3
Gok2_libmerged	2553971	2553983		clcB	12
Gok2_libmerged	2554373	2554633		YPO_RS12355	260
Gok2_libmerged	2554658	2555065		YPO_RS12360	407
Gok2_libmerged	2555162	2555608		YPO_RS12365	446
Gok2_libmerged	2555780	2556832		YPO_RS12370	1052
Gok2_libmerged	2556844	2557161		YPO_RS12375	317
Gok2_libmerged	2557164	2557415		YPO_RS12380	251
Gok2_libmerged	2557451	2557684		YPO_RS12385	233
Gok2_libmerged	2557749	2559461		YPO_RS12390	1712
Gok2_libmerged	2559474	2559761		YPO_RS12395	287
Gok2_libmerged	2559765	2560790		YPO_RS12400	1025
Gok2_libmerged	2560790	2562034		YPO_RS12405	1244
Gok2_libmerged	2562123	2562371		YPO_RS12410	248
Gok2_libmerged	2562568	2562765		YPO_RS12415	197
Gok2_libmerged	2563325	2563337		YPO_RS12420	12
Gok2_libmerged	2563568	2563643		YPO_RS12420	75
Gok2_libmerged	2563764	2563805		YPO_RS12420	41
Gok2_libmerged	2564061	2564089		YPO_RS12420	28
Gok2_libmerged	2564405	2564428		YPO_RS12425	23
Gok2_libmerged	2564505	2564557		YPO_RS12425	52
Gok2_libmerged	2564667	2564691		YPO_RS12425	24
Gok2_libmerged	2565808	2565839		YPO_RS12435	31
Gok2_libmerged	2565881	2565901		YPO_RS12435	20
Gok2_libmerged	2565957	2565976		YPO_RS12435	19
Gok2_libmerged	2566206	2566235		YPO_RS12435	29
Gok2_libmerged	2566390	2566396		YPO_RS12435	6
Gok2_libmerged	2566434	2566465		YPO_RS12435	31
Gok2_libmerged	2566767	2566839		YPO_RS12435	72
Gok2_libmerged	2566843	2566883		YPO_RS12440	40
Gok2_libmerged	2567321	2567363		YPO_RS12440	42
Gok2_libmerged	2567433	2567455		YPO_RS12440	22
Gok2_libmerged	2567542	2567588		YPO_RS12440	46
Gok2_libmerged	2567968	2568021		YPO_RS12445	53
Gok2_libmerged	2568166	2568224		YPO_RS12445	58
Gok2_libmerged	2568476	2568480		YPO_RS12445	4
Gok2_libmerged	2568581	2568582		YPO_RS12445	1
Gok2_libmerged	2568652	2568674		YPO_RS12445	22
Gok2_libmerged	2568908	2568938		YPO_RS12445	30
Gok2_libmerged	2569893	2569968		YPO_RS12450	75
Gok2_libmerged	2570139	2570150		YPO_RS12450	11
Gok2_libmerged	2571138	2571169		YPO_RS12450	31
Gok2_libmerged	2571247	2571269		YPO_RS12455	22
Gok2_libmerged	2571872	2571890		YPO_RS12455	18
Gok2_libmerged	2572230	2572244		YPO_RS12455	14
Gok2_libmerged	2572426	2572435		YPO_RS12455	9
Gok2_libmerged	2572609	2572625		YPO_RS12455	16
Gok2_libmerged	2572726	2572733		YPO_RS12455	7
Gok2_libmerged	2572830	2572866		YPO_RS12455	36
Gok2_libmerged	2573670	2573674		YPO_RS12455	4
Gok2_libmerged	2573927	2573954		YPO_RS12455	27
Gok2_libmerged	2574535	2574550		YPO_RS12460	15
Gok2_libmerged	2575150	2575165		YPO_RS12460	15
Gok2_libmerged	2575235	2575276		YPO_RS12460	41
Gok2_libmerged	2575490	2575497		YPO_RS12460	7
Gok2_libmerged	2575573	2575588		YPO_RS12460	15
Gok2_libmerged	2575754	2575796		YPO_RS12460	42
Gok2_libmerged	2575919	2575960		YPO_RS12460	41
Gok2_libmerged	2575994	2576053		YPO_RS12460	59
Gok2_libmerged	2576128	2576136		YPO_RS12460	8
Gok2_libmerged	2576401	2576407		YPO_RS12460	6
Gok2_libmerged	2576630	2576636		YPO_RS12460	6
Gok2_libmerged	2577048	2577050		YPO_RS12465	2
Gok2_libmerged	2577203	2577240		YPO_RS12465	37
Gok2_libmerged	2577332	2577350		YPO_RS12465	18
Gok2_libmerged	2577444	2577463		YPO_RS12465	19
Gok2_libmerged	2577569	2577584		YPO_RS12465	15
Gok2_libmerged	2577691	2577706		YPO_RS12465	15
Gok2_libmerged	2577805	2577810		YPO_RS12465	5
Gok2_libmerged	2578931	2578950		ilvB	19
Gok2_libmerged	2579774	2579801		ilvB	27
Gok2_libmerged	2580571	2580619		yjjG	48
Gok2_libmerged	2580991	2581030		yjjG	39
Gok2_libmerged	2581410	2581419		YPO_RS12490	9
Gok2_libmerged	2581698	2581732		YPO_RS12490	34
Gok2_libmerged	2581810	2581812		YPO_RS12490	2
Gok2_libmerged	2582176	2582190		YPO_RS12490	14
Gok2_libmerged	2582646	2582650		YPO_RS12495	4
Gok2_libmerged	2582837	2582848		YPO_RS12495	11
Gok2_libmerged	2582931	2582933		YPO_RS12495	2
Gok2_libmerged	2582966	2582978		YPO_RS12495	12
Gok2_libmerged	2583188	2583217		YPO_RS12495	29
Gok2_libmerged	2583498	2583529		YPO_RS12495	31
Gok2_libmerged	2584724	2584746		phoA	22
Gok2_libmerged	2585007	2585024		phoA	17
Gok2_libmerged	2585274	2585285		phoA	11
Gok2_libmerged	2585412	2585424		phoA	12
Gok2_libmerged	2585903	2585947		ogt	44
Gok2_libmerged	2586357	2586386		ogt	29
Gok2_libmerged	2586747	2586771		YPO_RS12510	24
Gok2_libmerged	2586901	2586932		YPO_RS12510	31
Gok2_libmerged	2587112	2587129		YPO_RS12510	17
Gok2_libmerged	2587478	2587483		uspE	5
Gok2_libmerged	2587562	2587624		uspE	62
Gok2_libmerged	2587717	2587741		uspE	24
Gok2_libmerged	2588831	2588834		pntB	3
Gok2_libmerged	2589751	2589766		pntB	15
Gok2_libmerged	2590295	2590300		pntA	5
Gok2_libmerged	2590509	2590605		pntA	96
Gok2_libmerged	2590651	2590683		pntA	32
Gok2_libmerged	2591557	2591570		pntA	13
Gok2_libmerged	2592371	2592422		YPO_RS12530	51
Gok2_libmerged	2592748	2592758		YPO_RS12530	10
Gok2_libmerged	2592932	2592934		YPO_RS12530	2
Gok2_libmerged	2594257	2594290		YPO_RS12535	33
Gok2_libmerged	2594899	2594927		YPO_RS12540	28
Gok2_libmerged	2594961	2594962		YPO_RS12540	1
Gok2_libmerged	2595451	2595468		rstA	17
Gok2_libmerged	2595639	2595666		rstA	27
Gok2_libmerged	2595960	2595987		rstA	27
Gok2_libmerged	2596115	2596168		rstA	53
Gok2_libmerged	2596415	2596424		rstB	9
Gok2_libmerged	2596501	2596541		rstB	40
Gok2_libmerged	2596754	2596774		rstB	20
Gok2_libmerged	2596986	2596991		rstB	5
Gok2_libmerged	2597343	2597353		rstB	10
Gok2_libmerged	2597451	2597453		rstB	2
Gok2_libmerged	2597596	2597598		YPO_RS12555	2
Gok2_libmerged	2598415	2598448		YPO_RS12555	33
Gok2_libmerged	2598827	2598846		YPO_RS12555	19
Gok2_libmerged	2599092	2599095		YPO_RS12555	3
Gok2_libmerged	2599247	2599253		YPO_RS12560	6
Gok2_libmerged	2599669	2599675		YPO_RS12560	6
Gok2_libmerged	2603732	2603747		YPO_RS12570	15
Gok2_libmerged	2604510	2604527		YPO_RS12575	17
Gok2_libmerged	2604580	2604582		YPO_RS12575	2
Gok2_libmerged	2604666	2604897		YPO_RS12575	231
Gok2_libmerged	2605090	2605112		YPO_RS12580	22
Gok2_libmerged	2606327	2606329		asr	2
Gok2_libmerged	2606381	2606388		asr	7
Gok2_libmerged	2606964	2606975		YPO_RS12590	11
Gok2_libmerged	2607073	2607085		YPO_RS12590	12
Gok2_libmerged	2607174	2607182		YPO_RS12590	8
Gok2_libmerged	2607727	2607762		YPO_RS12595	35
Gok2_libmerged	2607945	2607946		YPO_RS12595	1
Gok2_libmerged	2608043	2608050		YPO_RS12595	7
Gok2_libmerged	2608047	2608070		YPO_RS12600	23
Gok2_libmerged	2608988	2609023		hrpA	35
Gok2_libmerged	2609309	2609383		hrpA	74
Gok2_libmerged	2609840	2609920		hrpA	80
Gok2_libmerged	2609973	2610004		hrpA	31
Gok2_libmerged	2610431	2610450		hrpA	19
Gok2_libmerged	2610543	2610570		hrpA	27
Gok2_libmerged	2611477	2611514		hrpA	37
Gok2_libmerged	2611734	2611736		hrpA	2
Gok2_libmerged	2611897	2611910		hrpA	13
Gok2_libmerged	2612493	2612495		hrpA	2
Gok2_libmerged	2613505	2613507		azoR	2
Gok2_libmerged	2613609	2613630		azoR	21
Gok2_libmerged	2614267	2614289		YPO_RS12615	22
Gok2_libmerged	2614699	2614707		YPO_RS12615	8
Gok2_libmerged	2615147	2615151		YPO_RS12620	4
Gok2_libmerged	2615196	2615207		YPO_RS12620	11
Gok2_libmerged	2615694	2615755		YPO_RS12620	61
Gok2_libmerged	2615910	2615915		YPO_RS12620	5
Gok2_libmerged	2616164	2616195		YPO_RS12620	31
Gok2_libmerged	2616244	2616253		YPO_RS12620	9
Gok2_libmerged	2617692	2617693		YPO_RS12635	1
Gok2_libmerged	2617850	2617858		YPO_RS12635	8
Gok2_libmerged	2618917	2618960		YPO_RS12635	43
Gok2_libmerged	2619325	2619374		YPO_RS12635	49
Gok2_libmerged	2619619	2619628		YPO_RS12635	9
Gok2_libmerged	2620043	2620063		YPO_RS12640	20
Gok2_libmerged	2620484	2620524		YPO_RS12640	40
Gok2_libmerged	2620640	2620660		YPO_RS12640	20
Gok2_libmerged	2620806	2620817		YPO_RS12640	11
Gok2_libmerged	2620968	2620980		YPO_RS12640	12
Gok2_libmerged	2621105	2621150		hslJ	45
Gok2_libmerged	2621216	2621237		hslJ	21
Gok2_libmerged	2621303	2621329		hslJ	26
Gok2_libmerged	2621773	2621790		YPO_RS12650	17
Gok2_libmerged	2621844	2621884		YPO_RS12650	40
Gok2_libmerged	2622246	2622346		YPO_RS12655	100
Gok2_libmerged	2622685	2622770		YPO_RS12655	85
Gok2_libmerged	2622825	2622852		YPO_RS12655	27
Gok2_libmerged	2623146	2623199		YPO_RS12660	53
Gok2_libmerged	2623874	2623953		nifJ	79
Gok2_libmerged	2624114	2624143		nifJ	29
Gok2_libmerged	2624707	2624708		nifJ	1
Gok2_libmerged	2624902	2624940		nifJ	38
Gok2_libmerged	2624992	2624996		nifJ	4
Gok2_libmerged	2625751	2625782		nifJ	31
Gok2_libmerged	2625969	2625991		nifJ	22
Gok2_libmerged	2626178	2626186		nifJ	8
Gok2_libmerged	2626238	2626243		nifJ	5
Gok2_libmerged	2626303	2626351		nifJ	48
Gok2_libmerged	2626674	2626697		nifJ	23
Gok2_libmerged	2627169	2627191		nifJ	22
Gok2_libmerged	2627611	2627614		ttcA	3
Gok2_libmerged	2627837	2627901		ttcA	64
Gok2_libmerged	2628326	2628374		ttcA	48
Gok2_libmerged	2628976	2629027		YPO_RS12675	51
Gok2_libmerged	2629309	2629358		YPO_RS12675	49
Gok2_libmerged	2629427	2629481		YPO_RS12675	54
Gok2_libmerged	2629670	2629708		YPO_RS12675	38
Gok2_libmerged	2630107	2630113		YPO_RS12680	6
Gok2_libmerged	2630340	2630343		YPO_RS12680	3
Gok2_libmerged	2630492	2630531		YPO_RS12680	39
Gok2_libmerged	2630620	2630725		YPO_RS12680	105
Gok2_libmerged	2630800	2630825		YPO_RS12680	25
Gok2_libmerged	2630913	2630946		YPO_RS12680	33
Gok2_libmerged	2631391	2631419		zntB	28
Gok2_libmerged	2631479	2631520		zntB	41
Gok2_libmerged	2631713	2631722		zntB	9
Gok2_libmerged	2631962	2631970		zntB	8
Gok2_libmerged	2632233	2632235		zntB	2
Gok2_libmerged	2632546	2632566		YPO_RS12690	20
Gok2_libmerged	2632630	2632655		YPO_RS12690	25
Gok2_libmerged	2632775	2632790		YPO_RS12690	15
Gok2_libmerged	2633129	2633213		YPO_RS12690	84
Gok2_libmerged	2633294	2633346		YPO_RS12690	52
Gok2_libmerged	2633579	2633592		YPO_RS12690	13
Gok2_libmerged	2633649	2633657		YPO_RS12690	8
Gok2_libmerged	2633862	2633937		YPO_RS12690	75
Gok2_libmerged	2634603	2634634		mpaA	31
Gok2_libmerged	2634949	2634951		mpaA	2
Gok2_libmerged	2635362	2635399		ycjG	37
Gok2_libmerged	2635592	2635606		ycjG	14
Gok2_libmerged	2635819	2635830		ycjG	11
Gok2_libmerged	2636110	2636111		ycjG	1
Gok2_libmerged	2636267	2636269		ycjG	2
Gok2_libmerged	2636861	2636886		tpx	25
Gok2_libmerged	2636956	2636959		tpx	3
Gok2_libmerged	2637313	2637404		YPO_RS12710	91
Gok2_libmerged	2638080	2638157		tyrR	77
Gok2_libmerged	2638485	2638492		tyrR	7
Gok2_libmerged	2638951	2639021		tyrR	70
Gok2_libmerged	2639115	2639125		tyrR	10
Gok2_libmerged	2639239	2639339		tyrR	100
Gok2_libmerged	2639401	2639427		tyrR	26
Gok2_libmerged	2639883	2639914		YPO_RS12720	31
Gok2_libmerged	2640182	2640208		YPO_RS12720	26
Gok2_libmerged	2640342	2640409		YPO_RS12725	67
Gok2_libmerged	2640529	2640586		YPO_RS12725	57
Gok2_libmerged	2640838	2640842		YPO_RS12730	4
Gok2_libmerged	2640882	2640894		YPO_RS12730	12
Gok2_libmerged	2641260	2641261		YPO_RS12730	1
Gok2_libmerged	2641452	2641454		YPO_RS12730	2
Gok2_libmerged	2641575	2641578		YPO_RS12730	3
Gok2_libmerged	2641954	2642031		YPO_RS12735	77
Gok2_libmerged	2642216	2642249		YPO_RS12735	33
Gok2_libmerged	2642393	2642405		YPO_RS12735	12
Gok2_libmerged	2643178	2643186		YPO_RS12735	8
Gok2_libmerged	2643178	2643186		pspD	8
Gok2_libmerged	2643334	2643337		pspD	3
Gok2_libmerged	2643403	2643415		pspD	12
Gok2_libmerged	2643742	2643750		pspC	8
Gok2_libmerged	2643803	2643806		pspC	3
Gok2_libmerged	2643890	2643895		pspB	5
Gok2_libmerged	2643980	2643992		pspB	12
Gok2_libmerged	2644582	2644586		pspA	4
Gok2_libmerged	2644850	2644863		pspA	13
Gok2_libmerged	2645717	2645726		pspF	9
Gok2_libmerged	2645775	2645957		pspF	182
Gok2_libmerged	2646101	2646140		pspF	39
Gok2_libmerged	2646362	2646407		YPO_RS12765	45
Gok2_libmerged	2646631	2646678		YPO_RS12765	47
Gok2_libmerged	2646805	2646810		YPO_RS12765	5
Gok2_libmerged	2647601	2647602		sapA	1
Gok2_libmerged	2648383	2648427		sapA	44
Gok2_libmerged	2648499	2648518		sapA	19
Gok2_libmerged	2648593	2648599		sapA	6
Gok2_libmerged	2648883	2648898		sapA	15
Gok2_libmerged	2649173	2649184		sapB	11
Gok2_libmerged	2649304	2649313		sapB	9
Gok2_libmerged	2649452	2649455		sapB	3
Gok2_libmerged	2649912	2649914		sapB	2
Gok2_libmerged	2650589	2650625		sapC	36
Gok2_libmerged	2651246	2651271		sapD	25
Gok2_libmerged	2651782	2651794		sapD	12
Gok2_libmerged	2651937	2651941		sapD	4
Gok2_libmerged	2652048	2652059		sapF	11
Gok2_libmerged	2652097	2652104		sapF	7
Gok2_libmerged	2652158	2652212		sapF	54
Gok2_libmerged	2652286	2652293		sapF	7
Gok2_libmerged	2653337	2653344		YPO_RS12795	7
Gok2_libmerged	2653510	2653520		YPO_RS12795	10
Gok2_libmerged	2653781	2653796		YPO_RS12795	15
Gok2_libmerged	2654235	2654265		YPO_RS12795	30
Gok2_libmerged	2654418	2654423		YPO_RS12795	5
Gok2_libmerged	2655511	2655548		dtpA	37
Gok2_libmerged	2655742	2655759		dtpA	17
Gok2_libmerged	2655828	2655840		dtpA	12
Gok2_libmerged	2655995	2655997		dtpA	2
Gok2_libmerged	2656172	2656176		dtpA	4
Gok2_libmerged	2656220	2656289		dtpA	69
Gok2_libmerged	2657114	2657122		YPO_RS12805	8
Gok2_libmerged	2657896	2657932		YPO_RS12810	36
Gok2_libmerged	2658502	2658540		YPO_RS12815	38
Gok2_libmerged	2658663	2658706		YPO_RS12815	43
Gok2_libmerged	2658878	2658979		YPO_RS12820	101
Gok2_libmerged	2659868	2659893		YPO_RS12820	25
Gok2_libmerged	2660327	2660393		gstA	66
Gok2_libmerged	2660466	2660473		gstA	7
Gok2_libmerged	2660575	2660586		gstA	11
Gok2_libmerged	2660728	2660748		gstA	20
Gok2_libmerged	2661317	2661319		pdxY	2
Gok2_libmerged	2661853	2661880		tyrS	27
Gok2_libmerged	2662185	2662218		tyrS	33
Gok2_libmerged	2662728	2662744		tyrS	16
Gok2_libmerged	2663357	2663368		pdxH	11
Gok2_libmerged	2663704	2663717		pdxH	13
Gok2_libmerged	2663799	2663846		pdxH	47
Gok2_libmerged	2663890	2663912		pdxH	22
Gok2_libmerged	2664189	2664239		YPO_RS12845	50
Gok2_libmerged	2664395	2664401		anmK	6
Gok2_libmerged	2665347	2665385		anmK	38
Gok2_libmerged	2666063	2666070		YPO_RS12855	7
Gok2_libmerged	2666191	2666228		YPO_RS12855	37
Gok2_libmerged	2666674	2666745		rovA	71
Gok2_libmerged	2667001	2667018		rovA	17
Gok2_libmerged	2667948	2667952		YPO_RS12865	4
Gok2_libmerged	2668343	2668371		YPO_RS12865	28
Gok2_libmerged	2669344	2669471		eptA	127
Gok2_libmerged	2669535	2669647		eptA	112
Gok2_libmerged	2669819	2669895		eptA	76
Gok2_libmerged	2670029	2670031		eptA	2
Gok2_libmerged	2670127	2670141		eptA	14
Gok2_libmerged	2670193	2670221		eptA	28
Gok2_libmerged	2670370	2670447		eptA	77
Gok2_libmerged	2670807	2670811		eptA	4
Gok2_libmerged	2670879	2670945		eptA	66
Gok2_libmerged	2671784	2671803		YPO_RS12880	19
Gok2_libmerged	2672301	2672320		YPO_RS12885	19
Gok2_libmerged	2672521	2672529		YPO_RS12885	8
Gok2_libmerged	2673353	2673383		YPO_RS12890	30
Gok2_libmerged	2673647	2673733		YPO_RS12890	86
Gok2_libmerged	2674778	2674794		YPO_RS12890	16
Gok2_libmerged	2674887	2674950		YPO_RS12890	63
Gok2_libmerged	2674999	2675002		YPO_RS12890	3
Gok2_libmerged	2675058	2675068		YPO_RS12890	10
Gok2_libmerged	2675241	2675250		YPO_RS12890	9
Gok2_libmerged	2675323	2675330		YPO_RS12890	7
Gok2_libmerged	2675508	2675515		YPO_RS12890	7
Gok2_libmerged	2675618	2675627		YPO_RS12890	9
Gok2_libmerged	2676449	2676453		gloA	4
Gok2_libmerged	2676636	2676651		gloA	15
Gok2_libmerged	2676707	2676711		gloA	4
Gok2_libmerged	2676754	2676788		gloA	34
Gok2_libmerged	2677065	2677078		rnt	13
Gok2_libmerged	2677138	2677150		rnt	12
Gok2_libmerged	2677242	2677277		rnt	35
Gok2_libmerged	2678060	2678063		YPO_RS12910	3
Gok2_libmerged	2678198	2678208		YPO_RS12910	10
Gok2_libmerged	2678703	2678752		YPO_RS12915	49
Gok2_libmerged	2679264	2679285		YPO_RS12915	21
Gok2_libmerged	2679413	2679425		YPO_RS12915	12
Gok2_libmerged	2679930	2679943		sodB	13
Gok2_libmerged	2680026	2680041		sodB	15
Gok2_libmerged	2680261	2680271		sodB	10
Gok2_libmerged	2681214	2681293		purR	79
Gok2_libmerged	2682549	2682562		YPO_RS12935	13
Gok2_libmerged	2682697	2682726		YPO_RS12935	29
Gok2_libmerged	2684075	2684093		YPO_RS12940	18
Gok2_libmerged	2684271	2684274		YPO_RS12940	3
Gok2_libmerged	2684395	2684457		YPO_RS12940	62
Gok2_libmerged	2685436	2685452		cfa	16
Gok2_libmerged	2685618	2685658		cfa	40
Gok2_libmerged	2686193	2686204		cfa	11
Gok2_libmerged	2686299	2686323		YPO_RS12950	24
Gok2_libmerged	2686490	2686525		YPO_RS12950	35
Gok2_libmerged	2686557	2686601		YPO_RS12950	44
Gok2_libmerged	2686690	2686721		YPO_RS12950	31
Gok2_libmerged	2686834	2686841		YPO_RS12950	7
Gok2_libmerged	2687113	2687147		YPO_RS12955	34
Gok2_libmerged	2687160	2687262		YPO_RS12960	102
Gok2_libmerged	2687349	2687356		YPO_RS12960	7
Gok2_libmerged	2687455	2687499		YPO_RS12960	44
Gok2_libmerged	2687573	2687578		YPO_RS12960	5
Gok2_libmerged	2688496	2688508		YPO_RS12960	12
Gok2_libmerged	2689650	2689682		pykF	32
Gok2_libmerged	2689752	2689798		pykF	46
Gok2_libmerged	2690524	2690536		pykF	12
Gok2_libmerged	2690943	2690976		pykF	33
Gok2_libmerged	2692052	2692102		YPO_RS12985	50
Gok2_libmerged	2692154	2692157		YPO_RS12985	3
Gok2_libmerged	2692860	2692883		YPO_RS12990	23
Gok2_libmerged	2693200	2693219		YPO_RS12990	19
Gok2_libmerged	2693278	2693290		YPO_RS12990	12
Gok2_libmerged	2693613	2693651		YPO_RS12990	38
Gok2_libmerged	2693970	2693992		YPO_RS12995	22
Gok2_libmerged	2694105	2694154		YPO_RS12995	49
Gok2_libmerged	2694262	2694265		YPO_RS12995	3
Gok2_libmerged	2694609	2694632		YPO_RS13000	23
Gok2_libmerged	2694886	2694962		YPO_RS13000	76
Gok2_libmerged	2695190	2695285		YPO_RS13000	95
Gok2_libmerged	2695335	2695338		YPO_RS13000	3
Gok2_libmerged	2695506	2695533		YPO_RS13000	27
Gok2_libmerged	2695601	2695628		YPO_RS13000	27
Gok2_libmerged	2696261	2696321		sufE	60
Gok2_libmerged	2696413	2696417		sufS	4
Gok2_libmerged	2696539	2696577		sufS	38
Gok2_libmerged	2696817	2696824		sufS	7
Gok2_libmerged	2697266	2697283		sufS	17
Gok2_libmerged	2697829	2697866		sufD	37
Gok2_libmerged	2698298	2698301		sufD	3
Gok2_libmerged	2698416	2698432		sufD	16
Gok2_libmerged	2698576	2698607		sufD	31
Gok2_libmerged	2700053	2700064		sufB	11
Gok2_libmerged	2700156	2700170		sufB	14
Gok2_libmerged	2700693	2700738		sufB	45
Gok2_libmerged	2700811	2700820		sufB	9
Gok2_libmerged	2700954	2700985		sufB	31
Gok2_libmerged	2701130	2701131		sufB	1
Gok2_libmerged	2701339	2701370		sufB	31
Gok2_libmerged	2701385	2701395		sufA	10
Gok2_libmerged	2701510	2701536		sufA	26
Gok2_libmerged	2703276	2703277		YPO_RS13040	1
Gok2_libmerged	2704446	2704452		YPO_RS13040	6
Gok2_libmerged	2704585	2704618		YPO_RS13040	33
Gok2_libmerged	2704966	2704971		YPO_RS13040	5
Gok2_libmerged	2705131	2705221		YPO_RS13040	90
Gok2_libmerged	2705732	2705796		YPO_RS13040	64
Gok2_libmerged	2705899	2705905		YPO_RS13040	6
Gok2_libmerged	2706907	2706943		ydiK	36
Gok2_libmerged	2707110	2707115		ydiK	5
Gok2_libmerged	2707534	2707542		ydiK	8
Gok2_libmerged	2707943	2708013		rprA	70
Gok2_libmerged	2708794	2708816		ppsA	22
Gok2_libmerged	2709085	2709100		ppsA	15
Gok2_libmerged	2709349	2709388		ppsA	39
Gok2_libmerged	2709918	2709945		ppsA	27
Gok2_libmerged	2710015	2710017		ppsA	2
Gok2_libmerged	2710198	2710207		ppsA	9
Gok2_libmerged	2710564	2710652		ppsA	88
Gok2_libmerged	2711195	2711206		YPO_RS13060	11
Gok2_libmerged	2711460	2711471		YPO_RS13060	11
Gok2_libmerged	2711660	2711688		YPO_RS13060	28
Gok2_libmerged	2712142	2712165		YPO_RS13065	23
Gok2_libmerged	2712221	2712238		YPO_RS13065	17
Gok2_libmerged	2712429	2712457		YPO_RS13065	28
Gok2_libmerged	2712572	2712583		YPO_RS13065	11
Gok2_libmerged	2712861	2712892		YPO_RS13065	31
Gok2_libmerged	2714702	2714727		YPO_RS13075	25
Gok2_libmerged	2715435	2715462		YPO_RS13075	27
Gok2_libmerged	2715935	2715947		YPO_RS13080	12
Gok2_libmerged	2716194	2716229		YPO_RS13080	35
Gok2_libmerged	2716582	2716621		arnF	39
Gok2_libmerged	2716756	2716853		arnF	97
Gok2_libmerged	2716953	2716955		arnF	2
Gok2_libmerged	2717396	2717400		arnT	4
Gok2_libmerged	2717502	2717518		arnT	16
Gok2_libmerged	2717660	2717664		arnT	4
Gok2_libmerged	2717955	2718023		arnT	68
Gok2_libmerged	2718086	2718089		arnT	3
Gok2_libmerged	2718369	2718379		arnT	10
Gok2_libmerged	2718628	2718653		arnT	25
Gok2_libmerged	2718856	2718861		arnT	5
Gok2_libmerged	2718911	2718939		arnT	28
Gok2_libmerged	2719033	2719035		YPO_RS13105	2
Gok2_libmerged	2719343	2719354		YPO_RS13105	11
Gok2_libmerged	2719655	2719660		YPO_RS13105	5
Gok2_libmerged	2719863	2719872		YPO_RS13105	9
Gok2_libmerged	2719869	2719901		arnA	32
Gok2_libmerged	2720185	2720251		arnA	66
Gok2_libmerged	2720466	2720493		arnA	27
Gok2_libmerged	2720554	2720621		arnA	67
Gok2_libmerged	2720732	2720746		arnA	14
Gok2_libmerged	2720860	2720917		arnA	57
Gok2_libmerged	2721063	2721098		arnA	35
Gok2_libmerged	2721708	2721728		arnA	20
Gok2_libmerged	2721975	2722002		arnC	27
Gok2_libmerged	2722165	2722233		arnC	68
Gok2_libmerged	2722558	2722652		arnC	94
Gok2_libmerged	2722689	2722730		arnC	41
Gok2_libmerged	2723024	2723113		arnB	89
Gok2_libmerged	2723184	2723191		arnB	7
Gok2_libmerged	2723261	2723320		arnB	59
Gok2_libmerged	2723405	2723458		arnB	53
Gok2_libmerged	2723666	2723692		arnB	26
Gok2_libmerged	2723956	2723993		arnB	37
Gok2_libmerged	2724343	2724365		btuD	22
Gok2_libmerged	2724892	2724910		btuD	18
Gok2_libmerged	2725260	2725264		YPO_RS13130	4
Gok2_libmerged	2725502	2725560		YPO_RS13130	58
Gok2_libmerged	2725617	2725680		YPO_RS13130	63
Gok2_libmerged	2725750	2725775		btuC	25
Gok2_libmerged	2726028	2726055		btuC	27
Gok2_libmerged	2726283	2726340		btuC	57
Gok2_libmerged	2726404	2726452		btuC	48
Gok2_libmerged	2726502	2726517		btuC	15
Gok2_libmerged	2726661	2726666		btuC	5
Gok2_libmerged	2727031	2727057		YPO_RS13140	26
Gok2_libmerged	2727121	2727124		YPO_RS13140	3
Gok2_libmerged	2727234	2727239		YPO_RS13140	5
Gok2_libmerged	2727314	2727339		YPO_RS13140	25
Gok2_libmerged	2727394	2727442		YPO_RS13140	48
Gok2_libmerged	2727835	2727869		ihfA	34
Gok2_libmerged	2728416	2728435		pheT	19
Gok2_libmerged	2728491	2728539		pheT	48
Gok2_libmerged	2728662	2728670		pheT	8
Gok2_libmerged	2728902	2728963		pheT	61
Gok2_libmerged	2729023	2729060		pheT	37
Gok2_libmerged	2729235	2729294		pheT	59
Gok2_libmerged	2729869	2729879		pheT	10
Gok2_libmerged	2729971	2729978		pheT	7
Gok2_libmerged	2730478	2730493		pheS	15
Gok2_libmerged	2730657	2730664		pheS	7
Gok2_libmerged	2731344	2731420		pheS	76
Gok2_libmerged	2731862	2731865		pheM	3
Gok2_libmerged	2731960	2731973		rplT	13
Gok2_libmerged	2732466	2732472		rpmI	6
Gok2_libmerged	2732655	2732661		infC	6
Gok2_libmerged	2733073	2733093		infC	20
Gok2_libmerged	2733189	2733199		infC	10
Gok2_libmerged	2733203	2733212		thrS	9
Gok2_libmerged	2733620	2733627		thrS	7
Gok2_libmerged	2733850	2733851		thrS	1
Gok2_libmerged	2733989	2734011		thrS	22
Gok2_libmerged	2734242	2734270		thrS	28
Gok2_libmerged	2734579	2734588		thrS	9
Gok2_libmerged	2734656	2734677		thrS	21
Gok2_libmerged	2734785	2734835		thrS	50
Gok2_libmerged	2735120	2735122		thrS	2
Gok2_libmerged	2736680	2736722		YPO_RS13190	42
Gok2_libmerged	2737063	2737070		YPO_RS13195	7
Gok2_libmerged	2737240	2737243		YPO_RS13195	3
Gok2_libmerged	2737388	2737397		YPO_RS13195	9
Gok2_libmerged	2737461	2737510		YPO_RS13195	49
Gok2_libmerged	2737672	2737682		YPO_RS13195	10
Gok2_libmerged	2738444	2738477		YPO_RS13200	33
Gok2_libmerged	2738936	2738977		yfeA	41
Gok2_libmerged	2739525	2739583		yfeA	58
Gok2_libmerged	2739654	2739710		yfeA	56
Gok2_libmerged	2739707	2739742		yfeB	35
Gok2_libmerged	2739943	2739949		yfeB	6
Gok2_libmerged	2740210	2740225		yfeB	15
Gok2_libmerged	2740532	2740579		yfeB	47
Gok2_libmerged	2740910	2741020		yfeC	110
Gok2_libmerged	2741592	2741604		yfeD	12
Gok2_libmerged	2742360	2742371		yfeD	11
Gok2_libmerged	2742467	2742533		YPO_RS13225	66
Gok2_libmerged	2742648	2742651		YPO_RS13225	3
Gok2_libmerged	2742908	2742938		YPO_RS13230	30
Gok2_libmerged	2743317	2743376		YPO_RS13230	59
Gok2_libmerged	2743824	2743959		YPO_RS13235	135
Gok2_libmerged	2744003	2744022		YPO_RS13235	19
Gok2_libmerged	2744110	2744118		YPO_RS13235	8
Gok2_libmerged	2744221	2744234		YPO_RS13235	13
Gok2_libmerged	2744888	2744902		hxpB	14
Gok2_libmerged	2744959	2744962		hxpB	3
Gok2_libmerged	2745282	2745310		hxpB	28
Gok2_libmerged	2747254	2747283		solA	29
Gok2_libmerged	2748512	2748596		YPO_RS13255	84
Gok2_libmerged	2748776	2748853		YPO_RS13255	77
Gok2_libmerged	2749049	2749126		YPO_RS13255	77
Gok2_libmerged	2749953	2749971		YPO_RS13265	18
Gok2_libmerged	2750140	2750278		YPO_RS13265	138
Gok2_libmerged	2750386	2750394		YPO_RS13265	8
Gok2_libmerged	2750918	2750964		YPO_RS13270	46
Gok2_libmerged	2751022	2751024		YPO_RS13270	2
Gok2_libmerged	2751077	2751112		YPO_RS13270	35
Gok2_libmerged	2751237	2751246		YPO_RS13270	9
Gok2_libmerged	2751305	2751339		YPO_RS13270	34
Gok2_libmerged	2751370	2751389		YPO_RS13270	19
Gok2_libmerged	2751494	2751525		YPO_RS13270	31
Gok2_libmerged	2751687	2751693		YPO_RS13270	6
Gok2_libmerged	2751960	2751972		YPO_RS13270	12
Gok2_libmerged	2752331	2752364		YPO_RS13275	33
Gok2_libmerged	2752411	2752423		YPO_RS13275	12
Gok2_libmerged	2753034	2753101		YPO_RS13280	67
Gok2_libmerged	2753638	2753648		YPO_RS13280	10
Gok2_libmerged	2754142	2754320		YPO_RS13285	178
Gok2_libmerged	2754357	2754381		YPO_RS13285	24
Gok2_libmerged	2754644	2754656		YPO_RS13285	12
Gok2_libmerged	2754796	2754923		YPO_RS13290	127
Gok2_libmerged	2755017	2755035		YPO_RS13290	18
Gok2_libmerged	2755084	2755168		YPO_RS13290	84
Gok2_libmerged	2755373	2755411		YPO_RS13290	38
Gok2_libmerged	2755501	2755505		YPO_RS13290	4
Gok2_libmerged	2756174	2756184		YPO_RS13295	10
Gok2_libmerged	2756247	2756286		YPO_RS13295	39
Gok2_libmerged	2756369	2756374		YPO_RS13295	5
Gok2_libmerged	2756914	2756918		YPO_RS13295	4
Gok2_libmerged	2757215	2757242		YPO_RS13300	27
Gok2_libmerged	2757366	2757442		YPO_RS13305	76
Gok2_libmerged	2757539	2757703		YPO_RS13305	164
Gok2_libmerged	2757855	2757863		YPO_RS13305	8
Gok2_libmerged	2758426	2758432		YPO_RS13305	6
Gok2_libmerged	2758572	2758581		YPO_RS13305	9
Gok2_libmerged	2758771	2758800		fae	29
Gok2_libmerged	2759114	2759125		fae	11
Gok2_libmerged	2759211	2759223		fae	12
Gok2_libmerged	2759446	2759536		YPO_RS13315	90
Gok2_libmerged	2759598	2759615		YPO_RS13315	17
Gok2_libmerged	2759697	2759760		YPO_RS13315	63
Gok2_libmerged	2760104	2760112		YPO_RS13315	8
Gok2_libmerged	2760294	2760304		YPO_RS13315	10
Gok2_libmerged	2760905	2760936		cas6f	31
Gok2_libmerged	2761079	2761082		csy3	3
Gok2_libmerged	2761309	2761346		csy3	37
Gok2_libmerged	2761969	2762011		csy2	42
Gok2_libmerged	2762070	2762073		csy2	3
Gok2_libmerged	2762255	2762298		csy2	43
Gok2_libmerged	2762350	2762366		csy2	16
Gok2_libmerged	2762493	2762515		csy2	22
Gok2_libmerged	2762599	2762601		csy2	2
Gok2_libmerged	2763347	2763360		csy1	13
Gok2_libmerged	2763759	2763763		csy1	4
Gok2_libmerged	2763893	2763902		csy1	9
Gok2_libmerged	2764749	2764777		cas3f	28
Gok2_libmerged	2764818	2764848		cas3f	30
Gok2_libmerged	2765213	2765227		cas3f	14
Gok2_libmerged	2765376	2765380		cas3f	4
Gok2_libmerged	2765475	2765484		cas3f	9
Gok2_libmerged	2765618	2765632		cas3f	14
Gok2_libmerged	2766047	2766060		cas3f	13
Gok2_libmerged	2766191	2766210		cas3f	19
Gok2_libmerged	2766921	2766937		cas3f	16
Gok2_libmerged	2767013	2767025		cas3f	12
Gok2_libmerged	2767263	2767287		cas3f	24
Gok2_libmerged	2767544	2767583		cas3f	39
Gok2_libmerged	2767849	2767871		cas3f	22
Gok2_libmerged	2768030	2768037		cas1f	7
Gok2_libmerged	2768389	2768451		cas1f	62
Gok2_libmerged	2768671	2768676		cas1f	5
Gok2_libmerged	2768761	2768898		cas1f	137
Gok2_libmerged	2770199	2770262		YPO_RS13350	63
Gok2_libmerged	2770581	2770638		YPO_RS13350	57
Gok2_libmerged	2771017	2771036		YPO_RS13350	19
Gok2_libmerged	2771130	2771154		YPO_RS13350	24
Gok2_libmerged	2771262	2771307		YPO_RS13350	45
Gok2_libmerged	2772088	2772137		YPO_RS13355	49
Gok2_libmerged	2772560	2772596		YPO_RS13355	36
Gok2_libmerged	2772632	2772641		YPO_RS13355	9
Gok2_libmerged	2772891	2772937		YPO_RS13355	46
Gok2_libmerged	2773195	2773241		YPO_RS13355	46
Gok2_libmerged	2773280	2773295		YPO_RS13360	15
Gok2_libmerged	2773727	2773749		YPO_RS13360	22
Gok2_libmerged	2774070	2774083		YPO_RS13360	13
Gok2_libmerged	2774138	2774184		YPO_RS13360	46
Gok2_libmerged	2774301	2774395		YPO_RS13360	94
Gok2_libmerged	2774706	2774751		YPO_RS13365	45
Gok2_libmerged	2774927	2774928		YPO_RS13365	1
Gok2_libmerged	2775090	2775134		YPO_RS13365	44
Gok2_libmerged	2775166	2775215		YPO_RS13365	49
Gok2_libmerged	2775313	2775323		YPO_RS13365	10
Gok2_libmerged	2775720	2775743		YPO_RS13370	23
Gok2_libmerged	2776421	2776452		YPO_RS13370	31
Gok2_libmerged	2776522	2776538		YPO_RS13370	16
Gok2_libmerged	2776689	2776715		YPO_RS13375	26
Gok2_libmerged	2776779	2776790		YPO_RS13375	11
Gok2_libmerged	2777078	2777087		YPO_RS13375	9
Gok2_libmerged	2777409	2777439		YPO_RS13375	30
Gok2_libmerged	2777518	2777523		YPO_RS13380	5
Gok2_libmerged	2777586	2777592		YPO_RS13380	6
Gok2_libmerged	2777678	2777696		YPO_RS13380	18
Gok2_libmerged	2777748	2777773		YPO_RS13380	25
Gok2_libmerged	2777899	2777906		YPO_RS13380	7
Gok2_libmerged	2777951	2777972		YPO_RS13380	21
Gok2_libmerged	2778055	2778243		YPO_RS13380	188
Gok2_libmerged	2778383	2778385		YPO_RS13380	2
Gok2_libmerged	2778494	2778520		YPO_RS13385	26
Gok2_libmerged	2778593	2778606		YPO_RS13385	13
Gok2_libmerged	2779018	2779038		YPO_RS13385	20
Gok2_libmerged	2779313	2779349		YPO_RS13385	36
Gok2_libmerged	2779670	2779671		YPO_RS13385	1
Gok2_libmerged	2779766	2779780		YPO_RS13385	14
Gok2_libmerged	2780187	2780212		YPO_RS13390	25
Gok2_libmerged	2780273	2780284		YPO_RS13390	11
Gok2_libmerged	2780356	2780396		YPO_RS13390	40
Gok2_libmerged	2781072	2781092		YPO_RS13390	20
Gok2_libmerged	2781533	2781578		YPO_RS13395	45
Gok2_libmerged	2782315	2782369		YPO_RS13395	54
Gok2_libmerged	2782862	2782863		ugpC	1
Gok2_libmerged	2783162	2783207		ugpC	45
Gok2_libmerged	2783306	2783337		ugpC	31
Gok2_libmerged	2783966	2783968		YPO_RS13405	2
Gok2_libmerged	2784042	2784060		YPO_RS13405	18
Gok2_libmerged	2784197	2784210		YPO_RS13405	13
Gok2_libmerged	2784293	2784337		YPO_RS13405	44
Gok2_libmerged	2784744	2784767		YPO_RS13410	23
Gok2_libmerged	2784809	2784834		YPO_RS13410	25
Gok2_libmerged	2785296	2785525		YPO_RS13415	229
Gok2_libmerged	2785697	2785700		YPO_RS13415	3
Gok2_libmerged	2786217	2786310		YPO_RS13425	93
Gok2_libmerged	2786419	2786472		YPO_RS13430	53
Gok2_libmerged	2786819	2786906		YPO_RS13430	87
Gok2_libmerged	2787054	2787079		YPO_RS13430	25
Gok2_libmerged	2787619	2787671		YPO_RS13430	52
Gok2_libmerged	2788195	2788209		YPO_RS13430	14
Gok2_libmerged	2788355	2788357		YPO_RS13430	2
Gok2_libmerged	2788797	2788895		YPO_RS13435	98
Gok2_libmerged	2788974	2788975		YPO_RS13435	1
Gok2_libmerged	2789228	2789271		YPO_RS13440	43
Gok2_libmerged	2789357	2789367		YPO_RS13440	10
Gok2_libmerged	2789612	2789613		YPO_RS13445	1
Gok2_libmerged	2789727	2789932		YPO_RS13445	205
Gok2_libmerged	2790054	2790059		YPO_RS13445	5
Gok2_libmerged	2790116	2790121		YPO_RS13445	5
Gok2_libmerged	2790123	2790130		cdiA	7
Gok2_libmerged	2790210	2790214		cdiA	4
Gok2_libmerged	2790640	2790647		cdiA	7
Gok2_libmerged	2790897	2790898		cdiA	1
Gok2_libmerged	2791098	2791110		cdiA	12
Gok2_libmerged	2791350	2791354		cdiA	4
Gok2_libmerged	2791442	2791458		cdiA	16
Gok2_libmerged	2791548	2791568		cdiA	20
Gok2_libmerged	2792086	2792094		cdiA	8
Gok2_libmerged	2792430	2792431		cdiA	1
Gok2_libmerged	2792492	2792518		cdiA	26
Gok2_libmerged	2793260	2793291		cdiA	31
Gok2_libmerged	2793931	2793944		cdiA	13
Gok2_libmerged	2794617	2794623		cdiA	6
Gok2_libmerged	2794743	2794757		cdiA	14
Gok2_libmerged	2794829	2794854		cdiA	25
Gok2_libmerged	2796192	2796236		cdiA	44
Gok2_libmerged	2796582	2796584		cdiA	2
Gok2_libmerged	2796635	2796681		cdiA	46
Gok2_libmerged	2797193	2797215		cdiA	22
Gok2_libmerged	2798279	2798281		YPO_RS13455	2
Gok2_libmerged	2799189	2799225		YPO_RS13455	36
Gok2_libmerged	2799360	2799392		YPO_RS13455	32
Gok2_libmerged	2799539	2799562		YPO_RS13455	23
Gok2_libmerged	2800227	2800255		YPO_RS13460	28
Gok2_libmerged	2800367	2800384		YPO_RS13460	17
Gok2_libmerged	2800721	2800807		YPO_RS13460	86
Gok2_libmerged	2800915	2800925		YPO_RS13460	10
Gok2_libmerged	2800981	2801020		YPO_RS13460	39
Gok2_libmerged	2801284	2801296		YPO_RS13465	12
Gok2_libmerged	2801476	2801484		YPO_RS13465	8
Gok2_libmerged	2801936	2801952		YPO_RS13465	16
Gok2_libmerged	2802004	2802021		YPO_RS13465	17
Gok2_libmerged	2802160	2802170		YPO_RS13465	10
Gok2_libmerged	2802516	2802522		YPO_RS13470	6
Gok2_libmerged	2802636	2802704		YPO_RS13470	68
Gok2_libmerged	2802795	2802796		YPO_RS13470	1
Gok2_libmerged	2802860	2802928		YPO_RS13470	68
Gok2_libmerged	2803037	2803042		YPO_RS13470	5
Gok2_libmerged	2803116	2803153		YPO_RS13470	37
Gok2_libmerged	2803257	2803311		YPO_RS13470	54
Gok2_libmerged	2803608	2803718		YPO_RS13470	110
Gok2_libmerged	2804081	2804162		YPO_RS13470	81
Gok2_libmerged	2804779	2804806		YPO_RS13475	27
Gok2_libmerged	2805339	2805359		YPO_RS13475	20
Gok2_libmerged	2805431	2805457		YPO_RS13475	26
Gok2_libmerged	2805967	2805994		YPO_RS13480	27
Gok2_libmerged	2806334	2806342		YPO_RS13480	8
Gok2_libmerged	2806564	2806576		YPO_RS13480	12
Gok2_libmerged	2807250	2807325		YPO_RS13485	75
Gok2_libmerged	2807404	2807421		YPO_RS13485	17
Gok2_libmerged	2807615	2807650		YPO_RS13485	35
Gok2_libmerged	2807684	2807701		YPO_RS13485	17
Gok2_libmerged	2807791	2808044		YPO_RS13485	253
Gok2_libmerged	2808102	2808159		YPO_RS13485	57
Gok2_libmerged	2808450	2808457		YPO_RS13490	7
Gok2_libmerged	2808564	2808580		YPO_RS13490	16
Gok2_libmerged	2808675	2808746		YPO_RS13490	71
Gok2_libmerged	2808823	2808848		YPO_RS13490	25
Gok2_libmerged	2809101	2809168		YPO_RS13490	67
Gok2_libmerged	2809956	2809957		YPO_RS13495	1
Gok2_libmerged	2810478	2810512		YPO_RS13495	34
Gok2_libmerged	2811225	2811233		YPO_RS13500	8
Gok2_libmerged	2811279	2811286		YPO_RS13500	7
Gok2_libmerged	2811385	2811499		YPO_RS13500	114
Gok2_libmerged	2812009	2812029		YPO_RS13505	20
Gok2_libmerged	2812506	2812532		YPO_RS13505	26
Gok2_libmerged	2812691	2812701		YPO_RS13505	10
Gok2_libmerged	2812739	2812763		YPO_RS13505	24
Gok2_libmerged	2813712	2813729		YPO_RS13510	17
Gok2_libmerged	2813817	2813834		YPO_RS13510	17
Gok2_libmerged	2813924	2814103		YPO_RS13510	179
Gok2_libmerged	2814157	2814329		YPO_RS13510	172
Gok2_libmerged	2814371	2814380		YPO_RS13510	9
Gok2_libmerged	2814576	2814738		YPO_RS13515	162
Gok2_libmerged	2815003	2815005		YPO_RS13515	2
Gok2_libmerged	2815876	2815932		YPO_RS13520	56
Gok2_libmerged	2816712	2816748		ompX	36
Gok2_libmerged	2817037	2817045		ompX	8
Gok2_libmerged	2817630	2817639		rhtA	9
Gok2_libmerged	2817775	2817830		rhtA	55
Gok2_libmerged	2817946	2817960		rhtA	14
Gok2_libmerged	2818110	2818177		rhtA	67
Gok2_libmerged	2818962	2818966		tam	4
Gok2_libmerged	2819040	2819049		tam	9
Gok2_libmerged	2819215	2819222		tam	7
Gok2_libmerged	2819618	2819663		tam	45
Gok2_libmerged	2819731	2819738		tam	7
Gok2_libmerged	2820173	2820247		dps	74
Gok2_libmerged	2821012	2821020		YPO_RS13550	8
Gok2_libmerged	2821111	2821168		YPO_RS13550	57
Gok2_libmerged	2821617	2821653		YPO_RS13550	36
Gok2_libmerged	2821812	2821820		YPO_RS13550	8
Gok2_libmerged	2822515	2822550		glnH	35
Gok2_libmerged	2822791	2822805		glnH	14
Gok2_libmerged	2823239	2823258		glnH	19
Gok2_libmerged	2823590	2823618		glnP	28
Gok2_libmerged	2823774	2823815		glnP	41
Gok2_libmerged	2823869	2823949		glnP	80
Gok2_libmerged	2823946	2823952		glnQ	6
Gok2_libmerged	2823990	2824034		glnQ	44
Gok2_libmerged	2824478	2824496		glnQ	18
Gok2_libmerged	2824933	2825009		YPO_RS13570	76
Gok2_libmerged	2825110	2825127		YPO_RS13570	17
Gok2_libmerged	2825649	2825702		YPO_RS13570	53
Gok2_libmerged	2826044	2826096		YPO_RS13570	52
Gok2_libmerged	2826158	2826182		YPO_RS13570	24
Gok2_libmerged	2826531	2826573		YPO_RS13575	42
Gok2_libmerged	2826829	2826843		YPO_RS13575	14
Gok2_libmerged	2826927	2826940		YPO_RS13575	13
Gok2_libmerged	2827212	2827280		YPO_RS13575	68
Gok2_libmerged	2827480	2827486		YPO_RS13580	6
Gok2_libmerged	2827617	2827618		YPO_RS13580	1
Gok2_libmerged	2828409	2828458		YPO_RS13585	49
Gok2_libmerged	2829233	2829236		rlmF	3
Gok2_libmerged	2829316	2829322		rlmF	6
Gok2_libmerged	2829547	2829614		rlmF	67
Gok2_libmerged	2829694	2829723		rlmF	29
Gok2_libmerged	2829875	2829878		rlmF	3
Gok2_libmerged	2830425	2830486		YPO_RS13595	61
Gok2_libmerged	2831146	2831185		ybiB	39
Gok2_libmerged	2831524	2831532		ybiB	8
Gok2_libmerged	2831739	2831755		ybiB	16
Gok2_libmerged	2832268	2832290		menE	22
Gok2_libmerged	2832338	2832379		menE	41
Gok2_libmerged	2832491	2832638		menE	147
Gok2_libmerged	2833086	2833102		menE	16
Gok2_libmerged	2833133	2833217		menE	84
Gok2_libmerged	2833411	2833416		menC	5
Gok2_libmerged	2833636	2833645		menC	9
Gok2_libmerged	2833780	2833820		menC	40
Gok2_libmerged	2834017	2834040		menC	23
Gok2_libmerged	2834093	2834111		menC	18
Gok2_libmerged	2834911	2834936		menB	25
Gok2_libmerged	2835138	2835141		menH	3
Gok2_libmerged	2835452	2835461		menH	9
Gok2_libmerged	2835841	2835867		menH	26
Gok2_libmerged	2836481	2836584		menD	103
Gok2_libmerged	2837069	2837120		menD	51
Gok2_libmerged	2837233	2837263		menD	30
Gok2_libmerged	2837560	2837562		menD	2
Gok2_libmerged	2837980	2837999		menF	19
Gok2_libmerged	2838316	2838330		menF	14
Gok2_libmerged	2838539	2838559		menF	20
Gok2_libmerged	2838617	2838621		menF	4
Gok2_libmerged	2838751	2838763		menF	12
Gok2_libmerged	2839853	2839905		YPO_RS13635	52
Gok2_libmerged	2839975	2839980		YPO_RS13635	5
Gok2_libmerged	2840200	2840253		YPO_RS13635	53
Gok2_libmerged	2840339	2840423		YPO_RS13635	84
Gok2_libmerged	2841230	2841236		YPO_RS13640	6
Gok2_libmerged	2842402	2842420		YPO_RS13645	18
Gok2_libmerged	2842918	2842943		YPO_RS13645	25
Gok2_libmerged	2843194	2843212		YPO_RS13645	18
Gok2_libmerged	2843825	2843834		YPO_RS13645	9
Gok2_libmerged	2844097	2844117		YPO_RS13650	20
Gok2_libmerged	2844166	2844235		YPO_RS13650	69
Gok2_libmerged	2844348	2844360		YPO_RS13650	12
Gok2_libmerged	2844672	2844687		YPO_RS13655	15
Gok2_libmerged	2845576	2845607		YPO_RS13655	31
Gok2_libmerged	2845756	2845762		YPO_RS13655	6
Gok2_libmerged	2845891	2845894		YPO_RS13655	3
Gok2_libmerged	2845953	2845954		YPO_RS13655	1
Gok2_libmerged	2847128	2847146		YPO_RS13660	18
Gok2_libmerged	2847252	2847285		YPO_RS13660	33
Gok2_libmerged	2848076	2848094		YPO_RS13665	18
Gok2_libmerged	2848174	2848208		YPO_RS13665	34
Gok2_libmerged	2848597	2848610		YPO_RS13665	13
Gok2_libmerged	2848659	2848674		YPO_RS13665	15
Gok2_libmerged	2849834	2849850		YPO_RS13670	16
Gok2_libmerged	2849929	2849975		YPO_RS13670	46
Gok2_libmerged	2850606	2850614		YPO_RS13670	8
Gok2_libmerged	2851720	2851851		idnO	131
Gok2_libmerged	2852161	2852183		idnO	22
Gok2_libmerged	2852345	2852365		YPO_RS13680	20
Gok2_libmerged	2852849	2852863		YPO_RS13685	14
Gok2_libmerged	2852914	2852935		YPO_RS13685	21
Gok2_libmerged	2853194	2853196		YPO_RS13685	2
Gok2_libmerged	2853268	2853287		YPO_RS13685	19
Gok2_libmerged	2853931	2854000		YPO_RS13690	69
Gok2_libmerged	2854059	2854066		YPO_RS13690	7
Gok2_libmerged	2854142	2854288		YPO_RS13690	146
Gok2_libmerged	2854356	2854481		YPO_RS13690	125
Gok2_libmerged	2854554	2854579		YPO_RS13690	25
Gok2_libmerged	2854687	2854710		YPO_RS13690	23
Gok2_libmerged	2854765	2854800		YPO_RS13690	35
Gok2_libmerged	2854836	2854841		YPO_RS13690	5
Gok2_libmerged	2855340	2855374		nuoN	34
Gok2_libmerged	2855747	2855765		nuoN	18
Gok2_libmerged	2855993	2856008		nuoN	15
Gok2_libmerged	2856313	2856330		nuoN	17
Gok2_libmerged	2856510	2856518		nuoN	8
Gok2_libmerged	2856943	2857064		nuoM	121
Gok2_libmerged	2857303	2857415		nuoM	112
Gok2_libmerged	2857609	2857611		nuoM	2
Gok2_libmerged	2857872	2857892		nuoM	20
Gok2_libmerged	2858149	2858151		nuoL	2
Gok2_libmerged	2858522	2858531		nuoL	9
Gok2_libmerged	2858603	2858604		nuoL	1
Gok2_libmerged	2858903	2858928		nuoL	25
Gok2_libmerged	2859650	2859703		nuoL	53
Gok2_libmerged	2860003	2860005		nuoK	2
Gok2_libmerged	2860182	2860222		nuoK	40
Gok2_libmerged	2860363	2860364		nuoJ	1
Gok2_libmerged	2860480	2860532		nuoJ	52
Gok2_libmerged	2860947	2860969		nuoI	22
Gok2_libmerged	2861136	2861180		nuoI	44
Gok2_libmerged	2861374	2861425		nuoH	51
Gok2_libmerged	2862142	2862149		nuoH	7
Gok2_libmerged	2862497	2862554		nuoG	57
Gok2_libmerged	2863305	2863315		nuoG	10
Gok2_libmerged	2864140	2864152		nuoG	12
Gok2_libmerged	2864713	2864761		nuoG	48
Gok2_libmerged	2864878	2864922		nuoG	44
Gok2_libmerged	2865055	2865062		nuoG	7
Gok2_libmerged	2865766	2865768		nuoF	2
Gok2_libmerged	2866214	2866256		nuoF	42
Gok2_libmerged	2866395	2866397		nuoF	2
Gok2_libmerged	2866918	2866923		nuoE	5
Gok2_libmerged	2867093	2867123		nuoE	30
Gok2_libmerged	2867269	2867286		nuoC	17
Gok2_libmerged	2867816	2867825		nuoC	9
Gok2_libmerged	2867937	2867987		nuoC	50
Gok2_libmerged	2868282	2868305		nuoC	23
Gok2_libmerged	2868449	2868483		nuoC	34
Gok2_libmerged	2868714	2868748		nuoC	34
Gok2_libmerged	2867155	2867204		nuoC	49
Gok2_libmerged	2869126	2869163		YPO_RS13750	37
Gok2_libmerged	2869272	2869295		YPO_RS13750	23
Gok2_libmerged	2870334	2870336		YPO_RS13755	2
Gok2_libmerged	2871066	2871084		lrhA	18
Gok2_libmerged	2871149	2871178		lrhA	29
Gok2_libmerged	2871303	2871370		lrhA	67
Gok2_libmerged	2871669	2871699		lrhA	30
Gok2_libmerged	2871949	2871953		lrhA	4
Gok2_libmerged	2873653	2873654		YPO_RS13765	1
Gok2_libmerged	2873808	2873864		YPO_RS13765	56
Gok2_libmerged	2874421	2874491		yfbR	70
Gok2_libmerged	2874604	2874631		yfbR	27
Gok2_libmerged	2875167	2875182		YPO_RS13775	15
Gok2_libmerged	2875581	2875592		YPO_RS13775	11
Gok2_libmerged	2875830	2875832		YPO_RS13775	2
Gok2_libmerged	2875967	2876004		YPO_RS13775	37
Gok2_libmerged	2876342	2876383		YPO_RS13775	41
Gok2_libmerged	2877627	2877634		YPO_RS13780	7
Gok2_libmerged	2878055	2878078		YPO_RS13785	23
Gok2_libmerged	2878210	2878260		YPO_RS13785	50
Gok2_libmerged	2878348	2878353		YPO_RS13785	5
Gok2_libmerged	2878486	2878490		YPO_RS13785	4
Gok2_libmerged	2878995	2879003		YPO_RS13790	8
Gok2_libmerged	2879056	2879086		YPO_RS13790	30
Gok2_libmerged	2879306	2879311		YPO_RS13790	5
Gok2_libmerged	2879810	2879812		ackA	2
Gok2_libmerged	2880121	2880201		ackA	80
Gok2_libmerged	2880269	2880298		ackA	29
Gok2_libmerged	2881341	2881365		pta	24
Gok2_libmerged	2881607	2881611		pta	4
Gok2_libmerged	2882402	2882405		pta	3
Gok2_libmerged	2882577	2882595		pta	18
Gok2_libmerged	2882994	2882997		pta	3
Gok2_libmerged	2883565	2883581		YPO_RS13805	16
Gok2_libmerged	2883619	2883658		YPO_RS13805	39
Gok2_libmerged	2884030	2884056		YPO_RS13805	26
Gok2_libmerged	2884226	2884252		YPO_RS13805	26
Gok2_libmerged	2885136	2885169		YPO_RS13810	33
Gok2_libmerged	2885305	2885367		YPO_RS13810	62
Gok2_libmerged	2885780	2885787		YPO_RS13815	7
Gok2_libmerged	2885862	2885880		YPO_RS13820	18
Gok2_libmerged	2886217	2886248		YPO_RS13820	31
Gok2_libmerged	2886585	2886593		YPO_RS13820	8
Gok2_libmerged	2886818	2886829		YPO_RS13820	11
Gok2_libmerged	2887054	2887090		YPO_RS13825	36
Gok2_libmerged	2887185	2887204		YPO_RS13825	19
Gok2_libmerged	2887415	2887441		YPO_RS13825	26
Gok2_libmerged	2887514	2887556		YPO_RS13825	42
Gok2_libmerged	2887603	2887604		YPO_RS13825	1
Gok2_libmerged	2888243	2888271		YPO_RS13830	28
Gok2_libmerged	2888436	2888450		YPO_RS13830	14
Gok2_libmerged	2888504	2888538		YPO_RS13830	34
Gok2_libmerged	2888609	2888661		YPO_RS13830	52
Gok2_libmerged	2888754	2888771		YPO_RS13830	17
Gok2_libmerged	2889778	2889875		YPO_RS13830	97
Gok2_libmerged	2890120	2890122		YPO_RS13830	2
Gok2_libmerged	2890315	2890350		YPO_RS13830	35
Gok2_libmerged	2890400	2890512		YPO_RS13830	112
Gok2_libmerged	2890774	2890776		YPO_RS13830	2
Gok2_libmerged	2891014	2891018		YPO_RS13830	4
Gok2_libmerged	2891516	2891533		YPO_RS13830	17
Gok2_libmerged	2891917	2891927		YPO_RS13830	10
Gok2_libmerged	2892074	2892085		YPO_RS13830	11
Gok2_libmerged	2892649	2892678		YPO_RS13830	29
Gok2_libmerged	2892763	2892778		YPO_RS13830	15
Gok2_libmerged	2892983	2892984		YPO_RS13830	1
Gok2_libmerged	2893078	2893137		YPO_RS13830	59
Gok2_libmerged	2893201	2893242		YPO_RS13830	41
Gok2_libmerged	2893385	2893450		YPO_RS13830	65
Gok2_libmerged	2893504	2893513		YPO_RS13830	9
Gok2_libmerged	2893730	2893741		YPO_RS13830	11
Gok2_libmerged	2893916	2893965		YPO_RS13830	49
Gok2_libmerged	2894378	2894405		YPO_RS13835	27
Gok2_libmerged	2894681	2894702		YPO_RS13835	21
Gok2_libmerged	2894917	2894922		YPO_RS13835	5
Gok2_libmerged	2895630	2895640		YPO_RS13840	10
Gok2_libmerged	2896101	2896139		YPO_RS13840	38
Gok2_libmerged	2896337	2896344		YPO_RS13840	7
Gok2_libmerged	2897399	2897421		YPO_RS13845	22
Gok2_libmerged	2897656	2897679		YPO_RS13845	23
Gok2_libmerged	2897797	2897798		YPO_RS13845	1
Gok2_libmerged	2897932	2897965		YPO_RS13845	33
Gok2_libmerged	2898381	2898398		iolD	17
Gok2_libmerged	2898597	2898614		iolD	17
Gok2_libmerged	2899367	2899475		iolD	108
Gok2_libmerged	2899595	2899609		iolD	14
Gok2_libmerged	2899737	2899746		iolD	9
Gok2_libmerged	2899946	2899964		iolD	18
Gok2_libmerged	2900142	2900184		iolD	42
Gok2_libmerged	2901668	2901686		YPO_RS13860	18
Gok2_libmerged	2902232	2902249		YPO_RS13860	17
Gok2_libmerged	2902308	2902332		YPO_RS13860	24
Gok2_libmerged	2902469	2902477		YPO_RS13860	8
Gok2_libmerged	2902735	2902757		YPO_RS13865	22
Gok2_libmerged	2902922	2902974		YPO_RS13865	52
Gok2_libmerged	2903319	2903373		YPO_RS13865	54
Gok2_libmerged	2903486	2903520		YPO_RS13865	34
Gok2_libmerged	2904413	2904435		YPO_RS13870	22
Gok2_libmerged	2904517	2904546		YPO_RS13870	29
Gok2_libmerged	2904599	2904664		YPO_RS13870	65
Gok2_libmerged	2905705	2905739		YPO_RS13875	34
Gok2_libmerged	2905872	2905902		YPO_RS13875	30
Gok2_libmerged	2906046	2906095		YPO_RS13875	49
Gok2_libmerged	2906606	2906623		iolC	17
Gok2_libmerged	2907335	2907356		iolC	21
Gok2_libmerged	2907560	2907638		iolC	78
Gok2_libmerged	2909016	2909033		iolE	17
Gok2_libmerged	2909267	2909309		iolE	42
Gok2_libmerged	2909686	2909689		iolB	3
Gok2_libmerged	2909728	2909771		iolB	43
Gok2_libmerged	2909904	2909953		iolB	49
Gok2_libmerged	2910094	2910128		iolB	34
Gok2_libmerged	2910218	2910290		iolB	72
Gok2_libmerged	2910622	2910653		YPO_RS13895	31
Gok2_libmerged	2911047	2911061		YPO_RS13900	14
Gok2_libmerged	2911295	2911317		YPO_RS13900	22
Gok2_libmerged	2911386	2911388		YPO_RS13900	2
Gok2_libmerged	2911483	2911517		YPO_RS13900	34
Gok2_libmerged	2911753	2911756		YPO_RS13900	3
Gok2_libmerged	2911795	2911842		YPO_RS13900	47
Gok2_libmerged	2911952	2911971		YPO_RS13900	19
Gok2_libmerged	2913396	2913590		YPO_RS13910	194
Gok2_libmerged	2913608	2913650		YPO_RS13915	42
Gok2_libmerged	2913981	2914022		YPO_RS13920	41
Gok2_libmerged	2914103	2914322		YPO_RS13920	219
Gok2_libmerged	2914419	2914444		YPO_RS13920	25
Gok2_libmerged	2914611	2914703		YPO_RS13920	92
Gok2_libmerged	2914737	2914808		YPO_RS13920	71
Gok2_libmerged	2914868	2914877		YPO_RS13920	9
Gok2_libmerged	2915387	2915396		YPO_RS13925	9
Gok2_libmerged	2915474	2915551		YPO_RS13925	77
Gok2_libmerged	2915705	2915710		YPO_RS13925	5
Gok2_libmerged	2915754	2915857		YPO_RS13925	103
Gok2_libmerged	2915953	2915977		YPO_RS13925	24
Gok2_libmerged	2917054	2917088		cspE	34
Gok2_libmerged	2917686	2917757		crcB	71
Gok2_libmerged	2919359	2919402		lipA	43
Gok2_libmerged	2919783	2919794		lipA	11
Gok2_libmerged	2920523	2920558		lipB	35
Gok2_libmerged	2920690	2920704		lipB	14
Gok2_libmerged	2921200	2921239		YPO_RS13960	39
Gok2_libmerged	2921847	2921861		dacA	14
Gok2_libmerged	2922096	2922161		dacA	65
Gok2_libmerged	2922221	2922249		dacA	28
Gok2_libmerged	2922419	2922468		dacA	49
Gok2_libmerged	2922775	2922808		dacA	33
Gok2_libmerged	2923335	2923338		rlpA	3
Gok2_libmerged	2923612	2923629		rlpA	17
Gok2_libmerged	2923760	2923765		rlpA	5
Gok2_libmerged	2923812	2923857		rlpA	45
Gok2_libmerged	2924185	2924271		rlpA	86
Gok2_libmerged	2925157	2925162		mrdB	5
Gok2_libmerged	2925230	2925305		mrdB	75
Gok2_libmerged	2925642	2925643		mrdA	1
Gok2_libmerged	2925930	2925933		mrdA	3
Gok2_libmerged	2925964	2926088		mrdA	124
Gok2_libmerged	2926375	2926376		mrdA	1
Gok2_libmerged	2926488	2926501		mrdA	13
Gok2_libmerged	2926615	2926671		mrdA	56
Gok2_libmerged	2926729	2926858		mrdA	129
Gok2_libmerged	2926902	2926981		mrdA	79
Gok2_libmerged	2927159	2927161		mrdA	2
Gok2_libmerged	2927317	2927321		mrdA	4
Gok2_libmerged	2927577	2927595		rlmH	18
Gok2_libmerged	2928913	2928919		nadD	6
Gok2_libmerged	2928985	2928990		nadD	5
Gok2_libmerged	2929219	2929254		nadD	35
Gok2_libmerged	2929244	2929254		holA	10
Gok2_libmerged	2930457	2930464		lptE	7
Gok2_libmerged	2930707	2930742		lptE	35
Gok2_libmerged	2930913	2930965		leuS	52
Gok2_libmerged	2931757	2931790		leuS	33
Gok2_libmerged	2931891	2931942		leuS	51
Gok2_libmerged	2932210	2932211		leuS	1
Gok2_libmerged	2932295	2932332		leuS	37
Gok2_libmerged	2932429	2932457		leuS	28
Gok2_libmerged	2932537	2932556		leuS	19
Gok2_libmerged	2933053	2933112		leuS	59
Gok2_libmerged	2933186	2933188		leuS	2
Gok2_libmerged	2933379	2933387		leuS	8
Gok2_libmerged	2933807	2933822		YPO_RS14015	15
Gok2_libmerged	2934432	2934463		YPO_RS14020	31
Gok2_libmerged	2934544	2934558		YPO_RS14020	14
Gok2_libmerged	2934872	2934909		YPO_RS14020	37
Gok2_libmerged	2935549	2935563		gltK	14
Gok2_libmerged	2936013	2936031		YPO_RS14030	18
Gok2_libmerged	2936242	2936288		YPO_RS14030	46
Gok2_libmerged	2937110	2937114		YPO_RS14035	4
Gok2_libmerged	2938650	2938707		lnt	57
Gok2_libmerged	2938954	2938967		lnt	13
Gok2_libmerged	2939012	2939015		lnt	3
Gok2_libmerged	2939145	2939243		lnt	98
Gok2_libmerged	2939279	2939300		lnt	21
Gok2_libmerged	2939707	2939732		lnt	25
Gok2_libmerged	2940038	2940068		corC	30
Gok2_libmerged	2940117	2940159		corC	42
Gok2_libmerged	2940944	2940949		ybeY	5
Gok2_libmerged	2941025	2941041		ybeY	16
Gok2_libmerged	2941187	2941200		ybeY	13
Gok2_libmerged	2942308	2942383		YPO_RS14055	75
Gok2_libmerged	2942432	2942443		YPO_RS14055	11
Gok2_libmerged	2942794	2942818		miaB	24
Gok2_libmerged	2942855	2942871		miaB	16
Gok2_libmerged	2943457	2943461		miaB	4
Gok2_libmerged	2943700	2943728		miaB	28
Gok2_libmerged	2943849	2943868		miaB	19
Gok2_libmerged	2944000	2944010		miaB	10
Gok2_libmerged	2944062	2944068		miaB	6
Gok2_libmerged	2944174	2944212		miaB	38
Gok2_libmerged	2944845	2944917		ubiF	72
Gok2_libmerged	2944988	2944989		ubiF	1
Gok2_libmerged	2945585	2945617		ubiF	32
Gok2_libmerged	2946218	2946228		YPO_RS14080	10
Gok2_libmerged	2947531	2947547		asnB	16
Gok2_libmerged	2947871	2947882		asnB	11
Gok2_libmerged	2948263	2948292		asnB	29
Gok2_libmerged	2948574	2948612		asnB	38
Gok2_libmerged	2948991	2948993		YPO_RS14100	2
Gok2_libmerged	2949402	2949414		YPO_RS14100	12
Gok2_libmerged	2949464	2949470		YPO_RS14100	6
Gok2_libmerged	2949668	2949719		YPO_RS14100	51
Gok2_libmerged	2949872	2949896		YPO_RS14105	24
Gok2_libmerged	2950142	2950171		YPO_RS14105	29
Gok2_libmerged	2950340	2950350		YPO_RS14105	10
Gok2_libmerged	2950508	2950516		YPO_RS14105	8
Gok2_libmerged	2951035	2951040		nagA	5
Gok2_libmerged	2951278	2951279		nagA	1
Gok2_libmerged	2951938	2951950		nagA	12
Gok2_libmerged	2952037	2952064		nagA	27
Gok2_libmerged	2952428	2952466		nagB	38
Gok2_libmerged	2952521	2952558		nagB	37
Gok2_libmerged	2952948	2952954		nagB	6
Gok2_libmerged	2953400	2953411		YPO_RS14120	11
Gok2_libmerged	2953733	2953744		YPO_RS14120	11
Gok2_libmerged	2953904	2953992		YPO_RS14120	88
Gok2_libmerged	2954158	2954210		YPO_RS14120	52
Gok2_libmerged	2954499	2954503		YPO_RS14120	4
Gok2_libmerged	2955029	2955030		YPO_RS14120	1
Gok2_libmerged	2955117	2955143		YPO_RS14120	26
Gok2_libmerged	2955698	2955755		YPO_RS14125	57
Gok2_libmerged	2955885	2955924		YPO_RS14125	39
Gok2_libmerged	2956100	2956120		YPO_RS14125	20
Gok2_libmerged	2956633	2956641		glnS	8
Gok2_libmerged	2957006	2957041		glnS	35
Gok2_libmerged	2957158	2957171		glnS	13
Gok2_libmerged	2957550	2957552		glnS	2
Gok2_libmerged	2959023	2959024		YPO_RS14135	1
Gok2_libmerged	2959228	2959248		YPO_RS14135	20
Gok2_libmerged	2959977	2960033		YPO_RS14135	56
Gok2_libmerged	2963650	2963687		fur	37
Gok2_libmerged	2964682	2964688		fldA	6
Gok2_libmerged	2966136	2966146		ybfF	10
Gok2_libmerged	2966256	2966262		ybfF	6
Gok2_libmerged	2966450	2966496		ybfF	46
Gok2_libmerged	2966540	2966547		ybfF	7
Gok2_libmerged	2966604	2966628		ybfF	24
Gok2_libmerged	2967439	2967447		YPO_RS14165	8
Gok2_libmerged	2967662	2967690		YPO_RS14165	28
Gok2_libmerged	2967853	2967883		YPO_RS14170	30
Gok2_libmerged	2969189	2969199		YPO_RS14185	10
Gok2_libmerged	2969542	2969545		YPO_RS14185	3
Gok2_libmerged	2969776	2969874		YPO_RS14190	98
Gok2_libmerged	2970024	2970111		YPO_RS14190	87
Gok2_libmerged	2970227	2970262		YPO_RS14190	35
Gok2_libmerged	2970392	2970449		YPO_RS14190	57
Gok2_libmerged	2970521	2970637		YPO_RS14190	116
Gok2_libmerged	2970693	2970732		YPO_RS14190	39
Gok2_libmerged	2971845	2971885		proX	40
Gok2_libmerged	2972344	2972499		proX	155
Gok2_libmerged	2972694	2972725		proX	31
Gok2_libmerged	2973002	2973015		proW	13
Gok2_libmerged	2973267	2973275		proW	8
Gok2_libmerged	2974043	2974063		proV	20
Gok2_libmerged	2974102	2974106		proV	4
Gok2_libmerged	2974682	2974687		proV	5
Gok2_libmerged	2974743	2974885		proV	142
Gok2_libmerged	2975101	2975155		proV	54
Gok2_libmerged	2976048	2976103		nrdF	55
Gok2_libmerged	2976183	2976205		nrdF	22
Gok2_libmerged	2976323	2976327		nrdF	4
Gok2_libmerged	2976486	2976493		nrdF	7
Gok2_libmerged	2976818	2976828		nrdF	10
Gok2_libmerged	2977110	2977127		nrdE	17
Gok2_libmerged	2977220	2977226		nrdE	6
Gok2_libmerged	2977310	2977312		nrdE	2
Gok2_libmerged	2977350	2977367		nrdE	17
Gok2_libmerged	2977897	2977912		nrdE	15
Gok2_libmerged	2978766	2978771		nrdE	5
Gok2_libmerged	2978912	2978917		nrdE	5
Gok2_libmerged	2979150	2979210		nrdI	60
Gok2_libmerged	2979612	2979686		YPO_RS14230	74
Gok2_libmerged	2980313	2980359		YPO_RS14235	46
Gok2_libmerged	2981146	2981339		YPO_RS14240	193
Gok2_libmerged	2981561	2981594		YPO_RS14245	33
Gok2_libmerged	2981966	2981982		YPO_RS14245	16
Gok2_libmerged	2982429	2982442		YPO_RS14250	13
Gok2_libmerged	2982513	2982527		YPO_RS14250	14
Gok2_libmerged	2982585	2982590		YPO_RS14250	5
Gok2_libmerged	2982715	2982721		YPO_RS14250	6
Gok2_libmerged	2982977	2983015		YPO_RS14250	38
Gok2_libmerged	2983129	2983136		YPO_RS14250	7
Gok2_libmerged	2984316	2984325		cspA	9
Gok2_libmerged	2986003	2986049		YPO_RS14265	46
Gok2_libmerged	2986245	2986395		YPO_RS14265	150
Gok2_libmerged	2986613	2986653		YPO_RS14265	40
Gok2_libmerged	2987162	2987164		YPO_RS14270	2
Gok2_libmerged	2987498	2987516		YPO_RS14270	18
Gok2_libmerged	2987574	2987584		YPO_RS14270	10
Gok2_libmerged	2987749	2987780		YPO_RS14270	31
Gok2_libmerged	2987885	2987911		YPO_RS14270	26
Gok2_libmerged	2987973	2988035		YPO_RS14275	62
Gok2_libmerged	2988226	2988245		YPO_RS14275	19
Gok2_libmerged	2988863	2988903		YPO_RS14280	40
Gok2_libmerged	2989059	2989077		YPO_RS14280	18
Gok2_libmerged	2989167	2989248		YPO_RS14280	81
Gok2_libmerged	2989292	2989298		YPO_RS14280	6
Gok2_libmerged	2989338	2989343		YPO_RS14280	5
Gok2_libmerged	2989735	2989744		YPO_RS14285	9
Gok2_libmerged	2989848	2989904		YPO_RS14285	56
Gok2_libmerged	2990016	2990021		YPO_RS14285	5
Gok2_libmerged	2990114	2990126		YPO_RS14285	12
Gok2_libmerged	2990159	2990217		YPO_RS14285	58
Gok2_libmerged	2991416	2991437		YPO_RS14290	21
Gok2_libmerged	2991717	2991718		YPO_RS14290	1
Gok2_libmerged	2992099	2992128		YPO_RS14295	29
Gok2_libmerged	2992365	2992387		YPO_RS14300	22
Gok2_libmerged	2992495	2992496		YPO_RS14300	1
Gok2_libmerged	2993039	2993143		YPO_RS14300	104
Gok2_libmerged	2993532	2993545		YPO_RS14300	13
Gok2_libmerged	2993889	2993920		YPO_RS14300	31
Gok2_libmerged	2994310	2994311		ureE	1
Gok2_libmerged	2994534	2994586		ureE	52
Gok2_libmerged	2994949	2994967		ureE	18
Gok2_libmerged	2995198	2995227		YPO_RS14310	29
Gok2_libmerged	2995288	2995314		YPO_RS14310	26
Gok2_libmerged	2995839	2995863		ureG	24
Gok2_libmerged	2996214	2996322		ureG	108
Gok2_libmerged	2996469	2996495		ureG	26
Gok2_libmerged	2997788	2997809		yut	21
Gok2_libmerged	2997906	2997935		yut	29
Gok2_libmerged	2997996	2998028		yut	32
Gok2_libmerged	2998354	2998392		yut	38
Gok2_libmerged	2998896	2998909		YPO_RS14330	13
Gok2_libmerged	2998988	2999014		YPO_RS14330	26
Gok2_libmerged	2999245	2999276		YPO_RS14330	31
Gok2_libmerged	2999370	2999391		YPO_RS14330	21
Gok2_libmerged	2999747	2999855		YPO_RS14330	108
Gok2_libmerged	3000024	3000028		hdeB	4
Gok2_libmerged	3000158	3000215		hdeB	57
Gok2_libmerged	3000275	3000353		hdeB	78
Gok2_libmerged	3001424	3001483		kch	59
Gok2_libmerged	3001589	3001591		kch	2
Gok2_libmerged	3001695	3001723		kch	28
Gok2_libmerged	3001860	3001900		kch	40
Gok2_libmerged	3002251	3002273		crcB	22
Gok2_libmerged	3002427	3002505		crcB	78
Gok2_libmerged	3002885	3002914		crcB	29
Gok2_libmerged	3003026	3003044		crcB	18
Gok2_libmerged	3003133	3003182		YPO_RS14355	49
Gok2_libmerged	3003220	3003312		YPO_RS14355	92
Gok2_libmerged	3004085	3004098		YPO_RS14360	13
Gok2_libmerged	3004178	3004187		YPO_RS14360	9
Gok2_libmerged	3004472	3004556		chbC	84
Gok2_libmerged	3005518	3005523		chbC	5
Gok2_libmerged	3005952	3005959		chbA	7
Gok2_libmerged	3006050	3006081		chbA	31
Gok2_libmerged	3006343	3006352		chbR	9
Gok2_libmerged	3006449	3006483		chbR	34
Gok2_libmerged	3006533	3006637		chbR	104
Gok2_libmerged	3006750	3006751		chbR	1
Gok2_libmerged	3006969	3007033		chbR	64
Gok2_libmerged	3007149	3007167		chbR	18
Gok2_libmerged	3007219	3007268		chbG	49
Gok2_libmerged	3007565	3007579		chbG	14
Gok2_libmerged	3007703	3007716		chbG	13
Gok2_libmerged	3008511	3008520		YPO_RS14385	9
Gok2_libmerged	3009138	3009143		seqA	5
Gok2_libmerged	3009258	3009303		seqA	45
Gok2_libmerged	3009361	3009380		seqA	19
Gok2_libmerged	3009638	3009642		seqA	4
Gok2_libmerged	3010086	3010121		pgm	35
Gok2_libmerged	3010503	3010509		pgm	6
Gok2_libmerged	3010759	3010763		pgm	4
Gok2_libmerged	3010874	3010952		pgm	78
Gok2_libmerged	3011822	3011828		YPO_RS14400	6
Gok2_libmerged	3011893	3011997		YPO_RS14400	104
Gok2_libmerged	3012247	3012265		YPO_RS14405	18
Gok2_libmerged	3012344	3012356		YPO_RS14405	12
Gok2_libmerged	3012721	3012738		kdpE	17
Gok2_libmerged	3013021	3013038		kdpE	17
Gok2_libmerged	3013083	3013086		kdpE	3
Gok2_libmerged	3013217	3013225		kdpE	8
Gok2_libmerged	3013275	3013315		kdpE	40
Gok2_libmerged	3013607	3013618		kdbD	11
Gok2_libmerged	3014090	3014134		kdbD	44
Gok2_libmerged	3014336	3014353		kdbD	17
Gok2_libmerged	3014515	3014551		kdbD	36
Gok2_libmerged	3014898	3014901		kdbD	3
Gok2_libmerged	3014998	3015036		kdbD	38
Gok2_libmerged	3017464	3017510		kdpB	46
Gok2_libmerged	3018058	3018071		kdpB	13
Gok2_libmerged	3018628	3018648		kdpB	20
Gok2_libmerged	3018948	3018966		kdpB	18
Gok2_libmerged	3019073	3019085		kdpB	12
Gok2_libmerged	3019328	3019337		kdpA	9
Gok2_libmerged	3019506	3019533		kdpA	27
Gok2_libmerged	3019749	3019805		kdpA	56
Gok2_libmerged	3020396	3020429		kdpA	33
Gok2_libmerged	3020882	3020888		kdpA	6
Gok2_libmerged	3021064	3021167		YPO_RS14440	103
Gok2_libmerged	3021296	3021297		YPO_RS14440	1
Gok2_libmerged	3021463	3021492		YPO_RS14445	29
Gok2_libmerged	3022086	3022098		YPO_RS14450	12
Gok2_libmerged	3022267	3022347		YPO_RS14450	80
Gok2_libmerged	3022485	3022490		YPO_RS14450	5
Gok2_libmerged	3023322	3023336		phrB	14
Gok2_libmerged	3023454	3023517		phrB	63
Gok2_libmerged	3024040	3024083		phrB	43
Gok2_libmerged	3024074	3024109		YPO_RS14460	35
Gok2_libmerged	3024286	3024299		YPO_RS14460	13
Gok2_libmerged	3024697	3024736		YPO_RS14460	39
Gok2_libmerged	3024843	3024949		YPO_RS14460	106
Gok2_libmerged	3026092	3026183		YPO_RS14470	91
Gok2_libmerged	3027264	3027334		YPO_RS14480	70
Gok2_libmerged	3027585	3027623		YPO_RS14480	38
Gok2_libmerged	3027661	3027671		YPO_RS14480	10
Gok2_libmerged	3028089	3028199		YPO_RS14480	110
Gok2_libmerged	3028196	3028236		pxpA	40
Gok2_libmerged	3028512	3028513		pxpA	1
Gok2_libmerged	3029197	3029212		YPO_RS14490	15
Gok2_libmerged	3029303	3029387		YPO_RS14490	84
Gok2_libmerged	3029861	3029866		YPO_RS14495	5
Gok2_libmerged	3030450	3030481		YPO_RS14495	31
Gok2_libmerged	3030834	3030855		pcp	21
Gok2_libmerged	3030958	3030994		pcp	36
Gok2_libmerged	3031163	3031275		pcp	112
Gok2_libmerged	3031710	3031712		ung	2
Gok2_libmerged	3032086	3032134		ung	48
Gok2_libmerged	3032592	3032594		grcA	2
Gok2_libmerged	3033282	3033343		YPO_RS14515	61
Gok2_libmerged	3033407	3033445		YPO_RS14515	38
Gok2_libmerged	3033550	3033561		YPO_RS14515	11
Gok2_libmerged	3034067	3034076		YPO_RS14515	9
Gok2_libmerged	3034587	3034643		YPO_RS14520	56
Gok2_libmerged	3035065	3035092		srmB	27
Gok2_libmerged	3035682	3035724		srmB	42
Gok2_libmerged	3036259	3036266		srmB	7
Gok2_libmerged	3036518	3036520		YPO_RS14530	2
Gok2_libmerged	3036691	3036732		YPO_RS14530	41
Gok2_libmerged	3036805	3036824		YPO_RS14530	19
Gok2_libmerged	3037260	3037264		YPO_RS14530	4
Gok2_libmerged	3037607	3037613		nadB	6
Gok2_libmerged	3037994	3038026		nadB	32
Gok2_libmerged	3038388	3038416		nadB	28
Gok2_libmerged	3038617	3038696		nadB	79
Gok2_libmerged	3038882	3038883		nadB	1
Gok2_libmerged	3039006	3039073		nadB	67
Gok2_libmerged	3039142	3039184		nadB	42
Gok2_libmerged	3039552	3039555		rpoE	3
Gok2_libmerged	3039666	3039678		rpoE	12
Gok2_libmerged	3040758	3040774		rseB	16
Gok2_libmerged	3041378	3041412		rseB	34
Gok2_libmerged	3041813	3041878		rseC	65
Gok2_libmerged	3042025	3042037		rseC	12
Gok2_libmerged	3042085	3042490		YPO_RS14560	405
Gok2_libmerged	3042533	3042661		YPO_RS14560	128
Gok2_libmerged	3042904	3042912		YPO_RS14560	8
Gok2_libmerged	3043571	3043582		lepA	11
Gok2_libmerged	3044036	3044059		lepA	23
Gok2_libmerged	3044110	3044156		lepA	46
Gok2_libmerged	3044634	3044676		lepA	42
Gok2_libmerged	3044732	3044775		lepA	43
Gok2_libmerged	3045103	3045104		lepA	1
Gok2_libmerged	3045221	3045250		lepB	29
Gok2_libmerged	3045328	3045329		lepB	1
Gok2_libmerged	3045384	3045417		lepB	33
Gok2_libmerged	3045703	3045728		lepB	25
Gok2_libmerged	3046032	3046047		lepB	15
Gok2_libmerged	3046140	3046151		lepB	11
Gok2_libmerged	3047016	3047023		rnc	7
Gok2_libmerged	3047658	3047698		YPO_RS14580	40
Gok2_libmerged	3048337	3048341		recO	4
Gok2_libmerged	3048419	3048424		recO	5
Gok2_libmerged	3048575	3048576		recO	1
Gok2_libmerged	3048620	3048646		recO	26
Gok2_libmerged	3048694	3048695		recO	1
Gok2_libmerged	3049121	3049130		YPO_RS14590	9
Gok2_libmerged	3049216	3049228		YPO_RS14590	12
Gok2_libmerged	3049500	3049547		YPO_RS14590	47
Gok2_libmerged	3050196	3050235		YPO_RS14595	39
Gok2_libmerged	3050347	3050382		YPO_RS14595	35
Gok2_libmerged	3050818	3050822		YPO_RS14595	4
Gok2_libmerged	3050838	3050887		tssL	49
Gok2_libmerged	3051097	3051199		tssL	102
Gok2_libmerged	3051424	3051435		tssL	11
Gok2_libmerged	3051502	3051555		tssL	53
Gok2_libmerged	3051887	3051918		tssM	31
Gok2_libmerged	3052009	3052063		tssM	54
Gok2_libmerged	3052391	3052404		tssM	13
Gok2_libmerged	3052491	3052495		tssM	4
Gok2_libmerged	3052812	3052826		tssM	14
Gok2_libmerged	3052954	3052983		tssM	29
Gok2_libmerged	3053042	3053147		tssM	105
Gok2_libmerged	3053325	3053343		tssM	18
Gok2_libmerged	3053404	3053426		tssM	22
Gok2_libmerged	3053679	3053708		tssM	29
Gok2_libmerged	3053954	3053990		tssM	36
Gok2_libmerged	3054191	3054200		tssM	9
Gok2_libmerged	3054681	3054686		tssM	5
Gok2_libmerged	3054969	3055166		tssM	197
Gok2_libmerged	3056103	3056239		YPO_RS14610	136
Gok2_libmerged	3056771	3056784		YPO_RS14610	13
Gok2_libmerged	3056914	3056951		YPO_RS14610	37
Gok2_libmerged	3057007	3057020		YPO_RS14610	13
Gok2_libmerged	3057243	3057265		YPO_RS14610	22
Gok2_libmerged	3057460	3057466		YPO_RS14610	6
Gok2_libmerged	3057575	3057650		YPO_RS14610	75
Gok2_libmerged	3057785	3057818		YPO_RS14610	33
Gok2_libmerged	3057913	3057943		YPO_RS14610	30
Gok2_libmerged	3058276	3058321		YPO_RS14610	45
Gok2_libmerged	3058443	3058449		YPO_RS14610	6
Gok2_libmerged	3058489	3058499		YPO_RS14610	10
Gok2_libmerged	3058724	3058759		YPO_RS14615	35
Gok2_libmerged	3058937	3059076		YPO_RS14620	139
Gok2_libmerged	3059229	3059299		YPO_RS14620	70
Gok2_libmerged	3059561	3059612		YPO_RS14620	51
Gok2_libmerged	3059702	3059707		YPO_RS14620	5
Gok2_libmerged	3059765	3059776		YPO_RS14620	11
Gok2_libmerged	3060588	3060602		YPO_RS14625	14
Gok2_libmerged	3060822	3060824		YPO_RS14630	2
Gok2_libmerged	3061137	3061144		YPO_RS14630	7
Gok2_libmerged	3061334	3061402		YPO_RS14635	68
Gok2_libmerged	3061465	3061550		YPO_RS14635	85
Gok2_libmerged	3062339	3062340		YPO_RS14645	1
Gok2_libmerged	3062653	3062661		YPO_RS14645	8
Gok2_libmerged	3063484	3063512		YPO_RS14645	28
Gok2_libmerged	3063900	3063928		YPO_RS14645	28
Gok2_libmerged	3064411	3064437		YPO_RS14650	26
Gok2_libmerged	3065526	3065581		YPO_RS14660	55
Gok2_libmerged	3065635	3065763		YPO_RS14660	128
Gok2_libmerged	3065803	3065882		YPO_RS14660	79
Gok2_libmerged	3065941	3065942		YPO_RS14660	1
Gok2_libmerged	3065953	3065978		YPO_RS14660	25
Gok2_libmerged	3066504	3066507		ccmA	3
Gok2_libmerged	3066554	3066573		ccmA	19
Gok2_libmerged	3066795	3066816		ccmA	21
Gok2_libmerged	3067353	3067390		ccmB	37
Gok2_libmerged	3067427	3067451		ccmB	24
Gok2_libmerged	3067485	3067490		ccmB	5
Gok2_libmerged	3067786	3067804		YPO_RS14675	18
Gok2_libmerged	3068953	3068955		ccmE	2
Gok2_libmerged	3069048	3069074		ccmE	26
Gok2_libmerged	3069158	3069183		ccmE	25
Gok2_libmerged	3069478	3069487		YPO_RS14690	9
Gok2_libmerged	3069585	3069620		YPO_RS14690	35
Gok2_libmerged	3069739	3069756		YPO_RS14690	17
Gok2_libmerged	3070156	3070206		YPO_RS14690	50
Gok2_libmerged	3070487	3070523		YPO_RS14690	36
Gok2_libmerged	3070965	3070987		YPO_RS14690	22
Gok2_libmerged	3071424	3071430		YPO_RS14695	6
Gok2_libmerged	3071488	3071556		YPO_RS14695	68
Gok2_libmerged	3071650	3071683		YPO_RS14695	33
Gok2_libmerged	3072148	3072197		YPO_RS14700	49
Gok2_libmerged	3072320	3072349		YPO_RS14700	29
Gok2_libmerged	3072698	3072710		ccmI	12
Gok2_libmerged	3073030	3073031		ccmI	1
Gok2_libmerged	3073284	3073300		ccmI	16
Gok2_libmerged	3073555	3073569		ccmI	14
Gok2_libmerged	3073614	3073637		mlaA	23
Gok2_libmerged	3073846	3073854		mlaA	8
Gok2_libmerged	3074559	3074624		fadL	65
Gok2_libmerged	3075008	3075021		fadL	13
Gok2_libmerged	3075105	3075129		fadL	24
Gok2_libmerged	3075509	3075532		fadL	23
Gok2_libmerged	3077417	3077457		fadI	40
Gok2_libmerged	3077662	3077679		fadI	17
Gok2_libmerged	3077745	3077768		fadI	23
Gok2_libmerged	3077867	3077964		fadI	97
Gok2_libmerged	3078226	3078290		fadJ	64
Gok2_libmerged	3078834	3078861		fadJ	27
Gok2_libmerged	3079335	3079370		fadJ	35
Gok2_libmerged	3079513	3079546		fadJ	33
Gok2_libmerged	3079914	3079938		fadJ	24
Gok2_libmerged	3079977	3080028		fadJ	51
Gok2_libmerged	3081075	3081080		sixA	5
Gok2_libmerged	3082165	3082184		smrB	19
Gok2_libmerged	3082315	3082357		smrB	42
Gok2_libmerged	3082965	3082968		prmB	3
Gok2_libmerged	3083101	3083138		prmB	37
Gok2_libmerged	3083358	3083374		prmB	16
Gok2_libmerged	3083552	3083621		prmB	69
Gok2_libmerged	3083925	3083945		aroC	20
Gok2_libmerged	3084410	3084458		aroC	48
Gok2_libmerged	3084630	3084661		aroC	31
Gok2_libmerged	3085461	3085503		mepA	42
Gok2_libmerged	3086003	3086055		YPO_RS14760	52
Gok2_libmerged	3086230	3086364		YPO_RS14760	134
Gok2_libmerged	3087005	3087024		YPO_RS14765	19
Gok2_libmerged	3087164	3087166		YPO_RS14770	2
Gok2_libmerged	3087395	3087417		YPO_RS14770	22
Gok2_libmerged	3087634	3087663		mnmC	29
Gok2_libmerged	3088337	3088350		mnmC	13
Gok2_libmerged	3088692	3088719		mnmC	27
Gok2_libmerged	3088830	3088847		mnmC	17
Gok2_libmerged	3089121	3089225		mnmC	104
Gok2_libmerged	3089271	3089287		mnmC	16
Gok2_libmerged	3089456	3089487		mnmC	31
Gok2_libmerged	3089599	3089611		mnmC	12
Gok2_libmerged	3089891	3089994		fabB	103
Gok2_libmerged	3090543	3090554		fabB	11
Gok2_libmerged	3090918	3090919		fabB	1
Gok2_libmerged	3091059	3091070		fabB	11
Gok2_libmerged	3091492	3091507		YPO_RS14785	15
Gok2_libmerged	3092124	3092184		YPO_RS14785	60
Gok2_libmerged	3092975	3092998		YPO_RS14790	23
Gok2_libmerged	3093930	3093933		YPO_RS14795	3
Gok2_libmerged	3093989	3093997		YPO_RS14795	8
Gok2_libmerged	3094172	3094177		YPO_RS14795	5
Gok2_libmerged	3094285	3094369		YPO_RS14795	84
Gok2_libmerged	3094510	3094565		YPO_RS14795	55
Gok2_libmerged	3094838	3094845		YPO_RS14795	7
Gok2_libmerged	3095311	3095329		YPO_RS14800	18
Gok2_libmerged	3095384	3095406		YPO_RS14800	22
Gok2_libmerged	3095701	3095713		YPO_RS14800	12
Gok2_libmerged	3095882	3095950		YPO_RS14800	68
Gok2_libmerged	3096638	3096658		YPO_RS14805	20
Gok2_libmerged	3096871	3096880		YPO_RS14805	9
Gok2_libmerged	3097621	3097753		pdxB	132
Gok2_libmerged	3098445	3098533		YPO_RS14815	88
Gok2_libmerged	3098603	3098662		YPO_RS14815	59
Gok2_libmerged	3098746	3098757		YPO_RS14815	11
Gok2_libmerged	3099304	3099332		YPO_RS14820	28
Gok2_libmerged	3100631	3100644		truA	13
Gok2_libmerged	3100766	3100780		truA	14
Gok2_libmerged	3101221	3101249		YPO_RS14830	28
Gok2_libmerged	3101545	3101555		YPO_RS14830	10
Gok2_libmerged	3101687	3101789		YPO_RS14830	102
Gok2_libmerged	3102184	3102190		accD	6
Gok2_libmerged	3102702	3102709		accD	7
Gok2_libmerged	3103740	3103773		folC	33
Gok2_libmerged	3103974	3103976		folC	2
Gok2_libmerged	3104540	3104560		folC	20
Gok2_libmerged	3104713	3104724		dedD	11
Gok2_libmerged	3104872	3104877		dedD	5
Gok2_libmerged	3105368	3105402		dedD	34
Gok2_libmerged	3105834	3105883		cvpA	49
Gok2_libmerged	3106139	3106176		cvpA	37
Gok2_libmerged	3106474	3106481		purF	7
Gok2_libmerged	3107189	3107203		purF	14
Gok2_libmerged	3108158	3108163		YPO_RS14860	5
Gok2_libmerged	3108449	3108502		YPO_RS14860	53
Gok2_libmerged	3108560	3108572		YPO_RS14860	12
Gok2_libmerged	3109101	3109126		hisJ	25
Gok2_libmerged	3109663	3109740		hisJ	77
Gok2_libmerged	3110207	3110215		YPO_RS14870	8
Gok2_libmerged	3110379	3110411		YPO_RS14870	32
Gok2_libmerged	3110761	3110793		YPO_RS14875	32
Gok2_libmerged	3110834	3110871		YPO_RS14875	37
Gok2_libmerged	3111787	3111812		hisP	25
Gok2_libmerged	3111917	3111926		hisP	9
Gok2_libmerged	3111981	3112049		hisP	68
Gok2_libmerged	3112079	3112095		hisP	16
Gok2_libmerged	3112507	3112522		YPO_RS14885	15
Gok2_libmerged	3112556	3112566		YPO_RS14885	10
Gok2_libmerged	3112722	3112737		YPO_RS14885	15
Gok2_libmerged	3112830	3112887		YPO_RS14885	57
Gok2_libmerged	3113578	3113590		YPO_RS14890	12
Gok2_libmerged	3113713	3113717		YPO_RS14890	4
Gok2_libmerged	3113950	3113995		YPO_RS14890	45
Gok2_libmerged	3114095	3114119		YPO_RS14890	24
Gok2_libmerged	3114523	3114524		yfcE	1
Gok2_libmerged	3114638	3114641		yfcE	3
Gok2_libmerged	3114780	3114788		yfcE	8
Gok2_libmerged	3114964	3115014		yfcE	50
Gok2_libmerged	3115489	3115507		yfcD	18
Gok2_libmerged	3116072	3116086		YPO_RS14905	14
Gok2_libmerged	3116444	3116501		YPO_RS14905	57
Gok2_libmerged	3116540	3116570		YPO_RS14905	30
Gok2_libmerged	3116612	3116659		YPO_RS14905	47
Gok2_libmerged	3116954	3116961		YPO_RS14905	7
Gok2_libmerged	3117070	3117124		YPO_RS14905	54
Gok2_libmerged	3117696	3117702		YPO_RS14910	6
Gok2_libmerged	3117807	3117830		YPO_RS14910	23
Gok2_libmerged	3117873	3117891		YPO_RS14910	18
Gok2_libmerged	3118110	3118154		YPO_RS14910	44
Gok2_libmerged	3118322	3118338		YPO_RS14910	16
Gok2_libmerged	3120557	3120561		YPO_RS14920	4
Gok2_libmerged	3121234	3121283		YPO_RS14925	49
Gok2_libmerged	3121315	3121400		YPO_RS14925	85
Gok2_libmerged	3121603	3121665		YPO_RS14925	62
Gok2_libmerged	3122150	3122484		YPO_RS14930	334
Gok2_libmerged	3122732	3122737		YPO_RS14935	5
Gok2_libmerged	3122835	3122945		YPO_RS14935	110
Gok2_libmerged	3123007	3123063		YPO_RS14935	56
Gok2_libmerged	3123157	3123395		YPO_RS14940	238
Gok2_libmerged	3123431	3123500		YPO_RS14940	69
Gok2_libmerged	3123579	3123605		YPO_RS14940	26
Gok2_libmerged	3123687	3123702		YPO_RS14940	15
Gok2_libmerged	3123887	3123910		YPO_RS14945	23
Gok2_libmerged	3123950	3123977		YPO_RS14945	27
Gok2_libmerged	3124016	3124030		YPO_RS14950	14
Gok2_libmerged	3125064	3125100		yapC	36
Gok2_libmerged	3125263	3125267		yapC	4
Gok2_libmerged	3125491	3125538		yapC	47
Gok2_libmerged	3125700	3125701		yapC	1
Gok2_libmerged	3125803	3125817		yapC	14
Gok2_libmerged	3125914	3125952		yapC	38
Gok2_libmerged	3126034	3126058		yapC	24
Gok2_libmerged	3126222	3126225		yapC	3
Gok2_libmerged	3126324	3126369		yapC	45
Gok2_libmerged	3126429	3126475		yapC	46
Gok2_libmerged	3126818	3126978		yapC	160
Gok2_libmerged	3127200	3127226		YPO_RS14960	26
Gok2_libmerged	3128074	3128096		YPO_RS14965	22
Gok2_libmerged	3128592	3128609		YPO_RS14975	17
Gok2_libmerged	3128705	3128743		YPO_RS14975	38
Gok2_libmerged	3129441	3129449		YPO_RS14975	8
Gok2_libmerged	3129636	3129654		YPO_RS14975	18
Gok2_libmerged	3130195	3130220		YPO_RS14980	25
Gok2_libmerged	3130755	3130830		YPO_RS14980	75
Gok2_libmerged	3130971	3130986		YPO_RS14980	15
Gok2_libmerged	3131341	3131356		YPO_RS14980	15
Gok2_libmerged	3131507	3131528		YPO_RS14980	21
Gok2_libmerged	3131769	3131811		YPO_RS14980	42
Gok2_libmerged	3132287	3132292		YPO_RS14980	5
Gok2_libmerged	3132391	3132415		YPO_RS14985	24
Gok2_libmerged	3132484	3132520		YPO_RS14985	36
Gok2_libmerged	3132619	3132623		YPO_RS14985	4
Gok2_libmerged	3133047	3133068		YPO_RS14990	21
Gok2_libmerged	3133587	3133594		YPO_RS14990	7
Gok2_libmerged	3133826	3133843		YPO_RS14990	17
Gok2_libmerged	3133903	3133923		YPO_RS14990	20
Gok2_libmerged	3134130	3134153		YPO_RS14990	23
Gok2_libmerged	3134296	3134304		YPO_RS14990	8
Gok2_libmerged	3134465	3134478		YPO_RS14990	13
Gok2_libmerged	3134634	3134658		YPO_RS14990	24
Gok2_libmerged	3134880	3134935		YPO_RS14990	55
Gok2_libmerged	3135240	3135241		YPO_RS14990	1
Gok2_libmerged	3135507	3135574		YPO_RS14995	67
Gok2_libmerged	3136416	3136419		YPO_RS14995	3
Gok2_libmerged	3136663	3136699		YPO_RS14995	36
Gok2_libmerged	3136906	3136930		YPO_RS14995	24
Gok2_libmerged	3137091	3137135		YPO_RS14995	44
Gok2_libmerged	3137608	3137612		YPO_RS15000	4
Gok2_libmerged	3138026	3138085		YPO_RS15000	59
Gok2_libmerged	3138485	3138492		YPO_RS15005	7
Gok2_libmerged	3138547	3138575		YPO_RS15005	28
Gok2_libmerged	3138863	3138880		YPO_RS15005	17
Gok2_libmerged	3139070	3139074		YPO_RS15005	4
Gok2_libmerged	3139569	3139593		YPO_RS15010	24
Gok2_libmerged	3140023	3140138		YPO_RS15010	115
Gok2_libmerged	3140654	3140662		YPO_RS15015	8
Gok2_libmerged	3140713	3140723		YPO_RS15015	10
Gok2_libmerged	3140900	3140903		YPO_RS15015	3
Gok2_libmerged	3141031	3141042		YPO_RS15015	11
Gok2_libmerged	3141235	3141254		YPO_RS15015	19
Gok2_libmerged	3141713	3141724		YPO_RS15020	11
Gok2_libmerged	3141868	3141928		YPO_RS15020	60
Gok2_libmerged	3142776	3142807		YPO_RS15025	31
Gok2_libmerged	3142988	3142989		YPO_RS15025	1
Gok2_libmerged	3143086	3143093		YPO_RS15030	7
Gok2_libmerged	3143151	3143159		YPO_RS15030	8
Gok2_libmerged	3143312	3143322		YPO_RS15030	10
Gok2_libmerged	3143517	3143541		YPO_RS15035	24
Gok2_libmerged	3144221	3144224		YPO_RS15035	3
Gok2_libmerged	3145062	3145064		YPO_RS15040	2
Gok2_libmerged	3146168	3146191		YPO_RS15040	23
Gok2_libmerged	3146342	3146375		YPO_RS15040	33
Gok2_libmerged	3146445	3146473		YPO_RS15040	28
Gok2_libmerged	3146779	3146784		YPO_RS15045	5
Gok2_libmerged	3146960	3146965		YPO_RS15045	5
Gok2_libmerged	3147282	3147288		YPO_RS15050	6
Gok2_libmerged	3147598	3147646		YPO_RS15050	48
Gok2_libmerged	3147815	3147818		YPO_RS15050	3
Gok2_libmerged	3148168	3148231		YPO_RS15055	63
Gok2_libmerged	3148298	3148324		YPO_RS15055	26
Gok2_libmerged	3148493	3148514		YPO_RS15055	21
Gok2_libmerged	3149111	3149125		YPO_RS15060	14
Gok2_libmerged	3149244	3149256		YPO_RS15060	12
Gok2_libmerged	3149525	3149540		YPO_RS15065	15
Gok2_libmerged	3149934	3150004		YPO_RS15070	70
Gok2_libmerged	3150147	3150159		YPO_RS15070	12
Gok2_libmerged	3150516	3150545		YPO_RS15075	29
Gok2_libmerged	3150586	3150587		YPO_RS15075	1
Gok2_libmerged	3150639	3150693		YPO_RS15075	54
Gok2_libmerged	3151475	3151504		YPO_RS15085	29
Gok2_libmerged	3151592	3151606		YPO_RS15085	14
Gok2_libmerged	3151683	3151693		YPO_RS15090	10
Gok2_libmerged	3152348	3152349		folD	1
Gok2_libmerged	3153056	3153060		ybcJ	4
Gok2_libmerged	3153235	3153258		YPO_RS15105	23
Gok2_libmerged	3153326	3153336		YPO_RS15105	10
Gok2_libmerged	3153594	3153633		YPO_RS15105	39
Gok2_libmerged	3153907	3153933		upp	26
Gok2_libmerged	3154035	3154071		upp	36
Gok2_libmerged	3154209	3154232		upp	23
Gok2_libmerged	3154448	3154466		upp	18
Gok2_libmerged	3154891	3154928		purM	37
Gok2_libmerged	3154959	3154970		purM	11
Gok2_libmerged	3155133	3155136		purM	3
Gok2_libmerged	3155307	3155315		purM	8
Gok2_libmerged	3155479	3155511		purM	32
Gok2_libmerged	3156022	3156038		purN	16
Gok2_libmerged	3156229	3156323		purN	94
Gok2_libmerged	3157021	3157036		speG	15
Gok2_libmerged	3157276	3157409		speG	133
Gok2_libmerged	3158981	3159012		pstB	31
Gok2_libmerged	3159071	3159094		pstB	23
Gok2_libmerged	3159400	3159416		pstB	16
Gok2_libmerged	3159612	3159618		pstB	6
Gok2_libmerged	3159785	3159787		pstA	2
Gok2_libmerged	3160327	3160407		pstA	80
Gok2_libmerged	3160503	3160536		pstA	33
Gok2_libmerged	3160714	3160720		pstA	6
Gok2_libmerged	3161138	3161145		pstA	7
Gok2_libmerged	3161454	3161475		pstA	21
Gok2_libmerged	3162725	3162732		YPO_RS15145	7
Gok2_libmerged	3163045	3163047		YPO_RS15145	2
Gok2_libmerged	3163442	3163451		YPO_RS15145	9
Gok2_libmerged	3163556	3163566		YPO_RS15145	10
Gok2_libmerged	3163608	3163617		YPO_RS15145	9
Gok2_libmerged	3163724	3163728		YPO_RS15145	4
Gok2_libmerged	3164128	3164159		ppk1	31
Gok2_libmerged	3164262	3164312		ppk1	50
Gok2_libmerged	3164497	3164627		ppk1	130
Gok2_libmerged	3164869	3164922		ppk1	53
Gok2_libmerged	3165395	3165402		ppk1	7
Gok2_libmerged	3165930	3165980		ppk1	50
Gok2_libmerged	3166958	3166981		ppx	23
Gok2_libmerged	3167042	3167045		ppx	3
Gok2_libmerged	3167336	3167357		ppx	21
Gok2_libmerged	3167776	3167777		YPO_RS15160	1
Gok2_libmerged	3167872	3167917		YPO_RS15160	45
Gok2_libmerged	3168176	3168211		mgtE	35
Gok2_libmerged	3169133	3169216		mgtE	83
Gok2_libmerged	3169254	3169331		mgtE	77
Gok2_libmerged	3169366	3169370		mgtE	4
Gok2_libmerged	3169623	3169668		yegD	45
Gok2_libmerged	3169720	3169721		yegD	1
Gok2_libmerged	3170799	3170822		yegD	23
Gok2_libmerged	3170943	3170946		yegD	3
Gok2_libmerged	3171558	3171619		YPO_RS15175	61
Gok2_libmerged	3171686	3171737		YPO_RS15175	51
Gok2_libmerged	3171819	3171846		YPO_RS15175	27
Gok2_libmerged	3171988	3172027		YPO_RS15175	39
Gok2_libmerged	3172279	3172283		YPO_RS15180	4
Gok2_libmerged	3172497	3172504		YPO_RS15180	7
Gok2_libmerged	3173091	3173144		YPO_RS15180	53
Gok2_libmerged	3173200	3173257		YPO_RS15180	57
Gok2_libmerged	3173611	3173641		YPO_RS15185	30
Gok2_libmerged	3173692	3173778		YPO_RS15185	86
Gok2_libmerged	3173808	3173850		YPO_RS15185	42
Gok2_libmerged	3174221	3174222		YPO_RS15185	1
Gok2_libmerged	3174588	3174640		YPO_RS15190	52
Gok2_libmerged	3175004	3175045		YPO_RS15190	41
Gok2_libmerged	3175140	3175144		YPO_RS15190	4
Gok2_libmerged	3175530	3175553		YPO_RS15190	23
Gok2_libmerged	3175604	3175642		YPO_RS15190	38
Gok2_libmerged	3175721	3175734		YPO_RS15190	13
Gok2_libmerged	3176709	3176753		YPO_RS15195	44
Gok2_libmerged	3178125	3178180		YPO_RS15200	55
Gok2_libmerged	3178222	3178251		YPO_RS15200	29
Gok2_libmerged	3178322	3178327		YPO_RS15200	5
Gok2_libmerged	3178818	3178877		YPO_RS15200	59
Gok2_libmerged	3178964	3178985		YPO_RS15200	21
Gok2_libmerged	3179494	3179500		YPO_RS15205	6
Gok2_libmerged	3179920	3179925		YPO_RS15205	5
Gok2_libmerged	3180074	3180132		YPO_RS15205	58
Gok2_libmerged	3181887	3181949		YPO_RS15210	62
Gok2_libmerged	3182159	3182173		YPO_RS15210	14
Gok2_libmerged	3182764	3182766		YPO_RS15210	2
Gok2_libmerged	3182944	3182985		YPO_RS15210	41
Gok2_libmerged	3183046	3183084		YPO_RS15210	38
Gok2_libmerged	3183447	3183451		YPO_RS15210	4
Gok2_libmerged	3184279	3184281		mdtC	2
Gok2_libmerged	3184313	3184328		mdtC	15
Gok2_libmerged	3184472	3184530		mdtC	58
Gok2_libmerged	3184629	3184631		mdtC	2
Gok2_libmerged	3184804	3184811		mdtC	7
Gok2_libmerged	3185042	3185071		mdtC	29
Gok2_libmerged	3185191	3185206		mdtC	15
Gok2_libmerged	3185440	3185453		mdtC	13
Gok2_libmerged	3186568	3186591		mdtC	23
Gok2_libmerged	3186730	3186752		mdtC	22
Gok2_libmerged	3187051	3187054		YPO_RS15220	3
Gok2_libmerged	3187261	3187276		YPO_RS15220	15
Gok2_libmerged	3189884	3189893		baeR	9
Gok2_libmerged	3189957	3189971		baeR	14
Gok2_libmerged	3190200	3190230		baeR	30
Gok2_libmerged	3190450	3190453		baeR	3
Gok2_libmerged	3190651	3190740		YPO_RS15235	89
Gok2_libmerged	3190779	3190842		YPO_RS15235	63
Gok2_libmerged	3190917	3190971		YPO_RS15235	54
Gok2_libmerged	3191257	3191310		YPO_RS15240	53
Gok2_libmerged	3191582	3191621		YPO_RS15240	39
Gok2_libmerged	3191687	3191868		YPO_RS15240	181
Gok2_libmerged	3191932	3191973		YPO_RS15240	41
Gok2_libmerged	3192095	3192136		YPO_RS15240	41
Gok2_libmerged	3192449	3192557		YPO_RS15240	108
Gok2_libmerged	3193276	3193283		yegS	7
Gok2_libmerged	3193841	3193911		yegS	70
Gok2_libmerged	3194675	3194682		YPO_RS15250	7
Gok2_libmerged	3196131	3196132		thiD	1
Gok2_libmerged	3196229	3196259		thiD	30
Gok2_libmerged	3196494	3196521		thiD	27
Gok2_libmerged	3197538	3197582		YPO_RS15265	44
Gok2_libmerged	3197745	3197853		YPO_RS15265	108
Gok2_libmerged	3197900	3197912		YPO_RS15265	12
Gok2_libmerged	3197971	3198028		YPO_RS15270	57
Gok2_libmerged	3198201	3198247		YPO_RS15270	46
Gok2_libmerged	3198514	3198527		YPO_RS15275	13
Gok2_libmerged	3198648	3198669		YPO_RS15275	21
Gok2_libmerged	3199463	3199469		YPO_RS15275	6
Gok2_libmerged	3199601	3199782		YPO_RS15280	181
Gok2_libmerged	3199876	3200014		YPO_RS15280	138
Gok2_libmerged	3200087	3200195		YPO_RS15280	108
Gok2_libmerged	3200192	3200252		YPO_RS15285	60
Gok2_libmerged	3200313	3200324		YPO_RS15285	11
Gok2_libmerged	3200386	3200587		YPO_RS15285	201
Gok2_libmerged	3200651	3200739		YPO_RS15290	88
Gok2_libmerged	3200827	3200858		YPO_RS15290	31
Gok2_libmerged	3200902	3201046		YPO_RS15290	144
Gok2_libmerged	3201117	3201270		YPO_RS15295	153
Gok2_libmerged	3201319	3201353		YPO_RS15295	34
Gok2_libmerged	3201412	3201503		YPO_RS15295	91
Gok2_libmerged	3201567	3201581		YPO_RS15300	14
Gok2_libmerged	3201697	3201965		YPO_RS15300	268
Gok2_libmerged	3201989	3202001		YPO_RS15305	12
Gok2_libmerged	3202081	3202376		YPO_RS15305	295
Gok2_libmerged	3202423	3202468		YPO_RS15305	45
Gok2_libmerged	3202665	3202679		YPO_RS15310	14
Gok2_libmerged	3203006	3203017		YPO_RS15310	11
Gok2_libmerged	3203577	3203597		guaA	20
Gok2_libmerged	3204520	3204550		guaA	30
Gok2_libmerged	3204773	3204790		guaA	17
Gok2_libmerged	3204932	3204937		guaA	5
Gok2_libmerged	3205218	3205267		guaB	49
Gok2_libmerged	3205507	3205539		guaB	32
Gok2_libmerged	3205627	3205642		guaB	15
Gok2_libmerged	3206233	3206304		guaB	71
Gok2_libmerged	3206334	3206340		guaB	6
Gok2_libmerged	3206409	3206424		guaB	15
Gok2_libmerged	3207558	3207614		xseA	56
Gok2_libmerged	3208070	3208085		xseA	15
Gok2_libmerged	3208636	3208643		YPO_RS15335	7
Gok2_libmerged	3209234	3209245		YPO_RS15335	11
Gok2_libmerged	3209534	3209577		YPO_RS15335	43
Gok2_libmerged	3210141	3210147		der	6
Gok2_libmerged	3210716	3210846		der	130
Gok2_libmerged	3210994	3211026		der	32
Gok2_libmerged	3211221	3211232		der	11
Gok2_libmerged	3211371	3211413		der	42
Gok2_libmerged	3211722	3211737		bamB	15
Gok2_libmerged	3211849	3211877		bamB	28
Gok2_libmerged	3212189	3212256		bamB	67
Gok2_libmerged	3212736	3212755		bamB	19
Gok2_libmerged	3212767	3212793		YPO_RS15350	26
Gok2_libmerged	3213314	3213329		YPO_RS15350	15
Gok2_libmerged	3213416	3213418		hisS	2
Gok2_libmerged	3213899	3213936		hisS	37
Gok2_libmerged	3214084	3214090		hisS	6
Gok2_libmerged	3214478	3214484		hisS	6
Gok2_libmerged	3214922	3215052		ispG	130
Gok2_libmerged	3215309	3215325		ispG	16
Gok2_libmerged	3216375	3216397		rodZ	22
Gok2_libmerged	3216746	3216822		rodZ	76
Gok2_libmerged	3217056	3217099		rodZ	43
Gok2_libmerged	3217271	3217297		pilW	26
Gok2_libmerged	3217644	3217663		pilW	19
Gok2_libmerged	3218018	3218029		trmG/rlmN	11
Gok2_libmerged	3218072	3218079		trmG/rlmN	7
Gok2_libmerged	3218567	3218591		trmG/rlmN	24
Gok2_libmerged	3218653	3218692		trmG/rlmN	39
Gok2_libmerged	3219476	3219482		ndk	6
Gok2_libmerged	3219623	3219625		ndk	2
Gok2_libmerged	3220231	3220246		YPO_RS15385	15
Gok2_libmerged	3220631	3220660		YPO_RS15385	29
Gok2_libmerged	3220899	3220901		YPO_RS15385	2
Gok2_libmerged	3221076	3221136		YPO_RS15385	60
Gok2_libmerged	3221287	3221420		YPO_RS15385	133
Gok2_libmerged	3221541	3221750		YPO_RS15385	209
Gok2_libmerged	3221788	3221797		YPO_RS15385	9
Gok2_libmerged	3221873	3221888		YPO_RS15385	15
Gok2_libmerged	3221965	3222009		YPO_RS15385	44
Gok2_libmerged	3222062	3222202		YPO_RS15385	140
Gok2_libmerged	3222263	3222349		YPO_RS15385	86
Gok2_libmerged	3222477	3222478		YPO_RS15385	1
Gok2_libmerged	3222559	3222651		YPO_RS15385	92
Gok2_libmerged	3223341	3223361		yapA	20
Gok2_libmerged	3223453	3223475		yapA	22
Gok2_libmerged	3223672	3223696		yapA	24
Gok2_libmerged	3223836	3223907		yapA	71
Gok2_libmerged	3224059	3224082		yapA	23
Gok2_libmerged	3224279	3224312		yapA	33
Gok2_libmerged	3224548	3224578		yapA	30
Gok2_libmerged	3224985	3224991		yapA	6
Gok2_libmerged	3225162	3225179		yapA	17
Gok2_libmerged	3225617	3225706		yapA	89
Gok2_libmerged	3225811	3225866		yapA	55
Gok2_libmerged	3226967	3226969		yapA	2
Gok2_libmerged	3228287	3228290		YPO_RS15395	3
Gok2_libmerged	3228849	3228935		YPO_RS15395	86
Gok2_libmerged	3229659	3229671		YPO_RS15395	12
Gok2_libmerged	3231247	3231250		YPO_RS15395	3
Gok2_libmerged	3232470	3232499		sseB	29
Gok2_libmerged	3232589	3232604		sseB	15
Gok2_libmerged	3233215	3233232		pepB	17
Gok2_libmerged	3233661	3233668		pepB	7
Gok2_libmerged	3234241	3234340		pepB	99
Gok2_libmerged	3234729	3234739		iscX	10
Gok2_libmerged	3235052	3235069		fdx	17
Gok2_libmerged	3235414	3235425		hscA	11
Gok2_libmerged	3235911	3235913		hscA	2
Gok2_libmerged	3236010	3236013		hscA	3
Gok2_libmerged	3236202	3236247		hscA	45
Gok2_libmerged	3236639	3236655		hscA	16
Gok2_libmerged	3236833	3236835		hscA	2
Gok2_libmerged	3237036	3237059		hscA	23
Gok2_libmerged	3237355	3237362		hscB	7
Gok2_libmerged	3237503	3237558		hscB	55
Gok2_libmerged	3238770	3238803		iscU	33
Gok2_libmerged	3238906	3238916		iscU	10
Gok2_libmerged	3238947	3238953		YPO_RS15450	6
Gok2_libmerged	3239030	3239078		YPO_RS15450	48
Gok2_libmerged	3239385	3239401		YPO_RS15450	16
Gok2_libmerged	3239468	3239491		YPO_RS15450	23
Gok2_libmerged	3240036	3240086		YPO_RS15450	50
Gok2_libmerged	3240330	3240389		iscR	59
Gok2_libmerged	3240673	3240687		iscR	14
Gok2_libmerged	3240880	3240895		trmJ	15
Gok2_libmerged	3241532	3241571		trmJ	39
Gok2_libmerged	3241639	3241653		trmJ	14
Gok2_libmerged	3241946	3241950		suhB	4
Gok2_libmerged	3242573	3242575		suhB	2
Gok2_libmerged	3242861	3242887		YPO_RS15470	26
Gok2_libmerged	3242977	3243014		YPO_RS15470	37
Gok2_libmerged	3243126	3243147		YPO_RS15470	21
Gok2_libmerged	3243619	3243643		YPO_RS15475	24
Gok2_libmerged	3243909	3243923		YPO_RS15475	14
Gok2_libmerged	3244405	3244406		YPO_RS15475	1
Gok2_libmerged	3244405	3244422		YPO_RS15480	17
Gok2_libmerged	3244575	3244590		YPO_RS15480	15
Gok2_libmerged	3244964	3244971		YPO_RS15480	7
Gok2_libmerged	3245070	3245071		YPO_RS15480	1
Gok2_libmerged	3245608	3245622		csiE	14
Gok2_libmerged	3246245	3246313		csiE	68
Gok2_libmerged	3246414	3246455		csiE	41
Gok2_libmerged	3247131	3247159		YPO_RS15490	28
Gok2_libmerged	3248249	3248287		ail	38
Gok2_libmerged	3248611	3248618		ail	7
Gok2_libmerged	3249335	3249369		YPO_RS15505	34
Gok2_libmerged	3249456	3249481		YPO_RS15505	25
Gok2_libmerged	3249521	3249527		YPO_RS15505	6
Gok2_libmerged	3249581	3249585		YPO_RS15505	4
Gok2_libmerged	3249704	3249712		YPO_RS15505	8
Gok2_libmerged	3249881	3249884		YPO_RS15505	3
Gok2_libmerged	3250078	3250107		YPO_RS15505	29
Gok2_libmerged	3251803	3251815		hmpA	12
Gok2_libmerged	3253653	3253712		glnB	59
Gok2_libmerged	3253773	3253776		glnB	3
Gok2_libmerged	3254279	3254328		YPO_RS15525	49
Gok2_libmerged	3254522	3254621		YPO_RS15525	99
Gok2_libmerged	3254696	3254719		YPO_RS15525	23
Gok2_libmerged	3254897	3254908		YPO_RS15525	11
Gok2_libmerged	3254962	3254981		YPO_RS15525	19
Gok2_libmerged	3255837	3255866		glrR	29
Gok2_libmerged	3256020	3256023		glrR	3
Gok2_libmerged	3256087	3256092		glrR	5
Gok2_libmerged	3256331	3256349		glrR	18
Gok2_libmerged	3256874	3256898		glrR	24
Gok2_libmerged	3257139	3257143		qseG	4
Gok2_libmerged	3257205	3257217		qseG	12
Gok2_libmerged	3257572	3257592		qseG	20
Gok2_libmerged	3257820	3257829		qseG	9
Gok2_libmerged	3257975	3257981		qseG	6
Gok2_libmerged	3258115	3258118		YPO_RS15540	3
Gok2_libmerged	3258412	3258426		YPO_RS15540	14
Gok2_libmerged	3258723	3258749		YPO_RS15540	26
Gok2_libmerged	3258921	3258926		YPO_RS15540	5
Gok2_libmerged	3259134	3259145		YPO_RS15540	11
Gok2_libmerged	3259801	3259889		YPO_RS15545	88
Gok2_libmerged	3260205	3260210		YPO_RS15545	5
Gok2_libmerged	3260205	3260247		YPO_RS15550	42
Gok2_libmerged	3260314	3260424		YPO_RS15550	110
Gok2_libmerged	3261437	3261448		YPO_RS15555	11
Gok2_libmerged	3261504	3261516		YPO_RS15555	12
Gok2_libmerged	3261782	3261963		YPO_RS15555	181
Gok2_libmerged	3261996	3261997		YPO_RS15555	1
Gok2_libmerged	3262645	3262761		YPO_RS15560	116
Gok2_libmerged	3262829	3262898		YPO_RS15560	69
Gok2_libmerged	3263294	3263313		YPO_RS15565	19
Gok2_libmerged	3263310	3263325		purL	15
Gok2_libmerged	3263422	3263445		purL	23
Gok2_libmerged	3264259	3264301		purL	42
Gok2_libmerged	3264524	3264527		purL	3
Gok2_libmerged	3264935	3264947		purL	12
Gok2_libmerged	3265121	3265130		purL	9
Gok2_libmerged	3265533	3265579		purL	46
Gok2_libmerged	3265851	3265884		purL	33
Gok2_libmerged	3266128	3266129		purL	1
Gok2_libmerged	3266909	3266971		purL	62
Gok2_libmerged	3267960	3268001		mltF	41
Gok2_libmerged	3268335	3268392		mltF	57
Gok2_libmerged	3268497	3268560		mltF	63
Gok2_libmerged	3268778	3268790		mltF	12
Gok2_libmerged	3269887	3269900		yfhb	13
Gok2_libmerged	3270302	3270329		yfhb	27
Gok2_libmerged	3270435	3270437		yfhb	2
Gok2_libmerged	3270848	3270878		murQ	30
Gok2_libmerged	3270939	3270960		murQ	21
Gok2_libmerged	3271105	3271107		murQ	2
Gok2_libmerged	3271287	3271288		murQ	1
Gok2_libmerged	3272113	3272136		YPO_RS15595	23
Gok2_libmerged	3272776	3272819		YPO_RS15600	43
Gok2_libmerged	3272891	3272918		YPO_RS15600	27
Gok2_libmerged	3273254	3273348		YPO_RS15605	94
Gok2_libmerged	3273473	3273478		YPO_RS15605	5
Gok2_libmerged	3274009	3274028		YPO_RS15610	19
Gok2_libmerged	3274423	3274425		pdxJ	2
Gok2_libmerged	3274709	3274713		pdxJ	4
Gok2_libmerged	3274920	3274951		pdxJ	31
Gok2_libmerged	3275153	3275155		YPO_RS15620	2
Gok2_libmerged	3275275	3275305		YPO_RS15620	30
Gok2_libmerged	3275415	3275421		YPO_RS15620	6
Gok2_libmerged	3275563	3275566		YPO_RS15620	3
Gok2_libmerged	3275708	3275751		YPO_RS15620	43
Gok2_libmerged	3275959	3275967		YPO_RS15625	8
Gok2_libmerged	3275998	3276004		YPO_RS15625	6
Gok2_libmerged	3276241	3276349		YPO_RS15625	108
Gok2_libmerged	3276510	3276545		YPO_RS15625	35
Gok2_libmerged	3276660	3276662		YPO_RS15625	2
Gok2_libmerged	3276793	3276799		YPO_RS15625	6
Gok2_libmerged	3276951	3276954		YPO_RS15625	3
Gok2_libmerged	3277633	3277670		tssK	37
Gok2_libmerged	3277726	3277793		tssK	67
Gok2_libmerged	3278057	3278127		tssK	70
Gok2_libmerged	3278544	3278548		tssK	4
Gok2_libmerged	3278707	3278745		tssK	38
Gok2_libmerged	3278802	3278804		tssK	2
Gok2_libmerged	3278988	3279025		tssJ	37
Gok2_libmerged	3279259	3279268		tssJ	9
Gok2_libmerged	3279429	3279445		tssJ	16
Gok2_libmerged	3279803	3279877		YPO_RS15645	74
Gok2_libmerged	3280246	3280284		YPO_RS15645	38
Gok2_libmerged	3280818	3280828		tssC	10
Gok2_libmerged	3281142	3281245		tssC	103
Gok2_libmerged	3281576	3281621		tssC	45
Gok2_libmerged	3281884	3281910		tssC	26
Gok2_libmerged	3282301	3282352		tssB	51
Gok2_libmerged	3282560	3282577		tssB	17
Gok2_libmerged	3282765	3282779		YPO_RS15660	14
Gok2_libmerged	3282840	3282903		YPO_RS15660	63
Gok2_libmerged	3283054	3283058		YPO_RS15660	4
Gok2_libmerged	3283378	3283431		YPO_RS15665	53
Gok2_libmerged	3283514	3283526		YPO_RS15665	12
Gok2_libmerged	3283575	3283589		YPO_RS15665	14
Gok2_libmerged	3283672	3283685		YPO_RS15665	13
Gok2_libmerged	3284060	3284138		YPO_RS15665	78
Gok2_libmerged	3284332	3284368		YPO_RS15665	36
Gok2_libmerged	3284486	3284523		YPO_RS15665	37
Gok2_libmerged	3284692	3284697		YPO_RS15670	5
Gok2_libmerged	3284762	3284782		YPO_RS15670	20
Gok2_libmerged	3285058	3285078		YPO_RS15670	20
Gok2_libmerged	3285505	3285509		YPO_RS15670	4
Gok2_libmerged	3285762	3285781		YPO_RS15670	19
Gok2_libmerged	3285803	3285851		YPO_RS15675	48
Gok2_libmerged	3286041	3286091		YPO_RS15675	50
Gok2_libmerged	3286462	3286484		YPO_RS15675	22
Gok2_libmerged	3286731	3286802		YPO_RS15675	71
Gok2_libmerged	3286926	3286955		YPO_RS15675	29
Gok2_libmerged	3287097	3287098		YPO_RS15675	1
Gok2_libmerged	3287264	3287293		YPO_RS15675	29
Gok2_libmerged	3287490	3287507		YPO_RS15680	17
Gok2_libmerged	3287653	3287682		YPO_RS15680	29
Gok2_libmerged	3287798	3287843		YPO_RS15680	45
Gok2_libmerged	3287951	3287961		YPO_RS15680	10
Gok2_libmerged	3288020	3288132		YPO_RS15680	112
Gok2_libmerged	3288913	3288944		YPO_RS15685	31
Gok2_libmerged	3289145	3289147		tssH	2
Gok2_libmerged	3289220	3289263		tssH	43
Gok2_libmerged	3289324	3289339		tssH	15
Gok2_libmerged	3289440	3289461		tssH	21
Gok2_libmerged	3289687	3289731		tssH	44
Gok2_libmerged	3290243	3290248		tssH	5
Gok2_libmerged	3290677	3290678		tssH	1
Gok2_libmerged	3290875	3290905		tssH	30
Gok2_libmerged	3291282	3291284		tssH	2
Gok2_libmerged	3291505	3291590		tssH	85
Gok2_libmerged	3291683	3291710		tssH	27
Gok2_libmerged	3292603	3292624		tssF	21
Gok2_libmerged	3292764	3292780		tssF	16
Gok2_libmerged	3293098	3293105		tssF	7
Gok2_libmerged	3294497	3294500		tssG	3
Gok2_libmerged	3295505	3295508		tssG	3
Gok2_libmerged	3295946	3295995		YPO_RS15705	49
Gok2_libmerged	3296264	3296305		YPO_RS15705	41
Gok2_libmerged	3297129	3297177		YPO_RS15710	48
Gok2_libmerged	3297229	3297320		YPO_RS15710	91
Gok2_libmerged	3297420	3297423		YPO_RS15710	3
Gok2_libmerged	3297872	3297877		YPO_RS15715	5
Gok2_libmerged	3298075	3298083		YPO_RS15715	8
Gok2_libmerged	3298158	3298227		YPO_RS15715	69
Gok2_libmerged	3298408	3298410		YPO_RS15715	2
Gok2_libmerged	3298801	3298886		YPO_RS15715	85
Gok2_libmerged	3298994	3299000		YPO_RS15715	6
Gok2_libmerged	3299125	3299155		YPO_RS15715	30
Gok2_libmerged	3299874	3299882		YPO_RS15720	8
Gok2_libmerged	3299938	3299977		YPO_RS15725	39
Gok2_libmerged	3300032	3300049		YPO_RS15725	17
Gok2_libmerged	3300368	3300416		YPO_RS15725	48
Gok2_libmerged	3300615	3300647		YPO_RS15725	32
Gok2_libmerged	3300802	3300811		YPO_RS15725	9
Gok2_libmerged	3301582	3301678		YPO_RS15730	96
Gok2_libmerged	3301809	3301859		YPO_RS15730	50
Gok2_libmerged	3301994	3302027		YPO_RS15730	33
Gok2_libmerged	3302424	3302471		YPO_RS15735	47
Gok2_libmerged	3302683	3302685		YPO_RS15735	2
Gok2_libmerged	3302732	3302839		YPO_RS15735	107
Gok2_libmerged	3302968	3303005		YPO_RS15735	37
Gok2_libmerged	3304267	3304283		mltB	16
Gok2_libmerged	3304581	3304595		mltB	14
Gok2_libmerged	3305683	3305722		YPO_RS15745	39
Gok2_libmerged	3306758	3306798		YPO_RS15750	40
Gok2_libmerged	3306868	3306902		YPO_RS15750	34
Gok2_libmerged	3307134	3307151		YPO_RS15750	17
Gok2_libmerged	3307319	3307332		YPO_RS15750	13
Gok2_libmerged	3307452	3307469		YPO_RS15750	17
Gok2_libmerged	3307860	3307880		YPO_RS15750	20
Gok2_libmerged	3307958	3307990		YPO_RS15750	32
Gok2_libmerged	3308071	3308130		YPO_RS15750	59
Gok2_libmerged	3308196	3308233		YPO_RS15750	37
Gok2_libmerged	3308338	3308344		YPO_RS15750	6
Gok2_libmerged	3308341	3308356		YPO_RS15755	15
Gok2_libmerged	3308664	3308798		YPO_RS15755	134
Gok2_libmerged	3308997	3309003		YPO_RS15755	6
Gok2_libmerged	3309095	3309099		YPO_RS15755	4
Gok2_libmerged	3309657	3309722		YPO_RS15760	65
Gok2_libmerged	3310455	3310522		YPO_RS15765	67
Gok2_libmerged	3310656	3310738		YPO_RS15765	82
Gok2_libmerged	3310858	3310888		YPO_RS15765	30
Gok2_libmerged	3311163	3311189		YPO_RS15770	26
Gok2_libmerged	3311320	3311322		YPO_RS15770	2
Gok2_libmerged	3311425	3311527		YPO_RS15770	102
Gok2_libmerged	3311860	3311979		YPO_RS15770	119
Gok2_libmerged	3313270	3313278		YPO_RS15775	8
Gok2_libmerged	3313380	3313388		YPO_RS15775	8
Gok2_libmerged	3313542	3313555		YPO_RS15775	13
Gok2_libmerged	3313658	3313688		YPO_RS15775	30
Gok2_libmerged	3313847	3313857		YPO_RS15775	10
Gok2_libmerged	3313921	3313931		YPO_RS15775	10
Gok2_libmerged	3314228	3314308		YPO_RS15775	80
Gok2_libmerged	3314402	3314507		YPO_RS15775	105
Gok2_libmerged	3314646	3314661		YPO_RS15775	15
Gok2_libmerged	3314792	3314849		YPO_RS15775	57
Gok2_libmerged	3315097	3315112		YPO_RS15775	15
Gok2_libmerged	3315755	3315767		dmsB	12
Gok2_libmerged	3316107	3316117		YPO_RS15785	10
Gok2_libmerged	3317899	3317919		YPO_RS15795	20
Gok2_libmerged	3318208	3318214		YPO_RS15795	6
Gok2_libmerged	3318611	3318623		YPO_RS15800	12
Gok2_libmerged	3318686	3318734		YPO_RS15800	48
Gok2_libmerged	3319045	3319049		YPO_RS15800	4
Gok2_libmerged	3319729	3319790		YPO_RS15810	61
Gok2_libmerged	3320213	3320265		YPO_RS15810	52
Gok2_libmerged	3321476	3321495		YPO_RS15820	19
Gok2_libmerged	3321857	3321912		YPO_RS15820	55
Gok2_libmerged	3322455	3322459		alaC	4
Gok2_libmerged	3323352	3323379		alaC	27
Gok2_libmerged	3323741	3323753		YPO_RS15830	12
Gok2_libmerged	3323849	3323857		YPO_RS15830	8
Gok2_libmerged	3324050	3324059		YPO_RS15830	9
Gok2_libmerged	3324286	3324300		YPO_RS15830	14
Gok2_libmerged	3324654	3324737		YPO_RS15830	83
Gok2_libmerged	3325041	3325073		glk	32
Gok2_libmerged	3325228	3325230		glk	2
Gok2_libmerged	3325551	3325635		glk	84
Gok2_libmerged	3325951	3325954		glk	3
Gok2_libmerged	3326204	3326235		YPO_RS15840	31
Gok2_libmerged	3326377	3326386		YPO_RS15840	9
Gok2_libmerged	3326606	3326611		YPO_RS15840	5
Gok2_libmerged	3327177	3327209		YPO_RS15845	32
Gok2_libmerged	3327326	3327369		YPO_RS15845	43
Gok2_libmerged	3327454	3327553		YPO_RS15845	99
Gok2_libmerged	3327749	3327750		YPO_RS15850	1
Gok2_libmerged	3327856	3327947		YPO_RS15850	91
Gok2_libmerged	3328409	3328436		YPO_RS15850	27
Gok2_libmerged	3328495	3328565		YPO_RS15850	70
Gok2_libmerged	3329212	3329282		YPO_RS15855	70
Gok2_libmerged	3329394	3329477		YPO_RS15860	83
Gok2_libmerged	3329619	3329630		YPO_RS15860	11
Gok2_libmerged	3329950	3329969		YPO_RS15860	19
Gok2_libmerged	3330005	3330016		YPO_RS15860	11
Gok2_libmerged	3330479	3330487		YPO_RS15860	8
Gok2_libmerged	3331145	3331203		YPO_RS15865	58
Gok2_libmerged	3331348	3331381		YPO_RS15865	33
Gok2_libmerged	3331516	3331562		YPO_RS15865	46
Gok2_libmerged	3331667	3331679		YPO_RS15865	12
Gok2_libmerged	3331944	3331982		YPO_RS15865	38
Gok2_libmerged	3332469	3332476		YPO_RS15870	7
Gok2_libmerged	3332836	3332853		YPO_RS15880	17
Gok2_libmerged	3332894	3332899		YPO_RS15885	5
Gok2_libmerged	3333014	3333019		YPO_RS15890	5
Gok2_libmerged	3334026	3334144		gltX	118
Gok2_libmerged	3334257	3334317		gltX	60
Gok2_libmerged	3334597	3334602		gltX	5
Gok2_libmerged	3335138	3335161		YPO_RS15905	23
Gok2_libmerged	3335388	3335422		YPO_RS15905	34
Gok2_libmerged	3335490	3335509		YPO_RS15905	19
Gok2_libmerged	3336256	3336270		YPO_RS15920	14
Gok2_libmerged	3336396	3336434		YPO_RS15920	38
Gok2_libmerged	3336993	3337018		YPO_RS15925	25
Gok2_libmerged	3337550	3337626		YPO_RS15930	76
Gok2_libmerged	3337940	3337941		ligA	1
Gok2_libmerged	3338117	3338126		ligA	9
Gok2_libmerged	3338423	3338438		ligA	15
Gok2_libmerged	3338548	3338568		ligA	20
Gok2_libmerged	3338678	3338692		ligA	14
Gok2_libmerged	3338903	3338918		ligA	15
Gok2_libmerged	3339117	3339138		ligA	21
Gok2_libmerged	3339779	3339790		zipA	11
Gok2_libmerged	3340030	3340042		zipA	12
Gok2_libmerged	3340712	3340765		zipA	53
Gok2_libmerged	3341229	3341240		cysZ	11
Gok2_libmerged	3341491	3341534		cysZ	43
Gok2_libmerged	3341905	3341932		cysK	27
Gok2_libmerged	3341979	3341982		cysK	3
Gok2_libmerged	3342404	3342460		cysK	56
Gok2_libmerged	3342588	3342593		cysK	5
Gok2_libmerged	3343459	3343498		ptsH	39
Gok2_libmerged	3343544	3343549		ptsH	5
Gok2_libmerged	3344106	3344142		ptsI	36
Gok2_libmerged	3344344	3344388		ptsI	44
Gok2_libmerged	3344876	3344879		ptsI	3
Gok2_libmerged	3345053	3345067		ptsI	14
Gok2_libmerged	3345135	3345168		ptsI	33
Gok2_libmerged	3345272	3345295		ptsI	23
Gok2_libmerged	3345721	3345756		crr	35
Gok2_libmerged	3346136	3346143		YPO_RS15970	7
Gok2_libmerged	3346184	3346198		YPO_RS15970	14
Gok2_libmerged	3346451	3346564		YPO_RS15970	113
Gok2_libmerged	3346877	3346906		YPO_RS15975	29
Gok2_libmerged	3347140	3347151		YPO_RS15975	11
Gok2_libmerged	3347410	3347411		YPO_RS15975	1
Gok2_libmerged	3347658	3347770		YPO_RS15975	112
Gok2_libmerged	3348314	3348317		YPO_RS15980	3
Gok2_libmerged	3348811	3348812		YPO_RS15980	1
Gok2_libmerged	3349080	3349094		YPO_RS15985	14
Gok2_libmerged	3349328	3349334		YPO_RS15985	6
Gok2_libmerged	3349618	3349635		YPO_RS15985	17
Gok2_libmerged	3349806	3349825		YPO_RS15985	19
Gok2_libmerged	3349973	3349974		YPO_RS15985	1
Gok2_libmerged	3350223	3350262		YPO_RS15985	39
Gok2_libmerged	3350352	3350383		macB	31
Gok2_libmerged	3350553	3350556		macB	3
Gok2_libmerged	3350862	3350889		macB	27
Gok2_libmerged	3351116	3351136		macB	20
Gok2_libmerged	3351718	3351747		macB	29
Gok2_libmerged	3351813	3351926		macB	113
Gok2_libmerged	3352141	3352166		macB	25
Gok2_libmerged	3352254	3352257		macB	3
Gok2_libmerged	3352580	3352638		YPO_RS15995	58
Gok2_libmerged	3352717	3352721		YPO_RS15995	4
Gok2_libmerged	3352790	3352792		YPO_RS15995	2
Gok2_libmerged	3353028	3353039		YPO_RS15995	11
Gok2_libmerged	3353147	3353164		YPO_RS15995	17
Gok2_libmerged	3353513	3353586		YPO_RS15995	73
Gok2_libmerged	3353634	3353681		YPO_RS15995	47
Gok2_libmerged	3353805	3353807		YPO_RS15995	2
Gok2_libmerged	3353859	3353964		YPO_RS15995	105
Gok2_libmerged	3354053	3354057		YPO_RS15995	4
Gok2_libmerged	3354334	3354467		YPO_RS16000	133
Gok2_libmerged	3354532	3354617		YPO_RS16000	85
Gok2_libmerged	3354900	3354904		YPO_RS16000	4
Gok2_libmerged	3354952	3355008		YPO_RS16000	56
Gok2_libmerged	3355098	3355194		YPO_RS16000	96
Gok2_libmerged	3355274	3355317		YPO_RS16000	43
Gok2_libmerged	3355438	3355497		YPO_RS16000	59
Gok2_libmerged	3355648	3355665		YPO_RS16000	17
Gok2_libmerged	3355710	3355746		YPO_RS16000	36
Gok2_libmerged	3355743	3355892		YPO_RS16005	149
Gok2_libmerged	3356083	3356149		YPO_RS16010	66
Gok2_libmerged	3356457	3356476		YPO_RS16010	19
Gok2_libmerged	3356639	3356683		YPO_RS16010	44
Gok2_libmerged	3356891	3356922		YPO_RS16010	31
Gok2_libmerged	3357204	3357302		YPO_RS16015	98
Gok2_libmerged	3357336	3357417		YPO_RS16020	81
Gok2_libmerged	3357643	3357654		YPO_RS16020	11
Gok2_libmerged	3357728	3357803		YPO_RS16020	75
Gok2_libmerged	3357880	3357894		YPO_RS16020	14
Gok2_libmerged	3358127	3358193		YPO_RS16020	66
Gok2_libmerged	3358286	3358310		YPO_RS16020	24
Gok2_libmerged	3358426	3358500		YPO_RS16020	74
Gok2_libmerged	3359225	3359251		YPO_RS16025	26
Gok2_libmerged	3359361	3359391		YPO_RS16025	30
Gok2_libmerged	3360024	3360028		YPO_RS16025	4
Gok2_libmerged	3360276	3360307		YPO_RS16025	31
Gok2_libmerged	3360554	3360571		YPO_RS16025	17
Gok2_libmerged	3360876	3360896		YPO_RS16030	20
Gok2_libmerged	3361163	3361166		YPO_RS16030	3
Gok2_libmerged	3361386	3361398		YPO_RS16030	12
Gok2_libmerged	3361729	3361737		YPO_RS16030	8
Gok2_libmerged	3362015	3362107		YPO_RS16030	92
Gok2_libmerged	3362527	3362535		YPO_RS16035	8
Gok2_libmerged	3362611	3362612		YPO_RS16035	1
Gok2_libmerged	3363505	3363778		YPO_RS16040	273
Gok2_libmerged	3363875	3364170		YPO_RS16040	295
Gok2_libmerged	3364289	3364383		YPO_RS16040	94
Gok2_libmerged	3364689	3364737		YPO_RS16040	48
Gok2_libmerged	3364982	3365006		cysM	24
Gok2_libmerged	3365065	3365073		cysM	8
Gok2_libmerged	3365458	3365475		cysM	17
Gok2_libmerged	3365679	3365680		cysM	1
Gok2_libmerged	3366062	3366095		cysA	33
Gok2_libmerged	3366185	3366213		cysA	28
Gok2_libmerged	3366466	3366500		cysA	34
Gok2_libmerged	3366575	3366602		cysA	27
Gok2_libmerged	3366856	3366862		cysA	6
Gok2_libmerged	3367115	3367122		cysA	7
Gok2_libmerged	3367115	3367136		cysW	21
Gok2_libmerged	3367201	3367205		cysW	4
Gok2_libmerged	3367481	3367648		cysW	167
Gok2_libmerged	3367892	3367949		cysW	57
Gok2_libmerged	3368602	3368617		cysT	15
Gok2_libmerged	3368774	3368784		cysT	10
Gok2_libmerged	3369082	3369099		YPO_RS16065	17
Gok2_libmerged	3369327	3369334		YPO_RS16065	7
Gok2_libmerged	3369459	3369467		YPO_RS16065	8
Gok2_libmerged	3370172	3370178		YPO_RS16070	6
Gok2_libmerged	3370261	3370314		YPO_RS16070	53
Gok2_libmerged	3370572	3370616		YPO_RS16070	44
Gok2_libmerged	3370745	3370791		YPO_RS16070	46
Gok2_libmerged	3371582	3371590		YPO_RS16070	8
Gok2_libmerged	3372611	3372635		YPO_RS16075	24
Gok2_libmerged	3372693	3372706		YPO_RS16075	13
Gok2_libmerged	3372814	3372816		YPO_RS16075	2
Gok2_libmerged	3373117	3373143		YPO_RS16075	26
Gok2_libmerged	3373376	3373392		YPO_RS16080	16
Gok2_libmerged	3373590	3373700		YPO_RS16080	110
Gok2_libmerged	3373928	3373948		YPO_RS16085	20
Gok2_libmerged	3374075	3374084		YPO_RS16085	9
Gok2_libmerged	3374249	3374265		YPO_RS16085	16
Gok2_libmerged	3374504	3374555		YPO_RS16085	51
Gok2_libmerged	3376358	3376363		YPO_RS16095	5
Gok2_libmerged	3376603	3376613		YPO_RS16095	10
Gok2_libmerged	3376835	3376857		YPO_RS16095	22
Gok2_libmerged	3376930	3376941		YPO_RS16095	11
Gok2_libmerged	3377167	3377173		YPO_RS16100	6
Gok2_libmerged	3377235	3377296		YPO_RS16100	61
Gok2_libmerged	3377635	3377693		YPO_RS16100	58
Gok2_libmerged	3377807	3377812		YPO_RS16100	5
Gok2_libmerged	3377986	3377988		YPO_RS16100	2
Gok2_libmerged	3378342	3378384		YPO_RS16105	42
Gok2_libmerged	3378740	3378749		YPO_RS16105	9
Gok2_libmerged	3378997	3378999		YPO_RS16105	2
Gok2_libmerged	3379716	3379720		YPO_RS16110	4
Gok2_libmerged	3380338	3380347		YPO_RS16115	9
Gok2_libmerged	3380576	3380618		YPO_RS16115	42
Gok2_libmerged	3381105	3381135		yapL	30
Gok2_libmerged	3381172	3381217		yapL	45
Gok2_libmerged	3381319	3381326		yapL	7
Gok2_libmerged	3381368	3381436		yapL	68
Gok2_libmerged	3381592	3381699		yapL	107
Gok2_libmerged	3381762	3381811		yapL	49
Gok2_libmerged	3382137	3382155		yapL	18
Gok2_libmerged	3382206	3382260		yapL	54
Gok2_libmerged	3382621	3382642		yapL	21
Gok2_libmerged	3382786	3382845		yapL	59
Gok2_libmerged	3383090	3383137		yapL	47
Gok2_libmerged	3383217	3383240		yapL	23
Gok2_libmerged	3383476	3383595		YPO_RS16125	119
Gok2_libmerged	3383684	3383788		YPO_RS16125	104
Gok2_libmerged	3383839	3383863		YPO_RS16125	24
Gok2_libmerged	3384365	3384376		YPO_RS16130	11
Gok2_libmerged	3384446	3384453		YPO_RS16130	7
Gok2_libmerged	3384585	3384588		YPO_RS16130	3
Gok2_libmerged	3384649	3384673		YPO_RS16130	24
Gok2_libmerged	3384704	3384712		YPO_RS16130	8
Gok2_libmerged	3385508	3385527		hemF	19
Gok2_libmerged	3386285	3386338		YPO_RS16140	53
Gok2_libmerged	3386383	3386450		YPO_RS16140	67
Gok2_libmerged	3386665	3386702		maeB	37
Gok2_libmerged	3387012	3387016		maeB	4
Gok2_libmerged	3387337	3387370		maeB	33
Gok2_libmerged	3387529	3387560		maeB	31
Gok2_libmerged	3387615	3387635		maeB	20
Gok2_libmerged	3387864	3387868		maeB	4
Gok2_libmerged	3388101	3388142		maeB	41
Gok2_libmerged	3388228	3388244		maeB	16
Gok2_libmerged	3389106	3389153		nudK	47
Gok2_libmerged	3389299	3389311		nudK	12
Gok2_libmerged	3389465	3389508		nudK	43
Gok2_libmerged	3389588	3389688		nudK	100
Gok2_libmerged	3389872	3389885		napC	13
Gok2_libmerged	3390170	3390193		napC	23
Gok2_libmerged	3390251	3390300		napC	49
Gok2_libmerged	3390351	3390359		napC	8
Gok2_libmerged	3391155	3391185		napA	30
Gok2_libmerged	3391431	3391481		napA	50
Gok2_libmerged	3391561	3391563		napA	2
Gok2_libmerged	3391610	3391617		napA	7
Gok2_libmerged	3392033	3392050		napA	17
Gok2_libmerged	3392144	3392183		napA	39
Gok2_libmerged	3392264	3392283		napA	19
Gok2_libmerged	3392315	3392361		napA	46
Gok2_libmerged	3392692	3392770		napA	78
Gok2_libmerged	3392880	3392905		napA	25
Gok2_libmerged	3393073	3393075		napA	2
Gok2_libmerged	3393188	3393199		napA	11
Gok2_libmerged	3393328	3393338		napA	10
Gok2_libmerged	3393829	3393895		napF	66
Gok2_libmerged	3394198	3394202		napF	4
Gok2_libmerged	3394296	3394297		napF	1
Gok2_libmerged	3395285	3395302		YPO_RS16180	17
Gok2_libmerged	3395556	3395568		YPO_RS16180	12
Gok2_libmerged	3395792	3395815		YPO_RS16185	23
Gok2_libmerged	3396648	3396691		acrD	43
Gok2_libmerged	3396851	3396904		acrD	53
Gok2_libmerged	3397302	3397307		acrD	5
Gok2_libmerged	3397638	3397677		acrD	39
Gok2_libmerged	3397926	3397980		acrD	54
Gok2_libmerged	3398183	3398198		acrD	15
Gok2_libmerged	3398509	3398524		acrD	15
Gok2_libmerged	3398765	3398767		acrD	2
Gok2_libmerged	3398824	3398826		acrD	2
Gok2_libmerged	3399032	3399043		acrD	11
Gok2_libmerged	3399362	3399368		acrD	6
Gok2_libmerged	3399827	3399859		YPO_RS16195	32
Gok2_libmerged	3400183	3400202		YPO_RS16195	19
Gok2_libmerged	3400289	3400328		YPO_RS16195	39
Gok2_libmerged	3400362	3400411		YPO_RS16195	49
Gok2_libmerged	3400780	3400789		YPO_RS16200	9
Gok2_libmerged	3401188	3401215		YPO_RS16200	27
Gok2_libmerged	3402002	3402092		YPO_RS16205	90
Gok2_libmerged	3402223	3402249		YPO_RS16205	26
Gok2_libmerged	3402301	3402362		YPO_RS16205	61
Gok2_libmerged	3402602	3402672		YPO_RS16205	70
Gok2_libmerged	3402882	3402890		YPO_RS16205	8
Gok2_libmerged	3403015	3403063		YPO_RS16205	48
Gok2_libmerged	3403282	3403302		YPO_RS16210	20
Gok2_libmerged	3403394	3403493		YPO_RS16210	99
Gok2_libmerged	3404074	3404129		YPO_RS16210	55
Gok2_libmerged	3404294	3404298		YPO_RS16210	4
Gok2_libmerged	3404384	3404417		YPO_RS16210	33
Gok2_libmerged	3404574	3404630		YPO_RS16210	56
Gok2_libmerged	3404903	3404905		YPO_RS16210	2
Gok2_libmerged	3405266	3405276		YPO_RS16215	10
Gok2_libmerged	3405729	3405736		YPO_RS16220	7
Gok2_libmerged	3405812	3405825		YPO_RS16220	13
Gok2_libmerged	3406041	3406044		YPO_RS16220	3
Gok2_libmerged	3406391	3406395		YPO_RS16220	4
Gok2_libmerged	3406562	3406573		YPO_RS16225	11
Gok2_libmerged	3407217	3407237		YPO_RS16225	20
Gok2_libmerged	3407364	3407397		YPO_RS16225	33
Gok2_libmerged	3407567	3407568		YPO_RS16225	1
Gok2_libmerged	3408079	3408092		YPO_RS16225	13
Gok2_libmerged	3408123	3408150		YPO_RS16225	27
Gok2_libmerged	3407818	3407877		YPO_RS16225	59
Gok2_libmerged	3408362	3408374		YPO_RS16230	12
Gok2_libmerged	3408493	3408499		YPO_RS16230	6
Gok2_libmerged	3408600	3408609		YPO_RS16230	9
Gok2_libmerged	3408739	3408746		YPO_RS16230	7
Gok2_libmerged	3408850	3408870		YPO_RS16230	20
Gok2_libmerged	3409276	3409288		YPO_RS16230	12
Gok2_libmerged	3409341	3409401		YPO_RS16230	60
Gok2_libmerged	3409761	3409762		YPO_RS16235	1
Gok2_libmerged	3409896	3409911		YPO_RS16235	15
Gok2_libmerged	3410074	3410172		YPO_RS16235	98
Gok2_libmerged	3410345	3410478		YPO_RS16240	133
Gok2_libmerged	3410868	3410869		dapE	1
Gok2_libmerged	3410947	3410958		dapE	11
Gok2_libmerged	3411425	3411438		dapE	13
Gok2_libmerged	3411528	3411585		dapE	57
Gok2_libmerged	3411706	3411711		dapE	5
Gok2_libmerged	3411780	3411797		dapE	17
Gok2_libmerged	3411862	3411869		dapE	7
Gok2_libmerged	3412027	3412031		YPO_RS16250	4
Gok2_libmerged	3412245	3412284		YPO_RS16250	39
Gok2_libmerged	3412404	3412408		YPO_RS16250	4
Gok2_libmerged	3412491	3412503		YPO_RS16250	12
Gok2_libmerged	3412627	3412691		YPO_RS16255	64
Gok2_libmerged	3413041	3413074		YPO_RS16260	33
Gok2_libmerged	3413144	3413187		YPO_RS16260	43
Gok2_libmerged	3413375	3413417		YPO_RS16260	42
Gok2_libmerged	3413510	3413519		YPO_RS16260	9
Gok2_libmerged	3414222	3414230		YPO_RS16260	8
Gok2_libmerged	3414405	3414410		YPO_RS16260	5
Gok2_libmerged	3414454	3414460		YPO_RS16260	6
Gok2_libmerged	3415162	3415183		YPO_RS16265	21
Gok2_libmerged	3415353	3415504		YPO_RS16265	151
Gok2_libmerged	3416077	3416083		YPO_RS16270	6
Gok2_libmerged	3416400	3416496		YPO_RS16270	96
Gok2_libmerged	3417624	3417626		YPO_RS16280	2
Gok2_libmerged	3417679	3417735		YPO_RS16280	56
Gok2_libmerged	3417845	3417849		YPO_RS16280	4
Gok2_libmerged	3417949	3418028		YPO_RS16280	79
Gok2_libmerged	3418239	3418252		bamC	13
Gok2_libmerged	3418331	3418338		bamC	7
Gok2_libmerged	3418673	3418684		bamC	11
Gok2_libmerged	3418854	3418875		bamC	21
Gok2_libmerged	3419072	3419074		bamC	2
Gok2_libmerged	3419316	3419352		dapA	36
Gok2_libmerged	3419413	3419467		dapA	54
Gok2_libmerged	3419570	3419575		dapA	5
Gok2_libmerged	3420011	3420044		dapA	33
Gok2_libmerged	3420610	3420614		YPO_RS16295	4
Gok2_libmerged	3420772	3420780		YPO_RS16295	8
Gok2_libmerged	3420960	3420980		bcp	20
Gok2_libmerged	3421273	3421403		bcp	130
Gok2_libmerged	3422070	3422086		YPO_RS16305	16
Gok2_libmerged	3422209	3422257		YPO_RS16305	48
Gok2_libmerged	3422411	3422432		YPO_RS16305	21
Gok2_libmerged	3422741	3422765		YPO_RS16305	24
Gok2_libmerged	3423458	3423469		YPO_RS16310	11
Gok2_libmerged	3423905	3423948		YPO_RS16310	43
Gok2_libmerged	3423994	3424006		YPO_RS16310	12
Gok2_libmerged	3424361	3424389		YPO_RS16310	28
Gok2_libmerged	3425413	3425495		YPO_RS16315	82
Gok2_libmerged	3425680	3425683		YPO_RS16315	3
Gok2_libmerged	3425751	3425770		YPO_RS16315	19
Gok2_libmerged	3425813	3425835		YPO_RS16315	22
Gok2_libmerged	3425905	3425972		YPO_RS16315	67
Gok2_libmerged	3426125	3426139		YPO_RS16315	14
Gok2_libmerged	3426516	3426568		arsC	52
Gok2_libmerged	3427988	3428006		YPO_RS16330	18
Gok2_libmerged	3428188	3428212		YPO_RS16330	24
Gok2_libmerged	3428619	3428647		cysS	28
Gok2_libmerged	3429135	3429158		cysS	23
Gok2_libmerged	3429389	3429398		cysS	9
Gok2_libmerged	3429744	3429789		cysS	45
Gok2_libmerged	3429934	3430004		cysS	70
Gok2_libmerged	3430306	3430356		ppiB	50
Gok2_libmerged	3430590	3430594		ppiB	4
Gok2_libmerged	3430660	3430666		ppiB	6
Gok2_libmerged	3430907	3430923		YPO_RS16345	16
Gok2_libmerged	3431043	3431062		YPO_RS16345	19
Gok2_libmerged	3431200	3431247		YPO_RS16345	47
Gok2_libmerged	3432876	3432920		purK	44
Gok2_libmerged	3433156	3433158		purK	2
Gok2_libmerged	3433528	3433535		YPO_RS16360	7
Gok2_libmerged	3434062	3434068		YPO_RS16360	6
Gok2_libmerged	3434287	3434292		YPO_RS16360	5
Gok2_libmerged	3434480	3434517		YPO_RS16360	37
Gok2_libmerged	3434603	3434620		YPO_RS16360	17
Gok2_libmerged	3434743	3434794		YPO_RS16360	51
Gok2_libmerged	3435444	3435473		YPO_RS16360	29
Gok2_libmerged	3435696	3435704		YPO_RS16360	8
Gok2_libmerged	3436278	3436280		YPO_RS16365	2
Gok2_libmerged	3436418	3436424		YPO_RS16365	6
Gok2_libmerged	3436908	3436982		tesA	74
Gok2_libmerged	3437992	3437995		YPO_RS16375	3
Gok2_libmerged	3438335	3438341		YPO_RS16380	6
Gok2_libmerged	3438540	3438577		YPO_RS16380	37
Gok2_libmerged	3439544	3439561		YPO_RS16385	17
Gok2_libmerged	3440345	3440348		YPO_RS16390	3
Gok2_libmerged	3440540	3440548		YPO_RS16390	8
Gok2_libmerged	3441189	3441196		cueR	7
Gok2_libmerged	3441272	3441283		cueR	11
Gok2_libmerged	3441589	3441619		copA	30
Gok2_libmerged	3441795	3441801		copA	6
Gok2_libmerged	3442021	3442029		copA	8
Gok2_libmerged	3442559	3442616		copA	57
Gok2_libmerged	3444074	3444095		copA	21
Gok2_libmerged	3444148	3444160		copA	12
Gok2_libmerged	3444239	3444275		copA	36
Gok2_libmerged	3445003	3445073		YPO_RS16405	70
Gok2_libmerged	3445242	3445245		YPO_RS16405	3
Gok2_libmerged	3445291	3445323		YPO_RS16405	32
Gok2_libmerged	3445371	3445390		YPO_RS16405	19
Gok2_libmerged	3445424	3445443		YPO_RS16405	19
Gok2_libmerged	3445577	3445583		YPO_RS16405	6
Gok2_libmerged	3445969	3446020		ybaK	51
Gok2_libmerged	3446798	3446876		YPO_RS16415	78
Gok2_libmerged	3446945	3446948		YPO_RS16415	3
Gok2_libmerged	3449065	3449071		YPO_RS16425	6
Gok2_libmerged	3449437	3449477		YPO_RS16425	40
Gok2_libmerged	3449651	3449743		YPO_RS16425	92
Gok2_libmerged	3449808	3449828		YPO_RS16425	20
Gok2_libmerged	3449925	3449934		YPO_RS16425	9
Gok2_libmerged	3450190	3450193		YPO_RS16425	3
Gok2_libmerged	3450271	3450279		YPO_RS16425	8
Gok2_libmerged	3451395	3451479		YPO_RS16430	84
Gok2_libmerged	3451638	3451696		YPO_RS16430	58
Gok2_libmerged	3453258	3453268		YPO_RS16435	10
Gok2_libmerged	3454002	3454044		fepE	42
Gok2_libmerged	3454122	3454140		fepE	18
Gok2_libmerged	3454278	3454285		fepE	7
Gok2_libmerged	3454425	3454494		fepE	69
Gok2_libmerged	3454579	3454666		fepE	87
Gok2_libmerged	3454766	3454901		fepE	135
Gok2_libmerged	3455015	3455105		cpsG	90
Gok2_libmerged	3455331	3455335		cpsG	4
Gok2_libmerged	3455507	3455622		cpsG	115
Gok2_libmerged	3455786	3455792		cpsG	6
Gok2_libmerged	3456468	3456590		YPO_RS16450	122
Gok2_libmerged	3456666	3456892		YPO_RS16450	226
Gok2_libmerged	3456982	3457130		YPO_RS16450	148
Gok2_libmerged	3457435	3457442		YPO_RS16455	7
Gok2_libmerged	3457512	3457592		YPO_RS16455	80
Gok2_libmerged	3457631	3457664		YPO_RS16455	33
Gok2_libmerged	3457695	3457752		YPO_RS16455	57
Gok2_libmerged	3457944	3457982		YPO_RS16455	38
Gok2_libmerged	3458342	3458369		YPO_RS16455	27
Gok2_libmerged	3457133	3457148		YPO_RS16455	15
Gok2_libmerged	3460841	3460902		YPO_RS16470	61
Gok2_libmerged	3460979	3461004		YPO_RS16470	25
Gok2_libmerged	3461160	3461186		YPO_RS16470	26
Gok2_libmerged	3461284	3461458		YPO_RS16470	174
Gok2_libmerged	3461525	3461567		YPO_RS16470	42
Gok2_libmerged	3461602	3461743		YPO_RS16470	141
Gok2_libmerged	3461852	3461854		YPO_RS16470	2
Gok2_libmerged	3463321	3463345		YPO_RS16480	24
Gok2_libmerged	3463387	3463850		YPO_RS16480	463
Gok2_libmerged	3463899	3463931		YPO_RS16480	32
Gok2_libmerged	3464068	3464463		YPO_RS16480	395
Gok2_libmerged	3464843	3465052		YPO_RS16485	209
Gok2_libmerged	3465127	3465164		YPO_RS16485	37
Gok2_libmerged	3465307	3465315		YPO_RS16485	8
Gok2_libmerged	3465520	3465556		YPO_RS16485	36
Gok2_libmerged	3465567	3465605		YPO_RS16490	38
Gok2_libmerged	3465724	3465779		YPO_RS16490	55
Gok2_libmerged	3465857	3465874		YPO_RS16490	17
Gok2_libmerged	3465960	3465961		YPO_RS16490	1
Gok2_libmerged	3466043	3466134		YPO_RS16490	91
Gok2_libmerged	3466260	3466383		YPO_RS16490	123
Gok2_libmerged	3466469	3466623		YPO_RS16490	154
Gok2_libmerged	3466655	3466674		YPO_RS16490	19
Gok2_libmerged	3466759	3466831		YPO_RS16490	72
Gok2_libmerged	3466984	3467226		YPO_RS16495	242
Gok2_libmerged	3467311	3467405		YPO_RS16495	94
Gok2_libmerged	3467499	3467527		YPO_RS16495	28
Gok2_libmerged	3467647	3467687		YPO_RS16495	40
Gok2_libmerged	3467816	3467873		YPO_RS16495	57
Gok2_libmerged	3467963	3468060		YPO_RS16495	97
Gok2_libmerged	3468620	3468747		YPO_RS16500	127
Gok2_libmerged	3468907	3468985		YPO_RS16500	78
Gok2_libmerged	3469169	3469195		rfbH	26
Gok2_libmerged	3469233	3469240		rfbH	7
Gok2_libmerged	3469277	3469399		rfbH	122
Gok2_libmerged	3469517	3469532		rfbH	15
Gok2_libmerged	3469730	3469844		rfbH	114
Gok2_libmerged	3469990	3470108		rfbH	118
Gok2_libmerged	3470152	3470157		rfbH	5
Gok2_libmerged	3470493	3470502		rfbG	9
Gok2_libmerged	3470884	3470909		rfbG	25
Gok2_libmerged	3471149	3471162		rfbG	13
Gok2_libmerged	3471352	3471358		rfbG	6
Gok2_libmerged	3471573	3471575		rfbF	2
Gok2_libmerged	3471606	3471620		rfbF	14
Gok2_libmerged	3472113	3472142		rfbF	29
Gok2_libmerged	3472179	3472301		rfbF	122
Gok2_libmerged	3472589	3472610		YPO_RS16520	21
Gok2_libmerged	3472748	3472770		YPO_RS16520	22
Gok2_libmerged	3472852	3472885		YPO_RS16520	33
Gok2_libmerged	3472967	3473128		YPO_RS16520	161
Gok2_libmerged	3473339	3473373		YPO_RS16520	34
Gok2_libmerged	3473971	3473984		hemH	13
Gok2_libmerged	3474423	3474463		hemH	40
Gok2_libmerged	3474911	3474912		hemH	1
Gok2_libmerged	3476153	3476178		htpG	25
Gok2_libmerged	3476426	3476431		htpG	5
Gok2_libmerged	3476467	3476468		htpG	1
Gok2_libmerged	3476527	3476528		htpG	1
Gok2_libmerged	3476875	3476884		htpG	9
Gok2_libmerged	3477580	3477614		htpG	34
Gok2_libmerged	3477974	3477990		recR	16
Gok2_libmerged	3478258	3478282		recR	24
Gok2_libmerged	3478605	3478616		YPO_RS16545	11
Gok2_libmerged	3478695	3478703		YPO_RS16545	8
Gok2_libmerged	3478873	3478897		YPO_RS16545	24
Gok2_libmerged	3479185	3479262		dnaX	77
Gok2_libmerged	3479759	3479763		dnaX	4
Gok2_libmerged	3479981	3480013		dnaX	32
Gok2_libmerged	3480439	3480455		dnaX	16
Gok2_libmerged	3480746	3480803		dnaX	57
Gok2_libmerged	3480925	3480929		dnaX	4
Gok2_libmerged	3481644	3481649		apt	5
Gok2_libmerged	3481809	3481832		apt	23
Gok2_libmerged	3481901	3481931		apt	30
Gok2_libmerged	3482565	3482575		YPO_RS16560	10
Gok2_libmerged	3482616	3482667		YPO_RS16560	51
Gok2_libmerged	3483014	3483035		YPO_RS16560	21
Gok2_libmerged	3483163	3483191		YPO_RS16560	28
Gok2_libmerged	3485180	3485197		YPO_RS16575	17
Gok2_libmerged	3485436	3485461		YPO_RS16575	25
Gok2_libmerged	3485695	3485709		rsmS	14
Gok2_libmerged	3485769	3485787		rsmS	18
Gok2_libmerged	3486645	3486666		mscK	21
Gok2_libmerged	3487383	3487413		mscK	30
Gok2_libmerged	3487503	3487541		mscK	38
Gok2_libmerged	3487881	3487887		mscK	6
Gok2_libmerged	3488030	3488078		mscK	48
Gok2_libmerged	3488117	3488124		mscK	7
Gok2_libmerged	3488338	3488360		mscK	22
Gok2_libmerged	3488425	3488432		mscK	7
Gok2_libmerged	3488702	3488708		mscK	6
Gok2_libmerged	3488968	3488972		mscK	4
Gok2_libmerged	3489003	3489054		mscK	51
Gok2_libmerged	3489124	3489169		mscK	45
Gok2_libmerged	3489260	3489295		mscK	35
Gok2_libmerged	3489440	3489469		mscK	29
Gok2_libmerged	3490097	3490098		YPO_RS16590	1
Gok2_libmerged	3490130	3490139		YPO_RS16590	9
Gok2_libmerged	3490234	3490268		acrR	34
Gok2_libmerged	3490300	3490359		acrR	59
Gok2_libmerged	3490448	3490473		acrR	25
Gok2_libmerged	3490524	3490565		acrR	41
Gok2_libmerged	3490953	3490973		YPO_RS16600	20
Gok2_libmerged	3491164	3491191		YPO_RS16600	27
Gok2_libmerged	3491356	3491377		YPO_RS16600	21
Gok2_libmerged	3491731	3491817		YPO_RS16600	86
Gok2_libmerged	3491994	3492070		YPO_RS16600	76
Gok2_libmerged	3492494	3492504		YPO_RS16605	10
Gok2_libmerged	3492822	3492870		YPO_RS16605	48
Gok2_libmerged	3493213	3493218		YPO_RS16605	5
Gok2_libmerged	3493501	3493521		YPO_RS16605	20
Gok2_libmerged	3493569	3493571		YPO_RS16605	2
Gok2_libmerged	3493813	3493821		YPO_RS16605	8
Gok2_libmerged	3493967	3494013		YPO_RS16605	46
Gok2_libmerged	3494399	3494522		YPO_RS16605	123
Gok2_libmerged	3495087	3495127		YPO_RS16605	40
Gok2_libmerged	3495815	3495851		rpmJ	36
Gok2_libmerged	3496873	3497064		YPO_RS16620	191
Gok2_libmerged	3497441	3497460		tomB	19
Gok2_libmerged	3497544	3497576		tomB	32
Gok2_libmerged	3497635	3497668		tomB	33
Gok2_libmerged	3497717	3497747		YPO_RS16630	30
Gok2_libmerged	3497902	3497912		YPO_RS16630	10
Gok2_libmerged	3499042	3499085		YPO_RS16640	43
Gok2_libmerged	3499544	3499563		YPO_RS16645	19
Gok2_libmerged	3499811	3499817		YPO_RS16645	6
Gok2_libmerged	3500338	3500340		tesB	2
Gok2_libmerged	3501231	3501243		amtB	12
Gok2_libmerged	3501444	3501472		amtB	28
Gok2_libmerged	3501591	3501614		amtB	23
Gok2_libmerged	3502199	3502216		amtB	17
Gok2_libmerged	3503884	3503885		YPO_RS16665	1
Gok2_libmerged	3504585	3504612		YPO_RS16665	27
Gok2_libmerged	3504729	3504742		YPO_RS16665	13
Gok2_libmerged	3504900	3504911		YPO_RS16665	11
Gok2_libmerged	3505848	3505874		YPO_RS16670	26
Gok2_libmerged	3506044	3506071		YPO_RS16670	27
Gok2_libmerged	3506126	3506159		YPO_RS16670	33
Gok2_libmerged	3506337	3506362		YPO_RS16670	25
Gok2_libmerged	3506848	3506879		YPO_RS16670	31
Gok2_libmerged	3506992	3507047		YPO_RS16675	55
Gok2_libmerged	3507590	3507606		YPO_RS16680	16
Gok2_libmerged	3507960	3508014		YPO_RS16680	54
Gok2_libmerged	3508534	3508600		YPO_RS16680	66
Gok2_libmerged	3508831	3508846		cof	15
Gok2_libmerged	3509295	3509317		cof	22
Gok2_libmerged	3509411	3509462		cof	51
Gok2_libmerged	3509602	3509610		cof	8
Gok2_libmerged	3509978	3509980		YPO_RS16690	2
Gok2_libmerged	3510207	3510222		YPO_RS16690	15
Gok2_libmerged	3510310	3510349		YPO_RS16690	39
Gok2_libmerged	3510488	3510496		YPO_RS16690	8
Gok2_libmerged	3511107	3511110		YPO_RS16690	3
Gok2_libmerged	3511966	3512028		queC	62
Gok2_libmerged	3512686	3512742		YPO_RS16700	56
Gok2_libmerged	3512854	3512916		YPO_RS16700	62
Gok2_libmerged	3513309	3513312		YPO_RS16705	3
Gok2_libmerged	3513659	3513660		YPO_RS16705	1
Gok2_libmerged	3514129	3514139		ppiD	10
Gok2_libmerged	3514290	3514323		ppiD	33
Gok2_libmerged	3514969	3514993		ppiD	24
Gok2_libmerged	3515051	3515059		ppiD	8
Gok2_libmerged	3515378	3515414		ppiD	36
Gok2_libmerged	3515554	3515565		ppiD	11
Gok2_libmerged	3516638	3516692		lon	54
Gok2_libmerged	3517073	3517083		lon	10
Gok2_libmerged	3517497	3517525		lon	28
Gok2_libmerged	3517674	3517683		lon	9
Gok2_libmerged	3517752	3517815		lon	63
Gok2_libmerged	3518474	3518509		lon	35
Gok2_libmerged	3518565	3518611		lon	46
Gok2_libmerged	3518664	3518675		lon	11
Gok2_libmerged	3518848	3518887		lon	39
Gok2_libmerged	3519179	3519181		clpX	2
Gok2_libmerged	3519718	3519767		clpX	49
Gok2_libmerged	3519815	3519833		clpX	18
Gok2_libmerged	3520578	3520583		clpP	5
Gok2_libmerged	3520682	3520739		clpP	57
Gok2_libmerged	3520937	3520954		clpP	17
Gok2_libmerged	3521764	3521793		tig	29
Gok2_libmerged	3522296	3522299		tig	3
Gok2_libmerged	3522393	3522427		tig	34
Gok2_libmerged	3522516	3522517		tig	1
Gok2_libmerged	3523422	3523472		bolA	50
Gok2_libmerged	3524034	3524040		YPO_RS16745	6
Gok2_libmerged	3524320	3524380		YPO_RS16745	60
Gok2_libmerged	3524476	3524479		YPO_RS16745	3
Gok2_libmerged	3524525	3524557		YPO_RS16745	32
Gok2_libmerged	3524974	3524991		ampG	17
Gok2_libmerged	3525096	3525121		ampG	25
Gok2_libmerged	3525469	3525512		ampG	43
Gok2_libmerged	3525643	3525670		ampG	27
Gok2_libmerged	3526161	3526181		ampG	20
Gok2_libmerged	3526901	3526905		YPO_RS16755	4
Gok2_libmerged	3527214	3527267		YPO_RS16755	53
Gok2_libmerged	3527702	3527718		cyoA	16
Gok2_libmerged	3528247	3528279		cyoA	32
Gok2_libmerged	3528441	3528490		cyoA	49
Gok2_libmerged	3529154	3529165		cyoB	11
Gok2_libmerged	3529343	3529485		cyoB	142
Gok2_libmerged	3530469	3530526		cyoB	57
Gok2_libmerged	3530576	3530589		cyoB	13
Gok2_libmerged	3530579	3530624		YPO_RS16770	45
Gok2_libmerged	3530809	3530844		YPO_RS16770	35
Gok2_libmerged	3531013	3531087		YPO_RS16770	74
Gok2_libmerged	3531156	3531193		YPO_RS16770	37
Gok2_libmerged	3531193	3531227		YPO_RS16775	34
Gok2_libmerged	3531311	3531326		YPO_RS16775	15
Gok2_libmerged	3531633	3531639		cyoE	6
Gok2_libmerged	3531806	3531808		cyoE	2
Gok2_libmerged	3531972	3531983		cyoE	11
Gok2_libmerged	3533025	3533029		YPO_RS16785	4
Gok2_libmerged	3533189	3533204		YPO_RS16785	15
Gok2_libmerged	3533635	3533702		YPO_RS16785	67
Gok2_libmerged	3533991	3534009		YPO_RS16785	18
Gok2_libmerged	3534609	3534615		YPO_RS16790	6
Gok2_libmerged	3534887	3534889		YPO_RS16790	2
Gok2_libmerged	3535418	3535436		panE	18
Gok2_libmerged	3535833	3535855		panE	22
Gok2_libmerged	3536559	3536585		yajL	26
Gok2_libmerged	3536653	3536687		thiI	34
Gok2_libmerged	3537055	3537092		thiI	37
Gok2_libmerged	3537206	3537220		thiI	14
Gok2_libmerged	3537854	3537884		thiI	30
Gok2_libmerged	3539000	3539017		ispA	17
Gok2_libmerged	3539538	3539560		ispA	22
Gok2_libmerged	3540520	3540577		dxs	57
Gok2_libmerged	3540957	3540970		dxs	13
Gok2_libmerged	3541000	3541030		dxs	30
Gok2_libmerged	3541163	3541203		dxs	40
Gok2_libmerged	3541260	3541270		dxs	10
Gok2_libmerged	3541472	3541505		dxs	33
Gok2_libmerged	3541848	3541970		YPO_RS16825	122
Gok2_libmerged	3542214	3542215		YPO_RS16825	1
Gok2_libmerged	3542787	3542807		pgpA	20
Gok2_libmerged	3543043	3543049		thiL	6
Gok2_libmerged	3543576	3543746		thiL	170
Gok2_libmerged	3544211	3544225		nusB	14
Gok2_libmerged	3544315	3544340		nusB	25
Gok2_libmerged	3544432	3544441		nusB	9
Gok2_libmerged	3544859	3544861		ribE	2
Gok2_libmerged	3544989	3544992		ribE	3
Gok2_libmerged	3545086	3545107		ribE	21
Gok2_libmerged	3545550	3545591		ribD	41
Gok2_libmerged	3545656	3545693		ribD	37
Gok2_libmerged	3545924	3546006		ribD	82
Gok2_libmerged	3546244	3546247		ribD	3
Gok2_libmerged	3546925	3546958		nrdR	33
Gok2_libmerged	3547418	3547513		YPO_RS16860	95
Gok2_libmerged	3547700	3547750		YPO_RS16865	50
Gok2_libmerged	3547896	3548175		YPO_RS16865	279
Gok2_libmerged	3548223	3548311		YPO_RS16865	88
Gok2_libmerged	3548735	3548740		YPO_RS16870	5
Gok2_libmerged	3548832	3548873		YPO_RS16870	41
Gok2_libmerged	3548942	3548959		YPO_RS16870	17
Gok2_libmerged	3549413	3549463		secF	50
Gok2_libmerged	3549614	3549709		secF	95
Gok2_libmerged	3549767	3549799		secF	32
Gok2_libmerged	3549925	3549928		secF	3
Gok2_libmerged	3550617	3550647		secD	30
Gok2_libmerged	3550691	3550709		secD	18
Gok2_libmerged	3551041	3551071		secD	30
Gok2_libmerged	3551165	3551220		secD	55
Gok2_libmerged	3551375	3551397		secD	22
Gok2_libmerged	3551750	3551777		secD	27
Gok2_libmerged	3551914	3551944		secD	30
Gok2_libmerged	3552125	3552139		secD	14
Gok2_libmerged	3552225	3552237		yajC	12
Gok2_libmerged	3552371	3552502		yajC	131
Gok2_libmerged	3552614	3552617		tgt	3
Gok2_libmerged	3552700	3552789		tgt	89
Gok2_libmerged	3552856	3552916		tgt	60
Gok2_libmerged	3553004	3553030		tgt	26
Gok2_libmerged	3553147	3553184		tgt	37
Gok2_libmerged	3553515	3553530		tgt	15
Gok2_libmerged	3553675	3553714		tgt	39
Gok2_libmerged	3554029	3554065		queA	36
Gok2_libmerged	3554140	3554147		queA	7
Gok2_libmerged	3554289	3554291		queA	2
Gok2_libmerged	3554876	3554901		queA	25
Gok2_libmerged	3555541	3555543		YPO_RS16900	2
Gok2_libmerged	3555631	3555656		YPO_RS16900	25
Gok2_libmerged	3557033	3557041		YPO_RS16910	8
Gok2_libmerged	3557127	3557145		YPO_RS16910	18
Gok2_libmerged	3557221	3557248		YPO_RS16910	27
Gok2_libmerged	3559660	3559662		YPO_RS16920	2
Gok2_libmerged	3559839	3559849		YPO_RS16920	10
Gok2_libmerged	3559924	3559950		YPO_RS16920	26
Gok2_libmerged	3560384	3560419		YPO_RS16925	35
Gok2_libmerged	3560780	3560791		malZ	11
Gok2_libmerged	3560930	3560940		malZ	10
Gok2_libmerged	3560990	3561001		malZ	11
Gok2_libmerged	3561069	3561076		malZ	7
Gok2_libmerged	3561318	3561340		malZ	22
Gok2_libmerged	3561545	3561622		malZ	77
Gok2_libmerged	3561708	3561718		malZ	10
Gok2_libmerged	3561866	3561886		malZ	20
Gok2_libmerged	3562092	3562152		malZ	60
Gok2_libmerged	3562315	3562324		malZ	9
Gok2_libmerged	3562885	3562932		proY	47
Gok2_libmerged	3563035	3563047		proY	12
Gok2_libmerged	3563337	3563346		proY	9
Gok2_libmerged	3563388	3563514		proY	126
Gok2_libmerged	3563611	3563682		proY	71
Gok2_libmerged	3563922	3563973		proY	51
Gok2_libmerged	3564497	3564525		brnQ	28
Gok2_libmerged	3564667	3564711		brnQ	44
Gok2_libmerged	3564822	3564838		brnQ	16
Gok2_libmerged	3565140	3565187		brnQ	47
Gok2_libmerged	3565243	3565257		brnQ	14
Gok2_libmerged	3565656	3565671		brnQ	15
Gok2_libmerged	3566145	3566160		YPO_RS16945	15
Gok2_libmerged	3566613	3566700		YPO_RS16945	87
Gok2_libmerged	3567231	3567292		phoR	61
Gok2_libmerged	3567840	3567855		phoR	15
Gok2_libmerged	3568657	3568658		phoB	1
Gok2_libmerged	3568705	3568738		phoB	33
Gok2_libmerged	3568887	3568890		phoB	3
Gok2_libmerged	3569054	3569076		phoB	22
Gok2_libmerged	3569113	3569126		phoB	13
Gok2_libmerged	3569192	3569239		phoB	47
Gok2_libmerged	3570373	3570501		sbcD	128
Gok2_libmerged	3570560	3570595		sbcD	35
Gok2_libmerged	3570754	3570773		sbcD	19
Gok2_libmerged	3570770	3570806		YPO_RS16965	36
Gok2_libmerged	3570982	3570990		YPO_RS16965	8
Gok2_libmerged	3571276	3571284		YPO_RS16965	8
Gok2_libmerged	3571344	3571367		YPO_RS16965	23
Gok2_libmerged	3571539	3571540		YPO_RS16965	1
Gok2_libmerged	3572029	3572094		YPO_RS16965	65
Gok2_libmerged	3572560	3572584		YPO_RS16965	24
Gok2_libmerged	3572728	3572740		YPO_RS16965	12
Gok2_libmerged	3572869	3572942		YPO_RS16965	73
Gok2_libmerged	3573148	3573154		YPO_RS16965	6
Gok2_libmerged	3573515	3573543		YPO_RS16965	28
Gok2_libmerged	3573739	3573816		YPO_RS16965	77
Gok2_libmerged	3574255	3574257		YPO_RS16965	2
Gok2_libmerged	3574343	3574349		YPO_RS16965	6
Gok2_libmerged	3574421	3574477		YPO_RS16965	56
Gok2_libmerged	3574555	3574557		YPO_RS16970	2
Gok2_libmerged	3574655	3574658		YPO_RS16970	3
Gok2_libmerged	3574743	3574755		YPO_RS16970	12
Gok2_libmerged	3574897	3574901		YPO_RS16970	4
Gok2_libmerged	3575080	3575164		YPO_RS16970	84
Gok2_libmerged	3575294	3575337		YPO_RS16975	43
Gok2_libmerged	3575563	3575569		YPO_RS16975	6
Gok2_libmerged	3575756	3575819		YPO_RS16975	63
Gok2_libmerged	3575991	3576019		YPO_RS16975	28
Gok2_libmerged	3576112	3576155		YPO_RS16975	43
Gok2_libmerged	3577182	3577200		mak	18
Gok2_libmerged	3577483	3577499		mak	16
Gok2_libmerged	3577666	3577679		mak	13
Gok2_libmerged	3577738	3577785		mak	47
Gok2_libmerged	3577885	3577911		mak	26
Gok2_libmerged	3578579	3578641		rdgC	62
Gok2_libmerged	3579040	3579093		rdgC	53
Gok2_libmerged	3579681	3579701		ppnP	20
Gok2_libmerged	3580202	3580218		aroL	16
Gok2_libmerged	3580517	3580528		aroL	11
Gok2_libmerged	3580618	3580630		aroL	12
Gok2_libmerged	3580970	3580976		YPO_RS17000	6
Gok2_libmerged	3581025	3581037		YPO_RS17000	12
Gok2_libmerged	3581274	3581301		YPO_RS17000	27
Gok2_libmerged	3582534	3582543		YPO_RS17005	9
Gok2_libmerged	3582816	3582886		YPO_RS17005	70
Gok2_libmerged	3583016	3583182		YPO_RS17010	166
Gok2_libmerged	3584021	3584023		YPO_RS17015	2
Gok2_libmerged	3584142	3584174		YPO_RS17015	32
Gok2_libmerged	3585473	3585483		proA	10
Gok2_libmerged	3585609	3585626		proA	17
Gok2_libmerged	3585844	3585846		proB	2
Gok2_libmerged	3585924	3585930		proB	6
Gok2_libmerged	3586534	3586553		proB	19
Gok2_libmerged	3586747	3586859		proB	112
Gok2_libmerged	3587328	3587336		YPO_RS17030	8
Gok2_libmerged	3587469	3587504		YPO_RS17030	35
Gok2_libmerged	3587564	3587587		frsA	23
Gok2_libmerged	3587703	3587747		frsA	44
Gok2_libmerged	3587866	3587869		frsA	3
Gok2_libmerged	3587928	3587940		frsA	12
Gok2_libmerged	3587997	3588005		frsA	8
Gok2_libmerged	3588497	3588510		frsA	13
Gok2_libmerged	3588573	3588619		frsA	46
Gok2_libmerged	3589017	3589039		gpt	22
Gok2_libmerged	3589216	3589248		gpt	32
Gok2_libmerged	3589372	3589381		gpt	9
Gok2_libmerged	3589893	3589918		YPO_RS17045	25
Gok2_libmerged	3589974	3589998		YPO_RS17045	24
Gok2_libmerged	3590118	3590128		YPO_RS17045	10
Gok2_libmerged	3590341	3590359		YPO_RS17050	18
Gok2_libmerged	3590497	3590536		YPO_RS17050	39
Gok2_libmerged	3590623	3590635		YPO_RS17050	12
Gok2_libmerged	3590797	3590804		YPO_RS17050	7
Gok2_libmerged	3591090	3591117		YPO_RS17050	27
Gok2_libmerged	3591813	3591834		YPO_RS17050	21
Gok2_libmerged	3591883	3591921		YPO_RS17050	38
Gok2_libmerged	3592389	3592532		YPO_RS17055	143
Gok2_libmerged	3592608	3592945		YPO_RS17055	337
Gok2_libmerged	3592983	3593028		YPO_RS17055	45
Gok2_libmerged	3593059	3593088		YPO_RS17055	29
Gok2_libmerged	3595175	3595178		pepD	3
Gok2_libmerged	3595425	3595439		pepD	14
Gok2_libmerged	3595682	3595687		pepD	5
Gok2_libmerged	3596098	3596132		pepD	34
Gok2_libmerged	3596214	3596217		pepD	3
Gok2_libmerged	3596593	3596635		pepD	42
Gok2_libmerged	3596860	3596867		dinB	7
Gok2_libmerged	3597143	3597158		dinB	15
Gok2_libmerged	3597719	3597726		dinB	7
Gok2_libmerged	3598181	3598202		YPO_RS17070	21
Gok2_libmerged	3598433	3598442		YPO_RS17070	9
Gok2_libmerged	3598580	3598618		YPO_RS17070	38
Gok2_libmerged	3598899	3598949		YPO_RS17070	50
Gok2_libmerged	3599518	3599546		nqrM	28
Gok2_libmerged	3599603	3599684		YPO_RS17080	81
Gok2_libmerged	3599761	3599853		YPO_RS17080	92
Gok2_libmerged	3600302	3600325		YPO_RS17080	23
Gok2_libmerged	3600544	3600589		YPO_RS17080	45
Gok2_libmerged	3600700	3600713		nqrF	13
Gok2_libmerged	3600745	3600805		nqrF	60
Gok2_libmerged	3601025	3601035		nqrF	10
Gok2_libmerged	3601134	3601137		nqrF	3
Gok2_libmerged	3601407	3601449		nqrF	42
Gok2_libmerged	3601540	3601549		nqrF	9
Gok2_libmerged	3601640	3601648		nqrF	8
Gok2_libmerged	3601777	3601778		nqrF	1
Gok2_libmerged	3602174	3602184		nqrE	10
Gok2_libmerged	3602288	3602340		nqrE	52
Gok2_libmerged	3602513	3602542		YPO_RS17095	29
Gok2_libmerged	3602746	3602781		YPO_RS17095	35
Gok2_libmerged	3602840	3602870		YPO_RS17095	30
Gok2_libmerged	3603059	3603126		YPO_RS17095	67
Gok2_libmerged	3603121	3603126		YPO_RS17100	5
Gok2_libmerged	3603286	3603293		YPO_RS17100	7
Gok2_libmerged	3603554	3603632		YPO_RS17100	78
Gok2_libmerged	3603903	3603909		YPO_RS17100	6
Gok2_libmerged	3604111	3604134		YPO_RS17105	23
Gok2_libmerged	3604249	3604286		YPO_RS17105	37
Gok2_libmerged	3605215	3605238		YPO_RS17110	23
Gok2_libmerged	3605454	3605517		YPO_RS17110	63
Gok2_libmerged	3605606	3605686		YPO_RS17110	80
Gok2_libmerged	3605786	3605817		YPO_RS17110	31
Gok2_libmerged	3605877	3605880		YPO_RS17110	3
Gok2_libmerged	3606359	3606389		YPO_RS17110	30
Gok2_libmerged	3606452	3606499		YPO_RS17110	47
Gok2_libmerged	3607684	3607692		YPO_RS17115	8
Gok2_libmerged	3607921	3607981		YPO_RS17120	60
Gok2_libmerged	3608756	3608759		lpcA	3
Gok2_libmerged	3609236	3609257		lpcA	21
Gok2_libmerged	3609918	3609935		YPO_RS17130	17
Gok2_libmerged	3610165	3610191		YPO_RS17130	26
Gok2_libmerged	3610310	3610311		YPO_RS17130	1
Gok2_libmerged	3610386	3610387		YPO_RS17130	1
Gok2_libmerged	3610411	3610434		YPO_RS17130	23
Gok2_libmerged	3610557	3610648		YPO_RS17130	91
Gok2_libmerged	3610886	3610894		YPO_RS17130	8
Gok2_libmerged	3611397	3611428		YPO_RS17130	31
Gok2_libmerged	3611941	3611944		YPO_RS17130	3
Gok2_libmerged	3612482	3612517		YPO_RS17135	35
Gok2_libmerged	3612675	3612700		YPO_RS17135	25
Gok2_libmerged	3612816	3612839		YPO_RS17135	23
Gok2_libmerged	3613106	3613118		YPO_RS17140	12
Gok2_libmerged	3613273	3613377		YPO_RS17140	104
Gok2_libmerged	3613569	3613607		YPO_RS17140	38
Gok2_libmerged	3613978	3614025		YPO_RS17140	47
Gok2_libmerged	3614120	3614137		YPO_RS17140	17
Gok2_libmerged	3614524	3614548		YPO_RS17140	24
Gok2_libmerged	3614872	3614927		YPO_RS17145	55
Gok2_libmerged	3615435	3615510		YPO_RS17145	75
Gok2_libmerged	3616058	3616078		YPO_RS17145	20
Gok2_libmerged	3616205	3616250		YPO_RS17145	45
Gok2_libmerged	3616306	3616313		YPO_RS17145	7
Gok2_libmerged	3616394	3616420		YPO_RS17145	26
Gok2_libmerged	3616591	3616647		YPO_RS17145	56
Gok2_libmerged	3616706	3616717		YPO_RS17145	11
Gok2_libmerged	3616795	3616829		YPO_RS17145	34
Gok2_libmerged	3616986	3616993		YPO_RS17145	7
Gok2_libmerged	3617062	3617083		YPO_RS17145	21
Gok2_libmerged	3617185	3617201		YPO_RS17145	16
Gok2_libmerged	3617378	3617443		YPO_RS17145	65
Gok2_libmerged	3617607	3617625		YPO_RS17145	18
Gok2_libmerged	3617939	3617972		YPO_RS17145	33
Gok2_libmerged	3618095	3618097		YPO_RS17145	2
Gok2_libmerged	3618174	3618179		YPO_RS17145	5
Gok2_libmerged	3618601	3618604		YPO_RS17145	3
Gok2_libmerged	3618692	3618694		YPO_RS17145	2
Gok2_libmerged	3618893	3618918		YPO_RS17145	25
Gok2_libmerged	3619041	3619147		YPO_RS17145	106
Gok2_libmerged	3619201	3619205		YPO_RS17145	4
Gok2_libmerged	3619566	3619593		YPO_RS17145	27
Gok2_libmerged	3619996	3620016		YPO_RS17145	20
Gok2_libmerged	3620395	3620399		YPO_RS17145	4
Gok2_libmerged	3620601	3620604		YPO_RS17145	3
Gok2_libmerged	3620698	3620705		YPO_RS17150	7
Gok2_libmerged	3621064	3621153		YPO_RS17150	89
Gok2_libmerged	3621393	3621418		YPO_RS17150	25
Gok2_libmerged	3621569	3621576		YPO_RS17150	7
Gok2_libmerged	3621684	3621692		YPO_RS17150	8
Gok2_libmerged	3621804	3621863		YPO_RS17150	59
Gok2_libmerged	3621971	3621989		YPO_RS17150	18
Gok2_libmerged	3622213	3622237		YPO_RS17150	24
Gok2_libmerged	3622358	3622380		YPO_RS17150	22
Gok2_libmerged	3620844	3620888		YPO_RS17150	44
Gok2_libmerged	3624201	3624211		YPO_RS17160	10
Gok2_libmerged	3624330	3624334		YPO_RS17160	4
Gok2_libmerged	3624398	3624499		YPO_RS17160	101
Gok2_libmerged	3624871	3624887		YPO_RS17165	16
Gok2_libmerged	3625053	3625062		YPO_RS17165	9
Gok2_libmerged	3625183	3625188		YPO_RS17165	5
Gok2_libmerged	3625240	3625261		YPO_RS17165	21
Gok2_libmerged	3625390	3625435		YPO_RS17170	45
Gok2_libmerged	3625791	3625803		YPO_RS17170	12
Gok2_libmerged	3626071	3626077		YPO_RS17170	6
Gok2_libmerged	3626661	3626695		YPO_RS17175	34
Gok2_libmerged	3626741	3626756		YPO_RS17175	15
Gok2_libmerged	3626882	3626888		YPO_RS17175	6
Gok2_libmerged	3627143	3627145		YPO_RS17175	2
Gok2_libmerged	3627217	3627231		YPO_RS17180	14
Gok2_libmerged	3627275	3627277		YPO_RS17180	2
Gok2_libmerged	3627332	3627372		YPO_RS17180	40
Gok2_libmerged	3627563	3627579		YPO_RS17180	16
Gok2_libmerged	3627738	3627763		YPO_RS17180	25
Gok2_libmerged	3627821	3627832		YPO_RS17180	11
Gok2_libmerged	3628481	3628495		YPO_RS17185	14
Gok2_libmerged	3628558	3628563		YPO_RS17185	5
Gok2_libmerged	3628883	3628897		YPO_RS17185	14
Gok2_libmerged	3628883	3628945		YPO_RS17190	62
Gok2_libmerged	3629146	3629156		YPO_RS17190	10
Gok2_libmerged	3629242	3629251		YPO_RS17190	9
Gok2_libmerged	3629540	3629548		YPO_RS17195	8
Gok2_libmerged	3629609	3629612		YPO_RS17195	3
Gok2_libmerged	3630010	3630014		YPO_RS17195	4
Gok2_libmerged	3630128	3630134		YPO_RS17195	6
Gok2_libmerged	3630283	3630284		YPO_RS17200	1
Gok2_libmerged	3630733	3630741		YPO_RS17200	8
Gok2_libmerged	3632622	3632671		hpxX	49
Gok2_libmerged	3632668	3632673		YPO_RS17215	5
Gok2_libmerged	3633281	3633294		YPO_RS17215	13
Gok2_libmerged	3633652	3633661		YPO_RS17215	9
Gok2_libmerged	3633841	3633872		YPO_RS17215	31
Gok2_libmerged	3634064	3634065		YPO_RS17215	1
Gok2_libmerged	3634304	3634307		hpxZ	3
Gok2_libmerged	3634805	3634826		YPO_RS17225	21
Gok2_libmerged	3634919	3634966		YPO_RS17225	47
Gok2_libmerged	3635512	3635579		YPO_RS17225	67
Gok2_libmerged	3635714	3635756		YPO_RS17225	42
Gok2_libmerged	3635895	3635919		YPO_RS17225	24
Gok2_libmerged	3636148	3636159		YPO_RS17230	11
Gok2_libmerged	3636357	3636412		YPO_RS17230	55
Gok2_libmerged	3636663	3636665		YPO_RS17230	2
Gok2_libmerged	3636708	3636712		YPO_RS17230	4
Gok2_libmerged	3637431	3637452		mprA	21
Gok2_libmerged	3637544	3637580		mprA	36
Gok2_libmerged	3637820	3637831		mprA	11
Gok2_libmerged	3638363	3638425		emrA	62
Gok2_libmerged	3638529	3638579		emrA	50
Gok2_libmerged	3638690	3638693		emrA	3
Gok2_libmerged	3639284	3639323		emrA	39
Gok2_libmerged	3639601	3639614		emrB	13
Gok2_libmerged	3640249	3640270		emrB	21
Gok2_libmerged	3640380	3640479		emrB	99
Gok2_libmerged	3640796	3640834		emrB	38
Gok2_libmerged	3641233	3641234		YPO_RS17255	1
Gok2_libmerged	3641392	3641401		YPO_RS17255	9
Gok2_libmerged	3641559	3641560		YPO_RS17255	1
Gok2_libmerged	3642039	3642053		YPO_RS17255	14
Gok2_libmerged	3642129	3642161		YPO_RS17255	32
Gok2_libmerged	3642662	3642740		trxC	78
Gok2_libmerged	3643348	3643351		YPO_RS17265	3
Gok2_libmerged	3644053	3644065		YPO_RS17270	12
Gok2_libmerged	3644446	3644461		YPO_RS17270	15
Gok2_libmerged	3644506	3644515		YPO_RS17270	9
Gok2_libmerged	3645418	3645424		YPO_RS17270	6
Gok2_libmerged	3645848	3645866		YPO_RS17270	18
Gok2_libmerged	3646078	3646095		YPO_RS17270	17
Gok2_libmerged	3646217	3646314		YPO_RS17270	97
Gok2_libmerged	3646831	3646903		pssA	72
Gok2_libmerged	3646993	3647015		pssA	22
Gok2_libmerged	3647193	3647221		pssA	28
Gok2_libmerged	3647296	3647311		pssA	15
Gok2_libmerged	3647434	3647455		pssA	21
Gok2_libmerged	3647753	3647766		pssA	13
Gok2_libmerged	3647919	3647928		pssA	9
Gok2_libmerged	3647974	3648050		pssA	76
Gok2_libmerged	3648469	3648506		YPO_RS17280	37
Gok2_libmerged	3649886	3649993		YPO_RS17290	107
Gok2_libmerged	3651560	3651565		YPO_RS17290	5
Gok2_libmerged	3654739	3654765		clpB	26
Gok2_libmerged	3654996	3655013		clpB	17
Gok2_libmerged	3655116	3655134		clpB	18
Gok2_libmerged	3655294	3655299		clpB	5
Gok2_libmerged	3655620	3655635		clpB	15
Gok2_libmerged	3655720	3655722		clpB	2
Gok2_libmerged	3656042	3656051		clpB	9
Gok2_libmerged	3656126	3656190		clpB	64
Gok2_libmerged	3656282	3656355		clpB	73
Gok2_libmerged	3656406	3656448		clpB	42
Gok2_libmerged	3656904	3656914		clpB	10
Gok2_libmerged	3657244	3657265		clpB	21
Gok2_libmerged	3657987	3658021		pgeF	34
Gok2_libmerged	3658094	3658126		pgeF	32
Gok2_libmerged	3658128	3658159		rluD	31
Gok2_libmerged	3658353	3658363		rluD	10
Gok2_libmerged	3658571	3658597		rluD	26
Gok2_libmerged	3658960	3658980		rluD	20
Gok2_libmerged	3659376	3659387		bamD	11
Gok2_libmerged	3659551	3659553		bamD	2
Gok2_libmerged	3659825	3659892		bamD	67
Gok2_libmerged	3661300	3661316		YPO_RS17340	16
Gok2_libmerged	3662420	3662433		pheA	13
Gok2_libmerged	3662891	3663051		YPO_RS17350	160
Gok2_libmerged	3663690	3663759		YPO_RS17350	69
Gok2_libmerged	3664155	3664210		YPO_RS17355	55
Gok2_libmerged	3664324	3664333		YPO_RS17355	9
Gok2_libmerged	3664511	3664524		YPO_RS17355	13
Gok2_libmerged	3665606	3665654		tyrA	48
Gok2_libmerged	3665772	3665792		tyrA	20
Gok2_libmerged	3666198	3666230		YPO_RS17370	32
Gok2_libmerged	3666475	3666498		YPO_RS17370	23
Gok2_libmerged	3666707	3666709		YPO_RS17370	2
Gok2_libmerged	3666856	3666865		YPO_RS17370	9
Gok2_libmerged	3666910	3666926		YPO_RS17370	16
Gok2_libmerged	3667843	3667906		yehT	63
Gok2_libmerged	3667988	3668007		yehT	19
Gok2_libmerged	3670231	3670247		YPO_RS17385	16
Gok2_libmerged	3670474	3670493		YPO_RS17385	19
Gok2_libmerged	3670672	3670694		YPO_RS17385	22
Gok2_libmerged	3670816	3670837		YPO_RS17385	21
Gok2_libmerged	3670960	3670998		YPO_RS17385	38
Gok2_libmerged	3671331	3671408		YPO_RS17390	77
Gok2_libmerged	3671540	3671541		YPO_RS17390	1
Gok2_libmerged	3671595	3671625		YPO_RS17390	30
Gok2_libmerged	3672271	3672318		rplS	47
Gok2_libmerged	3673380	3673430		rimM	50
Gok2_libmerged	3673492	3673500		rimM	8
Gok2_libmerged	3674359	3674385		ffh	26
Gok2_libmerged	3674673	3674679		ffh	6
Gok2_libmerged	3675371	3675385		ffh	14
Gok2_libmerged	3676266	3676302		YPO_RS17420	36
Gok2_libmerged	3676644	3676686		YPO_RS17425	42
Gok2_libmerged	3677042	3677066		YPO_RS17425	24
Gok2_libmerged	3677487	3677532		YPO_RS17425	45
Gok2_libmerged	3677607	3677642		YPO_RS17425	35
Gok2_libmerged	3677887	3677894		YPO_RS17425	7
Gok2_libmerged	3678108	3678125		YPO_RS17430	17
Gok2_libmerged	3678326	3678490		YPO_RS17430	164
Gok2_libmerged	3678988	3678999		luxS	11
Gok2_libmerged	3679185	3679209		luxS	24
Gok2_libmerged	3679581	3679605		gshA	24
Gok2_libmerged	3679750	3679752		gshA	2
Gok2_libmerged	3679898	3679899		gshA	1
Gok2_libmerged	3679998	3680009		gshA	11
Gok2_libmerged	3680083	3680128		gshA	45
Gok2_libmerged	3680175	3680177		gshA	2
Gok2_libmerged	3680408	3680431		gshA	23
Gok2_libmerged	3680728	3680737		gshA	9
Gok2_libmerged	3681019	3681133		YPO_RS17445	114
Gok2_libmerged	3681234	3681292		YPO_RS17445	58
Gok2_libmerged	3681601	3681643		yqaB	42
Gok2_libmerged	3682325	3682327		YPO_RS17455	2
Gok2_libmerged	3682367	3682386		YPO_RS17455	19
Gok2_libmerged	3683377	3683391		csrA	14
Gok2_libmerged	3683714	3683725		alaS	11
Gok2_libmerged	3683892	3683917		alaS	25
Gok2_libmerged	3684344	3684380		alaS	36
Gok2_libmerged	3684453	3684495		alaS	42
Gok2_libmerged	3684743	3684810		alaS	67
Gok2_libmerged	3685139	3685149		alaS	10
Gok2_libmerged	3685384	3685413		alaS	29
Gok2_libmerged	3685591	3685597		alaS	6
Gok2_libmerged	3685670	3685675		alaS	5
Gok2_libmerged	3686015	3686020		alaS	5
Gok2_libmerged	3686115	3686118		alaS	3
Gok2_libmerged	3686699	3686721		recX	22
Gok2_libmerged	3686808	3686818		recX	10
Gok2_libmerged	3687332	3687362		recA	30
Gok2_libmerged	3688546	3688552		pncC	6
Gok2_libmerged	3688631	3688665		pncC	34
Gok2_libmerged	3689172	3689289		YPO_RS17505	117
Gok2_libmerged	3689344	3689348		YPO_RS17505	4
Gok2_libmerged	3689455	3689463		YPO_RS17505	8
Gok2_libmerged	3689527	3689530		YPO_RS17505	3
Gok2_libmerged	3689955	3689958		YPO_RS17505	3
Gok2_libmerged	3690760	3690823		YPO_RS17510	63
Gok2_libmerged	3690906	3690945		YPO_RS17510	39
Gok2_libmerged	3691040	3691043		YPO_RS17510	3
Gok2_libmerged	3691302	3691316		YPO_RS17510	14
Gok2_libmerged	3691572	3691604		YPO_RS17510	32
Gok2_libmerged	3692091	3692110		YPO_RS17515	19
Gok2_libmerged	3692262	3692275		YPO_RS17515	13
Gok2_libmerged	3692691	3692699		YPO_RS17515	8
Gok2_libmerged	3692740	3692769		YPO_RS17515	29
Gok2_libmerged	3692916	3692936		YPO_RS17515	20
Gok2_libmerged	3693031	3693034		YPO_RS17515	3
Gok2_libmerged	3693286	3693348		YPO_RS17515	62
Gok2_libmerged	3693946	3693974		YPO_RS17520	28
Gok2_libmerged	3694673	3694685		YPO_RS17520	12
Gok2_libmerged	3695048	3695078		YPO_RS17525	30
Gok2_libmerged	3695379	3695391		YPO_RS17525	12
Gok2_libmerged	3695586	3695594		YPO_RS17525	8
Gok2_libmerged	3695845	3695952		YPO_RS17530	107
Gok2_libmerged	3696003	3696007		YPO_RS17530	4
Gok2_libmerged	3696255	3696320		YPO_RS17530	65
Gok2_libmerged	3696491	3696533		YPO_RS17530	42
Gok2_libmerged	3697622	3697644		YPO_RS17535	22
Gok2_libmerged	3698300	3698309		YPO_RS17540	9
Gok2_libmerged	3698914	3698918		YPO_RS17540	4
Gok2_libmerged	3699126	3699158		YPO_RS17540	32
Gok2_libmerged	3699689	3699718		YPO_RS17545	29
Gok2_libmerged	3699845	3699852		YPO_RS17545	7
Gok2_libmerged	3700081	3700086		YPO_RS17545	5
Gok2_libmerged	3700316	3700333		YPO_RS17550	17
Gok2_libmerged	3700441	3700501		YPO_RS17550	60
Gok2_libmerged	3700559	3700647		YPO_RS17550	88
Gok2_libmerged	3700853	3700854		YPO_RS17550	1
Gok2_libmerged	3701196	3701200		YPO_RS17550	4
Gok2_libmerged	3701736	3701743		katG	7
Gok2_libmerged	3702035	3702058		katG	23
Gok2_libmerged	3702557	3702559		katG	2
Gok2_libmerged	3702719	3702726		katG	7
Gok2_libmerged	3702866	3702884		katG	18
Gok2_libmerged	3703028	3703107		katG	79
Gok2_libmerged	3703396	3703430		katG	34
Gok2_libmerged	3703504	3703607		katG	103
Gok2_libmerged	3703696	3703735		katG	39
Gok2_libmerged	3703882	3703949		katG	67
Gok2_libmerged	3704161	3704184		cybC	23
Gok2_libmerged	3704294	3704319		cybC	25
Gok2_libmerged	3704557	3704620		cybB	63
Gok2_libmerged	3704786	3704795		cybB	9
Gok2_libmerged	3705344	3705349		dmsD	5
Gok2_libmerged	3706040	3706054		dmsD	14
Gok2_libmerged	3706636	3706724		YPO_RS17575	88
Gok2_libmerged	3706754	3706758		YPO_RS17575	4
Gok2_libmerged	3706892	3706918		YPO_RS17575	26
Gok2_libmerged	3707003	3707059		YPO_RS17575	56
Gok2_libmerged	3707914	3707926		dmsA	12
Gok2_libmerged	3708460	3708490		dmsA	30
Gok2_libmerged	3708543	3708559		dmsA	16
Gok2_libmerged	3708643	3708724		dmsA	81
Gok2_libmerged	3708798	3708820		dmsA	22
Gok2_libmerged	3708978	3708982		dmsA	4
Gok2_libmerged	3709216	3709225		dmsA	9
Gok2_libmerged	3709264	3709316		dmsA	52
Gok2_libmerged	3709737	3709765		dmsA	28
Gok2_libmerged	3709833	3709872		dmsA	39
Gok2_libmerged	3710091	3710107		dmsA	16
Gok2_libmerged	3710728	3710749		YPO_RS17590	21
Gok2_libmerged	3711231	3711238		YPO_RS17590	7
Gok2_libmerged	3711290	3711299		YPO_RS17590	9
Gok2_libmerged	3712173	3712196		YPO_RS17595	23
Gok2_libmerged	3712557	3712569		YPO_RS17595	12
Gok2_libmerged	3712613	3712811		YPO_RS17595	198
Gok2_libmerged	3713393	3713432		YPO_RS17600	39
Gok2_libmerged	3714227	3714298		YPO_RS17605	71
Gok2_libmerged	3714520	3714602		YPO_RS17605	82
Gok2_libmerged	3715038	3715040		YPO_RS17610	2
Gok2_libmerged	3715296	3715320		YPO_RS17610	24
Gok2_libmerged	3715421	3715443		YPO_RS17610	22
Gok2_libmerged	3715835	3715859		YPO_RS17610	24
Gok2_libmerged	3716687	3716698		YPO_RS17615	11
Gok2_libmerged	3717199	3717217		YPO_RS17615	18
Gok2_libmerged	3717932	3717964		YPO_RS17620	32
Gok2_libmerged	3718096	3718147		YPO_RS17620	51
Gok2_libmerged	3718189	3718211		YPO_RS17620	22
Gok2_libmerged	3718316	3718382		YPO_RS17620	66
Gok2_libmerged	3718588	3718624		YPO_RS17625	36
Gok2_libmerged	3720119	3720131		YPO_RS17630	12
Gok2_libmerged	3720352	3720385		YPO_RS17630	33
Gok2_libmerged	3720530	3720611		YPO_RS17630	81
Gok2_libmerged	3720853	3720881		YPO_RS17630	28
Gok2_libmerged	3721625	3721629		YPO_RS17635	4
Gok2_libmerged	3721681	3721716		YPO_RS17635	35
Gok2_libmerged	3721900	3721906		YPO_RS17635	6
Gok2_libmerged	3722395	3722403		YPO_RS17635	8
Gok2_libmerged	3722665	3722751		YPO_RS17635	86
Gok2_libmerged	3722790	3722807		YPO_RS17635	17
Gok2_libmerged	3722863	3722882		YPO_RS17635	19
Gok2_libmerged	3722974	3723017		YPO_RS17635	43
Gok2_libmerged	3723200	3723227		YPO_RS17640	27
Gok2_libmerged	3723336	3723344		YPO_RS17640	8
Gok2_libmerged	3723667	3723753		map	86
Gok2_libmerged	3724591	3724595		YPO_RS17650	4
Gok2_libmerged	3724692	3724751		YPO_RS17650	59
Gok2_libmerged	3725015	3725024		YPO_RS17650	9
Gok2_libmerged	3725060	3725098		YPO_RS17650	38
Gok2_libmerged	3725144	3725269		YPO_RS17650	125
Gok2_libmerged	3725300	3725475		YPO_RS17650	175
Gok2_libmerged	3725581	3725644		YPO_RS17650	63
Gok2_libmerged	3728614	3728625		YPO_RS17660	11
Gok2_libmerged	3728999	3729030		YPO_RS17665	31
Gok2_libmerged	3729410	3729416		YPO_RS17665	6
Gok2_libmerged	3729939	3729970		YPO_RS17665	31
Gok2_libmerged	3730418	3730460		YPO_RS17670	42
Gok2_libmerged	3730544	3730629		YPO_RS17670	85
Gok2_libmerged	3730693	3730718		YPO_RS17670	25
Gok2_libmerged	3730939	3730949		YPO_RS17670	10
Gok2_libmerged	3731606	3731629		YPO_RS17675	23
Gok2_libmerged	3731749	3731809		YPO_RS17675	60
Gok2_libmerged	3732020	3732074		YPO_RS17680	54
Gok2_libmerged	3732235	3732237		YPO_RS17680	2
Gok2_libmerged	3732867	3732871		YPO_RS17685	4
Gok2_libmerged	3733506	3733508		arsB	2
Gok2_libmerged	3733553	3733578		arsB	25
Gok2_libmerged	3734861	3734878		YPO_RS17695	17
Gok2_libmerged	3734972	3734990		YPO_RS17695	18
Gok2_libmerged	3735270	3735289		YPO_RS17695	19
Gok2_libmerged	3735418	3735470		YPO_RS17695	52
Gok2_libmerged	3735708	3735771		YPO_RS17695	63
Gok2_libmerged	3736290	3736311		dhaL	21
Gok2_libmerged	3736419	3736420		dhaL	1
Gok2_libmerged	3736456	3736467		dhaL	11
Gok2_libmerged	3736518	3736557		dhaL	39
Gok2_libmerged	3736948	3736958		YPO_RS17705	10
Gok2_libmerged	3737179	3737209		YPO_RS17705	30
Gok2_libmerged	3737539	3737574		YPO_RS17705	35
Gok2_libmerged	3738065	3738089		YPO_RS17710	24
Gok2_libmerged	3738298	3738313		YPO_RS17710	15
Gok2_libmerged	3738495	3738524		YPO_RS17715	29
Gok2_libmerged	3739100	3739132		YPO_RS17715	32
Gok2_libmerged	3740093	3740123		rpiB	30
Gok2_libmerged	3740156	3740163		rpiB	7
Gok2_libmerged	3741493	3741499		mutS	6
Gok2_libmerged	3741686	3741693		mutS	7
Gok2_libmerged	3742069	3742109		mutS	40
Gok2_libmerged	3742494	3742532		mutS	38
Gok2_libmerged	3742725	3742760		mutS	35
Gok2_libmerged	3743529	3743544		mutS	15
Gok2_libmerged	3744358	3744379		rpoS	21
Gok2_libmerged	3744671	3744720		rpoS	49
Gok2_libmerged	3744895	3744935		rpoS	40
Gok2_libmerged	3745303	3745312		nlpD	9
Gok2_libmerged	3745693	3745737		nlpD	44
Gok2_libmerged	3745821	3745838		nlpD	17
Gok2_libmerged	3745923	3745944		nlpD	21
Gok2_libmerged	3746021	3746038		nlpD	17
Gok2_libmerged	3746146	3746209		nlpD	63
Gok2_libmerged	3746463	3746475		YPO_RS17740	12
Gok2_libmerged	3746960	3747009		YPO_RS17740	49
Gok2_libmerged	3747003	3747038		surE	35
Gok2_libmerged	3747720	3747723		surE	3
Gok2_libmerged	3747803	3747860		truD	57
Gok2_libmerged	3748279	3748314		truD	35
Gok2_libmerged	3748387	3748447		truD	60
Gok2_libmerged	3748945	3748991		ispF	46
Gok2_libmerged	3749292	3749293		ispF	1
Gok2_libmerged	3749526	3749532		ispD	6
Gok2_libmerged	3749593	3749598		ispD	5
Gok2_libmerged	3750005	3750016		ispD	11
Gok2_libmerged	3750181	3750207		ftsB	26
Gok2_libmerged	3750405	3750446		ftsB	41
Gok2_libmerged	3750996	3751022		YPO_RS17770	26
Gok2_libmerged	3751331	3751402		cysC	71
Gok2_libmerged	3751823	3751843		cysC	20
Gok2_libmerged	3752071	3752077		cysN	6
Gok2_libmerged	3752133	3752174		cysN	41
Gok2_libmerged	3752783	3752786		cysN	3
Gok2_libmerged	3753280	3753325		cysN	45
Gok2_libmerged	3753611	3753613		cysD	2
Gok2_libmerged	3753707	3753722		cysD	15
Gok2_libmerged	3754047	3754050		cysD	3
Gok2_libmerged	3754378	3754383		cysD	5
Gok2_libmerged	3754394	3754412		cobA	18
Gok2_libmerged	3754467	3754498		cobA	31
Gok2_libmerged	3754533	3754538		cobA	5
Gok2_libmerged	3755307	3755323		cobA	16
Gok2_libmerged	3755467	3755486		cobA	19
Gok2_libmerged	3755802	3755807		cobA	5
Gok2_libmerged	3756204	3756220		YPO_RS17795	16
Gok2_libmerged	3756262	3756310		YPO_RS17795	48
Gok2_libmerged	3756458	3756527		YPO_RS17800	69
Gok2_libmerged	3756854	3756883		YPO_RS17805	29
Gok2_libmerged	3756950	3756958		YPO_RS17805	8
Gok2_libmerged	3757068	3757073		YPO_RS17805	5
Gok2_libmerged	3758153	3758169		cysI	16
Gok2_libmerged	3758306	3758308		cysI	2
Gok2_libmerged	3758471	3758500		cysI	29
Gok2_libmerged	3758804	3758807		cysI	3
Gok2_libmerged	3759212	3759268		cysI	56
Gok2_libmerged	3759552	3759581		cysI	29
Gok2_libmerged	3760198	3760208		cysJ	10
Gok2_libmerged	3760335	3760367		cysJ	32
Gok2_libmerged	3760785	3760795		cysJ	10
Gok2_libmerged	3761422	3761424		cysJ	2
Gok2_libmerged	3761575	3761579		cysJ	4
Gok2_libmerged	3762094	3762112		queD	18
Gok2_libmerged	3762314	3762318		queD	4
Gok2_libmerged	3762360	3762364		queD	4
Gok2_libmerged	3763146	3763149		queE	3
Gok2_libmerged	3763643	3763674		YPO_RS17840	31
Gok2_libmerged	3763730	3763772		YPO_RS17840	42
Gok2_libmerged	3763960	3763977		YPO_RS17840	17
Gok2_libmerged	3766552	3766555		pyrG	3
Gok2_libmerged	3766680	3766817		pyrG	137
Gok2_libmerged	3766962	3766977		pyrG	15
Gok2_libmerged	3767053	3767065		pyrG	12
Gok2_libmerged	3767162	3767177		pyrG	15
Gok2_libmerged	3767993	3768019		mazG	26
Gok2_libmerged	3768384	3768395		mazG	11
Gok2_libmerged	3768462	3768506		mazG	44
Gok2_libmerged	3768273	3768331		mazG	58
Gok2_libmerged	3769629	3769664		relA	35
Gok2_libmerged	3769919	3770011		relA	92
Gok2_libmerged	3770250	3770257		relA	7
Gok2_libmerged	3771220	3771249		YPO_RS17870	29
Gok2_libmerged	3771458	3771524		barA	66
Gok2_libmerged	3771609	3771699		barA	90
Gok2_libmerged	3771752	3771761		barA	9
Gok2_libmerged	3772073	3772091		barA	18
Gok2_libmerged	3772495	3772552		barA	57
Gok2_libmerged	3773098	3773188		barA	90
Gok2_libmerged	3773483	3773498		barA	15
Gok2_libmerged	3773778	3773797		barA	19
Gok2_libmerged	3774353	3774388		degP	35
Gok2_libmerged	3774886	3774922		degP	36
Gok2_libmerged	3775126	3775145		degP	19
Gok2_libmerged	3775771	3775788		degP	17
Gok2_libmerged	3776016	3776104		dgt	88
Gok2_libmerged	3776318	3776361		dgt	43
Gok2_libmerged	3776612	3776627		dgt	15
Gok2_libmerged	3776667	3776674		dgt	7
Gok2_libmerged	3776768	3776791		dgt	23
Gok2_libmerged	3777088	3777090		dgt	2
Gok2_libmerged	3777156	3777175		dgt	19
Gok2_libmerged	3778038	3778067		mtnN	29
Gok2_libmerged	3778174	3778240		mtnN	66
Gok2_libmerged	3778370	3778415		mtnN	45
Gok2_libmerged	3778477	3778487		mtnN	10
Gok2_libmerged	3779386	3779443		YPO_RS17900	57
Gok2_libmerged	3780336	3780342		erpA	6
Gok2_libmerged	3780918	3780925		clcA	7
Gok2_libmerged	3781108	3781112		clcA	4
Gok2_libmerged	3781497	3781513		clcA	16
Gok2_libmerged	3781743	3781769		clcA	26
Gok2_libmerged	3781838	3781864		clcA	26
Gok2_libmerged	3782024	3782095		clcA	71
Gok2_libmerged	3782549	3782553		hemL	4
Gok2_libmerged	3782749	3782770		hemL	21
Gok2_libmerged	3782850	3782861		hemL	11
Gok2_libmerged	3783064	3783099		hemL	35
Gok2_libmerged	3783329	3783364		hemL	35
Gok2_libmerged	3784252	3784280		fhuB	28
Gok2_libmerged	3784354	3784362		fhuB	8
Gok2_libmerged	3785351	3785447		fhuB	96
Gok2_libmerged	3785760	3785797		fhuB	37
Gok2_libmerged	3785869	3785875		fhuB	6
Gok2_libmerged	3786140	3786200		fhuB	60
Gok2_libmerged	3784699	3784741		fhuB	42
Gok2_libmerged	3786197	3786381		fhuD	184
Gok2_libmerged	3786757	3786767		fhuD	10
Gok2_libmerged	3787353	3787410		fhuC	57
Gok2_libmerged	3787974	3787984		fhuC	10
Gok2_libmerged	3788401	3788402		mrcB	1
Gok2_libmerged	3789128	3789212		mrcB	84
Gok2_libmerged	3789427	3789443		mrcB	16
Gok2_libmerged	3789735	3789739		mrcB	4
Gok2_libmerged	3789958	3790011		mrcB	53
Gok2_libmerged	3790208	3790219		mrcB	11
Gok2_libmerged	3790490	3790536		mrcB	46
Gok2_libmerged	3790874	3790875		mrcB	1
Gok2_libmerged	3791029	3791038		hrpB	9
Gok2_libmerged	3791383	3791393		hrpB	10
Gok2_libmerged	3791470	3791516		hrpB	46
Gok2_libmerged	3791727	3791733		hrpB	6
Gok2_libmerged	3791835	3791849		hrpB	14
Gok2_libmerged	3794288	3794309		sfsA	21
Gok2_libmerged	3794632	3794654		sfsA	22
Gok2_libmerged	3794939	3794941		sfsA	2
Gok2_libmerged	3795630	3795636		dksA	6
Gok2_libmerged	3796520	3796565		gluQRS	45
Gok2_libmerged	3796711	3796717		gluQRS	6
Gok2_libmerged	3797333	3797337		pcnB	4
Gok2_libmerged	3797599	3797618		pcnB	19
Gok2_libmerged	3797780	3797792		pcnB	12
Gok2_libmerged	3798261	3798262		pcnB	1
Gok2_libmerged	3798391	3798401		pcnB	10
Gok2_libmerged	3798738	3798761		folK	23
Gok2_libmerged	3799448	3799480		panB	32
Gok2_libmerged	3799847	3799881		panB	34
Gok2_libmerged	3799958	3799966		panB	8
Gok2_libmerged	3800473	3800549		panC	76
Gok2_libmerged	3801356	3801360		panD	4
Gok2_libmerged	3801679	3801688		panD	9
Gok2_libmerged	3801940	3801997		YPO_RS17990	57
Gok2_libmerged	3802246	3802265		YPO_RS17990	19
Gok2_libmerged	3802329	3802331		YPO_RS17990	2
Gok2_libmerged	3802540	3802541		YPO_RS17990	1
Gok2_libmerged	3802745	3802762		YPO_RS17990	17
Gok2_libmerged	3802833	3802892		YPO_RS17990	59
Gok2_libmerged	3803500	3803614		YPO_RS17995	114
Gok2_libmerged	3803963	3803966		YPO_RS17995	3
Gok2_libmerged	3804103	3804127		YPO_RS17995	24
Gok2_libmerged	3804416	3804438		YPO_RS18000	22
Gok2_libmerged	3804770	3804793		YPO_RS18000	23
Gok2_libmerged	3805722	3805725		can	3
Gok2_libmerged	3805910	3805953		can	43
Gok2_libmerged	3806629	3806681		hpt	52
Gok2_libmerged	3806948	3806963		cueO	15
Gok2_libmerged	3807313	3807319		cueO	6
Gok2_libmerged	3807592	3807594		cueO	2
Gok2_libmerged	3807885	3807913		cueO	28
Gok2_libmerged	3808008	3808039		cueO	31
Gok2_libmerged	3808274	3808393		cueO	119
Gok2_libmerged	3808956	3808972		YPO_RS18020	16
Gok2_libmerged	3809039	3809051		YPO_RS18020	12
Gok2_libmerged	3809096	3809100		YPO_RS18020	4
Gok2_libmerged	3809439	3809460		speE	21
Gok2_libmerged	3809798	3809821		speE	23
Gok2_libmerged	3810440	3810465		speD	25
Gok2_libmerged	3810531	3810535		speD	4
Gok2_libmerged	3810768	3810921		speD	153
Gok2_libmerged	3811483	3811506		YPO_RS18035	23
Gok2_libmerged	3811662	3811726		YPO_RS18035	64
Gok2_libmerged	3811883	3811891		YPO_RS18035	8
Gok2_libmerged	3812090	3812098		YPO_RS18035	8
Gok2_libmerged	3812173	3812181		YPO_RS18035	8
Gok2_libmerged	3812841	3812861		YPO_RS18040	20
Gok2_libmerged	3813161	3813248		acnB	87
Gok2_libmerged	3813404	3813442		acnB	38
Gok2_libmerged	3813548	3813572		acnB	24
Gok2_libmerged	3813628	3813696		acnB	68
Gok2_libmerged	3814111	3814171		acnB	60
Gok2_libmerged	3814967	3815021		acnB	54
Gok2_libmerged	3815115	3815143		acnB	28
Gok2_libmerged	3815327	3815351		acnB	24
Gok2_libmerged	3815425	3815426		acnB	1
Gok2_libmerged	3816438	3816442		YPO_RS18050	4
Gok2_libmerged	3816735	3816749		YPO_RS18050	14
Gok2_libmerged	3817028	3817053		lpdA	25
Gok2_libmerged	3817221	3817242		lpdA	21
Gok2_libmerged	3817306	3817308		lpdA	2
Gok2_libmerged	3817604	3817608		lpdA	4
Gok2_libmerged	3817777	3817804		lpdA	27
Gok2_libmerged	3817893	3817898		lpdA	5
Gok2_libmerged	3818134	3818207		lpdA	73
Gok2_libmerged	3818338	3818348		lpdA	10
Gok2_libmerged	3818999	3819003		aceF	4
Gok2_libmerged	3819068	3819071		aceF	3
Gok2_libmerged	3819125	3819131		aceF	6
Gok2_libmerged	3819261	3819277		aceF	16
Gok2_libmerged	3819478	3819486		aceF	8
Gok2_libmerged	3819742	3819792		aceF	50
Gok2_libmerged	3819946	3819991		aceF	45
Gok2_libmerged	3820058	3820060		aceF	2
Gok2_libmerged	3820107	3820121		aceF	14
Gok2_libmerged	3820639	3820642		aceE	3
Gok2_libmerged	3820677	3820685		aceE	8
Gok2_libmerged	3821018	3821060		aceE	42
Gok2_libmerged	3821180	3821223		aceE	43
Gok2_libmerged	3821568	3821569		aceE	1
Gok2_libmerged	3822069	3822075		aceE	6
Gok2_libmerged	3822391	3822396		aceE	5
Gok2_libmerged	3822872	3822887		aceE	15
Gok2_libmerged	3823200	3823213		pdhR	13
Gok2_libmerged	3823432	3823453		pdhR	21
Gok2_libmerged	3823560	3823581		pdhR	21
Gok2_libmerged	3823707	3823715		pdhR	8
Gok2_libmerged	3824829	3824833		YPO_RS18075	4
Gok2_libmerged	3825237	3825270		YPO_RS18075	33
Gok2_libmerged	3826032	3826122		YPO_RS18075	90
Gok2_libmerged	3826851	3826937		ampE	86
Gok2_libmerged	3827003	3827031		ampE	28
Gok2_libmerged	3827305	3827312		ampE	7
Gok2_libmerged	3827848	3827871		ampD	23
Gok2_libmerged	3828246	3828253		ampD	7
Gok2_libmerged	3828554	3828565		nadC	11
Gok2_libmerged	3829015	3829025		nadC	10
Gok2_libmerged	3829777	3829933		ppdD	156
Gok2_libmerged	3830014	3830022		gspE	8
Gok2_libmerged	3830132	3830141		gspE	9
Gok2_libmerged	3830458	3830462		gspE	4
Gok2_libmerged	3830569	3830595		gspE	26
Gok2_libmerged	3830876	3830888		gspE	12
Gok2_libmerged	3831037	3831065		gspE	28
Gok2_libmerged	3831118	3831121		gspE	3
Gok2_libmerged	3831263	3831329		gspE	66
Gok2_libmerged	3831844	3831888		hofC	44
Gok2_libmerged	3831949	3831958		hofC	9
Gok2_libmerged	3832397	3832459		hofC	62
Gok2_libmerged	3832572	3832629		hofC	57
Gok2_libmerged	3832703	3832712		hofC	9
Gok2_libmerged	3834550	3834592		coaE	42
Gok2_libmerged	3834738	3834781		coaE	43
Gok2_libmerged	3834864	3834876		coaE	12
Gok2_libmerged	3835133	3835183		zapD	50
Gok2_libmerged	3835517	3835520		zapD	3
Gok2_libmerged	3836439	3836480		YPO_RS18130	41
Gok2_libmerged	3837282	3837315		YPO_RS18135	33
Gok2_libmerged	3837363	3837500		YPO_RS18135	137
Gok2_libmerged	3837550	3837556		YPO_RS18135	6
Gok2_libmerged	3838234	3838243		YPO_RS18140	9
Gok2_libmerged	3838350	3838351		YPO_RS18140	1
Gok2_libmerged	3838417	3838527		YPO_RS18140	110
Gok2_libmerged	3838707	3838715		YPO_RS18140	8
Gok2_libmerged	3838850	3838876		YPO_RS18145	26
Gok2_libmerged	3839481	3839498		YPO_RS18145	17
Gok2_libmerged	3839746	3839806		YPO_RS18145	60
Gok2_libmerged	3840608	3840614		YPO_RS18150	6
Gok2_libmerged	3841061	3841078		YPO_RS18150	17
Gok2_libmerged	3841193	3841218		YPO_RS18150	25
Gok2_libmerged	3841333	3841407		YPO_RS18150	74
Gok2_libmerged	3841620	3841627		YPO_RS18150	7
Gok2_libmerged	3841674	3841726		YPO_RS18150	52
Gok2_libmerged	3841811	3841832		YPO_RS18150	21
Gok2_libmerged	3842016	3842093		YPO_RS18155	77
Gok2_libmerged	3842201	3842217		YPO_RS18155	16
Gok2_libmerged	3842310	3842329		YPO_RS18155	19
Gok2_libmerged	3843109	3843112		YPO_RS18155	3
Gok2_libmerged	3843169	3843204		YPO_RS18155	35
Gok2_libmerged	3844090	3844116		lptG	26
Gok2_libmerged	3844218	3844224		lptG	6
Gok2_libmerged	3844382	3844385		lptG	3
Gok2_libmerged	3844542	3844552		lptG	10
Gok2_libmerged	3845824	3845833		lptF	9
Gok2_libmerged	3846113	3846122		pepA	9
Gok2_libmerged	3846187	3846206		pepA	19
Gok2_libmerged	3846518	3846548		pepA	30
Gok2_libmerged	3846754	3846765		pepA	11
Gok2_libmerged	3846863	3846911		pepA	48
Gok2_libmerged	3847141	3847155		pepA	14
Gok2_libmerged	3847358	3847363		pepA	5
Gok2_libmerged	3847435	3847484		pepA	49
Gok2_libmerged	3847969	3847983		YPO_RS18180	14
Gok2_libmerged	3848312	3848322		YPO_RS18185	10
Gok2_libmerged	3848478	3848509		YPO_RS18185	31
Gok2_libmerged	3848586	3848591		YPO_RS18185	5
Gok2_libmerged	3849483	3849536		YPO_RS18185	53
Gok2_libmerged	3849884	3849889		YPO_RS18185	5
Gok2_libmerged	3851126	3851129		YPO_RS18185	3
Gok2_libmerged	3851601	3851603		YPO_RS18190	2
Gok2_libmerged	3851759	3851780		YPO_RS18190	21
Gok2_libmerged	3853204	3853234		argF	30
Gok2_libmerged	3853399	3853407		argF	8
Gok2_libmerged	3853527	3853537		argF	10
Gok2_libmerged	3853748	3853878		argF	130
Gok2_libmerged	3854359	3854365		YPO_RS18205	6
Gok2_libmerged	3854508	3854510		YPO_RS18205	2
Gok2_libmerged	3854596	3854617		YPO_RS18205	21
Gok2_libmerged	3854657	3854702		YPO_RS18205	45
Gok2_libmerged	3857036	3857073		YPO_RS18215	37
Gok2_libmerged	3857456	3857462		YPO_RS18215	6
Gok2_libmerged	3857550	3857581		YPO_RS18215	31
Gok2_libmerged	3857701	3857710		YPO_RS18215	9
Gok2_libmerged	3858143	3858221		YPO_RS18220	78
Gok2_libmerged	3858349	3858354		YPO_RS18220	5
Gok2_libmerged	3859065	3859084		YPO_RS18225	19
Gok2_libmerged	3859586	3859633		YPO_RS18225	47
Gok2_libmerged	3859716	3859728		YPO_RS18225	12
Gok2_libmerged	3859992	3859999		YPO_RS18230	7
Gok2_libmerged	3861426	3861455		nrdD	29
Gok2_libmerged	3861601	3861603		nrdD	2
Gok2_libmerged	3861690	3861693		nrdD	3
Gok2_libmerged	3861754	3861792		nrdD	38
Gok2_libmerged	3861888	3861908		nrdD	20
Gok2_libmerged	3861961	3862044		nrdD	83
Gok2_libmerged	3862420	3862423		nrdD	3
Gok2_libmerged	3862536	3862542		nrdD	6
Gok2_libmerged	3862966	3863054		nrdD	88
Gok2_libmerged	3863236	3863267		nrdG	31
Gok2_libmerged	3864671	3864680		phnF	9
Gok2_libmerged	3864777	3864801		phnG	24
Gok2_libmerged	3864840	3864853		phnG	13
Gok2_libmerged	3865271	3865282		phnH	11
Gok2_libmerged	3866935	3866984		YPO_RS18260	49
Gok2_libmerged	3867137	3867146		YPO_RS18265	9
Gok2_libmerged	3867226	3867235		YPO_RS18265	9
Gok2_libmerged	3867287	3867301		YPO_RS18265	14
Gok2_libmerged	3867675	3867731		YPO_RS18265	56
Gok2_libmerged	3867899	3867903		YPO_RS18265	4
Gok2_libmerged	3867903	3867911		phnK	8
Gok2_libmerged	3868086	3868089		phnK	3
Gok2_libmerged	3868620	3868682		phnK	62
Gok2_libmerged	3869354	3869372		phnL	18
Gok2_libmerged	3869518	3869521		phnL	3
Gok2_libmerged	3869603	3869636		phnL	33
Gok2_libmerged	3869767	3869776		phnL	9
Gok2_libmerged	3869962	3870000		phnM	38
Gok2_libmerged	3870155	3870182		phnM	27
Gok2_libmerged	3870276	3870285		phnM	9
Gok2_libmerged	3870780	3870830		phnM	50
Gok2_libmerged	3871438	3871490		phnN	52
Gok2_libmerged	3871819	3871838		phnP	19
Gok2_libmerged	3871993	3872019		phnP	26
Gok2_libmerged	3872066	3872082		phnP	16
Gok2_libmerged	3872163	3872167		phnP	4
Gok2_libmerged	3872537	3872558		YPO_RS18295	21
Gok2_libmerged	3872762	3872766		YPO_RS18295	4
Gok2_libmerged	3872887	3872910		YPO_RS18295	23
Gok2_libmerged	3873636	3873697		YPO_RS18305	61
Gok2_libmerged	3873750	3873760		YPO_RS18305	10
Gok2_libmerged	3873874	3873905		YPO_RS18305	31
Gok2_libmerged	3874190	3874206		YPO_RS18305	16
Gok2_libmerged	3874468	3874509		YPO_RS18305	41
Gok2_libmerged	3874575	3874600		YPO_RS18305	25
Gok2_libmerged	3874725	3874731		YPO_RS18305	6
Gok2_libmerged	3875604	3875632		ugpC	28
Gok2_libmerged	3875818	3875877		ugpC	59
Gok2_libmerged	3876021	3876023		YPO_RS18315	2
Gok2_libmerged	3876099	3876167		YPO_RS18315	68
Gok2_libmerged	3876589	3876609		YPO_RS18315	20
Gok2_libmerged	3876645	3876650		YPO_RS18315	5
Gok2_libmerged	3876929	3876955		YPO_RS18320	26
Gok2_libmerged	3877518	3877519		YPO_RS18320	1
Gok2_libmerged	3877729	3877761		YPO_RS18325	32
Gok2_libmerged	3877835	3877866		YPO_RS18325	31
Gok2_libmerged	3878391	3878418		YPO_RS18325	27
Gok2_libmerged	3878540	3878648		YPO_RS18325	108
Gok2_libmerged	3878770	3878947		YPO_RS18325	177
Gok2_libmerged	3879566	3879702		YPO_RS18330	136
Gok2_libmerged	3880036	3880047		YPO_RS18330	11
Gok2_libmerged	3880226	3880243		YPO_RS18330	17
Gok2_libmerged	3880875	3880937		YPO_RS18335	62
Gok2_libmerged	3881151	3881242		YPO_RS18335	91
Gok2_libmerged	3882443	3882458		YPO_RS18335	15
Gok2_libmerged	3882542	3882548		YPO_RS18335	6
Gok2_libmerged	3882777	3882780		YPO_RS18335	3
Gok2_libmerged	3883030	3883036		YPO_RS18340	6
Gok2_libmerged	3883473	3883495		YPO_RS18345	22
Gok2_libmerged	3884094	3884127		YPO_RS18350	33
Gok2_libmerged	3884405	3884441		YPO_RS18350	36
Gok2_libmerged	3884810	3884813		YPO_RS18355	3
Gok2_libmerged	3884996	3885052		YPO_RS18355	56
Gok2_libmerged	3885165	3885174		YPO_RS18355	9
Gok2_libmerged	3885247	3885253		YPO_RS18355	6
Gok2_libmerged	3885364	3885367		YPO_RS18355	3
Gok2_libmerged	3885522	3885545		YPO_RS18355	23
Gok2_libmerged	3885597	3885602		YPO_RS18355	5
Gok2_libmerged	3885785	3885805		YPO_RS18355	20
Gok2_libmerged	3885901	3885959		YPO_RS18360	58
Gok2_libmerged	3886432	3886443		YPO_RS18360	11
Gok2_libmerged	3886836	3886863		YPO_RS18365	27
Gok2_libmerged	3887149	3887159		YPO_RS18365	10
Gok2_libmerged	3887436	3887482		YPO_RS18365	46
Gok2_libmerged	3887830	3887834		YPO_RS18365	4
Gok2_libmerged	3887989	3887992		YPO_RS18365	3
Gok2_libmerged	3888034	3888058		YPO_RS18365	24
Gok2_libmerged	3888250	3888255		YPO_RS18370	5
Gok2_libmerged	3888352	3888401		YPO_RS18370	49
Gok2_libmerged	3888655	3888677		YPO_RS18370	22
Gok2_libmerged	3888846	3888867		YPO_RS18370	21
Gok2_libmerged	3889063	3889093		YPO_RS18370	30
Gok2_libmerged	3889369	3889445		YPO_RS18370	76
Gok2_libmerged	3889935	3889951		YPO_RS18370	16
Gok2_libmerged	3890261	3890303		YPO_RS18370	42
Gok2_libmerged	3890410	3890415		YPO_RS18370	5
Gok2_libmerged	3890862	3890880		YPO_RS18370	18
Gok2_libmerged	3890935	3890996		YPO_RS18370	61
Gok2_libmerged	3891405	3891409		YPO_RS18375	4
Gok2_libmerged	3891473	3891511		YPO_RS18375	38
Gok2_libmerged	3892506	3892533		YPO_RS18375	27
Gok2_libmerged	3893113	3893121		YPO_RS18380	8
Gok2_libmerged	3893415	3893432		YPO_RS18380	17
Gok2_libmerged	3893533	3893551		YPO_RS18380	18
Gok2_libmerged	3893620	3893628		YPO_RS18380	8
Gok2_libmerged	3894007	3894011		YPO_RS18380	4
Gok2_libmerged	3894514	3894517		YPO_RS18390	3
Gok2_libmerged	3894634	3894658		YPO_RS18390	24
Gok2_libmerged	3894779	3894829		YPO_RS18395	50
Gok2_libmerged	3895021	3895054		YPO_RS18395	33
Gok2_libmerged	3895659	3895671		YPO_RS18400	12
Gok2_libmerged	3895734	3895746		YPO_RS18400	12
Gok2_libmerged	3895922	3895923		YPO_RS18400	1
Gok2_libmerged	3896275	3896316		YPO_RS18400	41
Gok2_libmerged	3896629	3896692		YPO_RS18400	63
Gok2_libmerged	3897624	3897645		nlpI	21
Gok2_libmerged	3897765	3897805		nlpI	40
Gok2_libmerged	3898045	3898050		nlpI	5
Gok2_libmerged	3898150	3898151		nlpI	1
Gok2_libmerged	3898306	3898321		nlpI	15
Gok2_libmerged	3898730	3898731		pnp	1
Gok2_libmerged	3898826	3898867		pnp	41
Gok2_libmerged	3899059	3899094		pnp	35
Gok2_libmerged	3899180	3899202		pnp	22
Gok2_libmerged	3899433	3899470		pnp	37
Gok2_libmerged	3899527	3899545		pnp	18
Gok2_libmerged	3900059	3900062		pnp	3
Gok2_libmerged	3900952	3900961		YPO_RS18420	9
Gok2_libmerged	3901027	3901030		YPO_RS18420	3
Gok2_libmerged	3901365	3901417		YPO_RS18420	52
Gok2_libmerged	3901624	3901637		YPO_RS18420	13
Gok2_libmerged	3902107	3902142		YPO_RS18420	35
Gok2_libmerged	3902172	3902173		YPO_RS18420	1
Gok2_libmerged	3902715	3902738		truB	23
Gok2_libmerged	3902859	3902865		truB	6
Gok2_libmerged	3903896	3903908		rbfA	12
Gok2_libmerged	3904146	3904192		infB	46
Gok2_libmerged	3904313	3904389		infB	76
Gok2_libmerged	3904498	3904525		infB	27
Gok2_libmerged	3904677	3904718		infB	41
Gok2_libmerged	3905255	3905257		infB	2
Gok2_libmerged	3906107	3906131		infB	24
Gok2_libmerged	3906194	3906195		infB	1
Gok2_libmerged	3906495	3906497		infB	2
Gok2_libmerged	3907169	3907220		nusA	51
Gok2_libmerged	3908414	3908506		rimP	92
Gok2_libmerged	3908777	3908786		rimP	9
Gok2_libmerged	3909876	3909878		glmM	2
Gok2_libmerged	3910069	3910253		glmM	184
Gok2_libmerged	3910486	3910506		glmM	20
Gok2_libmerged	3911422	3911446		folP	24
Gok2_libmerged	3911530	3911605		folP	75
Gok2_libmerged	3911773	3911783		folP	10
Gok2_libmerged	3912386	3912401		ftsH	15
Gok2_libmerged	3913058	3913082		ftsH	24
Gok2_libmerged	3913419	3913427		ftsH	8
Gok2_libmerged	3913460	3913544		ftsH	84
Gok2_libmerged	3913694	3913733		ftsH	39
Gok2_libmerged	3913777	3913936		ftsH	159
Gok2_libmerged	3914058	3914113		ftsH	55
Gok2_libmerged	3914347	3914404		rlmE	57
Gok2_libmerged	3914523	3914554		rlmE	31
Gok2_libmerged	3914789	3914796		rlmE	7
Gok2_libmerged	3914946	3915071		yhbY	125
Gok2_libmerged	3915164	3915184		yhbY	20
Gok2_libmerged	3915367	3915381		greA	14
Gok2_libmerged	3915433	3915436		greA	3
Gok2_libmerged	3915550	3915598		greA	48
Gok2_libmerged	3916173	3916226		dacB	53
Gok2_libmerged	3916432	3916442		dacB	10
Gok2_libmerged	3917065	3917077		dacB	12
Gok2_libmerged	3917170	3917294		dacB	124
Gok2_libmerged	3917499	3917529		dacB	30
Gok2_libmerged	3917909	3917920		pmrA	11
Gok2_libmerged	3918090	3918099		pmrA	9
Gok2_libmerged	3918209	3918217		pmrA	8
Gok2_libmerged	3918214	3918229		pmrB	15
Gok2_libmerged	3918778	3918828		pmrB	50
Gok2_libmerged	3919105	3919131		pmrB	26
Gok2_libmerged	3919168	3919177		pmrB	9
Gok2_libmerged	3919376	3919388		cgtA	12
Gok2_libmerged	3919544	3919549		cgtA	5
Gok2_libmerged	3919648	3919691		cgtA	43
Gok2_libmerged	3920050	3920089		cgtA	39
Gok2_libmerged	3920442	3920488		cgtA	46
Gok2_libmerged	3920647	3920687		YPO_RS18520	40
Gok2_libmerged	3920948	3920959		YPO_RS18520	11
Gok2_libmerged	3921076	3921172		YPO_RS18520	96
Gok2_libmerged	3924317	3924345		YPO_RS18545	28
Gok2_libmerged	3924795	3924813		mdh	18
Gok2_libmerged	3925257	3925301		mdh	44
Gok2_libmerged	3925535	3925541		mdh	6
Gok2_libmerged	3927040	3927104		yhcN	64
Gok2_libmerged	3928133	3928140		mpl	7
Gok2_libmerged	3928192	3928216		mpl	24
Gok2_libmerged	3928302	3928329		mpl	27
Gok2_libmerged	3928381	3928401		mpl	20
Gok2_libmerged	3928478	3928532		mpl	54
Gok2_libmerged	3928720	3928744		mpl	24
Gok2_libmerged	3928900	3928940		mpl	40
Gok2_libmerged	3929470	3929532		fbp	62
Gok2_libmerged	3929679	3929729		fbp	50
Gok2_libmerged	3929892	3930066		fbp	174
Gok2_libmerged	3930414	3930415		ppa	1
Gok2_libmerged	3930528	3930566		ppa	38
Gok2_libmerged	3930716	3930725		ppa	9
Gok2_libmerged	3931010	3931019		YPO_RS18580	9
Gok2_libmerged	3931256	3931289		YPO_RS18580	33
Gok2_libmerged	3931539	3931552		YPO_RS18585	13
Gok2_libmerged	3931602	3931634		YPO_RS18585	32
Gok2_libmerged	3931906	3931924		YPO_RS18585	18
Gok2_libmerged	3932347	3932401		YPO_RS18585	54
Gok2_libmerged	3932810	3932817		YPO_RS18585	7
Gok2_libmerged	3932883	3932947		YPO_RS18585	64
Gok2_libmerged	3933374	3933399		YPO_RS18585	25
Gok2_libmerged	3933678	3933709		YPO_RS18585	31
Gok2_libmerged	3934307	3934370		YPO_RS18585	63
Gok2_libmerged	3934529	3934540		YPO_RS18585	11
Gok2_libmerged	3934860	3934882		YPO_RS18585	22
Gok2_libmerged	3934953	3934956		YPO_RS18585	3
Gok2_libmerged	3935742	3935791		YPO_RS18590	49
Gok2_libmerged	3935846	3935885		YPO_RS18590	39
Gok2_libmerged	3936021	3936032		YPO_RS18590	11
Gok2_libmerged	3936203	3936208		YPO_RS18590	5
Gok2_libmerged	3936597	3936632		YPO_RS18590	35
Gok2_libmerged	3936943	3936989		YPO_RS18590	46
Gok2_libmerged	3937468	3937488		msrA	20
Gok2_libmerged	3938210	3938221		YPO_RS18600	11
Gok2_libmerged	3938654	3938661		YPO_RS18600	7
Gok2_libmerged	3939279	3939286		YPO_RS18600	7
Gok2_libmerged	3939375	3939424		YPO_RS18600	49
Gok2_libmerged	3940308	3940350		YPO_RS18610	42
Gok2_libmerged	3940394	3940397		YPO_RS18610	3
Gok2_libmerged	3940996	3940998		cysQ	2
Gok2_libmerged	3941435	3941437		cysQ	2
Gok2_libmerged	3941493	3941503		cysQ	10
Gok2_libmerged	3942235	3942253		YPO_RS18620	18
Gok2_libmerged	3942334	3942454		YPO_RS18620	120
Gok2_libmerged	3942501	3942503		YPO_RS18620	2
Gok2_libmerged	3942539	3942592		YPO_RS18620	53
Gok2_libmerged	3942833	3942842		YPO_RS18620	9
Gok2_libmerged	3942989	3942995		YPO_RS18620	6
Gok2_libmerged	3943246	3943255		YPO_RS18620	9
Gok2_libmerged	3943401	3943404		YPO_RS18620	3
Gok2_libmerged	3944168	3944209		ytfE	41
Gok2_libmerged	3944259	3944291		ytfE	32
Gok2_libmerged	3944455	3944469		ytfE	14
Gok2_libmerged	3944661	3944700		ytfE	39
Gok2_libmerged	3944888	3944909		YPO_RS18630	21
Gok2_libmerged	3945442	3945446		YPO_RS18630	4
Gok2_libmerged	3946035	3946052		YPO_RS18635	17
Gok2_libmerged	3946669	3946717		YPO_RS18640	48
Gok2_libmerged	3946759	3946799		YPO_RS18640	40
Gok2_libmerged	3947046	3947068		YPO_RS18640	22
Gok2_libmerged	3947263	3947266		YPO_RS18645	3
Gok2_libmerged	3947366	3947405		YPO_RS18645	39
Gok2_libmerged	3947468	3947568		YPO_RS18645	100
Gok2_libmerged	3947657	3947665		YPO_RS18645	8
Gok2_libmerged	3948498	3948537		rpsR	39
Gok2_libmerged	3948624	3948658		priB	34
Gok2_libmerged	3948733	3948742		priB	9
Gok2_libmerged	3949709	3949742		yjfP	33
Gok2_libmerged	3949810	3949819		yjfP	9
Gok2_libmerged	3949992	3950002		yjfP	10
Gok2_libmerged	3950348	3950410		yjfP	62
Gok2_libmerged	3950543	3950598		YPO_RS18675	55
Gok2_libmerged	3950633	3950642		YPO_RS18675	9
Gok2_libmerged	3950808	3950810		YPO_RS18675	2
Gok2_libmerged	3950993	3951016		YPO_RS18675	23
Gok2_libmerged	3951580	3951700		YPO_RS18680	120
Gok2_libmerged	3951986	3952011		YPO_RS18680	25
Gok2_libmerged	3952198	3952200		YPO_RS18680	2
Gok2_libmerged	3953519	3953605		YPO_RS18690	86
Gok2_libmerged	3954212	3954229		YPO_RS18690	17
Gok2_libmerged	3954585	3954609		YPO_RS18695	24
Gok2_libmerged	3954829	3954836		YPO_RS18695	7
Gok2_libmerged	3955075	3955083		YPO_RS18695	8
Gok2_libmerged	3955855	3955866		rnpB	11
Gok2_libmerged	3955899	3955901		rnpB	2
Gok2_libmerged	3956323	3956367		rsmI	44
Gok2_libmerged	3956531	3956541		rsmI	10
Gok2_libmerged	3956752	3956773		rsmI	21
Gok2_libmerged	3956853	3956879		rsmI	26
Gok2_libmerged	3957107	3957159		YPO_RS18710	52
Gok2_libmerged	3957263	3957264		YPO_RS18710	1
Gok2_libmerged	3957758	3957760		YPO_RS18710	2
Gok2_libmerged	3957903	3957935		YPO_RS18710	32
Gok2_libmerged	3958246	3958257		YPO_RS18710	11
Gok2_libmerged	3958343	3958344		YPO_RS18710	1
Gok2_libmerged	3959014	3959027		YPO_RS18710	13
Gok2_libmerged	3959500	3959517		YPO_RS18715	17
Gok2_libmerged	3960239	3960258		diaA	19
Gok2_libmerged	3960343	3960378		diaA	35
Gok2_libmerged	3960949	3960964		yraP	15
Gok2_libmerged	3961908	3961943		elbB	35
Gok2_libmerged	3962251	3962267		elbB	16
Gok2_libmerged	3962789	3962829		arcB	40
Gok2_libmerged	3963081	3963118		arcB	37
Gok2_libmerged	3963435	3963437		arcB	2
Gok2_libmerged	3963739	3963801		arcB	62
Gok2_libmerged	3963880	3963906		arcB	26
Gok2_libmerged	3964112	3964150		arcB	38
Gok2_libmerged	3965050	3965101		arcB	51
Gok2_libmerged	3965388	3965412		YPO_RS18745	24
Gok2_libmerged	3966035	3966066		YPO_RS18745	31
Gok2_libmerged	3967134	3967142		gltB	8
Gok2_libmerged	3967629	3967702		gltB	73
Gok2_libmerged	3968677	3968679		gltB	2
Gok2_libmerged	3969025	3969038		gltB	13
Gok2_libmerged	3969213	3969223		gltB	10
Gok2_libmerged	3969864	3969866		gltB	2
Gok2_libmerged	3970302	3970336		gltB	34
Gok2_libmerged	3970405	3970444		gltB	39
Gok2_libmerged	3970581	3970607		gltB	26
Gok2_libmerged	3970729	3970743		gltB	14
Gok2_libmerged	3971876	3971918		YPO_RS18755	42
Gok2_libmerged	3972172	3972260		YPO_RS18755	88
Gok2_libmerged	3972348	3972369		YPO_RS18755	21
Gok2_libmerged	3972475	3972514		YPO_RS18755	39
Gok2_libmerged	3972789	3972794		YPO_RS18755	5
Gok2_libmerged	3973014	3973028		YPO_RS18755	14
Gok2_libmerged	3973742	3973814		YPO_RS18760	72
Gok2_libmerged	3974279	3974307		sspB	28
Gok2_libmerged	3974573	3974575		sspB	2
Gok2_libmerged	3974860	3974887		sspA	27
Gok2_libmerged	3975028	3975060		sspA	32
Gok2_libmerged	3975179	3975187		sspA	8
Gok2_libmerged	3975488	3975497		YPO_RS18775	9
Gok2_libmerged	3975584	3975646		YPO_RS18775	62
Gok2_libmerged	3975643	3975675		rpsI	32
Gok2_libmerged	3975860	3975862		rpsI	2
Gok2_libmerged	3976025	3976035		rpsI	10
Gok2_libmerged	3976113	3976118		rplM	5
Gok2_libmerged	3976471	3976478		rplM	7
Gok2_libmerged	3976867	3976868		YPO_RS18790	1
Gok2_libmerged	3977399	3977488		YPO_RS18790	89
Gok2_libmerged	3977599	3977610		YPO_RS18790	11
Gok2_libmerged	3977671	3977723		YPO_RS18790	52
Gok2_libmerged	3978818	3978825		degQ	7
Gok2_libmerged	3979085	3979089		degQ	4
Gok2_libmerged	3979247	3979278		degQ	31
Gok2_libmerged	3979369	3979384		degQ	15
Gok2_libmerged	3979509	3979520		degQ	11
Gok2_libmerged	3979571	3979578		degQ	7
Gok2_libmerged	3979704	3979731		degQ	27
Gok2_libmerged	3979865	3979870		degQ	5
Gok2_libmerged	3979989	3979993		degQ	4
Gok2_libmerged	3980338	3980359		YPO_RS18805	21
Gok2_libmerged	3980427	3980439		YPO_RS18805	12
Gok2_libmerged	3981052	3981087		degS	35
Gok2_libmerged	3981315	3981326		degS	11
Gok2_libmerged	3981401	3981448		degS	47
Gok2_libmerged	3981786	3981802		degS	16
Gok2_libmerged	3981968	3981985		degS	17
Gok2_libmerged	3982261	3982291		murA	30
Gok2_libmerged	3982546	3982577		murA	31
Gok2_libmerged	3982673	3982688		murA	15
Gok2_libmerged	3982854	3982868		murA	14
Gok2_libmerged	3982901	3982910		murA	9
Gok2_libmerged	3983889	3983931		ibaG	42
Gok2_libmerged	3984244	3984259		mlaB	15
Gok2_libmerged	3984370	3984380		mlaB	10
Gok2_libmerged	3984799	3984842		mlaC	43
Gok2_libmerged	3985025	3985039		mlaC	14
Gok2_libmerged	3985052	3985053		mlaD	1
Gok2_libmerged	3985329	3985334		mlaD	5
Gok2_libmerged	3985567	3985570		mlaD	3
Gok2_libmerged	3985783	3985814		mlaE	31
Gok2_libmerged	3986032	3986044		mlaE	12
Gok2_libmerged	3986623	3986628		mlaF	5
Gok2_libmerged	3986824	3986836		mlaF	12
Gok2_libmerged	3987699	3987848		YPO_RS18850	149
Gok2_libmerged	3987898	3987957		YPO_RS18850	59
Gok2_libmerged	3988045	3988064		YPO_RS18850	19
Gok2_libmerged	3988410	3988431		YPO_RS18850	21
Gok2_libmerged	3988625	3988637		YPO_RS18850	12
Gok2_libmerged	3989010	3989025		kdsD	15
Gok2_libmerged	3989214	3989222		kdsD	8
Gok2_libmerged	3989566	3989619		kdsD	53
Gok2_libmerged	3989687	3989747		kdsD	60
Gok2_libmerged	3990019	3990055		kdsC	36
Gok2_libmerged	3990575	3990580		kdsC	5
Gok2_libmerged	3990577	3990591		lptC	14
Gok2_libmerged	3990902	3990920		lptC	18
Gok2_libmerged	3991052	3991058		lptC	6
Gok2_libmerged	3991263	3991305		lptA	42
Gok2_libmerged	3991453	3991568		lptA	115
Gok2_libmerged	3992192	3992235		lptB	43
Gok2_libmerged	3992317	3992377		lptB	60
Gok2_libmerged	3992468	3992470		rpoN	2
Gok2_libmerged	3992783	3992802		rpoN	19
Gok2_libmerged	3993108	3993126		rpoN	18
Gok2_libmerged	3993259	3993279		rpoN	20
Gok2_libmerged	3993858	3993896		rpoN	38
Gok2_libmerged	3994624	3994685		ptsN	61
Gok2_libmerged	3995215	3995219		rapZ	4
Gok2_libmerged	3995637	3995639		rapZ	2
Gok2_libmerged	3995744	3995785		rapZ	41
Gok2_libmerged	3995828	3995862		rapZ	34
Gok2_libmerged	3996583	3996624		pyrB	41
Gok2_libmerged	3997254	3997255		pyrB	1
Gok2_libmerged	3997295	3997347		pyrB	52
Gok2_libmerged	3997384	3997399		pyrB	15
Gok2_libmerged	3998195	3998196		ridA	1
Gok2_libmerged	3998384	3998391		ridA	7
Gok2_libmerged	3998850	3998869		YPO_RS18920	19
Gok2_libmerged	3999346	3999451		YPO_RS18920	105
Gok2_libmerged	3999638	3999661		YPO_RS18920	23
Gok2_libmerged	4000014	4000030		YPO_RS18925	16
Gok2_libmerged	4000161	4000229		YPO_RS18925	68
Gok2_libmerged	4000292	4000307		YPO_RS18925	15
Gok2_libmerged	4000337	4000412		YPO_RS18925	75
Gok2_libmerged	4000554	4000605		YPO_RS18925	51
Gok2_libmerged	4001238	4001248		YPO_RS18935	10
Gok2_libmerged	4001616	4001650		YPO_RS18935	34
Gok2_libmerged	4001713	4001718		YPO_RS18935	5
Gok2_libmerged	4001713	4001742		tssG	29
Gok2_libmerged	4002252	4002254		tssG	2
Gok2_libmerged	4002374	4002433		tssG	59
Gok2_libmerged	4004006	4004007		tagH	1
Gok2_libmerged	4004223	4004228		tssJ	5
Gok2_libmerged	4004351	4004377		tssJ	26
Gok2_libmerged	4004513	4004548		tssJ	35
Gok2_libmerged	4004633	4004657		tssJ	24
Gok2_libmerged	4004765	4004781		tssK	16
Gok2_libmerged	4004882	4004987		tssK	105
Gok2_libmerged	4005108	4005118		tssK	10
Gok2_libmerged	4005180	4005185		tssK	5
Gok2_libmerged	4005536	4005562		tssK	26
Gok2_libmerged	4005793	4005819		tssK	26
Gok2_libmerged	4005981	4005995		tssK	14
Gok2_libmerged	4006220	4006321		YPO_RS18960	101
Gok2_libmerged	4007209	4007241		tssH	32
Gok2_libmerged	4007519	4007564		tssH	45
Gok2_libmerged	4007988	4008001		tssH	13
Gok2_libmerged	4008123	4008157		tssH	34
Gok2_libmerged	4008336	4008343		tssH	7
Gok2_libmerged	4008554	4008572		tssH	18
Gok2_libmerged	4008742	4008793		tssH	51
Gok2_libmerged	4008995	4008996		tssH	1
Gok2_libmerged	4009121	4009143		tssH	22
Gok2_libmerged	4009461	4009487		tssH	26
Gok2_libmerged	4009484	4009498		YPO_RS18970	14
Gok2_libmerged	4009721	4009761		YPO_RS18970	40
Gok2_libmerged	4010238	4010250		YPO_RS18970	12
Gok2_libmerged	4010394	4010425		tagO	31
Gok2_libmerged	4010695	4010732		tagO	37
Gok2_libmerged	4010838	4010881		tagO	43
Gok2_libmerged	4011550	4011590		tssA	40
Gok2_libmerged	4011742	4011782		tssA	40
Gok2_libmerged	4011945	4011984		tssA	39
Gok2_libmerged	4012822	4012844		tssM	22
Gok2_libmerged	4014493	4014498		tssM	5
Gok2_libmerged	4014706	4014740		tssM	34
Gok2_libmerged	4015280	4015283		tssM	3
Gok2_libmerged	4015901	4015923		tssM	22
Gok2_libmerged	4016485	4016487		YPO_RS18990	2
Gok2_libmerged	4016768	4016782		YPO_RS18990	14
Gok2_libmerged	4017049	4017061		YPO_RS18995	12
Gok2_libmerged	4018054	4018079		YPO_RS19000	25
Gok2_libmerged	4018700	4018706		YPO_RS19000	6
Gok2_libmerged	4019411	4019516		YPO_RS19000	105
Gok2_libmerged	4019704	4019727		YPO_RS19000	23
Gok2_libmerged	4020377	4020386		YPO_RS19010	9
Gok2_libmerged	4020588	4020636		YPO_RS19010	48
Gok2_libmerged	4020737	4020781		YPO_RS19010	44
Gok2_libmerged	4021256	4021306		YPO_RS19010	50
Gok2_libmerged	4021427	4021435		YPO_RS19010	8
Gok2_libmerged	4022336	4022341		YPO_RS19010	5
Gok2_libmerged	4023291	4023302		YPO_RS19015	11
Gok2_libmerged	4023469	4023482		YPO_RS19015	13
Gok2_libmerged	4023762	4023766		YPO_RS19015	4
Gok2_libmerged	4024087	4024094		YPO_RS19015	7
Gok2_libmerged	4024301	4024323		YPO_RS19015	22
Gok2_libmerged	4024480	4024503		YPO_RS19015	23
Gok2_libmerged	4024505	4024521		YPO_RS19020	16
Gok2_libmerged	4024564	4024601		YPO_RS19020	37
Gok2_libmerged	4024706	4024770		YPO_RS19020	64
Gok2_libmerged	4024804	4024922		YPO_RS19020	118
Gok2_libmerged	4024955	4024990		YPO_RS19020	35
Gok2_libmerged	4025040	4025052		YPO_RS19025	12
Gok2_libmerged	4025227	4025231		YPO_RS19025	4
Gok2_libmerged	4025307	4025310		YPO_RS19030	3
Gok2_libmerged	4025499	4025527		YPO_RS19030	28
Gok2_libmerged	4025633	4025669		YPO_RS19035	36
Gok2_libmerged	4027071	4027077		YPO_RS19045	6
Gok2_libmerged	4027250	4027269		YPO_RS19045	19
Gok2_libmerged	4027499	4027523		YPO_RS19045	24
Gok2_libmerged	4028237	4028262		YPO_RS19045	25
Gok2_libmerged	4028382	4028397		YPO_RS19045	15
Gok2_libmerged	4028548	4028570		YPO_RS19045	22
Gok2_libmerged	4028853	4028861		YPO_RS19050	8
Gok2_libmerged	4028960	4028965		YPO_RS19050	5
Gok2_libmerged	4029655	4029663		YPO_RS19055	8
Gok2_libmerged	4029730	4029850		YPO_RS19055	120
Gok2_libmerged	4029927	4029939		YPO_RS19055	12
Gok2_libmerged	4030182	4030193		YPO_RS19055	11
Gok2_libmerged	4030385	4030405		YPO_RS19055	20
Gok2_libmerged	4030602	4030677		YPO_RS19055	75
Gok2_libmerged	4030789	4030791		YPO_RS19055	2
Gok2_libmerged	4032023	4032029		YPO_RS19055	6
Gok2_libmerged	4032207	4032275		YPO_RS19055	68
Gok2_libmerged	4032613	4032661		YPO_RS19055	48
Gok2_libmerged	4033003	4033021		YPO_RS19055	18
Gok2_libmerged	4033107	4033121		YPO_RS19055	14
Gok2_libmerged	4033219	4033283		YPO_RS19055	64
Gok2_libmerged	4033387	4033442		YPO_RS19055	55
Gok2_libmerged	4033522	4033587		YPO_RS19055	65
Gok2_libmerged	4033667	4033786		YPO_RS19060	119
Gok2_libmerged	4033915	4034112		YPO_RS19060	197
Gok2_libmerged	4034190	4034272		YPO_RS19060	82
Gok2_libmerged	4034356	4034359		YPO_RS19060	3
Gok2_libmerged	4034448	4034456		YPO_RS19065	8
Gok2_libmerged	4034508	4034712		YPO_RS19065	204
Gok2_libmerged	4034920	4034926		YPO_RS19070	6
Gok2_libmerged	4035071	4035102		YPO_RS19070	31
Gok2_libmerged	4035207	4035215		YPO_RS19070	8
Gok2_libmerged	4035294	4035308		YPO_RS19070	14
Gok2_libmerged	4035430	4035432		YPO_RS19070	2
Gok2_libmerged	4035654	4035692		YPO_RS19075	38
Gok2_libmerged	4035966	4035979		YPO_RS19075	13
Gok2_libmerged	4036129	4036130		YPO_RS19075	1
Gok2_libmerged	4036240	4036261		YPO_RS19075	21
Gok2_libmerged	4036517	4036567		YPO_RS19075	50
Gok2_libmerged	4037303	4037327		YPO_RS19080	24
Gok2_libmerged	4037440	4037450		YPO_RS19080	10
Gok2_libmerged	4037630	4037656		YPO_RS19080	26
Gok2_libmerged	4037747	4037750		YPO_RS19080	3
Gok2_libmerged	4038203	4038257		rbsD	54
Gok2_libmerged	4038301	4038308		rbsD	7
Gok2_libmerged	4038355	4038388		rbsD	33
Gok2_libmerged	4038781	4038827		YPO_RS19090	46
Gok2_libmerged	4039205	4039232		YPO_RS19090	27
Gok2_libmerged	4039391	4039411		YPO_RS19090	20
Gok2_libmerged	4040029	4040030		deoC	1
Gok2_libmerged	4040912	4040917		ssuE	5
Gok2_libmerged	4041267	4041284		ssuE	17
Gok2_libmerged	4041749	4041759		YPO_RS19105	10
Gok2_libmerged	4041988	4041991		YPO_RS19105	3
Gok2_libmerged	4042039	4042062		YPO_RS19105	23
Gok2_libmerged	4043528	4043539		ssuD	11
Gok2_libmerged	4043909	4043916		ssuC	7
Gok2_libmerged	4044114	4044162		ssuC	48
Gok2_libmerged	4044440	4044449		ssuC	9
Gok2_libmerged	4044645	4044653		ssuB	8
Gok2_libmerged	4045010	4045011		ssuB	1
Gok2_libmerged	4045226	4045286		ssuB	60
Gok2_libmerged	4045949	4045972		YPO_RS19130	23
Gok2_libmerged	4047038	4047046		YPO_RS19135	8
Gok2_libmerged	4047158	4047161		YPO_RS19135	3
Gok2_libmerged	4047253	4047274		YPO_RS19135	21
Gok2_libmerged	4048394	4048403		YPO_RS19140	9
Gok2_libmerged	4049024	4049028		YPO_RS19140	4
Gok2_libmerged	4049217	4049265		YPO_RS19140	48
Gok2_libmerged	4049691	4049709		YPO_RS19140	18
Gok2_libmerged	4049747	4049750		YPO_RS19140	3
Gok2_libmerged	4050177	4050180		YPO_RS19145	3
Gok2_libmerged	4050601	4050614		YPO_RS19145	13
Gok2_libmerged	4051516	4051529		lpxP	13
Gok2_libmerged	4051952	4051973		lpxP	21
Gok2_libmerged	4052176	4052227		lpxP	51
Gok2_libmerged	4053320	4053331		YPO_RS19155	11
Gok2_libmerged	4053498	4053530		YPO_RS19155	32
Gok2_libmerged	4053629	4053632		YPO_RS19155	3
Gok2_libmerged	4053734	4053776		YPO_RS19155	42
Gok2_libmerged	4054135	4054152		YPO_RS19155	17
Gok2_libmerged	4054710	4054784		YPO_RS19160	74
Gok2_libmerged	4054947	4054966		YPO_RS19160	19
Gok2_libmerged	4055872	4055914		YPO_RS19160	42
Gok2_libmerged	4055912	4055914		YPO_RS19165	2
Gok2_libmerged	4056373	4056409		YPO_RS19165	36
Gok2_libmerged	4057151	4057172		YPO_RS19170	21
Gok2_libmerged	4057844	4057856		YPO_RS19170	12
Gok2_libmerged	4057875	4057893		YPO_RS19175	18
Gok2_libmerged	4058006	4058023		YPO_RS19175	17
Gok2_libmerged	4058074	4058078		YPO_RS19175	4
Gok2_libmerged	4058313	4058346		YPO_RS19175	33
Gok2_libmerged	4058463	4058490		YPO_RS19175	27
Gok2_libmerged	4058624	4058634		YPO_RS19175	10
Gok2_libmerged	4058788	4058810		YPO_RS19175	22
Gok2_libmerged	4058860	4058893		YPO_RS19175	33
Gok2_libmerged	4058991	4058996		YPO_RS19175	5
Gok2_libmerged	4059225	4059237		YPO_RS19175	12
Gok2_libmerged	4059422	4059481		YPO_RS19175	59
Gok2_libmerged	4059521	4059523		YPO_RS19180	2
Gok2_libmerged	4059598	4059672		YPO_RS19180	74
Gok2_libmerged	4060638	4060651		yghU	13
Gok2_libmerged	4061824	4061830		YPO_RS19190	6
Gok2_libmerged	4061936	4061950		YPO_RS19190	14
Gok2_libmerged	4062308	4062397		YPO_RS19190	89
Gok2_libmerged	4062466	4062498		YPO_RS19190	32
Gok2_libmerged	4062862	4062871		YPO_RS19195	9
Gok2_libmerged	4062927	4062946		YPO_RS19195	19
Gok2_libmerged	4063422	4063462		YPO_RS19195	40
Gok2_libmerged	4063812	4063828		YPO_RS19195	16
Gok2_libmerged	4064023	4064037		YPO_RS19195	14
Gok2_libmerged	4064666	4064743		YPO_RS19200	77
Gok2_libmerged	4066336	4066391		YPO_RS19215	55
Gok2_libmerged	4066503	4066520		YPO_RS19215	17
Gok2_libmerged	4067243	4067259		YPO_RS19220	16
Gok2_libmerged	4067529	4067541		YPO_RS19220	12
Gok2_libmerged	4067598	4067599		YPO_RS19220	1
Gok2_libmerged	4067750	4067773		YPO_RS19220	23
Gok2_libmerged	4068127	4068158		YPO_RS19225	31
Gok2_libmerged	4068558	4068561		YPO_RS19225	3
Gok2_libmerged	4068703	4068706		YPO_RS19225	3
Gok2_libmerged	4069782	4069887		YPO_RS19235	105
Gok2_libmerged	4070112	4070125		YPO_RS19235	13
Gok2_libmerged	4070357	4070367		YPO_RS19235	10
Gok2_libmerged	4070498	4070607		YPO_RS19235	109
Gok2_libmerged	4070764	4070817		YPO_RS19235	53
Gok2_libmerged	4071040	4071048		YPO_RS19235	8
Gok2_libmerged	4071191	4071200		YPO_RS19240	9
Gok2_libmerged	4071464	4071474		YPO_RS19240	10
Gok2_libmerged	4071578	4071634		YPO_RS19240	56
Gok2_libmerged	4071720	4071733		YPO_RS19240	13
Gok2_libmerged	4071919	4071933		YPO_RS19245	14
Gok2_libmerged	4072128	4072138		YPO_RS19245	10
Gok2_libmerged	4072349	4072395		YPO_RS19245	46
Gok2_libmerged	4073413	4073434		fis	21
Gok2_libmerged	4073886	4073906		dusB	20
Gok2_libmerged	4074024	4074026		dusB	2
Gok2_libmerged	4074208	4074223		dusB	15
Gok2_libmerged	4075079	4075081		prmA	2
Gok2_libmerged	4075471	4075503		prmA	32
Gok2_libmerged	4075855	4075857		prmA	2
Gok2_libmerged	4076040	4076062		panF	22
Gok2_libmerged	4076221	4076224		panF	3
Gok2_libmerged	4076313	4076326		panF	13
Gok2_libmerged	4076432	4076453		panF	21
Gok2_libmerged	4076861	4076881		panF	20
Gok2_libmerged	4076927	4076933		panF	6
Gok2_libmerged	4077376	4077402		panF	26
Gok2_libmerged	4078603	4078672		YPO_RS19285	69
Gok2_libmerged	4079134	4079176		accC	42
Gok2_libmerged	4079259	4079265		accC	6
Gok2_libmerged	4079566	4079569		accC	3
Gok2_libmerged	4079773	4079785		accC	12
Gok2_libmerged	4079839	4079872		accC	33
Gok2_libmerged	4080833	4080850		accB	17
Gok2_libmerged	4081280	4081312		aroQ	32
Gok2_libmerged	4081394	4081402		aroQ	8
Gok2_libmerged	4081766	4081778		msrQ	12
Gok2_libmerged	4081966	4082086		msrQ	120
Gok2_libmerged	4082590	4082615		msrP	25
Gok2_libmerged	4083809	4083838		YPO_RS19315	29
Gok2_libmerged	4084224	4084245		YPO_RS19315	21
Gok2_libmerged	4085299	4085316		csrD	17
Gok2_libmerged	4085778	4085785		csrD	7
Gok2_libmerged	4085982	4085989		csrD	7
Gok2_libmerged	4086034	4086084		csrD	50
Gok2_libmerged	4086300	4086313		csrD	13
Gok2_libmerged	4086435	4086462		csrD	27
Gok2_libmerged	4086696	4086702		csrD	6
Gok2_libmerged	4086953	4086960		csrD	7
Gok2_libmerged	4087297	4087303		YPO_RS19325	6
Gok2_libmerged	4087334	4087374		YPO_RS19325	40
Gok2_libmerged	4087690	4087705		YPO_RS19325	15
Gok2_libmerged	4088052	4088073		YPO_RS19325	21
Gok2_libmerged	4088656	4088744		mreC	88
Gok2_libmerged	4088876	4088884		mreC	8
Gok2_libmerged	4089065	4089066		mreC	1
Gok2_libmerged	4089149	4089195		mreC	46
Gok2_libmerged	4089699	4089703		mreD	4
Gok2_libmerged	4090166	4090179		YPO_RS19340	13
Gok2_libmerged	4090246	4090277		YPO_RS19340	31
Gok2_libmerged	4090426	4090475		YPO_RS19340	49
Gok2_libmerged	4090515	4090531		YPO_RS19340	16
Gok2_libmerged	4090789	4090808		rng	19
Gok2_libmerged	4091210	4091226		rng	16
Gok2_libmerged	4091492	4091505		rng	13
Gok2_libmerged	4091814	4091855		rng	41
Gok2_libmerged	4093006	4093030		YPO_RS19350	24
Gok2_libmerged	4093158	4093188		YPO_RS19350	30
Gok2_libmerged	4093424	4093463		YPO_RS19350	39
Gok2_libmerged	4093827	4093892		YPO_RS19350	65
Gok2_libmerged	4094343	4094408		YPO_RS19350	65
Gok2_libmerged	4095167	4095171		YPO_RS19350	4
Gok2_libmerged	4095490	4095493		YPO_RS19350	3
Gok2_libmerged	4095922	4095940		YPO_RS19350	18
Gok2_libmerged	4096010	4096013		YPO_RS19350	3
Gok2_libmerged	4096194	4096200		YPO_RS19355	6
Gok2_libmerged	4096263	4096277		YPO_RS19355	14
Gok2_libmerged	4096352	4096356		YPO_RS19355	4
Gok2_libmerged	4096758	4096803		YPO_RS19355	45
Gok2_libmerged	4096955	4096973		YPO_RS19355	18
Gok2_libmerged	4097777	4097783		tldD	6
Gok2_libmerged	4098633	4098673		YPO_RS19365	40
Gok2_libmerged	4098763	4098804		YPO_RS19365	41
Gok2_libmerged	4098847	4098863		YPO_RS19365	16
Gok2_libmerged	4098970	4099042		YPO_RS19365	72
Gok2_libmerged	4099096	4099253		YPO_RS19365	157
Gok2_libmerged	4099319	4099356		YPO_RS19365	37
Gok2_libmerged	4099397	4099496		YPO_RS19365	99
Gok2_libmerged	4100289	4100319		YPO_RS19365	30
Gok2_libmerged	4100785	4100788		YPO_RS19365	3
Gok2_libmerged	4101278	4101285		YPO_RS19365	7
Gok2_libmerged	4101516	4101539		YPO_RS19370	23
Gok2_libmerged	4101621	4101640		YPO_RS19370	19
Gok2_libmerged	4101706	4102019		YPO_RS19370	313
Gok2_libmerged	4102225	4102227		YPO_RS19370	2
Gok2_libmerged	4102321	4102377		YPO_RS19370	56
Gok2_libmerged	4102785	4102809		YPO_RS19370	24
Gok2_libmerged	4103073	4103102		YPO_RS19370	29
Gok2_libmerged	4103804	4103814		YPO_RS19370	10
Gok2_libmerged	4104182	4104190		YPO_RS19370	8
Gok2_libmerged	4104318	4104326		YPO_RS19370	8
Gok2_libmerged	4105061	4105078		YPO_RS19380	17
Gok2_libmerged	4105163	4105198		YPO_RS19380	35
Gok2_libmerged	4105896	4105926		YPO_RS19390	30
Gok2_libmerged	4106319	4106422		YPO_RS19390	103
Gok2_libmerged	4106837	4106858		YPO_RS19390	21
Gok2_libmerged	4107440	4107466		YPO_RS19390	26
Gok2_libmerged	4107579	4107591		YPO_RS19390	12
Gok2_libmerged	4107636	4107698		YPO_RS19390	62
Gok2_libmerged	4108347	4108379		YPO_RS19390	32
Gok2_libmerged	4108595	4108598		YPO_RS19390	3
Gok2_libmerged	4108787	4108795		YPO_RS19390	8
Gok2_libmerged	4109015	4109056		YPO_RS19390	41
Gok2_libmerged	4109297	4109309		YPO_RS19390	12
Gok2_libmerged	4109387	4109389		YPO_RS19390	2
Gok2_libmerged	4109482	4109526		YPO_RS19390	44
Gok2_libmerged	4109572	4109637		YPO_RS19390	65
Gok2_libmerged	4109833	4109845		YPO_RS19390	12
Gok2_libmerged	4110133	4110134		YPO_RS19390	1
Gok2_libmerged	4110674	4110755		YPO_RS19395	81
Gok2_libmerged	4110812	4110815		YPO_RS19395	3
Gok2_libmerged	4111131	4111141		YPO_RS19395	10
Gok2_libmerged	4111414	4111453		YPO_RS19395	39
Gok2_libmerged	4111610	4111643		YPO_RS19395	33
Gok2_libmerged	4111816	4111832		YPO_RS19395	16
Gok2_libmerged	4111981	4112002		YPO_RS19395	21
Gok2_libmerged	4112135	4112177		YPO_RS19395	42
Gok2_libmerged	4112254	4112271		YPO_RS19395	17
Gok2_libmerged	4112397	4112404		YPO_RS19395	7
Gok2_libmerged	4112511	4112916		YPO_RS19400	405
Gok2_libmerged	4113031	4113056		YPO_RS19400	25
Gok2_libmerged	4113181	4113386		YPO_RS19400	205
Gok2_libmerged	4113494	4113544		YPO_RS19400	50
Gok2_libmerged	4113629	4113683		YPO_RS19400	54
Gok2_libmerged	4113755	4113774		YPO_RS19400	19
Gok2_libmerged	4113971	4114114		YPO_RS19405	143
Gok2_libmerged	4114160	4114261		YPO_RS19405	101
Gok2_libmerged	4114306	4114403		YPO_RS19405	97
Gok2_libmerged	4114479	4114636		YPO_RS19405	157
Gok2_libmerged	4114735	4114759		YPO_RS19405	24
Gok2_libmerged	4114882	4114956		YPO_RS19405	74
Gok2_libmerged	4115317	4115353		YPO_RS19405	36
Gok2_libmerged	4115509	4115545		YPO_RS19405	36
Gok2_libmerged	4115621	4115653		YPO_RS19405	32
Gok2_libmerged	4115882	4115950		YPO_RS19405	68
Gok2_libmerged	4116089	4116099		YPO_RS19405	10
Gok2_libmerged	4116144	4116163		YPO_RS19405	19
Gok2_libmerged	4116432	4116434		YPO_RS19405	2
Gok2_libmerged	4116706	4116724		YPO_RS19410	18
Gok2_libmerged	4116774	4116879		YPO_RS19410	105
Gok2_libmerged	4116936	4116948		YPO_RS19410	12
Gok2_libmerged	4117001	4117064		YPO_RS19410	63
Gok2_libmerged	4117246	4117262		YPO_RS19410	16
Gok2_libmerged	4117500	4117537		YPO_RS19410	37
Gok2_libmerged	4117798	4117838		aaeR	40
Gok2_libmerged	4117952	4118008		aaeR	56
Gok2_libmerged	4118251	4118259		aaeR	8
Gok2_libmerged	4118704	4118709		aaeR	5
Gok2_libmerged	4119163	4119204		YPO_RS19420	41
Gok2_libmerged	4119289	4119359		aaeA	70
Gok2_libmerged	4119736	4119740		aaeA	4
Gok2_libmerged	4120139	4120158		aaeA	19
Gok2_libmerged	4120160	4120238		aaeB	78
Gok2_libmerged	4120460	4120478		aaeB	18
Gok2_libmerged	4120550	4120560		aaeB	10
Gok2_libmerged	4121817	4121840		aaeB	23
Gok2_libmerged	4124045	4124081		YPO_RS19440	36
Gok2_libmerged	4124516	4124518		YPO_RS19440	2
Gok2_libmerged	4124523	4124536		YPO_RS19445	13
Gok2_libmerged	4124787	4124804		YPO_RS19445	17
Gok2_libmerged	4125403	4125407		YPO_RS19450	4
Gok2_libmerged	4126110	4126129		pmbA	19
Gok2_libmerged	4126252	4126254		pmbA	2
Gok2_libmerged	4126359	4126365		pmbA	6
Gok2_libmerged	4126647	4126661		pmbA	14
Gok2_libmerged	4126884	4126899		pmbA	15
Gok2_libmerged	4127234	4127436		YPO_RS19460	202
Gok2_libmerged	4127618	4127632		YPO_RS19460	14
Gok2_libmerged	4127737	4127751		YPO_RS19460	14
Gok2_libmerged	4128791	4128862		rnk	71
Gok2_libmerged	4129461	4129474		treC	13
Gok2_libmerged	4129843	4129846		treC	3
Gok2_libmerged	4130010	4130018		treC	8
Gok2_libmerged	4130279	4130282		treC	3
Gok2_libmerged	4130516	4130545		treC	29
Gok2_libmerged	4130751	4130765		treC	14
Gok2_libmerged	4131232	4131264		treB	32
Gok2_libmerged	4132071	4132085		treB	14
Gok2_libmerged	4132223	4132244		treB	21
Gok2_libmerged	4133182	4133231		treR	49
Gok2_libmerged	4133561	4133585		treR	24
Gok2_libmerged	4133928	4133958		treR	30
Gok2_libmerged	4134234	4134247		YPO_RS19490	13
Gok2_libmerged	4134893	4134905		YPO_RS19495	12
Gok2_libmerged	4135091	4135117		YPO_RS19495	26
Gok2_libmerged	4135236	4135240		YPO_RS19495	4
Gok2_libmerged	4135418	4135443		YPO_RS19495	25
Gok2_libmerged	4135613	4135695		YPO_RS19500	82
Gok2_libmerged	4136170	4136176		YPO_RS19500	6
Gok2_libmerged	4136235	4136268		YPO_RS19500	33
Gok2_libmerged	4136621	4136627		YPO_RS19500	6
Gok2_libmerged	4139008	4139060		tssE	52
Gok2_libmerged	4139176	4139223		tssE	47
Gok2_libmerged	4139840	4139921		tssC	81
Gok2_libmerged	4140143	4140161		tssC	18
Gok2_libmerged	4140441	4140446		tssC	5
Gok2_libmerged	4140979	4140980		tssB	1
Gok2_libmerged	4141222	4141231		tssB	9
Gok2_libmerged	4141449	4141476		tssB	27
Gok2_libmerged	4142067	4142163		YPO_RS19530	96
Gok2_libmerged	4142276	4142292		YPO_RS19530	16
Gok2_libmerged	4142670	4142906		YPO_RS19535	236
Gok2_libmerged	4143537	4143562		malM	25
Gok2_libmerged	4143730	4143771		malM	41
Gok2_libmerged	4144845	4144848		YPO_RS19545	3
Gok2_libmerged	4144905	4144935		YPO_RS19545	30
Gok2_libmerged	4145099	4145116		YPO_RS19545	17
Gok2_libmerged	4145321	4145406		YPO_RS19545	85
Gok2_libmerged	4145655	4145695		YPO_RS19545	40
Gok2_libmerged	4146091	4146100		malK	9
Gok2_libmerged	4146233	4146250		malK	17
Gok2_libmerged	4147111	4147131		YPO_RS19555	20
Gok2_libmerged	4147242	4147246		YPO_RS19555	4
Gok2_libmerged	4147917	4147969		malE	52
Gok2_libmerged	4148366	4148374		malE	8
Gok2_libmerged	4148809	4148812		malE	3
Gok2_libmerged	4148934	4148937		malE	3
Gok2_libmerged	4149222	4149244		malF	22
Gok2_libmerged	4149327	4149353		malF	26
Gok2_libmerged	4149983	4149991		malF	8
Gok2_libmerged	4150382	4150428		malF	46
Gok2_libmerged	4151135	4151147		malG	12
Gok2_libmerged	4151559	4151585		malG	26
Gok2_libmerged	4152141	4152179		psiE	38
Gok2_libmerged	4152218	4152232		psiE	14
Gok2_libmerged	4152478	4152496		pgi	18
Gok2_libmerged	4152637	4152653		pgi	16
Gok2_libmerged	4152691	4152715		pgi	24
Gok2_libmerged	4152814	4152868		pgi	54
Gok2_libmerged	4153011	4153012		pgi	1
Gok2_libmerged	4153504	4153521		pgi	17
Gok2_libmerged	4153945	4154034		pgi	89
Gok2_libmerged	4155601	4155605		lysC	4
Gok2_libmerged	4155667	4155716		lysC	49
Gok2_libmerged	4155784	4155789		lysC	5
Gok2_libmerged	4156475	4156499		YPO_RS19590	24
Gok2_libmerged	4156537	4156565		YPO_RS19590	28
Gok2_libmerged	4156607	4156650		YPO_RS19590	43
Gok2_libmerged	4157114	4157145		YPO_RS19590	31
Gok2_libmerged	4157252	4157277		YPO_RS19590	25
Gok2_libmerged	4158364	4158384		YPO_RS19595	20
Gok2_libmerged	4158652	4158738		YPO_RS19595	86
Gok2_libmerged	4158926	4158971		YPO_RS19595	45
Gok2_libmerged	4159063	4159102		YPO_RS19595	39
Gok2_libmerged	4159474	4159478		YPO_RS19595	4
Gok2_libmerged	4159572	4159598		YPO_RS19595	26
Gok2_libmerged	4159717	4159718		YPO_RS19595	1
Gok2_libmerged	4159790	4159826		YPO_RS19595	36
Gok2_libmerged	4160236	4160264		YPO_RS19595	28
Gok2_libmerged	4160617	4160769		YPO_RS19595	152
Gok2_libmerged	4160799	4160854		YPO_RS19595	55
Gok2_libmerged	4161079	4161095		YPO_RS19595	16
Gok2_libmerged	4161318	4161332		YPO_RS19595	14
Gok2_libmerged	4161875	4161904		YPO_RS19595	29
Gok2_libmerged	4162189	4162211		YPO_RS19595	22
Gok2_libmerged	4162404	4162407		YPO_RS19595	3
Gok2_libmerged	4162463	4162528		YPO_RS19595	65
Gok2_libmerged	4162582	4162607		YPO_RS19595	25
Gok2_libmerged	4162833	4162875		YPO_RS19595	42
Gok2_libmerged	4163115	4163125		metH	10
Gok2_libmerged	4163463	4163465		metH	2
Gok2_libmerged	4163828	4163829		metH	1
Gok2_libmerged	4164199	4164235		metH	36
Gok2_libmerged	4164486	4164491		metH	5
Gok2_libmerged	4164541	4164547		metH	6
Gok2_libmerged	4164744	4164747		metH	3
Gok2_libmerged	4164955	4164957		metH	2
Gok2_libmerged	4165206	4165216		metH	10
Gok2_libmerged	4165379	4165399		metH	20
Gok2_libmerged	4165863	4165866		metH	3
Gok2_libmerged	4166237	4166239		metH	2
Gok2_libmerged	4166571	4166573		metH	2
Gok2_libmerged	4168216	4168219		aceK	3
Gok2_libmerged	4168453	4168473		aceK	20
Gok2_libmerged	4169241	4169288		aceK	47
Gok2_libmerged	4169504	4169555		aceK	51
Gok2_libmerged	4169972	4170004		aceA	32
Gok2_libmerged	4170378	4170431		aceA	53
Gok2_libmerged	4170958	4170961		aceA	3
Gok2_libmerged	4171269	4171278		aceA	9
Gok2_libmerged	4171483	4171486		aceB	3
Gok2_libmerged	4171635	4171657		aceB	22
Gok2_libmerged	4172017	4172019		aceB	2
Gok2_libmerged	4172165	4172202		aceB	37
Gok2_libmerged	4172516	4172532		aceB	16
Gok2_libmerged	4172594	4172609		aceB	15
Gok2_libmerged	4172660	4172662		aceB	2
Gok2_libmerged	4173345	4173352		metA	7
Gok2_libmerged	4173665	4173682		metA	17
Gok2_libmerged	4173888	4173927		metA	39
Gok2_libmerged	4175222	4175245		YPO_RS19635	23
Gok2_libmerged	4175261	4175278		rrf	17
Gok2_libmerged	4175550	4175582		YPO_RS19645	32
Gok2_libmerged	4176213	4176223		YPO_RS19645	10
Gok2_libmerged	4177514	4177519		YPO_RS19645	5
Gok2_libmerged	4180310	4180311		YPO_RS19660	1
Gok2_libmerged	4180488	4180514		YPO_RS19665	26
Gok2_libmerged	4181839	4181840		purH	1
Gok2_libmerged	4182240	4182268		purH	28
Gok2_libmerged	4182980	4182984		purD	4
Gok2_libmerged	4183232	4183240		purD	8
Gok2_libmerged	4184661	4184663		YPO_RS19680	2
Gok2_libmerged	4184721	4184735		YPO_RS19680	14
Gok2_libmerged	4185368	4185384		YPO_RS19690	16
Gok2_libmerged	4186353	4186366		nfi	13
Gok2_libmerged	4186783	4186796		hemE	13
Gok2_libmerged	4186832	4186868		hemE	36
Gok2_libmerged	4187161	4187167		hemE	6
Gok2_libmerged	4187359	4187376		hemE	17
Gok2_libmerged	4187536	4187597		hemE	61
Gok2_libmerged	4188165	4188313		YPO_RS19705	148
Gok2_libmerged	4188399	4188405		YPO_RS19705	6
Gok2_libmerged	4188492	4188520		YPO_RS19705	28
Gok2_libmerged	4188577	4188579		YPO_RS19705	2
Gok2_libmerged	4188634	4188679		YPO_RS19705	45
Gok2_libmerged	4189171	4189178		nudC	7
Gok2_libmerged	4189604	4189619		nudC	15
Gok2_libmerged	4189815	4189828		rsd	13
Gok2_libmerged	4189879	4189894		rsd	15
Gok2_libmerged	4189984	4190039		rsd	55
Gok2_libmerged	4190164	4190179		rsd	15
Gok2_libmerged	4190706	4190707		thiC	1
Gok2_libmerged	4191159	4191198		thiC	39
Gok2_libmerged	4191266	4191271		thiC	5
Gok2_libmerged	4191369	4191380		thiC	11
Gok2_libmerged	4192586	4192614		thiC	28
Gok2_libmerged	4193187	4193194		thiE	7
Gok2_libmerged	4193299	4193308		thiE	9
Gok2_libmerged	4193299	4193328		YPO_RS19730	29
Gok2_libmerged	4193536	4193568		YPO_RS19730	32
Gok2_libmerged	4194170	4194173		thiS	3
Gok2_libmerged	4194470	4194474		YPO_RS19740	4
Gok2_libmerged	4195831	4195834		thiH	3
Gok2_libmerged	4195895	4195922		thiH	27
Gok2_libmerged	4196679	4196686		YPO_RS19750	7
Gok2_libmerged	4196979	4197080		YPO_RS19750	101
Gok2_libmerged	4197264	4197281		rpoC	17
Gok2_libmerged	4197359	4197380		rpoC	21
Gok2_libmerged	4197809	4197811		rpoC	2
Gok2_libmerged	4198095	4198131		rpoC	36
Gok2_libmerged	4198192	4198224		rpoC	32
Gok2_libmerged	4198444	4198445		rpoC	1
Gok2_libmerged	4198791	4198806		rpoC	15
Gok2_libmerged	4198856	4198958		rpoC	102
Gok2_libmerged	4199004	4199039		rpoC	35
Gok2_libmerged	4199244	4199287		rpoC	43
Gok2_libmerged	4200889	4200928		rpoC	39
Gok2_libmerged	4201904	4201912		rpoB	8
Gok2_libmerged	4202895	4202911		rpoB	16
Gok2_libmerged	4203357	4203385		rpoB	28
Gok2_libmerged	4203491	4203540		rpoB	49
Gok2_libmerged	4203817	4203848		rpoB	31
Gok2_libmerged	4203914	4203915		rpoB	1
Gok2_libmerged	4204284	4204293		rpoB	9
Gok2_libmerged	4204708	4204732		rpoB	24
Gok2_libmerged	4205241	4205267		rpoB	26
Gok2_libmerged	4205620	4205625		rpoB	5
Gok2_libmerged	4206000	4206020		rplL	20
Gok2_libmerged	4207281	4207295		rplA	14
Gok2_libmerged	4207460	4207540		rplA	80
Gok2_libmerged	4208110	4208125		rplK	15
Gok2_libmerged	4208167	4208184		rplK	17
Gok2_libmerged	4208232	4208259		rplK	27
Gok2_libmerged	4209119	4209153		nusG	34
Gok2_libmerged	4209155	4209159		secE	4
Gok2_libmerged	4209434	4209454		secE	20
Gok2_libmerged	4209864	4209906		tuf	42
Gok2_libmerged	4210071	4210113		tuf	42
Gok2_libmerged	4210284	4210285		tuf	1
Gok2_libmerged	4210865	4210870		tuf	5
Gok2_libmerged	4211491	4211501		YPO_RS19815	10
Gok2_libmerged	4212030	4212040		YPO_RS19820	10
Gok2_libmerged	4212511	4212519		YPO_RS19820	8
Gok2_libmerged	4213107	4213122		YPO_RS19825	15
Gok2_libmerged	4213281	4213298		YPO_RS19825	17
Gok2_libmerged	4213370	4213404		YPO_RS19825	34
Gok2_libmerged	4213639	4213646		YPO_RS19825	7
Gok2_libmerged	4213921	4213962		YPO_RS19830	41
Gok2_libmerged	4214010	4214054		YPO_RS19830	44
Gok2_libmerged	4214394	4214396		YPO_RS19830	2
Gok2_libmerged	4214706	4214726		coaA	20
Gok2_libmerged	4214792	4214849		coaA	57
Gok2_libmerged	4215164	4215166		coaA	2
Gok2_libmerged	4215219	4215375		coaA	156
Gok2_libmerged	4215461	4215633		coaA	172
Gok2_libmerged	4215939	4215977		birA	38
Gok2_libmerged	4216106	4216125		birA	19
Gok2_libmerged	4216337	4216410		birA	73
Gok2_libmerged	4216607	4216626		birA	19
Gok2_libmerged	4216624	4216626		murB	2
Gok2_libmerged	4216769	4216770		murB	1
Gok2_libmerged	4216841	4216912		murB	71
Gok2_libmerged	4217010	4217054		murB	44
Gok2_libmerged	4217117	4217132		murB	15
Gok2_libmerged	4217225	4217288		murB	63
Gok2_libmerged	4217344	4217374		murB	30
Gok2_libmerged	4217425	4217498		murB	73
Gok2_libmerged	4218437	4218452		YPO_RS19855	15
Gok2_libmerged	4223131	4223179		YPO_RS19870	48
Gok2_libmerged	4223891	4223902		hemG	11
Gok2_libmerged	4224138	4224173		hemG	35
Gok2_libmerged	4224353	4224459		trkH	106
Gok2_libmerged	4224853	4224911		trkH	58
Gok2_libmerged	4224978	4224992		trkH	14
Gok2_libmerged	4225086	4225100		trkH	14
Gok2_libmerged	4225505	4225572		trkH	67
Gok2_libmerged	4225654	4225673		trkH	19
Gok2_libmerged	4225733	4225749		trkH	16
Gok2_libmerged	4226787	4226812		YPO_RS19895	25
Gok2_libmerged	4226969	4226997		YPO_RS19900	28
Gok2_libmerged	4227236	4227416		pepQ	180
Gok2_libmerged	4227530	4227556		pepQ	26
Gok2_libmerged	4227800	4227807		pepQ	7
Gok2_libmerged	4227840	4227902		pepQ	62
Gok2_libmerged	4228122	4228266		pepQ	144
Gok2_libmerged	4228823	4228847		fadB	24
Gok2_libmerged	4228938	4228961		fadB	23
Gok2_libmerged	4229019	4229024		fadB	5
Gok2_libmerged	4229151	4229196		fadB	45
Gok2_libmerged	4229345	4229420		fadB	75
Gok2_libmerged	4229960	4230005		fadB	45
Gok2_libmerged	4230197	4230199		fadB	2
Gok2_libmerged	4230638	4230647		fadB	9
Gok2_libmerged	4231055	4231078		fadA	23
Gok2_libmerged	4231316	4231327		fadA	11
Gok2_libmerged	4231908	4231939		fadA	31
Gok2_libmerged	4232348	4232349		fre	1
Gok2_libmerged	4232993	4233001		fre	8
Gok2_libmerged	4233778	4233780		ubiD	2
Gok2_libmerged	4234126	4234157		ubiD	31
Gok2_libmerged	4234208	4234274		ubiD	66
Gok2_libmerged	4235147	4235221		rfaH	74
Gok2_libmerged	4235445	4235448		hemB	3
Gok2_libmerged	4235771	4235794		hemB	23
Gok2_libmerged	4236284	4236285		hemB	1
Gok2_libmerged	4236429	4236467		hemB	38
Gok2_libmerged	4236634	4236671		YPO_RS19940	37
Gok2_libmerged	4236740	4236817		YPO_RS19940	77
Gok2_libmerged	4236856	4236858		YPO_RS19945	2
Gok2_libmerged	4236943	4236968		YPO_RS19945	25
Gok2_libmerged	4237024	4237028		YPO_RS19945	4
Gok2_libmerged	4237086	4237124		YPO_RS19945	38
Gok2_libmerged	4237155	4237225		YPO_RS19945	70
Gok2_libmerged	4237425	4237452		YPO_RS19945	27
Gok2_libmerged	4238050	4238188		YPO_RS19950	138
Gok2_libmerged	4238476	4238560		YPO_RS19950	84
Gok2_libmerged	4238624	4238635		YPO_RS19950	11
Gok2_libmerged	4239672	4239686		tatC	14
Gok2_libmerged	4240552	4240568		tatB	16
Gok2_libmerged	4240833	4240837		YPO_RS19970	4
Gok2_libmerged	4241614	4241631		ubiB	17
Gok2_libmerged	4241875	4242026		ubiB	151
Gok2_libmerged	4242267	4242328		ubiB	61
Gok2_libmerged	4242460	4242463		ubiB	3
Gok2_libmerged	4242796	4242801		ubiB	5
Gok2_libmerged	4242801	4242817		YPO_RS19980	16
Gok2_libmerged	4242916	4242973		YPO_RS19980	57
Gok2_libmerged	4243285	4243322		YPO_RS19980	37
Gok2_libmerged	4243420	4243451		YPO_RS19980	31
Gok2_libmerged	4243812	4243939		ubiE	127
Gok2_libmerged	4244023	4244033		ubiE	10
Gok2_libmerged	4244111	4244126		ubiE	15
Gok2_libmerged	4244202	4244220		ubiE	18
Gok2_libmerged	4243465	4243478		ubiE	13
Gok2_libmerged	4244450	4244459		rmuC	9
Gok2_libmerged	4244923	4244945		rmuC	22
Gok2_libmerged	4245765	4245770		rmuC	5
Gok2_libmerged	4246123	4246137		YPO_RS19995	14
Gok2_libmerged	4246414	4246434		YPO_RS19995	20
Gok2_libmerged	4246827	4246831		YPO_RS20000	4
Gok2_libmerged	4247365	4247371		YPO_RS20000	6
Gok2_libmerged	4247613	4247619		YPO_RS20000	6
Gok2_libmerged	4247930	4247969		YPO_RS20000	39
Gok2_libmerged	4248123	4248158		YPO_RS20000	35
Gok2_libmerged	4248459	4248513		YPO_RS20000	54
Gok2_libmerged	4249002	4249039		YPO_RS20005	37
Gok2_libmerged	4249180	4249182		YPO_RS20005	2
Gok2_libmerged	4249549	4249557		YPO_RS20005	8
Gok2_libmerged	4250397	4250458		udp	61
Gok2_libmerged	4250585	4250611		udp	26
Gok2_libmerged	4251204	4251243		YPO_RS20015	39
Gok2_libmerged	4251318	4251327		YPO_RS20015	9
Gok2_libmerged	4251779	4251798		YPO_RS20015	19
Gok2_libmerged	4252310	4252363		metE	53
Gok2_libmerged	4252789	4252812		metE	23
Gok2_libmerged	4252938	4252984		metE	46
Gok2_libmerged	4253330	4253332		metE	2
Gok2_libmerged	4253588	4253612		metE	24
Gok2_libmerged	4253669	4253677		metE	8
Gok2_libmerged	4253833	4253863		metE	30
Gok2_libmerged	4253959	4253968		metE	9
Gok2_libmerged	4254071	4254074		metE	3
Gok2_libmerged	4254284	4254289		metE	5
Gok2_libmerged	4254355	4254360		metE	5
Gok2_libmerged	4254478	4254491		metR	13
Gok2_libmerged	4254830	4254855		metR	25
Gok2_libmerged	4254900	4254920		metR	20
Gok2_libmerged	4255202	4255215		metR	13
Gok2_libmerged	4255438	4255472		YPO_RS20030	34
Gok2_libmerged	4255864	4255907		YPO_RS20030	43
Gok2_libmerged	4255985	4256004		YPO_RS20030	19
Gok2_libmerged	4256106	4256120		YPO_RS20030	14
Gok2_libmerged	4256573	4256703		YPO_RS20035	130
Gok2_libmerged	4256764	4256871		YPO_RS20035	107
Gok2_libmerged	4257037	4257067		YPO_RS20035	30
Gok2_libmerged	4257115	4257166		YPO_RS20035	51
Gok2_libmerged	4257360	4257417		YPO_RS20035	57
Gok2_libmerged	4257700	4257709		ugpQ	9
Gok2_libmerged	4258132	4258175		ugpQ	43
Gok2_libmerged	4258676	4258683		YPO_RS20045	7
Gok2_libmerged	4259196	4259231		YPO_RS20045	35
Gok2_libmerged	4259630	4259679		ugpE	49
Gok2_libmerged	4259742	4259786		ugpE	44
Gok2_libmerged	4260171	4260271		ugpE	100
Gok2_libmerged	4260268	4260284		ugpA	16
Gok2_libmerged	4260935	4260937		ugpA	2
Gok2_libmerged	4261808	4261813		ugpB	5
Gok2_libmerged	4261915	4261918		ugpB	3
Gok2_libmerged	4262010	4262039		ugpB	29
Gok2_libmerged	4262397	4262408		ugpB	11
Gok2_libmerged	4262489	4262492		ugpB	3
Gok2_libmerged	4262755	4262768		ugpB	13
Gok2_libmerged	4263327	4263367		YPO_RS20065	40
Gok2_libmerged	4263443	4263536		YPO_RS20065	93
Gok2_libmerged	4264168	4264172		YPO_RS20070	4
Gok2_libmerged	4264253	4264447		YPO_RS20070	194
Gok2_libmerged	4264636	4264681		YPO_RS20070	45
Gok2_libmerged	4265026	4265036		YPO_RS20070	10
Gok2_libmerged	4265290	4265294		YPO_RS20070	4
Gok2_libmerged	4266014	4266082		YPO_RS20070	68
Gok2_libmerged	4266517	4266558		YPO_RS20075	41
Gok2_libmerged	4266812	4266846		YPO_RS20075	34
Gok2_libmerged	4267187	4267226		YPO_RS20080	39
Gok2_libmerged	4267507	4267536		YPO_RS20080	29
Gok2_libmerged	4267738	4267741		YPO_RS20080	3
Gok2_libmerged	4267894	4267917		YPO_RS20085	23
Gok2_libmerged	4268550	4268587		YPO_RS20090	37
Gok2_libmerged	4268705	4268752		YPO_RS20090	47
Gok2_libmerged	4269322	4269369		YPO_RS20090	47
Gok2_libmerged	4269527	4269540		YPO_RS20090	13
Gok2_libmerged	4269655	4269679		YPO_RS20095	24
Gok2_libmerged	4269891	4269899		YPO_RS20095	8
Gok2_libmerged	4269960	4269998		YPO_RS20095	38
Gok2_libmerged	4270093	4270116		YPO_RS20095	23
Gok2_libmerged	4270418	4270471		livF	53
Gok2_libmerged	4270768	4270780		livF	12
Gok2_libmerged	4270942	4270990		livF	48
Gok2_libmerged	4271246	4271271		YPO_RS20105	25
Gok2_libmerged	4271567	4271595		YPO_RS20105	28
Gok2_libmerged	4271960	4272003		YPO_RS20110	43
Gok2_libmerged	4272277	4272305		YPO_RS20110	28
Gok2_libmerged	4272406	4272422		YPO_RS20110	16
Gok2_libmerged	4272665	4272692		YPO_RS20110	27
Gok2_libmerged	4273035	4273043		YPO_RS20110	8
Gok2_libmerged	4273348	4273380		livH	32
Gok2_libmerged	4273660	4273694		livH	34
Gok2_libmerged	4273776	4273778		livH	2
Gok2_libmerged	4274425	4274431		YPO_RS20120	6
Gok2_libmerged	4274499	4274524		YPO_RS20120	25
Gok2_libmerged	4274686	4274696		YPO_RS20120	10
Gok2_libmerged	4275085	4275150		YPO_RS20120	65
Gok2_libmerged	4275238	4275259		YPO_RS20120	21
Gok2_libmerged	4276419	4276493		YPO_RS20130	74
Gok2_libmerged	4276799	4276874		YPO_RS20130	75
Gok2_libmerged	4277590	4277622		rpoH	32
Gok2_libmerged	4278469	4278536		ftsX	67
Gok2_libmerged	4278596	4278600		ftsX	4
Gok2_libmerged	4278718	4278736		ftsX	18
Gok2_libmerged	4278817	4278826		ftsX	9
Gok2_libmerged	4279287	4279308		ftsE	21
Gok2_libmerged	4279955	4279958		ftsY	3
Gok2_libmerged	4281041	4281064		ftsY	23
Gok2_libmerged	4281219	4281232		ftsY	13
Gok2_libmerged	4281327	4281396		ftsY	69
Gok2_libmerged	4281783	4281809		rsmD	26
Gok2_libmerged	4281983	4282023		rsmD	40
Gok2_libmerged	4282625	4282628		YPO_RS20160	3
Gok2_libmerged	4282938	4282958		YPO_RS20165	20
Gok2_libmerged	4283063	4283157		YPO_RS20165	94
Gok2_libmerged	4283301	4283313		YPO_RS20165	12
Gok2_libmerged	4283529	4283548		YPO_RS20170	19
Gok2_libmerged	4283795	4283798		YPO_RS20170	3
Gok2_libmerged	4284164	4284171		YPO_RS20175	7
Gok2_libmerged	4284230	4284232		YPO_RS20175	2
Gok2_libmerged	4284507	4284543		YPO_RS20175	36
Gok2_libmerged	4284713	4284760		YPO_RS20175	47
Gok2_libmerged	4285215	4285246		YPO_RS20180	31
Gok2_libmerged	4285784	4285788		YPO_RS20180	4
Gok2_libmerged	4286086	4286091		YPO_RS20180	5
Gok2_libmerged	4286710	4286726		YPO_RS20180	16
Gok2_libmerged	4286847	4286873		YPO_RS20180	26
Gok2_libmerged	4287646	4287669		tusA	23
Gok2_libmerged	4288478	4288485		YPO_RS20190	7
Gok2_libmerged	4288573	4288656		YPO_RS20190	83
Gok2_libmerged	4289095	4289119		dcrB	24
Gok2_libmerged	4289978	4289998		glpC	20
Gok2_libmerged	4290189	4290199		glpC	10
Gok2_libmerged	4290257	4290275		glpC	18
Gok2_libmerged	4290643	4290644		glpC	1
Gok2_libmerged	4292160	4292162		glpB	2
Gok2_libmerged	4292624	4292625		glpA	1
Gok2_libmerged	4292786	4292806		glpA	20
Gok2_libmerged	4292992	4293082		glpA	90
Gok2_libmerged	4293222	4293265		glpA	43
Gok2_libmerged	4293595	4293603		glpA	8
Gok2_libmerged	4293676	4293688		glpA	12
Gok2_libmerged	4293858	4293861		glpA	3
Gok2_libmerged	4294729	4294768		glpQ	39
Gok2_libmerged	4294944	4294963		glpQ	19
Gok2_libmerged	4295138	4295157		glpQ	19
Gok2_libmerged	4295221	4295250		glpQ	29
Gok2_libmerged	4295334	4295381		glpQ	47
Gok2_libmerged	4297153	4297157		yigL	4
Gok2_libmerged	4297294	4297297		yigL	3
Gok2_libmerged	4297409	4297412		yigL	3
Gok2_libmerged	4297701	4297707		yigL	6
Gok2_libmerged	4298634	4298679		pldB	45
Gok2_libmerged	4298880	4298963		pldB	83
Gok2_libmerged	4299553	4299571		rhtB	18
Gok2_libmerged	4299634	4299664		rhtB	30
Gok2_libmerged	4299867	4299932		rhtC	65
Gok2_libmerged	4300059	4300119		rhtC	60
Gok2_libmerged	4300256	4300257		rhtC	1
Gok2_libmerged	4300292	4300315		rhtC	23
Gok2_libmerged	4300486	4300487		rhtC	1
Gok2_libmerged	4301053	4301067		recQ	14
Gok2_libmerged	4301769	4301797		recQ	28
Gok2_libmerged	4302157	4302165		recQ	8
Gok2_libmerged	4302513	4302563		pldA	50
Gok2_libmerged	4303057	4303071		pldA	14
Gok2_libmerged	4303162	4303227		pldA	65
Gok2_libmerged	4304195	4304221		rarD	26
Gok2_libmerged	4304324	4304341		rarD	17
Gok2_libmerged	4304386	4304390		rarD	4
Gok2_libmerged	4304459	4304493		rarD	34
Gok2_libmerged	4304691	4304713		rarD	22
Gok2_libmerged	4305200	4305209		corA	9
Gok2_libmerged	4305600	4305603		corA	3
Gok2_libmerged	4305789	4305790		corA	1
Gok2_libmerged	4305840	4305885		corA	45
Gok2_libmerged	4307254	4307294		YPO_RS20275	40
Gok2_libmerged	4307344	4307363		YPO_RS20275	19
Gok2_libmerged	4307455	4307458		YPO_RS20275	3
Gok2_libmerged	4307609	4307613		YPO_RS20280	4
Gok2_libmerged	4307778	4307785		YPO_RS20280	7
Gok2_libmerged	4308241	4308261		YPO_RS20280	20
Gok2_libmerged	4308475	4308487		YPO_RS20280	12
Gok2_libmerged	4308783	4308812		YPO_RS20280	29
Gok2_libmerged	4309297	4309337		YPO_RS20285	40
Gok2_libmerged	4309444	4309493		YPO_RS20285	49
Gok2_libmerged	4310134	4310185		uvrD	51
Gok2_libmerged	4310402	4310439		uvrD	37
Gok2_libmerged	4310641	4310652		uvrD	11
Gok2_libmerged	4311086	4311092		uvrD	6
Gok2_libmerged	4311543	4311556		uvrD	13
Gok2_libmerged	4311771	4311782		uvrD	11
Gok2_libmerged	4312451	4312492		yigB	41
Gok2_libmerged	4312678	4312679		yigB	1
Gok2_libmerged	4312832	4312837		yigB	5
Gok2_libmerged	4312976	4312985		yigB	9
Gok2_libmerged	4314706	4314741		dapF	35
Gok2_libmerged	4314999	4315018		dapF	19
Gok2_libmerged	4315200	4315217		dapF	17
Gok2_libmerged	4315740	4315747		YPO_RS20315	7
Gok2_libmerged	4316845	4316894		YPO_RS20325	49
Gok2_libmerged	4316959	4316963		YPO_RS20325	4
Gok2_libmerged	4317033	4317047		YPO_RS20325	14
Gok2_libmerged	4317582	4317607		YPO_RS20325	25
Gok2_libmerged	4317831	4317848		YPO_RS20325	17
Gok2_libmerged	4318369	4318383		YPO_RS20325	14
Gok2_libmerged	4318785	4318798		YPO_RS20325	13
Gok2_libmerged	4318848	4318885		YPO_RS20325	37
Gok2_libmerged	4319253	4319274		YPO_RS20330	21
Gok2_libmerged	4319730	4319733		hemC	3
Gok2_libmerged	4319930	4319952		hemC	22
Gok2_libmerged	4320040	4320049		hemC	9
Gok2_libmerged	4320774	4320836		hemD	62
Gok2_libmerged	4321013	4321021		hemD	8
Gok2_libmerged	4321061	4321070		hemD	9
Gok2_libmerged	4321320	4321321		hemD	1
Gok2_libmerged	4321396	4321420		hemX	24
Gok2_libmerged	4321608	4321609		hemX	1
Gok2_libmerged	4321985	4321996		hemX	11
Gok2_libmerged	4322034	4322038		hemX	4
Gok2_libmerged	4322367	4322368		hemX	1
Gok2_libmerged	4322613	4322660		hemY	47
Gok2_libmerged	4322956	4322958		hemY	2
Gok2_libmerged	4323628	4323635		hemY	7
Gok2_libmerged	4324045	4324079		YPO_RS20355	34
Gok2_libmerged	4324152	4324282		YPO_RS20355	130
Gok2_libmerged	4326111	4326137		YPO_RS20380	26
Gok2_libmerged	4326518	4326610		YPO_RS20380	92
Gok2_libmerged	4326723	4326772		YPO_RS20380	49
Gok2_libmerged	4327101	4327173		YPO_RS20380	72
Gok2_libmerged	4327882	4327954		rffM	72
Gok2_libmerged	4327991	4328045		rffM	54
Gok2_libmerged	4328086	4328104		rffM	18
Gok2_libmerged	4328316	4328322		rffM	6
Gok2_libmerged	4328382	4328419		rffM	37
Gok2_libmerged	4328804	4328884		wzyE	80
Gok2_libmerged	4329179	4329186		wzyE	7
Gok2_libmerged	4329914	4329957		YPO_RS20395	43
Gok2_libmerged	4330300	4330317		YPO_RS20395	17
Gok2_libmerged	4330556	4330593		YPO_RS20395	37
Gok2_libmerged	4331019	4331030		wzxE	11
Gok2_libmerged	4331463	4331499		wzxE	36
Gok2_libmerged	4332071	4332124		wzxE	53
Gok2_libmerged	4332467	4332521		rffA	54
Gok2_libmerged	4332702	4332757		rffA	55
Gok2_libmerged	4332980	4333133		rffA	153
Gok2_libmerged	4333270	4333332		rffA	62
Gok2_libmerged	4333511	4333600		rffC	89
Gok2_libmerged	4333849	4333923		rffC	74
Gok2_libmerged	4334248	4334283		rfbA	35
Gok2_libmerged	4334838	4334865		rfbA	27
Gok2_libmerged	4335640	4335703		rffG	63
Gok2_libmerged	4336440	4336500		wecC	60
Gok2_libmerged	4337594	4337602		wecC	8
Gok2_libmerged	4337633	4337636		wecB	3
Gok2_libmerged	4337940	4337941		wecB	1
Gok2_libmerged	4338588	4338615		wecB	27
Gok2_libmerged	4338708	4338722		wecB	14
Gok2_libmerged	4339034	4339039		wzzE	5
Gok2_libmerged	4339234	4339272		wzzE	38
Gok2_libmerged	4339458	4339461		wzzE	3
Gok2_libmerged	4339628	4339640		wzzE	12
Gok2_libmerged	4339881	4339900		wzzE	19
Gok2_libmerged	4340443	4340486		wecA	43
Gok2_libmerged	4340630	4340634		wecA	4
Gok2_libmerged	4340681	4340710		wecA	29
Gok2_libmerged	4340959	4341034		wecA	75
Gok2_libmerged	4341097	4341102		wecA	5
Gok2_libmerged	4341773	4341774		rho	1
Gok2_libmerged	4341972	4341981		rho	9
Gok2_libmerged	4342178	4342236		rho	58
Gok2_libmerged	4342559	4342565		rho	6
Gok2_libmerged	4342642	4342686		rho	44
Gok2_libmerged	4342992	4343022		rho	30
Gok2_libmerged	4343808	4343828		trxA	20
Gok2_libmerged	4344079	4344089		rhlB	10
Gok2_libmerged	4344326	4344335		rhlB	9
Gok2_libmerged	4344683	4344754		rhlB	71
Gok2_libmerged	4346958	4346972		rep	14
Gok2_libmerged	4347523	4347574		rep	51
Gok2_libmerged	4347770	4347847		rep	77
Gok2_libmerged	4348030	4348072		rep	42
Gok2_libmerged	4348262	4348270		rep	8
Gok2_libmerged	4348400	4348419		rep	19
Gok2_libmerged	4349090	4349104		YPO_RS20470	14
Gok2_libmerged	4349124	4349165		YPO_RS20475	41
Gok2_libmerged	4349369	4349379		YPO_RS20475	10
Gok2_libmerged	4349644	4349715		YPO_RS20480	71
Gok2_libmerged	4349951	4349995		YPO_RS20480	44
Gok2_libmerged	4350130	4350244		YPO_RS20480	114
Gok2_libmerged	4350378	4350435		YPO_RS20480	57
Gok2_libmerged	4351012	4351039		YPO_RS20485	27
Gok2_libmerged	4351328	4351351		YPO_RS20485	23
Gok2_libmerged	4351473	4351486		YPO_RS20485	13
Gok2_libmerged	4351733	4351740		YPO_RS20485	7
Gok2_libmerged	4352550	4352561		YPO_RS20490	11
Gok2_libmerged	4353072	4353080		YPO_RS20490	8
Gok2_libmerged	4353145	4353214		YPO_RS20495	69
Gok2_libmerged	4353718	4353781		YPO_RS20495	63
Gok2_libmerged	4353834	4353861		YPO_RS20495	27
Gok2_libmerged	4354029	4354068		YPO_RS20500	39
Gok2_libmerged	4354130	4354136		YPO_RS20500	6
Gok2_libmerged	4354880	4354915		YPO_RS20500	35
Gok2_libmerged	4355205	4355213		YPO_RS20500	8
Gok2_libmerged	4355428	4355431		YPO_RS20500	3
Gok2_libmerged	4356389	4356411		YPO_RS20500	22
Gok2_libmerged	4357010	4357029		stbD	19
Gok2_libmerged	4357147	4357234		stbD	87
Gok2_libmerged	4357338	4357363		stbD	25
Gok2_libmerged	4357675	4357810		stbD	135
Gok2_libmerged	4358335	4358346		YPO_RS20510	11
Gok2_libmerged	4358130	4358160		YPO_RS20510	30
Gok2_libmerged	4359664	4359843		YPO_RS20520	179
Gok2_libmerged	4360096	4360110		YPO_RS20525	14
Gok2_libmerged	4360254	4360354		YPO_RS20525	100
Gok2_libmerged	4360453	4360526		YPO_RS20530	73
Gok2_libmerged	4360652	4360688		YPO_RS20530	36
Gok2_libmerged	4360776	4360808		YPO_RS20530	32
Gok2_libmerged	4360891	4360910		YPO_RS20530	19
Gok2_libmerged	4361165	4361176		YPO_RS20530	11
Gok2_libmerged	4362060	4362078		YPO_RS20535	18
Gok2_libmerged	4362571	4362602		ilvC	31
Gok2_libmerged	4363079	4363089		ilvC	10
Gok2_libmerged	4363137	4363177		ilvC	40
Gok2_libmerged	4363781	4363794		ilvC	13
Gok2_libmerged	4364447	4364451		ilvY	4
Gok2_libmerged	4364993	4365023		ilvY	30
Gok2_libmerged	4365078	4365128		YPO_RS20550	50
Gok2_libmerged	4365195	4365287		YPO_RS20550	92
Gok2_libmerged	4365956	4365958		YPO_RS20555	2
Gok2_libmerged	4366306	4366359		YPO_RS20560	53
Gok2_libmerged	4366530	4366597		YPO_RS20560	67
Gok2_libmerged	4366693	4366700		YPO_RS20560	7
Gok2_libmerged	4366998	4367009		YPO_RS20565	11
Gok2_libmerged	4367109	4367271		YPO_RS20565	162
Gok2_libmerged	4367558	4367596		YPO_RS20570	38
Gok2_libmerged	4367634	4367643		YPO_RS20570	9
Gok2_libmerged	4367704	4367840		YPO_RS20570	136
Gok2_libmerged	4368137	4368157		YPO_RS20575	20
Gok2_libmerged	4368247	4368317		YPO_RS20575	70
Gok2_libmerged	4368802	4368816		ilvA	14
Gok2_libmerged	4368877	4368941		ilvA	64
Gok2_libmerged	4370464	4370497		ilvD	33
Gok2_libmerged	4370953	4371032		ilvD	79
Gok2_libmerged	4371763	4371793		ilvD	30
Gok2_libmerged	4372801	4372815		YPO_RS20590	14
Gok2_libmerged	4373021	4373027		YPO_RS20590	6
Gok2_libmerged	4373235	4373243		ilvM	8
Gok2_libmerged	4373317	4373326		ilvM	9
Gok2_libmerged	4373481	4373484		YPO_RS20600	3
Gok2_libmerged	4373694	4373695		YPO_RS20600	1
Gok2_libmerged	4373822	4373874		YPO_RS20600	52
Gok2_libmerged	4374699	4374764		YPO_RS20600	65
Gok2_libmerged	4374799	4374802		YPO_RS20600	3
Gok2_libmerged	4374882	4374905		YPO_RS20600	23
Gok2_libmerged	4375280	4375314		ilvL	34
Gok2_libmerged	4375830	4375855		YPO_RS20610	25
Gok2_libmerged	4376500	4376604		YPO_RS20610	104
Gok2_libmerged	4377661	4377680		YPO_RS20615	19
Gok2_libmerged	4378080	4378089		hdfR	9
Gok2_libmerged	4378816	4378833		yjfF	17
Gok2_libmerged	4379156	4379189		yjfF	33
Gok2_libmerged	4379554	4379559		yjfF	5
Gok2_libmerged	4379641	4379693		yjfF	52
Gok2_libmerged	4379759	4379786		yjfF	27
Gok2_libmerged	4379861	4379865		YPO_RS20630	4
Gok2_libmerged	4379941	4379992		YPO_RS20630	51
Gok2_libmerged	4380214	4380288		YPO_RS20630	74
Gok2_libmerged	4380502	4380503		YPO_RS20630	1
Gok2_libmerged	4380669	4380718		YPO_RS20630	49
Gok2_libmerged	4380981	4381003		YPO_RS20635	22
Gok2_libmerged	4381123	4381133		YPO_RS20635	10
Gok2_libmerged	4381265	4381295		YPO_RS20635	30
Gok2_libmerged	4381396	4381431		YPO_RS20635	35
Gok2_libmerged	4381982	4382065		YPO_RS20635	83
Gok2_libmerged	4382162	4382170		YPO_RS20635	8
Gok2_libmerged	4382465	4382486		YPO_RS20640	21
Gok2_libmerged	4382797	4382826		YPO_RS20640	29
Gok2_libmerged	4382919	4383017		YPO_RS20640	98
Gok2_libmerged	4383100	4383129		YPO_RS20640	29
Gok2_libmerged	4389015	4389026		YPO_RS20670	11
Gok2_libmerged	4389611	4389625		YPO_RS20670	14
Gok2_libmerged	4390468	4390486		murI	18
Gok2_libmerged	4390634	4390640		murI	6
Gok2_libmerged	4391031	4391074		murI	43
Gok2_libmerged	4391031	4391074		btuB	43
Gok2_libmerged	4392007	4392151		btuB	144
Gok2_libmerged	4392293	4392349		btuB	56
Gok2_libmerged	4392854	4392894		btuB	40
Gok2_libmerged	4393551	4393558		trmA	7
Gok2_libmerged	4394052	4394061		trmA	9
Gok2_libmerged	4394111	4394112		trmA	1
Gok2_libmerged	4394236	4394336		trmA	100
Gok2_libmerged	4394397	4394440		trmA	43
Gok2_libmerged	4394618	4394630		YPO_RS20695	12
Gok2_libmerged	4394665	4394679		YPO_RS20695	14
Gok2_libmerged	4395513	4395544		fabR	31
Gok2_libmerged	4396233	4396318		sthA	85
Gok2_libmerged	4396438	4396467		sthA	29
Gok2_libmerged	4396574	4396642		sthA	68
Gok2_libmerged	4397066	4397135		sthA	69
Gok2_libmerged	4397287	4397291		sthA	4
Gok2_libmerged	4397287	4397325		oxyR	38
Gok2_libmerged	4397398	4397401		oxyR	3
Gok2_libmerged	4397760	4397763		oxyR	3
Gok2_libmerged	4397973	4397978		oxyR	5
Gok2_libmerged	4398026	4398033		oxyR	7
Gok2_libmerged	4398367	4398370		YPO_RS20715	3
Gok2_libmerged	4399266	4399280		YPO_RS20720	14
Gok2_libmerged	4399508	4399563		YPO_RS20720	55
Gok2_libmerged	4400355	4400398		YPO_RS20720	43
Gok2_libmerged	4400499	4400570		YPO_RS20720	71
Gok2_libmerged	4400743	4400757		YPO_RS20725	14
Gok2_libmerged	4400880	4400903		YPO_RS20725	23
Gok2_libmerged	4401269	4401271		YPO_RS20725	2
Gok2_libmerged	4401386	4401484		YPO_RS20725	98
Gok2_libmerged	4401783	4401793		YPO_RS20730	10
Gok2_libmerged	4401948	4401957		YPO_RS20730	9
Gok2_libmerged	4402255	4402313		YPO_RS20730	58
Gok2_libmerged	4402668	4402670		YPO_RS20730	2
Gok2_libmerged	4403107	4403178		YPO_RS20735	71
Gok2_libmerged	4403244	4403275		YPO_RS20735	31
Gok2_libmerged	4403394	4403399		YPO_RS20735	5
Gok2_libmerged	4403430	4403444		YPO_RS20735	14
Gok2_libmerged	4403710	4403719		YPO_RS20735	9
Gok2_libmerged	4403946	4403953		YPO_RS20735	7
Gok2_libmerged	4404240	4404307		YPO_RS20735	67
Gok2_libmerged	4404366	4404367		YPO_RS20735	1
Gok2_libmerged	4404536	4404548		YPO_RS20735	12
Gok2_libmerged	4404700	4404705		YPO_RS20735	5
Gok2_libmerged	4405091	4405118		YPO_RS20740	27
Gok2_libmerged	4405288	4405292		YPO_RS20740	4
Gok2_libmerged	4405348	4405371		YPO_RS20740	23
Gok2_libmerged	4405506	4405606		YPO_RS20740	100
Gok2_libmerged	4405937	4405969		YPO_RS20745	32
Gok2_libmerged	4406046	4406126		YPO_RS20745	80
Gok2_libmerged	4406209	4406256		YPO_RS20745	47
Gok2_libmerged	4406297	4406474		YPO_RS20745	177
Gok2_libmerged	4406849	4406876		YPO_RS20745	27
Gok2_libmerged	4407248	4407259		YPO_RS20745	11
Gok2_libmerged	4407298	4407301		YPO_RS20745	3
Gok2_libmerged	4408061	4408320		YPO_RS20745	259
Gok2_libmerged	4409009	4409022		argH	13
Gok2_libmerged	4409752	4409800		argH	48
Gok2_libmerged	4409887	4409896		argH	9
Gok2_libmerged	4410717	4410792		argB	75
Gok2_libmerged	4411217	4411220		argB	3
Gok2_libmerged	4411474	4411477		argC	3
Gok2_libmerged	4411593	4411613		argC	20
Gok2_libmerged	4411782	4411785		argC	3
Gok2_libmerged	4412726	4412784		argE	58
Gok2_libmerged	4413239	4413253		argE	14
Gok2_libmerged	4413293	4413306		argE	13
Gok2_libmerged	4413558	4413617		argE	59
Gok2_libmerged	4413746	4413769		argE	23
Gok2_libmerged	4414193	4414296		ppc	103
Gok2_libmerged	4414442	4414450		ppc	8
Gok2_libmerged	4414703	4414745		ppc	42
Gok2_libmerged	4414883	4414936		ppc	53
Gok2_libmerged	4415038	4415084		ppc	46
Gok2_libmerged	4415141	4415149		ppc	8
Gok2_libmerged	4415317	4415320		ppc	3
Gok2_libmerged	4415686	4415700		ppc	14
Gok2_libmerged	4416751	4416752		ppc	1
Gok2_libmerged	4416795	4416829		ppc	34
Gok2_libmerged	4418152	4418177		YPO_RS20775	25
Gok2_libmerged	4418711	4418761		YPO_RS20775	50
Gok2_libmerged	4418910	4418925		YPO_RS20775	15
Gok2_libmerged	4419311	4419331		YPO_RS20780	20
Gok2_libmerged	4419496	4419549		YPO_RS20780	53
Gok2_libmerged	4419727	4419891		YPO_RS20785	164
Gok2_libmerged	4419959	4420039		YPO_RS20785	80
Gok2_libmerged	4420291	4420327		YPO_RS20790	36
Gok2_libmerged	4421261	4421326		glpD	65
Gok2_libmerged	4421403	4421407		glpD	4
Gok2_libmerged	4421453	4421481		glpD	28
Gok2_libmerged	4421917	4421941		glpD	24
Gok2_libmerged	4422033	4422058		glpD	25
Gok2_libmerged	4422280	4422305		glpD	25
Gok2_libmerged	4422340	4422406		glpD	66
Gok2_libmerged	4422590	4422592		glpD	2
Gok2_libmerged	4423409	4423507		glgP	98
Gok2_libmerged	4423867	4423929		glgP	62
Gok2_libmerged	4424342	4424361		glgP	19
Gok2_libmerged	4424610	4424625		glgP	15
Gok2_libmerged	4424816	4424828		glgP	12
Gok2_libmerged	4424873	4424900		glgP	27
Gok2_libmerged	4424952	4424988		glgP	36
Gok2_libmerged	4425065	4425071		glgP	6
Gok2_libmerged	4425131	4425182		glgP	51
Gok2_libmerged	4425214	4425216		glgP	2
Gok2_libmerged	4426542	4426588		glgA	46
Gok2_libmerged	4426707	4426708		glgA	1
Gok2_libmerged	4426876	4426890		glgA	14
Gok2_libmerged	4428975	4429020		glgX	45
Gok2_libmerged	4429267	4429270		glgX	3
Gok2_libmerged	4429797	4429804		glgX	7
Gok2_libmerged	4429845	4429850		glgX	5
Gok2_libmerged	4429916	4429945		glgX	29
Gok2_libmerged	4430514	4430522		glgB	8
Gok2_libmerged	4430585	4430599		glgB	14
Gok2_libmerged	4430774	4430785		glgB	11
Gok2_libmerged	4431084	4431092		glgB	8
Gok2_libmerged	4432231	4432256		glgB	25
Gok2_libmerged	4432493	4432535		glgB	42
Gok2_libmerged	4433112	4433299		YPO_RS20825	187
Gok2_libmerged	4433896	4433902		YPO_RS20825	6
Gok2_libmerged	4434218	4434224		YPO_RS20825	6
Gok2_libmerged	4435215	4435244		YPO_RS20830	29
Gok2_libmerged	4435294	4435297		YPO_RS20830	3
Gok2_libmerged	4435386	4435402		YPO_RS20830	16
Gok2_libmerged	4435955	4435967		YPO_RS20830	12
Gok2_libmerged	4436137	4436150		YPO_RS20830	13
Gok2_libmerged	4436274	4436285		YPO_RS20830	11
Gok2_libmerged	4436340	4436362		YPO_RS20830	22
Gok2_libmerged	4436399	4436479		YPO_RS20830	80
Gok2_libmerged	4436599	4436709		YPO_RS20830	110
Gok2_libmerged	4436999	4437020		YPO_RS20830	21
Gok2_libmerged	4437136	4437140		YPO_RS20830	4
Gok2_libmerged	4437194	4437214		YPO_RS20830	20
Gok2_libmerged	4437257	4437262		YPO_RS20830	5
Gok2_libmerged	4437350	4437449		YPO_RS20830	99
Gok2_libmerged	4437571	4437593		YPO_RS20830	22
Gok2_libmerged	4437657	4437679		YPO_RS20830	22
Gok2_libmerged	4437764	4437824		YPO_RS20830	60
Gok2_libmerged	4437896	4437916		YPO_RS20830	20
Gok2_libmerged	4438203	4438205		YPO_RS20830	2
Gok2_libmerged	4438377	4438422		YPO_RS20830	45
Gok2_libmerged	4438557	4438563		YPO_RS20830	6
Gok2_libmerged	4438729	4438838		YPO_RS20830	109
Gok2_libmerged	4439100	4439101		YPO_RS20830	1
Gok2_libmerged	4439395	4439405		YPO_RS20830	10
Gok2_libmerged	4439783	4439806		YPO_RS20830	23
Gok2_libmerged	4440083	4440098		YPO_RS20830	15
Gok2_libmerged	4440188	4440192		YPO_RS20830	4
Gok2_libmerged	4441272	4441282		YPO_RS20830	10
Gok2_libmerged	4441617	4441621		YPO_RS20830	4
Gok2_libmerged	4442073	4442129		YPO_RS20830	56
Gok2_libmerged	4442318	4442326		YPO_RS20830	8
Gok2_libmerged	4442804	4442834		YPO_RS20830	30
Gok2_libmerged	4442923	4443018		YPO_RS20830	95
Gok2_libmerged	4443212	4443227		YPO_RS20830	15
Gok2_libmerged	4443492	4443494		YPO_RS20830	2
Gok2_libmerged	4443547	4443591		YPO_RS20830	44
Gok2_libmerged	4443985	4444023		YPO_RS20830	38
Gok2_libmerged	4445759	4445767		YPO_RS20840	8
Gok2_libmerged	4445947	4445995		YPO_RS20840	48
Gok2_libmerged	4446298	4446351		YPO_RS20845	53
Gok2_libmerged	4446518	4446521		YPO_RS20850	3
Gok2_libmerged	4446783	4446872		YPO_RS20855	89
Gok2_libmerged	4447147	4447151		asd	4
Gok2_libmerged	4448579	4448637		YPO_RS20865	58
Gok2_libmerged	4448688	4448750		YPO_RS20865	62
Gok2_libmerged	4448954	4448964		YPO_RS20865	10
Gok2_libmerged	4449412	4449433		YPO_RS20870	21
Gok2_libmerged	4449508	4449592		YPO_RS20870	84
Gok2_libmerged	4449791	4449801		YPO_RS20870	10
Gok2_libmerged	4451063	4451069		YPO_RS20880	6
Gok2_libmerged	4451376	4451389		gntT	13
Gok2_libmerged	4451526	4451547		gntT	21
Gok2_libmerged	4451595	4451734		gntT	139
Gok2_libmerged	4451925	4451929		gntT	4
Gok2_libmerged	4452291	4452326		gntT	35
Gok2_libmerged	4452481	4452574		gntT	93
Gok2_libmerged	4453176	4453196		gntR	20
Gok2_libmerged	4453953	4453956		YPO_RS20895	3
Gok2_libmerged	4454401	4454451		YPO_RS20895	50
Gok2_libmerged	4454503	4454549		YPO_RS20895	46
Gok2_libmerged	4454752	4454759		YPO_RS20900	7
Gok2_libmerged	4456020	4456050		YPO_RS20905	30
Gok2_libmerged	4456290	4456321		YPO_RS20910	31
Gok2_libmerged	4456516	4456517		YPO_RS20910	1
Gok2_libmerged	4456683	4456729		YPO_RS20910	46
Gok2_libmerged	4456841	4456868		YPO_RS20910	27
Gok2_libmerged	4456992	4457024		YPO_RS20910	32
Gok2_libmerged	4458027	4458048		YPO_RS20915	21
Gok2_libmerged	4458207	4458241		YPO_RS20920	34
Gok2_libmerged	4458294	4458312		YPO_RS20920	18
Gok2_libmerged	4458543	4458600		YPO_RS20920	57
Gok2_libmerged	4458940	4458941		YPO_RS20925	1
Gok2_libmerged	4459035	4459161		YPO_RS20925	126
Gok2_libmerged	4459266	4459305		YPO_RS20925	39
Gok2_libmerged	4459354	4459356		YPO_RS20925	2
Gok2_libmerged	4459818	4459840		YPO_RS20925	22
Gok2_libmerged	4459946	4460009		YPO_RS20930	63
Gok2_libmerged	4460097	4460099		YPO_RS20930	2
Gok2_libmerged	4460285	4460307		YPO_RS20930	22
Gok2_libmerged	4460379	4460464		YPO_RS20930	85
Gok2_libmerged	4460578	4460583		YPO_RS20930	5
Gok2_libmerged	4460746	4460760		YPO_RS20930	14
Gok2_libmerged	4460958	4460978		YPO_RS20935	20
Gok2_libmerged	4461581	4461586		YPO_RS20935	5
Gok2_libmerged	4462203	4462239		YPO_RS20935	36
Gok2_libmerged	4462763	4462776		YPO_RS20940	13
Gok2_libmerged	4463049	4463057		YPO_RS20940	8
Gok2_libmerged	4463119	4463155		YPO_RS20940	36
Gok2_libmerged	4463343	4463363		YPO_RS20940	20
Gok2_libmerged	4463721	4463787		YPO_RS20940	66
Gok2_libmerged	4463854	4463866		YPO_RS20940	12
Gok2_libmerged	4464614	4464622		YPO_RS20940	8
Gok2_libmerged	4465476	4465482		YPO_RS20945	6
Gok2_libmerged	4465876	4465927		YPO_RS20945	51
Gok2_libmerged	4466301	4466337		YPO_RS20945	36
Gok2_libmerged	4466430	4466455		YPO_RS20945	25
Gok2_libmerged	4466832	4466888		pitA	56
Gok2_libmerged	4467142	4467168		pitA	26
Gok2_libmerged	4467331	4467332		pitA	1
Gok2_libmerged	4467373	4467379		pitA	6
Gok2_libmerged	4467511	4467519		pitA	8
Gok2_libmerged	4468040	4468096		pitA	56
Gok2_libmerged	4468560	4468577		YPO_RS20955	17
Gok2_libmerged	4468665	4468691		YPO_RS20955	26
Gok2_libmerged	4468745	4468746		YPO_RS20955	1
Gok2_libmerged	4468821	4468898		YPO_RS20955	77
Gok2_libmerged	4469119	4469168		uspB	49
Gok2_libmerged	4470247	4470276		uspA	29
Gok2_libmerged	4470378	4470398		uspA	20
Gok2_libmerged	4470469	4470496		uspA	27
Gok2_libmerged	4470546	4470590		uspA	44
Gok2_libmerged	4470965	4470996		gdhA	31
Gok2_libmerged	4471224	4471238		gdhA	14
Gok2_libmerged	4471277	4471288		gdhA	11
Gok2_libmerged	4471397	4471412		gdhA	15
Gok2_libmerged	4471798	4471816		gdhA	18
Gok2_libmerged	4472061	4472198		gdhA	137
Gok2_libmerged	4472516	4472683		YPO_RS20975	167
Gok2_libmerged	4472743	4472749		YPO_RS20975	6
Gok2_libmerged	4472799	4472825		YPO_RS20975	26
Gok2_libmerged	4473285	4473366		YPO_RS20975	81
Gok2_libmerged	4473441	4473452		YPO_RS20975	11
Gok2_libmerged	4473584	4473602		YPO_RS20975	18
Gok2_libmerged	4475086	4475089		prlC	3
Gok2_libmerged	4475224	4475246		prlC	22
Gok2_libmerged	4475599	4475632		prlC	33
Gok2_libmerged	4475928	4475950		prlC	22
Gok2_libmerged	4476044	4476046		prlC	2
Gok2_libmerged	4476392	4476404		prlC	12
Gok2_libmerged	4476438	4476456		prlC	18
Gok2_libmerged	4476512	4476530		prlC	18
Gok2_libmerged	4477518	4477532		YPO_RS20990	14
Gok2_libmerged	4478118	4478127		gorA	9
Gok2_libmerged	4478245	4478403		gorA	158
Gok2_libmerged	4478654	4478679		gorA	25
Gok2_libmerged	4479645	4479703		YPO_RS21000	58
Gok2_libmerged	4479802	4479823		YPO_RS21000	21
Gok2_libmerged	4480533	4480689		YPO_RS21000	156
Gok2_libmerged	4480652	4480693		YPO_RS21005	41
Gok2_libmerged	4480894	4481007		YPO_RS21010	113
Gok2_libmerged	4481614	4481669		YPO_RS21010	55
Gok2_libmerged	4481713	4481745		YPO_RS21010	32
Gok2_libmerged	4482015	4482062		YPO_RS21010	47
Gok2_libmerged	4482113	4482129		YPO_RS21010	16
Gok2_libmerged	4482568	4482578		YPO_RS21015	10
Gok2_libmerged	4482670	4482683		YPO_RS21015	13
Gok2_libmerged	4483094	4483099		YPO_RS21015	5
Gok2_libmerged	4483528	4483550		YPO_RS21020	22
Gok2_libmerged	4483607	4483637		YPO_RS21020	30
Gok2_libmerged	4483732	4483897		YPO_RS21020	165
Gok2_libmerged	4484102	4484106		YPO_RS21025	4
Gok2_libmerged	4484162	4484180		YPO_RS21025	18
Gok2_libmerged	4484449	4484477		YPO_RS21025	28
Gok2_libmerged	4484555	4484599		YPO_RS21025	44
Gok2_libmerged	4484601	4484609		YPO_RS21030	8
Gok2_libmerged	4484739	4484831		YPO_RS21030	92
Gok2_libmerged	4484873	4485124		YPO_RS21030	251
Gok2_libmerged	4485212	4485224		YPO_RS21030	12
Gok2_libmerged	4485298	4485311		YPO_RS21030	13
Gok2_libmerged	4485602	4485613		yapE	11
Gok2_libmerged	4485907	4485993		yapE	86
Gok2_libmerged	4486101	4486125		yapE	24
Gok2_libmerged	4486230	4486241		yapE	11
Gok2_libmerged	4486477	4486504		yapE	27
Gok2_libmerged	4486549	4486587		yapE	38
Gok2_libmerged	4486674	4486696		yapE	22
Gok2_libmerged	4486751	4486791		yapE	40
Gok2_libmerged	4486912	4486952		yapE	40
Gok2_libmerged	4488346	4488352		yapE	6
Gok2_libmerged	4488400	4488434		yapE	34
Gok2_libmerged	4489773	4489893		yhjD	120
Gok2_libmerged	4489925	4489930		yhjD	5
Gok2_libmerged	4490030	4490056		yhjD	26
Gok2_libmerged	4490307	4490316		yhjD	9
Gok2_libmerged	4490448	4490462		yhjD	14
Gok2_libmerged	4490534	4490536		YPO_RS21045	2
Gok2_libmerged	4490570	4490606		YPO_RS21045	36
Gok2_libmerged	4490940	4491020		YPO_RS21045	80
Gok2_libmerged	4491102	4491106		YPO_RS21045	4
Gok2_libmerged	4491388	4491399		YPO_RS21050	11
Gok2_libmerged	4491471	4491474		YPO_RS21050	3
Gok2_libmerged	4491621	4491647		YPO_RS21050	26
Gok2_libmerged	4492496	4492503		YPO_RS21050	7
Gok2_libmerged	4492800	4492822		YPO_RS21050	22
Gok2_libmerged	4492965	4493013		YPO_RS21050	48
Gok2_libmerged	4493972	4494014		pdeH	42
Gok2_libmerged	4494260	4494302		pdeH	42
Gok2_libmerged	4494356	4494362		pdeH	6
Gok2_libmerged	4494441	4494472		pdeH	31
Gok2_libmerged	4494660	4494678		pdeH	18
Gok2_libmerged	4495544	4495550		YPO_RS21065	6
Gok2_libmerged	4495942	4495982		YPO_RS21065	40
Gok2_libmerged	4496274	4496277		YPO_RS21065	3
Gok2_libmerged	4496318	4496322		YPO_RS21065	4
Gok2_libmerged	4496777	4496804		YPO_RS21070	27
Gok2_libmerged	4497459	4497493		YPO_RS21070	34
Gok2_libmerged	4497607	4497667		YPO_RS21070	60
Gok2_libmerged	4497851	4497857		YPO_RS21070	6
Gok2_libmerged	4498350	4498367		YPO_RS21075	17
Gok2_libmerged	4498607	4498610		YPO_RS21075	3
Gok2_libmerged	4498646	4498688		YPO_RS21075	42
Gok2_libmerged	4498853	4498884		YPO_RS21075	31
Gok2_libmerged	4500721	4500764		YPO_RS21085	43
Gok2_libmerged	4500802	4500821		YPO_RS21085	19
Gok2_libmerged	4501636	4501684		YPO_RS21085	48
Gok2_libmerged	4501785	4501803		YPO_RS21085	18
Gok2_libmerged	4501947	4501951		YPO_RS21085	4
Gok2_libmerged	4502069	4502086		YPO_RS21085	17
Gok2_libmerged	4502361	4502416		YPO_RS21085	55
Gok2_libmerged	4502676	4502683		YPO_RS21090	7
Gok2_libmerged	4502747	4502982		YPO_RS21090	235
Gok2_libmerged	4503331	4503366		YPO_RS21090	35
Gok2_libmerged	4504379	4504383		hmsP	4
Gok2_libmerged	4504545	4504555		hmsP	10
Gok2_libmerged	4504853	4504877		hmsP	24
Gok2_libmerged	4505329	4505357		hmsP	28
Gok2_libmerged	4505777	4505790		hmsP	13
Gok2_libmerged	4506335	4506338		bcsZ	3
Gok2_libmerged	4506429	4506437		bcsZ	8
Gok2_libmerged	4506826	4506827		bcsZ	1
Gok2_libmerged	4507019	4507044		bcsZ	25
Gok2_libmerged	4507209	4507234		bcsZ	25
Gok2_libmerged	4507209	4507250		YPO_RS21105	41
Gok2_libmerged	4507866	4507932		YPO_RS21110	66
Gok2_libmerged	4508061	4508112		YPO_RS21110	51
Gok2_libmerged	4508173	4508190		YPO_RS21110	17
Gok2_libmerged	4508649	4508663		dppD	14
Gok2_libmerged	4508746	4508784		dppD	38
Gok2_libmerged	4508971	4508995		dppD	24
Gok2_libmerged	4509141	4509155		dppD	14
Gok2_libmerged	4509473	4509559		dppD	86
Gok2_libmerged	4509687	4509694		dppC	7
Gok2_libmerged	4509764	4509783		dppC	19
Gok2_libmerged	4509970	4509982		dppC	12
Gok2_libmerged	4510221	4510248		dppC	27
Gok2_libmerged	4510494	4510511		dppC	17
Gok2_libmerged	4510612	4510631		dppB	19
Gok2_libmerged	4510948	4510960		dppB	12
Gok2_libmerged	4511449	4511496		dppB	47
Gok2_libmerged	4511834	4511858		YPO_RS21130	24
Gok2_libmerged	4511978	4512008		YPO_RS21130	30
Gok2_libmerged	4512382	4512388		YPO_RS21130	6
Gok2_libmerged	4512806	4512814		YPO_RS21130	8
Gok2_libmerged	4513046	4513083		YPO_RS21130	37
Gok2_libmerged	4514289	4514293		YPO_RS21135	4
Gok2_libmerged	4514370	4514382		YPO_RS21135	12
Gok2_libmerged	4514457	4514479		YPO_RS21135	22
Gok2_libmerged	4514950	4514955		YPO_RS21135	5
Gok2_libmerged	4515044	4515079		YPO_RS21135	35
Gok2_libmerged	4515273	4515395		YPO_RS21135	122
Gok2_libmerged	4515451	4515507		YPO_RS21135	56
Gok2_libmerged	4515701	4515780		YPO_RS21135	79
Gok2_libmerged	4516012	4516015		YPO_RS21140	3
Gok2_libmerged	4516085	4516143		YPO_RS21140	58
Gok2_libmerged	4516246	4516293		YPO_RS21140	47
Gok2_libmerged	4516398	4516432		YPO_RS21140	34
Gok2_libmerged	4516475	4516535		YPO_RS21140	60
Gok2_libmerged	4516726	4516789		YPO_RS21140	63
Gok2_libmerged	4516875	4516894		YPO_RS21140	19
Gok2_libmerged	4516980	4517010		YPO_RS21140	30
Gok2_libmerged	4517104	4517152		YPO_RS21140	48
Gok2_libmerged	4518161	4518174		YPO_RS21150	13
Gok2_libmerged	4518316	4518326		YPO_RS21150	10
Gok2_libmerged	4518548	4518552		YPO_RS21150	4
Gok2_libmerged	4518720	4518763		YPO_RS21150	43
Gok2_libmerged	4519108	4519156		YPO_RS21150	48
Gok2_libmerged	4519816	4519839		YPO_RS21155	23
Gok2_libmerged	4520318	4520358		YPO_RS21160	40
Gok2_libmerged	4520467	4520486		YPO_RS21160	19
Gok2_libmerged	4520606	4520619		YPO_RS21160	13
Gok2_libmerged	4520708	4520712		YPO_RS21160	4
Gok2_libmerged	4520895	4520907		YPO_RS21165	12
Gok2_libmerged	4521074	4521076		YPO_RS21165	2
Gok2_libmerged	4521322	4521329		YPO_RS21165	7
Gok2_libmerged	4521410	4521442		YPO_RS21165	32
Gok2_libmerged	4521653	4521657		YPO_RS21165	4
Gok2_libmerged	4521883	4521907		YPO_RS21165	24
Gok2_libmerged	4523188	4523200		uhpA	12
Gok2_libmerged	4523332	4523340		uhpA	8
Gok2_libmerged	4523595	4523598		eptB	3
Gok2_libmerged	4523794	4523845		eptB	51
Gok2_libmerged	4524132	4524133		eptB	1
Gok2_libmerged	4524421	4524540		eptB	119
Gok2_libmerged	4524683	4524709		eptB	26
Gok2_libmerged	4525063	4525142		eptB	79
Gok2_libmerged	4526053	4526083		YPO_RS21185	30
Gok2_libmerged	4526551	4526554		YPO_RS21185	3
Gok2_libmerged	4526861	4526882		YPO_RS21185	21
Gok2_libmerged	4526981	4527001		YPO_RS21185	20
Gok2_libmerged	4527090	4527096		YPO_RS21185	6
Gok2_libmerged	4527812	4527824		YPO_RS21190	12
Gok2_libmerged	4527903	4527916		YPO_RS21190	13
Gok2_libmerged	4528020	4528059		YPO_RS21190	39
Gok2_libmerged	4528475	4528485		YPO_RS21190	10
Gok2_libmerged	4529468	4529481		hutH	13
Gok2_libmerged	4530151	4530188		hutH	37
Gok2_libmerged	4530317	4530321		hutH	4
Gok2_libmerged	4530904	4530930		hutH	26
Gok2_libmerged	4531637	4531709		hutU	72
Gok2_libmerged	4533415	4533562		YPO_RS21205	147
Gok2_libmerged	4533674	4533724		YPO_RS21205	50
Gok2_libmerged	4533764	4533908		YPO_RS21205	144
Gok2_libmerged	4534260	4534329		YPO_RS21205	69
Gok2_libmerged	4534372	4534409		YPO_RS21210	37
Gok2_libmerged	4534510	4534549		YPO_RS21210	39
Gok2_libmerged	4534610	4534665		YPO_RS21210	55
Gok2_libmerged	4534709	4534710		YPO_RS21210	1
Gok2_libmerged	4534820	4534922		YPO_RS21210	102
Gok2_libmerged	4535005	4535209		YPO_RS21215	204
Gok2_libmerged	4535373	4535430		YPO_RS21215	57
Gok2_libmerged	4535628	4535656		YPO_RS21215	28
Gok2_libmerged	4535888	4535934		YPO_RS21215	46
Gok2_libmerged	4535936	4536017		YPO_RS21220	81
Gok2_libmerged	4537038	4537042		YPO_RS21220	4
Gok2_libmerged	4537138	4537180		YPO_RS21220	42
Gok2_libmerged	4538571	4538642		YPO_RS21225	71
Gok2_libmerged	4538970	4538995		YPO_RS21230	25
Gok2_libmerged	4539402	4539421		YPO_RS21230	19
Gok2_libmerged	4539667	4539671		YPO_RS21235	4
Gok2_libmerged	4539853	4539872		YPO_RS21235	19
Gok2_libmerged	4540320	4540411		YPO_RS21235	91
Gok2_libmerged	4540458	4540468		YPO_RS21235	10
Gok2_libmerged	4540583	4540622		YPO_RS21235	39
Gok2_libmerged	4540619	4540671		YPO_RS21240	52
Gok2_libmerged	4541054	4541106		YPO_RS21240	52
Gok2_libmerged	4541196	4541206		YPO_RS21240	10
Gok2_libmerged	4541274	4541331		YPO_RS21240	57
Gok2_libmerged	4541557	4541583		YPO_RS21245	26
Gok2_libmerged	4542170	4542215		YPO_RS21250	45
Gok2_libmerged	4542294	4542295		YPO_RS21250	1
Gok2_libmerged	4542294	4542316		YPO_RS21255	22
Gok2_libmerged	4543227	4543229		YPO_RS21265	2
Gok2_libmerged	4543335	4543343		YPO_RS21265	8
Gok2_libmerged	4544906	4544928		YPO_RS21275	22
Gok2_libmerged	4545298	4545664		YPO_RS21280	366
Gok2_libmerged	4545806	4545821		YPO_RS21280	15
Gok2_libmerged	4545879	4545922		YPO_RS21280	43
Gok2_libmerged	4546293	4546385		YPO_RS21280	92
Gok2_libmerged	4546426	4546626		YPO_RS21280	200
Gok2_libmerged	4546613	4546645		YPO_RS21285	32
Gok2_libmerged	4546856	4546942		YPO_RS21285	86
Gok2_libmerged	4547113	4547151		YPO_RS21285	38
Gok2_libmerged	4547633	4547661		YPO_RS21285	28
Gok2_libmerged	4548459	4548477		YPO_RS21295	18
Gok2_libmerged	4548603	4548619		YPO_RS21295	16
Gok2_libmerged	4549033	4549052		YPO_RS21295	19
Gok2_libmerged	4549152	4549168		YPO_RS21295	16
Gok2_libmerged	4549231	4549262		YPO_RS21295	31
Gok2_libmerged	4549348	4549368		YPO_RS21295	20
Gok2_libmerged	4549610	4549640		YPO_RS21300	30
Gok2_libmerged	4549903	4549917		YPO_RS21300	14
Gok2_libmerged	4550104	4550105		YPO_RS21300	1
Gok2_libmerged	4550181	4550189		YPO_RS21300	8
Gok2_libmerged	4550845	4550854		YPO_RS21305	9
Gok2_libmerged	4551546	4551595		YPO_RS21305	49
Gok2_libmerged	4551727	4551778		YPO_RS21305	51
Gok2_libmerged	4551996	4552005		YPO_RS21305	9
Gok2_libmerged	4552018	4552019		YPO_RS21305	1
Gok2_libmerged	4552176	4552178		YPO_RS21305	2
Gok2_libmerged	4552461	4552500		xylF	39
Gok2_libmerged	4552765	4552768		xylF	3
Gok2_libmerged	4552969	4553020		xylF	51
Gok2_libmerged	4554173	4554176		xylA	3
Gok2_libmerged	4554773	4554779		xylA	6
Gok2_libmerged	4555571	4555596		xylB	25
Gok2_libmerged	4555861	4555862		xylB	1
Gok2_libmerged	4556712	4556740		xylB	28
Gok2_libmerged	4557004	4557082		YPO_RS21325	78
Gok2_libmerged	4557468	4557482		YPO_RS21325	14
Gok2_libmerged	4557530	4557537		YPO_RS21325	7
Gok2_libmerged	4557781	4557796		YPO_RS21325	15
Gok2_libmerged	4558078	4558119		YPO_RS21330	41
Gok2_libmerged	4558378	4558395		YPO_RS21330	17
Gok2_libmerged	4561456	4561462		YPO_RS21340	6
Gok2_libmerged	4561794	4561867		YPO_RS21340	73
Gok2_libmerged	4562789	4562855		YPO_RS21345	66
Gok2_libmerged	4563021	4563068		YPO_RS21345	47
Gok2_libmerged	4563236	4563250		YPO_RS21345	14
Gok2_libmerged	4563457	4563561		YPO_RS21345	104
Gok2_libmerged	4563900	4563919		YPO_RS21350	19
Gok2_libmerged	4564447	4564457		YPO_RS21355	10
Gok2_libmerged	4564927	4564989		YPO_RS21355	62
Gok2_libmerged	4565118	4565142		YPO_RS21355	24
Gok2_libmerged	4565243	4565298		YPO_RS21355	55
Gok2_libmerged	4565360	4565387		YPO_RS21355	27
Gok2_libmerged	4565443	4565445		YPO_RS21355	2
Gok2_libmerged	4566113	4566149		YPO_RS21360	36
Gok2_libmerged	4566204	4566207		YPO_RS21360	3
Gok2_libmerged	4566954	4566969		YPO_RS21360	15
Gok2_libmerged	4567391	4567398		YPO_RS21365	7
Gok2_libmerged	4567633	4567769		YPO_RS21370	136
Gok2_libmerged	4567971	4567977		YPO_RS21375	6
Gok2_libmerged	4568264	4568451		YPO_RS21375	187
Gok2_libmerged	4568465	4568489		YPO_RS21380	24
Gok2_libmerged	4568554	4568710		YPO_RS21380	156
Gok2_libmerged	4570101	4570106		selB	5
Gok2_libmerged	4570333	4570373		selB	40
Gok2_libmerged	4570591	4570602		selB	11
Gok2_libmerged	4570865	4570947		selB	82
Gok2_libmerged	4571268	4571272		selB	4
Gok2_libmerged	4571283	4571286		YPO_RS21395	3
Gok2_libmerged	4571291	4571292		YPO_RS21395	1
Gok2_libmerged	4571741	4571765		YPO_RS21400	24
Gok2_libmerged	4572819	4572825		YPO_RS21400	6
Gok2_libmerged	4572886	4572895		YPO_RS21400	9
Gok2_libmerged	4573149	4573160		fdhE	11
Gok2_libmerged	4573226	4573234		fdhE	8
Gok2_libmerged	4573300	4573312		fdhE	12
Gok2_libmerged	4573964	4573992		fdhE	28
Gok2_libmerged	4574177	4574185		fdoI	8
Gok2_libmerged	4574401	4574406		fdoI	5
Gok2_libmerged	4574500	4574564		fdoI	64
Gok2_libmerged	4574974	4575073		fdxH	99
Gok2_libmerged	4575104	4575111		fdxH	7
Gok2_libmerged	4575186	4575190		fdxH	4
Gok2_libmerged	4575239	4575254		fdxH	15
Gok2_libmerged	4575304	4575334		fdxH	30
Gok2_libmerged	4575534	4575565		fdxH	31
Gok2_libmerged	4575718	4575723		fdnG	5
Gok2_libmerged	4575816	4575847		fdnG	31
Gok2_libmerged	4576716	4576717		fdnG	1
Gok2_libmerged	4577097	4577122		fdnG	25
Gok2_libmerged	4577242	4577322		fdnG	80
Gok2_libmerged	4577591	4577598		fdnG	7
Gok2_libmerged	4577726	4577733		fdnG	7
Gok2_libmerged	4577801	4577831		fdnG	30
Gok2_libmerged	4578422	4578435		fdnG	13
Gok2_libmerged	4580660	4580676		sodA	16
Gok2_libmerged	4581134	4581143		YPO_RS21435	9
Gok2_libmerged	4581340	4581379		YPO_RS21435	39
Gok2_libmerged	4581939	4581942		YPO_RS21435	3
Gok2_libmerged	4582107	4582139		YPO_RS21435	32
Gok2_libmerged	4582726	4582727		YPO_RS21435	1
Gok2_libmerged	4583533	4583605		YPO_RS21440	72
Gok2_libmerged	4585115	4585138		YPO_RS21450	23
Gok2_libmerged	4585743	4585759		YPO_RS21455	16
Gok2_libmerged	4585910	4585941		YPO_RS21455	31
Gok2_libmerged	4586863	4586921		YPO_RS21460	58
Gok2_libmerged	4587448	4587463		YPO_RS21465	15
Gok2_libmerged	4587545	4587581		YPO_RS21465	36
Gok2_libmerged	4587743	4587794		YPO_RS21465	51
Gok2_libmerged	4588634	4588675		YPO_RS21465	41
Gok2_libmerged	4589111	4589120		YPO_RS21465	9
Gok2_libmerged	4590031	4590039		YPO_RS21470	8
Gok2_libmerged	4590249	4590262		YPO_RS21470	13
Gok2_libmerged	4591055	4591073		YPO_RS21475	18
Gok2_libmerged	4591428	4591464		glyS	36
Gok2_libmerged	4591826	4591833		glyS	7
Gok2_libmerged	4591867	4591921		glyS	54
Gok2_libmerged	4592068	4592073		glyS	5
Gok2_libmerged	4592335	4592342		glyS	7
Gok2_libmerged	4592400	4592430		glyS	30
Gok2_libmerged	4592758	4592761		glyS	3
Gok2_libmerged	4593337	4593386		glyQ	49
Gok2_libmerged	4594055	4594105		glyQ	50
Gok2_libmerged	4594173	4594195		glyQ	22
Gok2_libmerged	4594747	4594749		YPO_RS21490	2
Gok2_libmerged	4594895	4594931		YPO_RS21490	36
Gok2_libmerged	4595924	4595934		YPO_RS21500	10
Gok2_libmerged	4596139	4596151		YPO_RS21500	12
Gok2_libmerged	4596573	4596574		YPO_RS21500	1
Gok2_libmerged	4596728	4596750		YPO_RS21505	22
Gok2_libmerged	4597877	4597895		ghrB	18
Gok2_libmerged	4597954	4597962		ghrB	8
Gok2_libmerged	4599491	4599503		YPO_RS21515	12
Gok2_libmerged	4599662	4599666		YPO_RS21515	4
Gok2_libmerged	4600434	4600435		YPO_RS21515	1
Gok2_libmerged	4600725	4600727		YPO_RS21515	2
Gok2_libmerged	4600947	4600961		YPO_RS21515	14
Gok2_libmerged	4601655	4601742		YPO_RS21520	87
Gok2_libmerged	4601830	4601930		YPO_RS21520	100
Gok2_libmerged	4601964	4602067		YPO_RS21520	103
Gok2_libmerged	4602653	4602696		YPO_RS21525	43
Gok2_libmerged	4602998	4603105		YPO_RS21525	107
Gok2_libmerged	4603209	4603222		YPO_RS21525	13
Gok2_libmerged	4603636	4603666		YPO_RS21525	30
Gok2_libmerged	4604493	4604518		YPO_RS21530	25
Gok2_libmerged	4604609	4604620		YPO_RS21530	11
Gok2_libmerged	4604954	4604959		YPO_RS21530	5
Gok2_libmerged	4605036	4605061		YPO_RS21530	25
Gok2_libmerged	4605240	4605288		YPO_RS21530	48
Gok2_libmerged	4605337	4605428		YPO_RS21530	91
Gok2_libmerged	4605463	4605558		YPO_RS21530	95
Gok2_libmerged	4606289	4606342		ibpB	53
Gok2_libmerged	4606373	4606395		ibpB	22
Gok2_libmerged	4606685	4606693		ibpA	8
Gok2_libmerged	4606931	4606971		ibpA	40
Gok2_libmerged	4607466	4607491		YPO_RS21545	25
Gok2_libmerged	4608683	4608730		YPO_RS21555	47
Gok2_libmerged	4609768	4609790		YPO_RS21560	22
Gok2_libmerged	4610875	4610938		YPO_RS21565	63
Gok2_libmerged	4611578	4611586		YPO_RS21565	8
Gok2_libmerged	4611643	4611682		YPO_RS21565	39
Gok2_libmerged	4611913	4611968		YPO_RS21565	55
Gok2_libmerged	4612030	4612057		YPO_RS21565	27
Gok2_libmerged	4612774	4612794		yidA	20
Gok2_libmerged	4612880	4612980		yidA	100
Gok2_libmerged	4613136	4613177		yidA	41
Gok2_libmerged	4613308	4613327		yidA	19
Gok2_libmerged	4613623	4613626		gyrB	3
Gok2_libmerged	4615120	4615186		gyrB	66
Gok2_libmerged	4615284	4615298		gyrB	14
Gok2_libmerged	4615631	4615640		gyrB	9
Gok2_libmerged	4616755	4616793		recF	38
Gok2_libmerged	4617338	4617345		dnaN	7
Gok2_libmerged	4617592	4617634		dnaN	42
Gok2_libmerged	4618131	4618133		dnaN	2
Gok2_libmerged	4618205	4618277		dnaN	72
Gok2_libmerged	4618361	4618401		dnaA	40
Gok2_libmerged	4619152	4619176		dnaA	24
Gok2_libmerged	4619279	4619280		dnaA	1
Gok2_libmerged	4619545	4619570		dnaA	25
Gok2_libmerged	4619659	4619662		dnaA	3
Gok2_libmerged	4620737	4620748		rnpA	11
Gok2_libmerged	4621545	4621579		yidC	34
Gok2_libmerged	4621640	4621679		yidC	39
Gok2_libmerged	4622104	4622111		yidC	7
Gok2_libmerged	4622263	4622294		yidC	31
Gok2_libmerged	4622585	4622596		yidC	11
Gok2_libmerged	4622796	4622807		yidC	11
Gok2_libmerged	4623598	4623634		mnmE	36
Gok2_libmerged	4623996	4624071		mnmE	75
Gok2_libmerged	4624514	4624543		YPO_RS21620	29
Gok2_libmerged	4624808	4624814		YPO_RS21620	6
Gok2_libmerged	4624857	4624885		YPO_RS21620	28
Gok2_libmerged	4625582	4625593		YPO_RS21620	11
Gok2_libmerged	4625796	4625815		YPO_RS21625	19
Gok2_libmerged	4625923	4626029		YPO_RS21625	106
Gok2_libmerged	4626084	4626089		YPO_RS21625	5
Gok2_libmerged	4626181	4626217		YPO_RS21630	36
Gok2_libmerged	4626248	4626298		YPO_RS21630	50
Gok2_libmerged	4626455	4626462		YPO_RS21630	7
Gok2_libmerged	4626524	4626615		YPO_RS21635	91
Gok2_libmerged	4626739	4626873		YPO_RS21635	134
Gok2_libmerged	4626919	4627033		YPO_RS21635	114
Gok2_libmerged	4627119	4627144		YPO_RS21635	25
Gok2_libmerged	4627870	4628056		YPO_RS21640	186
Gok2_libmerged	4628275	4628280		YPO_RS21640	5
Gok2_libmerged	4629399	4629435		YPO_RS21645	36
Gok2_libmerged	4629618	4629782		yieH	164
Gok2_libmerged	4630107	4630178		yieH	71
Gok2_libmerged	4630213	4630262		YPO_RS21655	49
Gok2_libmerged	4630464	4630487		YPO_RS21655	23
Gok2_libmerged	4630694	4630765		YPO_RS21655	71
Gok2_libmerged	4630910	4630939		YPO_RS21655	29
Gok2_libmerged	4631129	4631147		YPO_RS21660	18
Gok2_libmerged	4631208	4631215		YPO_RS21660	7
Gok2_libmerged	4631442	4631449		YPO_RS21660	7
Gok2_libmerged	4631650	4631707		YPO_RS21660	57
Gok2_libmerged	4632475	4632594		YPO_RS21665	119
Gok2_libmerged	4633198	4633208		YPO_RS21670	10
Gok2_libmerged	4633275	4633276		YPO_RS21670	1
Gok2_libmerged	4633348	4633547		YPO_RS21670	199
Gok2_libmerged	4633612	4633618		YPO_RS21670	6
Gok2_libmerged	4634078	4634142		phoU	64
Gok2_libmerged	4634210	4634226		phoU	16
Gok2_libmerged	4634582	4634653		phoU	71
Gok2_libmerged	4634781	4634823		pstB	42
Gok2_libmerged	4635268	4635288		pstB	20
Gok2_libmerged	4635382	4635468		pstB	86
Gok2_libmerged	4635650	4635656		pstA	6
Gok2_libmerged	4635817	4635826		pstA	9
Gok2_libmerged	4636082	4636092		pstA	10
Gok2_libmerged	4636917	4636925		pstC	8
Gok2_libmerged	4636963	4636971		pstC	8
Gok2_libmerged	4637397	4637422		pstC	25
Gok2_libmerged	4637825	4637838		pstS	13
Gok2_libmerged	4638329	4638410		pstS	81
Gok2_libmerged	4639413	4639435		glmS	22
Gok2_libmerged	4639709	4639819		glmS	110
Gok2_libmerged	4639981	4639982		glmS	1
Gok2_libmerged	4640236	4640292		glmS	56
Gok2_libmerged	4640427	4640435		glmS	8
Gok2_libmerged	4640592	4640630		glmS	38
Gok2_libmerged	4640728	4640755		glmS	27
Gok2_libmerged	4640884	4640892		glmS	8
Gok2_libmerged	4641388	4641428		glmU	40
Gok2_libmerged	4641489	4641539		glmU	50
Gok2_libmerged	4641690	4641695		glmU	5
Gok2_libmerged	4641760	4641765		glmU	5
Gok2_libmerged	4641833	4641880		glmU	47
Gok2_libmerged	4641985	4642034		glmU	49
Gok2_libmerged	4642117	4642147		glmU	30
Gok2_libmerged	4642289	4642339		glmU	50
Gok2_libmerged	4643216	4643222		atpC	6
Gok2_libmerged	4643291	4643348		atpC	57
Gok2_libmerged	4643463	4643506		atpC	43
Gok2_libmerged	4643622	4643638		atpC	16
Gok2_libmerged	4643660	4643707		atpD	47
Gok2_libmerged	4644100	4644179		atpD	79
Gok2_libmerged	4644402	4644485		atpD	83
Gok2_libmerged	4644734	4644753		atpD	19
Gok2_libmerged	4644951	4644961		atpD	10
Gok2_libmerged	4645229	4645237		atpG	8
Gok2_libmerged	4645542	4645559		atpG	17
Gok2_libmerged	4645738	4645861		atpG	123
Gok2_libmerged	4646633	4646660		atpA	27
Gok2_libmerged	4646729	4646749		atpA	20
Gok2_libmerged	4646819	4646864		atpA	45
Gok2_libmerged	4646960	4646966		atpA	6
Gok2_libmerged	4649363	4649396		atpB	33
Gok2_libmerged	4650024	4650039		atpI	15
Gok2_libmerged	4651312	4651319		rsmG	7
Gok2_libmerged	4651395	4651424		rsmG	29
Gok2_libmerged	4651893	4651917		mnmG	24
Gok2_libmerged	4652011	4652020		mnmG	9
Gok2_libmerged	4652728	4652735		mnmG	7
Gok2_libmerged	4653197	4653255		mnmG	58
Gok2_libmerged	4653468	4653477		mnmG	9
Gok2_libmerged	4653558	4653594		mnmG	36
HOP001.A0102_rmdup	14916	14919		YPO_RS01080	3
HOP001.A0102_rmdup	106582	106588		YPO_RS01520	6
HOP001.A0102_rmdup	196659	196661		YPO_RS01895	2
HOP001.A0102_rmdup	275502	275510		YPO_RS02395	8
HOP001.A0102_rmdup	288874	288903		YPO_RS02455	29
HOP001.A0102_rmdup	315081	315090		yapK	9
HOP001.A0102_rmdup	345944	345955		YPO_RS02695	11
HOP001.A0102_rmdup	346674	346680		YPO_RS02695	6
HOP001.A0102_rmdup	347076	347096		YPO_RS02695	20
HOP001.A0102_rmdup	347200	347202		YPO_RS02695	2
HOP001.A0102_rmdup	347248	347273		YPO_RS02695	25
HOP001.A0102_rmdup	360473	360485		fxsA	12
HOP001.A0102_rmdup	360980	360988		fxsA	8
HOP001.A0102_rmdup	407864	407883		YPO_RS02955	19
HOP001.A0102_rmdup	408176	408198		YPO_RS02955	22
HOP001.A0102_rmdup	409197	409223		YPO_RS02960	26
HOP001.A0102_rmdup	409843	409879		YPO_RS02965	36
HOP001.A0102_rmdup	410568	410585		YPO_RS02965	17
HOP001.A0102_rmdup	410866	410891		YPO_RS02965	25
HOP001.A0102_rmdup	409584	409712		YPO_RS02965	128
HOP001.A0102_rmdup	431301	431309		YPO_RS03065	8
HOP001.A0102_rmdup	495396	495399		YPO_RS03330	3
HOP001.A0102_rmdup	495733	495753		YPO_RS03330	20
HOP001.A0102_rmdup	521134	521149		YPO_RS03450	15
HOP001.A0102_rmdup	656694	656695		cdiA	1
HOP001.A0102_rmdup	659416	659426		cdiI	10
HOP001.A0102_rmdup	660159	660165		YPO_RS04005	6
HOP001.A0102_rmdup	666290	666295		YPO_RS04030	5
HOP001.A0102_rmdup	673960	673974		YPO_RS04055	14
HOP001.A0102_rmdup	704995	705010		plsY	15
HOP001.A0102_rmdup	747589	747596		YPO_RS04390	7
HOP001.A0102_rmdup	749362	749375		YPO_RS04405	13
HOP001.A0102_rmdup	749612	749638		YPO_RS04405	26
HOP001.A0102_rmdup	749629	749638		YPO_RS04410	9
HOP001.A0102_rmdup	750081	750106		YPO_RS04410	25
HOP001.A0102_rmdup	750200	750266		YPO_RS04410	66
HOP001.A0102_rmdup	750426	750429		YPO_RS04410	3
HOP001.A0102_rmdup	750492	750526		YPO_RS04415	34
HOP001.A0102_rmdup	751001	751138		YPO_RS04415	137
HOP001.A0102_rmdup	751188	751191		YPO_RS04415	3
HOP001.A0102_rmdup	752468	752474		YPO_RS04420	6
HOP001.A0102_rmdup	752689	752691		YPO_RS04425	2
HOP001.A0102_rmdup	753521	753547		YPO_RS04425	26
HOP001.A0102_rmdup	753735	753754		YPO_RS04425	19
HOP001.A0102_rmdup	753903	753946		YPO_RS04430	43
HOP001.A0102_rmdup	754846	754847		YPO_RS04440	1
HOP001.A0102_rmdup	755321	755338		YPO_RS04440	17
HOP001.A0102_rmdup	755643	755664		YPO_RS04445	21
HOP001.A0102_rmdup	758471	758475		YPO_RS04465	4
HOP001.A0102_rmdup	772960	772990		YPO_RS04525	30
HOP001.A0102_rmdup	774272	774273		YPO_RS04530	1
HOP001.A0102_rmdup	785301	785314		YPO_RS04600	13
HOP001.A0102_rmdup	796062	796077		YPO_RS04660	15
HOP001.A0102_rmdup	801483	801495		fliS	12
HOP001.A0102_rmdup	803234	803240		YPO_RS04695	6
HOP001.A0102_rmdup	807627	807704		YPO_RS04720	77
HOP001.A0102_rmdup	807690	807704		YPO_RS04725	14
HOP001.A0102_rmdup	808993	809035		YPO_RS04735	42
HOP001.A0102_rmdup	809185	809217		YPO_RS04735	32
HOP001.A0102_rmdup	816410	816434		YPO_RS04765	24
HOP001.A0102_rmdup	816681	816737		YPO_RS04765	56
HOP001.A0102_rmdup	838861	838914		YPO_RS04815	53
HOP001.A0102_rmdup	845421	845556		YPO_RS04835	135
HOP001.A0102_rmdup	845589	845609		YPO_RS04835	20
HOP001.A0102_rmdup	884441	884472		YPO_RS04965	31
HOP001.A0102_rmdup	885664	885694		YPO_RS04975	30
HOP001.A0102_rmdup	886598	886669		YPO_RS04980	71
HOP001.A0102_rmdup	886770	886771		YPO_RS04980	1
HOP001.A0102_rmdup	888127	888173		YPO_RS04990	46
HOP001.A0102_rmdup	889201	889211		gspJ	10
HOP001.A0102_rmdup	889316	889326		gspJ	10
HOP001.A0102_rmdup	889511	889515		gspJ	4
HOP001.A0102_rmdup	890001	890011		YPO_RS05005	10
HOP001.A0102_rmdup	890249	890260		YPO_RS05005	11
HOP001.A0102_rmdup	893700	893743		gspD	43
HOP001.A0102_rmdup	893792	893831		gspD	39
HOP001.A0102_rmdup	894469	894486		gspD	17
HOP001.A0102_rmdup	894941	894945		gspD	4
HOP001.A0102_rmdup	895453	895466		gspD	13
HOP001.A0102_rmdup	895701	895716		YPO_RS05030	15
HOP001.A0102_rmdup	895908	895933		YPO_RS05030	25
HOP001.A0102_rmdup	896183	896190		YPO_RS05030	7
HOP001.A0102_rmdup	896336	896338		YPO_RS05035	2
HOP001.A0102_rmdup	896627	896630		YPO_RS05035	3
HOP001.A0102_rmdup	949939	949946		YPO_RS05235	7
HOP001.A0102_rmdup	950144	950183		YPO_RS05235	39
HOP001.A0102_rmdup	953658	953737		YPO_RS05260	79
HOP001.A0102_rmdup	963348	963355		YPO_RS05305	7
HOP001.A0102_rmdup	1043772	1043788		YPO_RS05675	16
HOP001.A0102_rmdup	1044405	1044416		YPO_RS05675	11
HOP001.A0102_rmdup	1044483	1044493		YPO_RS05675	10
HOP001.A0102_rmdup	1044635	1044637		YPO_RS05675	2
HOP001.A0102_rmdup	1045007	1045089		YPO_RS05675	82
HOP001.A0102_rmdup	1045552	1045562		YPO_RS05675	10
HOP001.A0102_rmdup	1046496	1046506		YPO_RS05675	10
HOP001.A0102_rmdup	1046682	1046717		YPO_RS05675	35
HOP001.A0102_rmdup	1066882	1066888		YPO_RS05765	6
HOP001.A0102_rmdup	1066979	1066995		YPO_RS05765	16
HOP001.A0102_rmdup	1067345	1067380		YPO_RS05765	35
HOP001.A0102_rmdup	1067376	1067380		YPO_RS05770	4
HOP001.A0102_rmdup	1068143	1068182		YPO_RS05770	39
HOP001.A0102_rmdup	1073122	1073141		YPO_RS05795	19
HOP001.A0102_rmdup	1088708	1088709		YPO_RS05845	1
HOP001.A0102_rmdup	1089072	1089082		YPO_RS05845	10
HOP001.A0102_rmdup	1117080	1117098		YPO_RS05940	18
HOP001.A0102_rmdup	1117269	1117293		YPO_RS05940	24
HOP001.A0102_rmdup	1118058	1118083		YPO_RS05940	25
HOP001.A0102_rmdup	1121100	1121102		yapH	2
HOP001.A0102_rmdup	1124075	1124084		yapH	9
HOP001.A0102_rmdup	1124169	1124184		yapH	15
HOP001.A0102_rmdup	1124222	1124226		yapH	4
HOP001.A0102_rmdup	1124281	1124283		yapH	2
HOP001.A0102_rmdup	1124387	1124397		yapH	10
HOP001.A0102_rmdup	1124447	1124495		yapH	48
HOP001.A0102_rmdup	1124535	1124542		yapH	7
HOP001.A0102_rmdup	1124684	1124878		yapH	194
HOP001.A0102_rmdup	1124927	1124936		yapH	9
HOP001.A0102_rmdup	1124994	1125006		yapH	12
HOP001.A0102_rmdup	1125176	1125257		yapH	81
HOP001.A0102_rmdup	1125303	1125395		yapH	92
HOP001.A0102_rmdup	1125444	1125474		yapH	30
HOP001.A0102_rmdup	1125544	1125597		yapH	53
HOP001.A0102_rmdup	1125664	1125675		yapH	11
HOP001.A0102_rmdup	1140365	1140394		YPO_RS05985	29
HOP001.A0102_rmdup	1141416	1141429		YPO_RS05985	13
HOP001.A0102_rmdup	1142205	1142212		YPO_RS05985	7
HOP001.A0102_rmdup	1142434	1142437		YPO_RS05985	3
HOP001.A0102_rmdup	1218462	1218463		YPO_RS06330	1
HOP001.A0102_rmdup	1220119	1220121		YPO_RS06340	2
HOP001.A0102_rmdup	1221218	1221220		YPO_RS06340	2
HOP001.A0102_rmdup	1221601	1221602		YPO_RS06340	1
HOP001.A0102_rmdup	1240945	1240978		YPO_RS06465	33
HOP001.A0102_rmdup	1241064	1241134		YPO_RS06465	70
HOP001.A0102_rmdup	1241985	1242018		YPO_RS06465	33
HOP001.A0102_rmdup	1242558	1242562		YPO_RS06470	4
HOP001.A0102_rmdup	1243192	1243234		YPO_RS06470	42
HOP001.A0102_rmdup	1269609	1269650		tolA	41
HOP001.A0102_rmdup	1322383	1322401		YPO_RS06875	18
HOP001.A0102_rmdup	1322976	1322977		YPO_RS06875	1
HOP001.A0102_rmdup	1331874	1331878		phnD	4
HOP001.A0102_rmdup	1432782	1432784		YPO_RS07370	2
HOP001.A0102_rmdup	1433391	1433399		YPO_RS07370	8
HOP001.A0102_rmdup	1461792	1461809		YPO_RS07490	17
HOP001.A0102_rmdup	1463379	1463420		YPO_RS07500	41
HOP001.A0102_rmdup	1647598	1647647		YPO_RS08260	49
HOP001.A0102_rmdup	1654108	1654112		YPO_RS08295	4
HOP001.A0102_rmdup	1658264	1658266		tssC	2
HOP001.A0102_rmdup	1658413	1658415		tssC	2
HOP001.A0102_rmdup	1666068	1666071		YPO_RS08345	3
HOP001.A0102_rmdup	1666146	1666149		YPO_RS08345	3
HOP001.A0102_rmdup	1668235	1668239		YPO_RS08350	4
HOP001.A0102_rmdup	1670183	1670196		YPO_RS08350	13
HOP001.A0102_rmdup	1670462	1670506		YPO_RS08355	44
HOP001.A0102_rmdup	1670573	1670576		YPO_RS08355	3
HOP001.A0102_rmdup	1673364	1673370		YPO_RS08365	6
HOP001.A0102_rmdup	1674401	1674426		YPO_RS08370	25
HOP001.A0102_rmdup	1684057	1684064		YPO_RS08400	7
HOP001.A0102_rmdup	1684119	1684146		YPO_RS08400	27
HOP001.A0102_rmdup	1684419	1684454		YPO_RS08400	35
HOP001.A0102_rmdup	1690300	1690305		YPO_RS08430	5
HOP001.A0102_rmdup	1698455	1698460		darE	5
HOP001.A0102_rmdup	1699094	1699120		darE	26
HOP001.A0102_rmdup	1699863	1699875		darD	12
HOP001.A0102_rmdup	1700307	1700371		darC	64
HOP001.A0102_rmdup	1701113	1701142		darC	29
HOP001.A0102_rmdup	1725937	1725943		YPO_RS08570	6
HOP001.A0102_rmdup	1726279	1726303		YPO_RS08570	24
HOP001.A0102_rmdup	1739303	1739311		YPO_RS08625	8
HOP001.A0102_rmdup	1796969	1796984		YPO_RS08860	15
HOP001.A0102_rmdup	1842258	1842277		YPO_RS09090	19
HOP001.A0102_rmdup	1878341	1878349		YPO_RS09250	8
HOP001.A0102_rmdup	1901661	1901663		YPO_RS09335	2
HOP001.A0102_rmdup	1904870	1904871		yapJ	1
HOP001.A0102_rmdup	1918294	1918296		YPO_RS09385	2
HOP001.A0102_rmdup	1963166	1963167		YPO_RS09565	1
HOP001.A0102_rmdup	1996034	1996048		YPO_RS09745	14
HOP001.A0102_rmdup	1999863	1999874		mntP	11
HOP001.A0102_rmdup	2000350	2000366		YPO_RS09760	16
HOP001.A0102_rmdup	2015853	2015856		hpaC	3
HOP001.A0102_rmdup	2070452	2070472		YPO_RS10110	20
HOP001.A0102_rmdup	2118015	2118040		hcp	25
HOP001.A0102_rmdup	2118343	2118344		hcp	1
HOP001.A0102_rmdup	2122646	2122655		YPO_RS10395	9
HOP001.A0102_rmdup	2123454	2123470		YPO_RS10405	16
HOP001.A0102_rmdup	2126515	2126552		YPO_RS10415	37
HOP001.A0102_rmdup	2126564	2126565		YPO_RS10420	1
HOP001.A0102_rmdup	2126781	2126787		YPO_RS10420	6
HOP001.A0102_rmdup	2126880	2126899		YPO_RS10420	19
HOP001.A0102_rmdup	2152641	2152647		irp1	6
HOP001.A0102_rmdup	2237356	2237375		YPO_RS10835	19
HOP001.A0102_rmdup	2256128	2256175		YPO_RS10925	47
HOP001.A0102_rmdup	2256502	2256545		YPO_RS10925	43
HOP001.A0102_rmdup	2258636	2258651		YPO_RS10935	15
HOP001.A0102_rmdup	2300007	2300030		YPO_RS11135	23
HOP001.A0102_rmdup	2316455	2316487		YPO_RS11220	32
HOP001.A0102_rmdup	2318097	2318102		YPO_RS11220	5
HOP001.A0102_rmdup	2318132	2318144		YPO_RS11225	12
HOP001.A0102_rmdup	2319509	2319553		YPO_RS11225	44
HOP001.A0102_rmdup	2376970	2376972		YPO_RS11520	2
HOP001.A0102_rmdup	2439748	2439779		YPO_RS11830	31
HOP001.A0102_rmdup	2439922	2439946		YPO_RS11830	24
HOP001.A0102_rmdup	2440162	2440183		YPO_RS11830	21
HOP001.A0102_rmdup	2440239	2440249		YPO_RS11830	10
HOP001.A0102_rmdup	2442372	2442373		purU	1
HOP001.A0102_rmdup	2475839	2475869		YPO_RS12005	30
HOP001.A0102_rmdup	2491173	2491228		topA	55
HOP001.A0102_rmdup	2495446	2495451		YPO_RS12105	5
HOP001.A0102_rmdup	2495889	2495905		YPO_RS12105	16
HOP001.A0102_rmdup	2519275	2519309		YPO_RS12215	34
HOP001.A0102_rmdup	2541335	2541357		YPO_RS12300	22
HOP001.A0102_rmdup	2548349	2548351		YPO_RS12325	2
HOP001.A0102_rmdup	2549507	2549509		YPO_RS12330	2
HOP001.A0102_rmdup	2554373	2554633		YPO_RS12355	260
HOP001.A0102_rmdup	2554658	2555065		YPO_RS12360	407
HOP001.A0102_rmdup	2555162	2555608		YPO_RS12365	446
HOP001.A0102_rmdup	2555780	2556832		YPO_RS12370	1052
HOP001.A0102_rmdup	2556844	2557161		YPO_RS12375	317
HOP001.A0102_rmdup	2557164	2557415		YPO_RS12380	251
HOP001.A0102_rmdup	2557451	2557684		YPO_RS12385	233
HOP001.A0102_rmdup	2557749	2559461		YPO_RS12390	1712
HOP001.A0102_rmdup	2559474	2559761		YPO_RS12395	287
HOP001.A0102_rmdup	2559765	2560790		YPO_RS12400	1025
HOP001.A0102_rmdup	2560790	2562034		YPO_RS12405	1244
HOP001.A0102_rmdup	2562123	2562371		YPO_RS12410	248
HOP001.A0102_rmdup	2562568	2562765		YPO_RS12415	197
HOP001.A0102_rmdup	2565819	2565842		YPO_RS12435	23
HOP001.A0102_rmdup	2630107	2630110		YPO_RS12680	3
HOP001.A0102_rmdup	2716582	2716623		arnF	41
HOP001.A0102_rmdup	2728910	2728917		pheT	7
HOP001.A0102_rmdup	2755450	2755502		YPO_RS13290	52
HOP001.A0102_rmdup	2772116	2772125		YPO_RS13355	9
HOP001.A0102_rmdup	2773280	2773287		YPO_RS13360	7
HOP001.A0102_rmdup	2786431	2786441		YPO_RS13430	10
HOP001.A0102_rmdup	2807963	2807965		YPO_RS13485	2
HOP001.A0102_rmdup	2813952	2813954		YPO_RS13510	2
HOP001.A0102_rmdup	2821148	2821176		YPO_RS13550	28
HOP001.A0102_rmdup	2853919	2853942		YPO_RS13690	23
HOP001.A0102_rmdup	2854053	2854064		YPO_RS13690	11
HOP001.A0102_rmdup	2854160	2854194		YPO_RS13690	34
HOP001.A0102_rmdup	2854671	2854676		YPO_RS13690	5
HOP001.A0102_rmdup	2885776	2885787		YPO_RS13815	11
HOP001.A0102_rmdup	2887091	2887932		YPO_RS13825	841
HOP001.A0102_rmdup	2887989	2893967		YPO_RS13830	5978
HOP001.A0102_rmdup	2894374	2894922		YPO_RS13835	548
HOP001.A0102_rmdup	2895617	2896471		YPO_RS13840	854
HOP001.A0102_rmdup	2896777	2898303		YPO_RS13845	1526
HOP001.A0102_rmdup	2898338	2900263		iolD	1925
HOP001.A0102_rmdup	2910256	2910290		iolB	34
HOP001.A0102_rmdup	2915456	2915474		YPO_RS13925	18
HOP001.A0102_rmdup	2980438	2980532		YPO_RS14235	94
HOP001.A0102_rmdup	2980589	2980592		YPO_RS14235	3
HOP001.A0102_rmdup	2996211	2996212		ureG	1
HOP001.A0102_rmdup	3012186	3012220		YPO_RS14405	34
HOP001.A0102_rmdup	3021121	3021162		YPO_RS14440	41
HOP001.A0102_rmdup	3024869	3024870		YPO_RS14460	1
HOP001.A0102_rmdup	3037251	3037264		YPO_RS14530	13
HOP001.A0102_rmdup	3120316	3120561		YPO_RS14920	245
HOP001.A0102_rmdup	3121234	3121815		YPO_RS14925	581
HOP001.A0102_rmdup	3122083	3122484		YPO_RS14930	401
HOP001.A0102_rmdup	3122717	3123118		YPO_RS14935	401
HOP001.A0102_rmdup	3123130	3123702		YPO_RS14940	572
HOP001.A0102_rmdup	3123726	3123773		YPO_RS14945	47
HOP001.A0102_rmdup	3123911	3123977		YPO_RS14945	66
HOP001.A0102_rmdup	3124016	3124255		YPO_RS14950	239
HOP001.A0102_rmdup	3125064	3126980		yapC	1916
HOP001.A0102_rmdup	3127169	3127226		YPO_RS14960	57
HOP001.A0102_rmdup	3127515	3128096		YPO_RS14965	581
HOP001.A0102_rmdup	3130158	3132365		YPO_RS14980	2207
HOP001.A0102_rmdup	3132358	3132888		YPO_RS14985	530
HOP001.A0102_rmdup	3133047	3135428		YPO_RS14990	2381
HOP001.A0102_rmdup	3135507	3137135		YPO_RS14995	1628
HOP001.A0102_rmdup	3137608	3138459		YPO_RS15000	851
HOP001.A0102_rmdup	3138485	3138989		YPO_RS15005	504
HOP001.A0102_rmdup	3139020	3139474		YPO_RS15005	454
HOP001.A0102_rmdup	3139529	3140422		YPO_RS15010	893
HOP001.A0102_rmdup	3142684	3142989		YPO_RS15025	305
HOP001.A0102_rmdup	3143086	3143487		YPO_RS15030	401
HOP001.A0102_rmdup	3143469	3144177		YPO_RS15035	708
HOP001.A0102_rmdup	3145848	3145855		YPO_RS15040	7
HOP001.A0102_rmdup	3165609	3165616		ppk1	7
HOP001.A0102_rmdup	3200192	3200195		YPO_RS15280	3
HOP001.A0102_rmdup	3200192	3200241		YPO_RS15285	49
HOP001.A0102_rmdup	3200411	3200417		YPO_RS15285	6
HOP001.A0102_rmdup	3200722	3200752		YPO_RS15290	30
HOP001.A0102_rmdup	3200833	3200872		YPO_RS15290	39
HOP001.A0102_rmdup	3201311	3201329		YPO_RS15295	18
HOP001.A0102_rmdup	3201495	3201503		YPO_RS15295	8
HOP001.A0102_rmdup	3201567	3201669		YPO_RS15300	102
HOP001.A0102_rmdup	3201758	3201780		YPO_RS15300	22
HOP001.A0102_rmdup	3221823	3221857		YPO_RS15385	34
HOP001.A0102_rmdup	3222628	3222651		YPO_RS15385	23
HOP001.A0102_rmdup	3225494	3225530		yapA	36
HOP001.A0102_rmdup	3225580	3225618		yapA	38
HOP001.A0102_rmdup	3262704	3262740		YPO_RS15560	36
HOP001.A0102_rmdup	3262878	3262898		YPO_RS15560	20
HOP001.A0102_rmdup	3320265	3320272		YPO_RS15810	7
HOP001.A0102_rmdup	3356140	3356143		YPO_RS16010	3
HOP001.A0102_rmdup	3356947	3356952		YPO_RS16010	5
HOP001.A0102_rmdup	3364285	3364287		YPO_RS16040	2
HOP001.A0102_rmdup	3364680	3364737		YPO_RS16040	57
HOP001.A0102_rmdup	3454811	3454836		fepE	25
HOP001.A0102_rmdup	3455009	3455020		cpsG	11
HOP001.A0102_rmdup	3455927	3455933		cpsG	6
HOP001.A0102_rmdup	3456548	3456587		YPO_RS16450	39
HOP001.A0102_rmdup	3457109	3457122		YPO_RS16450	13
HOP001.A0102_rmdup	3461634	3461653		YPO_RS16470	19
HOP001.A0102_rmdup	3461838	3461854		YPO_RS16470	16
HOP001.A0102_rmdup	3463467	3463494		YPO_RS16480	27
HOP001.A0102_rmdup	3463745	3463820		YPO_RS16480	75
HOP001.A0102_rmdup	3463863	3463968		YPO_RS16480	105
HOP001.A0102_rmdup	3464128	3464201		YPO_RS16480	73
HOP001.A0102_rmdup	3464843	3464875		YPO_RS16485	32
HOP001.A0102_rmdup	3465058	3465107		YPO_RS16485	49
HOP001.A0102_rmdup	3465428	3465429		YPO_RS16485	1
HOP001.A0102_rmdup	3465520	3465556		YPO_RS16485	36
HOP001.A0102_rmdup	3465567	3465601		YPO_RS16490	34
HOP001.A0102_rmdup	3466259	3466339		YPO_RS16490	80
HOP001.A0102_rmdup	3466450	3466461		YPO_RS16490	11
HOP001.A0102_rmdup	3466657	3466660		YPO_RS16490	3
HOP001.A0102_rmdup	3466984	3467003		YPO_RS16495	19
HOP001.A0102_rmdup	3468697	3468701		YPO_RS16500	4
HOP001.A0102_rmdup	3527253	3527267		YPO_RS16755	14
HOP001.A0102_rmdup	3547437	3547448		YPO_RS16860	11
HOP001.A0102_rmdup	3548045	3548160		YPO_RS16865	115
HOP001.A0102_rmdup	3572118	3572120		YPO_RS16965	2
HOP001.A0102_rmdup	3590101	3590128		YPO_RS17045	27
HOP001.A0102_rmdup	3592908	3592911		YPO_RS17055	3
HOP001.A0102_rmdup	3593026	3593061		YPO_RS17055	35
HOP001.A0102_rmdup	3593289	3593290		YPO_RS17055	1
HOP001.A0102_rmdup	3618897	3618900		YPO_RS17145	3
HOP001.A0102_rmdup	3704393	3704409		cybC	16
HOP001.A0102_rmdup	3712788	3712804		YPO_RS17595	16
HOP001.A0102_rmdup	3731757	3731776		YPO_RS17675	19
HOP001.A0102_rmdup	3773767	3773787		barA	20
HOP001.A0102_rmdup	3950373	3950378		yjfP	5
HOP001.A0102_rmdup	4018207	4018217		YPO_RS19000	10
HOP001.A0102_rmdup	4018273	4018276		YPO_RS19000	3
HOP001.A0102_rmdup	4018430	4018435		YPO_RS19000	5
HOP001.A0102_rmdup	4018553	4018555		YPO_RS19000	2
HOP001.A0102_rmdup	4018701	4018743		YPO_RS19000	42
HOP001.A0102_rmdup	4018830	4018878		YPO_RS19000	48
HOP001.A0102_rmdup	4018950	4018957		YPO_RS19000	7
HOP001.A0102_rmdup	4018999	4019001		YPO_RS19000	2
HOP001.A0102_rmdup	4019033	4019094		YPO_RS19000	61
HOP001.A0102_rmdup	4019298	4019299		YPO_RS19000	1
HOP001.A0102_rmdup	4019379	4019784		YPO_RS19000	405
HOP001.A0102_rmdup	4019790	4020032		YPO_RS19005	242
HOP001.A0102_rmdup	4020117	4020248		YPO_RS19005	131
HOP001.A0102_rmdup	4020241	4023105		YPO_RS19010	2864
HOP001.A0102_rmdup	4023133	4024503		YPO_RS19015	1370
HOP001.A0102_rmdup	4024505	4024990		YPO_RS19020	485
HOP001.A0102_rmdup	4025040	4025231		YPO_RS19025	191
HOP001.A0102_rmdup	4025307	4025531		YPO_RS19030	224
HOP001.A0102_rmdup	4025613	4026020		YPO_RS19035	407
HOP001.A0102_rmdup	4026413	4026416		YPO_RS19045	3
HOP001.A0102_rmdup	4026585	4026687		YPO_RS19045	102
HOP001.A0102_rmdup	4026778	4026779		YPO_RS19045	1
HOP001.A0102_rmdup	4026850	4026860		YPO_RS19045	10
HOP001.A0102_rmdup	4026892	4026898		YPO_RS19045	6
HOP001.A0102_rmdup	4033707	4033711		YPO_RS19060	4
HOP001.A0102_rmdup	4033788	4033827		YPO_RS19060	39
HOP001.A0102_rmdup	4033955	4033977		YPO_RS19060	22
HOP001.A0102_rmdup	4034678	4034682		YPO_RS19065	4
HOP001.A0102_rmdup	4035262	4035264		YPO_RS19070	2
HOP001.A0102_rmdup	4098633	4098664		YPO_RS19365	31
HOP001.A0102_rmdup	4098950	4098959		YPO_RS19365	9
HOP001.A0102_rmdup	4099390	4099450		YPO_RS19365	60
HOP001.A0102_rmdup	4101642	4101704		YPO_RS19370	62
HOP001.A0102_rmdup	4112696	4112769		YPO_RS19400	73
HOP001.A0102_rmdup	4113980	4114088		YPO_RS19405	108
HOP001.A0102_rmdup	4114153	4114158		YPO_RS19405	5
HOP001.A0102_rmdup	4114225	4114233		YPO_RS19405	8
HOP001.A0102_rmdup	4142770	4142774		YPO_RS19535	4
HOP001.A0102_rmdup	4206216	4206225		rplL	9
HOP001.A0102_rmdup	4219432	4219433		YPO_RS19855	1
HOP001.A0102_rmdup	4235786	4235789		hemB	3
HOP001.A0102_rmdup	4264345	4264365		YPO_RS20070	20
HOP001.A0102_rmdup	4269676	4269678		YPO_RS20095	2
HOP001.A0102_rmdup	4359333	4359388		YPO_RS20515	55
HOP001.A0102_rmdup	4368047	4368052		YPO_RS20575	5
HOP001.A0102_rmdup	4401542	4401546		YPO_RS20725	4
HOP001.A0102_rmdup	4405603	4405606		YPO_RS20740	3
HOP001.A0102_rmdup	4408289	4408320		YPO_RS20745	31
HOP001.A0102_rmdup	4480665	4480675		YPO_RS21000	10
HOP001.A0102_rmdup	4480665	4480675		YPO_RS21005	10
HOP001.A0102_rmdup	4483792	4483825		YPO_RS21020	33
HOP001.A0102_rmdup	4483890	4483897		YPO_RS21020	7
HOP001.A0102_rmdup	4484190	4484209		YPO_RS21025	19
HOP001.A0102_rmdup	4505795	4505796		hmsP	1
HOP001.A0102_rmdup	4515985	4515998		YPO_RS21140	13
HOP001.A0102_rmdup	4517309	4517339		YPO_RS21140	30
HOP001.A0102_rmdup	4567735	4567743		YPO_RS21370	8
HOP001.A0102_rmdup	4601707	4601722		YPO_RS21520	15
HOP001.A0102_rmdup	4601885	4601897		YPO_RS21520	12
HOP001.A0102_rmdup	4602022	4602041		YPO_RS21520	19
HOP001.A0102_rmdup	4626291	4626309		YPO_RS21630	18
HOP004_libmerged	4071	4086		ravA	15
HOP004_libmerged	14916	14917		YPO_RS01080	1
HOP004_libmerged	106572	106588		YPO_RS01520	16
HOP004_libmerged	196647	196668		YPO_RS01895	21
HOP004_libmerged	315087	315100		yapK	13
HOP004_libmerged	345919	345959		YPO_RS02695	40
HOP004_libmerged	407891	407894		YPO_RS02955	3
HOP004_libmerged	409198	409201		YPO_RS02960	3
HOP004_libmerged	409857	409859		YPO_RS02965	2
HOP004_libmerged	410566	410571		YPO_RS02965	5
HOP004_libmerged	410848	410891		YPO_RS02965	43
HOP004_libmerged	409557	409612		YPO_RS02965	55
HOP004_libmerged	426086	426087		lsrF	1
HOP004_libmerged	431305	431339		YPO_RS03065	34
HOP004_libmerged	495768	495786		YPO_RS03330	18
HOP004_libmerged	552920	552924		tssM	4
HOP004_libmerged	579552	579573		YPO_RS03675	21
HOP004_libmerged	659376	659378		cdiI	2
HOP004_libmerged	750484	750517		YPO_RS04415	33
HOP004_libmerged	751105	751113		YPO_RS04415	8
HOP004_libmerged	751163	751201		YPO_RS04415	38
HOP004_libmerged	752638	752656		YPO_RS04425	18
HOP004_libmerged	758454	758456		YPO_RS04465	2
HOP004_libmerged	785301	785302		YPO_RS04600	1
HOP004_libmerged	796065	796069		YPO_RS04660	4
HOP004_libmerged	801483	801505		fliS	22
HOP004_libmerged	806663	806666		YPO_RS04715	3
HOP004_libmerged	807640	807658		YPO_RS04720	18
HOP004_libmerged	809186	809228		YPO_RS04735	42
HOP004_libmerged	845442	845580		YPO_RS04835	138
HOP004_libmerged	884462	884467		YPO_RS04965	5
HOP004_libmerged	885680	885681		YPO_RS04975	1
HOP004_libmerged	886591	886679		YPO_RS04980	88
HOP004_libmerged	888159	888201		YPO_RS04990	42
HOP004_libmerged	890002	890008		YPO_RS05005	6
HOP004_libmerged	893727	893826		gspD	99
HOP004_libmerged	895739	895743		YPO_RS05030	4
HOP004_libmerged	896258	896261		YPO_RS05035	3
HOP004_libmerged	943975	943981		YPO_RS05215	6
HOP004_libmerged	950105	950116		YPO_RS05235	11
HOP004_libmerged	950161	950162		YPO_RS05235	1
HOP004_libmerged	953696	953704		YPO_RS05260	8
HOP004_libmerged	1043956	1043968		YPO_RS05675	12
HOP004_libmerged	1044466	1044504		YPO_RS05675	38
HOP004_libmerged	1045526	1045562		YPO_RS05675	36
HOP004_libmerged	1046484	1046495		YPO_RS05675	11
HOP004_libmerged	1066975	1066987		YPO_RS05765	12
HOP004_libmerged	1067363	1067380		YPO_RS05765	17
HOP004_libmerged	1067376	1067380		YPO_RS05770	4
HOP004_libmerged	1068146	1068173		YPO_RS05770	27
HOP004_libmerged	1118076	1118085		YPO_RS05940	9
HOP004_libmerged	1124074	1124103		yapH	29
HOP004_libmerged	1124183	1124226		yapH	43
HOP004_libmerged	1124279	1124283		yapH	4
HOP004_libmerged	1124381	1124397		yapH	16
HOP004_libmerged	1124464	1124492		yapH	28
HOP004_libmerged	1124537	1124541		yapH	4
HOP004_libmerged	1124607	1124608		yapH	1
HOP004_libmerged	1124693	1124876		yapH	183
HOP004_libmerged	1124924	1124934		yapH	10
HOP004_libmerged	1125122	1125256		yapH	134
HOP004_libmerged	1125306	1125394		yapH	88
HOP004_libmerged	1125442	1125472		yapH	30
HOP004_libmerged	1125545	1125597		yapH	52
HOP004_libmerged	1125668	1125676		yapH	8
HOP004_libmerged	1142063	1142068		YPO_RS05985	5
HOP004_libmerged	1218461	1218462		YPO_RS06330	1
HOP004_libmerged	1220120	1220121		YPO_RS06340	1
HOP004_libmerged	1221215	1221221		YPO_RS06340	6
HOP004_libmerged	1221600	1221602		YPO_RS06340	2
HOP004_libmerged	1241057	1241115		YPO_RS06465	58
HOP004_libmerged	1242664	1242665		YPO_RS06470	1
HOP004_libmerged	1269613	1269619		tolA	6
HOP004_libmerged	1461553	1461562		YPO_RS07485	9
HOP004_libmerged	1463116	1463120		psaA	4
HOP004_libmerged	1463379	1463444		YPO_RS07500	65
HOP004_libmerged	1477015	1477019		YPO_RS07545	4
HOP004_libmerged	1514465	1514474		artQ	9
HOP004_libmerged	1567538	1567549		YPO_RS07930	11
HOP004_libmerged	1567733	1567756		YPO_RS07930	23
HOP004_libmerged	1647598	1647649		YPO_RS08260	51
HOP004_libmerged	1658264	1658265		tssC	1
HOP004_libmerged	1658413	1658415		tssC	2
HOP004_libmerged	1666069	1666073		YPO_RS08345	4
HOP004_libmerged	1666147	1666148		YPO_RS08345	1
HOP004_libmerged	1684066	1684148		YPO_RS08400	82
HOP004_libmerged	1700326	1700388		darC	62
HOP004_libmerged	1701106	1701143		darC	37
HOP004_libmerged	1701145	1701157		darB	12
HOP004_libmerged	1701363	1701364		darB	1
HOP004_libmerged	1739303	1739320		YPO_RS08625	17
HOP004_libmerged	1742917	1742922		YPO_RS08640	5
HOP004_libmerged	1796135	1796179		YPO_RS08855	44
HOP004_libmerged	1808306	1808315		bssS	9
HOP004_libmerged	1904870	1904871		yapJ	1
HOP004_libmerged	1933838	1933844		YPO_RS09455	6
HOP004_libmerged	1999863	1999872		mntP	9
HOP004_libmerged	2000487	2000488		YPO_RS09760	1
HOP004_libmerged	2070470	2070475		YPO_RS10110	5
HOP004_libmerged	2081685	2081696		YPO_RS10170	11
HOP004_libmerged	2118063	2118082		hcp	19
HOP004_libmerged	2126787	2126790		YPO_RS10420	3
HOP004_libmerged	2187795	2187810		YPO_RS10645	15
HOP004_libmerged	2237356	2237375		YPO_RS10835	19
HOP004_libmerged	2258636	2258646		YPO_RS10935	10
HOP004_libmerged	2277261	2277268		YPO_RS11015	7
HOP004_libmerged	2299959	2299960		YPO_RS11135	1
HOP004_libmerged	2300025	2300030		YPO_RS11135	5
HOP004_libmerged	2303892	2303895		YPO_RS11155	3
HOP004_libmerged	2316441	2316527		YPO_RS11220	86
HOP004_libmerged	2318860	2318861		YPO_RS11225	1
HOP004_libmerged	2319542	2319550		YPO_RS11225	8
HOP004_libmerged	2375660	2375661		YPO_RS11510	1
HOP004_libmerged	2376965	2376968		YPO_RS11520	3
HOP004_libmerged	2442370	2442375		purU	5
HOP004_libmerged	2473579	2473581		YPO_RS11990	2
HOP004_libmerged	2475853	2475862		YPO_RS12005	9
HOP004_libmerged	2491188	2491239		topA	51
HOP004_libmerged	2541363	2541366		YPO_RS12300	3
HOP004_libmerged	2554373	2554633		YPO_RS12355	260
HOP004_libmerged	2554658	2555065		YPO_RS12360	407
HOP004_libmerged	2555162	2555608		YPO_RS12365	446
HOP004_libmerged	2555780	2556832		YPO_RS12370	1052
HOP004_libmerged	2556844	2557161		YPO_RS12375	317
HOP004_libmerged	2557164	2557415		YPO_RS12380	251
HOP004_libmerged	2557451	2557684		YPO_RS12385	233
HOP004_libmerged	2557749	2559461		YPO_RS12390	1712
HOP004_libmerged	2559474	2559761		YPO_RS12395	287
HOP004_libmerged	2559765	2560790		YPO_RS12400	1025
HOP004_libmerged	2560790	2562034		YPO_RS12405	1244
HOP004_libmerged	2562123	2562371		YPO_RS12410	248
HOP004_libmerged	2562568	2562765		YPO_RS12415	197
HOP004_libmerged	2565814	2565864		YPO_RS12435	50
HOP004_libmerged	2606379	2606396		asr	17
HOP004_libmerged	2814124	2814125		YPO_RS13510	1
HOP004_libmerged	2885774	2885777		YPO_RS13815	3
HOP004_libmerged	2887085	2887932		YPO_RS13825	847
HOP004_libmerged	2887989	2893967		YPO_RS13830	5978
HOP004_libmerged	2894374	2894922		YPO_RS13835	548
HOP004_libmerged	2895617	2896471		YPO_RS13840	854
HOP004_libmerged	2896777	2897241		YPO_RS13845	464
HOP004_libmerged	2897287	2898094		YPO_RS13845	807
HOP004_libmerged	2898129	2898303		YPO_RS13845	174
HOP004_libmerged	2898338	2900263		iolD	1925
HOP004_libmerged	2910281	2910290		iolB	9
HOP004_libmerged	2980442	2980551		YPO_RS14235	109
HOP004_libmerged	3012186	3012220		YPO_RS14405	34
HOP004_libmerged	3021131	3021142		YPO_RS14440	11
HOP004_libmerged	3037255	3037264		YPO_RS14530	9
HOP004_libmerged	3120316	3120561		YPO_RS14920	245
HOP004_libmerged	3121234	3121815		YPO_RS14925	581
HOP004_libmerged	3122083	3122484		YPO_RS14930	401
HOP004_libmerged	3122717	3123118		YPO_RS14935	401
HOP004_libmerged	3123130	3123702		YPO_RS14940	572
HOP004_libmerged	3123726	3123977		YPO_RS14945	251
HOP004_libmerged	3124016	3124255		YPO_RS14950	239
HOP004_libmerged	3125064	3126980		yapC	1916
HOP004_libmerged	3127174	3127226		YPO_RS14960	52
HOP004_libmerged	3127515	3128096		YPO_RS14965	581
HOP004_libmerged	3130158	3132365		YPO_RS14980	2207
HOP004_libmerged	3132358	3132888		YPO_RS14985	530
HOP004_libmerged	3133047	3135428		YPO_RS14990	2381
HOP004_libmerged	3135507	3137135		YPO_RS14995	1628
HOP004_libmerged	3137608	3138459		YPO_RS15000	851
HOP004_libmerged	3138485	3139474		YPO_RS15005	989
HOP004_libmerged	3139529	3140422		YPO_RS15010	893
HOP004_libmerged	3142684	3142989		YPO_RS15025	305
HOP004_libmerged	3143086	3143487		YPO_RS15030	401
HOP004_libmerged	3143469	3144177		YPO_RS15035	708
HOP004_libmerged	3145847	3145854		YPO_RS15040	7
HOP004_libmerged	3151681	3151683		YPO_RS15090	2
HOP004_libmerged	3197842	3197859		YPO_RS15265	17
HOP004_libmerged	3198226	3198235		YPO_RS15270	9
HOP004_libmerged	3200399	3200419		YPO_RS15285	20
HOP004_libmerged	3200571	3200587		YPO_RS15285	16
HOP004_libmerged	3200699	3200744		YPO_RS15290	45
HOP004_libmerged	3200830	3200909		YPO_RS15290	79
HOP004_libmerged	3201495	3201503		YPO_RS15295	8
HOP004_libmerged	3201637	3201680		YPO_RS15300	43
HOP004_libmerged	3221796	3221859		YPO_RS15385	63
HOP004_libmerged	3225495	3225532		yapA	37
HOP004_libmerged	3225584	3225617		yapA	33
HOP004_libmerged	3262711	3262720		YPO_RS15560	9
HOP004_libmerged	3285808	3285812		YPO_RS15675	4
HOP004_libmerged	3302802	3302804		YPO_RS15735	2
HOP004_libmerged	3310669	3310670		YPO_RS15765	1
HOP004_libmerged	3345044	3345052		ptsI	8
HOP004_libmerged	3403433	3403438		YPO_RS16210	5
HOP004_libmerged	3461649	3461655		YPO_RS16470	6
HOP004_libmerged	3463732	3463812		YPO_RS16480	80
HOP004_libmerged	3463896	3463948		YPO_RS16480	52
HOP004_libmerged	3464134	3464185		YPO_RS16480	51
HOP004_libmerged	3464843	3464873		YPO_RS16485	30
HOP004_libmerged	3465058	3465090		YPO_RS16485	32
HOP004_libmerged	3465236	3465244		YPO_RS16485	8
HOP004_libmerged	3465318	3465332		YPO_RS16485	14
HOP004_libmerged	3465493	3465555		YPO_RS16485	62
HOP004_libmerged	3466288	3466373		YPO_RS16490	85
HOP004_libmerged	3466583	3466632		YPO_RS16490	49
HOP004_libmerged	3466828	3466831		YPO_RS16490	3
HOP004_libmerged	3466984	3467015		YPO_RS16495	31
HOP004_libmerged	3472586	3472593		YPO_RS16520	7
HOP004_libmerged	3548087	3548134		YPO_RS16865	47
HOP004_libmerged	3592661	3592682		YPO_RS17055	21
HOP004_libmerged	3682476	3682480		YPO_RS17460	4
HOP004_libmerged	4018209	4018221		YPO_RS19000	12
HOP004_libmerged	4018429	4018436		YPO_RS19000	7
HOP004_libmerged	4018553	4018554		YPO_RS19000	1
HOP004_libmerged	4018702	4018743		YPO_RS19000	41
HOP004_libmerged	4018831	4018875		YPO_RS19000	44
HOP004_libmerged	4018950	4018960		YPO_RS19000	10
HOP004_libmerged	4018999	4019049		YPO_RS19000	50
HOP004_libmerged	4019090	4019125		YPO_RS19000	35
HOP004_libmerged	4019298	4019301		YPO_RS19000	3
HOP004_libmerged	4019380	4019784		YPO_RS19000	404
HOP004_libmerged	4019790	4020248		YPO_RS19005	458
HOP004_libmerged	4020241	4023105		YPO_RS19010	2864
HOP004_libmerged	4023133	4024503		YPO_RS19015	1370
HOP004_libmerged	4024505	4024990		YPO_RS19020	485
HOP004_libmerged	4025040	4025231		YPO_RS19025	191
HOP004_libmerged	4025307	4025531		YPO_RS19030	224
HOP004_libmerged	4025613	4026020		YPO_RS19035	407
HOP004_libmerged	4026412	4026416		YPO_RS19045	4
HOP004_libmerged	4026582	4026686		YPO_RS19045	104
HOP004_libmerged	4026778	4026779		YPO_RS19045	1
HOP004_libmerged	4026852	4026858		YPO_RS19045	6
HOP004_libmerged	4026894	4026897		YPO_RS19045	3
HOP004_libmerged	4033597	4033607		YPO_RS19060	10
HOP004_libmerged	4033676	4033707		YPO_RS19060	31
HOP004_libmerged	4098633	4098660		YPO_RS19365	27
HOP004_libmerged	4099418	4099443		YPO_RS19365	25
HOP004_libmerged	4101675	4101703		YPO_RS19370	28
HOP004_libmerged	4112693	4112768		YPO_RS19400	75
HOP004_libmerged	4113888	4113890		YPO_RS19400	2
HOP004_libmerged	4113994	4114024		YPO_RS19405	30
HOP004_libmerged	4142808	4142833		YPO_RS19535	25
HOP004_libmerged	4223144	4223145		YPO_RS19870	1
HOP004_libmerged	4359333	4359370		YPO_RS20515	37
HOP004_libmerged	4360242	4360262		YPO_RS20525	20
HOP004_libmerged	4388486	4388487		YPO_RS20670	1
HOP004_libmerged	4389733	4389737		YPO_RS20670	4
HOP004_libmerged	4406345	4406348		YPO_RS20745	3
HOP004_libmerged	4408300	4408319		YPO_RS20745	19
HOP004_libmerged	4484185	4484209		YPO_RS21025	24
HOP004_libmerged	4484584	4484598		YPO_RS21025	14
HOP004_libmerged	4534849	4534876		YPO_RS21210	27
HOP004_libmerged	4545702	4545709		YPO_RS21280	7
HOP004_libmerged	4567735	4567764		YPO_RS21370	29
HOP004_libmerged	4601695	4601733		YPO_RS21520	38
HOP004_libmerged	4626285	4626298		YPO_RS21630	13
KLE031.A0101_rmdup	922	929		asnC	7
KLE031.A0101_rmdup	4038	4088		ravA	50
KLE031.A0101_rmdup	10232	10237		YPO_RS01055	5
KLE031.A0101_rmdup	14919	14920		YPO_RS01080	1
KLE031.A0101_rmdup	15988	16012		YPO_RS01080	24
KLE031.A0101_rmdup	19080	19085		YPO_RS01090	5
KLE031.A0101_rmdup	22342	22364		dsbA	22
KLE031.A0101_rmdup	23888	23893		polA	5
KLE031.A0101_rmdup	29308	29317		hemN	9
KLE031.A0101_rmdup	44004	44013		YPO_RS01195	9
KLE031.A0101_rmdup	52288	52292		spoT	4
KLE031.A0101_rmdup	53817	53835		ligB	18
KLE031.A0101_rmdup	63079	63095		rpmG	16
KLE031.A0101_rmdup	64843	64864		YPO_RS01310	21
KLE031.A0101_rmdup	71699	71702		tdh	3
KLE031.A0101_rmdup	73906	73925		envC	19
KLE031.A0101_rmdup	77639	77646		grxC	7
KLE031.A0101_rmdup	78805	78820		gpsA	15
KLE031.A0101_rmdup	78858	78881		gpsA	23
KLE031.A0101_rmdup	82535	82593		cpxA	58
KLE031.A0101_rmdup	97323	97328		YPO_RS01470	5
KLE031.A0101_rmdup	106581	106588		YPO_RS01520	7
KLE031.A0101_rmdup	108563	108589		YPO_RS01530	26
KLE031.A0101_rmdup	116437	116444		cytR	7
KLE031.A0101_rmdup	127173	127179		YPO_RS01610	6
KLE031.A0101_rmdup	135794	135813		malP	19
KLE031.A0101_rmdup	142440	142448		feoB	8
KLE031.A0101_rmdup	150605	150612		envZ	7
KLE031.A0101_rmdup	151670	151672		pckA	2
KLE031.A0101_rmdup	166151	166159		aroB	8
KLE031.A0101_rmdup	170871	170873		YPO_RS01790	2
KLE031.A0101_rmdup	177048	177062		YPO_RS01815	14
KLE031.A0101_rmdup	180288	180291		tsgA	3
KLE031.A0101_rmdup	196227	196231		YPO_RS01890	4
KLE031.A0101_rmdup	196658	196679		YPO_RS01895	21
KLE031.A0101_rmdup	196791	196806		YPO_RS01895	15
KLE031.A0101_rmdup	199003	199020		YPO_RS01910	17
KLE031.A0101_rmdup	201794	201801		tauB	7
KLE031.A0101_rmdup	226247	226249		rpmC	2
KLE031.A0101_rmdup	236799	236822		mscL	23
KLE031.A0101_rmdup	239852	239855		rsmB	3
KLE031.A0101_rmdup	249466	249468		actP	2
KLE031.A0101_rmdup	249529	249540		actP	11
KLE031.A0101_rmdup	255183	255186		YPO_RS02280	3
KLE031.A0101_rmdup	258201	258210		YPO_RS02285	9
KLE031.A0101_rmdup	258368	258414		YPO_RS02285	46
KLE031.A0101_rmdup	258747	258790		YPO_RS02290	43
KLE031.A0101_rmdup	264935	264938		sctL	3
KLE031.A0101_rmdup	265940	265948		YPO_RS02340	8
KLE031.A0101_rmdup	268555	268566		YPO_RS02345	11
KLE031.A0101_rmdup	275511	275542		YPO_RS02395	31
KLE031.A0101_rmdup	275956	275977		YPO_RS02395	21
KLE031.A0101_rmdup	276365	276381		YPO_RS02395	16
KLE031.A0101_rmdup	288882	288946		YPO_RS02455	64
KLE031.A0101_rmdup	289431	289439		YPO_RS02460	8
KLE031.A0101_rmdup	307326	307332		YPO_RS02550	6
KLE031.A0101_rmdup	312947	312982		yapK	35
KLE031.A0101_rmdup	315029	315069		yapK	40
KLE031.A0101_rmdup	320865	320885		plsB	20
KLE031.A0101_rmdup	321761	321763		lexA	2
KLE031.A0101_rmdup	335053	335102		ssb1	49
KLE031.A0101_rmdup	345930	345956		YPO_RS02695	26
KLE031.A0101_rmdup	346031	346080		YPO_RS02695	49
KLE031.A0101_rmdup	346677	346695		YPO_RS02695	18
KLE031.A0101_rmdup	347054	347098		YPO_RS02695	44
KLE031.A0101_rmdup	347177	347192		YPO_RS02695	15
KLE031.A0101_rmdup	347248	347276		YPO_RS02695	28
KLE031.A0101_rmdup	347400	347402		YPO_RS02695	2
KLE031.A0101_rmdup	347645	347680		YPO_RS02695	35
KLE031.A0101_rmdup	347962	348010		YPO_RS02695	48
KLE031.A0101_rmdup	360473	360484		fxsA	11
KLE031.A0101_rmdup	360981	360988		fxsA	7
KLE031.A0101_rmdup	371059	371076		YPO_RS02805	17
KLE031.A0101_rmdup	373595	373615		mscM	20
KLE031.A0101_rmdup	394703	394706		nsrR	3
KLE031.A0101_rmdup	407780	407812		YPO_RS02955	32
KLE031.A0101_rmdup	407864	407867		YPO_RS02955	3
KLE031.A0101_rmdup	408020	408071		YPO_RS02955	51
KLE031.A0101_rmdup	408170	408220		YPO_RS02955	50
KLE031.A0101_rmdup	408279	408336		YPO_RS02955	57
KLE031.A0101_rmdup	408474	408504		YPO_RS02955	30
KLE031.A0101_rmdup	408643	408677		YPO_RS02955	34
KLE031.A0101_rmdup	408754	408774		YPO_RS02955	20
KLE031.A0101_rmdup	409193	409250		YPO_RS02960	57
KLE031.A0101_rmdup	409410	409546		YPO_RS02960	136
KLE031.A0101_rmdup	409854	409898		YPO_RS02965	44
KLE031.A0101_rmdup	410385	410388		YPO_RS02965	3
KLE031.A0101_rmdup	410561	410584		YPO_RS02965	23
KLE031.A0101_rmdup	410832	410891		YPO_RS02965	59
KLE031.A0101_rmdup	409518	409754		YPO_RS02965	236
KLE031.A0101_rmdup	413277	413293		YPO_RS02980	16
KLE031.A0101_rmdup	415842	415871		YPO_RS02990	29
KLE031.A0101_rmdup	416654	416658		YPO_RS02995	4
KLE031.A0101_rmdup	417003	417005		YPO_RS02995	2
KLE031.A0101_rmdup	418584	418586		YPO_RS03005	2
KLE031.A0101_rmdup	422302	422326		ptsP	24
KLE031.A0101_rmdup	425536	425564		lsrF	28
KLE031.A0101_rmdup	426089	426097		lsrF	8
KLE031.A0101_rmdup	431280	431340		YPO_RS03065	60
KLE031.A0101_rmdup	432799	432801		lsrK	2
KLE031.A0101_rmdup	446221	446264		YPO_RS03120	43
KLE031.A0101_rmdup	452233	452245		osmY	12
KLE031.A0101_rmdup	453368	453386		YPO_RS03165	18
KLE031.A0101_rmdup	460114	460117		deoB	3
KLE031.A0101_rmdup	475414	475416		YPO_RS03245	2
KLE031.A0101_rmdup	493427	493428		YPO_RS03325	1
KLE031.A0101_rmdup	494209	494223		YPO_RS03330	14
KLE031.A0101_rmdup	494465	494483		YPO_RS03330	18
KLE031.A0101_rmdup	495004	495048		YPO_RS03330	44
KLE031.A0101_rmdup	495121	495172		YPO_RS03330	51
KLE031.A0101_rmdup	495229	495308		YPO_RS03330	79
KLE031.A0101_rmdup	495384	495430		YPO_RS03330	46
KLE031.A0101_rmdup	495521	495556		YPO_RS03330	35
KLE031.A0101_rmdup	495721	495799		YPO_RS03330	78
KLE031.A0101_rmdup	501054	501066		nhaA	12
KLE031.A0101_rmdup	507522	507524		ileS	2
KLE031.A0101_rmdup	520847	520857		YPO_RS03445	10
KLE031.A0101_rmdup	521134	521158		YPO_RS03450	24
KLE031.A0101_rmdup	521340	521367		YPO_RS03450	27
KLE031.A0101_rmdup	526468	526499		lptD	31
KLE031.A0101_rmdup	526782	526783		lptD	1
KLE031.A0101_rmdup	535213	535219		tssC	6
KLE031.A0101_rmdup	540251	540254		tssH	3
KLE031.A0101_rmdup	540863	540881		tssH	18
KLE031.A0101_rmdup	549444	549496		tssJ	52
KLE031.A0101_rmdup	552884	552888		tssM	4
KLE031.A0101_rmdup	552919	552926		tssM	7
KLE031.A0101_rmdup	562652	562682		YPO_RS03600	30
KLE031.A0101_rmdup	563767	563773		thiQ	6
KLE031.A0101_rmdup	564002	564030		thiQ	28
KLE031.A0101_rmdup	579386	579398		YPO_RS03675	12
KLE031.A0101_rmdup	579533	579586		YPO_RS03675	53
KLE031.A0101_rmdup	583166	583168		YPO_RS03685	2
KLE031.A0101_rmdup	592188	592190		YPO_RS03735	2
KLE031.A0101_rmdup	595315	595359		murF	44
KLE031.A0101_rmdup	595789	595827		murF	38
KLE031.A0101_rmdup	598419	598425		murD	6
KLE031.A0101_rmdup	598945	598947		ftsW	2
KLE031.A0101_rmdup	602532	602548		murC	16
KLE031.A0101_rmdup	611741	611742		secA	1
KLE031.A0101_rmdup	621737	621742		YPO_RS03880	5
KLE031.A0101_rmdup	635181	635182		yapG	1
KLE031.A0101_rmdup	635501	635516		yapG	15
KLE031.A0101_rmdup	651953	651955		cdiA	2
KLE031.A0101_rmdup	652047	652060		cdiA	13
KLE031.A0101_rmdup	652453	652459		cdiA	6
KLE031.A0101_rmdup	653735	653750		cdiA	15
KLE031.A0101_rmdup	656946	656953		cdiA	7
KLE031.A0101_rmdup	659294	659410		cdiI	116
KLE031.A0101_rmdup	660126	660145		YPO_RS04005	19
KLE031.A0101_rmdup	664981	664983		YPO_RS04025	2
KLE031.A0101_rmdup	667962	667987		YPO_RS04035	25
KLE031.A0101_rmdup	673944	673985		YPO_RS04055	41
KLE031.A0101_rmdup	677274	677278		YPO_RS04070	4
KLE031.A0101_rmdup	684418	684471		YPO_RS04100	53
KLE031.A0101_rmdup	687065	687132		YPO_RS04110	67
KLE031.A0101_rmdup	687300	687301		YPO_RS04110	1
KLE031.A0101_rmdup	687952	687974		YPO_RS04115	22
KLE031.A0101_rmdup	704994	705008		plsY	14
KLE031.A0101_rmdup	730280	730285		YPO_RS04320	5
KLE031.A0101_rmdup	731945	731963		parC	18
KLE031.A0101_rmdup	739342	739351		YPO_RS04355	9
KLE031.A0101_rmdup	743684	743693		metC	9
KLE031.A0101_rmdup	744835	744848		exbB	13
KLE031.A0101_rmdup	746453	746473		YPO_RS04390	20
KLE031.A0101_rmdup	747782	747793		YPO_RS04390	11
KLE031.A0101_rmdup	749072	749074		YPO_RS04405	2
KLE031.A0101_rmdup	749341	749387		YPO_RS04405	46
KLE031.A0101_rmdup	749624	749645		YPO_RS04405	21
KLE031.A0101_rmdup	749629	749651		YPO_RS04410	22
KLE031.A0101_rmdup	750089	750097		YPO_RS04410	8
KLE031.A0101_rmdup	750212	750271		YPO_RS04410	59
KLE031.A0101_rmdup	750428	750462		YPO_RS04410	34
KLE031.A0101_rmdup	750459	750535		YPO_RS04415	76
KLE031.A0101_rmdup	750983	751046		YPO_RS04415	63
KLE031.A0101_rmdup	751119	751206		YPO_RS04415	87
KLE031.A0101_rmdup	752640	752675		YPO_RS04425	35
KLE031.A0101_rmdup	753518	753540		YPO_RS04425	22
KLE031.A0101_rmdup	753732	753756		YPO_RS04425	24
KLE031.A0101_rmdup	753767	753800		YPO_RS04430	33
KLE031.A0101_rmdup	753851	753953		YPO_RS04430	102
KLE031.A0101_rmdup	754831	754834		YPO_RS04440	3
KLE031.A0101_rmdup	755288	755371		YPO_RS04440	83
KLE031.A0101_rmdup	755369	755371		YPO_RS04445	2
KLE031.A0101_rmdup	755537	755574		YPO_RS04445	37
KLE031.A0101_rmdup	755725	755776		YPO_RS04445	51
KLE031.A0101_rmdup	756681	756695		YPO_RS04450	14
KLE031.A0101_rmdup	771743	771746		fliP	3
KLE031.A0101_rmdup	772826	772829		YPO_RS04525	3
KLE031.A0101_rmdup	772970	773002		YPO_RS04525	32
KLE031.A0101_rmdup	782912	782916		flgC	4
KLE031.A0101_rmdup	785301	785319		YPO_RS04600	18
KLE031.A0101_rmdup	793869	793936		YPO_RS04655	67
KLE031.A0101_rmdup	796060	796077		YPO_RS04660	17
KLE031.A0101_rmdup	797802	797821		YPO_RS04665	19
KLE031.A0101_rmdup	799215	799222		YPO_RS04670	7
KLE031.A0101_rmdup	801483	801508		fliS	25
KLE031.A0101_rmdup	802551	802650		YPO_RS04690	99
KLE031.A0101_rmdup	806676	806679		YPO_RS04715	3
KLE031.A0101_rmdup	806995	807072		YPO_RS04715	77
KLE031.A0101_rmdup	807641	807690		YPO_RS04720	49
KLE031.A0101_rmdup	809018	809027		YPO_RS04735	9
KLE031.A0101_rmdup	809175	809226		YPO_RS04735	51
KLE031.A0101_rmdup	815632	815646		YPO_RS04760	14
KLE031.A0101_rmdup	816391	816458		YPO_RS04765	67
KLE031.A0101_rmdup	816704	816737		YPO_RS04765	33
KLE031.A0101_rmdup	834339	834354		YPO_RS04800	15
KLE031.A0101_rmdup	838409	838417		YPO_RS04810	8
KLE031.A0101_rmdup	838867	838896		YPO_RS04815	29
KLE031.A0101_rmdup	839079	839088		YPO_RS04815	9
KLE031.A0101_rmdup	841508	841520		YPO_RS04825	12
KLE031.A0101_rmdup	842066	842092		YPO_RS04830	26
KLE031.A0101_rmdup	844880	844882		YPO_RS04835	2
KLE031.A0101_rmdup	845400	845626		YPO_RS04835	226
KLE031.A0101_rmdup	845909	845917		YPO_RS04835	8
KLE031.A0101_rmdup	846119	846125		YPO_RS04835	6
KLE031.A0101_rmdup	849550	849551		YPO_RS04840	1
KLE031.A0101_rmdup	852513	852518		YPO_RS04845	5
KLE031.A0101_rmdup	867827	867832		YPO_RS04900	5
KLE031.A0101_rmdup	867900	867906		YPO_RS04900	6
KLE031.A0101_rmdup	884205	884206		YPO_RS04965	1
KLE031.A0101_rmdup	884319	884445		YPO_RS04965	126
KLE031.A0101_rmdup	884895	884907		YPO_RS04965	12
KLE031.A0101_rmdup	885657	885715		YPO_RS04975	58
KLE031.A0101_rmdup	886193	886234		YPO_RS04975	41
KLE031.A0101_rmdup	886492	886512		YPO_RS04980	20
KLE031.A0101_rmdup	886573	886802		YPO_RS04980	229
KLE031.A0101_rmdup	886993	887125		gspL	132
KLE031.A0101_rmdup	888100	888219		YPO_RS04990	119
KLE031.A0101_rmdup	888429	888478		YPO_RS04990	49
KLE031.A0101_rmdup	888809	888823		YPO_RS04990	14
KLE031.A0101_rmdup	889276	889445		gspJ	169
KLE031.A0101_rmdup	889518	889537		gspJ	19
KLE031.A0101_rmdup	889989	890043		YPO_RS05005	54
KLE031.A0101_rmdup	890107	890147		YPO_RS05005	40
KLE031.A0101_rmdup	890958	890968		gspG	10
KLE031.A0101_rmdup	893252	893253		gspE	1
KLE031.A0101_rmdup	893764	893823		gspD	59
KLE031.A0101_rmdup	894060	894064		gspD	4
KLE031.A0101_rmdup	894455	894459		gspD	4
KLE031.A0101_rmdup	894835	894864		gspD	29
KLE031.A0101_rmdup	895377	895395		gspD	18
KLE031.A0101_rmdup	895443	895556		gspD	113
KLE031.A0101_rmdup	895600	895606		gspD	6
KLE031.A0101_rmdup	895687	895741		YPO_RS05030	54
KLE031.A0101_rmdup	895932	895937		YPO_RS05030	5
KLE031.A0101_rmdup	896055	896059		YPO_RS05030	4
KLE031.A0101_rmdup	896132	896190		YPO_RS05030	58
KLE031.A0101_rmdup	896258	896345		YPO_RS05035	87
KLE031.A0101_rmdup	896396	896415		YPO_RS05035	19
KLE031.A0101_rmdup	896527	896528		YPO_RS05035	1
KLE031.A0101_rmdup	896631	896674		YPO_RS05035	43
KLE031.A0101_rmdup	897417	897432		YPO_RS05040	15
KLE031.A0101_rmdup	905777	905807		YPO_RS05060	30
KLE031.A0101_rmdup	907998	907999		YPO_RS05070	1
KLE031.A0101_rmdup	910428	910440		YPO_RS05080	12
KLE031.A0101_rmdup	915439	915440		YPO_RS05105	1
KLE031.A0101_rmdup	917609	917622		nagA	13
KLE031.A0101_rmdup	919227	919232		kduD	5
KLE031.A0101_rmdup	920200	920201		YPO_RS05130	1
KLE031.A0101_rmdup	935741	935744		YPO_RS05185	3
KLE031.A0101_rmdup	937519	937520		YPO_RS05190	1
KLE031.A0101_rmdup	943003	943006		YPO_RS05210	3
KLE031.A0101_rmdup	946958	946963		YPO_RS05225	5
KLE031.A0101_rmdup	949877	949881		YPO_RS05235	4
KLE031.A0101_rmdup	950101	950193		YPO_RS05235	92
KLE031.A0101_rmdup	950323	950326		YPO_RS05235	3
KLE031.A0101_rmdup	952990	952996		YPO_RS05250	6
KLE031.A0101_rmdup	953671	953757		YPO_RS05260	86
KLE031.A0101_rmdup	954126	954145		YPO_RS05260	19
KLE031.A0101_rmdup	957900	957908		YPO_RS05270	8
KLE031.A0101_rmdup	958364	958372		YPO_RS05275	8
KLE031.A0101_rmdup	962608	962610		YPO_RS05295	2
KLE031.A0101_rmdup	963374	963379		YPO_RS05305	5
KLE031.A0101_rmdup	972418	972423		lysS	5
KLE031.A0101_rmdup	976915	976930		dsbC	15
KLE031.A0101_rmdup	977723	977725		xerD	2
KLE031.A0101_rmdup	980577	980591		creC	14
KLE031.A0101_rmdup	981390	981399		creC	9
KLE031.A0101_rmdup	993939	993957		gcvP	18
KLE031.A0101_rmdup	997726	997736		ubiI	10
KLE031.A0101_rmdup	1005858	1005860		YPO_RS05520	2
KLE031.A0101_rmdup	1007799	1007800		argO	1
KLE031.A0101_rmdup	1018877	1018886		YPO_RS05575	9
KLE031.A0101_rmdup	1020698	1020701		speA	3
KLE031.A0101_rmdup	1025338	1025339		YPO_RS05600	1
KLE031.A0101_rmdup	1032873	1032878		YPO_RS05645	5
KLE031.A0101_rmdup	1038767	1038777		YPO_RS05675	10
KLE031.A0101_rmdup	1039217	1039232		YPO_RS05675	15
KLE031.A0101_rmdup	1040989	1041007		YPO_RS05675	18
KLE031.A0101_rmdup	1042843	1042851		YPO_RS05675	8
KLE031.A0101_rmdup	1043123	1043142		YPO_RS05675	19
KLE031.A0101_rmdup	1043773	1043798		YPO_RS05675	25
KLE031.A0101_rmdup	1043860	1043886		YPO_RS05675	26
KLE031.A0101_rmdup	1043944	1043975		YPO_RS05675	31
KLE031.A0101_rmdup	1044309	1044315		YPO_RS05675	6
KLE031.A0101_rmdup	1044410	1044534		YPO_RS05675	124
KLE031.A0101_rmdup	1044728	1044873		YPO_RS05675	145
KLE031.A0101_rmdup	1045006	1045119		YPO_RS05675	113
KLE031.A0101_rmdup	1045193	1045217		YPO_RS05675	24
KLE031.A0101_rmdup	1045288	1045300		YPO_RS05675	12
KLE031.A0101_rmdup	1045533	1045573		YPO_RS05675	40
KLE031.A0101_rmdup	1045627	1045641		YPO_RS05675	14
KLE031.A0101_rmdup	1046476	1046492		YPO_RS05675	16
KLE031.A0101_rmdup	1046671	1046680		YPO_RS05675	9
KLE031.A0101_rmdup	1053165	1053195		mltC	30
KLE031.A0101_rmdup	1054500	1054504		YPO_RS05715	4
KLE031.A0101_rmdup	1065829	1065830		YPO_RS05760	1
KLE031.A0101_rmdup	1066880	1066883		YPO_RS05765	3
KLE031.A0101_rmdup	1066977	1066979		YPO_RS05765	2
KLE031.A0101_rmdup	1067306	1067380		YPO_RS05765	74
KLE031.A0101_rmdup	1067376	1067380		YPO_RS05770	4
KLE031.A0101_rmdup	1068142	1068187		YPO_RS05770	45
KLE031.A0101_rmdup	1069671	1069673		YPO_RS05770	2
KLE031.A0101_rmdup	1071654	1071682		YPO_RS05785	28
KLE031.A0101_rmdup	1071929	1071944		YPO_RS05790	15
KLE031.A0101_rmdup	1073121	1073156		YPO_RS05795	35
KLE031.A0101_rmdup	1075544	1075553		YPO_RS05800	9
KLE031.A0101_rmdup	1081014	1081028		YPO_RS05815	14
KLE031.A0101_rmdup	1085035	1085037		tssC	2
KLE031.A0101_rmdup	1085657	1085666		tssC	9
KLE031.A0101_rmdup	1089066	1089082		YPO_RS05845	16
KLE031.A0101_rmdup	1094189	1094203		YPO_RS05865	14
KLE031.A0101_rmdup	1095855	1095885		YPO_RS05870	30
KLE031.A0101_rmdup	1096805	1096809		YPO_RS05880	4
KLE031.A0101_rmdup	1108788	1108812		YPO_RS05915	24
KLE031.A0101_rmdup	1109070	1109074		YPO_RS05920	4
KLE031.A0101_rmdup	1112249	1112253		YPO_RS05930	4
KLE031.A0101_rmdup	1116817	1116826		YPO_RS05940	9
KLE031.A0101_rmdup	1116947	1117108		YPO_RS05940	161
KLE031.A0101_rmdup	1117257	1117286		YPO_RS05940	29
KLE031.A0101_rmdup	1117717	1117725		YPO_RS05940	8
KLE031.A0101_rmdup	1118021	1118027		YPO_RS05940	6
KLE031.A0101_rmdup	1118073	1118110		YPO_RS05940	37
KLE031.A0101_rmdup	1118909	1118924		YPO_RS05945	15
KLE031.A0101_rmdup	1121137	1121176		yapH	39
KLE031.A0101_rmdup	1123964	1123969		yapH	5
KLE031.A0101_rmdup	1124066	1124106		yapH	40
KLE031.A0101_rmdup	1124141	1124226		yapH	85
KLE031.A0101_rmdup	1124279	1124295		yapH	16
KLE031.A0101_rmdup	1124380	1124397		yapH	17
KLE031.A0101_rmdup	1124435	1124441		yapH	6
KLE031.A0101_rmdup	1124477	1124493		yapH	16
KLE031.A0101_rmdup	1124531	1124541		yapH	10
KLE031.A0101_rmdup	1124609	1124615		yapH	6
KLE031.A0101_rmdup	1124692	1124874		yapH	182
KLE031.A0101_rmdup	1124928	1124937		yapH	9
KLE031.A0101_rmdup	1124992	1125006		yapH	14
KLE031.A0101_rmdup	1125119	1125259		yapH	140
KLE031.A0101_rmdup	1125303	1125394		yapH	91
KLE031.A0101_rmdup	1125442	1125469		yapH	27
KLE031.A0101_rmdup	1125542	1125624		yapH	82
KLE031.A0101_rmdup	1125672	1125677		yapH	5
KLE031.A0101_rmdup	1127730	1127732		yapH	2
KLE031.A0101_rmdup	1130928	1130929		yapH	1
KLE031.A0101_rmdup	1131526	1131534		YPO_RS05955	8
KLE031.A0101_rmdup	1133538	1133546		YPO_RS05965	8
KLE031.A0101_rmdup	1133898	1133916		YPO_RS05965	18
KLE031.A0101_rmdup	1134099	1134101		YPO_RS05965	2
KLE031.A0101_rmdup	1134595	1134603		YPO_RS05970	8
KLE031.A0101_rmdup	1135002	1135003		YPO_RS05970	1
KLE031.A0101_rmdup	1135682	1135695		YPO_RS05970	13
KLE031.A0101_rmdup	1135761	1135777		YPO_RS05970	16
KLE031.A0101_rmdup	1136124	1136127		YPO_RS05970	3
KLE031.A0101_rmdup	1137301	1137318		YPO_RS05975	17
KLE031.A0101_rmdup	1140365	1140391		YPO_RS05985	26
KLE031.A0101_rmdup	1140739	1140755		YPO_RS05985	16
KLE031.A0101_rmdup	1140867	1140876		YPO_RS05985	9
KLE031.A0101_rmdup	1141665	1141713		YPO_RS05985	48
KLE031.A0101_rmdup	1142082	1142088		YPO_RS05985	6
KLE031.A0101_rmdup	1142223	1142231		YPO_RS05985	8
KLE031.A0101_rmdup	1150308	1150314		recC	6
KLE031.A0101_rmdup	1154259	1154261		ptrA	2
KLE031.A0101_rmdup	1156532	1156541		recB	9
KLE031.A0101_rmdup	1198464	1198465		lpxA	1
KLE031.A0101_rmdup	1214686	1214689		metI	3
KLE031.A0101_rmdup	1214956	1214965		metI	9
KLE031.A0101_rmdup	1220106	1220121		YPO_RS06340	15
KLE031.A0101_rmdup	1221213	1221227		YPO_RS06340	14
KLE031.A0101_rmdup	1221601	1221609		YPO_RS06340	8
KLE031.A0101_rmdup	1223356	1223365		dkgB	9
KLE031.A0101_rmdup	1232281	1232282		YPO_RS06405	1
KLE031.A0101_rmdup	1236398	1236399		YPO_RS06435	1
KLE031.A0101_rmdup	1241046	1241121		YPO_RS06465	75
KLE031.A0101_rmdup	1241535	1241570		YPO_RS06465	35
KLE031.A0101_rmdup	1242010	1242014		YPO_RS06465	4
KLE031.A0101_rmdup	1242369	1242408		YPO_RS06470	39
KLE031.A0101_rmdup	1242476	1242477		YPO_RS06470	1
KLE031.A0101_rmdup	1242565	1242673		YPO_RS06470	108
KLE031.A0101_rmdup	1242951	1242973		YPO_RS06470	22
KLE031.A0101_rmdup	1243181	1243214		YPO_RS06470	33
KLE031.A0101_rmdup	1251892	1251899		YPO_RS06525	7
KLE031.A0101_rmdup	1268776	1268779		tolR	3
KLE031.A0101_rmdup	1269587	1269663		tolA	76
KLE031.A0101_rmdup	1271111	1271120		tolB	9
KLE031.A0101_rmdup	1286097	1286136		galE	39
KLE031.A0101_rmdup	1294009	1294020		YPO_RS06745	11
KLE031.A0101_rmdup	1295727	1295732		bioA	5
KLE031.A0101_rmdup	1298627	1298635		bioF	8
KLE031.A0101_rmdup	1311992	1311997		betA	5
KLE031.A0101_rmdup	1315930	1315935		YPO_RS06845	5
KLE031.A0101_rmdup	1317768	1317770		YPO_RS06850	2
KLE031.A0101_rmdup	1319480	1319486		xapA	6
KLE031.A0101_rmdup	1322223	1322320		YPO_RS06875	97
KLE031.A0101_rmdup	1322386	1322438		YPO_RS06875	52
KLE031.A0101_rmdup	1322730	1322736		YPO_RS06875	6
KLE031.A0101_rmdup	1322964	1322972		YPO_RS06875	8
KLE031.A0101_rmdup	1329947	1329976		YPO_RS06910	29
KLE031.A0101_rmdup	1331251	1331255		phnC	4
KLE031.A0101_rmdup	1338604	1338611		urtB	7
KLE031.A0101_rmdup	1339459	1339461		urtC	2
KLE031.A0101_rmdup	1368607	1368608		nrdA	1
KLE031.A0101_rmdup	1379091	1379118		rcsD	27
KLE031.A0101_rmdup	1385427	1385452		ampH	25
KLE031.A0101_rmdup	1397643	1397644		YPO_RS07190	1
KLE031.A0101_rmdup	1398190	1398191		YPO_RS07190	1
KLE031.A0101_rmdup	1400691	1400693		YPO_RS07210	2
KLE031.A0101_rmdup	1404948	1404950		YPO_RS07230	2
KLE031.A0101_rmdup	1405581	1405611		YPO_RS07235	30
KLE031.A0101_rmdup	1407459	1407474		YPO_RS07245	15
KLE031.A0101_rmdup	1410528	1410534		YPO_RS07270	6
KLE031.A0101_rmdup	1410886	1410916		YPO_RS07270	30
KLE031.A0101_rmdup	1413172	1413198		YPO_RS07280	26
KLE031.A0101_rmdup	1414921	1414923		YPO_RS07290	2
KLE031.A0101_rmdup	1415250	1415271		YPO_RS07290	21
KLE031.A0101_rmdup	1421066	1421069		rplY	3
KLE031.A0101_rmdup	1421405	1421410		YPO_RS07330	5
KLE031.A0101_rmdup	1424500	1424514		YPO_RS07340	14
KLE031.A0101_rmdup	1430152	1430160		YPO_RS07360	8
KLE031.A0101_rmdup	1431819	1431827		YPO_RS07365	8
KLE031.A0101_rmdup	1433952	1433959		YPO_RS07370	7
KLE031.A0101_rmdup	1445556	1445559		YPO_RS07420	3
KLE031.A0101_rmdup	1445997	1446011		YPO_RS07425	14
KLE031.A0101_rmdup	1447876	1447881		YPO_RS07430	5
KLE031.A0101_rmdup	1449275	1449290		YPO_RS07435	15
KLE031.A0101_rmdup	1449535	1449544		YPO_RS07435	9
KLE031.A0101_rmdup	1454027	1454056		YPO_RS07455	29
KLE031.A0101_rmdup	1461395	1461402		YPO_RS07485	7
KLE031.A0101_rmdup	1461789	1461819		YPO_RS07490	30
KLE031.A0101_rmdup	1462101	1462106		YPO_RS07490	5
KLE031.A0101_rmdup	1463106	1463165		psaA	59
KLE031.A0101_rmdup	1463379	1463429		YPO_RS07500	50
KLE031.A0101_rmdup	1476995	1477016		YPO_RS07545	21
KLE031.A0101_rmdup	1489973	1489997		YPO_RS07595	24
KLE031.A0101_rmdup	1499911	1499920		potI	9
KLE031.A0101_rmdup	1501689	1501690		rlmC	1
KLE031.A0101_rmdup	1505620	1505634		YPO_RS07680	14
KLE031.A0101_rmdup	1514452	1514480		artQ	28
KLE031.A0101_rmdup	1517039	1517041		YPO_RS07755	2
KLE031.A0101_rmdup	1539720	1539759		aat	39
KLE031.A0101_rmdup	1548420	1548423		YPO_RS07870	3
KLE031.A0101_rmdup	1563862	1563868		ansB	6
KLE031.A0101_rmdup	1564313	1564315		ansB	2
KLE031.A0101_rmdup	1565872	1565929		YPO_RS07925	57
KLE031.A0101_rmdup	1566020	1566021		YPO_RS07925	1
KLE031.A0101_rmdup	1566337	1566349		YPO_RS07930	12
KLE031.A0101_rmdup	1566683	1566722		YPO_RS07930	39
KLE031.A0101_rmdup	1567522	1567558		YPO_RS07930	36
KLE031.A0101_rmdup	1567630	1567796		YPO_RS07930	166
KLE031.A0101_rmdup	1567856	1567860		YPO_RS07930	4
KLE031.A0101_rmdup	1578515	1578517		msbA	2
KLE031.A0101_rmdup	1580766	1580770		YPO_RS07975	4
KLE031.A0101_rmdup	1580944	1580971		YPO_RS07975	27
KLE031.A0101_rmdup	1595234	1595241		ldtD	7
KLE031.A0101_rmdup	1595720	1595772		ldtD	52
KLE031.A0101_rmdup	1599270	1599274		ompF	4
KLE031.A0101_rmdup	1625492	1625501		YPO_RS08150	9
KLE031.A0101_rmdup	1632375	1632455		YPO_RS08185	80
KLE031.A0101_rmdup	1634403	1634417		helD	14
KLE031.A0101_rmdup	1647598	1647715		YPO_RS08260	117
KLE031.A0101_rmdup	1650907	1650915		YPO_RS08275	8
KLE031.A0101_rmdup	1652057	1652100		YPO_RS08280	43
KLE031.A0101_rmdup	1652102	1652140		YPO_RS08285	38
KLE031.A0101_rmdup	1652427	1652430		YPO_RS08285	3
KLE031.A0101_rmdup	1655388	1655391		YPO_RS08305	3
KLE031.A0101_rmdup	1658263	1658269		tssC	6
KLE031.A0101_rmdup	1659302	1659314		tssK	12
KLE031.A0101_rmdup	1661195	1661223		YPO_RS08330	28
KLE031.A0101_rmdup	1661371	1661394		YPO_RS08330	23
KLE031.A0101_rmdup	1662129	1662159		YPO_RS08330	30
KLE031.A0101_rmdup	1665334	1665375		tssH	41
KLE031.A0101_rmdup	1666067	1666074		YPO_RS08345	7
KLE031.A0101_rmdup	1666147	1666152		YPO_RS08345	5
KLE031.A0101_rmdup	1667103	1667111		YPO_RS08345	8
KLE031.A0101_rmdup	1668235	1668241		YPO_RS08350	6
KLE031.A0101_rmdup	1670193	1670201		YPO_RS08350	8
KLE031.A0101_rmdup	1670475	1670508		YPO_RS08355	33
KLE031.A0101_rmdup	1670552	1670597		YPO_RS08355	45
KLE031.A0101_rmdup	1670822	1670863		YPO_RS08355	41
KLE031.A0101_rmdup	1670946	1670952		YPO_RS08355	6
KLE031.A0101_rmdup	1673355	1673411		YPO_RS08365	56
KLE031.A0101_rmdup	1673800	1673844		YPO_RS08365	44
KLE031.A0101_rmdup	1674391	1674397		YPO_RS08370	6
KLE031.A0101_rmdup	1680193	1680202		YPO_RS08385	9
KLE031.A0101_rmdup	1682671	1682682		tssA	11
KLE031.A0101_rmdup	1683424	1683459		YPO_RS08395	35
KLE031.A0101_rmdup	1684008	1684025		YPO_RS08395	17
KLE031.A0101_rmdup	1684040	1684183		YPO_RS08400	143
KLE031.A0101_rmdup	1684400	1684495		YPO_RS08400	95
KLE031.A0101_rmdup	1684848	1684858		tssF	10
KLE031.A0101_rmdup	1685197	1685222		tssF	25
KLE031.A0101_rmdup	1686164	1686172		tssF	8
KLE031.A0101_rmdup	1688626	1688662		YPO_RS08425	36
KLE031.A0101_rmdup	1689356	1689392		YPO_RS08425	36
KLE031.A0101_rmdup	1690140	1690151		YPO_RS08430	11
KLE031.A0101_rmdup	1690214	1690255		YPO_RS08430	41
KLE031.A0101_rmdup	1690327	1690390		YPO_RS08430	63
KLE031.A0101_rmdup	1690425	1690436		YPO_RS08430	11
KLE031.A0101_rmdup	1690626	1690673		YPO_RS08430	47
KLE031.A0101_rmdup	1693025	1693041		YPO_RS08435	16
KLE031.A0101_rmdup	1693447	1693452		YPO_RS08440	5
KLE031.A0101_rmdup	1693882	1693922		YPO_RS08440	40
KLE031.A0101_rmdup	1698382	1698388		darE	6
KLE031.A0101_rmdup	1698685	1698690		darE	5
KLE031.A0101_rmdup	1699072	1699094		darE	22
KLE031.A0101_rmdup	1699606	1699610		darD	4
KLE031.A0101_rmdup	1699862	1699868		darD	6
KLE031.A0101_rmdup	1700041	1700046		darC	5
KLE031.A0101_rmdup	1700279	1700390		darC	111
KLE031.A0101_rmdup	1700503	1700528		darC	25
KLE031.A0101_rmdup	1700644	1700667		darC	23
KLE031.A0101_rmdup	1700756	1700759		darC	3
KLE031.A0101_rmdup	1701115	1701143		darC	28
KLE031.A0101_rmdup	1701145	1701152		darB	7
KLE031.A0101_rmdup	1701244	1701259		darB	15
KLE031.A0101_rmdup	1701333	1701386		darB	53
KLE031.A0101_rmdup	1701508	1701522		darB	14
KLE031.A0101_rmdup	1702588	1702605		darB	17
KLE031.A0101_rmdup	1703363	1703390		darB	27
KLE031.A0101_rmdup	1703675	1703685		darA-c	10
KLE031.A0101_rmdup	1704642	1704647		fghA	5
KLE031.A0101_rmdup	1706506	1706507		YPO_RS08495	1
KLE031.A0101_rmdup	1706858	1706866		YPO_RS08495	8
KLE031.A0101_rmdup	1712775	1712796		mglA	21
KLE031.A0101_rmdup	1713950	1713955		mglA	5
KLE031.A0101_rmdup	1714321	1714322		mglC	1
KLE031.A0101_rmdup	1717399	1717425		YPO_RS08535	26
KLE031.A0101_rmdup	1718222	1718253		YPO_RS08535	31
KLE031.A0101_rmdup	1725936	1725960		YPO_RS08570	24
KLE031.A0101_rmdup	1726231	1726308		YPO_RS08570	77
KLE031.A0101_rmdup	1735132	1735152		asmA	20
KLE031.A0101_rmdup	1738562	1738566		fhuF	4
KLE031.A0101_rmdup	1739303	1739390		YPO_RS08625	87
KLE031.A0101_rmdup	1744327	1744333		YPO_RS08640	6
KLE031.A0101_rmdup	1746784	1746794		YPO_RS08655	10
KLE031.A0101_rmdup	1751971	1752022		YPO_RS08670	51
KLE031.A0101_rmdup	1754351	1754352		galU	1
KLE031.A0101_rmdup	1758609	1758638		hisF	29
KLE031.A0101_rmdup	1775716	1775724		YPO_RS08785	8
KLE031.A0101_rmdup	1795916	1795977		YPO_RS08855	61
KLE031.A0101_rmdup	1796033	1796048		YPO_RS08855	15
KLE031.A0101_rmdup	1796131	1796171		YPO_RS08855	40
KLE031.A0101_rmdup	1802711	1802726		YPO_RS08890	15
KLE031.A0101_rmdup	1806058	1806063		YPO_RS08905	5
KLE031.A0101_rmdup	1807000	1807024		YPO_RS08905	24
KLE031.A0101_rmdup	1807771	1807790		YPO_RS08910	19
KLE031.A0101_rmdup	1808311	1808322		bssS	11
KLE031.A0101_rmdup	1820900	1820909		plsX	9
KLE031.A0101_rmdup	1825032	1825034		fabF	2
KLE031.A0101_rmdup	1827114	1827121		pabC	7
KLE031.A0101_rmdup	1830558	1830570		YPO_RS09030	12
KLE031.A0101_rmdup	1839030	1839053		YPO_RS09075	23
KLE031.A0101_rmdup	1839103	1839107		YPO_RS09075	4
KLE031.A0101_rmdup	1842002	1842005		YPO_RS09090	3
KLE031.A0101_rmdup	1842241	1842277		YPO_RS09090	36
KLE031.A0101_rmdup	1843193	1843205		YPO_RS09095	12
KLE031.A0101_rmdup	1843699	1843705		YPO_RS09095	6
KLE031.A0101_rmdup	1868103	1868108		YPO_RS09200	5
KLE031.A0101_rmdup	1878306	1878350		YPO_RS09250	44
KLE031.A0101_rmdup	1883921	1883928		cspE	7
KLE031.A0101_rmdup	1899959	1899963		YPO_RS09320	4
KLE031.A0101_rmdup	1903586	1903588		yapJ	2
KLE031.A0101_rmdup	1904868	1904871		yapJ	3
KLE031.A0101_rmdup	1905791	1905810		yapJ	19
KLE031.A0101_rmdup	1907155	1907170		YPO_RS09345	15
KLE031.A0101_rmdup	1911061	1911072		YPO_RS09355	11
KLE031.A0101_rmdup	1918291	1918293		YPO_RS09385	2
KLE031.A0101_rmdup	1921274	1921276		YPO_RS09390	2
KLE031.A0101_rmdup	1921516	1921541		YPO_RS09390	25
KLE031.A0101_rmdup	1932732	1932744		YPO_RS09450	12
KLE031.A0101_rmdup	1933832	1933857		YPO_RS09455	25
KLE031.A0101_rmdup	1934336	1934351		YPO_RS09455	15
KLE031.A0101_rmdup	1940607	1940637		YPO_RS09480	30
KLE031.A0101_rmdup	1967672	1967717		YPO_RS09585	45
KLE031.A0101_rmdup	1973370	1973392		YPO_RS09610	22
KLE031.A0101_rmdup	1976755	1976760		YPO_RS09630	5
KLE031.A0101_rmdup	1992273	1992278		YPO_RS09730	5
KLE031.A0101_rmdup	1996044	1996049		YPO_RS09745	5
KLE031.A0101_rmdup	1999863	1999874		mntP	11
KLE031.A0101_rmdup	2000335	2000378		YPO_RS09760	43
KLE031.A0101_rmdup	2012189	2012209		hpaI	20
KLE031.A0101_rmdup	2012952	2012958		hpaX	6
KLE031.A0101_rmdup	2013350	2013354		hpaX	4
KLE031.A0101_rmdup	2015854	2015864		hpaC	10
KLE031.A0101_rmdup	2019325	2019330		pabB	5
KLE031.A0101_rmdup	2032315	2032338		YPO_RS09915	23
KLE031.A0101_rmdup	2033184	2033248		YPO_RS09920	64
KLE031.A0101_rmdup	2036232	2036237		flhA	5
KLE031.A0101_rmdup	2037393	2037429		flhA	36
KLE031.A0101_rmdup	2037941	2037976		YPO_RS09940	35
KLE031.A0101_rmdup	2050023	2050030		YPO_RS10010	7
KLE031.A0101_rmdup	2050253	2050260		YPO_RS10010	7
KLE031.A0101_rmdup	2060601	2060622		YPO_RS10045	21
KLE031.A0101_rmdup	2062930	2062934		YPO_RS10055	4
KLE031.A0101_rmdup	2067281	2067285		fliP	4
KLE031.A0101_rmdup	2067964	2067973		fliO	9
KLE031.A0101_rmdup	2070377	2070482		YPO_RS10110	105
KLE031.A0101_rmdup	2072538	2072542		fliI	4
KLE031.A0101_rmdup	2072849	2072854		fliI	5
KLE031.A0101_rmdup	2073605	2073608		fliI	3
KLE031.A0101_rmdup	2080251	2080256		YPO_RS10165	5
KLE031.A0101_rmdup	2081670	2081781		YPO_RS10170	111
KLE031.A0101_rmdup	2085721	2085738		fliD	17
KLE031.A0101_rmdup	2087384	2087399		YPO_RS10195	15
KLE031.A0101_rmdup	2090065	2090066		YPO_RS10210	1
KLE031.A0101_rmdup	2090838	2090851		YPO_RS10210	13
KLE031.A0101_rmdup	2109802	2109820		YPO_RS10290	18
KLE031.A0101_rmdup	2110762	2110763		YPO_RS10300	1
KLE031.A0101_rmdup	2112101	2112110		uvrY	9
KLE031.A0101_rmdup	2117239	2117290		YPO_RS10350	51
KLE031.A0101_rmdup	2117604	2117612		YPO_RS10355	8
KLE031.A0101_rmdup	2117753	2117786		YPO_RS10355	33
KLE031.A0101_rmdup	2118003	2118126		hcp	123
KLE031.A0101_rmdup	2118335	2118347		hcp	12
KLE031.A0101_rmdup	2123319	2123327		YPO_RS10405	8
KLE031.A0101_rmdup	2123437	2123470		YPO_RS10405	33
KLE031.A0101_rmdup	2126397	2126407		YPO_RS10415	10
KLE031.A0101_rmdup	2126496	2126544		YPO_RS10415	48
KLE031.A0101_rmdup	2126772	2126795		YPO_RS10420	23
KLE031.A0101_rmdup	2126886	2126919		YPO_RS10420	33
KLE031.A0101_rmdup	2129579	2129583		YPO_RS10435	4
KLE031.A0101_rmdup	2143225	2143226		ybtE	1
KLE031.A0101_rmdup	2144029	2144046		ybtE	17
KLE031.A0101_rmdup	2145536	2145539		ybtU	3
KLE031.A0101_rmdup	2145640	2145646		ybtU	6
KLE031.A0101_rmdup	2147275	2147276		irp1	1
KLE031.A0101_rmdup	2148538	2148544		irp1	6
KLE031.A0101_rmdup	2148588	2148606		irp1	18
KLE031.A0101_rmdup	2148866	2148889		irp1	23
KLE031.A0101_rmdup	2150861	2150884		irp1	23
KLE031.A0101_rmdup	2151331	2151358		irp1	27
KLE031.A0101_rmdup	2152259	2152271		irp1	12
KLE031.A0101_rmdup	2153506	2153515		irp1	9
KLE031.A0101_rmdup	2154311	2154336		irp1	25
KLE031.A0101_rmdup	2154380	2154386		irp1	6
KLE031.A0101_rmdup	2154432	2154448		irp1	16
KLE031.A0101_rmdup	2154547	2154561		irp1	14
KLE031.A0101_rmdup	2156356	2156367		irp2	11
KLE031.A0101_rmdup	2157230	2157232		irp2	2
KLE031.A0101_rmdup	2158228	2158249		irp2	21
KLE031.A0101_rmdup	2159749	2159757		irp2	8
KLE031.A0101_rmdup	2164585	2164636		ybtP	51
KLE031.A0101_rmdup	2165567	2165607		ybtQ	40
KLE031.A0101_rmdup	2165823	2165856		ybtQ	33
KLE031.A0101_rmdup	2165977	2166006		ybtQ	29
KLE031.A0101_rmdup	2166594	2166613		ybtQ	19
KLE031.A0101_rmdup	2167192	2167214		ybtX	22
KLE031.A0101_rmdup	2167684	2167695		ybtX	11
KLE031.A0101_rmdup	2168861	2168871		ybtS	10
KLE031.A0101_rmdup	2171013	2171020		YPO_RS10570	7
KLE031.A0101_rmdup	2176172	2176190		YPO_RS10590	18
KLE031.A0101_rmdup	2177673	2177674		YPO_RS10600	1
KLE031.A0101_rmdup	2183697	2183716		YPO_RS10620	19
KLE031.A0101_rmdup	2187733	2187770		YPO_RS10640	37
KLE031.A0101_rmdup	2198062	2198066		YPO_RS10685	4
KLE031.A0101_rmdup	2198188	2198205		YPO_RS10685	17
KLE031.A0101_rmdup	2207443	2207462		YPO_RS10715	19
KLE031.A0101_rmdup	2213674	2213684		pgaA	10
KLE031.A0101_rmdup	2218038	2218039		YPO_RS10760	1
KLE031.A0101_rmdup	2237356	2237379		YPO_RS10835	23
KLE031.A0101_rmdup	2253741	2253744		YPO_RS10915	3
KLE031.A0101_rmdup	2254953	2254985		YPO_RS10920	32
KLE031.A0101_rmdup	2256119	2256186		YPO_RS10925	67
KLE031.A0101_rmdup	2256516	2256541		YPO_RS10925	25
KLE031.A0101_rmdup	2258495	2258516		YPO_RS10930	21
KLE031.A0101_rmdup	2258636	2258642		YPO_RS10935	6
KLE031.A0101_rmdup	2259760	2259765		YPO_RS10935	5
KLE031.A0101_rmdup	2260035	2260055		YPO_RS10935	20
KLE031.A0101_rmdup	2265711	2265714		YPO_RS10955	3
KLE031.A0101_rmdup	2266425	2266443		YPO_RS10965	18
KLE031.A0101_rmdup	2266738	2266744		YPO_RS10965	6
KLE031.A0101_rmdup	2268842	2268890		YPO_RS10975	48
KLE031.A0101_rmdup	2269863	2269885		YPO_RS10980	22
KLE031.A0101_rmdup	2277260	2277273		YPO_RS11015	13
KLE031.A0101_rmdup	2278401	2278435		YPO_RS11020	34
KLE031.A0101_rmdup	2279223	2279235		YPO_RS11025	12
KLE031.A0101_rmdup	2280572	2280575		YPO_RS11035	3
KLE031.A0101_rmdup	2291005	2291029		prmC	24
KLE031.A0101_rmdup	2299964	2300030		YPO_RS11135	66
KLE031.A0101_rmdup	2303895	2303905		YPO_RS11155	10
KLE031.A0101_rmdup	2306050	2306079		YPO_RS11175	29
KLE031.A0101_rmdup	2306891	2306896		YPO_RS11175	5
KLE031.A0101_rmdup	2316446	2316506		YPO_RS11220	60
KLE031.A0101_rmdup	2316763	2316779		YPO_RS11220	16
KLE031.A0101_rmdup	2318132	2318134		YPO_RS11225	2
KLE031.A0101_rmdup	2318850	2318862		YPO_RS11225	12
KLE031.A0101_rmdup	2318968	2318977		YPO_RS11225	9
KLE031.A0101_rmdup	2319212	2319217		YPO_RS11225	5
KLE031.A0101_rmdup	2319473	2319476		YPO_RS11225	3
KLE031.A0101_rmdup	2319539	2319551		YPO_RS11225	12
KLE031.A0101_rmdup	2319770	2319802		YPO_RS11225	32
KLE031.A0101_rmdup	2320140	2320155		YPO_RS11225	15
KLE031.A0101_rmdup	2320341	2320342		YPO_RS11225	1
KLE031.A0101_rmdup	2320630	2320637		YPO_RS11225	7
KLE031.A0101_rmdup	2321178	2321180		YPO_RS11225	2
KLE031.A0101_rmdup	2321736	2321737		YPO_RS11225	1
KLE031.A0101_rmdup	2322824	2322845		YPO_RS11225	21
KLE031.A0101_rmdup	2331885	2331887		aspS	2
KLE031.A0101_rmdup	2338448	2338459		znuC	11
KLE031.A0101_rmdup	2360934	2360935		YPO_RS11405	1
KLE031.A0101_rmdup	2361373	2361374		YPO_RS11405	1
KLE031.A0101_rmdup	2370713	2370728		YPO_RS11475	15
KLE031.A0101_rmdup	2374913	2374938		YPO_RS11505	25
KLE031.A0101_rmdup	2375656	2375659		YPO_RS11510	3
KLE031.A0101_rmdup	2376928	2376936		YPO_RS11515	8
KLE031.A0101_rmdup	2376941	2376969		YPO_RS11520	28
KLE031.A0101_rmdup	2396248	2396251		YPO_RS11640	3
KLE031.A0101_rmdup	2403285	2403307		YPO_RS11680	22
KLE031.A0101_rmdup	2403779	2403796		YPO_RS11680	17
KLE031.A0101_rmdup	2407310	2407312		YPO_RS11695	2
KLE031.A0101_rmdup	2416704	2416712		YPO_RS11730	8
KLE031.A0101_rmdup	2417482	2417485		YPO_RS11730	3
KLE031.A0101_rmdup	2420956	2420963		YPO_RS11745	7
KLE031.A0101_rmdup	2437357	2437384		YPO_RS11820	27
KLE031.A0101_rmdup	2437883	2437888		xthA	5
KLE031.A0101_rmdup	2438120	2438130		xthA	10
KLE031.A0101_rmdup	2439595	2439602		YPO_RS11830	7
KLE031.A0101_rmdup	2439714	2439817		YPO_RS11830	103
KLE031.A0101_rmdup	2439896	2439931		YPO_RS11830	35
KLE031.A0101_rmdup	2440002	2440010		YPO_RS11830	8
KLE031.A0101_rmdup	2440167	2440259		YPO_RS11830	92
KLE031.A0101_rmdup	2440714	2440721		YPO_RS11840	7
KLE031.A0101_rmdup	2442318	2442339		YPO_RS11850	21
KLE031.A0101_rmdup	2442318	2442373		purU	55
KLE031.A0101_rmdup	2445243	2445285		rssB	42
KLE031.A0101_rmdup	2445712	2445732		rssB	20
KLE031.A0101_rmdup	2454382	2454402		adhE	20
KLE031.A0101_rmdup	2457839	2457856		oppA	17
KLE031.A0101_rmdup	2460834	2460835		oppC	1
KLE031.A0101_rmdup	2462641	2462645		YPO_RS11925	4
KLE031.A0101_rmdup	2463709	2463785		YPO_RS11930	76
KLE031.A0101_rmdup	2465307	2465319		cls	12
KLE031.A0101_rmdup	2468350	2468351		YPO_RS11960	1
KLE031.A0101_rmdup	2470221	2470231		YPO_RS11975	10
KLE031.A0101_rmdup	2470700	2470717		YPO_RS11975	17
KLE031.A0101_rmdup	2475861	2475869		YPO_RS12005	8
KLE031.A0101_rmdup	2478607	2478620		trpB	13
KLE031.A0101_rmdup	2480342	2480345		trpCF	3
KLE031.A0101_rmdup	2482803	2482807		YPO_RS12045	4
KLE031.A0101_rmdup	2487099	2487105		rluB	6
KLE031.A0101_rmdup	2489397	2489433		sohB	36
KLE031.A0101_rmdup	2490228	2490235		sohB	7
KLE031.A0101_rmdup	2490354	2490390		YPO_RS12085	36
KLE031.A0101_rmdup	2491194	2491235		topA	41
KLE031.A0101_rmdup	2495898	2495951		YPO_RS12105	53
KLE031.A0101_rmdup	2497528	2497535		acnA	7
KLE031.A0101_rmdup	2503047	2503070		YPO_RS12135	23
KLE031.A0101_rmdup	2503318	2503319		YPO_RS12135	1
KLE031.A0101_rmdup	2508386	2508400		YPO_RS12175	14
KLE031.A0101_rmdup	2527432	2527439		YPO_RS12245	7
KLE031.A0101_rmdup	2529617	2529640		YPO_RS12255	23
KLE031.A0101_rmdup	2539365	2539374		YPO_RS12290	9
KLE031.A0101_rmdup	2541706	2541719		YPO_RS12300	13
KLE031.A0101_rmdup	2545255	2545272		fumC	17
KLE031.A0101_rmdup	2549448	2549451		YPO_RS12330	3
KLE031.A0101_rmdup	2549512	2549513		YPO_RS12330	1
KLE031.A0101_rmdup	2551171	2551177		YPO_RS12340	6
KLE031.A0101_rmdup	2552152	2552181		bioD	29
KLE031.A0101_rmdup	2554373	2554633		YPO_RS12355	260
KLE031.A0101_rmdup	2554658	2555065		YPO_RS12360	407
KLE031.A0101_rmdup	2555162	2555608		YPO_RS12365	446
KLE031.A0101_rmdup	2555780	2556832		YPO_RS12370	1052
KLE031.A0101_rmdup	2556844	2557161		YPO_RS12375	317
KLE031.A0101_rmdup	2557164	2557415		YPO_RS12380	251
KLE031.A0101_rmdup	2557451	2557684		YPO_RS12385	233
KLE031.A0101_rmdup	2557749	2559461		YPO_RS12390	1712
KLE031.A0101_rmdup	2559474	2559761		YPO_RS12395	287
KLE031.A0101_rmdup	2559765	2560790		YPO_RS12400	1025
KLE031.A0101_rmdup	2560790	2562034		YPO_RS12405	1244
KLE031.A0101_rmdup	2562123	2562371		YPO_RS12410	248
KLE031.A0101_rmdup	2562568	2562765		YPO_RS12415	197
KLE031.A0101_rmdup	2565808	2565842		YPO_RS12435	34
KLE031.A0101_rmdup	2582650	2582651		YPO_RS12495	1
KLE031.A0101_rmdup	2582957	2582967		YPO_RS12495	10
KLE031.A0101_rmdup	2606354	2606412		asr	58
KLE031.A0101_rmdup	2608135	2608136		YPO_RS12600	1
KLE031.A0101_rmdup	2628967	2628968		YPO_RS12675	1
KLE031.A0101_rmdup	2629258	2629263		YPO_RS12675	5
KLE031.A0101_rmdup	2630124	2630131		YPO_RS12680	7
KLE031.A0101_rmdup	2632546	2632558		YPO_RS12690	12
KLE031.A0101_rmdup	2632657	2632663		YPO_RS12690	6
KLE031.A0101_rmdup	2640514	2640527		YPO_RS12725	13
KLE031.A0101_rmdup	2643649	2643659		pspC	10
KLE031.A0101_rmdup	2645917	2645919		pspF	2
KLE031.A0101_rmdup	2668204	2668206		YPO_RS12865	2
KLE031.A0101_rmdup	2670446	2670450		eptA	4
KLE031.A0101_rmdup	2672612	2672626		YPO_RS12885	14
KLE031.A0101_rmdup	2673686	2673688		YPO_RS12890	2
KLE031.A0101_rmdup	2675759	2675772		YPO_RS12890	13
KLE031.A0101_rmdup	2677013	2677016		rnt	3
KLE031.A0101_rmdup	2679550	2679552		YPO_RS12915	2
KLE031.A0101_rmdup	2690700	2690703		pykF	3
KLE031.A0101_rmdup	2694629	2694640		YPO_RS13000	11
KLE031.A0101_rmdup	2707932	2707970		rprA	38
KLE031.A0101_rmdup	2716582	2716599		arnF	17
KLE031.A0101_rmdup	2716958	2716961		arnF	3
KLE031.A0101_rmdup	2731015	2731022		pheS	7
KLE031.A0101_rmdup	2748813	2748825		YPO_RS13255	12
KLE031.A0101_rmdup	2749104	2749126		YPO_RS13255	22
KLE031.A0101_rmdup	2754131	2754181		YPO_RS13285	50
KLE031.A0101_rmdup	2754270	2754285		YPO_RS13285	15
KLE031.A0101_rmdup	2755040	2755042		YPO_RS13290	2
KLE031.A0101_rmdup	2755465	2755495		YPO_RS13290	30
KLE031.A0101_rmdup	2763987	2764005		csy1	18
KLE031.A0101_rmdup	2766976	2766986		cas3f	10
KLE031.A0101_rmdup	2768848	2768850		cas1f	2
KLE031.A0101_rmdup	2774643	2774644		YPO_RS13365	1
KLE031.A0101_rmdup	2776689	2776709		YPO_RS13375	20
KLE031.A0101_rmdup	2778334	2778337		YPO_RS13380	3
KLE031.A0101_rmdup	2784807	2784816		YPO_RS13410	9
KLE031.A0101_rmdup	2785300	2785306		YPO_RS13415	6
KLE031.A0101_rmdup	2785431	2785453		YPO_RS13415	22
KLE031.A0101_rmdup	2786441	2786457		YPO_RS13430	16
KLE031.A0101_rmdup	2788769	2788815		YPO_RS13435	46
KLE031.A0101_rmdup	2789803	2789837		YPO_RS13445	34
KLE031.A0101_rmdup	2790068	2790097		YPO_RS13445	29
KLE031.A0101_rmdup	2792608	2792645		cdiA	37
KLE031.A0101_rmdup	2794822	2794828		cdiA	6
KLE031.A0101_rmdup	2795987	2796001		cdiA	14
KLE031.A0101_rmdup	2796090	2796115		cdiA	25
KLE031.A0101_rmdup	2801770	2801790		YPO_RS13465	20
KLE031.A0101_rmdup	2811284	2811292		YPO_RS13500	8
KLE031.A0101_rmdup	2813931	2814032		YPO_RS13510	101
KLE031.A0101_rmdup	2814104	2814220		YPO_RS13510	116
KLE031.A0101_rmdup	2814283	2814306		YPO_RS13510	23
KLE031.A0101_rmdup	2814576	2814594		YPO_RS13515	18
KLE031.A0101_rmdup	2821137	2821152		YPO_RS13550	15
KLE031.A0101_rmdup	2830465	2830486		YPO_RS13595	21
KLE031.A0101_rmdup	2832571	2832574		menE	3
KLE031.A0101_rmdup	2838159	2838173		menF	14
KLE031.A0101_rmdup	2845099	2845100		YPO_RS13655	1
KLE031.A0101_rmdup	2853947	2853951		YPO_RS13690	4
KLE031.A0101_rmdup	2854213	2854225		YPO_RS13690	12
KLE031.A0101_rmdup	2854668	2854694		YPO_RS13690	26
KLE031.A0101_rmdup	2859282	2859296		nuoL	14
KLE031.A0101_rmdup	2871021	2871022		lrhA	1
KLE031.A0101_rmdup	2873950	2873958		YPO_RS13765	8
KLE031.A0101_rmdup	2879103	2879114		YPO_RS13790	11
KLE031.A0101_rmdup	2879909	2879912		ackA	3
KLE031.A0101_rmdup	2880457	2880461		ackA	4
KLE031.A0101_rmdup	2885556	2885594		YPO_RS13815	38
KLE031.A0101_rmdup	2885778	2885790		YPO_RS13815	12
KLE031.A0101_rmdup	2885812	2885817		YPO_RS13820	5
KLE031.A0101_rmdup	2886307	2886322		YPO_RS13820	15
KLE031.A0101_rmdup	2887080	2887932		YPO_RS13825	852
KLE031.A0101_rmdup	2887989	2893967		YPO_RS13830	5978
KLE031.A0101_rmdup	2894374	2894922		YPO_RS13835	548
KLE031.A0101_rmdup	2895617	2896471		YPO_RS13840	854
KLE031.A0101_rmdup	2896777	2897241		YPO_RS13845	464
KLE031.A0101_rmdup	2897284	2898091		YPO_RS13845	807
KLE031.A0101_rmdup	2898122	2898303		YPO_RS13845	181
KLE031.A0101_rmdup	2898338	2900263		iolD	1925
KLE031.A0101_rmdup	2903066	2903071		YPO_RS13865	5
KLE031.A0101_rmdup	2908160	2908196		iolC	36
KLE031.A0101_rmdup	2909494	2909507		iolB	13
KLE031.A0101_rmdup	2910286	2910290		iolB	4
KLE031.A0101_rmdup	2910493	2910525		YPO_RS13895	32
KLE031.A0101_rmdup	2914688	2914691		YPO_RS13920	3
KLE031.A0101_rmdup	2915966	2915977		YPO_RS13925	11
KLE031.A0101_rmdup	2918712	2918726		tatA	14
KLE031.A0101_rmdup	2926652	2926654		mrdA	2
KLE031.A0101_rmdup	2930822	2930826		lptE	4
KLE031.A0101_rmdup	2933223	2933232		leuS	9
KLE031.A0101_rmdup	2954785	2954797		YPO_RS14120	12
KLE031.A0101_rmdup	2974627	2974641		proV	14
KLE031.A0101_rmdup	2980432	2980583		YPO_RS14235	151
KLE031.A0101_rmdup	2983044	2983068		YPO_RS14250	24
KLE031.A0101_rmdup	2983550	2983556		YPO_RS14250	6
KLE031.A0101_rmdup	2999234	2999252		YPO_RS14330	18
KLE031.A0101_rmdup	2999786	2999817		YPO_RS14330	31
KLE031.A0101_rmdup	3002806	3002819		crcB	13
KLE031.A0101_rmdup	3003133	3003171		YPO_RS14355	38
KLE031.A0101_rmdup	3004845	3004855		chbC	10
KLE031.A0101_rmdup	3006642	3006647		chbR	5
KLE031.A0101_rmdup	3010192	3010193		pgm	1
KLE031.A0101_rmdup	3012187	3012223		YPO_RS14405	36
KLE031.A0101_rmdup	3021107	3021163		YPO_RS14440	56
KLE031.A0101_rmdup	3026136	3026220		YPO_RS14470	84
KLE031.A0101_rmdup	3031933	3031945		ung	12
KLE031.A0101_rmdup	3037256	3037264		YPO_RS14530	8
KLE031.A0101_rmdup	3042374	3042375		YPO_RS14560	1
KLE031.A0101_rmdup	3042687	3042694		YPO_RS14560	7
KLE031.A0101_rmdup	3049057	3049076		YPO_RS14590	19
KLE031.A0101_rmdup	3050880	3050885		tssL	5
KLE031.A0101_rmdup	3052801	3052804		tssM	3
KLE031.A0101_rmdup	3055901	3055922		YPO_RS14610	21
KLE031.A0101_rmdup	3059017	3059022		YPO_RS14620	5
KLE031.A0101_rmdup	3060599	3060602		YPO_RS14625	3
KLE031.A0101_rmdup	3065953	3065980		YPO_RS14660	27
KLE031.A0101_rmdup	3077139	3077150		fadI	11
KLE031.A0101_rmdup	3096826	3096831		YPO_RS14805	5
KLE031.A0101_rmdup	3106905	3106911		purF	6
KLE031.A0101_rmdup	3109617	3109626		hisJ	9
KLE031.A0101_rmdup	3112316	3112319		YPO_RS14885	3
KLE031.A0101_rmdup	3114625	3114644		yfcE	19
KLE031.A0101_rmdup	3118531	3118537		YPO_RS14910	6
KLE031.A0101_rmdup	3120316	3120561		YPO_RS14920	245
KLE031.A0101_rmdup	3121234	3121815		YPO_RS14925	581
KLE031.A0101_rmdup	3122083	3122484		YPO_RS14930	401
KLE031.A0101_rmdup	3122717	3123118		YPO_RS14935	401
KLE031.A0101_rmdup	3123130	3123702		YPO_RS14940	572
KLE031.A0101_rmdup	3123726	3123977		YPO_RS14945	251
KLE031.A0101_rmdup	3124016	3124255		YPO_RS14950	239
KLE031.A0101_rmdup	3125064	3126980		yapC	1916
KLE031.A0101_rmdup	3127148	3127226		YPO_RS14960	78
KLE031.A0101_rmdup	3127515	3128096		YPO_RS14965	581
KLE031.A0101_rmdup	3128504	3128514		YPO_RS14975	10
KLE031.A0101_rmdup	3128927	3128935		YPO_RS14975	8
KLE031.A0101_rmdup	3128979	3128990		YPO_RS14975	11
KLE031.A0101_rmdup	3129298	3129314		YPO_RS14975	16
KLE031.A0101_rmdup	3130158	3132365		YPO_RS14980	2207
KLE031.A0101_rmdup	3132358	3132474		YPO_RS14985	116
KLE031.A0101_rmdup	3132509	3132888		YPO_RS14985	379
KLE031.A0101_rmdup	3133047	3135428		YPO_RS14990	2381
KLE031.A0101_rmdup	3135507	3137135		YPO_RS14995	1628
KLE031.A0101_rmdup	3137608	3138459		YPO_RS15000	851
KLE031.A0101_rmdup	3138485	3139474		YPO_RS15005	989
KLE031.A0101_rmdup	3139529	3140421		YPO_RS15010	892
KLE031.A0101_rmdup	3142684	3142989		YPO_RS15025	305
KLE031.A0101_rmdup	3143086	3143487		YPO_RS15030	401
KLE031.A0101_rmdup	3143469	3144178		YPO_RS15035	709
KLE031.A0101_rmdup	3144879	3144881		YPO_RS15040	2
KLE031.A0101_rmdup	3145842	3145851		YPO_RS15040	9
KLE031.A0101_rmdup	3150360	3150366		YPO_RS15075	6
KLE031.A0101_rmdup	3154875	3154889		purM	14
KLE031.A0101_rmdup	3157403	3157415		speG	12
KLE031.A0101_rmdup	3162415	3162416		YPO_RS15145	1
KLE031.A0101_rmdup	3166026	3166036		ppk1	10
KLE031.A0101_rmdup	3170923	3170930		yegD	7
KLE031.A0101_rmdup	3179763	3179768		YPO_RS15205	5
KLE031.A0101_rmdup	3192267	3192271		YPO_RS15240	4
KLE031.A0101_rmdup	3197819	3197874		YPO_RS15265	55
KLE031.A0101_rmdup	3197971	3197978		YPO_RS15270	7
KLE031.A0101_rmdup	3198228	3198235		YPO_RS15270	7
KLE031.A0101_rmdup	3200194	3200195		YPO_RS15280	1
KLE031.A0101_rmdup	3200194	3200279		YPO_RS15285	85
KLE031.A0101_rmdup	3200401	3200417		YPO_RS15285	16
KLE031.A0101_rmdup	3200565	3200587		YPO_RS15285	22
KLE031.A0101_rmdup	3200696	3200839		YPO_RS15290	143
KLE031.A0101_rmdup	3200912	3200951		YPO_RS15290	39
KLE031.A0101_rmdup	3201169	3201170		YPO_RS15295	1
KLE031.A0101_rmdup	3201493	3201503		YPO_RS15295	10
KLE031.A0101_rmdup	3201567	3201794		YPO_RS15300	227
KLE031.A0101_rmdup	3201869	3201871		YPO_RS15300	2
KLE031.A0101_rmdup	3201946	3201959		YPO_RS15300	13
KLE031.A0101_rmdup	3202231	3202277		YPO_RS15305	46
KLE031.A0101_rmdup	3212673	3212675		bamB	2
KLE031.A0101_rmdup	3216205	3216220		rodZ	15
KLE031.A0101_rmdup	3221610	3221614		YPO_RS15385	4
KLE031.A0101_rmdup	3221687	3221739		YPO_RS15385	52
KLE031.A0101_rmdup	3221812	3221884		YPO_RS15385	72
KLE031.A0101_rmdup	3221951	3222000		YPO_RS15385	49
KLE031.A0101_rmdup	3222090	3222170		YPO_RS15385	80
KLE031.A0101_rmdup	3222627	3222651		YPO_RS15385	24
KLE031.A0101_rmdup	3225493	3225528		yapA	35
KLE031.A0101_rmdup	3225580	3225621		yapA	41
KLE031.A0101_rmdup	3228581	3228593		YPO_RS15395	12
KLE031.A0101_rmdup	3230087	3230091		YPO_RS15395	4
KLE031.A0101_rmdup	3230503	3230511		YPO_RS15395	8
KLE031.A0101_rmdup	3231849	3231863		YPO_RS15405	14
KLE031.A0101_rmdup	3243775	3243791		YPO_RS15475	16
KLE031.A0101_rmdup	3254247	3254264		YPO_RS15525	17
KLE031.A0101_rmdup	3260330	3260376		YPO_RS15550	46
KLE031.A0101_rmdup	3262676	3262752		YPO_RS15560	76
KLE031.A0101_rmdup	3262862	3262898		YPO_RS15560	36
KLE031.A0101_rmdup	3265841	3265857		purL	16
KLE031.A0101_rmdup	3282767	3282769		YPO_RS15660	2
KLE031.A0101_rmdup	3284502	3284540		YPO_RS15665	38
KLE031.A0101_rmdup	3285762	3285781		YPO_RS15670	19
KLE031.A0101_rmdup	3285803	3285815		YPO_RS15675	12
KLE031.A0101_rmdup	3287242	3287258		YPO_RS15675	16
KLE031.A0101_rmdup	3287582	3287584		YPO_RS15680	2
KLE031.A0101_rmdup	3289592	3289598		tssH	6
KLE031.A0101_rmdup	3295441	3295459		tssG	18
KLE031.A0101_rmdup	3299236	3299245		YPO_RS15720	9
KLE031.A0101_rmdup	3302799	3302805		YPO_RS15735	6
KLE031.A0101_rmdup	3307342	3307346		YPO_RS15750	4
KLE031.A0101_rmdup	3308773	3308777		YPO_RS15755	4
KLE031.A0101_rmdup	3310657	3310661		YPO_RS15765	4
KLE031.A0101_rmdup	3310669	3310670		YPO_RS15765	1
KLE031.A0101_rmdup	3311452	3311454		YPO_RS15770	2
KLE031.A0101_rmdup	3311878	3311899		YPO_RS15770	21
KLE031.A0101_rmdup	3318200	3318211		YPO_RS15795	11
KLE031.A0101_rmdup	3320249	3320272		YPO_RS15810	23
KLE031.A0101_rmdup	3324430	3324431		YPO_RS15830	1
KLE031.A0101_rmdup	3331949	3331950		YPO_RS15865	1
KLE031.A0101_rmdup	3341534	3341541		cysZ	7
KLE031.A0101_rmdup	3345009	3345011		ptsI	2
KLE031.A0101_rmdup	3348218	3348227		YPO_RS15980	9
KLE031.A0101_rmdup	3348694	3348703		YPO_RS15980	9
KLE031.A0101_rmdup	3355101	3355159		YPO_RS16000	58
KLE031.A0101_rmdup	3355452	3355460		YPO_RS16000	8
KLE031.A0101_rmdup	3358283	3358303		YPO_RS16020	20
KLE031.A0101_rmdup	3363068	3363070		YPO_RS16035	2
KLE031.A0101_rmdup	3363718	3363734		YPO_RS16040	16
KLE031.A0101_rmdup	3363814	3363887		YPO_RS16040	73
KLE031.A0101_rmdup	3364216	3364226		YPO_RS16040	10
KLE031.A0101_rmdup	3364366	3364388		YPO_RS16040	22
KLE031.A0101_rmdup	3364515	3364518		YPO_RS16040	3
KLE031.A0101_rmdup	3364670	3364737		YPO_RS16040	67
KLE031.A0101_rmdup	3369762	3369763		YPO_RS16065	1
KLE031.A0101_rmdup	3372784	3372809		YPO_RS16075	25
KLE031.A0101_rmdup	3373376	3373377		YPO_RS16080	1
KLE031.A0101_rmdup	3378771	3378782		YPO_RS16105	11
KLE031.A0101_rmdup	3381105	3381116		yapL	11
KLE031.A0101_rmdup	3383565	3383588		YPO_RS16125	23
KLE031.A0101_rmdup	3383845	3383869		YPO_RS16125	24
KLE031.A0101_rmdup	3385929	3385939		hemF	10
KLE031.A0101_rmdup	3389315	3389316		nudK	1
KLE031.A0101_rmdup	3400350	3400359		YPO_RS16195	9
KLE031.A0101_rmdup	3402538	3402545		YPO_RS16205	7
KLE031.A0101_rmdup	3403260	3403266		YPO_RS16210	6
KLE031.A0101_rmdup	3405493	3405529		YPO_RS16220	36
KLE031.A0101_rmdup	3405638	3405652		YPO_RS16220	14
KLE031.A0101_rmdup	3407462	3407470		YPO_RS16225	8
KLE031.A0101_rmdup	3408144	3408145		YPO_RS16225	1
KLE031.A0101_rmdup	3409391	3409401		YPO_RS16230	10
KLE031.A0101_rmdup	3422070	3422088		YPO_RS16305	18
KLE031.A0101_rmdup	3450523	3450535		YPO_RS16430	12
KLE031.A0101_rmdup	3454282	3454287		fepE	5
KLE031.A0101_rmdup	3454783	3454876		fepE	93
KLE031.A0101_rmdup	3455024	3455044		cpsG	20
KLE031.A0101_rmdup	3455914	3455956		cpsG	42
KLE031.A0101_rmdup	3456154	3456168		cpsG	14
KLE031.A0101_rmdup	3456558	3456582		YPO_RS16450	24
KLE031.A0101_rmdup	3457103	3457111		YPO_RS16450	8
KLE031.A0101_rmdup	3457641	3457657		YPO_RS16455	16
KLE031.A0101_rmdup	3460845	3460855		YPO_RS16470	10
KLE031.A0101_rmdup	3461026	3461040		YPO_RS16470	14
KLE031.A0101_rmdup	3461367	3461375		YPO_RS16470	8
KLE031.A0101_rmdup	3461643	3461659		YPO_RS16470	16
KLE031.A0101_rmdup	3461853	3461854		YPO_RS16470	1
KLE031.A0101_rmdup	3463321	3463378		YPO_RS16480	57
KLE031.A0101_rmdup	3463451	3463480		YPO_RS16480	29
KLE031.A0101_rmdup	3463714	3463811		YPO_RS16480	97
KLE031.A0101_rmdup	3463880	3463970		YPO_RS16480	90
KLE031.A0101_rmdup	3464107	3464252		YPO_RS16480	145
KLE031.A0101_rmdup	3464437	3464463		YPO_RS16480	26
KLE031.A0101_rmdup	3464843	3464876		YPO_RS16485	33
KLE031.A0101_rmdup	3465014	3465124		YPO_RS16485	110
KLE031.A0101_rmdup	3465226	3465255		YPO_RS16485	29
KLE031.A0101_rmdup	3465313	3465336		YPO_RS16485	23
KLE031.A0101_rmdup	3465424	3465432		YPO_RS16485	8
KLE031.A0101_rmdup	3465490	3465556		YPO_RS16485	66
KLE031.A0101_rmdup	3465567	3465598		YPO_RS16490	31
KLE031.A0101_rmdup	3466247	3466448		YPO_RS16490	201
KLE031.A0101_rmdup	3466587	3466674		YPO_RS16490	87
KLE031.A0101_rmdup	3466984	3467015		YPO_RS16495	31
KLE031.A0101_rmdup	3467100	3467110		YPO_RS16495	10
KLE031.A0101_rmdup	3467520	3467545		YPO_RS16495	25
KLE031.A0101_rmdup	3467605	3467618		YPO_RS16495	13
KLE031.A0101_rmdup	3468030	3468041		YPO_RS16495	11
KLE031.A0101_rmdup	3468638	3468693		YPO_RS16500	55
KLE031.A0101_rmdup	3469123	3469125		YPO_RS16500	2
KLE031.A0101_rmdup	3470506	3470516		rfbG	10
KLE031.A0101_rmdup	3471109	3471112		rfbG	3
KLE031.A0101_rmdup	3473066	3473103		YPO_RS16520	37
KLE031.A0101_rmdup	3473370	3473373		YPO_RS16520	3
KLE031.A0101_rmdup	3479760	3479770		dnaX	10
KLE031.A0101_rmdup	3488094	3488097		mscK	3
KLE031.A0101_rmdup	3495158	3495192		YPO_RS16605	34
KLE031.A0101_rmdup	3497012	3497039		YPO_RS16620	27
KLE031.A0101_rmdup	3520948	3520959		clpP	11
KLE031.A0101_rmdup	3527256	3527267		YPO_RS16755	11
KLE031.A0101_rmdup	3534645	3534663		YPO_RS16790	18
KLE031.A0101_rmdup	3536353	3536357		yajL	4
KLE031.A0101_rmdup	3541473	3541477		dxs	4
KLE031.A0101_rmdup	3541833	3541834		YPO_RS16825	1
KLE031.A0101_rmdup	3547447	3547506		YPO_RS16860	59
KLE031.A0101_rmdup	3548023	3548205		YPO_RS16865	182
KLE031.A0101_rmdup	3552003	3552011		secD	8
KLE031.A0101_rmdup	3553597	3553598		tgt	1
KLE031.A0101_rmdup	3560173	3560177		YPO_RS16920	4
KLE031.A0101_rmdup	3560391	3560430		YPO_RS16925	39
KLE031.A0101_rmdup	3572079	3572116		YPO_RS16965	37
KLE031.A0101_rmdup	3574423	3574428		YPO_RS16965	5
KLE031.A0101_rmdup	3582503	3582510		YPO_RS17005	7
KLE031.A0101_rmdup	3583073	3583079		YPO_RS17010	6
KLE031.A0101_rmdup	3590106	3590128		YPO_RS17045	22
KLE031.A0101_rmdup	3592454	3592539		YPO_RS17055	85
KLE031.A0101_rmdup	3592605	3592687		YPO_RS17055	82
KLE031.A0101_rmdup	3592899	3592901		YPO_RS17055	2
KLE031.A0101_rmdup	3592999	3593067		YPO_RS17055	68
KLE031.A0101_rmdup	3593271	3593300		YPO_RS17055	29
KLE031.A0101_rmdup	3595763	3595766		pepD	3
KLE031.A0101_rmdup	3598163	3598187		YPO_RS17070	24
KLE031.A0101_rmdup	3598828	3598831		YPO_RS17070	3
KLE031.A0101_rmdup	3600003	3600026		YPO_RS17080	23
KLE031.A0101_rmdup	3614545	3614558		YPO_RS17140	13
KLE031.A0101_rmdup	3617425	3617442		YPO_RS17145	17
KLE031.A0101_rmdup	3617607	3617645		YPO_RS17145	38
KLE031.A0101_rmdup	3617934	3617959		YPO_RS17145	25
KLE031.A0101_rmdup	3618077	3618078		YPO_RS17145	1
KLE031.A0101_rmdup	3618474	3618479		YPO_RS17145	5
KLE031.A0101_rmdup	3618889	3618904		YPO_RS17145	15
KLE031.A0101_rmdup	3619179	3619203		YPO_RS17145	24
KLE031.A0101_rmdup	3620700	3620702		YPO_RS17150	2
KLE031.A0101_rmdup	3623723	3623726		YPO_RS17160	3
KLE031.A0101_rmdup	3629921	3629929		YPO_RS17195	8
KLE031.A0101_rmdup	3635280	3635313		YPO_RS17225	33
KLE031.A0101_rmdup	3638673	3638690		emrA	17
KLE031.A0101_rmdup	3640014	3640022		emrB	8
KLE031.A0101_rmdup	3643005	3643025		trxC	20
KLE031.A0101_rmdup	3647296	3647311		pssA	15
KLE031.A0101_rmdup	3648248	3648249		YPO_RS17280	1
KLE031.A0101_rmdup	3648468	3648471		YPO_RS17280	3
KLE031.A0101_rmdup	3649933	3649939		YPO_RS17290	6
KLE031.A0101_rmdup	3650368	3650384		YPO_RS17290	16
KLE031.A0101_rmdup	3654206	3654212		YPO_RS17310	6
KLE031.A0101_rmdup	3654244	3654252		YPO_RS17310	8
KLE031.A0101_rmdup	3658571	3658599		rluD	28
KLE031.A0101_rmdup	3672554	3672571		trmD	17
KLE031.A0101_rmdup	3674834	3674849		ffh	15
KLE031.A0101_rmdup	3682294	3682312		YPO_RS17455	18
KLE031.A0101_rmdup	3682367	3682386		YPO_RS17455	19
KLE031.A0101_rmdup	3682466	3682482		YPO_RS17460	16
KLE031.A0101_rmdup	3696544	3696568		YPO_RS17530	24
KLE031.A0101_rmdup	3701183	3701198		YPO_RS17550	15
KLE031.A0101_rmdup	3703943	3703949		katG	6
KLE031.A0101_rmdup	3704294	3704300		cybC	6
KLE031.A0101_rmdup	3704986	3705005		cybB	19
KLE031.A0101_rmdup	3706018	3706054		dmsD	36
KLE031.A0101_rmdup	3712728	3712736		YPO_RS17595	8
KLE031.A0101_rmdup	3725203	3725224		YPO_RS17650	21
KLE031.A0101_rmdup	3725452	3725488		YPO_RS17650	36
KLE031.A0101_rmdup	3725665	3725667		YPO_RS17650	2
KLE031.A0101_rmdup	3731775	3731789		YPO_RS17675	14
KLE031.A0101_rmdup	3737941	3737953		YPO_RS17710	12
KLE031.A0101_rmdup	3754067	3754069		cysD	2
KLE031.A0101_rmdup	3755696	3755703		cobA	7
KLE031.A0101_rmdup	3759114	3759122		cysI	8
KLE031.A0101_rmdup	3761113	3761114		cysJ	1
KLE031.A0101_rmdup	3761333	3761350		cysJ	17
KLE031.A0101_rmdup	3766441	3766447		pyrG	6
KLE031.A0101_rmdup	3769296	3769305		relA	9
KLE031.A0101_rmdup	3771874	3771875		barA	1
KLE031.A0101_rmdup	3773771	3773775		barA	4
KLE031.A0101_rmdup	3774353	3774363		degP	10
KLE031.A0101_rmdup	3775602	3775613		degP	11
KLE031.A0101_rmdup	3793710	3793712		thpR	2
KLE031.A0101_rmdup	3799962	3799980		panB	18
KLE031.A0101_rmdup	3807007	3807008		cueO	1
KLE031.A0101_rmdup	3812180	3812188		YPO_RS18035	8
KLE031.A0101_rmdup	3812280	3812290		YPO_RS18035	10
KLE031.A0101_rmdup	3820050	3820056		aceF	6
KLE031.A0101_rmdup	3834024	3834031		YPO_RS18110	7
KLE031.A0101_rmdup	3858531	3858549		YPO_RS18220	18
KLE031.A0101_rmdup	3876915	3876916		YPO_RS18320	1
KLE031.A0101_rmdup	3877989	3877994		YPO_RS18325	5
KLE031.A0101_rmdup	3881823	3881827		YPO_RS18335	4
KLE031.A0101_rmdup	3883539	3883542		YPO_RS18345	3
KLE031.A0101_rmdup	3888496	3888498		YPO_RS18370	2
KLE031.A0101_rmdup	3894616	3894621		YPO_RS18390	5
KLE031.A0101_rmdup	3900897	3900903		YPO_RS18420	6
KLE031.A0101_rmdup	3906345	3906379		infB	34
KLE031.A0101_rmdup	3949234	3949244		rpsF	10
KLE031.A0101_rmdup	3950505	3950507		YPO_RS18675	2
KLE031.A0101_rmdup	3960456	3960476		yraP	20
KLE031.A0101_rmdup	3963225	3963238		arcB	13
KLE031.A0101_rmdup	3968462	3968466		gltB	4
KLE031.A0101_rmdup	3976861	3976865		YPO_RS18790	4
KLE031.A0101_rmdup	3983718	3983723		ibaG	5
KLE031.A0101_rmdup	3990496	3990508		kdsC	12
KLE031.A0101_rmdup	3996104	3996106		npr	2
KLE031.A0101_rmdup	4001564	4001572		YPO_RS18935	8
KLE031.A0101_rmdup	4009412	4009427		tssH	15
KLE031.A0101_rmdup	4011512	4011513		tssA	1
KLE031.A0101_rmdup	4016448	4016451		YPO_RS18990	3
KLE031.A0101_rmdup	4018181	4018189		YPO_RS19000	8
KLE031.A0101_rmdup	4019066	4019068		YPO_RS19000	2
KLE031.A0101_rmdup	4020354	4020398		YPO_RS19010	44
KLE031.A0101_rmdup	4022405	4022423		YPO_RS19010	18
KLE031.A0101_rmdup	4024716	4024751		YPO_RS19020	35
KLE031.A0101_rmdup	4029404	4029439		YPO_RS19055	35
KLE031.A0101_rmdup	4033561	4033587		YPO_RS19055	26
KLE031.A0101_rmdup	4033596	4033599		YPO_RS19060	3
KLE031.A0101_rmdup	4033662	4033826		YPO_RS19060	164
KLE031.A0101_rmdup	4033952	4033984		YPO_RS19060	32
KLE031.A0101_rmdup	4034669	4034689		YPO_RS19065	20
KLE031.A0101_rmdup	4038781	4038805		YPO_RS19090	24
KLE031.A0101_rmdup	4038927	4038928		YPO_RS19090	1
KLE031.A0101_rmdup	4047507	4047512		YPO_RS19135	5
KLE031.A0101_rmdup	4065290	4065295		cspA	5
KLE031.A0101_rmdup	4078671	4078676		YPO_RS19285	5
KLE031.A0101_rmdup	4082217	4082245		msrQ	28
KLE031.A0101_rmdup	4090668	4090677		rng	9
KLE031.A0101_rmdup	4098633	4098735		YPO_RS19365	102
KLE031.A0101_rmdup	4098949	4098954		YPO_RS19365	5
KLE031.A0101_rmdup	4099402	4099458		YPO_RS19365	56
KLE031.A0101_rmdup	4100966	4101082		YPO_RS19365	116
KLE031.A0101_rmdup	4101165	4101209		YPO_RS19365	44
KLE031.A0101_rmdup	4101296	4101312		YPO_RS19365	16
KLE031.A0101_rmdup	4101364	4101491		YPO_RS19365	127
KLE031.A0101_rmdup	4101516	4102551		YPO_RS19370	1035
KLE031.A0101_rmdup	4102718	4102822		YPO_RS19370	104
KLE031.A0101_rmdup	4102857	4102892		YPO_RS19370	35
KLE031.A0101_rmdup	4102928	4102936		YPO_RS19370	8
KLE031.A0101_rmdup	4103043	4103052		YPO_RS19370	9
KLE031.A0101_rmdup	4103119	4103146		YPO_RS19370	27
KLE031.A0101_rmdup	4103211	4103262		YPO_RS19370	51
KLE031.A0101_rmdup	4103420	4103441		YPO_RS19370	21
KLE031.A0101_rmdup	4104080	4104106		YPO_RS19370	26
KLE031.A0101_rmdup	4104604	4104607		YPO_RS19375	3
KLE031.A0101_rmdup	4110127	4110145		YPO_RS19390	18
KLE031.A0101_rmdup	4112694	4112754		YPO_RS19400	60
KLE031.A0101_rmdup	4112896	4112920		YPO_RS19400	24
KLE031.A0101_rmdup	4113055	4113058		YPO_RS19400	3
KLE031.A0101_rmdup	4113365	4113369		YPO_RS19400	4
KLE031.A0101_rmdup	4113891	4113893		YPO_RS19400	2
KLE031.A0101_rmdup	4114005	4114109		YPO_RS19405	104
KLE031.A0101_rmdup	4114167	4114230		YPO_RS19405	63
KLE031.A0101_rmdup	4114362	4114396		YPO_RS19405	34
KLE031.A0101_rmdup	4116720	4116827		YPO_RS19410	107
KLE031.A0101_rmdup	4119697	4119700		aaeA	3
KLE031.A0101_rmdup	4142776	4142829		YPO_RS19535	53
KLE031.A0101_rmdup	4150448	4150450		malF	2
KLE031.A0101_rmdup	4156566	4156574		YPO_RS19590	8
KLE031.A0101_rmdup	4156668	4156677		YPO_RS19590	9
KLE031.A0101_rmdup	4159898	4159904		YPO_RS19595	6
KLE031.A0101_rmdup	4176214	4176221		YPO_RS19645	7
KLE031.A0101_rmdup	4176654	4176669		YPO_RS19645	15
KLE031.A0101_rmdup	4180174	4180185		YPO_RS19660	11
KLE031.A0101_rmdup	4187362	4187363		hemE	1
KLE031.A0101_rmdup	4188578	4188604		YPO_RS19705	26
KLE031.A0101_rmdup	4206214	4206229		rplL	15
KLE031.A0101_rmdup	4206347	4206352		rplL	5
KLE031.A0101_rmdup	4223038	4223044		YPO_RS19870	6
KLE031.A0101_rmdup	4223143	4223145		YPO_RS19870	2
KLE031.A0101_rmdup	4224263	4224270		hemG	7
KLE031.A0101_rmdup	4226965	4226993		YPO_RS19900	28
KLE031.A0101_rmdup	4235777	4235792		hemB	15
KLE031.A0101_rmdup	4242459	4242462		ubiB	3
KLE031.A0101_rmdup	4253154	4253158		metE	4
KLE031.A0101_rmdup	4257918	4257951		ugpQ	33
KLE031.A0101_rmdup	4263382	4263387		YPO_RS20065	5
KLE031.A0101_rmdup	4263460	4263492		YPO_RS20065	32
KLE031.A0101_rmdup	4264307	4264391		YPO_RS20070	84
KLE031.A0101_rmdup	4265988	4265995		YPO_RS20070	7
KLE031.A0101_rmdup	4268923	4268948		YPO_RS20090	25
KLE031.A0101_rmdup	4269655	4269687		YPO_RS20095	32
KLE031.A0101_rmdup	4270008	4270022		YPO_RS20095	14
KLE031.A0101_rmdup	4270099	4270116		YPO_RS20095	17
KLE031.A0101_rmdup	4280857	4280884		ftsY	27
KLE031.A0101_rmdup	4281457	4281471		ftsY	14
KLE031.A0101_rmdup	4300892	4300895		recQ	3
KLE031.A0101_rmdup	4304841	4304856		rarD	15
KLE031.A0101_rmdup	4305664	4305670		corA	6
KLE031.A0101_rmdup	4312118	4312133		uvrD	15
KLE031.A0101_rmdup	4314488	4314501		YPO_RS20305	13
KLE031.A0101_rmdup	4321158	4321173		hemD	15
KLE031.A0101_rmdup	4322992	4323005		hemY	13
KLE031.A0101_rmdup	4332346	4332357		rffA	11
KLE031.A0101_rmdup	4339878	4339884		wzzE	6
KLE031.A0101_rmdup	4349644	4349703		YPO_RS20480	59
KLE031.A0101_rmdup	4349957	4350002		YPO_RS20480	45
KLE031.A0101_rmdup	4359333	4359370		YPO_RS20515	37
KLE031.A0101_rmdup	4359547	4359570		YPO_RS20515	23
KLE031.A0101_rmdup	4360200	4360358		YPO_RS20525	158
KLE031.A0101_rmdup	4364582	4364607		ilvY	25
KLE031.A0101_rmdup	4365273	4365287		YPO_RS20550	14
KLE031.A0101_rmdup	4366507	4366510		YPO_RS20560	3
KLE031.A0101_rmdup	4367015	4367022		YPO_RS20565	7
KLE031.A0101_rmdup	4367198	4367241		YPO_RS20565	43
KLE031.A0101_rmdup	4367709	4367768		YPO_RS20570	59
KLE031.A0101_rmdup	4368281	4368300		YPO_RS20575	19
KLE031.A0101_rmdup	4368373	4368384		YPO_RS20575	11
KLE031.A0101_rmdup	4376347	4376354		YPO_RS20610	7
KLE031.A0101_rmdup	4376481	4376482		YPO_RS20610	1
KLE031.A0101_rmdup	4386010	4386016		YPO_RS20660	6
KLE031.A0101_rmdup	4388480	4388489		YPO_RS20670	9
KLE031.A0101_rmdup	4389733	4389736		YPO_RS20670	3
KLE031.A0101_rmdup	4390897	4390933		murI	36
KLE031.A0101_rmdup	4400743	4400782		YPO_RS20725	39
KLE031.A0101_rmdup	4401529	4401546		YPO_RS20725	17
KLE031.A0101_rmdup	4406443	4406448		YPO_RS20745	5
KLE031.A0101_rmdup	4407031	4407047		YPO_RS20745	16
KLE031.A0101_rmdup	4408275	4408320		YPO_RS20745	45
KLE031.A0101_rmdup	4411589	4411591		argC	2
KLE031.A0101_rmdup	4411834	4411847		argC	13
KLE031.A0101_rmdup	4418851	4418892		YPO_RS20775	41
KLE031.A0101_rmdup	4419797	4419812		YPO_RS20785	15
KLE031.A0101_rmdup	4424354	4424360		glgP	6
KLE031.A0101_rmdup	4440885	4440887		YPO_RS20830	2
KLE031.A0101_rmdup	4442500	4442509		YPO_RS20830	9
KLE031.A0101_rmdup	4445759	4445769		YPO_RS20840	10
KLE031.A0101_rmdup	4465408	4465428		YPO_RS20945	20
KLE031.A0101_rmdup	4468244	4468247		pitA	3
KLE031.A0101_rmdup	4472517	4472526		YPO_RS20975	9
KLE031.A0101_rmdup	4472631	4472632		YPO_RS20975	1
KLE031.A0101_rmdup	4479883	4479892		YPO_RS21000	9
KLE031.A0101_rmdup	4481534	4481544		YPO_RS21010	10
KLE031.A0101_rmdup	4481953	4481983		YPO_RS21010	30
KLE031.A0101_rmdup	4483595	4483753		YPO_RS21020	158
KLE031.A0101_rmdup	4483804	4483813		YPO_RS21020	9
KLE031.A0101_rmdup	4483880	4483914		YPO_RS21020	34
KLE031.A0101_rmdup	4484178	4484197		YPO_RS21025	19
KLE031.A0101_rmdup	4484836	4484876		YPO_RS21030	40
KLE031.A0101_rmdup	4484933	4485059		YPO_RS21030	126
KLE031.A0101_rmdup	4489788	4489807		yhjD	19
KLE031.A0101_rmdup	4490548	4490558		YPO_RS21045	10
KLE031.A0101_rmdup	4491276	4491299		YPO_RS21045	23
KLE031.A0101_rmdup	4495763	4495764		YPO_RS21065	1
KLE031.A0101_rmdup	4503342	4503366		YPO_RS21090	24
KLE031.A0101_rmdup	4514643	4514644		YPO_RS21135	1
KLE031.A0101_rmdup	4515986	4515994		YPO_RS21140	8
KLE031.A0101_rmdup	4516097	4516147		YPO_RS21140	50
KLE031.A0101_rmdup	4516766	4516780		YPO_RS21140	14
KLE031.A0101_rmdup	4517352	4517373		YPO_RS21140	21
KLE031.A0101_rmdup	4519715	4519722		YPO_RS21155	7
KLE031.A0101_rmdup	4528814	4528820		YPO_RS21190	6
KLE031.A0101_rmdup	4533461	4533476		YPO_RS21205	15
KLE031.A0101_rmdup	4533683	4533710		YPO_RS21205	27
KLE031.A0101_rmdup	4534808	4534876		YPO_RS21210	68
KLE031.A0101_rmdup	4535134	4535148		YPO_RS21215	14
KLE031.A0101_rmdup	4539714	4539725		YPO_RS21235	11
KLE031.A0101_rmdup	4545503	4545520		YPO_RS21280	17
KLE031.A0101_rmdup	4545610	4545685		YPO_RS21280	75
KLE031.A0101_rmdup	4545803	4545883		YPO_RS21280	80
KLE031.A0101_rmdup	4546306	4546318		YPO_RS21280	12
KLE031.A0101_rmdup	4546383	4546403		YPO_RS21280	20
KLE031.A0101_rmdup	4555639	4555641		xylB	2
KLE031.A0101_rmdup	4558105	4558135		YPO_RS21330	30
KLE031.A0101_rmdup	4561511	4561533		YPO_RS21340	22
KLE031.A0101_rmdup	4561579	4561598		YPO_RS21340	19
KLE031.A0101_rmdup	4563885	4563938		YPO_RS21350	53
KLE031.A0101_rmdup	4565429	4565436		YPO_RS21355	7
KLE031.A0101_rmdup	4567696	4567766		YPO_RS21370	70
KLE031.A0101_rmdup	4572497	4572506		YPO_RS21400	9
KLE031.A0101_rmdup	4572574	4572581		YPO_RS21400	7
KLE031.A0101_rmdup	4574996	4575008		fdxH	12
KLE031.A0101_rmdup	4590029	4590032		YPO_RS21470	3
KLE031.A0101_rmdup	4593323	4593333		glyQ	10
KLE031.A0101_rmdup	4596427	4596442		YPO_RS21500	15
KLE031.A0101_rmdup	4601624	4601725		YPO_RS21520	101
KLE031.A0101_rmdup	4601832	4601861		YPO_RS21520	29
KLE031.A0101_rmdup	4601934	4601938		YPO_RS21520	4
KLE031.A0101_rmdup	4602037	4602067		YPO_RS21520	30
KLE031.A0101_rmdup	4612088	4612098		YPO_RS21565	10
KLE031.A0101_rmdup	4621860	4621877		yidC	17
KLE031.A0101_rmdup	4626082	4626089		YPO_RS21625	7
KLE031.A0101_rmdup	4626264	4626293		YPO_RS21630	29
KLE031.A0101_rmdup	4629423	4629435		YPO_RS21645	12
KLE031.A0101_rmdup	4634565	4634570		phoU	5
KLE048.A0101_rmdup	4031	4052		ravA	21
KLE048.A0101_rmdup	14915	14921		YPO_RS01080	6
KLE048.A0101_rmdup	19078	19097		YPO_RS01090	19
KLE048.A0101_rmdup	23888	23896		polA	8
KLE048.A0101_rmdup	45945	45949		gltS	4
KLE048.A0101_rmdup	64534	64556		YPO_RS01310	22
KLE048.A0101_rmdup	106582	106586		YPO_RS01520	4
KLE048.A0101_rmdup	116438	116447		cytR	9
KLE048.A0101_rmdup	127184	127185		YPO_RS01610	1
KLE048.A0101_rmdup	166155	166160		aroB	5
KLE048.A0101_rmdup	196655	196685		YPO_RS01895	30
KLE048.A0101_rmdup	236477	236492		YPO_RS02185	15
KLE048.A0101_rmdup	258146	258147		YPO_RS02285	1
KLE048.A0101_rmdup	270276	270291		YPO_RS02360	15
KLE048.A0101_rmdup	275523	275554		YPO_RS02395	31
KLE048.A0101_rmdup	288482	288521		YPO_RS02455	39
KLE048.A0101_rmdup	288871	288963		YPO_RS02455	92
KLE048.A0101_rmdup	315065	315094		yapK	29
KLE048.A0101_rmdup	345070	345087		YPO_RS02690	17
KLE048.A0101_rmdup	345931	345954		YPO_RS02695	23
KLE048.A0101_rmdup	347164	347195		YPO_RS02695	31
KLE048.A0101_rmdup	348154	348167		YPO_RS02695	13
KLE048.A0101_rmdup	371086	371117		YPO_RS02805	31
KLE048.A0101_rmdup	407775	407804		YPO_RS02955	29
KLE048.A0101_rmdup	407852	407864		YPO_RS02955	12
KLE048.A0101_rmdup	408060	408066		YPO_RS02955	6
KLE048.A0101_rmdup	408166	408236		YPO_RS02955	70
KLE048.A0101_rmdup	408287	408339		YPO_RS02955	52
KLE048.A0101_rmdup	408445	408470		YPO_RS02955	25
KLE048.A0101_rmdup	409030	409038		YPO_RS02960	8
KLE048.A0101_rmdup	409207	409213		YPO_RS02960	6
KLE048.A0101_rmdup	409260	409284		YPO_RS02960	24
KLE048.A0101_rmdup	409424	409443		YPO_RS02960	19
KLE048.A0101_rmdup	409820	409878		YPO_RS02965	58
KLE048.A0101_rmdup	410572	410583		YPO_RS02965	11
KLE048.A0101_rmdup	410824	410891		YPO_RS02965	67
KLE048.A0101_rmdup	409560	409747		YPO_RS02965	187
KLE048.A0101_rmdup	415855	415872		YPO_RS02990	17
KLE048.A0101_rmdup	422309	422324		ptsP	15
KLE048.A0101_rmdup	426082	426101		lsrF	19
KLE048.A0101_rmdup	430155	430158		lsrA	3
KLE048.A0101_rmdup	431289	431336		YPO_RS03065	47
KLE048.A0101_rmdup	452227	452229		osmY	2
KLE048.A0101_rmdup	494471	494477		YPO_RS03330	6
KLE048.A0101_rmdup	495002	495008		YPO_RS03330	6
KLE048.A0101_rmdup	495121	495160		YPO_RS03330	39
KLE048.A0101_rmdup	495301	495304		YPO_RS03330	3
KLE048.A0101_rmdup	495385	495387		YPO_RS03330	2
KLE048.A0101_rmdup	495726	495796		YPO_RS03330	70
KLE048.A0101_rmdup	501070	501088		nhaA	18
KLE048.A0101_rmdup	521332	521367		YPO_RS03450	35
KLE048.A0101_rmdup	576329	576335		leuB	6
KLE048.A0101_rmdup	579585	579586		YPO_RS03675	1
KLE048.A0101_rmdup	588399	588413		cra	14
KLE048.A0101_rmdup	595344	595353		murF	9
KLE048.A0101_rmdup	653731	653747		cdiA	16
KLE048.A0101_rmdup	656702	656705		cdiA	3
KLE048.A0101_rmdup	659371	659436		cdiI	65
KLE048.A0101_rmdup	660149	660169		YPO_RS04005	20
KLE048.A0101_rmdup	663798	663805		yapF	7
KLE048.A0101_rmdup	664977	664978		YPO_RS04025	1
KLE048.A0101_rmdup	667961	667975		YPO_RS04035	14
KLE048.A0101_rmdup	673951	673967		YPO_RS04055	16
KLE048.A0101_rmdup	674228	674231		YPO_RS04055	3
KLE048.A0101_rmdup	684413	684435		YPO_RS04100	22
KLE048.A0101_rmdup	688306	688336		YPO_RS04120	30
KLE048.A0101_rmdup	704997	705005		plsY	8
KLE048.A0101_rmdup	730279	730313		YPO_RS04320	34
KLE048.A0101_rmdup	746816	746851		YPO_RS04390	35
KLE048.A0101_rmdup	746924	746935		YPO_RS04390	11
KLE048.A0101_rmdup	747767	747790		YPO_RS04390	23
KLE048.A0101_rmdup	747928	747937		YPO_RS04395	9
KLE048.A0101_rmdup	749292	749364		YPO_RS04405	72
KLE048.A0101_rmdup	749625	749634		YPO_RS04405	9
KLE048.A0101_rmdup	749629	749634		YPO_RS04410	5
KLE048.A0101_rmdup	750212	750251		YPO_RS04410	39
KLE048.A0101_rmdup	750434	750462		YPO_RS04410	28
KLE048.A0101_rmdup	750459	750533		YPO_RS04415	74
KLE048.A0101_rmdup	750742	750767		YPO_RS04415	25
KLE048.A0101_rmdup	751042	751121		YPO_RS04415	79
KLE048.A0101_rmdup	751192	751202		YPO_RS04415	10
KLE048.A0101_rmdup	752456	752458		YPO_RS04420	2
KLE048.A0101_rmdup	752643	752672		YPO_RS04425	29
KLE048.A0101_rmdup	753520	753523		YPO_RS04425	3
KLE048.A0101_rmdup	753751	753756		YPO_RS04425	5
KLE048.A0101_rmdup	753767	753797		YPO_RS04430	30
KLE048.A0101_rmdup	753888	753958		YPO_RS04430	70
KLE048.A0101_rmdup	754844	754846		YPO_RS04440	2
KLE048.A0101_rmdup	755318	755345		YPO_RS04440	27
KLE048.A0101_rmdup	755530	755583		YPO_RS04445	53
KLE048.A0101_rmdup	755661	755665		YPO_RS04445	4
KLE048.A0101_rmdup	755805	755821		YPO_RS04445	16
KLE048.A0101_rmdup	755977	755987		YPO_RS04445	10
KLE048.A0101_rmdup	756528	756619		YPO_RS04450	91
KLE048.A0101_rmdup	772971	772988		YPO_RS04525	17
KLE048.A0101_rmdup	782239	782253		flgA	14
KLE048.A0101_rmdup	785302	785315		YPO_RS04600	13
KLE048.A0101_rmdup	791755	791786		flgL	31
KLE048.A0101_rmdup	793898	793924		YPO_RS04655	26
KLE048.A0101_rmdup	796062	796089		YPO_RS04660	27
KLE048.A0101_rmdup	802550	802645		YPO_RS04690	95
KLE048.A0101_rmdup	806663	806692		YPO_RS04715	29
KLE048.A0101_rmdup	807626	807695		YPO_RS04720	69
KLE048.A0101_rmdup	807690	807695		YPO_RS04725	5
KLE048.A0101_rmdup	808997	809004		YPO_RS04735	7
KLE048.A0101_rmdup	809214	809241		YPO_RS04735	27
KLE048.A0101_rmdup	811145	811152		YPO_RS04740	7
KLE048.A0101_rmdup	811145	811152		YPO_RS04745	7
KLE048.A0101_rmdup	811233	811240		YPO_RS04745	7
KLE048.A0101_rmdup	816387	816435		YPO_RS04765	48
KLE048.A0101_rmdup	817187	817190		YPO_RS04770	3
KLE048.A0101_rmdup	833835	833836		YPO_RS04800	1
KLE048.A0101_rmdup	836217	836221		YPO_RS04805	4
KLE048.A0101_rmdup	838867	838897		YPO_RS04815	30
KLE048.A0101_rmdup	842070	842079		YPO_RS04830	9
KLE048.A0101_rmdup	845413	845612		YPO_RS04835	199
KLE048.A0101_rmdup	858883	858887		YPO_RS04860	4
KLE048.A0101_rmdup	878595	878597		YPO_RS04935	2
KLE048.A0101_rmdup	884205	884222		YPO_RS04965	17
KLE048.A0101_rmdup	884316	884418		YPO_RS04965	102
KLE048.A0101_rmdup	884491	884501		YPO_RS04965	10
KLE048.A0101_rmdup	884819	884820		YPO_RS04965	1
KLE048.A0101_rmdup	884893	884907		YPO_RS04965	14
KLE048.A0101_rmdup	885666	885699		YPO_RS04975	33
KLE048.A0101_rmdup	886296	886297		YPO_RS04975	1
KLE048.A0101_rmdup	886600	886681		YPO_RS04980	81
KLE048.A0101_rmdup	886754	886777		YPO_RS04980	23
KLE048.A0101_rmdup	886982	887078		gspL	96
KLE048.A0101_rmdup	888123	888223		YPO_RS04990	100
KLE048.A0101_rmdup	888492	888522		YPO_RS04990	30
KLE048.A0101_rmdup	888607	888612		YPO_RS04990	5
KLE048.A0101_rmdup	889183	889403		gspJ	220
KLE048.A0101_rmdup	889951	889970		gspI	19
KLE048.A0101_rmdup	889984	890012		YPO_RS05005	28
KLE048.A0101_rmdup	890252	890278		YPO_RS05005	26
KLE048.A0101_rmdup	893713	893810		gspD	97
KLE048.A0101_rmdup	893944	893983		gspD	39
KLE048.A0101_rmdup	894456	894475		gspD	19
KLE048.A0101_rmdup	894854	894949		gspD	95
KLE048.A0101_rmdup	895452	895496		gspD	44
KLE048.A0101_rmdup	895687	895719		YPO_RS05030	32
KLE048.A0101_rmdup	895910	895938		YPO_RS05030	28
KLE048.A0101_rmdup	896056	896190		YPO_RS05030	134
KLE048.A0101_rmdup	896258	896264		YPO_RS05035	6
KLE048.A0101_rmdup	896399	896456		YPO_RS05035	57
KLE048.A0101_rmdup	896643	896674		YPO_RS05035	31
KLE048.A0101_rmdup	950130	950161		YPO_RS05235	31
KLE048.A0101_rmdup	950329	950346		YPO_RS05235	17
KLE048.A0101_rmdup	953668	953768		YPO_RS05260	100
KLE048.A0101_rmdup	957891	957894		YPO_RS05270	3
KLE048.A0101_rmdup	966538	966555		YPO_RS05330	17
KLE048.A0101_rmdup	993955	993982		gcvP	27
KLE048.A0101_rmdup	1039737	1039781		YPO_RS05675	44
KLE048.A0101_rmdup	1042860	1042865		YPO_RS05675	5
KLE048.A0101_rmdup	1043410	1043443		YPO_RS05675	33
KLE048.A0101_rmdup	1043953	1043964		YPO_RS05675	11
KLE048.A0101_rmdup	1044427	1044493		YPO_RS05675	66
KLE048.A0101_rmdup	1044635	1044636		YPO_RS05675	1
KLE048.A0101_rmdup	1044998	1045104		YPO_RS05675	106
KLE048.A0101_rmdup	1045178	1045179		YPO_RS05675	1
KLE048.A0101_rmdup	1045297	1045318		YPO_RS05675	21
KLE048.A0101_rmdup	1045524	1045661		YPO_RS05675	137
KLE048.A0101_rmdup	1046485	1046557		YPO_RS05675	72
KLE048.A0101_rmdup	1055635	1055637		YPO_RS05720	2
KLE048.A0101_rmdup	1067253	1067368		YPO_RS05765	115
KLE048.A0101_rmdup	1068139	1068174		YPO_RS05770	35
KLE048.A0101_rmdup	1071665	1071667		YPO_RS05785	2
KLE048.A0101_rmdup	1073120	1073157		YPO_RS05795	37
KLE048.A0101_rmdup	1081012	1081018		YPO_RS05815	6
KLE048.A0101_rmdup	1095869	1095885		YPO_RS05870	16
KLE048.A0101_rmdup	1099923	1099932		YPO_RS05890	9
KLE048.A0101_rmdup	1114312	1114322		YPO_RS05935	10
KLE048.A0101_rmdup	1116365	1116367		YPO_RS05935	2
KLE048.A0101_rmdup	1116949	1117004		YPO_RS05940	55
KLE048.A0101_rmdup	1117073	1117092		YPO_RS05940	19
KLE048.A0101_rmdup	1117262	1117301		YPO_RS05940	39
KLE048.A0101_rmdup	1118105	1118110		YPO_RS05940	5
KLE048.A0101_rmdup	1121570	1121585		yapH	15
KLE048.A0101_rmdup	1124075	1124103		yapH	28
KLE048.A0101_rmdup	1124148	1124226		yapH	78
KLE048.A0101_rmdup	1124277	1124284		yapH	7
KLE048.A0101_rmdup	1124383	1124402		yapH	19
KLE048.A0101_rmdup	1124456	1124492		yapH	36
KLE048.A0101_rmdup	1124534	1124541		yapH	7
KLE048.A0101_rmdup	1124604	1124610		yapH	6
KLE048.A0101_rmdup	1124687	1124879		yapH	192
KLE048.A0101_rmdup	1124922	1124935		yapH	13
KLE048.A0101_rmdup	1124984	1125007		yapH	23
KLE048.A0101_rmdup	1125122	1125256		yapH	134
KLE048.A0101_rmdup	1125306	1125395		yapH	89
KLE048.A0101_rmdup	1125443	1125475		yapH	32
KLE048.A0101_rmdup	1125545	1125604		yapH	59
KLE048.A0101_rmdup	1125674	1125678		yapH	4
KLE048.A0101_rmdup	1125807	1125808		yapH	1
KLE048.A0101_rmdup	1129986	1129993		yapH	7
KLE048.A0101_rmdup	1140365	1140377		YPO_RS05985	12
KLE048.A0101_rmdup	1140873	1140878		YPO_RS05985	5
KLE048.A0101_rmdup	1142178	1142185		YPO_RS05985	7
KLE048.A0101_rmdup	1142426	1142437		YPO_RS05985	11
KLE048.A0101_rmdup	1166425	1166429		mltA	4
KLE048.A0101_rmdup	1214697	1214713		metI	16
KLE048.A0101_rmdup	1220099	1220123		YPO_RS06340	24
KLE048.A0101_rmdup	1221216	1221227		YPO_RS06340	11
KLE048.A0101_rmdup	1221600	1221603		YPO_RS06340	3
KLE048.A0101_rmdup	1240950	1241116		YPO_RS06465	166
KLE048.A0101_rmdup	1241543	1241548		YPO_RS06465	5
KLE048.A0101_rmdup	1241935	1241938		YPO_RS06465	3
KLE048.A0101_rmdup	1243040	1243048		YPO_RS06470	8
KLE048.A0101_rmdup	1243214	1243235		YPO_RS06470	21
KLE048.A0101_rmdup	1246788	1246789		YPO_RS06495	1
KLE048.A0101_rmdup	1260337	1260347		odhB	10
KLE048.A0101_rmdup	1269598	1269644		tolA	46
KLE048.A0101_rmdup	1286124	1286125		galE	1
KLE048.A0101_rmdup	1301584	1301597		YPO_RS06780	13
KLE048.A0101_rmdup	1319487	1319511		xapA	24
KLE048.A0101_rmdup	1322240	1322270		YPO_RS06875	30
KLE048.A0101_rmdup	1322947	1322977		YPO_RS06875	30
KLE048.A0101_rmdup	1331065	1331068		phnC	3
KLE048.A0101_rmdup	1331890	1331897		phnD	7
KLE048.A0101_rmdup	1332588	1332593		phnD	5
KLE048.A0101_rmdup	1382264	1382265		YPO_RS07115	1
KLE048.A0101_rmdup	1392308	1392317		ycoA	9
KLE048.A0101_rmdup	1397870	1397913		YPO_RS07190	43
KLE048.A0101_rmdup	1402964	1402984		YPO_RS07225	20
KLE048.A0101_rmdup	1404931	1404939		YPO_RS07230	8
KLE048.A0101_rmdup	1407100	1407109		YPO_RS07240	9
KLE048.A0101_rmdup	1408979	1408984		YPO_RS07260	5
KLE048.A0101_rmdup	1411211	1411218		YPO_RS07270	7
KLE048.A0101_rmdup	1413181	1413192		YPO_RS07280	11
KLE048.A0101_rmdup	1450030	1450045		xylB	15
KLE048.A0101_rmdup	1461781	1461795		YPO_RS07490	14
KLE048.A0101_rmdup	1463132	1463147		psaA	15
KLE048.A0101_rmdup	1463379	1463423		YPO_RS07500	44
KLE048.A0101_rmdup	1465377	1465379		psaC	2
KLE048.A0101_rmdup	1514453	1514465		artQ	12
KLE048.A0101_rmdup	1517040	1517058		YPO_RS07755	18
KLE048.A0101_rmdup	1534411	1534417		cspD	6
KLE048.A0101_rmdup	1539727	1539738		aat	11
KLE048.A0101_rmdup	1565917	1565925		YPO_RS07925	8
KLE048.A0101_rmdup	1566379	1566406		YPO_RS07930	27
KLE048.A0101_rmdup	1566692	1566695		YPO_RS07930	3
KLE048.A0101_rmdup	1567657	1567770		YPO_RS07930	113
KLE048.A0101_rmdup	1567843	1567886		YPO_RS07930	43
KLE048.A0101_rmdup	1647598	1647682		YPO_RS08260	84
KLE048.A0101_rmdup	1652014	1652100		YPO_RS08280	86
KLE048.A0101_rmdup	1652102	1652135		YPO_RS08285	33
KLE048.A0101_rmdup	1652422	1652427		YPO_RS08285	5
KLE048.A0101_rmdup	1658264	1658268		tssC	4
KLE048.A0101_rmdup	1661789	1661793		YPO_RS08330	4
KLE048.A0101_rmdup	1666068	1666074		YPO_RS08345	6
KLE048.A0101_rmdup	1666147	1666148		YPO_RS08345	1
KLE048.A0101_rmdup	1667110	1667113		YPO_RS08345	3
KLE048.A0101_rmdup	1668235	1668238		YPO_RS08350	3
KLE048.A0101_rmdup	1670190	1670199		YPO_RS08350	9
KLE048.A0101_rmdup	1670469	1670551		YPO_RS08355	82
KLE048.A0101_rmdup	1673358	1673371		YPO_RS08365	13
KLE048.A0101_rmdup	1673789	1673845		YPO_RS08365	56
KLE048.A0101_rmdup	1681292	1681304		YPO_RS08385	12
KLE048.A0101_rmdup	1683418	1683441		YPO_RS08395	23
KLE048.A0101_rmdup	1683690	1683693		YPO_RS08395	3
KLE048.A0101_rmdup	1684040	1684157		YPO_RS08400	117
KLE048.A0101_rmdup	1684408	1684495		YPO_RS08400	87
KLE048.A0101_rmdup	1690195	1690244		YPO_RS08430	49
KLE048.A0101_rmdup	1690623	1690627		YPO_RS08430	4
KLE048.A0101_rmdup	1693766	1693771		YPO_RS08440	5
KLE048.A0101_rmdup	1693880	1693922		YPO_RS08440	42
KLE048.A0101_rmdup	1694445	1694462		YPO_RS08445	17
KLE048.A0101_rmdup	1698462	1698467		darE	5
KLE048.A0101_rmdup	1699081	1699139		darE	58
KLE048.A0101_rmdup	1699603	1699607		darD	4
KLE048.A0101_rmdup	1699890	1699893		darC	3
KLE048.A0101_rmdup	1700039	1700068		darC	29
KLE048.A0101_rmdup	1700302	1700373		darC	71
KLE048.A0101_rmdup	1700503	1700552		darC	49
KLE048.A0101_rmdup	1701038	1701143		darC	105
KLE048.A0101_rmdup	1701145	1701164		darB	19
KLE048.A0101_rmdup	1701243	1701257		darB	14
KLE048.A0101_rmdup	1702590	1702605		darB	15
KLE048.A0101_rmdup	1703375	1703383		darB	8
KLE048.A0101_rmdup	1713818	1713823		mglA	5
KLE048.A0101_rmdup	1714315	1714317		mglC	2
KLE048.A0101_rmdup	1717425	1717431		YPO_RS08535	6
KLE048.A0101_rmdup	1725939	1725946		YPO_RS08570	7
KLE048.A0101_rmdup	1726211	1726289		YPO_RS08570	78
KLE048.A0101_rmdup	1739018	1739027		fhuF	9
KLE048.A0101_rmdup	1739303	1739384		YPO_RS08625	81
KLE048.A0101_rmdup	1750120	1750124		YPO_RS08665	4
KLE048.A0101_rmdup	1751994	1752008		YPO_RS08670	14
KLE048.A0101_rmdup	1767758	1767765		YPO_RS08745	7
KLE048.A0101_rmdup	1779028	1779042		YPO_RS08795	14
KLE048.A0101_rmdup	1779028	1779042		YPO_RS08800	14
KLE048.A0101_rmdup	1795901	1795982		YPO_RS08855	81
KLE048.A0101_rmdup	1796159	1796188		YPO_RS08855	29
KLE048.A0101_rmdup	1796977	1796984		YPO_RS08860	7
KLE048.A0101_rmdup	1806997	1807005		YPO_RS08905	8
KLE048.A0101_rmdup	1807585	1807590		YPO_RS08910	5
KLE048.A0101_rmdup	1808286	1808332		bssS	46
KLE048.A0101_rmdup	1820332	1820335		plsX	3
KLE048.A0101_rmdup	1828952	1828955		YPO_RS09020	3
KLE048.A0101_rmdup	1837732	1837741		nagZ	9
KLE048.A0101_rmdup	1878284	1878285		YPO_RS09250	1
KLE048.A0101_rmdup	1888789	1888794		mgtA	5
KLE048.A0101_rmdup	1903596	1903607		yapJ	11
KLE048.A0101_rmdup	1904868	1904873		yapJ	5
KLE048.A0101_rmdup	1910111	1910113		YPO_RS09350	2
KLE048.A0101_rmdup	1921529	1921541		YPO_RS09390	12
KLE048.A0101_rmdup	1936664	1936671		YPO_RS09460	7
KLE048.A0101_rmdup	1938358	1938374		YPO_RS09475	16
KLE048.A0101_rmdup	1940606	1940610		YPO_RS09480	4
KLE048.A0101_rmdup	1983477	1983482		YPO_RS09670	5
KLE048.A0101_rmdup	1999863	1999877		mntP	14
KLE048.A0101_rmdup	2000350	2000374		YPO_RS09760	24
KLE048.A0101_rmdup	2012192	2012198		hpaI	6
KLE048.A0101_rmdup	2013324	2013329		hpaX	5
KLE048.A0101_rmdup	2015835	2015849		hpaC	14
KLE048.A0101_rmdup	2018941	2018945		YPO_RS09845	4
KLE048.A0101_rmdup	2033191	2033277		YPO_RS09920	86
KLE048.A0101_rmdup	2037395	2037427		flhA	32
KLE048.A0101_rmdup	2061740	2061741		YPO_RS10050	1
KLE048.A0101_rmdup	2066505	2066509		fliQ	4
KLE048.A0101_rmdup	2070461	2070468		YPO_RS10110	7
KLE048.A0101_rmdup	2081682	2081694		YPO_RS10170	12
KLE048.A0101_rmdup	2081777	2081785		YPO_RS10170	8
KLE048.A0101_rmdup	2085720	2085739		fliD	19
KLE048.A0101_rmdup	2090846	2090851		YPO_RS10210	5
KLE048.A0101_rmdup	2107230	2107241		cycA	11
KLE048.A0101_rmdup	2117239	2117281		YPO_RS10350	42
KLE048.A0101_rmdup	2117604	2117607		YPO_RS10355	3
KLE048.A0101_rmdup	2117736	2117771		YPO_RS10355	35
KLE048.A0101_rmdup	2118016	2118103		hcp	87
KLE048.A0101_rmdup	2118336	2118347		hcp	11
KLE048.A0101_rmdup	2123483	2123489		YPO_RS10405	6
KLE048.A0101_rmdup	2126399	2126408		YPO_RS10415	9
KLE048.A0101_rmdup	2126769	2126786		YPO_RS10420	17
KLE048.A0101_rmdup	2139279	2139283		YPO_RS10505	4
KLE048.A0101_rmdup	2143220	2143227		ybtE	7
KLE048.A0101_rmdup	2167192	2167201		ybtX	9
KLE048.A0101_rmdup	2170514	2170519		YPO_RS10570	5
KLE048.A0101_rmdup	2173111	2173112		YPO_RS10585	1
KLE048.A0101_rmdup	2183688	2183694		YPO_RS10620	6
KLE048.A0101_rmdup	2187727	2187770		YPO_RS10640	43
KLE048.A0101_rmdup	2187795	2187806		YPO_RS10645	11
KLE048.A0101_rmdup	2237356	2237375		YPO_RS10835	19
KLE048.A0101_rmdup	2252978	2252989		YPO_RS10910	11
KLE048.A0101_rmdup	2253382	2253388		YPO_RS10910	6
KLE048.A0101_rmdup	2256125	2256171		YPO_RS10925	46
KLE048.A0101_rmdup	2256534	2256556		YPO_RS10925	22
KLE048.A0101_rmdup	2256736	2256740		YPO_RS10925	4
KLE048.A0101_rmdup	2258446	2258460		YPO_RS10930	14
KLE048.A0101_rmdup	2258636	2258647		YPO_RS10935	11
KLE048.A0101_rmdup	2259056	2259058		YPO_RS10935	2
KLE048.A0101_rmdup	2259152	2259173		YPO_RS10935	21
KLE048.A0101_rmdup	2265710	2265715		YPO_RS10955	5
KLE048.A0101_rmdup	2266292	2266316		YPO_RS10965	24
KLE048.A0101_rmdup	2266722	2266729		YPO_RS10965	7
KLE048.A0101_rmdup	2268809	2268860		YPO_RS10975	51
KLE048.A0101_rmdup	2269863	2269873		YPO_RS10980	10
KLE048.A0101_rmdup	2277298	2277300		YPO_RS11015	2
KLE048.A0101_rmdup	2299998	2300030		YPO_RS11135	32
KLE048.A0101_rmdup	2303887	2303893		YPO_RS11155	6
KLE048.A0101_rmdup	2316463	2316521		YPO_RS11220	58
KLE048.A0101_rmdup	2317647	2317712		YPO_RS11220	65
KLE048.A0101_rmdup	2319486	2319550		YPO_RS11225	64
KLE048.A0101_rmdup	2322815	2322831		YPO_RS11225	16
KLE048.A0101_rmdup	2375656	2375665		YPO_RS11510	9
KLE048.A0101_rmdup	2376953	2376970		YPO_RS11520	17
KLE048.A0101_rmdup	2416709	2416711		YPO_RS11730	2
KLE048.A0101_rmdup	2434240	2434258		selD	18
KLE048.A0101_rmdup	2439604	2439606		YPO_RS11830	2
KLE048.A0101_rmdup	2439682	2439793		YPO_RS11830	111
KLE048.A0101_rmdup	2439927	2439984		YPO_RS11830	57
KLE048.A0101_rmdup	2440183	2440228		YPO_RS11830	45
KLE048.A0101_rmdup	2442313	2442339		YPO_RS11850	26
KLE048.A0101_rmdup	2442313	2442377		purU	64
KLE048.A0101_rmdup	2454421	2454430		adhE	9
KLE048.A0101_rmdup	2463709	2463714		YPO_RS11930	5
KLE048.A0101_rmdup	2475850	2475866		YPO_RS12005	16
KLE048.A0101_rmdup	2489398	2489408		sohB	10
KLE048.A0101_rmdup	2490227	2490232		sohB	5
KLE048.A0101_rmdup	2490377	2490394		YPO_RS12085	17
KLE048.A0101_rmdup	2491184	2491221		topA	37
KLE048.A0101_rmdup	2495860	2495962		YPO_RS12105	102
KLE048.A0101_rmdup	2503055	2503085		YPO_RS12135	30
KLE048.A0101_rmdup	2519275	2519313		YPO_RS12215	38
KLE048.A0101_rmdup	2521123	2521125		rsxC	2
KLE048.A0101_rmdup	2541929	2541933		YPO_RS12300	4
KLE048.A0101_rmdup	2549509	2549514		YPO_RS12330	5
KLE048.A0101_rmdup	2553225	2553237		clcB	12
KLE048.A0101_rmdup	2554373	2554633		YPO_RS12355	260
KLE048.A0101_rmdup	2554658	2555065		YPO_RS12360	407
KLE048.A0101_rmdup	2555162	2555608		YPO_RS12365	446
KLE048.A0101_rmdup	2555780	2556832		YPO_RS12370	1052
KLE048.A0101_rmdup	2556844	2557161		YPO_RS12375	317
KLE048.A0101_rmdup	2557164	2557415		YPO_RS12380	251
KLE048.A0101_rmdup	2557451	2557684		YPO_RS12385	233
KLE048.A0101_rmdup	2557749	2559461		YPO_RS12390	1712
KLE048.A0101_rmdup	2559474	2559761		YPO_RS12395	287
KLE048.A0101_rmdup	2559765	2560790		YPO_RS12400	1025
KLE048.A0101_rmdup	2560790	2562034		YPO_RS12405	1244
KLE048.A0101_rmdup	2562123	2562371		YPO_RS12410	248
KLE048.A0101_rmdup	2562568	2562765		YPO_RS12415	197
KLE048.A0101_rmdup	2565808	2565832		YPO_RS12435	24
KLE048.A0101_rmdup	2577773	2577810		YPO_RS12465	37
KLE048.A0101_rmdup	2582968	2582972		YPO_RS12495	4
KLE048.A0101_rmdup	2630107	2630138		YPO_RS12680	31
KLE048.A0101_rmdup	2677014	2677025		rnt	11
KLE048.A0101_rmdup	2683490	2683495		YPO_RS12940	5
KLE048.A0101_rmdup	2714922	2714928		YPO_RS13075	6
KLE048.A0101_rmdup	2716588	2716607		arnF	19
KLE048.A0101_rmdup	2748811	2748816		YPO_RS13255	5
KLE048.A0101_rmdup	2749120	2749126		YPO_RS13255	6
KLE048.A0101_rmdup	2754131	2754192		YPO_RS13285	61
KLE048.A0101_rmdup	2755005	2755022		YPO_RS13290	17
KLE048.A0101_rmdup	2755414	2755505		YPO_RS13290	91
KLE048.A0101_rmdup	2784839	2784847		YPO_RS13410	8
KLE048.A0101_rmdup	2785305	2785319		YPO_RS13415	14
KLE048.A0101_rmdup	2786212	2786230		YPO_RS13425	18
KLE048.A0101_rmdup	2790089	2790114		YPO_RS13445	25
KLE048.A0101_rmdup	2792621	2792622		cdiA	1
KLE048.A0101_rmdup	2801018	2801022		YPO_RS13460	4
KLE048.A0101_rmdup	2813940	2814030		YPO_RS13510	90
KLE048.A0101_rmdup	2814142	2814219		YPO_RS13510	77
KLE048.A0101_rmdup	2828452	2828455		YPO_RS13585	3
KLE048.A0101_rmdup	2830478	2830484		YPO_RS13595	6
KLE048.A0101_rmdup	2838166	2838167		menF	1
KLE048.A0101_rmdup	2853937	2853964		YPO_RS13690	27
KLE048.A0101_rmdup	2854060	2854073		YPO_RS13690	13
KLE048.A0101_rmdup	2854168	2854214		YPO_RS13690	46
KLE048.A0101_rmdup	2854650	2854704		YPO_RS13690	54
KLE048.A0101_rmdup	2880464	2880473		ackA	9
KLE048.A0101_rmdup	2885776	2885790		YPO_RS13815	14
KLE048.A0101_rmdup	2885812	2885849		YPO_RS13820	37
KLE048.A0101_rmdup	2887074	2887932		YPO_RS13825	858
KLE048.A0101_rmdup	2887989	2893967		YPO_RS13830	5978
KLE048.A0101_rmdup	2894374	2894922		YPO_RS13835	548
KLE048.A0101_rmdup	2895617	2896471		YPO_RS13840	854
KLE048.A0101_rmdup	2896777	2897242		YPO_RS13845	465
KLE048.A0101_rmdup	2897282	2898094		YPO_RS13845	812
KLE048.A0101_rmdup	2898124	2898303		YPO_RS13845	179
KLE048.A0101_rmdup	2898338	2900263		iolD	1925
KLE048.A0101_rmdup	2907543	2907549		iolC	6
KLE048.A0101_rmdup	2908143	2908146		iolC	3
KLE048.A0101_rmdup	2909158	2909165		iolE	7
KLE048.A0101_rmdup	2910254	2910290		iolB	36
KLE048.A0101_rmdup	2910493	2910513		YPO_RS13895	20
KLE048.A0101_rmdup	2915428	2915475		YPO_RS13925	47
KLE048.A0101_rmdup	2957463	2957490		glnS	27
KLE048.A0101_rmdup	2980423	2980544		YPO_RS14235	121
KLE048.A0101_rmdup	2983543	2983556		YPO_RS14250	13
KLE048.A0101_rmdup	2998366	2998369		yut	3
KLE048.A0101_rmdup	3003133	3003139		YPO_RS14355	6
KLE048.A0101_rmdup	3003281	3003290		YPO_RS14355	9
KLE048.A0101_rmdup	3011984	3011997		YPO_RS14400	13
KLE048.A0101_rmdup	3012186	3012221		YPO_RS14405	35
KLE048.A0101_rmdup	3013570	3013571		kdbD	1
KLE048.A0101_rmdup	3021115	3021165		YPO_RS14440	50
KLE048.A0101_rmdup	3037256	3037264		YPO_RS14530	8
KLE048.A0101_rmdup	3038766	3038770		nadB	4
KLE048.A0101_rmdup	3042612	3042649		YPO_RS14560	37
KLE048.A0101_rmdup	3043412	3043415		lepA	3
KLE048.A0101_rmdup	3056178	3056195		YPO_RS14610	17
KLE048.A0101_rmdup	3060601	3060602		YPO_RS14625	1
KLE048.A0101_rmdup	3065954	3065964		YPO_RS14660	10
KLE048.A0101_rmdup	3111106	3111109		YPO_RS14875	3
KLE048.A0101_rmdup	3114645	3114656		yfcE	11
KLE048.A0101_rmdup	3118531	3118536		YPO_RS14910	5
KLE048.A0101_rmdup	3120316	3120561		YPO_RS14920	245
KLE048.A0101_rmdup	3121234	3121815		YPO_RS14925	581
KLE048.A0101_rmdup	3122083	3122484		YPO_RS14930	401
KLE048.A0101_rmdup	3122717	3123118		YPO_RS14935	401
KLE048.A0101_rmdup	3123130	3123702		YPO_RS14940	572
KLE048.A0101_rmdup	3123726	3123977		YPO_RS14945	251
KLE048.A0101_rmdup	3124016	3124255		YPO_RS14950	239
KLE048.A0101_rmdup	3125064	3126980		yapC	1916
KLE048.A0101_rmdup	3127174	3127226		YPO_RS14960	52
KLE048.A0101_rmdup	3127515	3128096		YPO_RS14965	581
KLE048.A0101_rmdup	3128498	3128528		YPO_RS14975	30
KLE048.A0101_rmdup	3130158	3132365		YPO_RS14980	2207
KLE048.A0101_rmdup	3132358	3132474		YPO_RS14985	116
KLE048.A0101_rmdup	3132506	3132888		YPO_RS14985	382
KLE048.A0101_rmdup	3133047	3135428		YPO_RS14990	2381
KLE048.A0101_rmdup	3135507	3137135		YPO_RS14995	1628
KLE048.A0101_rmdup	3137608	3138459		YPO_RS15000	851
KLE048.A0101_rmdup	3138485	3139474		YPO_RS15005	989
KLE048.A0101_rmdup	3139529	3140419		YPO_RS15010	890
KLE048.A0101_rmdup	3142684	3142989		YPO_RS15025	305
KLE048.A0101_rmdup	3143086	3143487		YPO_RS15030	401
KLE048.A0101_rmdup	3143469	3144174		YPO_RS15035	705
KLE048.A0101_rmdup	3145295	3145308		YPO_RS15040	13
KLE048.A0101_rmdup	3145845	3145852		YPO_RS15040	7
KLE048.A0101_rmdup	3179515	3179522		YPO_RS15205	7
KLE048.A0101_rmdup	3197802	3197882		YPO_RS15265	80
KLE048.A0101_rmdup	3198226	3198228		YPO_RS15270	2
KLE048.A0101_rmdup	3198280	3198283		YPO_RS15275	3
KLE048.A0101_rmdup	3200071	3200095		YPO_RS15280	24
KLE048.A0101_rmdup	3200192	3200195		YPO_RS15280	3
KLE048.A0101_rmdup	3200192	3200215		YPO_RS15285	23
KLE048.A0101_rmdup	3200390	3200423		YPO_RS15285	33
KLE048.A0101_rmdup	3200571	3200587		YPO_RS15285	16
KLE048.A0101_rmdup	3200713	3200774		YPO_RS15290	61
KLE048.A0101_rmdup	3200824	3200966		YPO_RS15290	142
KLE048.A0101_rmdup	3201045	3201046		YPO_RS15290	1
KLE048.A0101_rmdup	3201314	3201333		YPO_RS15295	19
KLE048.A0101_rmdup	3201567	3201871		YPO_RS15300	304
KLE048.A0101_rmdup	3202235	3202295		YPO_RS15305	60
KLE048.A0101_rmdup	3205218	3205221		guaB	3
KLE048.A0101_rmdup	3221343	3221345		YPO_RS15385	2
KLE048.A0101_rmdup	3221670	3221675		YPO_RS15385	5
KLE048.A0101_rmdup	3221748	3221760		YPO_RS15385	12
KLE048.A0101_rmdup	3221833	3221874		YPO_RS15385	41
KLE048.A0101_rmdup	3221961	3221968		YPO_RS15385	7
KLE048.A0101_rmdup	3222072	3222105		YPO_RS15385	33
KLE048.A0101_rmdup	3222151	3222178		YPO_RS15385	27
KLE048.A0101_rmdup	3222622	3222651		YPO_RS15385	29
KLE048.A0101_rmdup	3225494	3225539		yapA	45
KLE048.A0101_rmdup	3225576	3225621		yapA	45
KLE048.A0101_rmdup	3230082	3230084		YPO_RS15395	2
KLE048.A0101_rmdup	3262696	3262764		YPO_RS15560	68
KLE048.A0101_rmdup	3278677	3278690		tssK	13
KLE048.A0101_rmdup	3280147	3280151		YPO_RS15645	4
KLE048.A0101_rmdup	3284502	3284527		YPO_RS15665	25
KLE048.A0101_rmdup	3285809	3285817		YPO_RS15675	8
KLE048.A0101_rmdup	3302775	3302791		YPO_RS15735	16
KLE048.A0101_rmdup	3302893	3302894		YPO_RS15735	1
KLE048.A0101_rmdup	3309048	3309056		YPO_RS15755	8
KLE048.A0101_rmdup	3311456	3311461		YPO_RS15770	5
KLE048.A0101_rmdup	3311858	3311877		YPO_RS15770	19
KLE048.A0101_rmdup	3315961	3315968		YPO_RS15785	7
KLE048.A0101_rmdup	3320256	3320272		YPO_RS15810	16
KLE048.A0101_rmdup	3352769	3352777		YPO_RS15995	8
KLE048.A0101_rmdup	3356090	3356095		YPO_RS16010	5
KLE048.A0101_rmdup	3356144	3356147		YPO_RS16010	3
KLE048.A0101_rmdup	3363505	3363527		YPO_RS16040	22
KLE048.A0101_rmdup	3363726	3363759		YPO_RS16040	33
KLE048.A0101_rmdup	3364193	3364239		YPO_RS16040	46
KLE048.A0101_rmdup	3364685	3364737		YPO_RS16040	52
KLE048.A0101_rmdup	3372751	3372755		YPO_RS16075	4
KLE048.A0101_rmdup	3380576	3380604		YPO_RS16115	28
KLE048.A0101_rmdup	3383751	3383753		YPO_RS16125	2
KLE048.A0101_rmdup	3383831	3383879		YPO_RS16125	48
KLE048.A0101_rmdup	3385314	3385327		hemF	13
KLE048.A0101_rmdup	3389315	3389316		nudK	1
KLE048.A0101_rmdup	3402522	3402542		YPO_RS16205	20
KLE048.A0101_rmdup	3403242	3403264		YPO_RS16210	22
KLE048.A0101_rmdup	3405496	3405532		YPO_RS16220	36
KLE048.A0101_rmdup	3405635	3405644		YPO_RS16220	9
KLE048.A0101_rmdup	3422070	3422075		YPO_RS16305	5
KLE048.A0101_rmdup	3450522	3450532		YPO_RS16430	10
KLE048.A0101_rmdup	3454812	3454912		fepE	100
KLE048.A0101_rmdup	3455009	3455012		cpsG	3
KLE048.A0101_rmdup	3455901	3455930		cpsG	29
KLE048.A0101_rmdup	3456549	3456563		YPO_RS16450	14
KLE048.A0101_rmdup	3457107	3457130		YPO_RS16450	23
KLE048.A0101_rmdup	3457133	3457139		YPO_RS16455	6
KLE048.A0101_rmdup	3460862	3460871		YPO_RS16470	9
KLE048.A0101_rmdup	3461838	3461854		YPO_RS16470	16
KLE048.A0101_rmdup	3463321	3463330		YPO_RS16480	9
KLE048.A0101_rmdup	3463734	3463968		YPO_RS16480	234
KLE048.A0101_rmdup	3464136	3464208		YPO_RS16480	72
KLE048.A0101_rmdup	3464843	3464873		YPO_RS16485	30
KLE048.A0101_rmdup	3465029	3465082		YPO_RS16485	53
KLE048.A0101_rmdup	3465320	3465321		YPO_RS16485	1
KLE048.A0101_rmdup	3465437	3465556		YPO_RS16485	119
KLE048.A0101_rmdup	3465567	3465596		YPO_RS16490	29
KLE048.A0101_rmdup	3466254	3466454		YPO_RS16490	200
KLE048.A0101_rmdup	3466558	3466648		YPO_RS16490	90
KLE048.A0101_rmdup	3466826	3466873		YPO_RS16490	47
KLE048.A0101_rmdup	3466984	3467001		YPO_RS16495	17
KLE048.A0101_rmdup	3467608	3467629		YPO_RS16495	21
KLE048.A0101_rmdup	3468697	3468698		YPO_RS16500	1
KLE048.A0101_rmdup	3473066	3473101		YPO_RS16520	35
KLE048.A0101_rmdup	3473366	3473373		YPO_RS16520	7
KLE048.A0101_rmdup	3495167	3495170		YPO_RS16605	3
KLE048.A0101_rmdup	3496965	3497039		YPO_RS16620	74
KLE048.A0101_rmdup	3497657	3497658		tomB	1
KLE048.A0101_rmdup	3527263	3527267		YPO_RS16755	4
KLE048.A0101_rmdup	3547439	3547480		YPO_RS16860	41
KLE048.A0101_rmdup	3547992	3548147		YPO_RS16865	155
KLE048.A0101_rmdup	3566187	3566194		YPO_RS16945	7
KLE048.A0101_rmdup	3572076	3572117		YPO_RS16965	41
KLE048.A0101_rmdup	3583074	3583075		YPO_RS17010	1
KLE048.A0101_rmdup	3590097	3590128		YPO_RS17045	31
KLE048.A0101_rmdup	3592444	3592537		YPO_RS17055	93
KLE048.A0101_rmdup	3593015	3593082		YPO_RS17055	67
KLE048.A0101_rmdup	3593253	3593292		YPO_RS17055	39
KLE048.A0101_rmdup	3600006	3600007		YPO_RS17080	1
KLE048.A0101_rmdup	3618891	3618902		YPO_RS17145	11
KLE048.A0101_rmdup	3637161	3637164		ygaH	3
KLE048.A0101_rmdup	3641058	3641067		emrB	9
KLE048.A0101_rmdup	3649931	3649939		YPO_RS17290	8
KLE048.A0101_rmdup	3654005	3654009		YPO_RS17305	4
KLE048.A0101_rmdup	3654246	3654250		YPO_RS17310	4
KLE048.A0101_rmdup	3657845	3657848		pgeF	3
KLE048.A0101_rmdup	3672561	3672562		trmD	1
KLE048.A0101_rmdup	3672973	3672996		trmD	23
KLE048.A0101_rmdup	3701736	3701737		katG	1
KLE048.A0101_rmdup	3703948	3703949		katG	1
KLE048.A0101_rmdup	3704392	3704409		cybC	17
KLE048.A0101_rmdup	3706019	3706038		dmsD	19
KLE048.A0101_rmdup	3731750	3731776		YPO_RS17675	26
KLE048.A0101_rmdup	3755415	3755423		cobA	8
KLE048.A0101_rmdup	3760426	3760433		cysJ	7
KLE048.A0101_rmdup	3806999	3807005		cueO	6
KLE048.A0101_rmdup	3817779	3817791		lpdA	12
KLE048.A0101_rmdup	3825954	3825956		YPO_RS18075	2
KLE048.A0101_rmdup	3835023	3835052		coaE	29
KLE048.A0101_rmdup	3877982	3877994		YPO_RS18325	12
KLE048.A0101_rmdup	3878588	3878595		YPO_RS18325	7
KLE048.A0101_rmdup	3906352	3906379		infB	27
KLE048.A0101_rmdup	3915367	3915375		greA	8
KLE048.A0101_rmdup	3949721	3949738		yjfP	17
KLE048.A0101_rmdup	3960461	3960475		yraP	14
KLE048.A0101_rmdup	3962045	3962048		elbB	3
KLE048.A0101_rmdup	3980188	3980191		degQ	3
KLE048.A0101_rmdup	3993744	3993748		rpoN	4
KLE048.A0101_rmdup	4012864	4012869		tssM	5
KLE048.A0101_rmdup	4017239	4017244		YPO_RS18995	5
KLE048.A0101_rmdup	4024704	4024755		YPO_RS19020	51
KLE048.A0101_rmdup	4026670	4026672		YPO_RS19045	2
KLE048.A0101_rmdup	4033531	4033578		YPO_RS19055	47
KLE048.A0101_rmdup	4033763	4033794		YPO_RS19060	31
KLE048.A0101_rmdup	4033950	4033967		YPO_RS19060	17
KLE048.A0101_rmdup	4034667	4034682		YPO_RS19065	15
KLE048.A0101_rmdup	4065290	4065295		cspA	5
KLE048.A0101_rmdup	4082232	4082238		msrQ	6
KLE048.A0101_rmdup	4098633	4098670		YPO_RS19365	37
KLE048.A0101_rmdup	4098797	4098843		YPO_RS19365	46
KLE048.A0101_rmdup	4098948	4099000		YPO_RS19365	52
KLE048.A0101_rmdup	4099365	4099443		YPO_RS19365	78
KLE048.A0101_rmdup	4100967	4101082		YPO_RS19365	115
KLE048.A0101_rmdup	4101298	4101317		YPO_RS19365	19
KLE048.A0101_rmdup	4101368	4101491		YPO_RS19365	123
KLE048.A0101_rmdup	4101516	4102576		YPO_RS19370	1060
KLE048.A0101_rmdup	4102696	4102697		YPO_RS19370	1
KLE048.A0101_rmdup	4102737	4102821		YPO_RS19370	84
KLE048.A0101_rmdup	4102857	4102886		YPO_RS19370	29
KLE048.A0101_rmdup	4102934	4102935		YPO_RS19370	1
KLE048.A0101_rmdup	4103038	4103052		YPO_RS19370	14
KLE048.A0101_rmdup	4103128	4103142		YPO_RS19370	14
KLE048.A0101_rmdup	4103211	4103268		YPO_RS19370	57
KLE048.A0101_rmdup	4103426	4103439		YPO_RS19370	13
KLE048.A0101_rmdup	4110168	4110186		YPO_RS19390	18
KLE048.A0101_rmdup	4112708	4112781		YPO_RS19400	73
KLE048.A0101_rmdup	4112867	4112882		YPO_RS19400	15
KLE048.A0101_rmdup	4113036	4113078		YPO_RS19400	42
KLE048.A0101_rmdup	4113126	4113129		YPO_RS19400	3
KLE048.A0101_rmdup	4113934	4113939		YPO_RS19405	5
KLE048.A0101_rmdup	4113981	4114108		YPO_RS19405	127
KLE048.A0101_rmdup	4114163	4114181		YPO_RS19405	18
KLE048.A0101_rmdup	4114219	4114221		YPO_RS19405	2
KLE048.A0101_rmdup	4116422	4116423		YPO_RS19405	1
KLE048.A0101_rmdup	4116740	4116834		YPO_RS19410	94
KLE048.A0101_rmdup	4125072	4125074		YPO_RS19450	2
KLE048.A0101_rmdup	4139210	4139227		tssE	17
KLE048.A0101_rmdup	4142770	4142840		YPO_RS19535	70
KLE048.A0101_rmdup	4176219	4176223		YPO_RS19645	4
KLE048.A0101_rmdup	4203521	4203522		rpoB	1
KLE048.A0101_rmdup	4219432	4219433		YPO_RS19855	1
KLE048.A0101_rmdup	4223144	4223145		YPO_RS19870	1
KLE048.A0101_rmdup	4226959	4226992		YPO_RS19900	33
KLE048.A0101_rmdup	4233892	4233901		ubiD	9
KLE048.A0101_rmdup	4235790	4235793		hemB	3
KLE048.A0101_rmdup	4251476	4251493		YPO_RS20015	17
KLE048.A0101_rmdup	4264354	4264360		YPO_RS20070	6
KLE048.A0101_rmdup	4268314	4268321		YPO_RS20085	7
KLE048.A0101_rmdup	4269655	4269665		YPO_RS20095	10
KLE048.A0101_rmdup	4280863	4280873		ftsY	10
KLE048.A0101_rmdup	4298031	4298038		pldB	7
KLE048.A0101_rmdup	4304826	4304837		rarD	11
KLE048.A0101_rmdup	4323020	4323024		hemY	4
KLE048.A0101_rmdup	4328880	4328881		wzyE	1
KLE048.A0101_rmdup	4349644	4349697		YPO_RS20480	53
KLE048.A0101_rmdup	4349945	4349999		YPO_RS20480	54
KLE048.A0101_rmdup	4353971	4353985		YPO_RS20500	14
KLE048.A0101_rmdup	4354078	4354082		YPO_RS20500	4
KLE048.A0101_rmdup	4359333	4359365		YPO_RS20515	32
KLE048.A0101_rmdup	4359509	4359560		YPO_RS20515	51
KLE048.A0101_rmdup	4360256	4360266		YPO_RS20525	10
KLE048.A0101_rmdup	4360662	4360689		YPO_RS20530	27
KLE048.A0101_rmdup	4367169	4367199		YPO_RS20565	30
KLE048.A0101_rmdup	4368277	4368373		YPO_RS20575	96
KLE048.A0101_rmdup	4376542	4376546		YPO_RS20610	4
KLE048.A0101_rmdup	4388483	4388487		YPO_RS20670	4
KLE048.A0101_rmdup	4389731	4389736		YPO_RS20670	5
KLE048.A0101_rmdup	4400768	4400770		YPO_RS20725	2
KLE048.A0101_rmdup	4401542	4401546		YPO_RS20725	4
KLE048.A0101_rmdup	4405922	4405961		YPO_RS20745	39
KLE048.A0101_rmdup	4408299	4408320		YPO_RS20745	21
KLE048.A0101_rmdup	4417600	4417603		YPO_RS20775	3
KLE048.A0101_rmdup	4438357	4438359		YPO_RS20830	2
KLE048.A0101_rmdup	4462714	4462728		YPO_RS20940	14
KLE048.A0101_rmdup	4471649	4471650		gdhA	1
KLE048.A0101_rmdup	4479338	4479340		gorA	2
KLE048.A0101_rmdup	4483639	4483670		YPO_RS21020	31
KLE048.A0101_rmdup	4483793	4483819		YPO_RS21020	26
KLE048.A0101_rmdup	4483893	4483896		YPO_RS21020	3
KLE048.A0101_rmdup	4484196	4484207		YPO_RS21025	11
KLE048.A0101_rmdup	4484402	4484420		YPO_RS21025	18
KLE048.A0101_rmdup	4484582	4484599		YPO_RS21025	17
KLE048.A0101_rmdup	4484601	4484631		YPO_RS21030	30
KLE048.A0101_rmdup	4484946	4485024		YPO_RS21030	78
KLE048.A0101_rmdup	4516783	4516789		YPO_RS21140	6
KLE048.A0101_rmdup	4528811	4528819		YPO_RS21190	8
KLE048.A0101_rmdup	4534843	4534849		YPO_RS21210	6
KLE048.A0101_rmdup	4535140	4535158		YPO_RS21215	18
KLE048.A0101_rmdup	4545797	4545915		YPO_RS21280	118
KLE048.A0101_rmdup	4561584	4561598		YPO_RS21340	14
KLE048.A0101_rmdup	4561843	4561867		YPO_RS21340	24
KLE048.A0101_rmdup	4567694	4567772		YPO_RS21370	78
KLE048.A0101_rmdup	4569616	4569630		selB	14
KLE048.A0101_rmdup	4572564	4572569		YPO_RS21400	5
KLE048.A0101_rmdup	4583547	4583577		YPO_RS21440	30
KLE048.A0101_rmdup	4589126	4589130		YPO_RS21465	4
KLE048.A0101_rmdup	4596425	4596441		YPO_RS21500	16
KLE048.A0101_rmdup	4601662	4601722		YPO_RS21520	60
KLE048.A0101_rmdup	4601951	4602029		YPO_RS21520	78
KLE048.A0101_rmdup	4609002	4609005		YPO_RS21555	3
KLE048.A0101_rmdup	4625906	4625960		YPO_RS21625	54
KLE048.A0101_rmdup	4626292	4626310		YPO_RS21630	18
KLZ001ss_ds.merged.samereadgroup.cleaned	4016	4025		ravA	9
KLZ001ss_ds.merged.samereadgroup.cleaned	10222	10237		YPO_RS01055	15
KLZ001ss_ds.merged.samereadgroup.cleaned	10657	10680		YPO_RS01055	23
KLZ001ss_ds.merged.samereadgroup.cleaned	73926	73931		envC	5
KLZ001ss_ds.merged.samereadgroup.cleaned	74279	74280		envC	1
KLZ001ss_ds.merged.samereadgroup.cleaned	74634	74638		envC	4
KLZ001ss_ds.merged.samereadgroup.cleaned	81498	81508		ada	10
KLZ001ss_ds.merged.samereadgroup.cleaned	124943	124947		YPO_RS01600	4
KLZ001ss_ds.merged.samereadgroup.cleaned	131973	131976		malT	3
KLZ001ss_ds.merged.samereadgroup.cleaned	151669	151670		pckA	1
KLZ001ss_ds.merged.samereadgroup.cleaned	156708	156717		YPO_RS01725	9
KLZ001ss_ds.merged.samereadgroup.cleaned	159893	159896		mrcA	3
KLZ001ss_ds.merged.samereadgroup.cleaned	160271	160274		mrcA	3
KLZ001ss_ds.merged.samereadgroup.cleaned	160837	160841		mrcA	4
KLZ001ss_ds.merged.samereadgroup.cleaned	166160	166170		aroB	10
KLZ001ss_ds.merged.samereadgroup.cleaned	183067	183075		YPO_RS01835	8
KLZ001ss_ds.merged.samereadgroup.cleaned	196672	196701		YPO_RS01895	29
KLZ001ss_ds.merged.samereadgroup.cleaned	196800	196803		YPO_RS01895	3
KLZ001ss_ds.merged.samereadgroup.cleaned	197744	197756		YPO_RS01900	12
KLZ001ss_ds.merged.samereadgroup.cleaned	236807	236831		mscL	24
KLZ001ss_ds.merged.samereadgroup.cleaned	238103	238120		trkA	17
KLZ001ss_ds.merged.samereadgroup.cleaned	249534	249545		actP	11
KLZ001ss_ds.merged.samereadgroup.cleaned	261171	261174		sctD	3
KLZ001ss_ds.merged.samereadgroup.cleaned	263091	263103		sctI	12
KLZ001ss_ds.merged.samereadgroup.cleaned	265933	265949		YPO_RS02340	16
KLZ001ss_ds.merged.samereadgroup.cleaned	266501	266527		YPO_RS02340	26
KLZ001ss_ds.merged.samereadgroup.cleaned	270253	270281		YPO_RS02360	28
KLZ001ss_ds.merged.samereadgroup.cleaned	272552	272559		YPO_RS02380	7
KLZ001ss_ds.merged.samereadgroup.cleaned	275511	275538		YPO_RS02395	27
KLZ001ss_ds.merged.samereadgroup.cleaned	288385	288394		YPO_RS02455	9
KLZ001ss_ds.merged.samereadgroup.cleaned	288875	288899		YPO_RS02455	24
KLZ001ss_ds.merged.samereadgroup.cleaned	315069	315100		yapK	31
KLZ001ss_ds.merged.samereadgroup.cleaned	326939	326946		dnaB	7
KLZ001ss_ds.merged.samereadgroup.cleaned	342576	342582		rhaR	6
KLZ001ss_ds.merged.samereadgroup.cleaned	345089	345114		YPO_RS02690	25
KLZ001ss_ds.merged.samereadgroup.cleaned	345937	345960		YPO_RS02695	23
KLZ001ss_ds.merged.samereadgroup.cleaned	347272	347281		YPO_RS02695	9
KLZ001ss_ds.merged.samereadgroup.cleaned	347673	347718		YPO_RS02695	45
KLZ001ss_ds.merged.samereadgroup.cleaned	360464	360481		fxsA	17
KLZ001ss_ds.merged.samereadgroup.cleaned	363907	363915		YPO_RS02760	8
KLZ001ss_ds.merged.samereadgroup.cleaned	371041	371057		YPO_RS02805	16
KLZ001ss_ds.merged.samereadgroup.cleaned	371142	371146		YPO_RS02805	4
KLZ001ss_ds.merged.samereadgroup.cleaned	396149	396169		rnr	20
KLZ001ss_ds.merged.samereadgroup.cleaned	401048	401049		YPO_RS02925	1
KLZ001ss_ds.merged.samereadgroup.cleaned	407805	407828		YPO_RS02955	23
KLZ001ss_ds.merged.samereadgroup.cleaned	408273	408335		YPO_RS02955	62
KLZ001ss_ds.merged.samereadgroup.cleaned	408655	408666		YPO_RS02955	11
KLZ001ss_ds.merged.samereadgroup.cleaned	409200	409205		YPO_RS02960	5
KLZ001ss_ds.merged.samereadgroup.cleaned	409522	409523		YPO_RS02960	1
KLZ001ss_ds.merged.samereadgroup.cleaned	409522	409523		YPO_RS02965	1
KLZ001ss_ds.merged.samereadgroup.cleaned	409863	409883		YPO_RS02965	20
KLZ001ss_ds.merged.samereadgroup.cleaned	410033	410075		YPO_RS02965	42
KLZ001ss_ds.merged.samereadgroup.cleaned	410379	410396		YPO_RS02965	17
KLZ001ss_ds.merged.samereadgroup.cleaned	410823	410891		YPO_RS02965	68
KLZ001ss_ds.merged.samereadgroup.cleaned	409567	409699		YPO_RS02965	132
KLZ001ss_ds.merged.samereadgroup.cleaned	426059	426101		lsrF	42
KLZ001ss_ds.merged.samereadgroup.cleaned	431289	431347		YPO_RS03065	58
KLZ001ss_ds.merged.samereadgroup.cleaned	446229	446262		YPO_RS03120	33
KLZ001ss_ds.merged.samereadgroup.cleaned	446335	446361		YPO_RS03120	26
KLZ001ss_ds.merged.samereadgroup.cleaned	490259	490272		tal	13
KLZ001ss_ds.merged.samereadgroup.cleaned	494993	495067		YPO_RS03330	74
KLZ001ss_ds.merged.samereadgroup.cleaned	495158	495169		YPO_RS03330	11
KLZ001ss_ds.merged.samereadgroup.cleaned	495222	495321		YPO_RS03330	99
KLZ001ss_ds.merged.samereadgroup.cleaned	495737	495786		YPO_RS03330	49
KLZ001ss_ds.merged.samereadgroup.cleaned	506929	506931		ileS	2
KLZ001ss_ds.merged.samereadgroup.cleaned	520835	520837		YPO_RS03445	2
KLZ001ss_ds.merged.samereadgroup.cleaned	541495	541507		tssH	12
KLZ001ss_ds.merged.samereadgroup.cleaned	550612	550615		tssK	3
KLZ001ss_ds.merged.samereadgroup.cleaned	590602	590610		rsmH	8
KLZ001ss_ds.merged.samereadgroup.cleaned	592031	592088		YPO_RS03735	57
KLZ001ss_ds.merged.samereadgroup.cleaned	594888	594893		murE	5
KLZ001ss_ds.merged.samereadgroup.cleaned	595335	595364		murF	29
KLZ001ss_ds.merged.samereadgroup.cleaned	602539	602543		murC	4
KLZ001ss_ds.merged.samereadgroup.cleaned	653723	653738		cdiA	15
KLZ001ss_ds.merged.samereadgroup.cleaned	659287	659288		cdiI	1
KLZ001ss_ds.merged.samereadgroup.cleaned	660149	660191		YPO_RS04005	42
KLZ001ss_ds.merged.samereadgroup.cleaned	660640	660654		YPO_RS04010	14
KLZ001ss_ds.merged.samereadgroup.cleaned	666290	666337		YPO_RS04030	47
KLZ001ss_ds.merged.samereadgroup.cleaned	667973	667987		YPO_RS04035	14
KLZ001ss_ds.merged.samereadgroup.cleaned	672595	672602		YPO_RS04050	7
KLZ001ss_ds.merged.samereadgroup.cleaned	672650	672674		YPO_RS04050	24
KLZ001ss_ds.merged.samereadgroup.cleaned	673952	673978		YPO_RS04055	26
KLZ001ss_ds.merged.samereadgroup.cleaned	674615	674633		YPO_RS04055	18
KLZ001ss_ds.merged.samereadgroup.cleaned	687944	687960		YPO_RS04115	16
KLZ001ss_ds.merged.samereadgroup.cleaned	696905	696918		YPO_RS04170	13
KLZ001ss_ds.merged.samereadgroup.cleaned	704988	705016		plsY	28
KLZ001ss_ds.merged.samereadgroup.cleaned	744817	744845		exbB	28
KLZ001ss_ds.merged.samereadgroup.cleaned	745516	745517		exbB	1
KLZ001ss_ds.merged.samereadgroup.cleaned	746388	746395		YPO_RS04390	7
KLZ001ss_ds.merged.samereadgroup.cleaned	747817	747823		YPO_RS04390	6
KLZ001ss_ds.merged.samereadgroup.cleaned	749316	749323		YPO_RS04405	7
KLZ001ss_ds.merged.samereadgroup.cleaned	750075	750103		YPO_RS04410	28
KLZ001ss_ds.merged.samereadgroup.cleaned	750241	750282		YPO_RS04410	41
KLZ001ss_ds.merged.samereadgroup.cleaned	750453	750462		YPO_RS04410	9
KLZ001ss_ds.merged.samereadgroup.cleaned	750459	750530		YPO_RS04415	71
KLZ001ss_ds.merged.samereadgroup.cleaned	750928	750976		YPO_RS04415	48
KLZ001ss_ds.merged.samereadgroup.cleaned	751023	751027		YPO_RS04415	4
KLZ001ss_ds.merged.samereadgroup.cleaned	751123	751200		YPO_RS04415	77
KLZ001ss_ds.merged.samereadgroup.cleaned	752637	752679		YPO_RS04425	42
KLZ001ss_ds.merged.samereadgroup.cleaned	753735	753738		YPO_RS04425	3
KLZ001ss_ds.merged.samereadgroup.cleaned	753868	753881		YPO_RS04430	13
KLZ001ss_ds.merged.samereadgroup.cleaned	755000	755005		YPO_RS04440	5
KLZ001ss_ds.merged.samereadgroup.cleaned	755315	755372		YPO_RS04440	57
KLZ001ss_ds.merged.samereadgroup.cleaned	755369	755374		YPO_RS04445	5
KLZ001ss_ds.merged.samereadgroup.cleaned	756541	756542		YPO_RS04450	1
KLZ001ss_ds.merged.samereadgroup.cleaned	756680	756695		YPO_RS04450	15
KLZ001ss_ds.merged.samereadgroup.cleaned	758451	758458		YPO_RS04465	7
KLZ001ss_ds.merged.samereadgroup.cleaned	772970	772992		YPO_RS04525	22
KLZ001ss_ds.merged.samereadgroup.cleaned	781511	781518		flgA	7
KLZ001ss_ds.merged.samereadgroup.cleaned	782249	782266		flgA	17
KLZ001ss_ds.merged.samereadgroup.cleaned	785301	785323		YPO_RS04600	22
KLZ001ss_ds.merged.samereadgroup.cleaned	793899	793910		YPO_RS04655	11
KLZ001ss_ds.merged.samereadgroup.cleaned	801486	801491		fliS	5
KLZ001ss_ds.merged.samereadgroup.cleaned	802547	802649		YPO_RS04690	102
KLZ001ss_ds.merged.samereadgroup.cleaned	807138	807140		YPO_RS04715	2
KLZ001ss_ds.merged.samereadgroup.cleaned	807620	807680		YPO_RS04720	60
KLZ001ss_ds.merged.samereadgroup.cleaned	809026	809031		YPO_RS04735	5
KLZ001ss_ds.merged.samereadgroup.cleaned	809178	809236		YPO_RS04735	58
KLZ001ss_ds.merged.samereadgroup.cleaned	816392	816434		YPO_RS04765	42
KLZ001ss_ds.merged.samereadgroup.cleaned	816730	816737		YPO_RS04765	7
KLZ001ss_ds.merged.samereadgroup.cleaned	833835	833848		YPO_RS04800	13
KLZ001ss_ds.merged.samereadgroup.cleaned	838855	838892		YPO_RS04815	37
KLZ001ss_ds.merged.samereadgroup.cleaned	841501	841515		YPO_RS04825	14
KLZ001ss_ds.merged.samereadgroup.cleaned	842076	842081		YPO_RS04830	5
KLZ001ss_ds.merged.samereadgroup.cleaned	845416	845616		YPO_RS04835	200
KLZ001ss_ds.merged.samereadgroup.cleaned	846139	846153		YPO_RS04835	14
KLZ001ss_ds.merged.samereadgroup.cleaned	884205	884206		YPO_RS04965	1
KLZ001ss_ds.merged.samereadgroup.cleaned	884224	884240		YPO_RS04965	16
KLZ001ss_ds.merged.samereadgroup.cleaned	884417	884507		YPO_RS04965	90
KLZ001ss_ds.merged.samereadgroup.cleaned	884903	884907		YPO_RS04965	4
KLZ001ss_ds.merged.samereadgroup.cleaned	885548	885552		YPO_RS04975	4
KLZ001ss_ds.merged.samereadgroup.cleaned	885670	885725		YPO_RS04975	55
KLZ001ss_ds.merged.samereadgroup.cleaned	886616	886694		YPO_RS04980	78
KLZ001ss_ds.merged.samereadgroup.cleaned	886757	886778		YPO_RS04980	21
KLZ001ss_ds.merged.samereadgroup.cleaned	887098	887100		gspL	2
KLZ001ss_ds.merged.samereadgroup.cleaned	887475	887484		gspL	9
KLZ001ss_ds.merged.samereadgroup.cleaned	888152	888196		YPO_RS04990	44
KLZ001ss_ds.merged.samereadgroup.cleaned	888435	888469		YPO_RS04990	34
KLZ001ss_ds.merged.samereadgroup.cleaned	889198	889208		gspJ	10
KLZ001ss_ds.merged.samereadgroup.cleaned	889520	889537		gspJ	17
KLZ001ss_ds.merged.samereadgroup.cleaned	889935	889970		gspI	35
KLZ001ss_ds.merged.samereadgroup.cleaned	889984	890011		YPO_RS05005	27
KLZ001ss_ds.merged.samereadgroup.cleaned	890248	890277		YPO_RS05005	29
KLZ001ss_ds.merged.samereadgroup.cleaned	893704	893818		gspD	114
KLZ001ss_ds.merged.samereadgroup.cleaned	894066	894077		gspD	11
KLZ001ss_ds.merged.samereadgroup.cleaned	894849	894875		gspD	26
KLZ001ss_ds.merged.samereadgroup.cleaned	894956	894966		gspD	10
KLZ001ss_ds.merged.samereadgroup.cleaned	895453	895489		gspD	36
KLZ001ss_ds.merged.samereadgroup.cleaned	895687	895754		YPO_RS05030	67
KLZ001ss_ds.merged.samereadgroup.cleaned	895898	895929		YPO_RS05030	31
KLZ001ss_ds.merged.samereadgroup.cleaned	896050	896059		YPO_RS05030	9
KLZ001ss_ds.merged.samereadgroup.cleaned	896114	896190		YPO_RS05030	76
KLZ001ss_ds.merged.samereadgroup.cleaned	896660	896674		YPO_RS05035	14
KLZ001ss_ds.merged.samereadgroup.cleaned	902656	902657		yapM	1
KLZ001ss_ds.merged.samereadgroup.cleaned	903962	903964		YPO_RS05060	2
KLZ001ss_ds.merged.samereadgroup.cleaned	930397	930406		YPO_RS05170	9
KLZ001ss_ds.merged.samereadgroup.cleaned	949941	949945		YPO_RS05235	4
KLZ001ss_ds.merged.samereadgroup.cleaned	950128	950189		YPO_RS05235	61
KLZ001ss_ds.merged.samereadgroup.cleaned	953031	953033		YPO_RS05250	2
KLZ001ss_ds.merged.samereadgroup.cleaned	953651	953764		YPO_RS05260	113
KLZ001ss_ds.merged.samereadgroup.cleaned	954416	954417		YPO_RS05260	1
KLZ001ss_ds.merged.samereadgroup.cleaned	962607	962610		YPO_RS05295	3
KLZ001ss_ds.merged.samereadgroup.cleaned	966520	966524		YPO_RS05330	4
KLZ001ss_ds.merged.samereadgroup.cleaned	976922	976923		dsbC	1
KLZ001ss_ds.merged.samereadgroup.cleaned	976998	977004		dsbC	6
KLZ001ss_ds.merged.samereadgroup.cleaned	993958	993991		gcvP	33
KLZ001ss_ds.merged.samereadgroup.cleaned	997019	997036		ubiI	17
KLZ001ss_ds.merged.samereadgroup.cleaned	1039220	1039230		YPO_RS05675	10
KLZ001ss_ds.merged.samereadgroup.cleaned	1039757	1039764		YPO_RS05675	7
KLZ001ss_ds.merged.samereadgroup.cleaned	1043953	1043967		YPO_RS05675	14
KLZ001ss_ds.merged.samereadgroup.cleaned	1044428	1044460		YPO_RS05675	32
KLZ001ss_ds.merged.samereadgroup.cleaned	1044507	1044518		YPO_RS05675	11
KLZ001ss_ds.merged.samereadgroup.cleaned	1044629	1044655		YPO_RS05675	26
KLZ001ss_ds.merged.samereadgroup.cleaned	1044793	1044802		YPO_RS05675	9
KLZ001ss_ds.merged.samereadgroup.cleaned	1045039	1045078		YPO_RS05675	39
KLZ001ss_ds.merged.samereadgroup.cleaned	1045539	1045590		YPO_RS05675	51
KLZ001ss_ds.merged.samereadgroup.cleaned	1045830	1045867		YPO_RS05675	37
KLZ001ss_ds.merged.samereadgroup.cleaned	1046492	1046583		YPO_RS05675	91
KLZ001ss_ds.merged.samereadgroup.cleaned	1052516	1052524		mltC	8
KLZ001ss_ds.merged.samereadgroup.cleaned	1060469	1060479		YPO_RS05735	10
KLZ001ss_ds.merged.samereadgroup.cleaned	1067346	1067389		YPO_RS05765	43
KLZ001ss_ds.merged.samereadgroup.cleaned	1067376	1067393		YPO_RS05770	17
KLZ001ss_ds.merged.samereadgroup.cleaned	1068142	1068185		YPO_RS05770	43
KLZ001ss_ds.merged.samereadgroup.cleaned	1073124	1073157		YPO_RS05795	33
KLZ001ss_ds.merged.samereadgroup.cleaned	1073841	1073860		YPO_RS05795	19
KLZ001ss_ds.merged.samereadgroup.cleaned	1081404	1081406		YPO_RS05815	2
KLZ001ss_ds.merged.samereadgroup.cleaned	1084033	1084038		tssK	5
KLZ001ss_ds.merged.samereadgroup.cleaned	1085046	1085048		tssC	2
KLZ001ss_ds.merged.samereadgroup.cleaned	1088717	1088733		YPO_RS05845	16
KLZ001ss_ds.merged.samereadgroup.cleaned	1094217	1094225		YPO_RS05865	8
KLZ001ss_ds.merged.samereadgroup.cleaned	1095705	1095709		YPO_RS05870	4
KLZ001ss_ds.merged.samereadgroup.cleaned	1099695	1099697		YPO_RS05890	2
KLZ001ss_ds.merged.samereadgroup.cleaned	1114951	1114952		YPO_RS05935	1
KLZ001ss_ds.merged.samereadgroup.cleaned	1116378	1116387		YPO_RS05935	9
KLZ001ss_ds.merged.samereadgroup.cleaned	1116715	1116722		YPO_RS05940	7
KLZ001ss_ds.merged.samereadgroup.cleaned	1116982	1116988		YPO_RS05940	6
KLZ001ss_ds.merged.samereadgroup.cleaned	1117067	1117128		YPO_RS05940	61
KLZ001ss_ds.merged.samereadgroup.cleaned	1117270	1117290		YPO_RS05940	20
KLZ001ss_ds.merged.samereadgroup.cleaned	1118004	1118019		YPO_RS05940	15
KLZ001ss_ds.merged.samereadgroup.cleaned	1118079	1118091		YPO_RS05940	12
KLZ001ss_ds.merged.samereadgroup.cleaned	1120042	1120079		yapH	37
KLZ001ss_ds.merged.samereadgroup.cleaned	1121576	1121589		yapH	13
KLZ001ss_ds.merged.samereadgroup.cleaned	1121828	1121832		yapH	4
KLZ001ss_ds.merged.samereadgroup.cleaned	1123980	1123986		yapH	6
KLZ001ss_ds.merged.samereadgroup.cleaned	1124077	1124188		yapH	111
KLZ001ss_ds.merged.samereadgroup.cleaned	1124224	1124269		yapH	45
KLZ001ss_ds.merged.samereadgroup.cleaned	1124387	1124493		yapH	106
KLZ001ss_ds.merged.samereadgroup.cleaned	1124537	1124540		yapH	3
KLZ001ss_ds.merged.samereadgroup.cleaned	1124609	1124617		yapH	8
KLZ001ss_ds.merged.samereadgroup.cleaned	1124693	1124873		yapH	180
KLZ001ss_ds.merged.samereadgroup.cleaned	1124926	1124950		yapH	24
KLZ001ss_ds.merged.samereadgroup.cleaned	1124994	1125004		yapH	10
KLZ001ss_ds.merged.samereadgroup.cleaned	1125121	1125129		yapH	8
KLZ001ss_ds.merged.samereadgroup.cleaned	1125164	1125258		yapH	94
KLZ001ss_ds.merged.samereadgroup.cleaned	1125318	1125398		yapH	80
KLZ001ss_ds.merged.samereadgroup.cleaned	1125444	1125471		yapH	27
KLZ001ss_ds.merged.samereadgroup.cleaned	1125544	1125602		yapH	58
KLZ001ss_ds.merged.samereadgroup.cleaned	1125801	1125810		yapH	9
KLZ001ss_ds.merged.samereadgroup.cleaned	1126245	1126272		yapH	27
KLZ001ss_ds.merged.samereadgroup.cleaned	1127626	1127637		yapH	11
KLZ001ss_ds.merged.samereadgroup.cleaned	1135677	1135690		YPO_RS05970	13
KLZ001ss_ds.merged.samereadgroup.cleaned	1142189	1142211		YPO_RS05985	22
KLZ001ss_ds.merged.samereadgroup.cleaned	1142424	1142437		YPO_RS05985	13
KLZ001ss_ds.merged.samereadgroup.cleaned	1166430	1166439		mltA	9
KLZ001ss_ds.merged.samereadgroup.cleaned	1190649	1190656		ispU	7
KLZ001ss_ds.merged.samereadgroup.cleaned	1221200	1221222		YPO_RS06340	22
KLZ001ss_ds.merged.samereadgroup.cleaned	1237271	1237289		YPO_RS06440	18
KLZ001ss_ds.merged.samereadgroup.cleaned	1240946	1241160		YPO_RS06465	214
KLZ001ss_ds.merged.samereadgroup.cleaned	1241546	1241565		YPO_RS06465	19
KLZ001ss_ds.merged.samereadgroup.cleaned	1242349	1242361		YPO_RS06470	12
KLZ001ss_ds.merged.samereadgroup.cleaned	1242596	1242615		YPO_RS06470	19
KLZ001ss_ds.merged.samereadgroup.cleaned	1243175	1243240		YPO_RS06470	65
KLZ001ss_ds.merged.samereadgroup.cleaned	1249006	1249034		recN	28
KLZ001ss_ds.merged.samereadgroup.cleaned	1251902	1251907		YPO_RS06525	5
KLZ001ss_ds.merged.samereadgroup.cleaned	1260350	1260354		odhB	4
KLZ001ss_ds.merged.samereadgroup.cleaned	1269587	1269642		tolA	55
KLZ001ss_ds.merged.samereadgroup.cleaned	1273808	1273810		nadA	2
KLZ001ss_ds.merged.samereadgroup.cleaned	1275762	1275777		zitB	15
KLZ001ss_ds.merged.samereadgroup.cleaned	1278060	1278064		aroG	4
KLZ001ss_ds.merged.samereadgroup.cleaned	1286116	1286149		galE	33
KLZ001ss_ds.merged.samereadgroup.cleaned	1298673	1298684		bioF	11
KLZ001ss_ds.merged.samereadgroup.cleaned	1300304	1300315		bioD	11
KLZ001ss_ds.merged.samereadgroup.cleaned	1322379	1322443		YPO_RS06875	64
KLZ001ss_ds.merged.samereadgroup.cleaned	1331070	1331075		phnC	5
KLZ001ss_ds.merged.samereadgroup.cleaned	1332498	1332501		phnD	3
KLZ001ss_ds.merged.samereadgroup.cleaned	1341138	1341146		urtE	8
KLZ001ss_ds.merged.samereadgroup.cleaned	1390687	1390696		YPO_RS07150	9
KLZ001ss_ds.merged.samereadgroup.cleaned	1391776	1391809		ycoA	33
KLZ001ss_ds.merged.samereadgroup.cleaned	1392307	1392317		ycoA	10
KLZ001ss_ds.merged.samereadgroup.cleaned	1397656	1397662		YPO_RS07190	6
KLZ001ss_ds.merged.samereadgroup.cleaned	1402978	1402980		YPO_RS07225	2
KLZ001ss_ds.merged.samereadgroup.cleaned	1413174	1413182		YPO_RS07280	8
KLZ001ss_ds.merged.samereadgroup.cleaned	1421386	1421390		YPO_RS07330	4
KLZ001ss_ds.merged.samereadgroup.cleaned	1427206	1427220		yejF	14
KLZ001ss_ds.merged.samereadgroup.cleaned	1438648	1438656		YPO_RS07390	8
KLZ001ss_ds.merged.samereadgroup.cleaned	1461800	1461810		YPO_RS07490	10
KLZ001ss_ds.merged.samereadgroup.cleaned	1461879	1461893		YPO_RS07490	14
KLZ001ss_ds.merged.samereadgroup.cleaned	1462100	1462112		YPO_RS07490	12
KLZ001ss_ds.merged.samereadgroup.cleaned	1463379	1463423		YPO_RS07500	44
KLZ001ss_ds.merged.samereadgroup.cleaned	1463525	1463527		YPO_RS07500	2
KLZ001ss_ds.merged.samereadgroup.cleaned	1466556	1466559		psaC	3
KLZ001ss_ds.merged.samereadgroup.cleaned	1477010	1477044		YPO_RS07545	34
KLZ001ss_ds.merged.samereadgroup.cleaned	1505618	1505634		YPO_RS07680	16
KLZ001ss_ds.merged.samereadgroup.cleaned	1512233	1512234		YPO_RS07720	1
KLZ001ss_ds.merged.samereadgroup.cleaned	1514453	1514468		artQ	15
KLZ001ss_ds.merged.samereadgroup.cleaned	1539726	1539759		aat	33
KLZ001ss_ds.merged.samereadgroup.cleaned	1552292	1552302		YPO_RS07880	10
KLZ001ss_ds.merged.samereadgroup.cleaned	1554917	1554938		YPO_RS07890	21
KLZ001ss_ds.merged.samereadgroup.cleaned	1561181	1561182		focA	1
KLZ001ss_ds.merged.samereadgroup.cleaned	1562467	1562491		YPO_RS07915	24
KLZ001ss_ds.merged.samereadgroup.cleaned	1566365	1566369		YPO_RS07930	4
KLZ001ss_ds.merged.samereadgroup.cleaned	1566685	1566689		YPO_RS07930	4
KLZ001ss_ds.merged.samereadgroup.cleaned	1567395	1567396		YPO_RS07930	1
KLZ001ss_ds.merged.samereadgroup.cleaned	1567732	1567785		YPO_RS07930	53
KLZ001ss_ds.merged.samereadgroup.cleaned	1567839	1567881		YPO_RS07930	42
KLZ001ss_ds.merged.samereadgroup.cleaned	1569082	1569086		serC	4
KLZ001ss_ds.merged.samereadgroup.cleaned	1580954	1580956		YPO_RS07975	2
KLZ001ss_ds.merged.samereadgroup.cleaned	1591695	1591703		mukB	8
KLZ001ss_ds.merged.samereadgroup.cleaned	1595753	1595755		ldtD	2
KLZ001ss_ds.merged.samereadgroup.cleaned	1615546	1615553		pqiA	7
KLZ001ss_ds.merged.samereadgroup.cleaned	1628611	1628615		sulA	4
KLZ001ss_ds.merged.samereadgroup.cleaned	1646383	1646385		YPO_RS08250	2
KLZ001ss_ds.merged.samereadgroup.cleaned	1647598	1647616		YPO_RS08260	18
KLZ001ss_ds.merged.samereadgroup.cleaned	1652053	1652100		YPO_RS08280	47
KLZ001ss_ds.merged.samereadgroup.cleaned	1652102	1652123		YPO_RS08285	21
KLZ001ss_ds.merged.samereadgroup.cleaned	1653831	1653841		YPO_RS08295	10
KLZ001ss_ds.merged.samereadgroup.cleaned	1658264	1658266		tssC	2
KLZ001ss_ds.merged.samereadgroup.cleaned	1661196	1661205		YPO_RS08330	9
KLZ001ss_ds.merged.samereadgroup.cleaned	1666069	1666070		YPO_RS08345	1
KLZ001ss_ds.merged.samereadgroup.cleaned	1666147	1666149		YPO_RS08345	2
KLZ001ss_ds.merged.samereadgroup.cleaned	1668239	1668240		YPO_RS08350	1
KLZ001ss_ds.merged.samereadgroup.cleaned	1669985	1669999		YPO_RS08350	14
KLZ001ss_ds.merged.samereadgroup.cleaned	1670168	1670212		YPO_RS08350	44
KLZ001ss_ds.merged.samereadgroup.cleaned	1670491	1670497		YPO_RS08355	6
KLZ001ss_ds.merged.samereadgroup.cleaned	1670936	1670943		YPO_RS08355	7
KLZ001ss_ds.merged.samereadgroup.cleaned	1673341	1673395		YPO_RS08365	54
KLZ001ss_ds.merged.samereadgroup.cleaned	1673832	1673845		YPO_RS08365	13
KLZ001ss_ds.merged.samereadgroup.cleaned	1674328	1674343		YPO_RS08370	15
KLZ001ss_ds.merged.samereadgroup.cleaned	1677051	1677068		YPO_RS08380	17
KLZ001ss_ds.merged.samereadgroup.cleaned	1683660	1683680		YPO_RS08395	20
KLZ001ss_ds.merged.samereadgroup.cleaned	1684049	1684218		YPO_RS08400	169
KLZ001ss_ds.merged.samereadgroup.cleaned	1684434	1684485		YPO_RS08400	51
KLZ001ss_ds.merged.samereadgroup.cleaned	1684848	1684852		tssF	4
KLZ001ss_ds.merged.samereadgroup.cleaned	1685359	1685360		tssF	1
KLZ001ss_ds.merged.samereadgroup.cleaned	1685813	1685814		tssF	1
KLZ001ss_ds.merged.samereadgroup.cleaned	1688626	1688658		YPO_RS08425	32
KLZ001ss_ds.merged.samereadgroup.cleaned	1690304	1690309		YPO_RS08430	5
KLZ001ss_ds.merged.samereadgroup.cleaned	1690614	1690659		YPO_RS08430	45
KLZ001ss_ds.merged.samereadgroup.cleaned	1692160	1692167		YPO_RS08435	7
KLZ001ss_ds.merged.samereadgroup.cleaned	1698466	1698470		darE	4
KLZ001ss_ds.merged.samereadgroup.cleaned	1699113	1699119		darE	6
KLZ001ss_ds.merged.samereadgroup.cleaned	1699920	1699924		darC	4
KLZ001ss_ds.merged.samereadgroup.cleaned	1700290	1700370		darC	80
KLZ001ss_ds.merged.samereadgroup.cleaned	1701037	1701047		darC	10
KLZ001ss_ds.merged.samereadgroup.cleaned	1701118	1701137		darC	19
KLZ001ss_ds.merged.samereadgroup.cleaned	1701365	1701424		darB	59
KLZ001ss_ds.merged.samereadgroup.cleaned	1701506	1701530		darB	24
KLZ001ss_ds.merged.samereadgroup.cleaned	1703376	1703389		darB	13
KLZ001ss_ds.merged.samereadgroup.cleaned	1706865	1706870		YPO_RS08495	5
KLZ001ss_ds.merged.samereadgroup.cleaned	1712907	1712940		mglA	33
KLZ001ss_ds.merged.samereadgroup.cleaned	1713768	1713793		mglA	25
KLZ001ss_ds.merged.samereadgroup.cleaned	1717437	1717440		YPO_RS08535	3
KLZ001ss_ds.merged.samereadgroup.cleaned	1722676	1722698		YPO_RS08560	22
KLZ001ss_ds.merged.samereadgroup.cleaned	1725941	1725973		YPO_RS08570	32
KLZ001ss_ds.merged.samereadgroup.cleaned	1726221	1726339		YPO_RS08570	118
KLZ001ss_ds.merged.samereadgroup.cleaned	1739332	1739375		YPO_RS08625	43
KLZ001ss_ds.merged.samereadgroup.cleaned	1739690	1739693		YPO_RS08625	3
KLZ001ss_ds.merged.samereadgroup.cleaned	1740829	1740841		YPO_RS08625	12
KLZ001ss_ds.merged.samereadgroup.cleaned	1761911	1761917		hisC	6
KLZ001ss_ds.merged.samereadgroup.cleaned	1765816	1765823		YPO_RS08735	7
KLZ001ss_ds.merged.samereadgroup.cleaned	1778550	1778564		YPO_RS08795	14
KLZ001ss_ds.merged.samereadgroup.cleaned	1795902	1795924		YPO_RS08855	22
KLZ001ss_ds.merged.samereadgroup.cleaned	1796129	1796172		YPO_RS08855	43
KLZ001ss_ds.merged.samereadgroup.cleaned	1803900	1803919		YPO_RS08900	19
KLZ001ss_ds.merged.samereadgroup.cleaned	1806996	1807005		YPO_RS08905	9
KLZ001ss_ds.merged.samereadgroup.cleaned	1808303	1808339		bssS	36
KLZ001ss_ds.merged.samereadgroup.cleaned	1814404	1814410		rne	6
KLZ001ss_ds.merged.samereadgroup.cleaned	1828215	1828220		mltG	5
KLZ001ss_ds.merged.samereadgroup.cleaned	1861610	1861612		purB	2
KLZ001ss_ds.merged.samereadgroup.cleaned	1865686	1865699		rluE	13
KLZ001ss_ds.merged.samereadgroup.cleaned	1878284	1878350		YPO_RS09250	66
KLZ001ss_ds.merged.samereadgroup.cleaned	1901660	1901684		YPO_RS09335	24
KLZ001ss_ds.merged.samereadgroup.cleaned	1903603	1903605		yapJ	2
KLZ001ss_ds.merged.samereadgroup.cleaned	1905807	1905815		yapJ	8
KLZ001ss_ds.merged.samereadgroup.cleaned	1915010	1915012		cheR	2
KLZ001ss_ds.merged.samereadgroup.cleaned	1919639	1919644		YPO_RS09390	5
KLZ001ss_ds.merged.samereadgroup.cleaned	1933839	1933878		YPO_RS09455	39
KLZ001ss_ds.merged.samereadgroup.cleaned	1938371	1938374		YPO_RS09475	3
KLZ001ss_ds.merged.samereadgroup.cleaned	1959937	1959941		YPO_RS09555	4
KLZ001ss_ds.merged.samereadgroup.cleaned	1983819	1983838		YPO_RS09675	19
KLZ001ss_ds.merged.samereadgroup.cleaned	1987807	1987809		YPO_RS09705	2
KLZ001ss_ds.merged.samereadgroup.cleaned	1999336	1999339		mntP	3
KLZ001ss_ds.merged.samereadgroup.cleaned	1999863	1999879		mntP	16
KLZ001ss_ds.merged.samereadgroup.cleaned	2000334	2000380		YPO_RS09760	46
KLZ001ss_ds.merged.samereadgroup.cleaned	2005256	2005265		YPO_RS09780	9
KLZ001ss_ds.merged.samereadgroup.cleaned	2010789	2010793		YPO_RS09810	4
KLZ001ss_ds.merged.samereadgroup.cleaned	2012185	2012230		hpaI	45
KLZ001ss_ds.merged.samereadgroup.cleaned	2013319	2013352		hpaX	33
KLZ001ss_ds.merged.samereadgroup.cleaned	2015843	2015852		hpaC	9
KLZ001ss_ds.merged.samereadgroup.cleaned	2020158	2020161		pabB	3
KLZ001ss_ds.merged.samereadgroup.cleaned	2033276	2033281		YPO_RS09920	5
KLZ001ss_ds.merged.samereadgroup.cleaned	2046388	2046394		YPO_RS09990	6
KLZ001ss_ds.merged.samereadgroup.cleaned	2050023	2050032		YPO_RS10010	9
KLZ001ss_ds.merged.samereadgroup.cleaned	2053331	2053342		flgK	11
KLZ001ss_ds.merged.samereadgroup.cleaned	2054155	2054158		flgK	3
KLZ001ss_ds.merged.samereadgroup.cleaned	2060375	2060404		YPO_RS10045	29
KLZ001ss_ds.merged.samereadgroup.cleaned	2060621	2060637		YPO_RS10045	16
KLZ001ss_ds.merged.samereadgroup.cleaned	2070350	2070368		YPO_RS10110	18
KLZ001ss_ds.merged.samereadgroup.cleaned	2074471	2074472		fliG	1
KLZ001ss_ds.merged.samereadgroup.cleaned	2080217	2080237		YPO_RS10165	20
KLZ001ss_ds.merged.samereadgroup.cleaned	2083444	2083449		YPO_RS10175	5
KLZ001ss_ds.merged.samereadgroup.cleaned	2088383	2088391		YPO_RS10200	8
KLZ001ss_ds.merged.samereadgroup.cleaned	2090829	2090851		YPO_RS10210	22
KLZ001ss_ds.merged.samereadgroup.cleaned	2101980	2101999		YPO_RS10260	19
KLZ001ss_ds.merged.samereadgroup.cleaned	2107217	2107228		cycA	11
KLZ001ss_ds.merged.samereadgroup.cleaned	2109793	2109794		YPO_RS10290	1
KLZ001ss_ds.merged.samereadgroup.cleaned	2117285	2117287		YPO_RS10350	2
KLZ001ss_ds.merged.samereadgroup.cleaned	2117739	2117786		YPO_RS10355	47
KLZ001ss_ds.merged.samereadgroup.cleaned	2118032	2118121		hcp	89
KLZ001ss_ds.merged.samereadgroup.cleaned	2118337	2118347		hcp	10
KLZ001ss_ds.merged.samereadgroup.cleaned	2126392	2126401		YPO_RS10415	9
KLZ001ss_ds.merged.samereadgroup.cleaned	2126495	2126552		YPO_RS10415	57
KLZ001ss_ds.merged.samereadgroup.cleaned	2126564	2126566		YPO_RS10420	2
KLZ001ss_ds.merged.samereadgroup.cleaned	2126755	2126801		YPO_RS10420	46
KLZ001ss_ds.merged.samereadgroup.cleaned	2129550	2129563		YPO_RS10435	13
KLZ001ss_ds.merged.samereadgroup.cleaned	2138522	2138526		YPO_RS10495	4
KLZ001ss_ds.merged.samereadgroup.cleaned	2139166	2139179		YPO_RS10505	13
KLZ001ss_ds.merged.samereadgroup.cleaned	2139412	2139414		YPO_RS10505	2
KLZ001ss_ds.merged.samereadgroup.cleaned	2142276	2142299		fyuA	23
KLZ001ss_ds.merged.samereadgroup.cleaned	2143194	2143214		ybtE	20
KLZ001ss_ds.merged.samereadgroup.cleaned	2144036	2144045		ybtE	9
KLZ001ss_ds.merged.samereadgroup.cleaned	2145164	2145184		ybtT	20
KLZ001ss_ds.merged.samereadgroup.cleaned	2146040	2146046		ybtU	6
KLZ001ss_ds.merged.samereadgroup.cleaned	2148863	2148864		irp1	1
KLZ001ss_ds.merged.samereadgroup.cleaned	2149495	2149497		irp1	2
KLZ001ss_ds.merged.samereadgroup.cleaned	2150854	2150899		irp1	45
KLZ001ss_ds.merged.samereadgroup.cleaned	2151954	2151981		irp1	27
KLZ001ss_ds.merged.samereadgroup.cleaned	2153263	2153267		irp1	4
KLZ001ss_ds.merged.samereadgroup.cleaned	2153336	2153367		irp1	31
KLZ001ss_ds.merged.samereadgroup.cleaned	2154177	2154183		irp1	6
KLZ001ss_ds.merged.samereadgroup.cleaned	2154335	2154339		irp1	4
KLZ001ss_ds.merged.samereadgroup.cleaned	2154567	2154568		irp1	1
KLZ001ss_ds.merged.samereadgroup.cleaned	2156780	2156792		irp2	12
KLZ001ss_ds.merged.samereadgroup.cleaned	2159338	2159345		irp2	7
KLZ001ss_ds.merged.samereadgroup.cleaned	2164484	2164488		ybtP	4
KLZ001ss_ds.merged.samereadgroup.cleaned	2165832	2165833		ybtQ	1
KLZ001ss_ds.merged.samereadgroup.cleaned	2167138	2167156		ybtX	18
KLZ001ss_ds.merged.samereadgroup.cleaned	2167199	2167214		ybtX	15
KLZ001ss_ds.merged.samereadgroup.cleaned	2167353	2167368		ybtX	15
KLZ001ss_ds.merged.samereadgroup.cleaned	2167691	2167693		ybtX	2
KLZ001ss_ds.merged.samereadgroup.cleaned	2172666	2172678		YPO_RS10585	12
KLZ001ss_ds.merged.samereadgroup.cleaned	2173070	2173084		YPO_RS10585	14
KLZ001ss_ds.merged.samereadgroup.cleaned	2174352	2174360		YPO_RS10590	8
KLZ001ss_ds.merged.samereadgroup.cleaned	2183694	2183702		YPO_RS10620	8
KLZ001ss_ds.merged.samereadgroup.cleaned	2187762	2187770		YPO_RS10640	8
KLZ001ss_ds.merged.samereadgroup.cleaned	2210974	2211011		tehB	37
KLZ001ss_ds.merged.samereadgroup.cleaned	2218051	2218061		YPO_RS10760	10
KLZ001ss_ds.merged.samereadgroup.cleaned	2227755	2227757		YPO_RS10800	2
KLZ001ss_ds.merged.samereadgroup.cleaned	2237356	2237377		YPO_RS10835	21
KLZ001ss_ds.merged.samereadgroup.cleaned	2249995	2249996		YPO_RS10895	1
KLZ001ss_ds.merged.samereadgroup.cleaned	2252961	2252971		YPO_RS10905	10
KLZ001ss_ds.merged.samereadgroup.cleaned	2252968	2252993		YPO_RS10910	25
KLZ001ss_ds.merged.samereadgroup.cleaned	2253989	2254008		YPO_RS10915	19
KLZ001ss_ds.merged.samereadgroup.cleaned	2254719	2254725		YPO_RS10915	6
KLZ001ss_ds.merged.samereadgroup.cleaned	2255359	2255361		YPO_RS10920	2
KLZ001ss_ds.merged.samereadgroup.cleaned	2256530	2256561		YPO_RS10925	31
KLZ001ss_ds.merged.samereadgroup.cleaned	2258499	2258516		YPO_RS10930	17
KLZ001ss_ds.merged.samereadgroup.cleaned	2258636	2258673		YPO_RS10935	37
KLZ001ss_ds.merged.samereadgroup.cleaned	2259141	2259177		YPO_RS10935	36
KLZ001ss_ds.merged.samereadgroup.cleaned	2259847	2259848		YPO_RS10935	1
KLZ001ss_ds.merged.samereadgroup.cleaned	2260117	2260138		YPO_RS10935	21
KLZ001ss_ds.merged.samereadgroup.cleaned	2266403	2266414		YPO_RS10965	11
KLZ001ss_ds.merged.samereadgroup.cleaned	2266982	2266983		YPO_RS10965	1
KLZ001ss_ds.merged.samereadgroup.cleaned	2277278	2277305		YPO_RS11015	27
KLZ001ss_ds.merged.samereadgroup.cleaned	2283590	2283620		pth	30
KLZ001ss_ds.merged.samereadgroup.cleaned	2294432	2294439		YPO_RS11110	7
KLZ001ss_ds.merged.samereadgroup.cleaned	2299987	2300030		YPO_RS11135	43
KLZ001ss_ds.merged.samereadgroup.cleaned	2306029	2306035		YPO_RS11175	6
KLZ001ss_ds.merged.samereadgroup.cleaned	2310781	2310785		mdtH	4
KLZ001ss_ds.merged.samereadgroup.cleaned	2316447	2316502		YPO_RS11220	55
KLZ001ss_ds.merged.samereadgroup.cleaned	2318098	2318102		YPO_RS11220	4
KLZ001ss_ds.merged.samereadgroup.cleaned	2318132	2318176		YPO_RS11225	44
KLZ001ss_ds.merged.samereadgroup.cleaned	2319511	2319553		YPO_RS11225	42
KLZ001ss_ds.merged.samereadgroup.cleaned	2319786	2319808		YPO_RS11225	22
KLZ001ss_ds.merged.samereadgroup.cleaned	2321736	2321737		YPO_RS11225	1
KLZ001ss_ds.merged.samereadgroup.cleaned	2321843	2321847		YPO_RS11225	4
KLZ001ss_ds.merged.samereadgroup.cleaned	2355321	2355323		fadD	2
KLZ001ss_ds.merged.samereadgroup.cleaned	2400848	2400853		YPO_RS11665	5
KLZ001ss_ds.merged.samereadgroup.cleaned	2414657	2414659		YPO_RS11720	2
KLZ001ss_ds.merged.samereadgroup.cleaned	2417480	2417484		YPO_RS11730	4
KLZ001ss_ds.merged.samereadgroup.cleaned	2419458	2419465		YPO_RS11740	7
KLZ001ss_ds.merged.samereadgroup.cleaned	2420947	2420962		YPO_RS11745	15
KLZ001ss_ds.merged.samereadgroup.cleaned	2424447	2424452		yeaG	5
KLZ001ss_ds.merged.samereadgroup.cleaned	2434024	2434026		selD	2
KLZ001ss_ds.merged.samereadgroup.cleaned	2439541	2439558		YPO_RS11830	17
KLZ001ss_ds.merged.samereadgroup.cleaned	2439588	2439615		YPO_RS11830	27
KLZ001ss_ds.merged.samereadgroup.cleaned	2439748	2439778		YPO_RS11830	30
KLZ001ss_ds.merged.samereadgroup.cleaned	2439920	2439968		YPO_RS11830	48
KLZ001ss_ds.merged.samereadgroup.cleaned	2440173	2440196		YPO_RS11830	23
KLZ001ss_ds.merged.samereadgroup.cleaned	2441837	2441850		YPO_RS11850	13
KLZ001ss_ds.merged.samereadgroup.cleaned	2442369	2442375		purU	6
KLZ001ss_ds.merged.samereadgroup.cleaned	2446854	2446855		YPO_RS11870	1
KLZ001ss_ds.merged.samereadgroup.cleaned	2446923	2446933		YPO_RS11870	10
KLZ001ss_ds.merged.samereadgroup.cleaned	2458454	2458462		oppA	8
KLZ001ss_ds.merged.samereadgroup.cleaned	2461796	2461800		YPO_RS11920	4
KLZ001ss_ds.merged.samereadgroup.cleaned	2463709	2463757		YPO_RS11930	48
KLZ001ss_ds.merged.samereadgroup.cleaned	2465295	2465310		cls	15
KLZ001ss_ds.merged.samereadgroup.cleaned	2473121	2473125		YPO_RS11990	4
KLZ001ss_ds.merged.samereadgroup.cleaned	2475855	2475869		YPO_RS12005	14
KLZ001ss_ds.merged.samereadgroup.cleaned	2483126	2483129		YPO_RS12045	3
KLZ001ss_ds.merged.samereadgroup.cleaned	2489393	2489430		sohB	37
KLZ001ss_ds.merged.samereadgroup.cleaned	2491200	2491212		topA	12
KLZ001ss_ds.merged.samereadgroup.cleaned	2495439	2495465		YPO_RS12105	26
KLZ001ss_ds.merged.samereadgroup.cleaned	2495852	2495951		YPO_RS12105	99
KLZ001ss_ds.merged.samereadgroup.cleaned	2496197	2496203		YPO_RS12105	6
KLZ001ss_ds.merged.samereadgroup.cleaned	2501803	2501805		lapB	2
KLZ001ss_ds.merged.samereadgroup.cleaned	2503053	2503078		YPO_RS12135	25
KLZ001ss_ds.merged.samereadgroup.cleaned	2513262	2513270		YPO_RS12185	8
KLZ001ss_ds.merged.samereadgroup.cleaned	2519275	2519296		YPO_RS12215	21
KLZ001ss_ds.merged.samereadgroup.cleaned	2526469	2526488		YPO_RS12245	19
KLZ001ss_ds.merged.samereadgroup.cleaned	2529603	2529606		YPO_RS12255	3
KLZ001ss_ds.merged.samereadgroup.cleaned	2541480	2541491		YPO_RS12300	11
KLZ001ss_ds.merged.samereadgroup.cleaned	2541708	2541709		YPO_RS12300	1
KLZ001ss_ds.merged.samereadgroup.cleaned	2541919	2541933		YPO_RS12300	14
KLZ001ss_ds.merged.samereadgroup.cleaned	2547283	2547287		YPO_RS12320	4
KLZ001ss_ds.merged.samereadgroup.cleaned	2549423	2549438		YPO_RS12330	15
KLZ001ss_ds.merged.samereadgroup.cleaned	2553227	2553238		clcB	11
KLZ001ss_ds.merged.samereadgroup.cleaned	2554373	2554633		YPO_RS12355	260
KLZ001ss_ds.merged.samereadgroup.cleaned	2554658	2555065		YPO_RS12360	407
KLZ001ss_ds.merged.samereadgroup.cleaned	2555162	2555608		YPO_RS12365	446
KLZ001ss_ds.merged.samereadgroup.cleaned	2555780	2556832		YPO_RS12370	1052
KLZ001ss_ds.merged.samereadgroup.cleaned	2556844	2557161		YPO_RS12375	317
KLZ001ss_ds.merged.samereadgroup.cleaned	2557164	2557415		YPO_RS12380	251
KLZ001ss_ds.merged.samereadgroup.cleaned	2557451	2557684		YPO_RS12385	233
KLZ001ss_ds.merged.samereadgroup.cleaned	2557749	2559461		YPO_RS12390	1712
KLZ001ss_ds.merged.samereadgroup.cleaned	2559474	2559761		YPO_RS12395	287
KLZ001ss_ds.merged.samereadgroup.cleaned	2559765	2560790		YPO_RS12400	1025
KLZ001ss_ds.merged.samereadgroup.cleaned	2560790	2562034		YPO_RS12405	1244
KLZ001ss_ds.merged.samereadgroup.cleaned	2562123	2562371		YPO_RS12410	248
KLZ001ss_ds.merged.samereadgroup.cleaned	2562568	2562765		YPO_RS12415	197
KLZ001ss_ds.merged.samereadgroup.cleaned	2565808	2565878		YPO_RS12435	70
KLZ001ss_ds.merged.samereadgroup.cleaned	2567288	2567307		YPO_RS12440	19
KLZ001ss_ds.merged.samereadgroup.cleaned	2577734	2577788		YPO_RS12465	54
KLZ001ss_ds.merged.samereadgroup.cleaned	2606380	2606395		asr	15
KLZ001ss_ds.merged.samereadgroup.cleaned	2630107	2630120		YPO_RS12680	13
KLZ001ss_ds.merged.samereadgroup.cleaned	2640270	2640283		YPO_RS12725	13
KLZ001ss_ds.merged.samereadgroup.cleaned	2640505	2640508		YPO_RS12725	3
KLZ001ss_ds.merged.samereadgroup.cleaned	2650594	2650601		sapC	7
KLZ001ss_ds.merged.samereadgroup.cleaned	2666674	2666681		rovA	7
KLZ001ss_ds.merged.samereadgroup.cleaned	2681298	2681302		purR	4
KLZ001ss_ds.merged.samereadgroup.cleaned	2687524	2687530		YPO_RS12960	6
KLZ001ss_ds.merged.samereadgroup.cleaned	2694629	2694632		YPO_RS13000	3
KLZ001ss_ds.merged.samereadgroup.cleaned	2715942	2715946		YPO_RS13080	4
KLZ001ss_ds.merged.samereadgroup.cleaned	2716607	2716608		arnF	1
KLZ001ss_ds.merged.samereadgroup.cleaned	2749111	2749126		YPO_RS13255	15
KLZ001ss_ds.merged.samereadgroup.cleaned	2754131	2754169		YPO_RS13285	38
KLZ001ss_ds.merged.samereadgroup.cleaned	2755037	2755052		YPO_RS13290	15
KLZ001ss_ds.merged.samereadgroup.cleaned	2755150	2755152		YPO_RS13290	2
KLZ001ss_ds.merged.samereadgroup.cleaned	2755433	2755487		YPO_RS13290	54
KLZ001ss_ds.merged.samereadgroup.cleaned	2772893	2772900		YPO_RS13355	7
KLZ001ss_ds.merged.samereadgroup.cleaned	2781018	2781040		YPO_RS13390	22
KLZ001ss_ds.merged.samereadgroup.cleaned	2784846	2784921		YPO_RS13410	75
KLZ001ss_ds.merged.samereadgroup.cleaned	2786419	2786422		YPO_RS13430	3
KLZ001ss_ds.merged.samereadgroup.cleaned	2788780	2788810		YPO_RS13435	30
KLZ001ss_ds.merged.samereadgroup.cleaned	2790069	2790101		YPO_RS13445	32
KLZ001ss_ds.merged.samereadgroup.cleaned	2796581	2796588		cdiA	7
KLZ001ss_ds.merged.samereadgroup.cleaned	2799533	2799553		YPO_RS13455	20
KLZ001ss_ds.merged.samereadgroup.cleaned	2807951	2807985		YPO_RS13485	34
KLZ001ss_ds.merged.samereadgroup.cleaned	2809988	2809992		YPO_RS13495	4
KLZ001ss_ds.merged.samereadgroup.cleaned	2814095	2814128		YPO_RS13510	33
KLZ001ss_ds.merged.samereadgroup.cleaned	2814174	2814227		YPO_RS13510	53
KLZ001ss_ds.merged.samereadgroup.cleaned	2815011	2815018		YPO_RS13515	7
KLZ001ss_ds.merged.samereadgroup.cleaned	2818912	2818917		YPO_RS13535	5
KLZ001ss_ds.merged.samereadgroup.cleaned	2832570	2832575		menE	5
KLZ001ss_ds.merged.samereadgroup.cleaned	2836039	2836050		menD	11
KLZ001ss_ds.merged.samereadgroup.cleaned	2838158	2838172		menF	14
KLZ001ss_ds.merged.samereadgroup.cleaned	2845087	2845108		YPO_RS13655	21
KLZ001ss_ds.merged.samereadgroup.cleaned	2846739	2846741		YPO_RS13660	2
KLZ001ss_ds.merged.samereadgroup.cleaned	2850404	2850411		YPO_RS13670	7
KLZ001ss_ds.merged.samereadgroup.cleaned	2851806	2851815		idnO	9
KLZ001ss_ds.merged.samereadgroup.cleaned	2853915	2853986		YPO_RS13690	71
KLZ001ss_ds.merged.samereadgroup.cleaned	2854050	2854059		YPO_RS13690	9
KLZ001ss_ds.merged.samereadgroup.cleaned	2854142	2854231		YPO_RS13690	89
KLZ001ss_ds.merged.samereadgroup.cleaned	2854392	2854393		YPO_RS13690	1
KLZ001ss_ds.merged.samereadgroup.cleaned	2879904	2879917		ackA	13
KLZ001ss_ds.merged.samereadgroup.cleaned	2880451	2880493		ackA	42
KLZ001ss_ds.merged.samereadgroup.cleaned	2884098	2884108		YPO_RS13805	10
KLZ001ss_ds.merged.samereadgroup.cleaned	2885691	2885693		YPO_RS13815	2
KLZ001ss_ds.merged.samereadgroup.cleaned	2885773	2885785		YPO_RS13815	12
KLZ001ss_ds.merged.samereadgroup.cleaned	2887086	2887932		YPO_RS13825	846
KLZ001ss_ds.merged.samereadgroup.cleaned	2887989	2892162		YPO_RS13830	4173
KLZ001ss_ds.merged.samereadgroup.cleaned	2892234	2893967		YPO_RS13830	1733
KLZ001ss_ds.merged.samereadgroup.cleaned	2894374	2894922		YPO_RS13835	548
KLZ001ss_ds.merged.samereadgroup.cleaned	2895617	2896471		YPO_RS13840	854
KLZ001ss_ds.merged.samereadgroup.cleaned	2896777	2897234		YPO_RS13845	457
KLZ001ss_ds.merged.samereadgroup.cleaned	2897288	2898093		YPO_RS13845	805
KLZ001ss_ds.merged.samereadgroup.cleaned	2898164	2898303		YPO_RS13845	139
KLZ001ss_ds.merged.samereadgroup.cleaned	2898338	2898793		iolD	455
KLZ001ss_ds.merged.samereadgroup.cleaned	2898827	2899221		iolD	394
KLZ001ss_ds.merged.samereadgroup.cleaned	2899251	2900263		iolD	1012
KLZ001ss_ds.merged.samereadgroup.cleaned	2907421	2907427		iolC	6
KLZ001ss_ds.merged.samereadgroup.cleaned	2907560	2907572		iolC	12
KLZ001ss_ds.merged.samereadgroup.cleaned	2908156	2908178		iolC	22
KLZ001ss_ds.merged.samereadgroup.cleaned	2910260	2910290		iolB	30
KLZ001ss_ds.merged.samereadgroup.cleaned	2915956	2915964		YPO_RS13925	8
KLZ001ss_ds.merged.samereadgroup.cleaned	2920524	2920526		lipB	2
KLZ001ss_ds.merged.samereadgroup.cleaned	2926646	2926658		mrdA	12
KLZ001ss_ds.merged.samereadgroup.cleaned	2954911	2954924		YPO_RS14120	13
KLZ001ss_ds.merged.samereadgroup.cleaned	2980429	2980595		YPO_RS14235	166
KLZ001ss_ds.merged.samereadgroup.cleaned	2981298	2981302		YPO_RS14240	4
KLZ001ss_ds.merged.samereadgroup.cleaned	2999279	2999282		YPO_RS14330	3
KLZ001ss_ds.merged.samereadgroup.cleaned	2999808	2999830		YPO_RS14330	22
KLZ001ss_ds.merged.samereadgroup.cleaned	3002501	3002508		crcB	7
KLZ001ss_ds.merged.samereadgroup.cleaned	3003282	3003292		YPO_RS14355	10
KLZ001ss_ds.merged.samereadgroup.cleaned	3006656	3006658		chbR	2
KLZ001ss_ds.merged.samereadgroup.cleaned	3010732	3010740		pgm	8
KLZ001ss_ds.merged.samereadgroup.cleaned	3012187	3012219		YPO_RS14405	32
KLZ001ss_ds.merged.samereadgroup.cleaned	3021137	3021144		YPO_RS14440	7
KLZ001ss_ds.merged.samereadgroup.cleaned	3031200	3031204		pcp	4
KLZ001ss_ds.merged.samereadgroup.cleaned	3037251	3037264		YPO_RS14530	13
KLZ001ss_ds.merged.samereadgroup.cleaned	3042697	3042707		YPO_RS14560	10
KLZ001ss_ds.merged.samereadgroup.cleaned	3042822	3042832		YPO_RS14560	10
KLZ001ss_ds.merged.samereadgroup.cleaned	3056175	3056212		YPO_RS14610	37
KLZ001ss_ds.merged.samereadgroup.cleaned	3059030	3059031		YPO_RS14620	1
KLZ001ss_ds.merged.samereadgroup.cleaned	3062814	3062815		YPO_RS14645	1
KLZ001ss_ds.merged.samereadgroup.cleaned	3065979	3065980		YPO_RS14660	1
KLZ001ss_ds.merged.samereadgroup.cleaned	3096816	3096824		YPO_RS14805	8
KLZ001ss_ds.merged.samereadgroup.cleaned	3120316	3120561		YPO_RS14920	245
KLZ001ss_ds.merged.samereadgroup.cleaned	3121234	3121815		YPO_RS14925	581
KLZ001ss_ds.merged.samereadgroup.cleaned	3122083	3122484		YPO_RS14930	401
KLZ001ss_ds.merged.samereadgroup.cleaned	3122717	3123118		YPO_RS14935	401
KLZ001ss_ds.merged.samereadgroup.cleaned	3123130	3123702		YPO_RS14940	572
KLZ001ss_ds.merged.samereadgroup.cleaned	3123726	3123977		YPO_RS14945	251
KLZ001ss_ds.merged.samereadgroup.cleaned	3124016	3124255		YPO_RS14950	239
KLZ001ss_ds.merged.samereadgroup.cleaned	3125064	3126980		yapC	1916
KLZ001ss_ds.merged.samereadgroup.cleaned	3127168	3127226		YPO_RS14960	58
KLZ001ss_ds.merged.samereadgroup.cleaned	3127515	3128096		YPO_RS14965	581
KLZ001ss_ds.merged.samereadgroup.cleaned	3130158	3132365		YPO_RS14980	2207
KLZ001ss_ds.merged.samereadgroup.cleaned	3132358	3132888		YPO_RS14985	530
KLZ001ss_ds.merged.samereadgroup.cleaned	3133047	3133595		YPO_RS14990	548
KLZ001ss_ds.merged.samereadgroup.cleaned	3133632	3135428		YPO_RS14990	1796
KLZ001ss_ds.merged.samereadgroup.cleaned	3135507	3137135		YPO_RS14995	1628
KLZ001ss_ds.merged.samereadgroup.cleaned	3137608	3137910		YPO_RS15000	302
KLZ001ss_ds.merged.samereadgroup.cleaned	3137946	3138459		YPO_RS15000	513
KLZ001ss_ds.merged.samereadgroup.cleaned	3138485	3138544		YPO_RS15005	59
KLZ001ss_ds.merged.samereadgroup.cleaned	3138574	3138839		YPO_RS15005	265
KLZ001ss_ds.merged.samereadgroup.cleaned	3138872	3138989		YPO_RS15005	117
KLZ001ss_ds.merged.samereadgroup.cleaned	3139030	3139039		YPO_RS15005	9
KLZ001ss_ds.merged.samereadgroup.cleaned	3139100	3139474		YPO_RS15005	374
KLZ001ss_ds.merged.samereadgroup.cleaned	3139529	3140312		YPO_RS15010	783
KLZ001ss_ds.merged.samereadgroup.cleaned	3140343	3140422		YPO_RS15010	79
KLZ001ss_ds.merged.samereadgroup.cleaned	3142684	3142989		YPO_RS15025	305
KLZ001ss_ds.merged.samereadgroup.cleaned	3143086	3143487		YPO_RS15030	401
KLZ001ss_ds.merged.samereadgroup.cleaned	3143469	3144179		YPO_RS15035	710
KLZ001ss_ds.merged.samereadgroup.cleaned	3144882	3144912		YPO_RS15040	30
KLZ001ss_ds.merged.samereadgroup.cleaned	3145836	3145854		YPO_RS15040	18
KLZ001ss_ds.merged.samereadgroup.cleaned	3151676	3151681		YPO_RS15090	5
KLZ001ss_ds.merged.samereadgroup.cleaned	3163417	3163420		YPO_RS15145	3
KLZ001ss_ds.merged.samereadgroup.cleaned	3164653	3164654		ppk1	1
KLZ001ss_ds.merged.samereadgroup.cleaned	3173722	3173728		YPO_RS15185	6
KLZ001ss_ds.merged.samereadgroup.cleaned	3179481	3179503		YPO_RS15205	22
KLZ001ss_ds.merged.samereadgroup.cleaned	3183936	3183976		mdtC	40
KLZ001ss_ds.merged.samereadgroup.cleaned	3184490	3184498		mdtC	8
KLZ001ss_ds.merged.samereadgroup.cleaned	3197815	3197822		YPO_RS15265	7
KLZ001ss_ds.merged.samereadgroup.cleaned	3197861	3197897		YPO_RS15265	36
KLZ001ss_ds.merged.samereadgroup.cleaned	3198227	3198231		YPO_RS15270	4
KLZ001ss_ds.merged.samereadgroup.cleaned	3198282	3198285		YPO_RS15275	3
KLZ001ss_ds.merged.samereadgroup.cleaned	3200205	3200227		YPO_RS15285	22
KLZ001ss_ds.merged.samereadgroup.cleaned	3200405	3200434		YPO_RS15285	29
KLZ001ss_ds.merged.samereadgroup.cleaned	3200560	3200587		YPO_RS15285	27
KLZ001ss_ds.merged.samereadgroup.cleaned	3200719	3200759		YPO_RS15290	40
KLZ001ss_ds.merged.samereadgroup.cleaned	3200808	3200859		YPO_RS15290	51
KLZ001ss_ds.merged.samereadgroup.cleaned	3200928	3200959		YPO_RS15290	31
KLZ001ss_ds.merged.samereadgroup.cleaned	3201033	3201046		YPO_RS15290	13
KLZ001ss_ds.merged.samereadgroup.cleaned	3201312	3201362		YPO_RS15295	50
KLZ001ss_ds.merged.samereadgroup.cleaned	3201491	3201503		YPO_RS15295	12
KLZ001ss_ds.merged.samereadgroup.cleaned	3201567	3201685		YPO_RS15300	118
KLZ001ss_ds.merged.samereadgroup.cleaned	3201731	3201734		YPO_RS15300	3
KLZ001ss_ds.merged.samereadgroup.cleaned	3201946	3201954		YPO_RS15300	8
KLZ001ss_ds.merged.samereadgroup.cleaned	3205218	3205234		guaB	16
KLZ001ss_ds.merged.samereadgroup.cleaned	3221693	3221852		YPO_RS15385	159
KLZ001ss_ds.merged.samereadgroup.cleaned	3221953	3221987		YPO_RS15385	34
KLZ001ss_ds.merged.samereadgroup.cleaned	3222625	3222651		YPO_RS15385	26
KLZ001ss_ds.merged.samereadgroup.cleaned	3223963	3223981		yapA	18
KLZ001ss_ds.merged.samereadgroup.cleaned	3225008	3225017		yapA	9
KLZ001ss_ds.merged.samereadgroup.cleaned	3225498	3225531		yapA	33
KLZ001ss_ds.merged.samereadgroup.cleaned	3225581	3225617		yapA	36
KLZ001ss_ds.merged.samereadgroup.cleaned	3229868	3229882		YPO_RS15395	14
KLZ001ss_ds.merged.samereadgroup.cleaned	3230071	3230079		YPO_RS15395	8
KLZ001ss_ds.merged.samereadgroup.cleaned	3230867	3230874		YPO_RS15395	7
KLZ001ss_ds.merged.samereadgroup.cleaned	3241407	3241409		trmJ	2
KLZ001ss_ds.merged.samereadgroup.cleaned	3243780	3243784		YPO_RS15475	4
KLZ001ss_ds.merged.samereadgroup.cleaned	3259136	3259137		YPO_RS15540	1
KLZ001ss_ds.merged.samereadgroup.cleaned	3262463	3262468		YPO_RS15560	5
KLZ001ss_ds.merged.samereadgroup.cleaned	3262697	3262730		YPO_RS15560	33
KLZ001ss_ds.merged.samereadgroup.cleaned	3262883	3262898		YPO_RS15560	15
KLZ001ss_ds.merged.samereadgroup.cleaned	3265841	3265856		purL	15
KLZ001ss_ds.merged.samereadgroup.cleaned	3284496	3284528		YPO_RS15665	32
KLZ001ss_ds.merged.samereadgroup.cleaned	3288010	3288013		YPO_RS15680	3
KLZ001ss_ds.merged.samereadgroup.cleaned	3291268	3291269		tssH	1
KLZ001ss_ds.merged.samereadgroup.cleaned	3296866	3296870		YPO_RS15710	4
KLZ001ss_ds.merged.samereadgroup.cleaned	3297284	3297300		YPO_RS15710	16
KLZ001ss_ds.merged.samereadgroup.cleaned	3301409	3301415		YPO_RS15725	6
KLZ001ss_ds.merged.samereadgroup.cleaned	3304730	3304731		mltB	1
KLZ001ss_ds.merged.samereadgroup.cleaned	3311457	3311459		YPO_RS15770	2
KLZ001ss_ds.merged.samereadgroup.cleaned	3317580	3317584		YPO_RS15790	4
KLZ001ss_ds.merged.samereadgroup.cleaned	3320271	3320272		YPO_RS15810	1
KLZ001ss_ds.merged.samereadgroup.cleaned	3348211	3348213		YPO_RS15980	2
KLZ001ss_ds.merged.samereadgroup.cleaned	3356091	3356126		YPO_RS16010	35
KLZ001ss_ds.merged.samereadgroup.cleaned	3363505	3363534		YPO_RS16040	29
KLZ001ss_ds.merged.samereadgroup.cleaned	3363723	3363734		YPO_RS16040	11
KLZ001ss_ds.merged.samereadgroup.cleaned	3363811	3363828		YPO_RS16040	17
KLZ001ss_ds.merged.samereadgroup.cleaned	3364200	3364212		YPO_RS16040	12
KLZ001ss_ds.merged.samereadgroup.cleaned	3364268	3364282		YPO_RS16040	14
KLZ001ss_ds.merged.samereadgroup.cleaned	3364369	3364377		YPO_RS16040	8
KLZ001ss_ds.merged.samereadgroup.cleaned	3364735	3364737		YPO_RS16040	2
KLZ001ss_ds.merged.samereadgroup.cleaned	3371429	3371433		YPO_RS16070	4
KLZ001ss_ds.merged.samereadgroup.cleaned	3372737	3372772		YPO_RS16075	35
KLZ001ss_ds.merged.samereadgroup.cleaned	3373376	3373384		YPO_RS16080	8
KLZ001ss_ds.merged.samereadgroup.cleaned	3376506	3376508		YPO_RS16095	2
KLZ001ss_ds.merged.samereadgroup.cleaned	3378784	3378786		YPO_RS16105	2
KLZ001ss_ds.merged.samereadgroup.cleaned	3379485	3379488		YPO_RS16110	3
KLZ001ss_ds.merged.samereadgroup.cleaned	3381105	3381119		yapL	14
KLZ001ss_ds.merged.samereadgroup.cleaned	3382995	3383007		yapL	12
KLZ001ss_ds.merged.samereadgroup.cleaned	3383656	3383668		YPO_RS16125	12
KLZ001ss_ds.merged.samereadgroup.cleaned	3383849	3383888		YPO_RS16125	39
KLZ001ss_ds.merged.samereadgroup.cleaned	3396585	3396607		acrD	22
KLZ001ss_ds.merged.samereadgroup.cleaned	3403258	3403280		YPO_RS16210	22
KLZ001ss_ds.merged.samereadgroup.cleaned	3405497	3405534		YPO_RS16220	37
KLZ001ss_ds.merged.samereadgroup.cleaned	3405641	3405661		YPO_RS16220	20
KLZ001ss_ds.merged.samereadgroup.cleaned	3422105	3422124		YPO_RS16305	19
KLZ001ss_ds.merged.samereadgroup.cleaned	3438068	3438072		YPO_RS16375	4
KLZ001ss_ds.merged.samereadgroup.cleaned	3454005	3454038		fepE	33
KLZ001ss_ds.merged.samereadgroup.cleaned	3454809	3454818		fepE	9
KLZ001ss_ds.merged.samereadgroup.cleaned	3454888	3454896		fepE	8
KLZ001ss_ds.merged.samereadgroup.cleaned	3455009	3455016		cpsG	7
KLZ001ss_ds.merged.samereadgroup.cleaned	3455887	3455931		cpsG	44
KLZ001ss_ds.merged.samereadgroup.cleaned	3456558	3456601		YPO_RS16450	43
KLZ001ss_ds.merged.samereadgroup.cleaned	3456714	3456780		YPO_RS16450	66
KLZ001ss_ds.merged.samereadgroup.cleaned	3456980	3457001		YPO_RS16450	21
KLZ001ss_ds.merged.samereadgroup.cleaned	3457109	3457130		YPO_RS16450	21
KLZ001ss_ds.merged.samereadgroup.cleaned	3457133	3457146		YPO_RS16455	13
KLZ001ss_ds.merged.samereadgroup.cleaned	3461650	3461654		YPO_RS16470	4
KLZ001ss_ds.merged.samereadgroup.cleaned	3461837	3461854		YPO_RS16470	17
KLZ001ss_ds.merged.samereadgroup.cleaned	3463456	3463478		YPO_RS16480	22
KLZ001ss_ds.merged.samereadgroup.cleaned	3463723	3463968		YPO_RS16480	245
KLZ001ss_ds.merged.samereadgroup.cleaned	3464091	3464209		YPO_RS16480	118
KLZ001ss_ds.merged.samereadgroup.cleaned	3464451	3464452		YPO_RS16480	1
KLZ001ss_ds.merged.samereadgroup.cleaned	3464843	3464880		YPO_RS16485	37
KLZ001ss_ds.merged.samereadgroup.cleaned	3465030	3465095		YPO_RS16485	65
KLZ001ss_ds.merged.samereadgroup.cleaned	3465330	3465331		YPO_RS16485	1
KLZ001ss_ds.merged.samereadgroup.cleaned	3465428	3465450		YPO_RS16485	22
KLZ001ss_ds.merged.samereadgroup.cleaned	3465494	3465556		YPO_RS16485	62
KLZ001ss_ds.merged.samereadgroup.cleaned	3465567	3465596		YPO_RS16490	29
KLZ001ss_ds.merged.samereadgroup.cleaned	3466012	3466030		YPO_RS16490	18
KLZ001ss_ds.merged.samereadgroup.cleaned	3466246	3466381		YPO_RS16490	135
KLZ001ss_ds.merged.samereadgroup.cleaned	3466602	3466650		YPO_RS16490	48
KLZ001ss_ds.merged.samereadgroup.cleaned	3466984	3466992		YPO_RS16495	8
KLZ001ss_ds.merged.samereadgroup.cleaned	3467121	3467122		YPO_RS16495	1
KLZ001ss_ds.merged.samereadgroup.cleaned	3467468	3467470		YPO_RS16495	2
KLZ001ss_ds.merged.samereadgroup.cleaned	3467504	3467529		YPO_RS16495	25
KLZ001ss_ds.merged.samereadgroup.cleaned	3468668	3468682		YPO_RS16500	14
KLZ001ss_ds.merged.samereadgroup.cleaned	3469106	3469125		YPO_RS16500	19
KLZ001ss_ds.merged.samereadgroup.cleaned	3470130	3470136		rfbH	6
KLZ001ss_ds.merged.samereadgroup.cleaned	3473067	3473090		YPO_RS16520	23
KLZ001ss_ds.merged.samereadgroup.cleaned	3480495	3480497		dnaX	2
KLZ001ss_ds.merged.samereadgroup.cleaned	3487016	3487017		mscK	1
KLZ001ss_ds.merged.samereadgroup.cleaned	3490246	3490272		acrR	26
KLZ001ss_ds.merged.samereadgroup.cleaned	3492811	3492815		YPO_RS16605	4
KLZ001ss_ds.merged.samereadgroup.cleaned	3497039	3497055		YPO_RS16620	16
KLZ001ss_ds.merged.samereadgroup.cleaned	3516086	3516103		hupB	17
KLZ001ss_ds.merged.samereadgroup.cleaned	3516277	3516282		hupB	5
KLZ001ss_ds.merged.samereadgroup.cleaned	3520980	3520988		clpP	8
KLZ001ss_ds.merged.samereadgroup.cleaned	3523471	3523479		bolA	8
KLZ001ss_ds.merged.samereadgroup.cleaned	3527672	3527694		cyoA	22
KLZ001ss_ds.merged.samereadgroup.cleaned	3535826	3535828		panE	2
KLZ001ss_ds.merged.samereadgroup.cleaned	3535877	3535901		panE	24
KLZ001ss_ds.merged.samereadgroup.cleaned	3543533	3543536		thiL	3
KLZ001ss_ds.merged.samereadgroup.cleaned	3547262	3547278		YPO_RS16860	16
KLZ001ss_ds.merged.samereadgroup.cleaned	3548024	3548046		YPO_RS16865	22
KLZ001ss_ds.merged.samereadgroup.cleaned	3548082	3548196		YPO_RS16865	114
KLZ001ss_ds.merged.samereadgroup.cleaned	3560397	3560425		YPO_RS16925	28
KLZ001ss_ds.merged.samereadgroup.cleaned	3568235	3568245		phoR	10
KLZ001ss_ds.merged.samereadgroup.cleaned	3572097	3572137		YPO_RS16965	40
KLZ001ss_ds.merged.samereadgroup.cleaned	3590108	3590128		YPO_RS17045	20
KLZ001ss_ds.merged.samereadgroup.cleaned	3592421	3592475		YPO_RS17055	54
KLZ001ss_ds.merged.samereadgroup.cleaned	3592522	3592529		YPO_RS17055	7
KLZ001ss_ds.merged.samereadgroup.cleaned	3592639	3592668		YPO_RS17055	29
KLZ001ss_ds.merged.samereadgroup.cleaned	3592801	3592803		YPO_RS17055	2
KLZ001ss_ds.merged.samereadgroup.cleaned	3592898	3592913		YPO_RS17055	15
KLZ001ss_ds.merged.samereadgroup.cleaned	3593249	3593284		YPO_RS17055	35
KLZ001ss_ds.merged.samereadgroup.cleaned	3598250	3598252		YPO_RS17070	2
KLZ001ss_ds.merged.samereadgroup.cleaned	3611637	3611642		YPO_RS17130	5
KLZ001ss_ds.merged.samereadgroup.cleaned	3640017	3640022		emrB	5
KLZ001ss_ds.merged.samereadgroup.cleaned	3642614	3642627		trxC	13
KLZ001ss_ds.merged.samereadgroup.cleaned	3649931	3649939		YPO_RS17290	8
KLZ001ss_ds.merged.samereadgroup.cleaned	3654006	3654010		YPO_RS17305	4
KLZ001ss_ds.merged.samereadgroup.cleaned	3658360	3658363		rluD	3
KLZ001ss_ds.merged.samereadgroup.cleaned	3665928	3665938		tyrA	10
KLZ001ss_ds.merged.samereadgroup.cleaned	3682304	3682322		YPO_RS17455	18
KLZ001ss_ds.merged.samereadgroup.cleaned	3701130	3701167		YPO_RS17550	37
KLZ001ss_ds.merged.samereadgroup.cleaned	3704383	3704409		cybC	26
KLZ001ss_ds.merged.samereadgroup.cleaned	3725447	3725455		YPO_RS17650	8
KLZ001ss_ds.merged.samereadgroup.cleaned	3725616	3725639		YPO_RS17650	23
KLZ001ss_ds.merged.samereadgroup.cleaned	3728653	3728680		YPO_RS17660	27
KLZ001ss_ds.merged.samereadgroup.cleaned	3731745	3731797		YPO_RS17675	52
KLZ001ss_ds.merged.samereadgroup.cleaned	3736713	3736715		YPO_RS17705	2
KLZ001ss_ds.merged.samereadgroup.cleaned	3753260	3753281		cysN	21
KLZ001ss_ds.merged.samereadgroup.cleaned	3754809	3754812		cobA	3
KLZ001ss_ds.merged.samereadgroup.cleaned	3760426	3760431		cysJ	5
KLZ001ss_ds.merged.samereadgroup.cleaned	3773768	3773774		barA	6
KLZ001ss_ds.merged.samereadgroup.cleaned	3793277	3793280		hrpB	3
KLZ001ss_ds.merged.samereadgroup.cleaned	3812282	3812303		YPO_RS18035	21
KLZ001ss_ds.merged.samereadgroup.cleaned	3827746	3827748		ampD	2
KLZ001ss_ds.merged.samereadgroup.cleaned	3830242	3830244		gspE	2
KLZ001ss_ds.merged.samereadgroup.cleaned	3835013	3835057		coaE	44
KLZ001ss_ds.merged.samereadgroup.cleaned	3853235	3853248		argF	13
KLZ001ss_ds.merged.samereadgroup.cleaned	3858539	3858543		YPO_RS18220	4
KLZ001ss_ds.merged.samereadgroup.cleaned	3872048	3872064		phnP	16
KLZ001ss_ds.merged.samereadgroup.cleaned	3872207	3872212		phnP	5
KLZ001ss_ds.merged.samereadgroup.cleaned	3873317	3873320		YPO_RS18300	3
KLZ001ss_ds.merged.samereadgroup.cleaned	3883749	3883771		YPO_RS18345	22
KLZ001ss_ds.merged.samereadgroup.cleaned	3891755	3891760		YPO_RS18375	5
KLZ001ss_ds.merged.samereadgroup.cleaned	3898035	3898050		nlpI	15
KLZ001ss_ds.merged.samereadgroup.cleaned	3906346	3906357		infB	11
KLZ001ss_ds.merged.samereadgroup.cleaned	3910354	3910369		glmM	15
KLZ001ss_ds.merged.samereadgroup.cleaned	3918849	3918853		pmrB	4
KLZ001ss_ds.merged.samereadgroup.cleaned	3946207	3946222		YPO_RS18635	15
KLZ001ss_ds.merged.samereadgroup.cleaned	3977876	3977881		YPO_RS18790	5
KLZ001ss_ds.merged.samereadgroup.cleaned	3990498	3990503		kdsC	5
KLZ001ss_ds.merged.samereadgroup.cleaned	4013610	4013618		tssM	8
KLZ001ss_ds.merged.samereadgroup.cleaned	4027513	4027514		YPO_RS19045	1
KLZ001ss_ds.merged.samereadgroup.cleaned	4029402	4029410		YPO_RS19055	8
KLZ001ss_ds.merged.samereadgroup.cleaned	4033685	4033715		YPO_RS19060	30
KLZ001ss_ds.merged.samereadgroup.cleaned	4033789	4033808		YPO_RS19060	19
KLZ001ss_ds.merged.samereadgroup.cleaned	4033940	4033966		YPO_RS19060	26
KLZ001ss_ds.merged.samereadgroup.cleaned	4034672	4034698		YPO_RS19065	26
KLZ001ss_ds.merged.samereadgroup.cleaned	4035263	4035268		YPO_RS19070	5
KLZ001ss_ds.merged.samereadgroup.cleaned	4043095	4043105		ssuD	10
KLZ001ss_ds.merged.samereadgroup.cleaned	4052428	4052430		lpxP	2
KLZ001ss_ds.merged.samereadgroup.cleaned	4072281	4072284		YPO_RS19245	3
KLZ001ss_ds.merged.samereadgroup.cleaned	4078603	4078619		YPO_RS19285	16
KLZ001ss_ds.merged.samereadgroup.cleaned	4080030	4080034		accC	4
KLZ001ss_ds.merged.samereadgroup.cleaned	4098633	4098714		YPO_RS19365	81
KLZ001ss_ds.merged.samereadgroup.cleaned	4098821	4098842		YPO_RS19365	21
KLZ001ss_ds.merged.samereadgroup.cleaned	4098938	4098961		YPO_RS19365	23
KLZ001ss_ds.merged.samereadgroup.cleaned	4101621	4101770		YPO_RS19370	149
KLZ001ss_ds.merged.samereadgroup.cleaned	4105754	4105776		YPO_RS19390	22
KLZ001ss_ds.merged.samereadgroup.cleaned	4106362	4106377		YPO_RS19390	15
KLZ001ss_ds.merged.samereadgroup.cleaned	4110136	4110184		YPO_RS19390	48
KLZ001ss_ds.merged.samereadgroup.cleaned	4112687	4112785		YPO_RS19400	98
KLZ001ss_ds.merged.samereadgroup.cleaned	4113994	4114047		YPO_RS19405	53
KLZ001ss_ds.merged.samereadgroup.cleaned	4114200	4114219		YPO_RS19405	19
KLZ001ss_ds.merged.samereadgroup.cleaned	4115041	4115056		YPO_RS19405	15
KLZ001ss_ds.merged.samereadgroup.cleaned	4116827	4116831		YPO_RS19410	4
KLZ001ss_ds.merged.samereadgroup.cleaned	4117255	4117290		YPO_RS19410	35
KLZ001ss_ds.merged.samereadgroup.cleaned	4127394	4127433		YPO_RS19460	39
KLZ001ss_ds.merged.samereadgroup.cleaned	4130822	4130824		treC	2
KLZ001ss_ds.merged.samereadgroup.cleaned	4134306	4134316		YPO_RS19490	10
KLZ001ss_ds.merged.samereadgroup.cleaned	4142776	4142826		YPO_RS19535	50
KLZ001ss_ds.merged.samereadgroup.cleaned	4145953	4145956		malK	3
KLZ001ss_ds.merged.samereadgroup.cleaned	4176216	4176223		YPO_RS19645	7
KLZ001ss_ds.merged.samereadgroup.cleaned	4206198	4206236		rplL	38
KLZ001ss_ds.merged.samereadgroup.cleaned	4213921	4213933		YPO_RS19830	12
KLZ001ss_ds.merged.samereadgroup.cleaned	4216751	4216794		murB	43
KLZ001ss_ds.merged.samereadgroup.cleaned	4223144	4223145		YPO_RS19870	1
KLZ001ss_ds.merged.samereadgroup.cleaned	4233887	4233894		ubiD	7
KLZ001ss_ds.merged.samereadgroup.cleaned	4242476	4242484		ubiB	8
KLZ001ss_ds.merged.samereadgroup.cleaned	4242683	4242692		ubiB	9
KLZ001ss_ds.merged.samereadgroup.cleaned	4251493	4251503		YPO_RS20015	10
KLZ001ss_ds.merged.samereadgroup.cleaned	4257946	4257950		ugpQ	4
KLZ001ss_ds.merged.samereadgroup.cleaned	4264328	4264336		YPO_RS20070	8
KLZ001ss_ds.merged.samereadgroup.cleaned	4269662	4269678		YPO_RS20095	16
KLZ001ss_ds.merged.samereadgroup.cleaned	4271898	4271912		YPO_RS20110	14
KLZ001ss_ds.merged.samereadgroup.cleaned	4280839	4280947		ftsY	108
KLZ001ss_ds.merged.samereadgroup.cleaned	4281469	4281473		ftsY	4
KLZ001ss_ds.merged.samereadgroup.cleaned	4288210	4288214		YPO_RS20190	4
KLZ001ss_ds.merged.samereadgroup.cleaned	4304807	4304832		rarD	25
KLZ001ss_ds.merged.samereadgroup.cleaned	4315885	4315888		YPO_RS20315	3
KLZ001ss_ds.merged.samereadgroup.cleaned	4349675	4349688		YPO_RS20480	13
KLZ001ss_ds.merged.samereadgroup.cleaned	4349983	4350002		YPO_RS20480	19
KLZ001ss_ds.merged.samereadgroup.cleaned	4358255	4358267		YPO_RS20510	12
KLZ001ss_ds.merged.samereadgroup.cleaned	4359333	4359352		YPO_RS20515	19
KLZ001ss_ds.merged.samereadgroup.cleaned	4360349	4360350		YPO_RS20525	1
KLZ001ss_ds.merged.samereadgroup.cleaned	4364590	4364597		ilvY	7
KLZ001ss_ds.merged.samereadgroup.cleaned	4367735	4367737		YPO_RS20570	2
KLZ001ss_ds.merged.samereadgroup.cleaned	4368024	4368060		YPO_RS20575	36
KLZ001ss_ds.merged.samereadgroup.cleaned	4369985	4369988		ilvA	3
KLZ001ss_ds.merged.samereadgroup.cleaned	4376549	4376550		YPO_RS20610	1
KLZ001ss_ds.merged.samereadgroup.cleaned	4400751	4400755		YPO_RS20725	4
KLZ001ss_ds.merged.samereadgroup.cleaned	4404989	4404998		YPO_RS20740	9
KLZ001ss_ds.merged.samereadgroup.cleaned	4405898	4405937		YPO_RS20745	39
KLZ001ss_ds.merged.samereadgroup.cleaned	4406445	4406452		YPO_RS20745	7
KLZ001ss_ds.merged.samereadgroup.cleaned	4408258	4408320		YPO_RS20745	62
KLZ001ss_ds.merged.samereadgroup.cleaned	4421983	4421986		glpD	3
KLZ001ss_ds.merged.samereadgroup.cleaned	4442481	4442498		YPO_RS20830	17
KLZ001ss_ds.merged.samereadgroup.cleaned	4455701	4455717		YPO_RS20905	16
KLZ001ss_ds.merged.samereadgroup.cleaned	4461720	4461727		YPO_RS20935	7
KLZ001ss_ds.merged.samereadgroup.cleaned	4480653	4480659		YPO_RS21000	6
KLZ001ss_ds.merged.samereadgroup.cleaned	4480653	4480659		YPO_RS21005	6
KLZ001ss_ds.merged.samereadgroup.cleaned	4483624	4483697		YPO_RS21020	73
KLZ001ss_ds.merged.samereadgroup.cleaned	4483821	4483921		YPO_RS21020	100
KLZ001ss_ds.merged.samereadgroup.cleaned	4484578	4484585		YPO_RS21025	7
KLZ001ss_ds.merged.samereadgroup.cleaned	4484979	4485018		YPO_RS21030	39
KLZ001ss_ds.merged.samereadgroup.cleaned	4491396	4491400		YPO_RS21050	4
KLZ001ss_ds.merged.samereadgroup.cleaned	4503362	4503366		YPO_RS21090	4
KLZ001ss_ds.merged.samereadgroup.cleaned	4515987	4515993		YPO_RS21140	6
KLZ001ss_ds.merged.samereadgroup.cleaned	4516314	4516324		YPO_RS21140	10
KLZ001ss_ds.merged.samereadgroup.cleaned	4517291	4517297		YPO_RS21140	6
KLZ001ss_ds.merged.samereadgroup.cleaned	4517366	4517373		YPO_RS21140	7
KLZ001ss_ds.merged.samereadgroup.cleaned	4519679	4519693		YPO_RS21155	14
KLZ001ss_ds.merged.samereadgroup.cleaned	4527080	4527090		YPO_RS21185	10
KLZ001ss_ds.merged.samereadgroup.cleaned	4533466	4533474		YPO_RS21205	8
KLZ001ss_ds.merged.samereadgroup.cleaned	4533658	4533677		YPO_RS21205	19
KLZ001ss_ds.merged.samereadgroup.cleaned	4534829	4534874		YPO_RS21210	45
KLZ001ss_ds.merged.samereadgroup.cleaned	4539719	4539723		YPO_RS21235	4
KLZ001ss_ds.merged.samereadgroup.cleaned	4545552	4545557		YPO_RS21280	5
KLZ001ss_ds.merged.samereadgroup.cleaned	4545599	4545688		YPO_RS21280	89
KLZ001ss_ds.merged.samereadgroup.cleaned	4545847	4545855		YPO_RS21280	8
KLZ001ss_ds.merged.samereadgroup.cleaned	4546305	4546322		YPO_RS21280	17
KLZ001ss_ds.merged.samereadgroup.cleaned	4558116	4558133		YPO_RS21330	17
KLZ001ss_ds.merged.samereadgroup.cleaned	4561507	4561524		YPO_RS21340	17
KLZ001ss_ds.merged.samereadgroup.cleaned	4567683	4567688		YPO_RS21370	5
KLZ001ss_ds.merged.samereadgroup.cleaned	4567744	4567765		YPO_RS21370	21
KLZ001ss_ds.merged.samereadgroup.cleaned	4570800	4570820		selB	20
KLZ001ss_ds.merged.samereadgroup.cleaned	4571534	4571535		YPO_RS21400	1
KLZ001ss_ds.merged.samereadgroup.cleaned	4583339	4583345		YPO_RS21440	6
KLZ001ss_ds.merged.samereadgroup.cleaned	4585006	4585009		YPO_RS21450	3
KLZ001ss_ds.merged.samereadgroup.cleaned	4593772	4593775		glyQ	3
KLZ001ss_ds.merged.samereadgroup.cleaned	4601697	4601738		YPO_RS21520	41
KLZ001ss_ds.merged.samereadgroup.cleaned	4601880	4601908		YPO_RS21520	28
KLZ001ss_ds.merged.samereadgroup.cleaned	4602020	4602027		YPO_RS21520	7
KLZ001ss_ds.merged.samereadgroup.cleaned	4607533	4607543		YPO_RS21545	10
KLZ001ss_ds.merged.samereadgroup.cleaned	4608758	4608766		YPO_RS21555	8
KLZ001ss_ds.merged.samereadgroup.cleaned	4623770	4623790		mnmE	20
KLZ001ss_ds.merged.samereadgroup.cleaned	4626279	4626288		YPO_RS21630	9
KLZ001ss_ds.merged.samereadgroup.cleaned	4627801	4627812		YPO_RS21640	11
KLZ001ss_ds.merged.samereadgroup.cleaned	4630016	4630019		yieH	3
KLZ001ss_ds.merged.samereadgroup.cleaned	4633476	4633500		YPO_RS21670	24
KLZ001ss_ds.merged.samereadgroup.cleaned	4642492	4642497		glmU	5
KLZ001ss_ds.merged.samereadgroup.cleaned	4649344	4649368		atpB	24
KNK001ss_ds.merged.samereadgroup.cleaned	4023	4070		ravA	47
KNK001ss_ds.merged.samereadgroup.cleaned	10192	10195		YPO_RS01055	3
KNK001ss_ds.merged.samereadgroup.cleaned	19635	19650		mobB	15
KNK001ss_ds.merged.samereadgroup.cleaned	21507	21511		YPO_RS01110	4
KNK001ss_ds.merged.samereadgroup.cleaned	63071	63095		rpmG	24
KNK001ss_ds.merged.samereadgroup.cleaned	78268	78270		gpsA	2
KNK001ss_ds.merged.samereadgroup.cleaned	81470	81493		ada	23
KNK001ss_ds.merged.samereadgroup.cleaned	97634	97635		YPO_RS01470	1
KNK001ss_ds.merged.samereadgroup.cleaned	106564	106585		YPO_RS01520	21
KNK001ss_ds.merged.samereadgroup.cleaned	112374	112388		YPO_RS01550	14
KNK001ss_ds.merged.samereadgroup.cleaned	159902	159921		mrcA	19
KNK001ss_ds.merged.samereadgroup.cleaned	181882	181883		YPO_RS01830	1
KNK001ss_ds.merged.samereadgroup.cleaned	196663	196686		YPO_RS01895	23
KNK001ss_ds.merged.samereadgroup.cleaned	241435	241455		def	20
KNK001ss_ds.merged.samereadgroup.cleaned	258184	258192		YPO_RS02285	8
KNK001ss_ds.merged.samereadgroup.cleaned	258747	258769		YPO_RS02290	22
KNK001ss_ds.merged.samereadgroup.cleaned	276816	276817		YPO_RS02400	1
KNK001ss_ds.merged.samereadgroup.cleaned	278899	278909		metC	10
KNK001ss_ds.merged.samereadgroup.cleaned	279051	279064		metC	13
KNK001ss_ds.merged.samereadgroup.cleaned	288862	288888		YPO_RS02455	26
KNK001ss_ds.merged.samereadgroup.cleaned	289431	289450		YPO_RS02460	19
KNK001ss_ds.merged.samereadgroup.cleaned	294448	294467		YPO_RS02485	19
KNK001ss_ds.merged.samereadgroup.cleaned	303026	303044		YPO_RS02530	18
KNK001ss_ds.merged.samereadgroup.cleaned	321767	321791		lexA	24
KNK001ss_ds.merged.samereadgroup.cleaned	346075	346111		YPO_RS02695	36
KNK001ss_ds.merged.samereadgroup.cleaned	347683	347688		YPO_RS02695	5
KNK001ss_ds.merged.samereadgroup.cleaned	359244	359253		aspA	9
KNK001ss_ds.merged.samereadgroup.cleaned	360807	360809		fxsA	2
KNK001ss_ds.merged.samereadgroup.cleaned	363914	363918		YPO_RS02760	4
KNK001ss_ds.merged.samereadgroup.cleaned	381419	381428		nnr	9
KNK001ss_ds.merged.samereadgroup.cleaned	394387	394413		nsrR	26
KNK001ss_ds.merged.samereadgroup.cleaned	394703	394706		nsrR	3
KNK001ss_ds.merged.samereadgroup.cleaned	396005	396007		rnr	2
KNK001ss_ds.merged.samereadgroup.cleaned	404308	404315		YPO_RS02940	7
KNK001ss_ds.merged.samereadgroup.cleaned	407789	407805		YPO_RS02955	16
KNK001ss_ds.merged.samereadgroup.cleaned	407856	407894		YPO_RS02955	38
KNK001ss_ds.merged.samereadgroup.cleaned	408049	408080		YPO_RS02955	31
KNK001ss_ds.merged.samereadgroup.cleaned	408164	408203		YPO_RS02955	39
KNK001ss_ds.merged.samereadgroup.cleaned	408313	408316		YPO_RS02955	3
KNK001ss_ds.merged.samereadgroup.cleaned	408387	408394		YPO_RS02955	7
KNK001ss_ds.merged.samereadgroup.cleaned	408655	408658		YPO_RS02955	3
KNK001ss_ds.merged.samereadgroup.cleaned	409042	409046		YPO_RS02960	4
KNK001ss_ds.merged.samereadgroup.cleaned	409202	409219		YPO_RS02960	17
KNK001ss_ds.merged.samereadgroup.cleaned	409396	409439		YPO_RS02960	43
KNK001ss_ds.merged.samereadgroup.cleaned	409479	409514		YPO_RS02960	35
KNK001ss_ds.merged.samereadgroup.cleaned	409569	409595		YPO_RS02965	26
KNK001ss_ds.merged.samereadgroup.cleaned	409677	409756		YPO_RS02965	79
KNK001ss_ds.merged.samereadgroup.cleaned	409814	409894		YPO_RS02965	80
KNK001ss_ds.merged.samereadgroup.cleaned	410033	410064		YPO_RS02965	31
KNK001ss_ds.merged.samereadgroup.cleaned	410568	410583		YPO_RS02965	15
KNK001ss_ds.merged.samereadgroup.cleaned	410806	410832		YPO_RS02965	26
KNK001ss_ds.merged.samereadgroup.cleaned	410868	410891		YPO_RS02965	23
KNK001ss_ds.merged.samereadgroup.cleaned	426808	426809		lsrB	1
KNK001ss_ds.merged.samereadgroup.cleaned	431303	431315		YPO_RS03065	12
KNK001ss_ds.merged.samereadgroup.cleaned	446365	446437		YPO_RS03120	72
KNK001ss_ds.merged.samereadgroup.cleaned	478398	478406		trpR	8
KNK001ss_ds.merged.samereadgroup.cleaned	495004	495024		YPO_RS03330	20
KNK001ss_ds.merged.samereadgroup.cleaned	495143	495159		YPO_RS03330	16
KNK001ss_ds.merged.samereadgroup.cleaned	495223	495232		YPO_RS03330	9
KNK001ss_ds.merged.samereadgroup.cleaned	495317	495319		YPO_RS03330	2
KNK001ss_ds.merged.samereadgroup.cleaned	495716	495794		YPO_RS03330	78
KNK001ss_ds.merged.samereadgroup.cleaned	521134	521172		YPO_RS03450	38
KNK001ss_ds.merged.samereadgroup.cleaned	540221	540255		tssH	34
KNK001ss_ds.merged.samereadgroup.cleaned	541949	541962		tssH	13
KNK001ss_ds.merged.samereadgroup.cleaned	552920	552930		tssM	10
KNK001ss_ds.merged.samereadgroup.cleaned	584137	584148		ilvI	11
KNK001ss_ds.merged.samereadgroup.cleaned	588404	588413		cra	9
KNK001ss_ds.merged.samereadgroup.cleaned	591348	591364		rsmH	16
KNK001ss_ds.merged.samereadgroup.cleaned	592178	592200		YPO_RS03735	22
KNK001ss_ds.merged.samereadgroup.cleaned	595331	595352		murF	21
KNK001ss_ds.merged.samereadgroup.cleaned	596603	596613		mraY	10
KNK001ss_ds.merged.samereadgroup.cleaned	606086	606094		ftsZ	8
KNK001ss_ds.merged.samereadgroup.cleaned	625877	625883		YPO_RS03895	6
KNK001ss_ds.merged.samereadgroup.cleaned	629191	629195		sstT	4
KNK001ss_ds.merged.samereadgroup.cleaned	630662	630665		YPO_RS03915	3
KNK001ss_ds.merged.samereadgroup.cleaned	635504	635526		yapG	22
KNK001ss_ds.merged.samereadgroup.cleaned	638120	638162		YPO_RS03935	42
KNK001ss_ds.merged.samereadgroup.cleaned	641669	641697		YPO_RS03945	28
KNK001ss_ds.merged.samereadgroup.cleaned	642532	642535		YPO_RS03950	3
KNK001ss_ds.merged.samereadgroup.cleaned	649377	649380		cdiA	3
KNK001ss_ds.merged.samereadgroup.cleaned	653706	653727		cdiA	21
KNK001ss_ds.merged.samereadgroup.cleaned	656391	656398		cdiA	7
KNK001ss_ds.merged.samereadgroup.cleaned	656679	656684		cdiA	5
KNK001ss_ds.merged.samereadgroup.cleaned	659370	659388		cdiI	18
KNK001ss_ds.merged.samereadgroup.cleaned	659745	659746		YPO_RS03995	1
KNK001ss_ds.merged.samereadgroup.cleaned	660154	660167		YPO_RS04005	13
KNK001ss_ds.merged.samereadgroup.cleaned	667949	667987		YPO_RS04035	38
KNK001ss_ds.merged.samereadgroup.cleaned	673937	673940		YPO_RS04055	3
KNK001ss_ds.merged.samereadgroup.cleaned	677267	677277		YPO_RS04070	10
KNK001ss_ds.merged.samereadgroup.cleaned	682747	682759		mdtN	12
KNK001ss_ds.merged.samereadgroup.cleaned	684440	684455		YPO_RS04100	15
KNK001ss_ds.merged.samereadgroup.cleaned	686872	686873		YPO_RS04110	1
KNK001ss_ds.merged.samereadgroup.cleaned	687300	687301		YPO_RS04110	1
KNK001ss_ds.merged.samereadgroup.cleaned	687943	687977		YPO_RS04115	34
KNK001ss_ds.merged.samereadgroup.cleaned	697576	697581		YPO_RS04175	5
KNK001ss_ds.merged.samereadgroup.cleaned	704996	705022		plsY	26
KNK001ss_ds.merged.samereadgroup.cleaned	713805	713814		glnE	9
KNK001ss_ds.merged.samereadgroup.cleaned	731953	731960		parC	7
KNK001ss_ds.merged.samereadgroup.cleaned	749293	749314		YPO_RS04405	21
KNK001ss_ds.merged.samereadgroup.cleaned	749627	749644		YPO_RS04405	17
KNK001ss_ds.merged.samereadgroup.cleaned	749629	749644		YPO_RS04410	15
KNK001ss_ds.merged.samereadgroup.cleaned	750089	750119		YPO_RS04410	30
KNK001ss_ds.merged.samereadgroup.cleaned	750248	750280		YPO_RS04410	32
KNK001ss_ds.merged.samereadgroup.cleaned	750433	750462		YPO_RS04410	29
KNK001ss_ds.merged.samereadgroup.cleaned	750459	750542		YPO_RS04415	83
KNK001ss_ds.merged.samereadgroup.cleaned	750952	750953		YPO_RS04415	1
KNK001ss_ds.merged.samereadgroup.cleaned	751034	751065		YPO_RS04415	31
KNK001ss_ds.merged.samereadgroup.cleaned	751127	751149		YPO_RS04415	22
KNK001ss_ds.merged.samereadgroup.cleaned	752435	752463		YPO_RS04420	28
KNK001ss_ds.merged.samereadgroup.cleaned	752602	752617		YPO_RS04420	15
KNK001ss_ds.merged.samereadgroup.cleaned	752629	752694		YPO_RS04425	65
KNK001ss_ds.merged.samereadgroup.cleaned	753103	753104		YPO_RS04425	1
KNK001ss_ds.merged.samereadgroup.cleaned	753539	753623		YPO_RS04425	84
KNK001ss_ds.merged.samereadgroup.cleaned	753870	753922		YPO_RS04430	52
KNK001ss_ds.merged.samereadgroup.cleaned	754426	754427		YPO_RS04435	1
KNK001ss_ds.merged.samereadgroup.cleaned	754779	754784		YPO_RS04440	5
KNK001ss_ds.merged.samereadgroup.cleaned	754832	754854		YPO_RS04440	22
KNK001ss_ds.merged.samereadgroup.cleaned	754991	755017		YPO_RS04440	26
KNK001ss_ds.merged.samereadgroup.cleaned	755316	755372		YPO_RS04440	56
KNK001ss_ds.merged.samereadgroup.cleaned	755369	755375		YPO_RS04445	6
KNK001ss_ds.merged.samereadgroup.cleaned	755543	755561		YPO_RS04445	18
KNK001ss_ds.merged.samereadgroup.cleaned	755668	755669		YPO_RS04445	1
KNK001ss_ds.merged.samereadgroup.cleaned	758439	758462		YPO_RS04465	23
KNK001ss_ds.merged.samereadgroup.cleaned	772983	772997		YPO_RS04525	14
KNK001ss_ds.merged.samereadgroup.cleaned	781510	781522		flgA	12
KNK001ss_ds.merged.samereadgroup.cleaned	782240	782264		flgA	24
KNK001ss_ds.merged.samereadgroup.cleaned	784100	784123		flaE	23
KNK001ss_ds.merged.samereadgroup.cleaned	785304	785319		YPO_RS04600	15
KNK001ss_ds.merged.samereadgroup.cleaned	793919	793925		YPO_RS04655	6
KNK001ss_ds.merged.samereadgroup.cleaned	796058	796078		YPO_RS04660	20
KNK001ss_ds.merged.samereadgroup.cleaned	799315	799317		YPO_RS04670	2
KNK001ss_ds.merged.samereadgroup.cleaned	801484	801501		fliS	17
KNK001ss_ds.merged.samereadgroup.cleaned	803234	803237		YPO_RS04695	3
KNK001ss_ds.merged.samereadgroup.cleaned	806658	806692		YPO_RS04715	34
KNK001ss_ds.merged.samereadgroup.cleaned	807619	807695		YPO_RS04720	76
KNK001ss_ds.merged.samereadgroup.cleaned	807690	807695		YPO_RS04725	5
KNK001ss_ds.merged.samereadgroup.cleaned	808986	809046		YPO_RS04735	60
KNK001ss_ds.merged.samereadgroup.cleaned	809185	809224		YPO_RS04735	39
KNK001ss_ds.merged.samereadgroup.cleaned	836203	836236		YPO_RS04805	33
KNK001ss_ds.merged.samereadgroup.cleaned	838836	838905		YPO_RS04815	69
KNK001ss_ds.merged.samereadgroup.cleaned	845400	845512		YPO_RS04835	112
KNK001ss_ds.merged.samereadgroup.cleaned	845543	845634		YPO_RS04835	91
KNK001ss_ds.merged.samereadgroup.cleaned	851568	851577		YPO_RS04845	9
KNK001ss_ds.merged.samereadgroup.cleaned	867707	867709		YPO_RS04900	2
KNK001ss_ds.merged.samereadgroup.cleaned	867901	867919		YPO_RS04900	18
KNK001ss_ds.merged.samereadgroup.cleaned	884369	884379		YPO_RS04965	10
KNK001ss_ds.merged.samereadgroup.cleaned	884440	884475		YPO_RS04965	35
KNK001ss_ds.merged.samereadgroup.cleaned	885677	885714		YPO_RS04975	37
KNK001ss_ds.merged.samereadgroup.cleaned	886215	886235		YPO_RS04975	20
KNK001ss_ds.merged.samereadgroup.cleaned	886308	886321		YPO_RS04975	13
KNK001ss_ds.merged.samereadgroup.cleaned	886498	886545		YPO_RS04980	47
KNK001ss_ds.merged.samereadgroup.cleaned	886606	886679		YPO_RS04980	73
KNK001ss_ds.merged.samereadgroup.cleaned	886759	886790		YPO_RS04980	31
KNK001ss_ds.merged.samereadgroup.cleaned	887098	887115		gspL	17
KNK001ss_ds.merged.samereadgroup.cleaned	887770	887772		gspL	2
KNK001ss_ds.merged.samereadgroup.cleaned	888114	888203		YPO_RS04990	89
KNK001ss_ds.merged.samereadgroup.cleaned	888419	888435		YPO_RS04990	16
KNK001ss_ds.merged.samereadgroup.cleaned	888598	888599		YPO_RS04990	1
KNK001ss_ds.merged.samereadgroup.cleaned	889204	889225		gspJ	21
KNK001ss_ds.merged.samereadgroup.cleaned	889294	889317		gspJ	23
KNK001ss_ds.merged.samereadgroup.cleaned	889509	889512		gspJ	3
KNK001ss_ds.merged.samereadgroup.cleaned	889985	890010		YPO_RS05005	25
KNK001ss_ds.merged.samereadgroup.cleaned	890240	890244		YPO_RS05005	4
KNK001ss_ds.merged.samereadgroup.cleaned	890965	890968		gspG	3
KNK001ss_ds.merged.samereadgroup.cleaned	893705	893804		gspD	99
KNK001ss_ds.merged.samereadgroup.cleaned	893882	893885		gspD	3
KNK001ss_ds.merged.samereadgroup.cleaned	894844	894872		gspD	28
KNK001ss_ds.merged.samereadgroup.cleaned	894943	894958		gspD	15
KNK001ss_ds.merged.samereadgroup.cleaned	895444	895532		gspD	88
KNK001ss_ds.merged.samereadgroup.cleaned	895604	895606		gspD	2
KNK001ss_ds.merged.samereadgroup.cleaned	895689	895760		YPO_RS05030	71
KNK001ss_ds.merged.samereadgroup.cleaned	895940	895951		YPO_RS05030	11
KNK001ss_ds.merged.samereadgroup.cleaned	896146	896190		YPO_RS05030	44
KNK001ss_ds.merged.samereadgroup.cleaned	896308	896355		YPO_RS05035	47
KNK001ss_ds.merged.samereadgroup.cleaned	896478	896480		YPO_RS05035	2
KNK001ss_ds.merged.samereadgroup.cleaned	897450	897457		YPO_RS05040	7
KNK001ss_ds.merged.samereadgroup.cleaned	908125	908126		tnpA	1
KNK001ss_ds.merged.samereadgroup.cleaned	909821	909822		YPO_RS05080	1
KNK001ss_ds.merged.samereadgroup.cleaned	922957	922976		YPO_RS05140	19
KNK001ss_ds.merged.samereadgroup.cleaned	950120	950185		YPO_RS05235	65
KNK001ss_ds.merged.samereadgroup.cleaned	952604	952610		YPO_RS05245	6
KNK001ss_ds.merged.samereadgroup.cleaned	953659	953768		YPO_RS05260	109
KNK001ss_ds.merged.samereadgroup.cleaned	962609	962610		YPO_RS05295	1
KNK001ss_ds.merged.samereadgroup.cleaned	963638	963657		YPO_RS05310	19
KNK001ss_ds.merged.samereadgroup.cleaned	966525	966548		YPO_RS05330	23
KNK001ss_ds.merged.samereadgroup.cleaned	976994	977004		dsbC	10
KNK001ss_ds.merged.samereadgroup.cleaned	978714	978728		creD	14
KNK001ss_ds.merged.samereadgroup.cleaned	997028	997032		ubiI	4
KNK001ss_ds.merged.samereadgroup.cleaned	1010764	1010767		fbaA	3
KNK001ss_ds.merged.samereadgroup.cleaned	1020699	1020706		speA	7
KNK001ss_ds.merged.samereadgroup.cleaned	1039769	1039799		YPO_RS05675	30
KNK001ss_ds.merged.samereadgroup.cleaned	1040317	1040319		YPO_RS05675	2
KNK001ss_ds.merged.samereadgroup.cleaned	1040886	1040903		YPO_RS05675	17
KNK001ss_ds.merged.samereadgroup.cleaned	1042522	1042525		YPO_RS05675	3
KNK001ss_ds.merged.samereadgroup.cleaned	1043767	1043791		YPO_RS05675	24
KNK001ss_ds.merged.samereadgroup.cleaned	1043958	1043971		YPO_RS05675	13
KNK001ss_ds.merged.samereadgroup.cleaned	1045070	1045128		YPO_RS05675	58
KNK001ss_ds.merged.samereadgroup.cleaned	1045403	1045408		YPO_RS05675	5
KNK001ss_ds.merged.samereadgroup.cleaned	1045525	1045589		YPO_RS05675	64
KNK001ss_ds.merged.samereadgroup.cleaned	1045841	1045859		YPO_RS05675	18
KNK001ss_ds.merged.samereadgroup.cleaned	1046493	1046578		YPO_RS05675	85
KNK001ss_ds.merged.samereadgroup.cleaned	1046682	1046714		YPO_RS05675	32
KNK001ss_ds.merged.samereadgroup.cleaned	1053163	1053176		mltC	13
KNK001ss_ds.merged.samereadgroup.cleaned	1056040	1056041		YPO_RS05720	1
KNK001ss_ds.merged.samereadgroup.cleaned	1066699	1066703		YPO_RS05765	4
KNK001ss_ds.merged.samereadgroup.cleaned	1066850	1066880		YPO_RS05765	30
KNK001ss_ds.merged.samereadgroup.cleaned	1066968	1066990		YPO_RS05765	22
KNK001ss_ds.merged.samereadgroup.cleaned	1067235	1067251		YPO_RS05765	16
KNK001ss_ds.merged.samereadgroup.cleaned	1067324	1067381		YPO_RS05765	57
KNK001ss_ds.merged.samereadgroup.cleaned	1067376	1067381		YPO_RS05770	5
KNK001ss_ds.merged.samereadgroup.cleaned	1068122	1068165		YPO_RS05770	43
KNK001ss_ds.merged.samereadgroup.cleaned	1071909	1071915		YPO_RS05790	6
KNK001ss_ds.merged.samereadgroup.cleaned	1073116	1073126		YPO_RS05795	10
KNK001ss_ds.merged.samereadgroup.cleaned	1081005	1081023		YPO_RS05815	18
KNK001ss_ds.merged.samereadgroup.cleaned	1081567	1081579		YPO_RS05815	12
KNK001ss_ds.merged.samereadgroup.cleaned	1084041	1084045		tssK	4
KNK001ss_ds.merged.samereadgroup.cleaned	1088713	1088717		YPO_RS05845	4
KNK001ss_ds.merged.samereadgroup.cleaned	1089061	1089082		YPO_RS05845	21
KNK001ss_ds.merged.samereadgroup.cleaned	1090062	1090064		YPO_RS05850	2
KNK001ss_ds.merged.samereadgroup.cleaned	1091419	1091420		YPO_RS05855	1
KNK001ss_ds.merged.samereadgroup.cleaned	1108840	1108841		YPO_RS05915	1
KNK001ss_ds.merged.samereadgroup.cleaned	1111279	1111292		YPO_RS05920	13
KNK001ss_ds.merged.samereadgroup.cleaned	1115334	1115343		YPO_RS05935	9
KNK001ss_ds.merged.samereadgroup.cleaned	1116996	1117014		YPO_RS05940	18
KNK001ss_ds.merged.samereadgroup.cleaned	1117274	1117294		YPO_RS05940	20
KNK001ss_ds.merged.samereadgroup.cleaned	1117788	1117802		YPO_RS05940	14
KNK001ss_ds.merged.samereadgroup.cleaned	1118009	1118025		YPO_RS05940	16
KNK001ss_ds.merged.samereadgroup.cleaned	1118101	1118107		YPO_RS05940	6
KNK001ss_ds.merged.samereadgroup.cleaned	1121576	1121592		yapH	16
KNK001ss_ds.merged.samereadgroup.cleaned	1121834	1121841		yapH	7
KNK001ss_ds.merged.samereadgroup.cleaned	1124433	1124435		yapH	2
KNK001ss_ds.merged.samereadgroup.cleaned	1125972	1125974		yapH	2
KNK001ss_ds.merged.samereadgroup.cleaned	1131526	1131529		YPO_RS05955	3
KNK001ss_ds.merged.samereadgroup.cleaned	1132030	1132044		YPO_RS05955	14
KNK001ss_ds.merged.samereadgroup.cleaned	1141644	1141667		YPO_RS05985	23
KNK001ss_ds.merged.samereadgroup.cleaned	1142197	1142230		YPO_RS05985	33
KNK001ss_ds.merged.samereadgroup.cleaned	1142425	1142437		YPO_RS05985	12
KNK001ss_ds.merged.samereadgroup.cleaned	1149710	1149711		recC	1
KNK001ss_ds.merged.samereadgroup.cleaned	1151715	1151729		recC	14
KNK001ss_ds.merged.samereadgroup.cleaned	1156047	1156051		recB	4
KNK001ss_ds.merged.samereadgroup.cleaned	1167629	1167630		csdE	1
KNK001ss_ds.merged.samereadgroup.cleaned	1174185	1174217		YPO_RS06110	32
KNK001ss_ds.merged.samereadgroup.cleaned	1214953	1214962		metI	9
KNK001ss_ds.merged.samereadgroup.cleaned	1221219	1221226		YPO_RS06340	7
KNK001ss_ds.merged.samereadgroup.cleaned	1226722	1226731		mltD	9
KNK001ss_ds.merged.samereadgroup.cleaned	1227218	1227225		gloB	7
KNK001ss_ds.merged.samereadgroup.cleaned	1240951	1240965		YPO_RS06465	14
KNK001ss_ds.merged.samereadgroup.cleaned	1241035	1241131		YPO_RS06465	96
KNK001ss_ds.merged.samereadgroup.cleaned	1241994	1242020		YPO_RS06465	26
KNK001ss_ds.merged.samereadgroup.cleaned	1242431	1242478		YPO_RS06470	47
KNK001ss_ds.merged.samereadgroup.cleaned	1243182	1243239		YPO_RS06470	57
KNK001ss_ds.merged.samereadgroup.cleaned	1251907	1251909		YPO_RS06525	2
KNK001ss_ds.merged.samereadgroup.cleaned	1260338	1260340		odhB	2
KNK001ss_ds.merged.samereadgroup.cleaned	1260871	1260879		odhB	8
KNK001ss_ds.merged.samereadgroup.cleaned	1269588	1269655		tolA	67
KNK001ss_ds.merged.samereadgroup.cleaned	1271111	1271123		tolB	12
KNK001ss_ds.merged.samereadgroup.cleaned	1277527	1277555		aroG	28
KNK001ss_ds.merged.samereadgroup.cleaned	1278059	1278062		aroG	3
KNK001ss_ds.merged.samereadgroup.cleaned	1285938	1285941		galE	3
KNK001ss_ds.merged.samereadgroup.cleaned	1298698	1298708		bioF	10
KNK001ss_ds.merged.samereadgroup.cleaned	1311991	1312000		betA	9
KNK001ss_ds.merged.samereadgroup.cleaned	1322379	1322396		YPO_RS06875	17
KNK001ss_ds.merged.samereadgroup.cleaned	1322735	1322738		YPO_RS06875	3
KNK001ss_ds.merged.samereadgroup.cleaned	1331072	1331100		phnC	28
KNK001ss_ds.merged.samereadgroup.cleaned	1334851	1334854		YPO_RS06940	3
KNK001ss_ds.merged.samereadgroup.cleaned	1339452	1339454		urtC	2
KNK001ss_ds.merged.samereadgroup.cleaned	1340334	1340335		urtD	1
KNK001ss_ds.merged.samereadgroup.cleaned	1346428	1346430		YPO_RS06990	2
KNK001ss_ds.merged.samereadgroup.cleaned	1347233	1347239		YPO_RS06995	6
KNK001ss_ds.merged.samereadgroup.cleaned	1350132	1350144		adiC	12
KNK001ss_ds.merged.samereadgroup.cleaned	1365354	1365363		eco	9
KNK001ss_ds.merged.samereadgroup.cleaned	1378600	1378611		rcsD	11
KNK001ss_ds.merged.samereadgroup.cleaned	1388245	1388251		YPO_RS07145	6
KNK001ss_ds.merged.samereadgroup.cleaned	1391781	1391796		ycoA	15
KNK001ss_ds.merged.samereadgroup.cleaned	1392289	1392317		ycoA	28
KNK001ss_ds.merged.samereadgroup.cleaned	1397884	1397917		YPO_RS07190	33
KNK001ss_ds.merged.samereadgroup.cleaned	1399584	1399585		YPO_RS07200	1
KNK001ss_ds.merged.samereadgroup.cleaned	1407103	1407113		YPO_RS07240	10
KNK001ss_ds.merged.samereadgroup.cleaned	1407110	1407117		YPO_RS07245	7
KNK001ss_ds.merged.samereadgroup.cleaned	1407925	1407941		YPO_RS07250	16
KNK001ss_ds.merged.samereadgroup.cleaned	1409640	1409643		YPO_RS07265	3
KNK001ss_ds.merged.samereadgroup.cleaned	1410751	1410760		YPO_RS07270	9
KNK001ss_ds.merged.samereadgroup.cleaned	1413161	1413173		YPO_RS07280	12
KNK001ss_ds.merged.samereadgroup.cleaned	1430531	1430536		YPO_RS07360	5
KNK001ss_ds.merged.samereadgroup.cleaned	1438628	1438658		YPO_RS07390	30
KNK001ss_ds.merged.samereadgroup.cleaned	1449537	1449540		YPO_RS07435	3
KNK001ss_ds.merged.samereadgroup.cleaned	1449833	1449834		YPO_RS07435	1
KNK001ss_ds.merged.samereadgroup.cleaned	1451317	1451323		xylB	6
KNK001ss_ds.merged.samereadgroup.cleaned	1461578	1461604		YPO_RS07485	26
KNK001ss_ds.merged.samereadgroup.cleaned	1461797	1461830		YPO_RS07490	33
KNK001ss_ds.merged.samereadgroup.cleaned	1462227	1462231		YPO_RS07490	4
KNK001ss_ds.merged.samereadgroup.cleaned	1463379	1463419		YPO_RS07500	40
KNK001ss_ds.merged.samereadgroup.cleaned	1464015	1464054		YPO_RS07500	39
KNK001ss_ds.merged.samereadgroup.cleaned	1464890	1464892		psaC	2
KNK001ss_ds.merged.samereadgroup.cleaned	1474370	1474372		YPO_RS07535	2
KNK001ss_ds.merged.samereadgroup.cleaned	1477039	1477044		YPO_RS07545	5
KNK001ss_ds.merged.samereadgroup.cleaned	1505630	1505634		YPO_RS07680	4
KNK001ss_ds.merged.samereadgroup.cleaned	1505975	1505985		YPO_RS07685	10
KNK001ss_ds.merged.samereadgroup.cleaned	1512236	1512239		YPO_RS07720	3
KNK001ss_ds.merged.samereadgroup.cleaned	1517034	1517052		YPO_RS07755	18
KNK001ss_ds.merged.samereadgroup.cleaned	1519646	1519649		YPO_RS07770	3
KNK001ss_ds.merged.samereadgroup.cleaned	1539741	1539759		aat	18
KNK001ss_ds.merged.samereadgroup.cleaned	1552134	1552150		YPO_RS07880	16
KNK001ss_ds.merged.samereadgroup.cleaned	1555720	1555727		pflA	7
KNK001ss_ds.merged.samereadgroup.cleaned	1563540	1563547		YPO_RS07915	7
KNK001ss_ds.merged.samereadgroup.cleaned	1563862	1563867		ansB	5
KNK001ss_ds.merged.samereadgroup.cleaned	1565985	1566005		YPO_RS07925	20
KNK001ss_ds.merged.samereadgroup.cleaned	1566373	1566377		YPO_RS07930	4
KNK001ss_ds.merged.samereadgroup.cleaned	1567527	1567534		YPO_RS07930	7
KNK001ss_ds.merged.samereadgroup.cleaned	1567859	1567863		YPO_RS07930	4
KNK001ss_ds.merged.samereadgroup.cleaned	1569985	1569988		aroA	3
KNK001ss_ds.merged.samereadgroup.cleaned	1580769	1580770		YPO_RS07975	1
KNK001ss_ds.merged.samereadgroup.cleaned	1580948	1580961		YPO_RS07975	13
KNK001ss_ds.merged.samereadgroup.cleaned	1581175	1581182		YPO_RS07975	7
KNK001ss_ds.merged.samereadgroup.cleaned	1592975	1592980		mukB	5
KNK001ss_ds.merged.samereadgroup.cleaned	1595718	1595753		ldtD	35
KNK001ss_ds.merged.samereadgroup.cleaned	1596478	1596483		YPO_RS08030	5
KNK001ss_ds.merged.samereadgroup.cleaned	1605474	1605476		pepN	2
KNK001ss_ds.merged.samereadgroup.cleaned	1647598	1647673		YPO_RS08260	75
KNK001ss_ds.merged.samereadgroup.cleaned	1648195	1648199		YPO_RS08265	4
KNK001ss_ds.merged.samereadgroup.cleaned	1649316	1649320		YPO_RS08265	4
KNK001ss_ds.merged.samereadgroup.cleaned	1649998	1650000		YPO_RS08270	2
KNK001ss_ds.merged.samereadgroup.cleaned	1650575	1650576		YPO_RS08275	1
KNK001ss_ds.merged.samereadgroup.cleaned	1652424	1652428		YPO_RS08285	4
KNK001ss_ds.merged.samereadgroup.cleaned	1657142	1657143		tssC	1
KNK001ss_ds.merged.samereadgroup.cleaned	1658264	1658265		tssC	1
KNK001ss_ds.merged.samereadgroup.cleaned	1661109	1661119		YPO_RS08330	10
KNK001ss_ds.merged.samereadgroup.cleaned	1662188	1662205		YPO_RS08330	17
KNK001ss_ds.merged.samereadgroup.cleaned	1665628	1665637		tssH	9
KNK001ss_ds.merged.samereadgroup.cleaned	1669974	1669978		YPO_RS08350	4
KNK001ss_ds.merged.samereadgroup.cleaned	1670179	1670190		YPO_RS08350	11
KNK001ss_ds.merged.samereadgroup.cleaned	1670473	1670485		YPO_RS08355	12
KNK001ss_ds.merged.samereadgroup.cleaned	1670573	1670578		YPO_RS08355	5
KNK001ss_ds.merged.samereadgroup.cleaned	1670719	1670726		YPO_RS08355	7
KNK001ss_ds.merged.samereadgroup.cleaned	1674246	1674255		YPO_RS08370	9
KNK001ss_ds.merged.samereadgroup.cleaned	1677063	1677064		YPO_RS08380	1
KNK001ss_ds.merged.samereadgroup.cleaned	1678166	1678173		YPO_RS08385	7
KNK001ss_ds.merged.samereadgroup.cleaned	1682661	1682666		tssA	5
KNK001ss_ds.merged.samereadgroup.cleaned	1683769	1683775		YPO_RS08395	6
KNK001ss_ds.merged.samereadgroup.cleaned	1684040	1684143		YPO_RS08400	103
KNK001ss_ds.merged.samereadgroup.cleaned	1684446	1684481		YPO_RS08400	35
KNK001ss_ds.merged.samereadgroup.cleaned	1685397	1685401		tssF	4
KNK001ss_ds.merged.samereadgroup.cleaned	1685808	1685854		tssF	46
KNK001ss_ds.merged.samereadgroup.cleaned	1686157	1686167		tssF	10
KNK001ss_ds.merged.samereadgroup.cleaned	1689384	1689388		YPO_RS08425	4
KNK001ss_ds.merged.samereadgroup.cleaned	1690630	1690644		YPO_RS08430	14
KNK001ss_ds.merged.samereadgroup.cleaned	1698454	1698455		darE	1
KNK001ss_ds.merged.samereadgroup.cleaned	1699163	1699164		darE	1
KNK001ss_ds.merged.samereadgroup.cleaned	1700286	1700371		darC	85
KNK001ss_ds.merged.samereadgroup.cleaned	1701085	1701136		darC	51
KNK001ss_ds.merged.samereadgroup.cleaned	1701351	1701383		darB	32
KNK001ss_ds.merged.samereadgroup.cleaned	1701728	1701735		darB	7
KNK001ss_ds.merged.samereadgroup.cleaned	1703242	1703254		darB	12
KNK001ss_ds.merged.samereadgroup.cleaned	1711411	1711415		mglB	4
KNK001ss_ds.merged.samereadgroup.cleaned	1712725	1712762		mglA	37
KNK001ss_ds.merged.samereadgroup.cleaned	1725955	1725960		YPO_RS08570	5
KNK001ss_ds.merged.samereadgroup.cleaned	1726212	1726308		YPO_RS08570	96
KNK001ss_ds.merged.samereadgroup.cleaned	1730422	1730430		metG	8
KNK001ss_ds.merged.samereadgroup.cleaned	1732829	1732845		udk	16
KNK001ss_ds.merged.samereadgroup.cleaned	1738563	1738568		fhuF	5
KNK001ss_ds.merged.samereadgroup.cleaned	1739131	1739151		fhuF	20
KNK001ss_ds.merged.samereadgroup.cleaned	1739318	1739322		YPO_RS08625	4
KNK001ss_ds.merged.samereadgroup.cleaned	1741183	1741187		YPO_RS08630	4
KNK001ss_ds.merged.samereadgroup.cleaned	1751040	1751050		YPO_RS08665	10
KNK001ss_ds.merged.samereadgroup.cleaned	1751988	1752008		YPO_RS08670	20
KNK001ss_ds.merged.samereadgroup.cleaned	1763891	1763893		hisD	2
KNK001ss_ds.merged.samereadgroup.cleaned	1771603	1771616		YPO_RS08765	13
KNK001ss_ds.merged.samereadgroup.cleaned	1795959	1795978		YPO_RS08855	19
KNK001ss_ds.merged.samereadgroup.cleaned	1796041	1796045		YPO_RS08855	4
KNK001ss_ds.merged.samereadgroup.cleaned	1796134	1796147		YPO_RS08855	13
KNK001ss_ds.merged.samereadgroup.cleaned	1803538	1803546		YPO_RS08895	8
KNK001ss_ds.merged.samereadgroup.cleaned	1806990	1807010		YPO_RS08905	20
KNK001ss_ds.merged.samereadgroup.cleaned	1808300	1808308		bssS	8
KNK001ss_ds.merged.samereadgroup.cleaned	1811445	1811460		YPO_RS08940	15
KNK001ss_ds.merged.samereadgroup.cleaned	1813082	1813093		rne	11
KNK001ss_ds.merged.samereadgroup.cleaned	1820336	1820344		plsX	8
KNK001ss_ds.merged.samereadgroup.cleaned	1837738	1837765		nagZ	27
KNK001ss_ds.merged.samereadgroup.cleaned	1847149	1847154		mfd	5
KNK001ss_ds.merged.samereadgroup.cleaned	1856042	1856052		pepT	10
KNK001ss_ds.merged.samereadgroup.cleaned	1866421	1866424		icd	3
KNK001ss_ds.merged.samereadgroup.cleaned	1878316	1878350		YPO_RS09250	34
KNK001ss_ds.merged.samereadgroup.cleaned	1898994	1898996		YPO_RS09320	2
KNK001ss_ds.merged.samereadgroup.cleaned	1907134	1907159		YPO_RS09345	25
KNK001ss_ds.merged.samereadgroup.cleaned	1918291	1918296		YPO_RS09385	5
KNK001ss_ds.merged.samereadgroup.cleaned	1919039	1919055		YPO_RS09385	16
KNK001ss_ds.merged.samereadgroup.cleaned	1919814	1919817		YPO_RS09390	3
KNK001ss_ds.merged.samereadgroup.cleaned	1921263	1921274		YPO_RS09390	11
KNK001ss_ds.merged.samereadgroup.cleaned	1926295	1926296		YPO_RS09415	1
KNK001ss_ds.merged.samereadgroup.cleaned	1930682	1930685		YPO_RS09435	3
KNK001ss_ds.merged.samereadgroup.cleaned	1933851	1933882		YPO_RS09455	31
KNK001ss_ds.merged.samereadgroup.cleaned	1938357	1938374		YPO_RS09475	17
KNK001ss_ds.merged.samereadgroup.cleaned	1940606	1940638		YPO_RS09480	32
KNK001ss_ds.merged.samereadgroup.cleaned	1949331	1949338		YPO_RS09515	7
KNK001ss_ds.merged.samereadgroup.cleaned	1949794	1949796		YPO_RS09515	2
KNK001ss_ds.merged.samereadgroup.cleaned	1950483	1950491		YPO_RS09520	8
KNK001ss_ds.merged.samereadgroup.cleaned	1963164	1963167		YPO_RS09565	3
KNK001ss_ds.merged.samereadgroup.cleaned	1968953	1968959		YPO_RS09590	6
KNK001ss_ds.merged.samereadgroup.cleaned	1976629	1976635		YPO_RS09630	6
KNK001ss_ds.merged.samereadgroup.cleaned	1983850	1983852		YPO_RS09675	2
KNK001ss_ds.merged.samereadgroup.cleaned	1985802	1985814		YPO_RS09695	12
KNK001ss_ds.merged.samereadgroup.cleaned	1989954	1989955		pgeF	1
KNK001ss_ds.merged.samereadgroup.cleaned	1996047	1996051		YPO_RS09745	4
KNK001ss_ds.merged.samereadgroup.cleaned	1999858	1999874		mntP	16
KNK001ss_ds.merged.samereadgroup.cleaned	2007865	2007867		YPO_RS09795	2
KNK001ss_ds.merged.samereadgroup.cleaned	2010783	2010790		YPO_RS09810	7
KNK001ss_ds.merged.samereadgroup.cleaned	2012200	2012230		hpaI	30
KNK001ss_ds.merged.samereadgroup.cleaned	2012960	2012964		hpaX	4
KNK001ss_ds.merged.samereadgroup.cleaned	2015831	2015869		hpaC	38
KNK001ss_ds.merged.samereadgroup.cleaned	2016696	2016697		YPO_RS09840	1
KNK001ss_ds.merged.samereadgroup.cleaned	2033187	2033191		YPO_RS09920	4
KNK001ss_ds.merged.samereadgroup.cleaned	2044808	2044813		flgC	5
KNK001ss_ds.merged.samereadgroup.cleaned	2047226	2047229		YPO_RS09990	3
KNK001ss_ds.merged.samereadgroup.cleaned	2051067	2051078		flgJ	11
KNK001ss_ds.merged.samereadgroup.cleaned	2060620	2060627		YPO_RS10045	7
KNK001ss_ds.merged.samereadgroup.cleaned	2064282	2064292		YPO_RS10060	10
KNK001ss_ds.merged.samereadgroup.cleaned	2070411	2070482		YPO_RS10110	71
KNK001ss_ds.merged.samereadgroup.cleaned	2072562	2072578		fliI	16
KNK001ss_ds.merged.samereadgroup.cleaned	2080225	2080266		YPO_RS10165	41
KNK001ss_ds.merged.samereadgroup.cleaned	2081652	2081676		YPO_RS10170	24
KNK001ss_ds.merged.samereadgroup.cleaned	2088386	2088389		YPO_RS10200	3
KNK001ss_ds.merged.samereadgroup.cleaned	2090051	2090060		YPO_RS10210	9
KNK001ss_ds.merged.samereadgroup.cleaned	2090849	2090851		YPO_RS10210	2
KNK001ss_ds.merged.samereadgroup.cleaned	2091629	2091633		tcyJ	4
KNK001ss_ds.merged.samereadgroup.cleaned	2092177	2092191		tcyL	14
KNK001ss_ds.merged.samereadgroup.cleaned	2096694	2096701		putA	7
KNK001ss_ds.merged.samereadgroup.cleaned	2098331	2098343		putA	12
KNK001ss_ds.merged.samereadgroup.cleaned	2110339	2110341		YPO_RS10295	2
KNK001ss_ds.merged.samereadgroup.cleaned	2110751	2110760		YPO_RS10300	9
KNK001ss_ds.merged.samereadgroup.cleaned	2117604	2117631		YPO_RS10355	27
KNK001ss_ds.merged.samereadgroup.cleaned	2117742	2117786		YPO_RS10355	44
KNK001ss_ds.merged.samereadgroup.cleaned	2118328	2118347		hcp	19
KNK001ss_ds.merged.samereadgroup.cleaned	2122650	2122654		YPO_RS10395	4
KNK001ss_ds.merged.samereadgroup.cleaned	2123439	2123467		YPO_RS10405	28
KNK001ss_ds.merged.samereadgroup.cleaned	2126495	2126552		YPO_RS10415	57
KNK001ss_ds.merged.samereadgroup.cleaned	2126752	2126788		YPO_RS10420	36
KNK001ss_ds.merged.samereadgroup.cleaned	2129575	2129581		YPO_RS10435	6
KNK001ss_ds.merged.samereadgroup.cleaned	2129700	2129703		YPO_RS10435	3
KNK001ss_ds.merged.samereadgroup.cleaned	2134600	2134606		YPO_RS10460	6
KNK001ss_ds.merged.samereadgroup.cleaned	2138506	2138526		YPO_RS10495	20
KNK001ss_ds.merged.samereadgroup.cleaned	2139152	2139160		YPO_RS10505	8
KNK001ss_ds.merged.samereadgroup.cleaned	2145546	2145552		ybtU	6
KNK001ss_ds.merged.samereadgroup.cleaned	2146057	2146061		ybtU	4
KNK001ss_ds.merged.samereadgroup.cleaned	2146987	2146999		irp1	12
KNK001ss_ds.merged.samereadgroup.cleaned	2148535	2148544		irp1	9
KNK001ss_ds.merged.samereadgroup.cleaned	2148606	2148611		irp1	5
KNK001ss_ds.merged.samereadgroup.cleaned	2150862	2150876		irp1	14
KNK001ss_ds.merged.samereadgroup.cleaned	2152638	2152657		irp1	19
KNK001ss_ds.merged.samereadgroup.cleaned	2153705	2153707		irp1	2
KNK001ss_ds.merged.samereadgroup.cleaned	2154086	2154098		irp1	12
KNK001ss_ds.merged.samereadgroup.cleaned	2154317	2154319		irp1	2
KNK001ss_ds.merged.samereadgroup.cleaned	2154534	2154563		irp1	29
KNK001ss_ds.merged.samereadgroup.cleaned	2159318	2159338		irp2	20
KNK001ss_ds.merged.samereadgroup.cleaned	2164613	2164657		ybtP	44
KNK001ss_ds.merged.samereadgroup.cleaned	2165620	2165628		ybtQ	8
KNK001ss_ds.merged.samereadgroup.cleaned	2165818	2165830		ybtQ	12
KNK001ss_ds.merged.samereadgroup.cleaned	2166621	2166623		ybtQ	2
KNK001ss_ds.merged.samereadgroup.cleaned	2167166	2167218		ybtX	52
KNK001ss_ds.merged.samereadgroup.cleaned	2176156	2176164		YPO_RS10590	8
KNK001ss_ds.merged.samereadgroup.cleaned	2176686	2176708		YPO_RS10595	22
KNK001ss_ds.merged.samereadgroup.cleaned	2177658	2177672		YPO_RS10600	14
KNK001ss_ds.merged.samereadgroup.cleaned	2187156	2187167		YPO_RS10635	11
KNK001ss_ds.merged.samereadgroup.cleaned	2187675	2187686		YPO_RS10640	11
KNK001ss_ds.merged.samereadgroup.cleaned	2207446	2207452		YPO_RS10715	6
KNK001ss_ds.merged.samereadgroup.cleaned	2218037	2218044		YPO_RS10760	7
KNK001ss_ds.merged.samereadgroup.cleaned	2226461	2226476		YPO_RS10800	15
KNK001ss_ds.merged.samereadgroup.cleaned	2227549	2227561		YPO_RS10800	12
KNK001ss_ds.merged.samereadgroup.cleaned	2237356	2237397		YPO_RS10835	41
KNK001ss_ds.merged.samereadgroup.cleaned	2237397	2237406		YPO_RS10840	9
KNK001ss_ds.merged.samereadgroup.cleaned	2251531	2251534		YPO_RS10900	3
KNK001ss_ds.merged.samereadgroup.cleaned	2252955	2252957		YPO_RS10905	2
KNK001ss_ds.merged.samereadgroup.cleaned	2255811	2255816		YPO_RS10925	5
KNK001ss_ds.merged.samereadgroup.cleaned	2256144	2256183		YPO_RS10925	39
KNK001ss_ds.merged.samereadgroup.cleaned	2256523	2256539		YPO_RS10925	16
KNK001ss_ds.merged.samereadgroup.cleaned	2258636	2258640		YPO_RS10935	4
KNK001ss_ds.merged.samereadgroup.cleaned	2259155	2259164		YPO_RS10935	9
KNK001ss_ds.merged.samereadgroup.cleaned	2259866	2259897		YPO_RS10935	31
KNK001ss_ds.merged.samereadgroup.cleaned	2260001	2260014		YPO_RS10935	13
KNK001ss_ds.merged.samereadgroup.cleaned	2266242	2266246		YPO_RS10960	4
KNK001ss_ds.merged.samereadgroup.cleaned	2267206	2267208		YPO_RS10965	2
KNK001ss_ds.merged.samereadgroup.cleaned	2274732	2274737		YPO_RS11005	5
KNK001ss_ds.merged.samereadgroup.cleaned	2277258	2277280		YPO_RS11015	22
KNK001ss_ds.merged.samereadgroup.cleaned	2280589	2280616		YPO_RS11035	27
KNK001ss_ds.merged.samereadgroup.cleaned	2286155	2286165		ispE	10
KNK001ss_ds.merged.samereadgroup.cleaned	2288677	2288678		hemA	1
KNK001ss_ds.merged.samereadgroup.cleaned	2294432	2294443		YPO_RS11110	11
KNK001ss_ds.merged.samereadgroup.cleaned	2299726	2299767		YPO_RS11135	41
KNK001ss_ds.merged.samereadgroup.cleaned	2299999	2300030		YPO_RS11135	31
KNK001ss_ds.merged.samereadgroup.cleaned	2300856	2300864		YPO_RS11140	8
KNK001ss_ds.merged.samereadgroup.cleaned	2302110	2302111		YPO_RS11145	1
KNK001ss_ds.merged.samereadgroup.cleaned	2303882	2303884		YPO_RS11155	2
KNK001ss_ds.merged.samereadgroup.cleaned	2313240	2313244		YPO_RS11210	4
KNK001ss_ds.merged.samereadgroup.cleaned	2316441	2316503		YPO_RS11220	62
KNK001ss_ds.merged.samereadgroup.cleaned	2316760	2316778		YPO_RS11220	18
KNK001ss_ds.merged.samereadgroup.cleaned	2317195	2317202		YPO_RS11220	7
KNK001ss_ds.merged.samereadgroup.cleaned	2318132	2318161		YPO_RS11225	29
KNK001ss_ds.merged.samereadgroup.cleaned	2318989	2319014		YPO_RS11225	25
KNK001ss_ds.merged.samereadgroup.cleaned	2319541	2319566		YPO_RS11225	25
KNK001ss_ds.merged.samereadgroup.cleaned	2319772	2319786		YPO_RS11225	14
KNK001ss_ds.merged.samereadgroup.cleaned	2321102	2321109		YPO_RS11225	7
KNK001ss_ds.merged.samereadgroup.cleaned	2321846	2321850		YPO_RS11225	4
KNK001ss_ds.merged.samereadgroup.cleaned	2322826	2322851		YPO_RS11225	25
KNK001ss_ds.merged.samereadgroup.cleaned	2336463	2336465		ruvB	2
KNK001ss_ds.merged.samereadgroup.cleaned	2339258	2339273		znuA	15
KNK001ss_ds.merged.samereadgroup.cleaned	2340701	2340715		mepM	14
KNK001ss_ds.merged.samereadgroup.cleaned	2362355	2362359		YPO_RS11410	4
KNK001ss_ds.merged.samereadgroup.cleaned	2372954	2372962		YPO_RS11495	8
KNK001ss_ds.merged.samereadgroup.cleaned	2375653	2375657		YPO_RS11510	4
KNK001ss_ds.merged.samereadgroup.cleaned	2396165	2396173		YPO_RS11640	8
KNK001ss_ds.merged.samereadgroup.cleaned	2401221	2401245		YPO_RS11665	24
KNK001ss_ds.merged.samereadgroup.cleaned	2405309	2405317		YPO_RS11685	8
KNK001ss_ds.merged.samereadgroup.cleaned	2419838	2419853		YPO_RS11740	15
KNK001ss_ds.merged.samereadgroup.cleaned	2439472	2439484		YPO_RS11830	12
KNK001ss_ds.merged.samereadgroup.cleaned	2439594	2439598		YPO_RS11830	4
KNK001ss_ds.merged.samereadgroup.cleaned	2439755	2439773		YPO_RS11830	18
KNK001ss_ds.merged.samereadgroup.cleaned	2439901	2439941		YPO_RS11830	40
KNK001ss_ds.merged.samereadgroup.cleaned	2440154	2440228		YPO_RS11830	74
KNK001ss_ds.merged.samereadgroup.cleaned	2440487	2440495		YPO_RS11835	8
KNK001ss_ds.merged.samereadgroup.cleaned	2442325	2442327		YPO_RS11850	2
KNK001ss_ds.merged.samereadgroup.cleaned	2442325	2442327		purU	2
KNK001ss_ds.merged.samereadgroup.cleaned	2442367	2442372		purU	5
KNK001ss_ds.merged.samereadgroup.cleaned	2447302	2447308		YPO_RS11870	6
KNK001ss_ds.merged.samereadgroup.cleaned	2454792	2454794		adhE	2
KNK001ss_ds.merged.samereadgroup.cleaned	2459183	2459195		oppA	12
KNK001ss_ds.merged.samereadgroup.cleaned	2459471	2459473		oppB	2
KNK001ss_ds.merged.samereadgroup.cleaned	2463709	2463756		YPO_RS11930	47
KNK001ss_ds.merged.samereadgroup.cleaned	2470713	2470722		YPO_RS11975	9
KNK001ss_ds.merged.samereadgroup.cleaned	2475843	2475866		YPO_RS12005	23
KNK001ss_ds.merged.samereadgroup.cleaned	2477611	2477622		trpA	11
KNK001ss_ds.merged.samereadgroup.cleaned	2489401	2489437		sohB	36
KNK001ss_ds.merged.samereadgroup.cleaned	2489531	2489545		sohB	14
KNK001ss_ds.merged.samereadgroup.cleaned	2491164	2491217		topA	53
KNK001ss_ds.merged.samereadgroup.cleaned	2491753	2491760		topA	7
KNK001ss_ds.merged.samereadgroup.cleaned	2495839	2495946		YPO_RS12105	107
KNK001ss_ds.merged.samereadgroup.cleaned	2496069	2496073		YPO_RS12105	4
KNK001ss_ds.merged.samereadgroup.cleaned	2503058	2503088		YPO_RS12135	30
KNK001ss_ds.merged.samereadgroup.cleaned	2514633	2514634		YPO_RS12190	1
KNK001ss_ds.merged.samereadgroup.cleaned	2519275	2519289		YPO_RS12215	14
KNK001ss_ds.merged.samereadgroup.cleaned	2521116	2521126		rsxC	10
KNK001ss_ds.merged.samereadgroup.cleaned	2529641	2529653		YPO_RS12255	12
KNK001ss_ds.merged.samereadgroup.cleaned	2532816	2532845		YPO_RS12265	29
KNK001ss_ds.merged.samereadgroup.cleaned	2536872	2536875		YPO_RS12280	3
KNK001ss_ds.merged.samereadgroup.cleaned	2554373	2554633		YPO_RS12355	260
KNK001ss_ds.merged.samereadgroup.cleaned	2554658	2555065		YPO_RS12360	407
KNK001ss_ds.merged.samereadgroup.cleaned	2555162	2555608		YPO_RS12365	446
KNK001ss_ds.merged.samereadgroup.cleaned	2555780	2556832		YPO_RS12370	1052
KNK001ss_ds.merged.samereadgroup.cleaned	2556844	2557161		YPO_RS12375	317
KNK001ss_ds.merged.samereadgroup.cleaned	2557164	2557415		YPO_RS12380	251
KNK001ss_ds.merged.samereadgroup.cleaned	2557451	2557684		YPO_RS12385	233
KNK001ss_ds.merged.samereadgroup.cleaned	2557749	2559461		YPO_RS12390	1712
KNK001ss_ds.merged.samereadgroup.cleaned	2559474	2559761		YPO_RS12395	287
KNK001ss_ds.merged.samereadgroup.cleaned	2559765	2560790		YPO_RS12400	1025
KNK001ss_ds.merged.samereadgroup.cleaned	2560790	2562034		YPO_RS12405	1244
KNK001ss_ds.merged.samereadgroup.cleaned	2562123	2562371		YPO_RS12410	248
KNK001ss_ds.merged.samereadgroup.cleaned	2562568	2562765		YPO_RS12415	197
KNK001ss_ds.merged.samereadgroup.cleaned	2568117	2568122		YPO_RS12445	5
KNK001ss_ds.merged.samereadgroup.cleaned	2569934	2569943		YPO_RS12450	9
KNK001ss_ds.merged.samereadgroup.cleaned	2578273	2578274		ivbL	1
KNK001ss_ds.merged.samereadgroup.cleaned	2582976	2582978		YPO_RS12495	2
KNK001ss_ds.merged.samereadgroup.cleaned	2595664	2595671		rstA	7
KNK001ss_ds.merged.samereadgroup.cleaned	2606335	2606394		asr	59
KNK001ss_ds.merged.samereadgroup.cleaned	2618585	2618588		YPO_RS12635	3
KNK001ss_ds.merged.samereadgroup.cleaned	2627897	2627900		ttcA	3
KNK001ss_ds.merged.samereadgroup.cleaned	2638993	2639001		tyrR	8
KNK001ss_ds.merged.samereadgroup.cleaned	2640270	2640273		YPO_RS12725	3
KNK001ss_ds.merged.samereadgroup.cleaned	2651236	2651246		sapD	10
KNK001ss_ds.merged.samereadgroup.cleaned	2660718	2660741		gstA	23
KNK001ss_ds.merged.samereadgroup.cleaned	2669832	2669843		eptA	11
KNK001ss_ds.merged.samereadgroup.cleaned	2677063	2677075		rnt	12
KNK001ss_ds.merged.samereadgroup.cleaned	2716587	2716607		arnF	20
KNK001ss_ds.merged.samereadgroup.cleaned	2725882	2725891		btuC	9
KNK001ss_ds.merged.samereadgroup.cleaned	2727430	2727442		YPO_RS13140	12
KNK001ss_ds.merged.samereadgroup.cleaned	2737741	2737746		YPO_RS13195	5
KNK001ss_ds.merged.samereadgroup.cleaned	2740537	2740539		yfeB	2
KNK001ss_ds.merged.samereadgroup.cleaned	2748799	2748809		YPO_RS13255	10
KNK001ss_ds.merged.samereadgroup.cleaned	2749116	2749126		YPO_RS13255	10
KNK001ss_ds.merged.samereadgroup.cleaned	2751869	2751886		YPO_RS13270	17
KNK001ss_ds.merged.samereadgroup.cleaned	2754138	2754168		YPO_RS13285	30
KNK001ss_ds.merged.samereadgroup.cleaned	2754838	2754844		YPO_RS13290	6
KNK001ss_ds.merged.samereadgroup.cleaned	2755008	2755048		YPO_RS13290	40
KNK001ss_ds.merged.samereadgroup.cleaned	2755154	2755160		YPO_RS13290	6
KNK001ss_ds.merged.samereadgroup.cleaned	2755473	2755487		YPO_RS13290	14
KNK001ss_ds.merged.samereadgroup.cleaned	2761980	2761989		csy2	9
KNK001ss_ds.merged.samereadgroup.cleaned	2772115	2772137		YPO_RS13355	22
KNK001ss_ds.merged.samereadgroup.cleaned	2774385	2774395		YPO_RS13360	10
KNK001ss_ds.merged.samereadgroup.cleaned	2777486	2777492		YPO_RS13375	6
KNK001ss_ds.merged.samereadgroup.cleaned	2783052	2783057		ugpC	5
KNK001ss_ds.merged.samereadgroup.cleaned	2785409	2785445		YPO_RS13415	36
KNK001ss_ds.merged.samereadgroup.cleaned	2790072	2790098		YPO_RS13445	26
KNK001ss_ds.merged.samereadgroup.cleaned	2792614	2792645		cdiA	31
KNK001ss_ds.merged.samereadgroup.cleaned	2800562	2800565		YPO_RS13460	3
KNK001ss_ds.merged.samereadgroup.cleaned	2801778	2801794		YPO_RS13465	16
KNK001ss_ds.merged.samereadgroup.cleaned	2802554	2802556		YPO_RS13470	2
KNK001ss_ds.merged.samereadgroup.cleaned	2807948	2807964		YPO_RS13485	16
KNK001ss_ds.merged.samereadgroup.cleaned	2813928	2813970		YPO_RS13510	42
KNK001ss_ds.merged.samereadgroup.cleaned	2814139	2814160		YPO_RS13510	21
KNK001ss_ds.merged.samereadgroup.cleaned	2814371	2814380		YPO_RS13510	9
KNK001ss_ds.merged.samereadgroup.cleaned	2821599	2821600		YPO_RS13550	1
KNK001ss_ds.merged.samereadgroup.cleaned	2822552	2822554		glnH	2
KNK001ss_ds.merged.samereadgroup.cleaned	2826175	2826177		YPO_RS13570	2
KNK001ss_ds.merged.samereadgroup.cleaned	2829707	2829724		rlmF	17
KNK001ss_ds.merged.samereadgroup.cleaned	2829862	2829876		rlmF	14
KNK001ss_ds.merged.samereadgroup.cleaned	2830468	2830483		YPO_RS13595	15
KNK001ss_ds.merged.samereadgroup.cleaned	2831204	2831226		ybiB	22
KNK001ss_ds.merged.samereadgroup.cleaned	2836047	2836063		menD	16
KNK001ss_ds.merged.samereadgroup.cleaned	2853914	2853973		YPO_RS13690	59
KNK001ss_ds.merged.samereadgroup.cleaned	2854150	2854178		YPO_RS13690	28
KNK001ss_ds.merged.samereadgroup.cleaned	2854665	2854694		YPO_RS13690	29
KNK001ss_ds.merged.samereadgroup.cleaned	2858530	2858533		nuoL	3
KNK001ss_ds.merged.samereadgroup.cleaned	2861974	2861991		nuoH	17
KNK001ss_ds.merged.samereadgroup.cleaned	2870189	2870194		YPO_RS13755	5
KNK001ss_ds.merged.samereadgroup.cleaned	2880467	2880472		ackA	5
KNK001ss_ds.merged.samereadgroup.cleaned	2885538	2885548		YPO_RS13815	10
KNK001ss_ds.merged.samereadgroup.cleaned	2885780	2885783		YPO_RS13815	3
KNK001ss_ds.merged.samereadgroup.cleaned	2889649	2889658		YPO_RS13830	9
KNK001ss_ds.merged.samereadgroup.cleaned	2896016	2896017		YPO_RS13840	1
KNK001ss_ds.merged.samereadgroup.cleaned	2897601	2897620		YPO_RS13845	19
KNK001ss_ds.merged.samereadgroup.cleaned	2905507	2905511		YPO_RS13875	4
KNK001ss_ds.merged.samereadgroup.cleaned	2907377	2907379		iolC	2
KNK001ss_ds.merged.samereadgroup.cleaned	2907681	2907687		iolC	6
KNK001ss_ds.merged.samereadgroup.cleaned	2910279	2910290		iolB	11
KNK001ss_ds.merged.samereadgroup.cleaned	2912810	2912822		YPO_RS13905	12
KNK001ss_ds.merged.samereadgroup.cleaned	2913533	2913547		YPO_RS13910	14
KNK001ss_ds.merged.samereadgroup.cleaned	2926660	2926666		mrdA	6
KNK001ss_ds.merged.samereadgroup.cleaned	2930686	2930691		lptE	5
KNK001ss_ds.merged.samereadgroup.cleaned	2953664	2953667		YPO_RS14120	3
KNK001ss_ds.merged.samereadgroup.cleaned	2954923	2954931		YPO_RS14120	8
KNK001ss_ds.merged.samereadgroup.cleaned	2970691	2970700		YPO_RS14190	9
KNK001ss_ds.merged.samereadgroup.cleaned	2972885	2972902		proW	17
KNK001ss_ds.merged.samereadgroup.cleaned	2979331	2979337		nrdI	6
KNK001ss_ds.merged.samereadgroup.cleaned	2980406	2980432		YPO_RS14235	26
KNK001ss_ds.merged.samereadgroup.cleaned	2980469	2980575		YPO_RS14235	106
KNK001ss_ds.merged.samereadgroup.cleaned	2983555	2983556		YPO_RS14250	1
KNK001ss_ds.merged.samereadgroup.cleaned	2999798	2999836		YPO_RS14330	38
KNK001ss_ds.merged.samereadgroup.cleaned	3002456	3002469		crcB	13
KNK001ss_ds.merged.samereadgroup.cleaned	3003133	3003138		YPO_RS14355	5
KNK001ss_ds.merged.samereadgroup.cleaned	3010745	3010763		pgm	18
KNK001ss_ds.merged.samereadgroup.cleaned	3012187	3012221		YPO_RS14405	34
KNK001ss_ds.merged.samereadgroup.cleaned	3013590	3013604		kdbD	14
KNK001ss_ds.merged.samereadgroup.cleaned	3021090	3021159		YPO_RS14440	69
KNK001ss_ds.merged.samereadgroup.cleaned	3024322	3024323		YPO_RS14460	1
KNK001ss_ds.merged.samereadgroup.cleaned	3037251	3037264		YPO_RS14530	13
KNK001ss_ds.merged.samereadgroup.cleaned	3059683	3059692		YPO_RS14620	9
KNK001ss_ds.merged.samereadgroup.cleaned	3075631	3075634		fadL	3
KNK001ss_ds.merged.samereadgroup.cleaned	3084865	3084874		mepA	9
KNK001ss_ds.merged.samereadgroup.cleaned	3085748	3085751		YPO_RS14760	3
KNK001ss_ds.merged.samereadgroup.cleaned	3096819	3096825		YPO_RS14805	6
KNK001ss_ds.merged.samereadgroup.cleaned	3115553	3115560		yfcD	7
KNK001ss_ds.merged.samereadgroup.cleaned	3117057	3117073		YPO_RS14905	16
KNK001ss_ds.merged.samereadgroup.cleaned	3121234	3121254		YPO_RS14925	20
KNK001ss_ds.merged.samereadgroup.cleaned	3122440	3122444		YPO_RS14930	4
KNK001ss_ds.merged.samereadgroup.cleaned	3122907	3122912		YPO_RS14935	5
KNK001ss_ds.merged.samereadgroup.cleaned	3123951	3123977		YPO_RS14945	26
KNK001ss_ds.merged.samereadgroup.cleaned	3124121	3124122		YPO_RS14950	1
KNK001ss_ds.merged.samereadgroup.cleaned	3127219	3127226		YPO_RS14960	7
KNK001ss_ds.merged.samereadgroup.cleaned	3140567	3140573		YPO_RS15015	6
KNK001ss_ds.merged.samereadgroup.cleaned	3143546	3143557		YPO_RS15035	11
KNK001ss_ds.merged.samereadgroup.cleaned	3144888	3144889		YPO_RS15040	1
KNK001ss_ds.merged.samereadgroup.cleaned	3145731	3145739		YPO_RS15040	8
KNK001ss_ds.merged.samereadgroup.cleaned	3154864	3154887		purM	23
KNK001ss_ds.merged.samereadgroup.cleaned	3183895	3183938		mdtC	43
KNK001ss_ds.merged.samereadgroup.cleaned	3184468	3184481		mdtC	13
KNK001ss_ds.merged.samereadgroup.cleaned	3194923	3194924		YPO_RS15250	1
KNK001ss_ds.merged.samereadgroup.cleaned	3197585	3197591		YPO_RS15265	6
KNK001ss_ds.merged.samereadgroup.cleaned	3197811	3197820		YPO_RS15265	9
KNK001ss_ds.merged.samereadgroup.cleaned	3197863	3197880		YPO_RS15265	17
KNK001ss_ds.merged.samereadgroup.cleaned	3198227	3198237		YPO_RS15270	10
KNK001ss_ds.merged.samereadgroup.cleaned	3198273	3198280		YPO_RS15275	7
KNK001ss_ds.merged.samereadgroup.cleaned	3200071	3200087		YPO_RS15280	16
KNK001ss_ds.merged.samereadgroup.cleaned	3200198	3200233		YPO_RS15285	35
KNK001ss_ds.merged.samereadgroup.cleaned	3200403	3200423		YPO_RS15285	20
KNK001ss_ds.merged.samereadgroup.cleaned	3200579	3200587		YPO_RS15285	8
KNK001ss_ds.merged.samereadgroup.cleaned	3200700	3200717		YPO_RS15290	17
KNK001ss_ds.merged.samereadgroup.cleaned	3200835	3200872		YPO_RS15290	37
KNK001ss_ds.merged.samereadgroup.cleaned	3201036	3201046		YPO_RS15290	10
KNK001ss_ds.merged.samereadgroup.cleaned	3201293	3201358		YPO_RS15295	65
KNK001ss_ds.merged.samereadgroup.cleaned	3201404	3201425		YPO_RS15295	21
KNK001ss_ds.merged.samereadgroup.cleaned	3201482	3201503		YPO_RS15295	21
KNK001ss_ds.merged.samereadgroup.cleaned	3201567	3201713		YPO_RS15300	146
KNK001ss_ds.merged.samereadgroup.cleaned	3201954	3201965		YPO_RS15300	11
KNK001ss_ds.merged.samereadgroup.cleaned	3202225	3202260		YPO_RS15305	35
KNK001ss_ds.merged.samereadgroup.cleaned	3205218	3205222		guaB	4
KNK001ss_ds.merged.samereadgroup.cleaned	3216186	3216190		rodZ	4
KNK001ss_ds.merged.samereadgroup.cleaned	3216817	3216820		rodZ	3
KNK001ss_ds.merged.samereadgroup.cleaned	3221729	3221754		YPO_RS15385	25
KNK001ss_ds.merged.samereadgroup.cleaned	3221815	3221862		YPO_RS15385	47
KNK001ss_ds.merged.samereadgroup.cleaned	3222343	3222361		YPO_RS15385	18
KNK001ss_ds.merged.samereadgroup.cleaned	3224993	3224999		yapA	6
KNK001ss_ds.merged.samereadgroup.cleaned	3228561	3228572		YPO_RS15395	11
KNK001ss_ds.merged.samereadgroup.cleaned	3234046	3234055		pepB	9
KNK001ss_ds.merged.samereadgroup.cleaned	3262830	3262856		YPO_RS15560	26
KNK001ss_ds.merged.samereadgroup.cleaned	3278234	3278247		tssK	13
KNK001ss_ds.merged.samereadgroup.cleaned	3280129	3280148		YPO_RS15645	19
KNK001ss_ds.merged.samereadgroup.cleaned	3287481	3287495		YPO_RS15680	14
KNK001ss_ds.merged.samereadgroup.cleaned	3288018	3288024		YPO_RS15680	6
KNK001ss_ds.merged.samereadgroup.cleaned	3295455	3295459		tssG	4
KNK001ss_ds.merged.samereadgroup.cleaned	3298451	3298453		YPO_RS15715	2
KNK001ss_ds.merged.samereadgroup.cleaned	3300391	3300399		YPO_RS15725	8
KNK001ss_ds.merged.samereadgroup.cleaned	3301706	3301715		YPO_RS15730	9
KNK001ss_ds.merged.samereadgroup.cleaned	3302634	3302641		YPO_RS15735	7
KNK001ss_ds.merged.samereadgroup.cleaned	3302802	3302812		YPO_RS15735	10
KNK001ss_ds.merged.samereadgroup.cleaned	3307343	3307345		YPO_RS15750	2
KNK001ss_ds.merged.samereadgroup.cleaned	3311632	3311633		YPO_RS15770	1
KNK001ss_ds.merged.samereadgroup.cleaned	3320233	3320272		YPO_RS15810	39
KNK001ss_ds.merged.samereadgroup.cleaned	3325070	3325073		glk	3
KNK001ss_ds.merged.samereadgroup.cleaned	3342452	3342460		cysK	8
KNK001ss_ds.merged.samereadgroup.cleaned	3353321	3353322		YPO_RS15995	1
KNK001ss_ds.merged.samereadgroup.cleaned	3355113	3355158		YPO_RS16000	45
KNK001ss_ds.merged.samereadgroup.cleaned	3356103	3356142		YPO_RS16010	39
KNK001ss_ds.merged.samereadgroup.cleaned	3357170	3357176		YPO_RS16015	6
KNK001ss_ds.merged.samereadgroup.cleaned	3358294	3358298		YPO_RS16020	4
KNK001ss_ds.merged.samereadgroup.cleaned	3363719	3363749		YPO_RS16040	30
KNK001ss_ds.merged.samereadgroup.cleaned	3363801	3363826		YPO_RS16040	25
KNK001ss_ds.merged.samereadgroup.cleaned	3363886	3363943		YPO_RS16040	57
KNK001ss_ds.merged.samereadgroup.cleaned	3364243	3364270		YPO_RS16040	27
KNK001ss_ds.merged.samereadgroup.cleaned	3364685	3364737		YPO_RS16040	52
KNK001ss_ds.merged.samereadgroup.cleaned	3372754	3372756		YPO_RS16075	2
KNK001ss_ds.merged.samereadgroup.cleaned	3380607	3380618		YPO_RS16115	11
KNK001ss_ds.merged.samereadgroup.cleaned	3381105	3381115		yapL	10
KNK001ss_ds.merged.samereadgroup.cleaned	3383653	3383666		YPO_RS16125	13
KNK001ss_ds.merged.samereadgroup.cleaned	3389311	3389322		nudK	11
KNK001ss_ds.merged.samereadgroup.cleaned	3389627	3389628		nudK	1
KNK001ss_ds.merged.samereadgroup.cleaned	3395780	3395794		YPO_RS16185	14
KNK001ss_ds.merged.samereadgroup.cleaned	3411965	3411968		YPO_RS16250	3
KNK001ss_ds.merged.samereadgroup.cleaned	3429243	3429247		cysS	4
KNK001ss_ds.merged.samereadgroup.cleaned	3434085	3434094		YPO_RS16360	9
KNK001ss_ds.merged.samereadgroup.cleaned	3454005	3454029		fepE	24
KNK001ss_ds.merged.samereadgroup.cleaned	3454801	3454857		fepE	56
KNK001ss_ds.merged.samereadgroup.cleaned	3454905	3454908		fepE	3
KNK001ss_ds.merged.samereadgroup.cleaned	3454948	3454961		fepE	13
KNK001ss_ds.merged.samereadgroup.cleaned	3455009	3455017		cpsG	8
KNK001ss_ds.merged.samereadgroup.cleaned	3455904	3455953		cpsG	49
KNK001ss_ds.merged.samereadgroup.cleaned	3456237	3456245		cpsG	8
KNK001ss_ds.merged.samereadgroup.cleaned	3456722	3456730		YPO_RS16450	8
KNK001ss_ds.merged.samereadgroup.cleaned	3461310	3461364		YPO_RS16470	54
KNK001ss_ds.merged.samereadgroup.cleaned	3461836	3461854		YPO_RS16470	18
KNK001ss_ds.merged.samereadgroup.cleaned	3463321	3463371		YPO_RS16480	50
KNK001ss_ds.merged.samereadgroup.cleaned	3463473	3463477		YPO_RS16480	4
KNK001ss_ds.merged.samereadgroup.cleaned	3463564	3463570		YPO_RS16480	6
KNK001ss_ds.merged.samereadgroup.cleaned	3463728	3463808		YPO_RS16480	80
KNK001ss_ds.merged.samereadgroup.cleaned	3463872	3463973		YPO_RS16480	101
KNK001ss_ds.merged.samereadgroup.cleaned	3464168	3464178		YPO_RS16480	10
KNK001ss_ds.merged.samereadgroup.cleaned	3464459	3464463		YPO_RS16480	4
KNK001ss_ds.merged.samereadgroup.cleaned	3464843	3464870		YPO_RS16485	27
KNK001ss_ds.merged.samereadgroup.cleaned	3465074	3465123		YPO_RS16485	49
KNK001ss_ds.merged.samereadgroup.cleaned	3465310	3465320		YPO_RS16485	10
KNK001ss_ds.merged.samereadgroup.cleaned	3465419	3465556		YPO_RS16485	137
KNK001ss_ds.merged.samereadgroup.cleaned	3465567	3465584		YPO_RS16490	17
KNK001ss_ds.merged.samereadgroup.cleaned	3465704	3465707		YPO_RS16490	3
KNK001ss_ds.merged.samereadgroup.cleaned	3466027	3466032		YPO_RS16490	5
KNK001ss_ds.merged.samereadgroup.cleaned	3466258	3466393		YPO_RS16490	135
KNK001ss_ds.merged.samereadgroup.cleaned	3466582	3466686		YPO_RS16490	104
KNK001ss_ds.merged.samereadgroup.cleaned	3466827	3466869		YPO_RS16490	42
KNK001ss_ds.merged.samereadgroup.cleaned	3466984	3467007		YPO_RS16495	23
KNK001ss_ds.merged.samereadgroup.cleaned	3467109	3467136		YPO_RS16495	27
KNK001ss_ds.merged.samereadgroup.cleaned	3467586	3467629		YPO_RS16495	43
KNK001ss_ds.merged.samereadgroup.cleaned	3468676	3468696		YPO_RS16500	20
KNK001ss_ds.merged.samereadgroup.cleaned	3469121	3469125		YPO_RS16500	4
KNK001ss_ds.merged.samereadgroup.cleaned	3469975	3469976		rfbH	1
KNK001ss_ds.merged.samereadgroup.cleaned	3472391	3472396		YPO_RS16520	5
KNK001ss_ds.merged.samereadgroup.cleaned	3473066	3473082		YPO_RS16520	16
KNK001ss_ds.merged.samereadgroup.cleaned	3479771	3479776		dnaX	5
KNK001ss_ds.merged.samereadgroup.cleaned	3487010	3487027		mscK	17
KNK001ss_ds.merged.samereadgroup.cleaned	3536324	3536358		yajL	34
KNK001ss_ds.merged.samereadgroup.cleaned	3547555	3547563		YPO_RS16860	8
KNK001ss_ds.merged.samereadgroup.cleaned	3548083	3548149		YPO_RS16865	66
KNK001ss_ds.merged.samereadgroup.cleaned	3548207	3548216		YPO_RS16865	9
KNK001ss_ds.merged.samereadgroup.cleaned	3572082	3572126		YPO_RS16965	44
KNK001ss_ds.merged.samereadgroup.cleaned	3583057	3583068		YPO_RS17010	11
KNK001ss_ds.merged.samereadgroup.cleaned	3584805	3584807		proA	2
KNK001ss_ds.merged.samereadgroup.cleaned	3590097	3590108		YPO_RS17045	11
KNK001ss_ds.merged.samereadgroup.cleaned	3592485	3592495		YPO_RS17055	10
KNK001ss_ds.merged.samereadgroup.cleaned	3593025	3593094		YPO_RS17055	69
KNK001ss_ds.merged.samereadgroup.cleaned	3596090	3596096		pepD	6
KNK001ss_ds.merged.samereadgroup.cleaned	3618890	3618914		YPO_RS17145	24
KNK001ss_ds.merged.samereadgroup.cleaned	3619156	3619200		YPO_RS17145	44
KNK001ss_ds.merged.samereadgroup.cleaned	3619233	3619243		YPO_RS17145	10
KNK001ss_ds.merged.samereadgroup.cleaned	3629215	3629219		YPO_RS17190	4
KNK001ss_ds.merged.samereadgroup.cleaned	3629917	3629933		YPO_RS17195	16
KNK001ss_ds.merged.samereadgroup.cleaned	3644346	3644358		YPO_RS17270	12
KNK001ss_ds.merged.samereadgroup.cleaned	3647314	3647315		pssA	1
KNK001ss_ds.merged.samereadgroup.cleaned	3649933	3649936		YPO_RS17290	3
KNK001ss_ds.merged.samereadgroup.cleaned	3672999	3673007		trmD	8
KNK001ss_ds.merged.samereadgroup.cleaned	3674544	3674552		ffh	8
KNK001ss_ds.merged.samereadgroup.cleaned	3689202	3689209		YPO_RS17505	7
KNK001ss_ds.merged.samereadgroup.cleaned	3720290	3720291		YPO_RS17630	1
KNK001ss_ds.merged.samereadgroup.cleaned	3725193	3725202		YPO_RS17650	9
KNK001ss_ds.merged.samereadgroup.cleaned	3728653	3728662		YPO_RS17660	9
KNK001ss_ds.merged.samereadgroup.cleaned	3735195	3735207		YPO_RS17695	12
KNK001ss_ds.merged.samereadgroup.cleaned	3737936	3737940		YPO_RS17710	4
KNK001ss_ds.merged.samereadgroup.cleaned	3739395	3739404		YPO_RS17715	9
KNK001ss_ds.merged.samereadgroup.cleaned	3754873	3754910		cobA	37
KNK001ss_ds.merged.samereadgroup.cleaned	3761361	3761364		cysJ	3
KNK001ss_ds.merged.samereadgroup.cleaned	3773772	3773788		barA	16
KNK001ss_ds.merged.samereadgroup.cleaned	3775796	3775798		degP	2
KNK001ss_ds.merged.samereadgroup.cleaned	3796302	3796303		gluQRS	1
KNK001ss_ds.merged.samereadgroup.cleaned	3799959	3799969		panB	10
KNK001ss_ds.merged.samereadgroup.cleaned	3801898	3801918		YPO_RS17990	20
KNK001ss_ds.merged.samereadgroup.cleaned	3812273	3812283		YPO_RS18035	10
KNK001ss_ds.merged.samereadgroup.cleaned	3820272	3820287		aceF	15
KNK001ss_ds.merged.samereadgroup.cleaned	3878251	3878258		YPO_RS18325	7
KNK001ss_ds.merged.samereadgroup.cleaned	3878809	3878867		YPO_RS18325	58
KNK001ss_ds.merged.samereadgroup.cleaned	3880403	3880412		YPO_RS18330	9
KNK001ss_ds.merged.samereadgroup.cleaned	3883667	3883669		YPO_RS18345	2
KNK001ss_ds.merged.samereadgroup.cleaned	3888244	3888267		YPO_RS18370	23
KNK001ss_ds.merged.samereadgroup.cleaned	3906344	3906383		infB	39
KNK001ss_ds.merged.samereadgroup.cleaned	3916885	3916889		dacB	4
KNK001ss_ds.merged.samereadgroup.cleaned	3938210	3938232		YPO_RS18600	22
KNK001ss_ds.merged.samereadgroup.cleaned	3948537	3948540		rpsR	3
KNK001ss_ds.merged.samereadgroup.cleaned	3949236	3949250		rpsF	14
KNK001ss_ds.merged.samereadgroup.cleaned	3960452	3960458		yraP	6
KNK001ss_ds.merged.samereadgroup.cleaned	3975583	3975603		YPO_RS18775	20
KNK001ss_ds.merged.samereadgroup.cleaned	4011529	4011530		tssA	1
KNK001ss_ds.merged.samereadgroup.cleaned	4011729	4011732		tssA	3
KNK001ss_ds.merged.samereadgroup.cleaned	4016437	4016443		YPO_RS18990	6
KNK001ss_ds.merged.samereadgroup.cleaned	4016619	4016620		YPO_RS18990	1
KNK001ss_ds.merged.samereadgroup.cleaned	4018195	4018197		YPO_RS19000	2
KNK001ss_ds.merged.samereadgroup.cleaned	4025041	4025045		YPO_RS19025	4
KNK001ss_ds.merged.samereadgroup.cleaned	4027894	4027906		YPO_RS19045	12
KNK001ss_ds.merged.samereadgroup.cleaned	4028548	4028549		YPO_RS19045	1
KNK001ss_ds.merged.samereadgroup.cleaned	4029395	4029428		YPO_RS19055	33
KNK001ss_ds.merged.samereadgroup.cleaned	4033671	4033708		YPO_RS19060	37
KNK001ss_ds.merged.samereadgroup.cleaned	4033956	4033970		YPO_RS19060	14
KNK001ss_ds.merged.samereadgroup.cleaned	4034676	4034685		YPO_RS19065	9
KNK001ss_ds.merged.samereadgroup.cleaned	4038906	4038933		YPO_RS19090	27
KNK001ss_ds.merged.samereadgroup.cleaned	4040864	4040872		ssuE	8
KNK001ss_ds.merged.samereadgroup.cleaned	4063205	4063223		YPO_RS19195	18
KNK001ss_ds.merged.samereadgroup.cleaned	4071520	4071521		YPO_RS19240	1
KNK001ss_ds.merged.samereadgroup.cleaned	4098633	4098648		YPO_RS19365	15
KNK001ss_ds.merged.samereadgroup.cleaned	4098945	4098948		YPO_RS19365	3
KNK001ss_ds.merged.samereadgroup.cleaned	4099415	4099420		YPO_RS19365	5
KNK001ss_ds.merged.samereadgroup.cleaned	4101644	4101749		YPO_RS19370	105
KNK001ss_ds.merged.samereadgroup.cleaned	4101895	4101913		YPO_RS19370	18
KNK001ss_ds.merged.samereadgroup.cleaned	4102442	4102453		YPO_RS19370	11
KNK001ss_ds.merged.samereadgroup.cleaned	4104584	4104609		YPO_RS19375	25
KNK001ss_ds.merged.samereadgroup.cleaned	4112718	4112786		YPO_RS19400	68
KNK001ss_ds.merged.samereadgroup.cleaned	4113043	4113059		YPO_RS19400	16
KNK001ss_ds.merged.samereadgroup.cleaned	4113996	4114058		YPO_RS19405	62
KNK001ss_ds.merged.samereadgroup.cleaned	4114562	4114577		YPO_RS19405	15
KNK001ss_ds.merged.samereadgroup.cleaned	4116778	4116790		YPO_RS19410	12
KNK001ss_ds.merged.samereadgroup.cleaned	4117189	4117203		YPO_RS19410	14
KNK001ss_ds.merged.samereadgroup.cleaned	4117798	4117799		aaeR	1
KNK001ss_ds.merged.samereadgroup.cleaned	4125072	4125074		YPO_RS19450	2
KNK001ss_ds.merged.samereadgroup.cleaned	4126956	4126962		pmbA	6
KNK001ss_ds.merged.samereadgroup.cleaned	4134304	4134309		YPO_RS19490	5
KNK001ss_ds.merged.samereadgroup.cleaned	4142795	4142840		YPO_RS19535	45
KNK001ss_ds.merged.samereadgroup.cleaned	4143937	4143941		malM	4
KNK001ss_ds.merged.samereadgroup.cleaned	4164248	4164250		metH	2
KNK001ss_ds.merged.samereadgroup.cleaned	4174132	4174143		metA	11
KNK001ss_ds.merged.samereadgroup.cleaned	4208913	4208930		nusG	17
KNK001ss_ds.merged.samereadgroup.cleaned	4209197	4209205		secE	8
KNK001ss_ds.merged.samereadgroup.cleaned	4213921	4213925		YPO_RS19830	4
KNK001ss_ds.merged.samereadgroup.cleaned	4223136	4223145		YPO_RS19870	9
KNK001ss_ds.merged.samereadgroup.cleaned	4236792	4236793		YPO_RS19940	1
KNK001ss_ds.merged.samereadgroup.cleaned	4238618	4238619		YPO_RS19950	1
KNK001ss_ds.merged.samereadgroup.cleaned	4242461	4242490		ubiB	29
KNK001ss_ds.merged.samereadgroup.cleaned	4243409	4243416		YPO_RS19980	7
KNK001ss_ds.merged.samereadgroup.cleaned	4257917	4257922		ugpQ	5
KNK001ss_ds.merged.samereadgroup.cleaned	4264085	4264111		YPO_RS20070	26
KNK001ss_ds.merged.samereadgroup.cleaned	4264338	4264393		YPO_RS20070	55
KNK001ss_ds.merged.samereadgroup.cleaned	4268313	4268321		YPO_RS20085	8
KNK001ss_ds.merged.samereadgroup.cleaned	4270006	4270012		YPO_RS20095	6
KNK001ss_ds.merged.samereadgroup.cleaned	4280841	4280897		ftsY	56
KNK001ss_ds.merged.samereadgroup.cleaned	4294556	4294563		glpQ	7
KNK001ss_ds.merged.samereadgroup.cleaned	4298038	4298044		pldB	6
KNK001ss_ds.merged.samereadgroup.cleaned	4310116	4310128		uvrD	12
KNK001ss_ds.merged.samereadgroup.cleaned	4314481	4314488		YPO_RS20305	7
KNK001ss_ds.merged.samereadgroup.cleaned	4332080	4332082		wzxE	2
KNK001ss_ds.merged.samereadgroup.cleaned	4339862	4339878		wzzE	16
KNK001ss_ds.merged.samereadgroup.cleaned	4341771	4341777		rho	6
KNK001ss_ds.merged.samereadgroup.cleaned	4351721	4351735		YPO_RS20485	14
KNK001ss_ds.merged.samereadgroup.cleaned	4353075	4353080		YPO_RS20490	5
KNK001ss_ds.merged.samereadgroup.cleaned	4353945	4353973		YPO_RS20500	28
KNK001ss_ds.merged.samereadgroup.cleaned	4359333	4359334		YPO_RS20515	1
KNK001ss_ds.merged.samereadgroup.cleaned	4359841	4359843		YPO_RS20520	2
KNK001ss_ds.merged.samereadgroup.cleaned	4360231	4360244		YPO_RS20525	13
KNK001ss_ds.merged.samereadgroup.cleaned	4360651	4360672		YPO_RS20530	21
KNK001ss_ds.merged.samereadgroup.cleaned	4365282	4365287		YPO_RS20550	5
KNK001ss_ds.merged.samereadgroup.cleaned	4366494	4366512		YPO_RS20560	18
KNK001ss_ds.merged.samereadgroup.cleaned	4367716	4367744		YPO_RS20570	28
KNK001ss_ds.merged.samereadgroup.cleaned	4368056	4368063		YPO_RS20575	7
KNK001ss_ds.merged.samereadgroup.cleaned	4368305	4368337		YPO_RS20575	32
KNK001ss_ds.merged.samereadgroup.cleaned	4369988	4370002		ilvA	14
KNK001ss_ds.merged.samereadgroup.cleaned	4378431	4378435		hdfR	4
KNK001ss_ds.merged.samereadgroup.cleaned	4400762	4400776		YPO_RS20725	14
KNK001ss_ds.merged.samereadgroup.cleaned	4401531	4401546		YPO_RS20725	15
KNK001ss_ds.merged.samereadgroup.cleaned	4405828	4405830		YPO_RS20745	2
KNK001ss_ds.merged.samereadgroup.cleaned	4406434	4406447		YPO_RS20745	13
KNK001ss_ds.merged.samereadgroup.cleaned	4408282	4408320		YPO_RS20745	38
KNK001ss_ds.merged.samereadgroup.cleaned	4418873	4418893		YPO_RS20775	20
KNK001ss_ds.merged.samereadgroup.cleaned	4419548	4419549		YPO_RS20780	1
KNK001ss_ds.merged.samereadgroup.cleaned	4420165	4420173		YPO_RS20785	8
KNK001ss_ds.merged.samereadgroup.cleaned	4420165	4420173		YPO_RS20790	8
KNK001ss_ds.merged.samereadgroup.cleaned	4421872	4421887		glpD	15
KNK001ss_ds.merged.samereadgroup.cleaned	4421977	4421986		glpD	9
KNK001ss_ds.merged.samereadgroup.cleaned	4442503	4442507		YPO_RS20830	4
KNK001ss_ds.merged.samereadgroup.cleaned	4442697	4442703		YPO_RS20830	6
KNK001ss_ds.merged.samereadgroup.cleaned	4462669	4462676		YPO_RS20940	7
KNK001ss_ds.merged.samereadgroup.cleaned	4472567	4472570		YPO_RS20975	3
KNK001ss_ds.merged.samereadgroup.cleaned	4478430	4478446		gorA	16
KNK001ss_ds.merged.samereadgroup.cleaned	4483608	4483653		YPO_RS21020	45
KNK001ss_ds.merged.samereadgroup.cleaned	4483684	4483734		YPO_RS21020	50
KNK001ss_ds.merged.samereadgroup.cleaned	4483798	4483822		YPO_RS21020	24
KNK001ss_ds.merged.samereadgroup.cleaned	4483886	4483905		YPO_RS21020	19
KNK001ss_ds.merged.samereadgroup.cleaned	4484198	4484202		YPO_RS21025	4
KNK001ss_ds.merged.samereadgroup.cleaned	4484431	4484435		YPO_RS21025	4
KNK001ss_ds.merged.samereadgroup.cleaned	4484958	4484988		YPO_RS21030	30
KNK001ss_ds.merged.samereadgroup.cleaned	4499625	4499627		YPO_RS21075	2
KNK001ss_ds.merged.samereadgroup.cleaned	4524505	4524526		eptB	21
KNK001ss_ds.merged.samereadgroup.cleaned	4533662	4533677		YPO_RS21205	15
KNK001ss_ds.merged.samereadgroup.cleaned	4533879	4533895		YPO_RS21205	16
KNK001ss_ds.merged.samereadgroup.cleaned	4534845	4534887		YPO_RS21210	42
KNK001ss_ds.merged.samereadgroup.cleaned	4535147	4535162		YPO_RS21215	15
KNK001ss_ds.merged.samereadgroup.cleaned	4539716	4539747		YPO_RS21235	31
KNK001ss_ds.merged.samereadgroup.cleaned	4545688	4545690		YPO_RS21280	2
KNK001ss_ds.merged.samereadgroup.cleaned	4545767	4545874		YPO_RS21280	107
KNK001ss_ds.merged.samereadgroup.cleaned	4546305	4546323		YPO_RS21280	18
KNK001ss_ds.merged.samereadgroup.cleaned	4553380	4553381		xylF	1
KNK001ss_ds.merged.samereadgroup.cleaned	4558133	4558140		YPO_RS21330	7
KNK001ss_ds.merged.samereadgroup.cleaned	4563897	4563900		YPO_RS21350	3
KNK001ss_ds.merged.samereadgroup.cleaned	4567677	4567687		YPO_RS21370	10
KNK001ss_ds.merged.samereadgroup.cleaned	4567747	4567779		YPO_RS21370	32
KNK001ss_ds.merged.samereadgroup.cleaned	4568485	4568486		YPO_RS21380	1
KNK001ss_ds.merged.samereadgroup.cleaned	4583568	4583605		YPO_RS21440	37
KNK001ss_ds.merged.samereadgroup.cleaned	4596366	4596371		YPO_RS21500	5
KNK001ss_ds.merged.samereadgroup.cleaned	4601693	4601743		YPO_RS21520	50
KNK001ss_ds.merged.samereadgroup.cleaned	4601890	4601896		YPO_RS21520	6
KNK001ss_ds.merged.samereadgroup.cleaned	4601940	4601954		YPO_RS21520	14
KNK001ss_ds.merged.samereadgroup.cleaned	4602015	4602061		YPO_RS21520	46
KNK001ss_ds.merged.samereadgroup.cleaned	4615291	4615300		gyrB	9
KNK001ss_ds.merged.samereadgroup.cleaned	4623265	4623266		mnmE	1
KNK001ss_ds.merged.samereadgroup.cleaned	4626295	4626300		YPO_RS21630	5
KNK001ss_ds.merged.samereadgroup.cleaned	4626526	4626528		YPO_RS21635	2
KNK001ss_ds.merged.samereadgroup.cleaned	4634565	4634581		phoU	16
KNK001ss_ds.merged.samereadgroup.cleaned	4638583	4638585		pstS	2
KZL002_libmerged	4066	4099		ravA	33
KZL002_libmerged	23893	23895		polA	2
KZL002_libmerged	63084	63095		rpmG	11
KZL002_libmerged	106581	106588		YPO_RS01520	7
KZL002_libmerged	147233	147235		YPO_RS01685	2
KZL002_libmerged	166152	166169		aroB	17
KZL002_libmerged	199587	199593		YPO_RS01915	6
KZL002_libmerged	236807	236814		mscL	7
KZL002_libmerged	251534	251541		acs	7
KZL002_libmerged	261172	261174		sctD	2
KZL002_libmerged	270959	270965		sctR	6
KZL002_libmerged	288885	288913		YPO_RS02455	28
KZL002_libmerged	315080	315098		yapK	18
KZL002_libmerged	345946	345972		YPO_RS02695	26
KZL002_libmerged	347163	347184		YPO_RS02695	21
KZL002_libmerged	347798	347801		YPO_RS02695	3
KZL002_libmerged	371077	371085		YPO_RS02805	8
KZL002_libmerged	371139	371146		YPO_RS02805	7
KZL002_libmerged	408312	408337		YPO_RS02955	25
KZL002_libmerged	409013	409030		YPO_RS02960	17
KZL002_libmerged	410567	410581		YPO_RS02965	14
KZL002_libmerged	410858	410891		YPO_RS02965	33
KZL002_libmerged	409569	409742		YPO_RS02965	173
KZL002_libmerged	431290	431360		YPO_RS03065	70
KZL002_libmerged	432736	432737		lsrK	1
KZL002_libmerged	446229	446231		YPO_RS03120	2
KZL002_libmerged	454637	454638		YPO_RS03170	1
KZL002_libmerged	495032	495038		YPO_RS03330	6
KZL002_libmerged	495711	495790		YPO_RS03330	79
KZL002_libmerged	507634	507638		lspA	4
KZL002_libmerged	521134	521151		YPO_RS03450	17
KZL002_libmerged	545284	545285		YPO_RS03545	1
KZL002_libmerged	579554	579556		YPO_RS03675	2
KZL002_libmerged	584139	584143		ilvI	4
KZL002_libmerged	592190	592199		YPO_RS03735	9
KZL002_libmerged	610628	610634		secA	6
KZL002_libmerged	630618	631613		YPO_RS03915	995
KZL002_libmerged	631816	632325		YPO_RS03920	509
KZL002_libmerged	632564	635548		yapG	2984
KZL002_libmerged	636017	637204		rlmG	1187
KZL002_libmerged	637320	639341		YPO_RS03935	2021
KZL002_libmerged	639554	640123		YPO_RS03940	569
KZL002_libmerged	640514	642013		YPO_RS03945	1499
KZL002_libmerged	642045	643778		YPO_RS03950	1733
KZL002_libmerged	643834	644817		YPO_RS03955	983
KZL002_libmerged	644919	645557		YPO_RS03960	638
KZL002_libmerged	645559	646200		YPO_RS03965	641
KZL002_libmerged	646233	646871		YPO_RS03970	638
KZL002_libmerged	647586	649274		YPO_RS03975	1688
KZL002_libmerged	649319	655157		cdiA	5838
KZL002_libmerged	655238	659206		cdiA	3968
KZL002_libmerged	659203	659436		cdiI	233
KZL002_libmerged	659498	659647		YPO_RS03990	149
KZL002_libmerged	659702	659929		YPO_RS03995	227
KZL002_libmerged	659865	660023		YPO_RS04000	158
KZL002_libmerged	660025	660441		YPO_RS04005	416
KZL002_libmerged	660474	661225		YPO_RS04010	751
KZL002_libmerged	661293	661457		YPO_RS04015	164
KZL002_libmerged	661725	664010		yapF	2285
KZL002_libmerged	664070	665065		YPO_RS04025	995
KZL002_libmerged	665167	666546		YPO_RS04030	1379
KZL002_libmerged	666872	667455		YPO_RS04035	583
KZL002_libmerged	667490	667987		YPO_RS04035	497
KZL002_libmerged	668070	671423		YPO_RS04040	3353
KZL002_libmerged	671532	672518		YPO_RS04045	986
KZL002_libmerged	672595	673839		YPO_RS04050	1244
KZL002_libmerged	673893	674774		YPO_RS04055	881
KZL002_libmerged	674774	675592		YPO_RS04060	818
KZL002_libmerged	675589	675921		YPO_RS04065	332
KZL002_libmerged	684617	684618		YPO_RS04100	1
KZL002_libmerged	687939	687973		YPO_RS04115	34
KZL002_libmerged	705000	705011		plsY	11
KZL002_libmerged	746915	746937		YPO_RS04390	22
KZL002_libmerged	747927	747934		YPO_RS04395	7
KZL002_libmerged	749283	749371		YPO_RS04405	88
KZL002_libmerged	750165	750251		YPO_RS04410	86
KZL002_libmerged	750442	750462		YPO_RS04410	20
KZL002_libmerged	750459	750526		YPO_RS04415	67
KZL002_libmerged	751109	751178		YPO_RS04415	69
KZL002_libmerged	751189	751190		YPO_RS04415	1
KZL002_libmerged	752629	752678		YPO_RS04425	49
KZL002_libmerged	753506	753574		YPO_RS04425	68
KZL002_libmerged	753751	753756		YPO_RS04425	5
KZL002_libmerged	753767	753779		YPO_RS04430	12
KZL002_libmerged	754830	754859		YPO_RS04440	29
KZL002_libmerged	755332	755372		YPO_RS04440	40
KZL002_libmerged	755369	755384		YPO_RS04445	15
KZL002_libmerged	755781	755798		YPO_RS04445	17
KZL002_libmerged	755907	755936		YPO_RS04445	29
KZL002_libmerged	758430	760910		YPO_RS04465	2480
KZL002_libmerged	760928	761647		YPO_RS04470	719
KZL002_libmerged	761672	762778		YPO_RS04475	1106
KZL002_libmerged	762990	764069		fepB	1079
KZL002_libmerged	764925	765920		YPO_RS04485	995
KZL002_libmerged	766012	766581		YPO_RS04490	569
KZL002_libmerged	768877	770010		flhB	1133
KZL002_libmerged	770010	770783		YPO_RS04505	773
KZL002_libmerged	770790	771062		fliQ	272
KZL002_libmerged	771064	771834		fliP	770
KZL002_libmerged	771831	772244		fliN	413
KZL002_libmerged	772237	773136		YPO_RS04525	899
KZL002_libmerged	773659	774687		YPO_RS04530	1028
KZL002_libmerged	774704	775084		fliE	380
KZL002_libmerged	775094	776734		fliF	1640
KZL002_libmerged	776706	777749		YPO_RS04545	1043
KZL002_libmerged	777754	778470		YPO_RS04550	716
KZL002_libmerged	778463	779803		fliI	1340
KZL002_libmerged	779807	780190		fliJ	383
KZL002_libmerged	780518	780943		YPO_RS04565	425
KZL002_libmerged	780950	781216		flgM	266
KZL002_libmerged	781445	782293		flgA	848
KZL002_libmerged	782351	782797		flgB	446
KZL002_libmerged	782800	783225		flgC	425
KZL002_libmerged	783228	783884		flgD	656
KZL002_libmerged	783939	785180		flaE	1241
KZL002_libmerged	785180	785318		YPO_RS04600	138
KZL002_libmerged	786029	786622		flgF	593
KZL002_libmerged	786690	787475		flgG	785
KZL002_libmerged	787510	788175		flgH	665
KZL002_libmerged	788222	789364		YPO_RS04625	1142
KZL002_libmerged	789374	789667		flgJ	293
KZL002_libmerged	789780	791141		flgK	1361
KZL002_libmerged	791170	792093		flgL	923
KZL002_libmerged	792105	793118		YPO_RS04645	1013
KZL002_libmerged	793282	793728		YPO_RS04650	446
KZL002_libmerged	793709	794755		YPO_RS04655	1046
KZL002_libmerged	795421	795522		YPO_RS04660	101
KZL002_libmerged	795562	795670		YPO_RS04660	108
KZL002_libmerged	795824	796300		YPO_RS04660	476
KZL002_libmerged	796354	796358		YPO_RS04660	4
KZL002_libmerged	796555	796556		YPO_RS04660	1
KZL002_libmerged	795381	795385		YPO_RS04660	4
KZL002_libmerged	802551	802649		YPO_RS04690	98
KZL002_libmerged	803187	803195		YPO_RS04690	8
KZL002_libmerged	807642	807702		YPO_RS04720	60
KZL002_libmerged	807690	807702		YPO_RS04725	12
KZL002_libmerged	809160	809226		YPO_RS04735	66
KZL002_libmerged	816722	816737		YPO_RS04765	15
KZL002_libmerged	822829	822830		vgrG	1
KZL002_libmerged	838838	838909		YPO_RS04815	71
KZL002_libmerged	842068	842081		YPO_RS04830	13
KZL002_libmerged	845425	845618		YPO_RS04835	193
KZL002_libmerged	872562	872586		YPO_RS04915	24
KZL002_libmerged	884626	884633		YPO_RS04965	7
KZL002_libmerged	885548	885549		YPO_RS04975	1
KZL002_libmerged	886598	886657		YPO_RS04980	59
KZL002_libmerged	886994	887036		gspL	42
KZL002_libmerged	887155	887180		gspL	25
KZL002_libmerged	888146	888232		YPO_RS04990	86
KZL002_libmerged	889344	889352		gspJ	8
KZL002_libmerged	889499	889518		gspJ	19
KZL002_libmerged	890008	890017		YPO_RS05005	9
KZL002_libmerged	890273	890278		YPO_RS05005	5
KZL002_libmerged	893732	893841		gspD	109
KZL002_libmerged	894819	894833		gspD	14
KZL002_libmerged	895248	895249		gspD	1
KZL002_libmerged	895447	895484		gspD	37
KZL002_libmerged	895571	895606		gspD	35
KZL002_libmerged	895693	895701		YPO_RS05030	8
KZL002_libmerged	896258	896290		YPO_RS05035	32
KZL002_libmerged	919750	919752		YPO_RS05130	2
KZL002_libmerged	923514	923522		YPO_RS05140	8
KZL002_libmerged	940566	940570		YPO_RS05205	4
KZL002_libmerged	950111	950129		YPO_RS05235	18
KZL002_libmerged	953694	953764		YPO_RS05260	70
KZL002_libmerged	954404	954417		YPO_RS05260	13
KZL002_libmerged	986403	986431		YPO_RS05440	28
KZL002_libmerged	1038775	1038777		YPO_RS05675	2
KZL002_libmerged	1039754	1039759		YPO_RS05675	5
KZL002_libmerged	1040571	1040576		YPO_RS05675	5
KZL002_libmerged	1043790	1043792		YPO_RS05675	2
KZL002_libmerged	1043936	1043970		YPO_RS05675	34
KZL002_libmerged	1044042	1044043		YPO_RS05675	1
KZL002_libmerged	1044443	1044471		YPO_RS05675	28
KZL002_libmerged	1045518	1045600		YPO_RS05675	82
KZL002_libmerged	1046494	1046554		YPO_RS05675	60
KZL002_libmerged	1046713	1046718		YPO_RS05675	5
KZL002_libmerged	1053168	1053182		mltC	14
KZL002_libmerged	1065829	1065952		YPO_RS05760	123
KZL002_libmerged	1067227	1067228		YPO_RS05765	1
KZL002_libmerged	1067313	1067389		YPO_RS05765	76
KZL002_libmerged	1067376	1067405		YPO_RS05770	29
KZL002_libmerged	1069976	1069981		YPO_RS05775	5
KZL002_libmerged	1070114	1070130		YPO_RS05775	16
KZL002_libmerged	1070206	1070213		YPO_RS05775	7
KZL002_libmerged	1071563	1071743		YPO_RS05785	180
KZL002_libmerged	1071907	1072254		YPO_RS05790	347
KZL002_libmerged	1072398	1074588		YPO_RS05795	2190
KZL002_libmerged	1074662	1074719		YPO_RS05800	57
KZL002_libmerged	1096820	1096824		YPO_RS05880	4
KZL002_libmerged	1116965	1117005		YPO_RS05940	40
KZL002_libmerged	1117062	1117080		YPO_RS05940	18
KZL002_libmerged	1117260	1117327		YPO_RS05940	67
KZL002_libmerged	1118023	1118031		YPO_RS05940	8
KZL002_libmerged	1118080	1118109		YPO_RS05940	29
KZL002_libmerged	1124073	1124104		yapH	31
KZL002_libmerged	1124180	1124190		yapH	10
KZL002_libmerged	1124225	1124231		yapH	6
KZL002_libmerged	1124281	1124284		yapH	3
KZL002_libmerged	1124382	1124492		yapH	110
KZL002_libmerged	1124532	1124541		yapH	9
KZL002_libmerged	1124606	1124612		yapH	6
KZL002_libmerged	1124687	1124884		yapH	197
KZL002_libmerged	1124924	1124934		yapH	10
KZL002_libmerged	1124992	1125007		yapH	15
KZL002_libmerged	1125121	1125127		yapH	6
KZL002_libmerged	1125163	1125258		yapH	95
KZL002_libmerged	1125303	1125400		yapH	97
KZL002_libmerged	1125441	1125472		yapH	31
KZL002_libmerged	1125543	1125620		yapH	77
KZL002_libmerged	1125661	1125675		yapH	14
KZL002_libmerged	1135767	1135769		YPO_RS05970	2
KZL002_libmerged	1140365	1140419		YPO_RS05985	54
KZL002_libmerged	1142436	1142437		YPO_RS05985	1
KZL002_libmerged	1154165	1154174		ptrA	9
KZL002_libmerged	1217392	1217407		YPO_RS06325	15
KZL002_libmerged	1220120	1220121		YPO_RS06340	1
KZL002_libmerged	1220653	1220662		YPO_RS06340	9
KZL002_libmerged	1221601	1221602		YPO_RS06340	1
KZL002_libmerged	1235044	1235063		YPO_RS06425	19
KZL002_libmerged	1235077	1235391		YPO_RS06430	314
KZL002_libmerged	1235740	1236828		YPO_RS06435	1088
KZL002_libmerged	1236825	1237784		YPO_RS06440	959
KZL002_libmerged	1237777	1238319		YPO_RS06445	542
KZL002_libmerged	1238319	1238519		YPO_RS06450	200
KZL002_libmerged	1238512	1239399		YPO_RS06455	887
KZL002_libmerged	1240207	1240434		YPO_RS06460	227
KZL002_libmerged	1240596	1242266		YPO_RS06465	1670
KZL002_libmerged	1242317	1243405		YPO_RS06470	1088
KZL002_libmerged	1243484	1244263		YPO_RS06475	779
KZL002_libmerged	1244318	1244350		YPO_RS06475	32
KZL002_libmerged	1244406	1244547		YPO_RS06475	141
KZL002_libmerged	1244583	1244589		YPO_RS06475	6
KZL002_libmerged	1244626	1244683		YPO_RS06475	57
KZL002_libmerged	1269614	1269637		tolA	23
KZL002_libmerged	1269751	1269753		tolA	2
KZL002_libmerged	1271112	1271117		tolB	5
KZL002_libmerged	1280017	1280025		YPO_RS06670	8
KZL002_libmerged	1322246	1322257		YPO_RS06875	11
KZL002_libmerged	1322395	1322399		YPO_RS06875	4
KZL002_libmerged	1331061	1331070		phnC	9
KZL002_libmerged	1331734	1331741		phnD	7
KZL002_libmerged	1377476	1377482		YPO_RS07100	6
KZL002_libmerged	1405461	1405468		YPO_RS07235	7
KZL002_libmerged	1411143	1411146		YPO_RS07270	3
KZL002_libmerged	1414395	1414398		YPO_RS07285	3
KZL002_libmerged	1436416	1436417		YPO_RS07380	1
KZL002_libmerged	1461543	1461573		YPO_RS07485	30
KZL002_libmerged	1463154	1463162		psaA	8
KZL002_libmerged	1463379	1463420		YPO_RS07500	41
KZL002_libmerged	1510210	1510211		YPO_RS07710	1
KZL002_libmerged	1552301	1552302		YPO_RS07880	1
KZL002_libmerged	1566893	1566912		YPO_RS07930	19
KZL002_libmerged	1567528	1567599		YPO_RS07930	71
KZL002_libmerged	1567747	1567765		YPO_RS07930	18
KZL002_libmerged	1613690	1613702		YPO_RS08090	12
KZL002_libmerged	1647598	1647646		YPO_RS08260	48
KZL002_libmerged	1649386	1649388		YPO_RS08265	2
KZL002_libmerged	1652063	1652091		YPO_RS08280	28
KZL002_libmerged	1654211	1654230		YPO_RS08300	19
KZL002_libmerged	1658263	1658265		tssC	2
KZL002_libmerged	1658412	1658414		tssC	2
KZL002_libmerged	1666068	1666070		YPO_RS08345	2
KZL002_libmerged	1666146	1666148		YPO_RS08345	2
KZL002_libmerged	1668235	1668238		YPO_RS08350	3
KZL002_libmerged	1670499	1670540		YPO_RS08355	41
KZL002_libmerged	1673832	1673845		YPO_RS08365	13
KZL002_libmerged	1680196	1680210		YPO_RS08385	14
KZL002_libmerged	1681291	1681304		YPO_RS08385	13
KZL002_libmerged	1684015	1684025		YPO_RS08395	10
KZL002_libmerged	1684040	1684180		YPO_RS08400	140
KZL002_libmerged	1684397	1684495		YPO_RS08400	98
KZL002_libmerged	1688634	1688655		YPO_RS08425	21
KZL002_libmerged	1690425	1690433		YPO_RS08430	8
KZL002_libmerged	1690626	1690678		YPO_RS08430	52
KZL002_libmerged	1693897	1693922		YPO_RS08440	25
KZL002_libmerged	1700336	1700413		darC	77
KZL002_libmerged	1701109	1701143		darC	34
KZL002_libmerged	1701145	1701149		darB	4
KZL002_libmerged	1701730	1701732		darB	2
KZL002_libmerged	1701787	1701790		darB	3
KZL002_libmerged	1703659	1703675		darA-c	16
KZL002_libmerged	1712741	1712744		mglA	3
KZL002_libmerged	1717428	1717438		YPO_RS08535	10
KZL002_libmerged	1723330	1723333		YPO_RS08560	3
KZL002_libmerged	1739303	1739314		YPO_RS08625	11
KZL002_libmerged	1754162	1754166		galU	4
KZL002_libmerged	1781584	1781593		YPO_RS08800	9
KZL002_libmerged	1791025	1791031		argG	6
KZL002_libmerged	1806986	1806999		YPO_RS08905	13
KZL002_libmerged	1808307	1808315		bssS	8
KZL002_libmerged	1878282	1878350		YPO_RS09250	68
KZL002_libmerged	1899490	1899510		YPO_RS09320	20
KZL002_libmerged	1903844	1903846		yapJ	2
KZL002_libmerged	1904865	1904872		yapJ	7
KZL002_libmerged	1915010	1915011		cheR	1
KZL002_libmerged	1933837	1933844		YPO_RS09455	7
KZL002_libmerged	1936650	1936663		YPO_RS09460	13
KZL002_libmerged	1942176	1942186		yebS	10
KZL002_libmerged	1967590	1967592		YPO_RS09585	2
KZL002_libmerged	1978588	1978597		YPO_RS09645	9
KZL002_libmerged	1979692	1979700		YPO_RS09650	8
KZL002_libmerged	1999863	1999872		mntP	9
KZL002_libmerged	2000353	2000376		YPO_RS09760	23
KZL002_libmerged	2005264	2005265		YPO_RS09780	1
KZL002_libmerged	2012189	2012211		hpaI	22
KZL002_libmerged	2015829	2015860		hpaC	31
KZL002_libmerged	2037395	2037423		flhA	28
KZL002_libmerged	2051589	2051590		flgJ	1
KZL002_libmerged	2060610	2060638		YPO_RS10045	28
KZL002_libmerged	2067978	2067979		fliO	1
KZL002_libmerged	2070365	2070380		YPO_RS10110	15
KZL002_libmerged	2117766	2117778		YPO_RS10355	12
KZL002_libmerged	2118003	2118027		hcp	24
KZL002_libmerged	2118107	2118120		hcp	13
KZL002_libmerged	2118332	2118344		hcp	12
KZL002_libmerged	2122647	2122653		YPO_RS10395	6
KZL002_libmerged	2126533	2126552		YPO_RS10415	19
KZL002_libmerged	2126749	2126804		YPO_RS10420	55
KZL002_libmerged	2150872	2150883		irp1	11
KZL002_libmerged	2152641	2152656		irp1	15
KZL002_libmerged	2166609	2166611		ybtQ	2
KZL002_libmerged	2182012	2182018		YPO_RS10615	6
KZL002_libmerged	2187674	2187694		YPO_RS10640	20
KZL002_libmerged	2187765	2187770		YPO_RS10640	5
KZL002_libmerged	2187795	2187810		YPO_RS10645	15
KZL002_libmerged	2234548	2234654		astE	106
KZL002_libmerged	2237356	2237374		YPO_RS10835	18
KZL002_libmerged	2256125	2256158		YPO_RS10925	33
KZL002_libmerged	2265707	2265710		YPO_RS10955	3
KZL002_libmerged	2266295	2266300		YPO_RS10965	5
KZL002_libmerged	2277267	2277296		YPO_RS11015	29
KZL002_libmerged	2299994	2300030		YPO_RS11135	36
KZL002_libmerged	2316453	2316469		YPO_RS11220	16
KZL002_libmerged	2318092	2318102		YPO_RS11220	10
KZL002_libmerged	2318132	2318154		YPO_RS11225	22
KZL002_libmerged	2319512	2319566		YPO_RS11225	54
KZL002_libmerged	2319790	2319798		YPO_RS11225	8
KZL002_libmerged	2321179	2321180		YPO_RS11225	1
KZL002_libmerged	2322818	2322822		YPO_RS11225	4
KZL002_libmerged	2376948	2376970		YPO_RS11520	22
KZL002_libmerged	2391611	2391755		YPO_RS11605	144
KZL002_libmerged	2391758	2391814		YPO_RS11610	56
KZL002_libmerged	2405315	2405326		YPO_RS11685	11
KZL002_libmerged	2437369	2437381		YPO_RS11820	12
KZL002_libmerged	2439892	2439940		YPO_RS11830	48
KZL002_libmerged	2440211	2440259		YPO_RS11830	48
KZL002_libmerged	2442363	2442374		purU	11
KZL002_libmerged	2463709	2463728		YPO_RS11930	19
KZL002_libmerged	2465287	2465297		cls	10
KZL002_libmerged	2475847	2475869		YPO_RS12005	22
KZL002_libmerged	2490354	2490359		YPO_RS12085	5
KZL002_libmerged	2495927	2495935		YPO_RS12105	8
KZL002_libmerged	2498671	2498672		acnA	1
KZL002_libmerged	2503061	2503068		YPO_RS12135	7
KZL002_libmerged	2507450	2507457		fsa	7
KZL002_libmerged	2519275	2519285		YPO_RS12215	10
KZL002_libmerged	2548983	2549140		YPO_RS12325	157
KZL002_libmerged	2549374	2549477		YPO_RS12330	103
KZL002_libmerged	2554373	2554633		YPO_RS12355	260
KZL002_libmerged	2554658	2555065		YPO_RS12360	407
KZL002_libmerged	2555162	2555608		YPO_RS12365	446
KZL002_libmerged	2555780	2556832		YPO_RS12370	1052
KZL002_libmerged	2556844	2557161		YPO_RS12375	317
KZL002_libmerged	2557164	2557415		YPO_RS12380	251
KZL002_libmerged	2557451	2557684		YPO_RS12385	233
KZL002_libmerged	2557749	2559461		YPO_RS12390	1712
KZL002_libmerged	2559474	2559761		YPO_RS12395	287
KZL002_libmerged	2559765	2560790		YPO_RS12400	1025
KZL002_libmerged	2560790	2562034		YPO_RS12405	1244
KZL002_libmerged	2562123	2562371		YPO_RS12410	248
KZL002_libmerged	2562568	2562765		YPO_RS12415	197
KZL002_libmerged	2563325	2563938		YPO_RS12420	613
KZL002_libmerged	2565808	2565858		YPO_RS12435	50
KZL002_libmerged	2567281	2567290		YPO_RS12440	9
KZL002_libmerged	2571276	2571279		YPO_RS12455	3
KZL002_libmerged	2606334	2606386		asr	52
KZL002_libmerged	2638979	2638994		tyrR	15
KZL002_libmerged	2640516	2640517		YPO_RS12725	1
KZL002_libmerged	2660604	2660611		gstA	7
KZL002_libmerged	2679550	2679552		YPO_RS12915	2
KZL002_libmerged	2716950	2716952		arnF	2
KZL002_libmerged	2748575	2748597		YPO_RS13255	22
KZL002_libmerged	2755474	2755477		YPO_RS13290	3
KZL002_libmerged	2772121	2772128		YPO_RS13355	7
KZL002_libmerged	2784870	2784871		YPO_RS13410	1
KZL002_libmerged	2788896	2788916		YPO_RS13435	20
KZL002_libmerged	2800582	2800593		YPO_RS13460	11
KZL002_libmerged	2810486	2810491		YPO_RS13495	5
KZL002_libmerged	2814157	2814218		YPO_RS13510	61
KZL002_libmerged	2814332	2814337		YPO_RS13510	5
KZL002_libmerged	2831190	2831224		ybiB	34
KZL002_libmerged	2853922	2853960		YPO_RS13690	38
KZL002_libmerged	2854165	2854175		YPO_RS13690	10
KZL002_libmerged	2880450	2880464		ackA	14
KZL002_libmerged	2885777	2885781		YPO_RS13815	4
KZL002_libmerged	2885831	2885833		YPO_RS13820	2
KZL002_libmerged	2887088	2887932		YPO_RS13825	844
KZL002_libmerged	2887989	2893967		YPO_RS13830	5978
KZL002_libmerged	2894374	2894922		YPO_RS13835	548
KZL002_libmerged	2895617	2896471		YPO_RS13840	854
KZL002_libmerged	2896777	2897244		YPO_RS13845	467
KZL002_libmerged	2897282	2898104		YPO_RS13845	822
KZL002_libmerged	2898140	2898303		YPO_RS13845	163
KZL002_libmerged	2898338	2900263		iolD	1925
KZL002_libmerged	2915436	2915437		YPO_RS13925	1
KZL002_libmerged	2926659	2926661		mrdA	2
KZL002_libmerged	2980488	2980550		YPO_RS14235	62
KZL002_libmerged	3012184	3012220		YPO_RS14405	36
KZL002_libmerged	3037242	3037264		YPO_RS14530	22
KZL002_libmerged	3058221	3058222		YPO_RS14610	1
KZL002_libmerged	3058267	3058312		YPO_RS14610	45
KZL002_libmerged	3058365	3058404		YPO_RS14610	39
KZL002_libmerged	3058484	3058489		YPO_RS14610	5
KZL002_libmerged	3062808	3062811		YPO_RS14645	3
KZL002_libmerged	3066636	3066639		ccmA	3
KZL002_libmerged	3114645	3114647		yfcE	2
KZL002_libmerged	3115558	3115560		yfcD	2
KZL002_libmerged	3118524	3118537		YPO_RS14910	13
KZL002_libmerged	3120316	3120561		YPO_RS14920	245
KZL002_libmerged	3121234	3121815		YPO_RS14925	581
KZL002_libmerged	3122083	3122484		YPO_RS14930	401
KZL002_libmerged	3122717	3123118		YPO_RS14935	401
KZL002_libmerged	3123130	3123702		YPO_RS14940	572
KZL002_libmerged	3123726	3123977		YPO_RS14945	251
KZL002_libmerged	3124016	3124255		YPO_RS14950	239
KZL002_libmerged	3125064	3126980		yapC	1916
KZL002_libmerged	3127163	3127226		YPO_RS14960	63
KZL002_libmerged	3127515	3128096		YPO_RS14965	581
KZL002_libmerged	3130158	3132365		YPO_RS14980	2207
KZL002_libmerged	3132358	3132888		YPO_RS14985	530
KZL002_libmerged	3133047	3135428		YPO_RS14990	2381
KZL002_libmerged	3135507	3137135		YPO_RS14995	1628
KZL002_libmerged	3137608	3138459		YPO_RS15000	851
KZL002_libmerged	3138485	3139474		YPO_RS15005	989
KZL002_libmerged	3139529	3140422		YPO_RS15010	893
KZL002_libmerged	3142684	3142989		YPO_RS15025	305
KZL002_libmerged	3143086	3143487		YPO_RS15030	401
KZL002_libmerged	3143469	3144177		YPO_RS15035	708
KZL002_libmerged	3145845	3145854		YPO_RS15040	9
KZL002_libmerged	3173732	3173742		YPO_RS15185	10
KZL002_libmerged	3181310	3181677		YPO_RS15210	367
KZL002_libmerged	3181709	3181883		YPO_RS15210	174
KZL002_libmerged	3181913	3182330		YPO_RS15210	417
KZL002_libmerged	3197830	3197871		YPO_RS15265	41
KZL002_libmerged	3198225	3198229		YPO_RS15270	4
KZL002_libmerged	3200351	3200355		YPO_RS15285	4
KZL002_libmerged	3200409	3200431		YPO_RS15285	22
KZL002_libmerged	3200487	3200505		YPO_RS15285	18
KZL002_libmerged	3200584	3200587		YPO_RS15285	3
KZL002_libmerged	3200830	3200865		YPO_RS15290	35
KZL002_libmerged	3201041	3201046		YPO_RS15290	5
KZL002_libmerged	3201567	3201652		YPO_RS15300	85
KZL002_libmerged	3201867	3201876		YPO_RS15300	9
KZL002_libmerged	3202269	3202277		YPO_RS15305	8
KZL002_libmerged	3202441	3202446		YPO_RS15305	5
KZL002_libmerged	3221810	3221850		YPO_RS15385	40
KZL002_libmerged	3222625	3222651		YPO_RS15385	26
KZL002_libmerged	3223351	3223370		yapA	19
KZL002_libmerged	3225492	3225532		yapA	40
KZL002_libmerged	3225571	3225635		yapA	64
KZL002_libmerged	3228585	3228586		YPO_RS15395	1
KZL002_libmerged	3231860	3231862		YPO_RS15405	2
KZL002_libmerged	3236858	3236888		hscA	30
KZL002_libmerged	3262725	3262739		YPO_RS15560	14
KZL002_libmerged	3262828	3262832		YPO_RS15560	4
KZL002_libmerged	3265849	3265854		purL	5
KZL002_libmerged	3285820	3285823		YPO_RS15675	3
KZL002_libmerged	3302456	3302457		YPO_RS15735	1
KZL002_libmerged	3302820	3302823		YPO_RS15735	3
KZL002_libmerged	3311469	3311473		YPO_RS15770	4
KZL002_libmerged	3315927	3315946		YPO_RS15785	19
KZL002_libmerged	3320244	3320272		YPO_RS15810	28
KZL002_libmerged	3335907	3335908		YPO_RS15910	1
KZL002_libmerged	3364680	3364736		YPO_RS16040	56
KZL002_libmerged	3373376	3373380		YPO_RS16080	4
KZL002_libmerged	3381105	3381115		yapL	10
KZL002_libmerged	3383743	3383747		YPO_RS16125	4
KZL002_libmerged	3383842	3383891		YPO_RS16125	49
KZL002_libmerged	3405495	3405536		YPO_RS16220	41
KZL002_libmerged	3405649	3405653		YPO_RS16220	4
KZL002_libmerged	3434087	3434090		YPO_RS16360	3
KZL002_libmerged	3437805	3438248		YPO_RS16375	443
KZL002_libmerged	3438325	3439194		YPO_RS16380	869
KZL002_libmerged	3439389	3439707		YPO_RS16385	318
KZL002_libmerged	3439743	3439841		YPO_RS16385	98
KZL002_libmerged	3439878	3439879		YPO_RS16385	1
KZL002_libmerged	3450521	3450534		YPO_RS16430	13
KZL002_libmerged	3454285	3454302		fepE	17
KZL002_libmerged	3455920	3455924		cpsG	4
KZL002_libmerged	3456249	3456250		cpsG	1
KZL002_libmerged	3456551	3456564		YPO_RS16450	13
KZL002_libmerged	3457096	3457126		YPO_RS16450	30
KZL002_libmerged	3463730	3463810		YPO_RS16480	80
KZL002_libmerged	3463906	3463949		YPO_RS16480	43
KZL002_libmerged	3464160	3464173		YPO_RS16480	13
KZL002_libmerged	3464843	3464875		YPO_RS16485	32
KZL002_libmerged	3465059	3465138		YPO_RS16485	79
KZL002_libmerged	3465490	3465556		YPO_RS16485	66
KZL002_libmerged	3465567	3465590		YPO_RS16490	23
KZL002_libmerged	3465963	3465964		YPO_RS16490	1
KZL002_libmerged	3466261	3466340		YPO_RS16490	79
KZL002_libmerged	3466579	3466583		YPO_RS16490	4
KZL002_libmerged	3466851	3466857		YPO_RS16490	6
KZL002_libmerged	3466984	3467012		YPO_RS16495	28
KZL002_libmerged	3467524	3467533		YPO_RS16495	9
KZL002_libmerged	3467608	3467617		YPO_RS16495	9
KZL002_libmerged	3473091	3473093		YPO_RS16520	2
KZL002_libmerged	3479761	3479762		dnaX	1
KZL002_libmerged	3496989	3497028		YPO_RS16620	39
KZL002_libmerged	3516278	3516283		hupB	5
KZL002_libmerged	3522671	3522672		tig	1
KZL002_libmerged	3547559	3547575		YPO_RS16860	16
KZL002_libmerged	3548056	3548068		YPO_RS16865	12
KZL002_libmerged	3548127	3548136		YPO_RS16865	9
KZL002_libmerged	3572061	3572128		YPO_RS16965	67
KZL002_libmerged	3592597	3592605		YPO_RS17055	8
KZL002_libmerged	3596086	3596090		pepD	4
KZL002_libmerged	3598163	3598190		YPO_RS17070	27
KZL002_libmerged	3602992	3603009		YPO_RS17095	17
KZL002_libmerged	3618865	3618895		YPO_RS17145	30
KZL002_libmerged	3619186	3619188		YPO_RS17145	2
KZL002_libmerged	3619497	3619499		YPO_RS17145	2
KZL002_libmerged	3649932	3649938		YPO_RS17290	6
KZL002_libmerged	3654006	3654009		YPO_RS17305	3
KZL002_libmerged	3654245	3654247		YPO_RS17310	2
KZL002_libmerged	3682464	3682471		YPO_RS17460	7
KZL002_libmerged	3684583	3684585		alaS	2
KZL002_libmerged	3698920	3698923		YPO_RS17540	3
KZL002_libmerged	3702732	3702737		katG	5
KZL002_libmerged	3704387	3704409		cybC	22
KZL002_libmerged	3754888	3754896		cobA	8
KZL002_libmerged	3759118	3759121		cysI	3
KZL002_libmerged	3759603	3759604		cysI	1
KZL002_libmerged	3760427	3760434		cysJ	7
KZL002_libmerged	3769299	3769306		relA	7
KZL002_libmerged	3873307	3873311		YPO_RS18300	4
KZL002_libmerged	3877986	3877994		YPO_RS18325	8
KZL002_libmerged	3889079	3889082		YPO_RS18370	3
KZL002_libmerged	3949718	3949750		yjfP	32
KZL002_libmerged	3962035	3962044		elbB	9
KZL002_libmerged	4000975	4001718		YPO_RS18935	743
KZL002_libmerged	4001682	4002770		tssG	1088
KZL002_libmerged	4002896	4004212		tagH	1316
KZL002_libmerged	4004212	4004757		tssJ	545
KZL002_libmerged	4004760	4005254		tssK	494
KZL002_libmerged	4011545	4011558		tssA	13
KZL002_libmerged	4016716	4016717		YPO_RS18990	1
KZL002_libmerged	4033910	4033958		YPO_RS19060	48
KZL002_libmerged	4034682	4034683		YPO_RS19065	1
KZL002_libmerged	4082231	4082237		msrQ	6
KZL002_libmerged	4098633	4098635		YPO_RS19365	2
KZL002_libmerged	4098922	4098979		YPO_RS19365	57
KZL002_libmerged	4099413	4099441		YPO_RS19365	28
KZL002_libmerged	4100963	4101035		YPO_RS19365	72
KZL002_libmerged	4101079	4101081		YPO_RS19365	2
KZL002_libmerged	4101305	4101324		YPO_RS19365	19
KZL002_libmerged	4101363	4101491		YPO_RS19365	128
KZL002_libmerged	4101516	4102509		YPO_RS19370	993
KZL002_libmerged	4102542	4102551		YPO_RS19370	9
KZL002_libmerged	4102695	4102890		YPO_RS19370	195
KZL002_libmerged	4102920	4102941		YPO_RS19370	21
KZL002_libmerged	4103043	4103052		YPO_RS19370	9
KZL002_libmerged	4103126	4103143		YPO_RS19370	17
KZL002_libmerged	4103211	4103264		YPO_RS19370	53
KZL002_libmerged	4103431	4103440		YPO_RS19370	9
KZL002_libmerged	4112693	4112776		YPO_RS19400	83
KZL002_libmerged	4113981	4114025		YPO_RS19405	44
KZL002_libmerged	4114228	4114230		YPO_RS19405	2
KZL002_libmerged	4116788	4116823		YPO_RS19410	35
KZL002_libmerged	4127405	4127434		YPO_RS19460	29
KZL002_libmerged	4138983	4139423		tssE	440
KZL002_libmerged	4139430	4140013		tssC	583
KZL002_libmerged	4140053	4140911		tssC	858
KZL002_libmerged	4140979	4141476		tssB	497
KZL002_libmerged	4142000	4142518		YPO_RS19530	518
KZL002_libmerged	4142670	4142948		YPO_RS19535	278
KZL002_libmerged	4156569	4156586		YPO_RS19590	17
KZL002_libmerged	4176216	4176220		YPO_RS19645	4
KZL002_libmerged	4213921	4213926		YPO_RS19830	5
KZL002_libmerged	4214018	4214210		YPO_RS19830	192
KZL002_libmerged	4220078	4220087		YPO_RS19855	9
KZL002_libmerged	4226976	4226991		YPO_RS19900	15
KZL002_libmerged	4235792	4235793		hemB	1
KZL002_libmerged	4258604	4258605		YPO_RS20045	1
KZL002_libmerged	4263364	4263383		YPO_RS20065	19
KZL002_libmerged	4359333	4359370		YPO_RS20515	37
KZL002_libmerged	4360681	4360692		YPO_RS20530	11
KZL002_libmerged	4388486	4388487		YPO_RS20670	1
KZL002_libmerged	4389733	4389738		YPO_RS20670	5
KZL002_libmerged	4405924	4405940		YPO_RS20745	16
KZL002_libmerged	4406433	4406449		YPO_RS20745	16
KZL002_libmerged	4408302	4408320		YPO_RS20745	18
KZL002_libmerged	4421979	4421993		glpD	14
KZL002_libmerged	4460258	4460274		YPO_RS20930	16
KZL002_libmerged	4480665	4480672		YPO_RS21000	7
KZL002_libmerged	4480665	4480672		YPO_RS21005	7
KZL002_libmerged	4481951	4481971		YPO_RS21010	20
KZL002_libmerged	4483692	4483704		YPO_RS21020	12
KZL002_libmerged	4483849	4483864		YPO_RS21020	15
KZL002_libmerged	4483911	4483914		YPO_RS21020	3
KZL002_libmerged	4484162	4484190		YPO_RS21025	28
KZL002_libmerged	4484212	4484213		YPO_RS21025	1
KZL002_libmerged	4484580	4484599		YPO_RS21025	19
KZL002_libmerged	4484601	4484629		YPO_RS21030	28
KZL002_libmerged	4484955	4485018		YPO_RS21030	63
KZL002_libmerged	4514642	4514647		YPO_RS21135	5
KZL002_libmerged	4516088	4516098		YPO_RS21140	10
KZL002_libmerged	4517366	4517373		YPO_RS21140	7
KZL002_libmerged	4527106	4527112		YPO_RS21185	6
KZL002_libmerged	4528814	4528819		YPO_RS21190	5
KZL002_libmerged	4545315	4545328		YPO_RS21280	13
KZL002_libmerged	4545881	4545885		YPO_RS21280	4
KZL002_libmerged	4558127	4558136		YPO_RS21330	9
KZL002_libmerged	4561514	4561528		YPO_RS21340	14
KZL002_libmerged	4561598	4561602		YPO_RS21340	4
KZL002_libmerged	4561866	4561867		YPO_RS21340	1
KZL002_libmerged	4567695	4567702		YPO_RS21370	7
KZL002_libmerged	4567758	4567777		YPO_RS21370	19
KZL002_libmerged	4570826	4570828		selB	2
KZL002_libmerged	4601641	4601737		YPO_RS21520	96
KZL002_libmerged	4601878	4601905		YPO_RS21520	27
KZL002_libmerged	4602028	4602067		YPO_RS21520	39
KZL002_libmerged	4621896	4621902		yidC	6
KZL002_libmerged	4627809	4627822		YPO_RS21640	13
KZL002_libmerged	4634563	4634569		phoU	6
MIB054_libmerged	14916	14918		YPO_RS01080	2
MIB054_libmerged	106578	106585		YPO_RS01520	7
MIB054_libmerged	236804	236808		mscL	4
MIB054_libmerged	275526	275527		YPO_RS02395	1
MIB054_libmerged	371069	371076		YPO_RS02805	7
MIB054_libmerged	401046	401048		YPO_RS02925	2
MIB054_libmerged	408176	408180		YPO_RS02955	4
MIB054_libmerged	408323	408338		YPO_RS02955	15
MIB054_libmerged	409216	409223		YPO_RS02960	7
MIB054_libmerged	409603	409610		YPO_RS02965	7
MIB054_libmerged	410380	410387		YPO_RS02965	7
MIB054_libmerged	410849	410891		YPO_RS02965	42
MIB054_libmerged	495121	495130		YPO_RS03330	9
MIB054_libmerged	495721	495774		YPO_RS03330	53
MIB054_libmerged	545294	545296		YPO_RS03545	2
MIB054_libmerged	595338	595345		murF	7
MIB054_libmerged	659375	659378		cdiI	3
MIB054_libmerged	660154	660159		YPO_RS04005	5
MIB054_libmerged	667977	667986		YPO_RS04035	9
MIB054_libmerged	704995	705014		plsY	19
MIB054_libmerged	749616	749627		YPO_RS04405	11
MIB054_libmerged	750498	750516		YPO_RS04415	18
MIB054_libmerged	751087	751089		YPO_RS04415	2
MIB054_libmerged	753730	753754		YPO_RS04425	24
MIB054_libmerged	785301	785318		YPO_RS04600	17
MIB054_libmerged	796060	796075		YPO_RS04660	15
MIB054_libmerged	802563	802645		YPO_RS04690	82
MIB054_libmerged	807668	807689		YPO_RS04720	21
MIB054_libmerged	809002	809012		YPO_RS04735	10
MIB054_libmerged	809200	809224		YPO_RS04735	24
MIB054_libmerged	845423	845611		YPO_RS04835	188
MIB054_libmerged	884439	884473		YPO_RS04965	34
MIB054_libmerged	886600	886666		YPO_RS04980	66
MIB054_libmerged	888157	888164		YPO_RS04990	7
MIB054_libmerged	893734	893817		gspD	83
MIB054_libmerged	895448	895475		gspD	27
MIB054_libmerged	895694	895701		YPO_RS05030	7
MIB054_libmerged	953681	953763		YPO_RS05260	82
MIB054_libmerged	1043962	1043968		YPO_RS05675	6
MIB054_libmerged	1044631	1044645		YPO_RS05675	14
MIB054_libmerged	1045533	1045561		YPO_RS05675	28
MIB054_libmerged	1046484	1046498		YPO_RS05675	14
MIB054_libmerged	1067330	1067373		YPO_RS05765	43
MIB054_libmerged	1068153	1068167		YPO_RS05770	14
MIB054_libmerged	1084047	1084051		tssK	4
MIB054_libmerged	1117273	1117286		YPO_RS05940	13
MIB054_libmerged	1124075	1124106		yapH	31
MIB054_libmerged	1124183	1124186		yapH	3
MIB054_libmerged	1124223	1124226		yapH	3
MIB054_libmerged	1124279	1124282		yapH	3
MIB054_libmerged	1124386	1124402		yapH	16
MIB054_libmerged	1124468	1124493		yapH	25
MIB054_libmerged	1124534	1124541		yapH	7
MIB054_libmerged	1124609	1124610		yapH	1
MIB054_libmerged	1124693	1124877		yapH	184
MIB054_libmerged	1124925	1124934		yapH	9
MIB054_libmerged	1124994	1125006		yapH	12
MIB054_libmerged	1125121	1125123		yapH	2
MIB054_libmerged	1125182	1125256		yapH	74
MIB054_libmerged	1125306	1125394		yapH	88
MIB054_libmerged	1125445	1125475		yapH	30
MIB054_libmerged	1125544	1125597		yapH	53
MIB054_libmerged	1125671	1125676		yapH	5
MIB054_libmerged	1221218	1221224		YPO_RS06340	6
MIB054_libmerged	1241058	1241098		YPO_RS06465	40
MIB054_libmerged	1269609	1269646		tolA	37
MIB054_libmerged	1280017	1280020		YPO_RS06670	3
MIB054_libmerged	1322397	1322403		YPO_RS06875	6
MIB054_libmerged	1392301	1392317		ycoA	16
MIB054_libmerged	1463394	1463404		YPO_RS07500	10
MIB054_libmerged	1505630	1505634		YPO_RS07680	4
MIB054_libmerged	1514465	1514472		artQ	7
MIB054_libmerged	1566372	1566381		YPO_RS07930	9
MIB054_libmerged	1580945	1580965		YPO_RS07975	20
MIB054_libmerged	1647598	1647650		YPO_RS08260	52
MIB054_libmerged	1652102	1652103		YPO_RS08285	1
MIB054_libmerged	1666069	1666072		YPO_RS08345	3
MIB054_libmerged	1666147	1666149		YPO_RS08345	2
MIB054_libmerged	1684044	1684147		YPO_RS08400	103
MIB054_libmerged	1699107	1699117		darE	10
MIB054_libmerged	1700354	1700377		darC	23
MIB054_libmerged	1701118	1701142		darC	24
MIB054_libmerged	1701348	1701372		darB	24
MIB054_libmerged	1725941	1725942		YPO_RS08570	1
MIB054_libmerged	1726297	1726310		YPO_RS08570	13
MIB054_libmerged	1739303	1739327		YPO_RS08625	24
MIB054_libmerged	1796133	1796137		YPO_RS08855	4
MIB054_libmerged	1837758	1837761		nagZ	3
MIB054_libmerged	1904870	1904871		yapJ	1
MIB054_libmerged	1949333	1949341		YPO_RS09515	8
MIB054_libmerged	1999862	1999871		mntP	9
MIB054_libmerged	2037395	2037426		flhA	31
MIB054_libmerged	2070467	2070473		YPO_RS10110	6
MIB054_libmerged	2081671	2081681		YPO_RS10170	10
MIB054_libmerged	2090846	2090851		YPO_RS10210	5
MIB054_libmerged	2117759	2117771		YPO_RS10355	12
MIB054_libmerged	2126535	2126543		YPO_RS10415	8
MIB054_libmerged	2145628	2145643		ybtU	15
MIB054_libmerged	2152642	2152652		irp1	10
MIB054_libmerged	2178513	2178520		YPO_RS10605	7
MIB054_libmerged	2187795	2187811		YPO_RS10645	16
MIB054_libmerged	2218038	2218039		YPO_RS10760	1
MIB054_libmerged	2237356	2237376		YPO_RS10835	20
MIB054_libmerged	2258636	2258639		YPO_RS10935	3
MIB054_libmerged	2299997	2300030		YPO_RS11135	33
MIB054_libmerged	2306899	2306903		YPO_RS11175	4
MIB054_libmerged	2316466	2316489		YPO_RS11220	23
MIB054_libmerged	2319537	2319550		YPO_RS11225	13
MIB054_libmerged	2319792	2319798		YPO_RS11225	6
MIB054_libmerged	2375659	2375662		YPO_RS11510	3
MIB054_libmerged	2376941	2376969		YPO_RS11520	28
MIB054_libmerged	2405313	2405315		YPO_RS11685	2
MIB054_libmerged	2442369	2442373		purU	4
MIB054_libmerged	2445270	2445275		rssB	5
MIB054_libmerged	2475855	2475861		YPO_RS12005	6
MIB054_libmerged	2491168	2491190		topA	22
MIB054_libmerged	2503051	2503058		YPO_RS12135	7
MIB054_libmerged	2554373	2554633		YPO_RS12355	260
MIB054_libmerged	2554658	2555065		YPO_RS12360	407
MIB054_libmerged	2555162	2555608		YPO_RS12365	446
MIB054_libmerged	2555780	2556832		YPO_RS12370	1052
MIB054_libmerged	2556844	2557161		YPO_RS12375	317
MIB054_libmerged	2557164	2557415		YPO_RS12380	251
MIB054_libmerged	2557451	2557684		YPO_RS12385	233
MIB054_libmerged	2557749	2559461		YPO_RS12390	1712
MIB054_libmerged	2559474	2559761		YPO_RS12395	287
MIB054_libmerged	2559765	2560790		YPO_RS12400	1025
MIB054_libmerged	2560790	2562034		YPO_RS12405	1244
MIB054_libmerged	2562123	2562371		YPO_RS12410	248
MIB054_libmerged	2562568	2562765		YPO_RS12415	197
MIB054_libmerged	2606363	2606394		asr	31
MIB054_libmerged	2716949	2716950		arnF	1
MIB054_libmerged	2754131	2754139		YPO_RS13285	8
MIB054_libmerged	2789808	2789812		YPO_RS13445	4
MIB054_libmerged	2813953	2813954		YPO_RS13510	1
MIB054_libmerged	2814179	2814207		YPO_RS13510	28
MIB054_libmerged	2885776	2885782		YPO_RS13815	6
MIB054_libmerged	2887091	2887932		YPO_RS13825	841
MIB054_libmerged	2887989	2893967		YPO_RS13830	5978
MIB054_libmerged	2894374	2894922		YPO_RS13835	548
MIB054_libmerged	2895617	2896471		YPO_RS13840	854
MIB054_libmerged	2896777	2897119		YPO_RS13845	342
MIB054_libmerged	2897149	2897241		YPO_RS13845	92
MIB054_libmerged	2897285	2898095		YPO_RS13845	810
MIB054_libmerged	2898143	2898303		YPO_RS13845	160
MIB054_libmerged	2898338	2898758		iolD	420
MIB054_libmerged	2898838	2900263		iolD	1425
MIB054_libmerged	2910282	2910290		iolB	8
MIB054_libmerged	2926659	2926660		mrdA	1
MIB054_libmerged	2980434	2980556		YPO_RS14235	122
MIB054_libmerged	3012186	3012220		YPO_RS14405	34
MIB054_libmerged	3021138	3021147		YPO_RS14440	9
MIB054_libmerged	3037259	3037264		YPO_RS14530	5
MIB054_libmerged	3120316	3120561		YPO_RS14920	245
MIB054_libmerged	3121234	3121815		YPO_RS14925	581
MIB054_libmerged	3122083	3122484		YPO_RS14930	401
MIB054_libmerged	3122717	3123118		YPO_RS14935	401
MIB054_libmerged	3123130	3123702		YPO_RS14940	572
MIB054_libmerged	3123726	3123977		YPO_RS14945	251
MIB054_libmerged	3124016	3124255		YPO_RS14950	239
MIB054_libmerged	3125064	3126980		yapC	1916
MIB054_libmerged	3127171	3127226		YPO_RS14960	55
MIB054_libmerged	3127515	3128096		YPO_RS14965	581
MIB054_libmerged	3130158	3130997		YPO_RS14980	839
MIB054_libmerged	3131028	3132365		YPO_RS14980	1337
MIB054_libmerged	3132358	3132888		YPO_RS14985	530
MIB054_libmerged	3133047	3135428		YPO_RS14990	2381
MIB054_libmerged	3135507	3137135		YPO_RS14995	1628
MIB054_libmerged	3137608	3138459		YPO_RS15000	851
MIB054_libmerged	3138485	3139474		YPO_RS15005	989
MIB054_libmerged	3139529	3139637		YPO_RS15010	108
MIB054_libmerged	3139677	3140421		YPO_RS15010	744
MIB054_libmerged	3142684	3142989		YPO_RS15025	305
MIB054_libmerged	3143086	3143487		YPO_RS15030	401
MIB054_libmerged	3143469	3143630		YPO_RS15035	161
MIB054_libmerged	3143712	3144177		YPO_RS15035	465
MIB054_libmerged	3145846	3145851		YPO_RS15040	5
MIB054_libmerged	3200400	3200433		YPO_RS15285	33
MIB054_libmerged	3200828	3200856		YPO_RS15290	28
MIB054_libmerged	3201567	3201680		YPO_RS15300	113
MIB054_libmerged	3221800	3221846		YPO_RS15385	46
MIB054_libmerged	3223344	3223349		yapA	5
MIB054_libmerged	3225494	3225523		yapA	29
MIB054_libmerged	3225582	3225622		yapA	40
MIB054_libmerged	3265850	3265856		purL	6
MIB054_libmerged	3320263	3320272		YPO_RS15810	9
MIB054_libmerged	3355114	3355121		YPO_RS16000	7
MIB054_libmerged	3364695	3364726		YPO_RS16040	31
MIB054_libmerged	3405494	3405534		YPO_RS16220	40
MIB054_libmerged	3405636	3405652		YPO_RS16220	16
MIB054_libmerged	3450527	3450535		YPO_RS16430	8
MIB054_libmerged	3455920	3455936		cpsG	16
MIB054_libmerged	3456548	3456564		YPO_RS16450	16
MIB054_libmerged	3463730	3463796		YPO_RS16480	66
MIB054_libmerged	3463915	3463950		YPO_RS16480	35
MIB054_libmerged	3464167	3464189		YPO_RS16480	22
MIB054_libmerged	3464843	3464873		YPO_RS16485	30
MIB054_libmerged	3465065	3465093		YPO_RS16485	28
MIB054_libmerged	3465529	3465556		YPO_RS16485	27
MIB054_libmerged	3465567	3465572		YPO_RS16490	5
MIB054_libmerged	3466274	3466382		YPO_RS16490	108
MIB054_libmerged	3466832	3466843		YPO_RS16490	11
MIB054_libmerged	3466984	3466986		YPO_RS16495	2
MIB054_libmerged	3548105	3548113		YPO_RS16865	8
MIB054_libmerged	3572108	3572127		YPO_RS16965	19
MIB054_libmerged	3600010	3600011		YPO_RS17080	1
MIB054_libmerged	3654245	3654250		YPO_RS17310	5
MIB054_libmerged	3773761	3773777		barA	16
MIB054_libmerged	3877991	3877994		YPO_RS18325	3
MIB054_libmerged	4020393	4020398		YPO_RS19010	5
MIB054_libmerged	4033804	4033819		YPO_RS19060	15
MIB054_libmerged	4033963	4033976		YPO_RS19060	13
MIB054_libmerged	4098633	4098645		YPO_RS19365	12
MIB054_libmerged	4100970	4100994		YPO_RS19365	24
MIB054_libmerged	4101024	4101082		YPO_RS19365	58
MIB054_libmerged	4101303	4101315		YPO_RS19365	12
MIB054_libmerged	4101363	4101491		YPO_RS19365	128
MIB054_libmerged	4101516	4102391		YPO_RS19370	875
MIB054_libmerged	4102424	4102547		YPO_RS19370	123
MIB054_libmerged	4102698	4102821		YPO_RS19370	123
MIB054_libmerged	4102860	4102885		YPO_RS19370	25
MIB054_libmerged	4102934	4102935		YPO_RS19370	1
MIB054_libmerged	4103042	4103052		YPO_RS19370	10
MIB054_libmerged	4103125	4103142		YPO_RS19370	17
MIB054_libmerged	4103211	4103216		YPO_RS19370	5
MIB054_libmerged	4103261	4103263		YPO_RS19370	2
MIB054_libmerged	4103435	4103439		YPO_RS19370	4
MIB054_libmerged	4104059	4104061		YPO_RS19370	2
MIB054_libmerged	4112727	4112789		YPO_RS19400	62
MIB054_libmerged	4114009	4114025		YPO_RS19405	16
MIB054_libmerged	4223144	4223147		YPO_RS19870	3
MIB054_libmerged	4235789	4235793		hemB	4
MIB054_libmerged	4408313	4408317		YPO_RS20745	4
MIB054_libmerged	4484193	4484211		YPO_RS21025	18
MIB054_libmerged	4528818	4528820		YPO_RS21190	2
MIB054_libmerged	4558120	4558137		YPO_RS21330	17
MIB054_libmerged	4601713	4601726		YPO_RS21520	13
MIB054_libmerged	4602036	4602044		YPO_RS21520	8
OOH003ss_ds.merged.samereadgroup.cleaned	4010	4011		ravA	1
OOH003ss_ds.merged.samereadgroup.cleaned	4029	4076		ravA	47
OOH003ss_ds.merged.samereadgroup.cleaned	7230	7232		kup	2
OOH003ss_ds.merged.samereadgroup.cleaned	10227	10238		YPO_RS01055	11
OOH003ss_ds.merged.samereadgroup.cleaned	23876	23899		polA	23
OOH003ss_ds.merged.samereadgroup.cleaned	29311	29317		hemN	6
OOH003ss_ds.merged.samereadgroup.cleaned	50410	50420		spoT	10
OOH003ss_ds.merged.samereadgroup.cleaned	73912	73934		envC	22
OOH003ss_ds.merged.samereadgroup.cleaned	106577	106582		YPO_RS01520	5
OOH003ss_ds.merged.samereadgroup.cleaned	150602	150607		envZ	5
OOH003ss_ds.merged.samereadgroup.cleaned	150929	150932		pckA	3
OOH003ss_ds.merged.samereadgroup.cleaned	177053	177057		YPO_RS01815	4
OOH003ss_ds.merged.samereadgroup.cleaned	183882	183897		YPO_RS01835	15
OOH003ss_ds.merged.samereadgroup.cleaned	193915	193918		YPO_RS01880	3
OOH003ss_ds.merged.samereadgroup.cleaned	196663	196667		YPO_RS01895	4
OOH003ss_ds.merged.samereadgroup.cleaned	226244	226248		rpmC	4
OOH003ss_ds.merged.samereadgroup.cleaned	236814	236816		mscL	2
OOH003ss_ds.merged.samereadgroup.cleaned	240356	240357		fmt	1
OOH003ss_ds.merged.samereadgroup.cleaned	280113	280124		YPO_RS02415	11
OOH003ss_ds.merged.samereadgroup.cleaned	288866	288920		YPO_RS02455	54
OOH003ss_ds.merged.samereadgroup.cleaned	360483	360490		fxsA	7
OOH003ss_ds.merged.samereadgroup.cleaned	381886	381898		nnr	12
OOH003ss_ds.merged.samereadgroup.cleaned	408329	408331		YPO_RS02955	2
OOH003ss_ds.merged.samereadgroup.cleaned	409600	409633		YPO_RS02965	33
OOH003ss_ds.merged.samereadgroup.cleaned	415843	415863		YPO_RS02990	20
OOH003ss_ds.merged.samereadgroup.cleaned	426083	426084		lsrF	1
OOH003ss_ds.merged.samereadgroup.cleaned	446220	446225		YPO_RS03120	5
OOH003ss_ds.merged.samereadgroup.cleaned	449166	449176		YPO_RS03140	10
OOH003ss_ds.merged.samereadgroup.cleaned	453381	453409		YPO_RS03165	28
OOH003ss_ds.merged.samereadgroup.cleaned	502132	502136		nhaR	4
OOH003ss_ds.merged.samereadgroup.cleaned	506294	506296		ileS	2
OOH003ss_ds.merged.samereadgroup.cleaned	521134	521142		YPO_RS03450	8
OOH003ss_ds.merged.samereadgroup.cleaned	549482	549484		tssJ	2
OOH003ss_ds.merged.samereadgroup.cleaned	575333	575337		leuC	4
OOH003ss_ds.merged.samereadgroup.cleaned	576311	576315		leuB	4
OOH003ss_ds.merged.samereadgroup.cleaned	584149	584154		ilvI	5
OOH003ss_ds.merged.samereadgroup.cleaned	592060	592070		YPO_RS03735	10
OOH003ss_ds.merged.samereadgroup.cleaned	595313	595351		murF	38
OOH003ss_ds.merged.samereadgroup.cleaned	595778	595805		murF	27
OOH003ss_ds.merged.samereadgroup.cleaned	602364	602365		murC	1
OOH003ss_ds.merged.samereadgroup.cleaned	602539	602542		murC	3
OOH003ss_ds.merged.samereadgroup.cleaned	637710	637711		YPO_RS03935	1
OOH003ss_ds.merged.samereadgroup.cleaned	653712	653722		cdiA	10
OOH003ss_ds.merged.samereadgroup.cleaned	656693	656702		cdiA	9
OOH003ss_ds.merged.samereadgroup.cleaned	657251	657252		cdiA	1
OOH003ss_ds.merged.samereadgroup.cleaned	667975	667987		YPO_RS04035	12
OOH003ss_ds.merged.samereadgroup.cleaned	668141	668143		YPO_RS04040	2
OOH003ss_ds.merged.samereadgroup.cleaned	669613	669617		YPO_RS04040	4
OOH003ss_ds.merged.samereadgroup.cleaned	677286	677291		YPO_RS04070	5
OOH003ss_ds.merged.samereadgroup.cleaned	678118	678123		YPO_RS04070	5
OOH003ss_ds.merged.samereadgroup.cleaned	704994	705002		plsY	8
OOH003ss_ds.merged.samereadgroup.cleaned	713824	713831		glnE	7
OOH003ss_ds.merged.samereadgroup.cleaned	727119	727125		parE	6
OOH003ss_ds.merged.samereadgroup.cleaned	749305	749349		YPO_RS04405	44
OOH003ss_ds.merged.samereadgroup.cleaned	750262	750276		YPO_RS04410	14
OOH003ss_ds.merged.samereadgroup.cleaned	750460	750462		YPO_RS04410	2
OOH003ss_ds.merged.samereadgroup.cleaned	750460	750503		YPO_RS04415	43
OOH003ss_ds.merged.samereadgroup.cleaned	752629	752637		YPO_RS04425	8
OOH003ss_ds.merged.samereadgroup.cleaned	753746	753750		YPO_RS04425	4
OOH003ss_ds.merged.samereadgroup.cleaned	758467	758480		YPO_RS04465	13
OOH003ss_ds.merged.samereadgroup.cleaned	785302	785308		YPO_RS04600	6
OOH003ss_ds.merged.samereadgroup.cleaned	786293	786306		flgF	13
OOH003ss_ds.merged.samereadgroup.cleaned	796058	796075		YPO_RS04660	17
OOH003ss_ds.merged.samereadgroup.cleaned	802554	802649		YPO_RS04690	95
OOH003ss_ds.merged.samereadgroup.cleaned	807626	807643		YPO_RS04720	17
OOH003ss_ds.merged.samereadgroup.cleaned	807675	807703		YPO_RS04720	28
OOH003ss_ds.merged.samereadgroup.cleaned	807690	807703		YPO_RS04725	13
OOH003ss_ds.merged.samereadgroup.cleaned	809192	809225		YPO_RS04735	33
OOH003ss_ds.merged.samereadgroup.cleaned	823558	823563		vgrG	5
OOH003ss_ds.merged.samereadgroup.cleaned	838873	838879		YPO_RS04815	6
OOH003ss_ds.merged.samereadgroup.cleaned	841156	841159		YPO_RS04825	3
OOH003ss_ds.merged.samereadgroup.cleaned	845426	845646		YPO_RS04835	220
OOH003ss_ds.merged.samereadgroup.cleaned	850363	850391		YPO_RS04845	28
OOH003ss_ds.merged.samereadgroup.cleaned	884203	884224		YPO_RS04965	21
OOH003ss_ds.merged.samereadgroup.cleaned	884446	884449		YPO_RS04965	3
OOH003ss_ds.merged.samereadgroup.cleaned	885679	885683		YPO_RS04975	4
OOH003ss_ds.merged.samereadgroup.cleaned	886611	886646		YPO_RS04980	35
OOH003ss_ds.merged.samereadgroup.cleaned	888177	888180		YPO_RS04990	3
OOH003ss_ds.merged.samereadgroup.cleaned	893733	893802		gspD	69
OOH003ss_ds.merged.samereadgroup.cleaned	896176	896190		YPO_RS05030	14
OOH003ss_ds.merged.samereadgroup.cleaned	919739	919765		YPO_RS05130	26
OOH003ss_ds.merged.samereadgroup.cleaned	923250	923257		YPO_RS05140	7
OOH003ss_ds.merged.samereadgroup.cleaned	924409	924414		YPO_RS05145	5
OOH003ss_ds.merged.samereadgroup.cleaned	925968	925983		YPO_RS05150	15
OOH003ss_ds.merged.samereadgroup.cleaned	930400	930402		YPO_RS05170	2
OOH003ss_ds.merged.samereadgroup.cleaned	953663	953688		YPO_RS05260	25
OOH003ss_ds.merged.samereadgroup.cleaned	960348	960351		YPO_RS05290	3
OOH003ss_ds.merged.samereadgroup.cleaned	966515	966521		YPO_RS05330	6
OOH003ss_ds.merged.samereadgroup.cleaned	993959	993962		gcvP	3
OOH003ss_ds.merged.samereadgroup.cleaned	997008	997013		ubiI	5
OOH003ss_ds.merged.samereadgroup.cleaned	1043960	1043973		YPO_RS05675	13
OOH003ss_ds.merged.samereadgroup.cleaned	1044483	1044506		YPO_RS05675	23
OOH003ss_ds.merged.samereadgroup.cleaned	1044978	1044992		YPO_RS05675	14
OOH003ss_ds.merged.samereadgroup.cleaned	1045525	1045551		YPO_RS05675	26
OOH003ss_ds.merged.samereadgroup.cleaned	1053177	1053202		mltC	25
OOH003ss_ds.merged.samereadgroup.cleaned	1065829	1065951		YPO_RS05760	122
OOH003ss_ds.merged.samereadgroup.cleaned	1067336	1067370		YPO_RS05765	34
OOH003ss_ds.merged.samereadgroup.cleaned	1068161	1068165		YPO_RS05770	4
OOH003ss_ds.merged.samereadgroup.cleaned	1081419	1081443		YPO_RS05815	24
OOH003ss_ds.merged.samereadgroup.cleaned	1084027	1084040		tssK	13
OOH003ss_ds.merged.samereadgroup.cleaned	1115259	1115266		YPO_RS05935	7
OOH003ss_ds.merged.samereadgroup.cleaned	1117264	1117295		YPO_RS05940	31
OOH003ss_ds.merged.samereadgroup.cleaned	1122622	1122624		yapH	2
OOH003ss_ds.merged.samereadgroup.cleaned	1123636	1123646		yapH	10
OOH003ss_ds.merged.samereadgroup.cleaned	1124075	1124195		yapH	120
OOH003ss_ds.merged.samereadgroup.cleaned	1124387	1124408		yapH	21
OOH003ss_ds.merged.samereadgroup.cleaned	1124473	1124499		yapH	26
OOH003ss_ds.merged.samereadgroup.cleaned	1124694	1124879		yapH	185
OOH003ss_ds.merged.samereadgroup.cleaned	1125122	1125258		yapH	136
OOH003ss_ds.merged.samereadgroup.cleaned	1125305	1125399		yapH	94
OOH003ss_ds.merged.samereadgroup.cleaned	1125445	1125481		yapH	36
OOH003ss_ds.merged.samereadgroup.cleaned	1125540	1125617		yapH	77
OOH003ss_ds.merged.samereadgroup.cleaned	1125660	1125677		yapH	17
OOH003ss_ds.merged.samereadgroup.cleaned	1167433	1167434		tcdA	1
OOH003ss_ds.merged.samereadgroup.cleaned	1217391	1217401		YPO_RS06325	10
OOH003ss_ds.merged.samereadgroup.cleaned	1220119	1220121		YPO_RS06340	2
OOH003ss_ds.merged.samereadgroup.cleaned	1241063	1241089		YPO_RS06465	26
OOH003ss_ds.merged.samereadgroup.cleaned	1256646	1256648		YPO_RS06545	2
OOH003ss_ds.merged.samereadgroup.cleaned	1269615	1269644		tolA	29
OOH003ss_ds.merged.samereadgroup.cleaned	1269757	1269766		tolA	9
OOH003ss_ds.merged.samereadgroup.cleaned	1271118	1271121		tolB	3
OOH003ss_ds.merged.samereadgroup.cleaned	1280090	1280100		YPO_RS06670	10
OOH003ss_ds.merged.samereadgroup.cleaned	1292908	1292914		modC	6
OOH003ss_ds.merged.samereadgroup.cleaned	1311990	1311995		betA	5
OOH003ss_ds.merged.samereadgroup.cleaned	1339794	1339828		urtD	34
OOH003ss_ds.merged.samereadgroup.cleaned	1379093	1379112		rcsD	19
OOH003ss_ds.merged.samereadgroup.cleaned	1385440	1385446		ampH	6
OOH003ss_ds.merged.samereadgroup.cleaned	1421386	1421387		YPO_RS07330	1
OOH003ss_ds.merged.samereadgroup.cleaned	1438654	1438658		YPO_RS07390	4
OOH003ss_ds.merged.samereadgroup.cleaned	1449274	1449287		YPO_RS07435	13
OOH003ss_ds.merged.samereadgroup.cleaned	1450100	1450114		xylB	14
OOH003ss_ds.merged.samereadgroup.cleaned	1465368	1465373		psaC	5
OOH003ss_ds.merged.samereadgroup.cleaned	1476997	1477027		YPO_RS07545	30
OOH003ss_ds.merged.samereadgroup.cleaned	1514443	1514461		artQ	18
OOH003ss_ds.merged.samereadgroup.cleaned	1528842	1528844		YPO_RS07800	2
OOH003ss_ds.merged.samereadgroup.cleaned	1539729	1539738		aat	9
OOH003ss_ds.merged.samereadgroup.cleaned	1554927	1554934		YPO_RS07890	7
OOH003ss_ds.merged.samereadgroup.cleaned	1566350	1566381		YPO_RS07930	31
OOH003ss_ds.merged.samereadgroup.cleaned	1567753	1567756		YPO_RS07930	3
OOH003ss_ds.merged.samereadgroup.cleaned	1580503	1580507		YPO_RS07975	4
OOH003ss_ds.merged.samereadgroup.cleaned	1595741	1595748		ldtD	7
OOH003ss_ds.merged.samereadgroup.cleaned	1647598	1647624		YPO_RS08260	26
OOH003ss_ds.merged.samereadgroup.cleaned	1658263	1658265		tssC	2
OOH003ss_ds.merged.samereadgroup.cleaned	1658414	1658415		tssC	1
OOH003ss_ds.merged.samereadgroup.cleaned	1661219	1661247		YPO_RS08330	28
OOH003ss_ds.merged.samereadgroup.cleaned	1661388	1661397		YPO_RS08330	9
OOH003ss_ds.merged.samereadgroup.cleaned	1666070	1666075		YPO_RS08345	5
OOH003ss_ds.merged.samereadgroup.cleaned	1673841	1673844		YPO_RS08365	3
OOH003ss_ds.merged.samereadgroup.cleaned	1678179	1678187		YPO_RS08385	8
OOH003ss_ds.merged.samereadgroup.cleaned	1680195	1680202		YPO_RS08385	7
OOH003ss_ds.merged.samereadgroup.cleaned	1680604	1680621		YPO_RS08385	17
OOH003ss_ds.merged.samereadgroup.cleaned	1684045	1684122		YPO_RS08400	77
OOH003ss_ds.merged.samereadgroup.cleaned	1685802	1685814		tssF	12
OOH003ss_ds.merged.samereadgroup.cleaned	1686171	1686181		tssF	10
OOH003ss_ds.merged.samereadgroup.cleaned	1688298	1688305		tssE	7
OOH003ss_ds.merged.samereadgroup.cleaned	1688456	1688462		tssE	6
OOH003ss_ds.merged.samereadgroup.cleaned	1688605	1688613		YPO_RS08425	8
OOH003ss_ds.merged.samereadgroup.cleaned	1688653	1688655		YPO_RS08425	2
OOH003ss_ds.merged.samereadgroup.cleaned	1700326	1700372		darC	46
OOH003ss_ds.merged.samereadgroup.cleaned	1701519	1701533		darB	14
OOH003ss_ds.merged.samereadgroup.cleaned	1706507	1706516		YPO_RS08495	9
OOH003ss_ds.merged.samereadgroup.cleaned	1717398	1717429		YPO_RS08535	31
OOH003ss_ds.merged.samereadgroup.cleaned	1767768	1767769		YPO_RS08745	1
OOH003ss_ds.merged.samereadgroup.cleaned	1788872	1788885		lldD	13
OOH003ss_ds.merged.samereadgroup.cleaned	1789154	1789162		lldD	8
OOH003ss_ds.merged.samereadgroup.cleaned	1802722	1802723		YPO_RS08890	1
OOH003ss_ds.merged.samereadgroup.cleaned	1808304	1808323		bssS	19
OOH003ss_ds.merged.samereadgroup.cleaned	1820331	1820339		plsX	8
OOH003ss_ds.merged.samereadgroup.cleaned	1837736	1837746		nagZ	10
OOH003ss_ds.merged.samereadgroup.cleaned	1921273	1921282		YPO_RS09390	9
OOH003ss_ds.merged.samereadgroup.cleaned	1921532	1921546		YPO_RS09390	14
OOH003ss_ds.merged.samereadgroup.cleaned	1963166	1963167		YPO_RS09565	1
OOH003ss_ds.merged.samereadgroup.cleaned	1979691	1979697		YPO_RS09650	6
OOH003ss_ds.merged.samereadgroup.cleaned	1999858	1999877		mntP	19
OOH003ss_ds.merged.samereadgroup.cleaned	2010149	2010153		hpaD	4
OOH003ss_ds.merged.samereadgroup.cleaned	2012197	2012211		hpaI	14
OOH003ss_ds.merged.samereadgroup.cleaned	2015832	2015844		hpaC	12
OOH003ss_ds.merged.samereadgroup.cleaned	2037395	2037431		flhA	36
OOH003ss_ds.merged.samereadgroup.cleaned	2053359	2053363		flgK	4
OOH003ss_ds.merged.samereadgroup.cleaned	2060622	2060625		YPO_RS10045	3
OOH003ss_ds.merged.samereadgroup.cleaned	2067973	2067979		fliO	6
OOH003ss_ds.merged.samereadgroup.cleaned	2070398	2070483		YPO_RS10110	85
OOH003ss_ds.merged.samereadgroup.cleaned	2088382	2088384		YPO_RS10200	2
OOH003ss_ds.merged.samereadgroup.cleaned	2090845	2090851		YPO_RS10210	6
OOH003ss_ds.merged.samereadgroup.cleaned	2094684	2094685		putA	1
OOH003ss_ds.merged.samereadgroup.cleaned	2096695	2096722		putA	27
OOH003ss_ds.merged.samereadgroup.cleaned	2126772	2126783		YPO_RS10420	11
OOH003ss_ds.merged.samereadgroup.cleaned	2129559	2129561		YPO_RS10435	2
OOH003ss_ds.merged.samereadgroup.cleaned	2142277	2142289		fyuA	12
OOH003ss_ds.merged.samereadgroup.cleaned	2148609	2148619		irp1	10
OOH003ss_ds.merged.samereadgroup.cleaned	2148870	2148887		irp1	17
OOH003ss_ds.merged.samereadgroup.cleaned	2149943	2149945		irp1	2
OOH003ss_ds.merged.samereadgroup.cleaned	2150852	2150884		irp1	32
OOH003ss_ds.merged.samereadgroup.cleaned	2152261	2152272		irp1	11
OOH003ss_ds.merged.samereadgroup.cleaned	2152626	2152666		irp1	40
OOH003ss_ds.merged.samereadgroup.cleaned	2153121	2153125		irp1	4
OOH003ss_ds.merged.samereadgroup.cleaned	2154296	2154299		irp1	3
OOH003ss_ds.merged.samereadgroup.cleaned	2156357	2156385		irp2	28
OOH003ss_ds.merged.samereadgroup.cleaned	2159087	2159093		irp2	6
OOH003ss_ds.merged.samereadgroup.cleaned	2159342	2159345		irp2	3
OOH003ss_ds.merged.samereadgroup.cleaned	2161531	2161533		irp2	2
OOH003ss_ds.merged.samereadgroup.cleaned	2164479	2164492		ybtP	13
OOH003ss_ds.merged.samereadgroup.cleaned	2164964	2164971		ybtP	7
OOH003ss_ds.merged.samereadgroup.cleaned	2165494	2165514		ybtQ	20
OOH003ss_ds.merged.samereadgroup.cleaned	2165596	2165608		ybtQ	12
OOH003ss_ds.merged.samereadgroup.cleaned	2165978	2166014		ybtQ	36
OOH003ss_ds.merged.samereadgroup.cleaned	2166598	2166619		ybtQ	21
OOH003ss_ds.merged.samereadgroup.cleaned	2167174	2167205		ybtX	31
OOH003ss_ds.merged.samereadgroup.cleaned	2170507	2170521		YPO_RS10570	14
OOH003ss_ds.merged.samereadgroup.cleaned	2174350	2174355		YPO_RS10590	5
OOH003ss_ds.merged.samereadgroup.cleaned	2178515	2178524		YPO_RS10605	9
OOH003ss_ds.merged.samereadgroup.cleaned	2183692	2183727		YPO_RS10620	35
OOH003ss_ds.merged.samereadgroup.cleaned	2226534	2226541		YPO_RS10800	7
OOH003ss_ds.merged.samereadgroup.cleaned	2237356	2237375		YPO_RS10835	19
OOH003ss_ds.merged.samereadgroup.cleaned	2251902	2251905		YPO_RS10905	3
OOH003ss_ds.merged.samereadgroup.cleaned	2261849	2261853		YPO_RS10940	4
OOH003ss_ds.merged.samereadgroup.cleaned	2294432	2294443		YPO_RS11110	11
OOH003ss_ds.merged.samereadgroup.cleaned	2301989	2301995		YPO_RS11145	6
OOH003ss_ds.merged.samereadgroup.cleaned	2306086	2306088		YPO_RS11175	2
OOH003ss_ds.merged.samereadgroup.cleaned	2313234	2313242		YPO_RS11210	8
OOH003ss_ds.merged.samereadgroup.cleaned	2316454	2316465		YPO_RS11220	11
OOH003ss_ds.merged.samereadgroup.cleaned	2387921	2387922		YPO_RS11590	1
OOH003ss_ds.merged.samereadgroup.cleaned	2405325	2405333		YPO_RS11685	8
OOH003ss_ds.merged.samereadgroup.cleaned	2420941	2420953		YPO_RS11745	12
OOH003ss_ds.merged.samereadgroup.cleaned	2437377	2437378		YPO_RS11820	1
OOH003ss_ds.merged.samereadgroup.cleaned	2442372	2442377		purU	5
OOH003ss_ds.merged.samereadgroup.cleaned	2445256	2445260		rssB	4
OOH003ss_ds.merged.samereadgroup.cleaned	2465300	2465302		cls	2
OOH003ss_ds.merged.samereadgroup.cleaned	2491183	2491187		topA	4
OOH003ss_ds.merged.samereadgroup.cleaned	2521123	2521125		rsxC	2
OOH003ss_ds.merged.samereadgroup.cleaned	2541930	2541933		YPO_RS12300	3
OOH003ss_ds.merged.samereadgroup.cleaned	2554373	2554633		YPO_RS12355	260
OOH003ss_ds.merged.samereadgroup.cleaned	2554658	2555065		YPO_RS12360	407
OOH003ss_ds.merged.samereadgroup.cleaned	2555162	2555608		YPO_RS12365	446
OOH003ss_ds.merged.samereadgroup.cleaned	2555780	2556832		YPO_RS12370	1052
OOH003ss_ds.merged.samereadgroup.cleaned	2556844	2557161		YPO_RS12375	317
OOH003ss_ds.merged.samereadgroup.cleaned	2557164	2557415		YPO_RS12380	251
OOH003ss_ds.merged.samereadgroup.cleaned	2557451	2557684		YPO_RS12385	233
OOH003ss_ds.merged.samereadgroup.cleaned	2557749	2559461		YPO_RS12390	1712
OOH003ss_ds.merged.samereadgroup.cleaned	2559474	2559761		YPO_RS12395	287
OOH003ss_ds.merged.samereadgroup.cleaned	2559765	2560790		YPO_RS12400	1025
OOH003ss_ds.merged.samereadgroup.cleaned	2560790	2562034		YPO_RS12405	1244
OOH003ss_ds.merged.samereadgroup.cleaned	2562123	2562371		YPO_RS12410	248
OOH003ss_ds.merged.samereadgroup.cleaned	2562568	2562765		YPO_RS12415	197
OOH003ss_ds.merged.samereadgroup.cleaned	2563325	2563443		YPO_RS12420	118
OOH003ss_ds.merged.samereadgroup.cleaned	2590433	2590437		pntA	4
OOH003ss_ds.merged.samereadgroup.cleaned	2672610	2672615		YPO_RS12885	5
OOH003ss_ds.merged.samereadgroup.cleaned	2760246	2760248		YPO_RS13315	2
OOH003ss_ds.merged.samereadgroup.cleaned	2778332	2778335		YPO_RS13380	3
OOH003ss_ds.merged.samereadgroup.cleaned	2792589	2792607		cdiA	18
OOH003ss_ds.merged.samereadgroup.cleaned	2795985	2795998		cdiA	13
OOH003ss_ds.merged.samereadgroup.cleaned	2802561	2802562		YPO_RS13470	1
OOH003ss_ds.merged.samereadgroup.cleaned	2832569	2832571		menE	2
OOH003ss_ds.merged.samereadgroup.cleaned	2853937	2853942		YPO_RS13690	5
OOH003ss_ds.merged.samereadgroup.cleaned	2885781	2885790		YPO_RS13815	9
OOH003ss_ds.merged.samereadgroup.cleaned	2887088	2887932		YPO_RS13825	844
OOH003ss_ds.merged.samereadgroup.cleaned	2887989	2893967		YPO_RS13830	5978
OOH003ss_ds.merged.samereadgroup.cleaned	2894374	2894922		YPO_RS13835	548
OOH003ss_ds.merged.samereadgroup.cleaned	2895617	2896471		YPO_RS13840	854
OOH003ss_ds.merged.samereadgroup.cleaned	2896777	2897236		YPO_RS13845	459
OOH003ss_ds.merged.samereadgroup.cleaned	2897286	2898101		YPO_RS13845	815
OOH003ss_ds.merged.samereadgroup.cleaned	2898177	2898303		YPO_RS13845	126
OOH003ss_ds.merged.samereadgroup.cleaned	2898338	2900263		iolD	1925
OOH003ss_ds.merged.samereadgroup.cleaned	2907397	2907420		iolC	23
OOH003ss_ds.merged.samereadgroup.cleaned	2908960	2908964		iolE	4
OOH003ss_ds.merged.samereadgroup.cleaned	2909517	2909522		iolB	5
OOH003ss_ds.merged.samereadgroup.cleaned	2910271	2910290		iolB	19
OOH003ss_ds.merged.samereadgroup.cleaned	2922468	2922473		dacA	5
OOH003ss_ds.merged.samereadgroup.cleaned	2941764	2941766		YPO_RS14055	2
OOH003ss_ds.merged.samereadgroup.cleaned	2980439	2980590		YPO_RS14235	151
OOH003ss_ds.merged.samereadgroup.cleaned	3010444	3010451		pgm	7
OOH003ss_ds.merged.samereadgroup.cleaned	3012165	3012216		YPO_RS14405	51
OOH003ss_ds.merged.samereadgroup.cleaned	3014521	3014536		kdbD	15
OOH003ss_ds.merged.samereadgroup.cleaned	3021133	3021155		YPO_RS14440	22
OOH003ss_ds.merged.samereadgroup.cleaned	3120316	3120561		YPO_RS14920	245
OOH003ss_ds.merged.samereadgroup.cleaned	3121234	3121815		YPO_RS14925	581
OOH003ss_ds.merged.samereadgroup.cleaned	3122083	3122484		YPO_RS14930	401
OOH003ss_ds.merged.samereadgroup.cleaned	3122717	3123118		YPO_RS14935	401
OOH003ss_ds.merged.samereadgroup.cleaned	3123130	3123702		YPO_RS14940	572
OOH003ss_ds.merged.samereadgroup.cleaned	3123726	3123977		YPO_RS14945	251
OOH003ss_ds.merged.samereadgroup.cleaned	3124016	3124255		YPO_RS14950	239
OOH003ss_ds.merged.samereadgroup.cleaned	3125064	3126980		yapC	1916
OOH003ss_ds.merged.samereadgroup.cleaned	3127176	3127226		YPO_RS14960	50
OOH003ss_ds.merged.samereadgroup.cleaned	3127515	3128096		YPO_RS14965	581
OOH003ss_ds.merged.samereadgroup.cleaned	3130158	3132365		YPO_RS14980	2207
OOH003ss_ds.merged.samereadgroup.cleaned	3132358	3132888		YPO_RS14985	530
OOH003ss_ds.merged.samereadgroup.cleaned	3133047	3135428		YPO_RS14990	2381
OOH003ss_ds.merged.samereadgroup.cleaned	3135507	3137135		YPO_RS14995	1628
OOH003ss_ds.merged.samereadgroup.cleaned	3137608	3138459		YPO_RS15000	851
OOH003ss_ds.merged.samereadgroup.cleaned	3138485	3139474		YPO_RS15005	989
OOH003ss_ds.merged.samereadgroup.cleaned	3139529	3140421		YPO_RS15010	892
OOH003ss_ds.merged.samereadgroup.cleaned	3142684	3142989		YPO_RS15025	305
OOH003ss_ds.merged.samereadgroup.cleaned	3143086	3143487		YPO_RS15030	401
OOH003ss_ds.merged.samereadgroup.cleaned	3143469	3144177		YPO_RS15035	708
OOH003ss_ds.merged.samereadgroup.cleaned	3145307	3145311		YPO_RS15040	4
OOH003ss_ds.merged.samereadgroup.cleaned	3145844	3145852		YPO_RS15040	8
OOH003ss_ds.merged.samereadgroup.cleaned	3151676	3151688		YPO_RS15090	12
OOH003ss_ds.merged.samereadgroup.cleaned	3163404	3163419		YPO_RS15145	15
OOH003ss_ds.merged.samereadgroup.cleaned	3183963	3183964		mdtC	1
OOH003ss_ds.merged.samereadgroup.cleaned	3200819	3200837		YPO_RS15290	18
OOH003ss_ds.merged.samereadgroup.cleaned	3201602	3201603		YPO_RS15300	1
OOH003ss_ds.merged.samereadgroup.cleaned	3201679	3201704		YPO_RS15300	25
OOH003ss_ds.merged.samereadgroup.cleaned	3221824	3221855		YPO_RS15385	31
OOH003ss_ds.merged.samereadgroup.cleaned	3222644	3222651		YPO_RS15385	7
OOH003ss_ds.merged.samereadgroup.cleaned	3225496	3225524		yapA	28
OOH003ss_ds.merged.samereadgroup.cleaned	3225584	3225631		yapA	47
OOH003ss_ds.merged.samereadgroup.cleaned	3231858	3231860		YPO_RS15405	2
OOH003ss_ds.merged.samereadgroup.cleaned	3236971	3236978		hscA	7
OOH003ss_ds.merged.samereadgroup.cleaned	3265851	3265857		purL	6
OOH003ss_ds.merged.samereadgroup.cleaned	3294242	3294245		tssF	3
OOH003ss_ds.merged.samereadgroup.cleaned	3318208	3318209		YPO_RS15795	1
OOH003ss_ds.merged.samereadgroup.cleaned	3364213	3364234		YPO_RS16040	21
OOH003ss_ds.merged.samereadgroup.cleaned	3364712	3364725		YPO_RS16040	13
OOH003ss_ds.merged.samereadgroup.cleaned	3385312	3385316		hemF	4
OOH003ss_ds.merged.samereadgroup.cleaned	3385904	3385921		hemF	17
OOH003ss_ds.merged.samereadgroup.cleaned	3398549	3398550		acrD	1
OOH003ss_ds.merged.samereadgroup.cleaned	3405496	3405530		YPO_RS16220	34
OOH003ss_ds.merged.samereadgroup.cleaned	3405628	3405649		YPO_RS16220	21
OOH003ss_ds.merged.samereadgroup.cleaned	3425947	3425948		YPO_RS16315	1
OOH003ss_ds.merged.samereadgroup.cleaned	3429652	3429657		cysS	5
OOH003ss_ds.merged.samereadgroup.cleaned	3433268	3433281		purK	13
OOH003ss_ds.merged.samereadgroup.cleaned	3434072	3434088		YPO_RS16360	16
OOH003ss_ds.merged.samereadgroup.cleaned	3435001	3435002		YPO_RS16360	1
OOH003ss_ds.merged.samereadgroup.cleaned	3437815	3438248		YPO_RS16375	433
OOH003ss_ds.merged.samereadgroup.cleaned	3438325	3438662		YPO_RS16380	337
OOH003ss_ds.merged.samereadgroup.cleaned	3438716	3438771		YPO_RS16380	55
OOH003ss_ds.merged.samereadgroup.cleaned	3438824	3438918		YPO_RS16380	94
OOH003ss_ds.merged.samereadgroup.cleaned	3438973	3439019		YPO_RS16380	46
OOH003ss_ds.merged.samereadgroup.cleaned	3439092	3439194		YPO_RS16380	102
OOH003ss_ds.merged.samereadgroup.cleaned	3439389	3439633		YPO_RS16385	244
OOH003ss_ds.merged.samereadgroup.cleaned	3439706	3439871		YPO_RS16385	165
OOH003ss_ds.merged.samereadgroup.cleaned	3450521	3450522		YPO_RS16430	1
OOH003ss_ds.merged.samereadgroup.cleaned	3450529	3450538		YPO_RS16430	9
OOH003ss_ds.merged.samereadgroup.cleaned	3455009	3455012		cpsG	3
OOH003ss_ds.merged.samereadgroup.cleaned	3457118	3457120		YPO_RS16450	2
OOH003ss_ds.merged.samereadgroup.cleaned	3463766	3463817		YPO_RS16480	51
OOH003ss_ds.merged.samereadgroup.cleaned	3463938	3463958		YPO_RS16480	20
OOH003ss_ds.merged.samereadgroup.cleaned	3464843	3464868		YPO_RS16485	25
OOH003ss_ds.merged.samereadgroup.cleaned	3465508	3465556		YPO_RS16485	48
OOH003ss_ds.merged.samereadgroup.cleaned	3465567	3465580		YPO_RS16490	13
OOH003ss_ds.merged.samereadgroup.cleaned	3466275	3466377		YPO_RS16490	102
OOH003ss_ds.merged.samereadgroup.cleaned	3466635	3466647		YPO_RS16490	12
OOH003ss_ds.merged.samereadgroup.cleaned	3546209	3546213		ribD	4
OOH003ss_ds.merged.samereadgroup.cleaned	3572099	3572122		YPO_RS16965	23
OOH003ss_ds.merged.samereadgroup.cleaned	3600204	3600211		YPO_RS17080	7
OOH003ss_ds.merged.samereadgroup.cleaned	3600722	3600725		nqrF	3
OOH003ss_ds.merged.samereadgroup.cleaned	3629203	3629211		YPO_RS17190	8
OOH003ss_ds.merged.samereadgroup.cleaned	3654007	3654009		YPO_RS17305	2
OOH003ss_ds.merged.samereadgroup.cleaned	3654246	3654247		YPO_RS17310	1
OOH003ss_ds.merged.samereadgroup.cleaned	3672986	3673044		trmD	58
OOH003ss_ds.merged.samereadgroup.cleaned	3682302	3682312		YPO_RS17455	10
OOH003ss_ds.merged.samereadgroup.cleaned	3682473	3682483		YPO_RS17460	10
OOH003ss_ds.merged.samereadgroup.cleaned	3696533	3696552		YPO_RS17530	19
OOH003ss_ds.merged.samereadgroup.cleaned	3747637	3747651		surE	14
OOH003ss_ds.merged.samereadgroup.cleaned	3755698	3755715		cobA	17
OOH003ss_ds.merged.samereadgroup.cleaned	3758311	3758334		cysI	23
OOH003ss_ds.merged.samereadgroup.cleaned	3760432	3760435		cysJ	3
OOH003ss_ds.merged.samereadgroup.cleaned	3761535	3761541		cysJ	6
OOH003ss_ds.merged.samereadgroup.cleaned	3773769	3773779		barA	10
OOH003ss_ds.merged.samereadgroup.cleaned	3779831	3779840		YPO_RS17900	9
OOH003ss_ds.merged.samereadgroup.cleaned	3781610	3781616		clcA	6
OOH003ss_ds.merged.samereadgroup.cleaned	3793675	3793715		thpR	40
OOH003ss_ds.merged.samereadgroup.cleaned	3796305	3796324		gluQRS	19
OOH003ss_ds.merged.samereadgroup.cleaned	3812185	3812186		YPO_RS18035	1
OOH003ss_ds.merged.samereadgroup.cleaned	3848884	3848899		YPO_RS18185	15
OOH003ss_ds.merged.samereadgroup.cleaned	3877990	3877992		YPO_RS18325	2
OOH003ss_ds.merged.samereadgroup.cleaned	3890491	3890495		YPO_RS18370	4
OOH003ss_ds.merged.samereadgroup.cleaned	3949740	3949748		yjfP	8
OOH003ss_ds.merged.samereadgroup.cleaned	3996111	3996116		npr	5
OOH003ss_ds.merged.samereadgroup.cleaned	4005931	4005935		tssK	4
OOH003ss_ds.merged.samereadgroup.cleaned	4011717	4011720		tssA	3
OOH003ss_ds.merged.samereadgroup.cleaned	4026659	4026680		YPO_RS19045	21
OOH003ss_ds.merged.samereadgroup.cleaned	4027513	4027518		YPO_RS19045	5
OOH003ss_ds.merged.samereadgroup.cleaned	4029420	4029433		YPO_RS19055	13
OOH003ss_ds.merged.samereadgroup.cleaned	4032702	4032703		YPO_RS19055	1
OOH003ss_ds.merged.samereadgroup.cleaned	4033796	4033799		YPO_RS19060	3
OOH003ss_ds.merged.samereadgroup.cleaned	4071540	4071541		YPO_RS19240	1
OOH003ss_ds.merged.samereadgroup.cleaned	4071843	4071853		YPO_RS19240	10
OOH003ss_ds.merged.samereadgroup.cleaned	4080645	4080680		accB	35
OOH003ss_ds.merged.samereadgroup.cleaned	4082227	4082232		msrQ	5
OOH003ss_ds.merged.samereadgroup.cleaned	4100967	4101101		YPO_RS19365	134
OOH003ss_ds.merged.samereadgroup.cleaned	4101309	4101316		YPO_RS19365	7
OOH003ss_ds.merged.samereadgroup.cleaned	4101369	4101491		YPO_RS19365	122
OOH003ss_ds.merged.samereadgroup.cleaned	4101516	4102383		YPO_RS19370	867
OOH003ss_ds.merged.samereadgroup.cleaned	4102420	4102493		YPO_RS19370	73
OOH003ss_ds.merged.samereadgroup.cleaned	4102534	4102546		YPO_RS19370	12
OOH003ss_ds.merged.samereadgroup.cleaned	4102692	4102785		YPO_RS19370	93
OOH003ss_ds.merged.samereadgroup.cleaned	4102874	4102887		YPO_RS19370	13
OOH003ss_ds.merged.samereadgroup.cleaned	4102933	4102945		YPO_RS19370	12
OOH003ss_ds.merged.samereadgroup.cleaned	4103042	4103052		YPO_RS19370	10
OOH003ss_ds.merged.samereadgroup.cleaned	4103125	4103143		YPO_RS19370	18
OOH003ss_ds.merged.samereadgroup.cleaned	4103208	4103214		YPO_RS19370	6
OOH003ss_ds.merged.samereadgroup.cleaned	4103247	4103262		YPO_RS19370	15
OOH003ss_ds.merged.samereadgroup.cleaned	4103438	4103443		YPO_RS19370	5
OOH003ss_ds.merged.samereadgroup.cleaned	4110134	4110157		YPO_RS19390	23
OOH003ss_ds.merged.samereadgroup.cleaned	4112720	4112777		YPO_RS19400	57
OOH003ss_ds.merged.samereadgroup.cleaned	4114002	4114019		YPO_RS19405	17
OOH003ss_ds.merged.samereadgroup.cleaned	4129039	4129045		rnk	6
OOH003ss_ds.merged.samereadgroup.cleaned	4150436	4150441		malF	5
OOH003ss_ds.merged.samereadgroup.cleaned	4155787	4155789		lysC	2
OOH003ss_ds.merged.samereadgroup.cleaned	4206220	4206223		rplL	3
OOH003ss_ds.merged.samereadgroup.cleaned	4223144	4223145		YPO_RS19870	1
OOH003ss_ds.merged.samereadgroup.cleaned	4236786	4236788		YPO_RS19940	2
OOH003ss_ds.merged.samereadgroup.cleaned	4258485	4258491		YPO_RS20045	6
OOH003ss_ds.merged.samereadgroup.cleaned	4264356	4264394		YPO_RS20070	38
OOH003ss_ds.merged.samereadgroup.cleaned	4280849	4280882		ftsY	33
OOH003ss_ds.merged.samereadgroup.cleaned	4294584	4294586		glpQ	2
OOH003ss_ds.merged.samereadgroup.cleaned	4298041	4298063		pldB	22
OOH003ss_ds.merged.samereadgroup.cleaned	4312703	4312706		yigB	3
OOH003ss_ds.merged.samereadgroup.cleaned	4323001	4323010		hemY	9
OOH003ss_ds.merged.samereadgroup.cleaned	4353075	4353080		YPO_RS20490	5
OOH003ss_ds.merged.samereadgroup.cleaned	4360281	4360282		YPO_RS20525	1
OOH003ss_ds.merged.samereadgroup.cleaned	4364598	4364601		ilvY	3
OOH003ss_ds.merged.samereadgroup.cleaned	4369970	4370010		ilvA	40
OOH003ss_ds.merged.samereadgroup.cleaned	4433886	4433896		YPO_RS20825	10
OOH003ss_ds.merged.samereadgroup.cleaned	4440020	4440032		YPO_RS20830	12
OOH003ss_ds.merged.samereadgroup.cleaned	4448907	4448928		YPO_RS20865	21
OOH003ss_ds.merged.samereadgroup.cleaned	4474573	4474579		rsmJ	6
OOH003ss_ds.merged.samereadgroup.cleaned	4481961	4481967		YPO_RS21010	6
OOH003ss_ds.merged.samereadgroup.cleaned	4484607	4484613		YPO_RS21030	6
OOH003ss_ds.merged.samereadgroup.cleaned	4528820	4528822		YPO_RS21190	2
OOH003ss_ds.merged.samereadgroup.cleaned	4545805	4545811		YPO_RS21280	6
OOH003ss_ds.merged.samereadgroup.cleaned	4549843	4549848		YPO_RS21300	5
OOH003ss_ds.merged.samereadgroup.cleaned	4561585	4561597		YPO_RS21340	12
OOH003ss_ds.merged.samereadgroup.cleaned	4569626	4569653		selB	27
OOH003ss_ds.merged.samereadgroup.cleaned	4612520	4612521		yidA	1
OOH003ss_ds.merged.samereadgroup.cleaned	4614243	4614247		gyrB	4
OOH003ss_ds.merged.samereadgroup.cleaned	4620974	4620975		yidD	1
RISE505.MA873_L1	7244	7253		kup	9
RISE505.MA873_L1	14685	14687		YPO_RS01080	2
RISE505.MA873_L1	18112	18114		YPO_RS01090	2
RISE505.MA873_L1	18175	18177		YPO_RS01090	2
RISE505.MA873_L1	18873	18875		YPO_RS01090	2
RISE505.MA873_L1	18945	18950		YPO_RS01090	5
RISE505.MA873_L1	19020	19021		YPO_RS01090	1
RISE505.MA873_L1	19654	19663		mobB	9
RISE505.MA873_L1	23668	23670		polA	2
RISE505.MA873_L1	39789	39796		YPO_RS01180	7
RISE505.MA873_L1	69337	69350		rfaD	13
RISE505.MA873_L1	71697	71704		tdh	7
RISE505.MA873_L1	85698	85701		YPO_RS01420	3
RISE505.MA873_L1	90839	90841		YPO_RS01440	2
RISE505.MA873_L1	106096	106099		YPO_RS01515	3
RISE505.MA873_L1	106535	106539		YPO_RS01520	4
RISE505.MA873_L1	106580	106599		YPO_RS01520	19
RISE505.MA873_L1	128450	128452		YPO_RS01610	2
RISE505.MA873_L1	138034	138036		malQ	2
RISE505.MA873_L1	151669	151670		pckA	1
RISE505.MA873_L1	152514	152517		pckA	3
RISE505.MA873_L1	169607	169609		rpe	2
RISE505.MA873_L1	196779	196788		YPO_RS01895	9
RISE505.MA873_L1	202478	202484		tauC	6
RISE505.MA873_L1	213924	213939		YPO_RS01985	15
RISE505.MA873_L1	216464	216470		fusA	6
RISE505.MA873_L1	232058	232061		secY	3
RISE505.MA873_L1	237227	237228		trkA	1
RISE505.MA873_L1	244906	244908		aroE	2
RISE505.MA873_L1	257981	257982		YPO_RS02285	1
RISE505.MA873_L1	259798	259799		YPO_RS02290	1
RISE505.MA873_L1	274980	274982		yedE	2
RISE505.MA873_L1	277184	277185		YPO_RS02400	1
RISE505.MA873_L1	278430	278432		metC	2
RISE505.MA873_L1	286999	287009		YPO_RS02450	10
RISE505.MA873_L1	295767	295768		YPO_RS02490	1
RISE505.MA873_L1	297213	297215		YPO_RS02495	2
RISE505.MA873_L1	315124	315125		yapK	1
RISE505.MA873_L1	323433	323435		dusA	2
RISE505.MA873_L1	345100	345109		YPO_RS02690	9
RISE505.MA873_L1	345247	345250		YPO_RS02690	3
RISE505.MA873_L1	346397	346408		YPO_RS02695	11
RISE505.MA873_L1	346582	346630		YPO_RS02695	48
RISE505.MA873_L1	347907	347909		YPO_RS02695	2
RISE505.MA873_L1	374983	374987		mscM	4
RISE505.MA873_L1	401049	401052		YPO_RS02925	3
RISE505.MA873_L1	408328	408336		YPO_RS02955	8
RISE505.MA873_L1	408392	408406		YPO_RS02955	14
RISE505.MA873_L1	408436	408437		YPO_RS02955	1
RISE505.MA873_L1	409549	409585		YPO_RS02965	36
RISE505.MA873_L1	410562	410566		YPO_RS02965	4
RISE505.MA873_L1	427766	427768		lsrD	2
RISE505.MA873_L1	436085	436086		YPO_RS03085	1
RISE505.MA873_L1	437864	437865		YPO_RS03090	1
RISE505.MA873_L1	444689	444691		YPO_RS03115	2
RISE505.MA873_L1	446213	446217		YPO_RS03120	4
RISE505.MA873_L1	479356	479365		gpmB	9
RISE505.MA873_L1	484741	484742		thrA	1
RISE505.MA873_L1	508678	508682		ispH	4
RISE505.MA873_L1	512263	512272		carA	9
RISE505.MA873_L1	521237	521246		YPO_RS03450	9
RISE505.MA873_L1	532849	532850		YPO_RS03500	1
RISE505.MA873_L1	535715	535717		tssC	2
RISE505.MA873_L1	537909	537911		tssF	2
RISE505.MA873_L1	552923	552930		tssM	7
RISE505.MA873_L1	562121	562126		YPO_RS03600	5
RISE505.MA873_L1	569058	569061		YPO_RS03625	3
RISE505.MA873_L1	573140	573142		YPO_RS03645	2
RISE505.MA873_L1	579578	579586		YPO_RS03675	8
RISE505.MA873_L1	593320	593327		YPO_RS03735	7
RISE505.MA873_L1	596795	596798		mraY	3
RISE505.MA873_L1	604640	604642		ftsA	2
RISE505.MA873_L1	616464	616469		YPO_RS03845	5
RISE505.MA873_L1	634310	634311		yapG	1
RISE505.MA873_L1	634807	634814		yapG	7
RISE505.MA873_L1	642987	642989		YPO_RS03950	2
RISE505.MA873_L1	646261	646264		YPO_RS03970	3
RISE505.MA873_L1	652821	652824		cdiA	3
RISE505.MA873_L1	659215	659245		cdiI	30
RISE505.MA873_L1	659377	659386		cdiI	9
RISE505.MA873_L1	696694	696700		YPO_RS04170	6
RISE505.MA873_L1	697052	697057		YPO_RS04170	5
RISE505.MA873_L1	713295	713296		glnE	1
RISE505.MA873_L1	728808	728810		parE	2
RISE505.MA873_L1	743803	743805		metC	2
RISE505.MA873_L1	750925	750964		YPO_RS04415	39
RISE505.MA873_L1	751117	751127		YPO_RS04415	10
RISE505.MA873_L1	751611	751630		YPO_RS04420	19
RISE505.MA873_L1	753356	753362		YPO_RS04425	6
RISE505.MA873_L1	753753	753756		YPO_RS04425	3
RISE505.MA873_L1	753767	753778		YPO_RS04430	11
RISE505.MA873_L1	754426	754428		YPO_RS04435	2
RISE505.MA873_L1	755318	755320		YPO_RS04440	2
RISE505.MA873_L1	756556	756569		YPO_RS04450	13
RISE505.MA873_L1	758430	760910		YPO_RS04465	2480
RISE505.MA873_L1	760928	761647		YPO_RS04470	719
RISE505.MA873_L1	761672	762778		YPO_RS04475	1106
RISE505.MA873_L1	762990	764069		fepB	1079
RISE505.MA873_L1	764925	765051		YPO_RS04485	126
RISE505.MA873_L1	765090	765920		YPO_RS04485	830
RISE505.MA873_L1	766012	766581		YPO_RS04490	569
RISE505.MA873_L1	768877	770010		flhB	1133
RISE505.MA873_L1	770010	770783		YPO_RS04505	773
RISE505.MA873_L1	770790	771062		fliQ	272
RISE505.MA873_L1	771223	771834		fliP	611
RISE505.MA873_L1	771064	771191		fliP	127
RISE505.MA873_L1	771831	772244		fliN	413
RISE505.MA873_L1	772237	773136		YPO_RS04525	899
RISE505.MA873_L1	773659	773680		YPO_RS04530	21
RISE505.MA873_L1	773709	774687		YPO_RS04530	978
RISE505.MA873_L1	774704	775084		fliE	380
RISE505.MA873_L1	775094	776734		fliF	1640
RISE505.MA873_L1	776706	777749		YPO_RS04545	1043
RISE505.MA873_L1	777754	778470		YPO_RS04550	716
RISE505.MA873_L1	778463	779803		fliI	1340
RISE505.MA873_L1	779807	780190		fliJ	383
RISE505.MA873_L1	780518	780943		YPO_RS04565	425
RISE505.MA873_L1	780950	781216		flgM	266
RISE505.MA873_L1	781445	782148		flgA	703
RISE505.MA873_L1	782178	782293		flgA	115
RISE505.MA873_L1	782351	782797		flgB	446
RISE505.MA873_L1	782800	783225		flgC	425
RISE505.MA873_L1	783228	783884		flgD	656
RISE505.MA873_L1	783939	785180		flaE	1241
RISE505.MA873_L1	785180	785291		YPO_RS04600	111
RISE505.MA873_L1	786029	786622		flgF	593
RISE505.MA873_L1	786690	787475		flgG	785
RISE505.MA873_L1	787510	788175		flgH	665
RISE505.MA873_L1	788222	789364		YPO_RS04625	1142
RISE505.MA873_L1	789374	789667		flgJ	293
RISE505.MA873_L1	789780	791141		flgK	1361
RISE505.MA873_L1	791170	792093		flgL	923
RISE505.MA873_L1	792105	793118		YPO_RS04645	1013
RISE505.MA873_L1	793666	793728		YPO_RS04650	62
RISE505.MA873_L1	793282	793635		YPO_RS04650	353
RISE505.MA873_L1	793709	794755		YPO_RS04655	1046
RISE505.MA873_L1	795381	795524		YPO_RS04660	143
RISE505.MA873_L1	795561	795566		YPO_RS04660	5
RISE505.MA873_L1	795609	795663		YPO_RS04660	54
RISE505.MA873_L1	795823	796295		YPO_RS04660	472
RISE505.MA873_L1	796555	796556		YPO_RS04660	1
RISE505.MA873_L1	800883	800885		fliD	2
RISE505.MA873_L1	802547	802643		YPO_RS04690	96
RISE505.MA873_L1	809051	809053		YPO_RS04735	2
RISE505.MA873_L1	810422	810426		YPO_RS04740	4
RISE505.MA873_L1	811217	811233		YPO_RS04745	16
RISE505.MA873_L1	820609	820617		YPO_RS04770	8
RISE505.MA873_L1	841545	841550		YPO_RS04825	5
RISE505.MA873_L1	842071	842078		YPO_RS04830	7
RISE505.MA873_L1	843591	843598		YPO_RS04835	7
RISE505.MA873_L1	845040	845047		YPO_RS04835	7
RISE505.MA873_L1	852611	852613		YPO_RS04845	2
RISE505.MA873_L1	863519	863532		ptsP	13
RISE505.MA873_L1	866491	866492		YPO_RS04890	1
RISE505.MA873_L1	867368	867373		YPO_RS04895	5
RISE505.MA873_L1	871952	871956		YPO_RS04915	4
RISE505.MA873_L1	884141	884153		YPO_RS04960	12
RISE505.MA873_L1	884215	884217		YPO_RS04965	2
RISE505.MA873_L1	885581	885588		YPO_RS04975	7
RISE505.MA873_L1	886460	886489		YPO_RS04980	29
RISE505.MA873_L1	886709	886728		YPO_RS04980	19
RISE505.MA873_L1	886827	886833		YPO_RS04980	6
RISE505.MA873_L1	887181	887185		gspL	4
RISE505.MA873_L1	887217	887229		gspL	12
RISE505.MA873_L1	888158	888161		YPO_RS04990	3
RISE505.MA873_L1	888436	888440		YPO_RS04990	4
RISE505.MA873_L1	888929	888931		YPO_RS04990	2
RISE505.MA873_L1	889373	889419		gspJ	46
RISE505.MA873_L1	889458	889496		gspJ	38
RISE505.MA873_L1	889655	889662		gspI	7
RISE505.MA873_L1	890792	890800		gspG	8
RISE505.MA873_L1	892176	892192		gspE	16
RISE505.MA873_L1	892746	892748		gspE	2
RISE505.MA873_L1	893771	893784		gspD	13
RISE505.MA873_L1	895719	895733		YPO_RS05030	14
RISE505.MA873_L1	896145	896157		YPO_RS05030	12
RISE505.MA873_L1	903065	903068		YPO_RS05060	3
RISE505.MA873_L1	903950	903955		YPO_RS05060	5
RISE505.MA873_L1	907132	907134		YPO_RS05070	2
RISE505.MA873_L1	926724	926727		YPO_RS05155	3
RISE505.MA873_L1	927554	927559		YPO_RS05160	5
RISE505.MA873_L1	934492	934493		YPO_RS05180	1
RISE505.MA873_L1	937318	937324		YPO_RS05190	6
RISE505.MA873_L1	939351	939352		YPO_RS05195	1
RISE505.MA873_L1	940582	940589		YPO_RS05205	7
RISE505.MA873_L1	942368	942373		YPO_RS05210	5
RISE505.MA873_L1	943968	943969		YPO_RS05215	1
RISE505.MA873_L1	946165	946178		YPO_RS05220	13
RISE505.MA873_L1	949883	949889		YPO_RS05235	6
RISE505.MA873_L1	950097	950142		YPO_RS05235	45
RISE505.MA873_L1	950256	950266		YPO_RS05235	10
RISE505.MA873_L1	953702	953704		YPO_RS05260	2
RISE505.MA873_L1	956291	956294		YPO_RS05270	3
RISE505.MA873_L1	962580	962582		YPO_RS05295	2
RISE505.MA873_L1	966685	966690		YPO_RS05330	5
RISE505.MA873_L1	974302	974303		prfB	1
RISE505.MA873_L1	976941	976943		dsbC	2
RISE505.MA873_L1	981889	981901		creB	12
RISE505.MA873_L1	983697	983706		ygfZ	9
RISE505.MA873_L1	985177	985186		YPO_RS05435	9
RISE505.MA873_L1	1002564	1002579		YPO_RS05505	15
RISE505.MA873_L1	1020687	1020689		speA	2
RISE505.MA873_L1	1026003	1026005		endA	2
RISE505.MA873_L1	1037627	1037630		YPO_RS05675	3
RISE505.MA873_L1	1038773	1038778		YPO_RS05675	5
RISE505.MA873_L1	1040111	1040127		YPO_RS05675	16
RISE505.MA873_L1	1041056	1041058		YPO_RS05675	2
RISE505.MA873_L1	1042171	1042187		YPO_RS05675	16
RISE505.MA873_L1	1044354	1044358		YPO_RS05675	4
RISE505.MA873_L1	1044671	1044672		YPO_RS05675	1
RISE505.MA873_L1	1044775	1044783		YPO_RS05675	8
RISE505.MA873_L1	1045161	1045165		YPO_RS05675	4
RISE505.MA873_L1	1045282	1045299		YPO_RS05675	17
RISE505.MA873_L1	1045381	1045388		YPO_RS05675	7
RISE505.MA873_L1	1062151	1062152		speF	1
RISE505.MA873_L1	1065208	1065221		YPO_RS05755	13
RISE505.MA873_L1	1065829	1065952		YPO_RS05760	123
RISE505.MA873_L1	1066706	1066708		YPO_RS05765	2
RISE505.MA873_L1	1066969	1066983		YPO_RS05765	14
RISE505.MA873_L1	1067312	1067332		YPO_RS05765	20
RISE505.MA873_L1	1067798	1067810		YPO_RS05770	12
RISE505.MA873_L1	1068071	1068085		YPO_RS05770	14
RISE505.MA873_L1	1069661	1069664		YPO_RS05770	3
RISE505.MA873_L1	1071667	1071679		YPO_RS05785	12
RISE505.MA873_L1	1091417	1091421		YPO_RS05855	4
RISE505.MA873_L1	1092640	1092642		YPO_RS05860	2
RISE505.MA873_L1	1093923	1093943		YPO_RS05865	20
RISE505.MA873_L1	1101547	1101549		iucC	2
RISE505.MA873_L1	1106197	1106200		YPO_RS05910	3
RISE505.MA873_L1	1108465	1108469		YPO_RS05915	4
RISE505.MA873_L1	1108786	1108788		YPO_RS05915	2
RISE505.MA873_L1	1110833	1110893		YPO_RS05920	60
RISE505.MA873_L1	1113225	1113226		YPO_RS05930	1
RISE505.MA873_L1	1116964	1116977		YPO_RS05940	13
RISE505.MA873_L1	1117331	1117359		YPO_RS05940	28
RISE505.MA873_L1	1117595	1117604		YPO_RS05940	9
RISE505.MA873_L1	1124095	1124103		yapH	8
RISE505.MA873_L1	1124179	1124191		yapH	12
RISE505.MA873_L1	1124221	1124230		yapH	9
RISE505.MA873_L1	1124370	1124416		yapH	46
RISE505.MA873_L1	1124476	1124497		yapH	21
RISE505.MA873_L1	1124530	1124544		yapH	14
RISE505.MA873_L1	1124588	1124615		yapH	27
RISE505.MA873_L1	1124694	1124883		yapH	189
RISE505.MA873_L1	1124920	1124935		yapH	15
RISE505.MA873_L1	1124992	1124993		yapH	1
RISE505.MA873_L1	1125118	1125249		yapH	131
RISE505.MA873_L1	1125318	1125394		yapH	76
RISE505.MA873_L1	1125439	1125472		yapH	33
RISE505.MA873_L1	1125543	1125602		yapH	59
RISE505.MA873_L1	1125669	1125691		yapH	22
RISE505.MA873_L1	1128251	1128253		yapH	2
RISE505.MA873_L1	1128438	1128439		yapH	1
RISE505.MA873_L1	1140512	1140528		YPO_RS05985	16
RISE505.MA873_L1	1141699	1141707		YPO_RS05985	8
RISE505.MA873_L1	1147542	1147543		YPO_RS06000	1
RISE505.MA873_L1	1152304	1152308		recC	4
RISE505.MA873_L1	1161769	1161771		argA	2
RISE505.MA873_L1	1173223	1173229		xni	6
RISE505.MA873_L1	1181592	1181597		glnD	5
RISE505.MA873_L1	1192812	1192816		rseP	4
RISE505.MA873_L1	1211053	1211054		proS	1
RISE505.MA873_L1	1217389	1217402		YPO_RS06325	13
RISE505.MA873_L1	1218461	1218464		YPO_RS06330	3
RISE505.MA873_L1	1220109	1220124		YPO_RS06340	15
RISE505.MA873_L1	1231685	1231687		YPO_RS06400	2
RISE505.MA873_L1	1233179	1233180		YPO_RS06415	1
RISE505.MA873_L1	1233763	1233765		YPO_RS06415	2
RISE505.MA873_L1	1238558	1238559		YPO_RS06455	1
RISE505.MA873_L1	1241447	1241453		YPO_RS06465	6
RISE505.MA873_L1	1242159	1242168		YPO_RS06465	9
RISE505.MA873_L1	1242846	1242848		YPO_RS06470	2
RISE505.MA873_L1	1247554	1247556		bamE	2
RISE505.MA873_L1	1249619	1249620		recN	1
RISE505.MA873_L1	1264996	1264998		cydA	2
RISE505.MA873_L1	1272665	1272677		cpoB	12
RISE505.MA873_L1	1278065	1278086		aroG	21
RISE505.MA873_L1	1316638	1316642		YPO_RS06845	4
RISE505.MA873_L1	1316703	1316705		YPO_RS06845	2
RISE505.MA873_L1	1322735	1322758		YPO_RS06875	23
RISE505.MA873_L1	1331234	1331237		phnC	3
RISE505.MA873_L1	1334743	1334744		YPO_RS06940	1
RISE505.MA873_L1	1353695	1353702		YPO_RS07015	7
RISE505.MA873_L1	1366281	1366287		nrdB	6
RISE505.MA873_L1	1374208	1374217		rcsC	9
RISE505.MA873_L1	1374495	1374512		rcsC	17
RISE505.MA873_L1	1378195	1378200		rcsD	5
RISE505.MA873_L1	1391793	1391796		ycoA	3
RISE505.MA873_L1	1402477	1402481		YPO_RS07225	4
RISE505.MA873_L1	1405574	1405578		YPO_RS07235	4
RISE505.MA873_L1	1411142	1411156		YPO_RS07270	14
RISE505.MA873_L1	1412930	1412946		YPO_RS07275	16
RISE505.MA873_L1	1414251	1414268		YPO_RS07285	17
RISE505.MA873_L1	1415520	1415526		YPO_RS07290	6
RISE505.MA873_L1	1436476	1436478		YPO_RS07385	2
RISE505.MA873_L1	1448919	1448921		YPO_RS07435	2
RISE505.MA873_L1	1451807	1451808		rpiA	1
RISE505.MA873_L1	1461384	1461390		YPO_RS07485	6
RISE505.MA873_L1	1463860	1463862		YPO_RS07500	2
RISE505.MA873_L1	1467515	1467516		nfo	1
RISE505.MA873_L1	1468504	1468507		YPO_RS07515	3
RISE505.MA873_L1	1470121	1470126		YPO_RS07520	5
RISE505.MA873_L1	1474295	1474296		YPO_RS07535	1
RISE505.MA873_L1	1481759	1481760		YPO_RS07565	1
RISE505.MA873_L1	1489990	1489997		YPO_RS07595	7
RISE505.MA873_L1	1493567	1493569		YPO_RS07610	2
RISE505.MA873_L1	1505601	1505606		YPO_RS07680	5
RISE505.MA873_L1	1506456	1506465		YPO_RS07685	9
RISE505.MA873_L1	1520585	1520586		YPO_RS07770	1
RISE505.MA873_L1	1526816	1526819		YPO_RS07795	3
RISE505.MA873_L1	1529640	1529647		YPO_RS07800	7
RISE505.MA873_L1	1532996	1532997		macB	1
RISE505.MA873_L1	1533517	1533520		macB	3
RISE505.MA873_L1	1553057	1553061		serS	4
RISE505.MA873_L1	1555304	1555307		YPO_RS07890	3
RISE505.MA873_L1	1566687	1566715		YPO_RS07930	28
RISE505.MA873_L1	1566945	1566949		YPO_RS07930	4
RISE505.MA873_L1	1567751	1567753		YPO_RS07930	2
RISE505.MA873_L1	1596859	1596860		YPO_RS08035	1
RISE505.MA873_L1	1599278	1599285		ompF	7
RISE505.MA873_L1	1608130	1608134		pyrD	4
RISE505.MA873_L1	1621892	1621894		YPO_RS08130	2
RISE505.MA873_L1	1621897	1621898		YPO_RS08130	1
RISE505.MA873_L1	1631701	1631703		yccS	2
RISE505.MA873_L1	1648471	1648506		YPO_RS08265	35
RISE505.MA873_L1	1649778	1649781		YPO_RS08270	3
RISE505.MA873_L1	1653170	1653176		YPO_RS08290	6
RISE505.MA873_L1	1653351	1653360		YPO_RS08290	9
RISE505.MA873_L1	1654926	1654932		YPO_RS08305	6
RISE505.MA873_L1	1658261	1658267		tssC	6
RISE505.MA873_L1	1658413	1658416		tssC	3
RISE505.MA873_L1	1666068	1666070		YPO_RS08345	2
RISE505.MA873_L1	1666147	1666149		YPO_RS08345	2
RISE505.MA873_L1	1668164	1668177		YPO_RS08350	13
RISE505.MA873_L1	1668234	1668239		YPO_RS08350	5
RISE505.MA873_L1	1670476	1670504		YPO_RS08355	28
RISE505.MA873_L1	1670552	1670553		YPO_RS08355	1
RISE505.MA873_L1	1674058	1674059		YPO_RS08370	1
RISE505.MA873_L1	1684140	1684177		YPO_RS08400	37
RISE505.MA873_L1	1690319	1690353		YPO_RS08430	34
RISE505.MA873_L1	1690462	1690465		YPO_RS08430	3
RISE505.MA873_L1	1690617	1690624		YPO_RS08430	7
RISE505.MA873_L1	1693269	1693275		YPO_RS08440	6
RISE505.MA873_L1	1693972	1693973		YPO_RS08445	1
RISE505.MA873_L1	1694468	1694469		YPO_RS08445	1
RISE505.MA873_L1	1694530	1694539		YPO_RS08445	9
RISE505.MA873_L1	1694823	1694829		YPO_RS08445	6
RISE505.MA873_L1	1695116	1695128		YPO_RS08445	12
RISE505.MA873_L1	1700040	1700045		darC	5
RISE505.MA873_L1	1700238	1700243		darC	5
RISE505.MA873_L1	1700297	1700302		darC	5
RISE505.MA873_L1	1700415	1700421		darC	6
RISE505.MA873_L1	1700973	1700983		darC	10
RISE505.MA873_L1	1701846	1701871		darB	25
RISE505.MA873_L1	1702060	1702064		darB	4
RISE505.MA873_L1	1702216	1702228		darB	12
RISE505.MA873_L1	1714098	1714104		mglC	6
RISE505.MA873_L1	1714672	1714676		mglC	4
RISE505.MA873_L1	1718202	1718216		YPO_RS08535	14
RISE505.MA873_L1	1722848	1722850		YPO_RS08560	2
RISE505.MA873_L1	1723439	1723446		YPO_RS08560	7
RISE505.MA873_L1	1736070	1736072		asmA	2
RISE505.MA873_L1	1738397	1738409		fhuF	12
RISE505.MA873_L1	1738578	1738582		fhuF	4
RISE505.MA873_L1	1739953	1739954		YPO_RS08625	1
RISE505.MA873_L1	1743727	1743734		YPO_RS08640	7
RISE505.MA873_L1	1747092	1747095		YPO_RS08655	3
RISE505.MA873_L1	1748399	1748400		YPO_RS08660	1
RISE505.MA873_L1	1760720	1760724		hisB	4
RISE505.MA873_L1	1771588	1771592		YPO_RS08765	4
RISE505.MA873_L1	1777873	1777888		YPO_RS08795	15
RISE505.MA873_L1	1778009	1778018		YPO_RS08795	9
RISE505.MA873_L1	1778925	1778947		YPO_RS08795	22
RISE505.MA873_L1	1780701	1780713		YPO_RS08800	12
RISE505.MA873_L1	1784730	1784736		YPO_RS08810	6
RISE505.MA873_L1	1791764	1791766		YPO_RS08840	2
RISE505.MA873_L1	1792043	1792056		YPO_RS08840	13
RISE505.MA873_L1	1792212	1792223		YPO_RS08840	11
RISE505.MA873_L1	1792566	1792571		YPO_RS08840	5
RISE505.MA873_L1	1797188	1797191		YPO_RS08860	3
RISE505.MA873_L1	1801581	1801583		YPO_RS08885	2
RISE505.MA873_L1	1805922	1805927		YPO_RS08905	5
RISE505.MA873_L1	1806057	1806058		YPO_RS08905	1
RISE505.MA873_L1	1807001	1807002		YPO_RS08905	1
RISE505.MA873_L1	1807096	1807101		YPO_RS08910	5
RISE505.MA873_L1	1807150	1807154		YPO_RS08910	4
RISE505.MA873_L1	1808312	1808350		bssS	38
RISE505.MA873_L1	1811826	1811874		YPO_RS08940	48
RISE505.MA873_L1	1811929	1811941		YPO_RS08940	12
RISE505.MA873_L1	1828349	1828358		mltG	9
RISE505.MA873_L1	1842014	1842025		YPO_RS09090	11
RISE505.MA873_L1	1842528	1842532		YPO_RS09095	4
RISE505.MA873_L1	1865046	1865047		YPO_RS09185	1
RISE505.MA873_L1	1865249	1865257		YPO_RS09185	8
RISE505.MA873_L1	1874076	1874077		YPO_RS09230	1
RISE505.MA873_L1	1878157	1878170		YPO_RS09250	13
RISE505.MA873_L1	1880150	1880152		YPO_RS09260	2
RISE505.MA873_L1	1882335	1882348		YPO_RS09260	13
RISE505.MA873_L1	1899965	1899969		YPO_RS09320	4
RISE505.MA873_L1	1900892	1900894		YPO_RS09330	2
RISE505.MA873_L1	1910109	1910123		YPO_RS09350	14
RISE505.MA873_L1	1911064	1911074		YPO_RS09355	10
RISE505.MA873_L1	1915761	1915770		YPO_RS09370	9
RISE505.MA873_L1	1919938	1919940		YPO_RS09390	2
RISE505.MA873_L1	1921654	1921666		YPO_RS09395	12
RISE505.MA873_L1	1932957	1932964		YPO_RS09450	7
RISE505.MA873_L1	1933838	1933853		YPO_RS09455	15
RISE505.MA873_L1	1936617	1936618		YPO_RS09460	1
RISE505.MA873_L1	1936873	1936874		YPO_RS09465	1
RISE505.MA873_L1	1938366	1938374		YPO_RS09475	8
RISE505.MA873_L1	1940594	1940611		YPO_RS09480	17
RISE505.MA873_L1	1941227	1941229		YPO_RS09480	2
RISE505.MA873_L1	1961682	1961691		YPO_RS09560	9
RISE505.MA873_L1	1963140	1963167		YPO_RS09565	27
RISE505.MA873_L1	1963549	1963550		YPO_RS09570	1
RISE505.MA873_L1	1965216	1965217		YPO_RS09575	1
RISE505.MA873_L1	1972342	1972343		YPO_RS09610	1
RISE505.MA873_L1	1972666	1972685		YPO_RS09610	19
RISE505.MA873_L1	1973380	1973392		YPO_RS09610	12
RISE505.MA873_L1	1976641	1976653		YPO_RS09630	12
RISE505.MA873_L1	1976758	1976784		YPO_RS09630	26
RISE505.MA873_L1	1979695	1979697		YPO_RS09650	2
RISE505.MA873_L1	1985161	1985162		YPO_RS09690	1
RISE505.MA873_L1	1986956	1986970		YPO_RS09700	14
RISE505.MA873_L1	1987252	1987253		YPO_RS09700	1
RISE505.MA873_L1	1998205	1998217		YPO_RS09750	12
RISE505.MA873_L1	1999864	1999873		mntP	9
RISE505.MA873_L1	2000740	2000742		YPO_RS09760	2
RISE505.MA873_L1	2002380	2002388		YPO_RS09770	8
RISE505.MA873_L1	2004527	2004531		YPO_RS09780	4
RISE505.MA873_L1	2011852	2011853		hpaH	1
RISE505.MA873_L1	2020700	2020702		YPO_RS09855	2
RISE505.MA873_L1	2024276	2024299		YPO_RS09870	23
RISE505.MA873_L1	2036812	2036821		flhA	9
RISE505.MA873_L1	2037391	2037422		flhA	31
RISE505.MA873_L1	2044798	2044802		flgB	4
RISE505.MA873_L1	2044808	2044811		flgC	3
RISE505.MA873_L1	2048016	2048020		flgG	4
RISE505.MA873_L1	2049263	2049267		flgH	4
RISE505.MA873_L1	2058182	2058188		YPO_RS10035	6
RISE505.MA873_L1	2058960	2058971		YPO_RS10040	11
RISE505.MA873_L1	2065832	2065843		fliR	11
RISE505.MA873_L1	2067219	2067234		fliP	15
RISE505.MA873_L1	2081663	2081689		YPO_RS10170	26
RISE505.MA873_L1	2083687	2083689		YPO_RS10175	2
RISE505.MA873_L1	2102917	2102919		YPO_RS10260	2
RISE505.MA873_L1	2105007	2105015		wrbA	8
RISE505.MA873_L1	2105428	2105436		YPO_RS10275	8
RISE505.MA873_L1	2115605	2115615		YPO_RS10340	10
RISE505.MA873_L1	2117348	2117370		YPO_RS10350	22
RISE505.MA873_L1	2117695	2117725		YPO_RS10355	30
RISE505.MA873_L1	2118062	2118074		hcp	12
RISE505.MA873_L1	2118105	2118136		hcp	31
RISE505.MA873_L1	2126493	2126498		YPO_RS10415	5
RISE505.MA873_L1	2126632	2126635		YPO_RS10420	3
RISE505.MA873_L1	2136888	2136895		YPO_RS10480	7
RISE505.MA873_L1	2138780	2138781		YPO_RS10500	1
RISE505.MA873_L1	2147596	2147600		irp1	4
RISE505.MA873_L1	2176419	2176427		YPO_RS10595	8
RISE505.MA873_L1	2184899	2184915		YPO_RS10625	16
RISE505.MA873_L1	2187682	2187710		YPO_RS10640	28
RISE505.MA873_L1	2187803	2187815		YPO_RS10645	12
RISE505.MA873_L1	2188006	2188007		YPO_RS10645	1
RISE505.MA873_L1	2189010	2189011		YPO_RS10650	1
RISE505.MA873_L1	2189570	2189572		YPO_RS10650	2
RISE505.MA873_L1	2194196	2194213		YPO_RS10670	17
RISE505.MA873_L1	2195023	2195045		ansP	22
RISE505.MA873_L1	2198052	2198055		YPO_RS10685	3
RISE505.MA873_L1	2203703	2203704		YPO_RS10700	1
RISE505.MA873_L1	2203780	2203784		YPO_RS10700	4
RISE505.MA873_L1	2205154	2205155		YPO_RS10710	1
RISE505.MA873_L1	2205278	2205281		YPO_RS10710	3
RISE505.MA873_L1	2208400	2208401		YPO_RS10720	1
RISE505.MA873_L1	2211024	2211038		tehB	14
RISE505.MA873_L1	2214346	2214369		pgaA	23
RISE505.MA873_L1	2223360	2223361		chaA	1
RISE505.MA873_L1	2229136	2229145		YPO_RS10805	9
RISE505.MA873_L1	2232442	2232445		astB	3
RISE505.MA873_L1	2232626	2232627		astB	1
RISE505.MA873_L1	2237352	2237380		YPO_RS10835	28
RISE505.MA873_L1	2244066	2244074		YPO_RS10875	8
RISE505.MA873_L1	2256114	2256118		YPO_RS10925	4
RISE505.MA873_L1	2256467	2256471		YPO_RS10925	4
RISE505.MA873_L1	2257392	2257393		YPO_RS10930	1
RISE505.MA873_L1	2257904	2257910		YPO_RS10930	6
RISE505.MA873_L1	2258068	2258080		YPO_RS10930	12
RISE505.MA873_L1	2259174	2259182		YPO_RS10935	8
RISE505.MA873_L1	2266818	2266824		YPO_RS10965	6
RISE505.MA873_L1	2267645	2267658		YPO_RS10970	13
RISE505.MA873_L1	2270383	2270413		YPO_RS10980	30
RISE505.MA873_L1	2274962	2274964		YPO_RS11005	2
RISE505.MA873_L1	2276420	2276421		YPO_RS11010	1
RISE505.MA873_L1	2295335	2295342		YPO_RS11115	7
RISE505.MA873_L1	2300023	2300030		YPO_RS11135	7
RISE505.MA873_L1	2302937	2302943		YPO_RS11150	6
RISE505.MA873_L1	2307348	2307350		YPO_RS11180	2
RISE505.MA873_L1	2307753	2307764		YPO_RS11185	11
RISE505.MA873_L1	2308105	2308117		YPO_RS11185	12
RISE505.MA873_L1	2311612	2311613		mdtH	1
RISE505.MA873_L1	2315260	2315266		murJ	6
RISE505.MA873_L1	2316503	2316526		YPO_RS11220	23
RISE505.MA873_L1	2318357	2318381		YPO_RS11225	24
RISE505.MA873_L1	2322824	2322831		YPO_RS11225	7
RISE505.MA873_L1	2323891	2323892		argS	1
RISE505.MA873_L1	2327588	2327594		cmoB	6
RISE505.MA873_L1	2330460	2330468		YPO_RS11260	8
RISE505.MA873_L1	2334293	2334295		YPO_RS11275	2
RISE505.MA873_L1	2337709	2337712		znuB	3
RISE505.MA873_L1	2349117	2349123		mdtJ	6
RISE505.MA873_L1	2369702	2369709		YPO_RS11465	7
RISE505.MA873_L1	2375774	2375812		YPO_RS11515	38
RISE505.MA873_L1	2376280	2376281		YPO_RS11515	1
RISE505.MA873_L1	2376954	2376964		YPO_RS11520	10
RISE505.MA873_L1	2391805	2391811		YPO_RS11610	6
RISE505.MA873_L1	2392440	2392445		YPO_RS11610	5
RISE505.MA873_L1	2395776	2395779		YPO_RS11635	3
RISE505.MA873_L1	2398615	2398617		YPO_RS11660	2
RISE505.MA873_L1	2401717	2401719		YPO_RS11670	2
RISE505.MA873_L1	2403843	2403853		YPO_RS11680	10
RISE505.MA873_L1	2404445	2404475		YPO_RS11680	30
RISE505.MA873_L1	2406511	2406522		YPO_RS11690	11
RISE505.MA873_L1	2430216	2430217		ansA	1
RISE505.MA873_L1	2438137	2438140		xthA	3
RISE505.MA873_L1	2440708	2440721		YPO_RS11840	13
RISE505.MA873_L1	2441339	2441342		YPO_RS11850	3
RISE505.MA873_L1	2441769	2441776		YPO_RS11850	7
RISE505.MA873_L1	2442371	2442379		purU	8
RISE505.MA873_L1	2445958	2445961		rssB	3
RISE505.MA873_L1	2446461	2446470		YPO_RS11870	9
RISE505.MA873_L1	2458135	2458139		oppA	4
RISE505.MA873_L1	2458944	2458952		oppA	8
RISE505.MA873_L1	2461794	2461799		YPO_RS11920	5
RISE505.MA873_L1	2462784	2462787		YPO_RS11925	3
RISE505.MA873_L1	2463776	2463777		YPO_RS11930	1
RISE505.MA873_L1	2465352	2465356		cls	4
RISE505.MA873_L1	2465708	2465709		cls	1
RISE505.MA873_L1	2467728	2467731		YPO_RS11950	3
RISE505.MA873_L1	2467971	2467991		YPO_RS11955	20
RISE505.MA873_L1	2468350	2468352		YPO_RS11960	2
RISE505.MA873_L1	2470746	2470773		YPO_RS11975	27
RISE505.MA873_L1	2474188	2474201		YPO_RS11995	13
RISE505.MA873_L1	2474842	2474846		YPO_RS12000	4
RISE505.MA873_L1	2476575	2476579		ompW	4
RISE505.MA873_L1	2478203	2478207		trpA	4
RISE505.MA873_L1	2494985	2494989		cysB	4
RISE505.MA873_L1	2516154	2516156		nth	2
RISE505.MA873_L1	2521119	2521122		rsxC	3
RISE505.MA873_L1	2523315	2523322		rsxA	7
RISE505.MA873_L1	2535144	2535149		YPO_RS12275	5
RISE505.MA873_L1	2544725	2544730		manA	5
RISE505.MA873_L1	2547252	2547263		YPO_RS12320	11
RISE505.MA873_L1	2549508	2549513		YPO_RS12330	5
RISE505.MA873_L1	2552104	2552125		bioD	21
RISE505.MA873_L1	2552360	2552387		bioD	27
RISE505.MA873_L1	2553239	2553240		clcB	1
RISE505.MA873_L1	2554373	2554633		YPO_RS12355	260
RISE505.MA873_L1	2554658	2555065		YPO_RS12360	407
RISE505.MA873_L1	2555162	2555494		YPO_RS12365	332
RISE505.MA873_L1	2555524	2555608		YPO_RS12365	84
RISE505.MA873_L1	2555780	2556832		YPO_RS12370	1052
RISE505.MA873_L1	2556844	2557161		YPO_RS12375	317
RISE505.MA873_L1	2557164	2557415		YPO_RS12380	251
RISE505.MA873_L1	2557451	2557684		YPO_RS12385	233
RISE505.MA873_L1	2557861	2559461		YPO_RS12390	1600
RISE505.MA873_L1	2557749	2557830		YPO_RS12390	81
RISE505.MA873_L1	2559474	2559761		YPO_RS12395	287
RISE505.MA873_L1	2559765	2560790		YPO_RS12400	1025
RISE505.MA873_L1	2560790	2562034		YPO_RS12405	1244
RISE505.MA873_L1	2562123	2562371		YPO_RS12410	248
RISE505.MA873_L1	2562568	2562765		YPO_RS12415	197
RISE505.MA873_L1	2563325	2563436		YPO_RS12420	111
RISE505.MA873_L1	2564515	2564523		YPO_RS12425	8
RISE505.MA873_L1	2566334	2566342		YPO_RS12435	8
RISE505.MA873_L1	2566448	2566450		YPO_RS12435	2
RISE505.MA873_L1	2567079	2567080		YPO_RS12440	1
RISE505.MA873_L1	2568166	2568168		YPO_RS12445	2
RISE505.MA873_L1	2568219	2568223		YPO_RS12445	4
RISE505.MA873_L1	2568880	2568881		YPO_RS12445	1
RISE505.MA873_L1	2576630	2576644		YPO_RS12460	14
RISE505.MA873_L1	2577180	2577182		YPO_RS12465	2
RISE505.MA873_L1	2580057	2580065		ilvB	8
RISE505.MA873_L1	2580067	2580074		ilvN	7
RISE505.MA873_L1	2583335	2583336		YPO_RS12495	1
RISE505.MA873_L1	2594616	2594620		YPO_RS12535	4
RISE505.MA873_L1	2612255	2612259		hrpA	4
RISE505.MA873_L1	2614179	2614180		YPO_RS12615	1
RISE505.MA873_L1	2615269	2615275		YPO_RS12620	6
RISE505.MA873_L1	2622359	2622362		YPO_RS12655	3
RISE505.MA873_L1	2627867	2627868		ttcA	1
RISE505.MA873_L1	2629284	2629288		YPO_RS12675	4
RISE505.MA873_L1	2632546	2632564		YPO_RS12690	18
RISE505.MA873_L1	2632663	2632670		YPO_RS12690	7
RISE505.MA873_L1	2652213	2652228		sapF	15
RISE505.MA873_L1	2670901	2670902		eptA	1
RISE505.MA873_L1	2672160	2672162		YPO_RS12885	2
RISE505.MA873_L1	2687065	2687070		YPO_RS12955	5
RISE505.MA873_L1	2688952	2688955		YPO_RS12970	3
RISE505.MA873_L1	2694273	2694279		YPO_RS12995	6
RISE505.MA873_L1	2694629	2694636		YPO_RS13000	7
RISE505.MA873_L1	2707523	2707524		ydiK	1
RISE505.MA873_L1	2707969	2707992		rprA	23
RISE505.MA873_L1	2714924	2714925		YPO_RS13075	1
RISE505.MA873_L1	2718686	2718694		arnT	8
RISE505.MA873_L1	2719796	2719803		YPO_RS13105	7
RISE505.MA873_L1	2727790	2727793		ihfA	3
RISE505.MA873_L1	2740625	2740630		yfeC	5
RISE505.MA873_L1	2744101	2744105		YPO_RS13235	4
RISE505.MA873_L1	2746116	2746127		YPO_RS13245	11
RISE505.MA873_L1	2748562	2748576		YPO_RS13255	14
RISE505.MA873_L1	2748809	2748820		YPO_RS13255	11
RISE505.MA873_L1	2749917	2749934		YPO_RS13265	17
RISE505.MA873_L1	2750519	2750528		YPO_RS13265	9
RISE505.MA873_L1	2757060	2757079		YPO_RS13300	19
RISE505.MA873_L1	2757404	2757408		YPO_RS13305	4
RISE505.MA873_L1	2757672	2757674		YPO_RS13305	2
RISE505.MA873_L1	2758157	2758164		YPO_RS13305	7
RISE505.MA873_L1	2758340	2758341		YPO_RS13305	1
RISE505.MA873_L1	2774104	2774112		YPO_RS13360	8
RISE505.MA873_L1	2779024	2779027		YPO_RS13385	3
RISE505.MA873_L1	2782325	2782326		YPO_RS13395	1
RISE505.MA873_L1	2784092	2784113		YPO_RS13405	21
RISE505.MA873_L1	2786293	2786304		YPO_RS13425	11
RISE505.MA873_L1	2786496	2786504		YPO_RS13430	8
RISE505.MA873_L1	2790214	2790222		cdiA	8
RISE505.MA873_L1	2791897	2791898		cdiA	1
RISE505.MA873_L1	2803845	2803861		YPO_RS13470	16
RISE505.MA873_L1	2805503	2805509		YPO_RS13475	6
RISE505.MA873_L1	2814377	2814380		YPO_RS13510	3
RISE505.MA873_L1	2831179	2831183		ybiB	4
RISE505.MA873_L1	2850097	2850107		YPO_RS13670	10
RISE505.MA873_L1	2885774	2885790		YPO_RS13815	16
RISE505.MA873_L1	2886934	2886937		YPO_RS13820	3
RISE505.MA873_L1	2887054	2887932		YPO_RS13825	878
RISE505.MA873_L1	2887989	2893967		YPO_RS13830	5978
RISE505.MA873_L1	2894374	2894650		YPO_RS13835	276
RISE505.MA873_L1	2894680	2894922		YPO_RS13835	242
RISE505.MA873_L1	2895617	2896471		YPO_RS13840	854
RISE505.MA873_L1	2896777	2898099		YPO_RS13845	1322
RISE505.MA873_L1	2898136	2898303		YPO_RS13845	167
RISE505.MA873_L1	2898338	2900263		iolD	1925
RISE505.MA873_L1	2915423	2915438		YPO_RS13925	15
RISE505.MA873_L1	2922694	2922695		dacA	1
RISE505.MA873_L1	2926008	2926011		mrdA	3
RISE505.MA873_L1	2969388	2969394		YPO_RS14185	6
RISE505.MA873_L1	2974866	2974868		proV	2
RISE505.MA873_L1	2978756	2978764		nrdE	8
RISE505.MA873_L1	2979334	2979337		nrdI	3
RISE505.MA873_L1	2983140	2983141		YPO_RS14250	1
RISE505.MA873_L1	2983499	2983500		YPO_RS14250	1
RISE505.MA873_L1	2983544	2983556		YPO_RS14250	12
RISE505.MA873_L1	2999363	2999366		YPO_RS14330	3
RISE505.MA873_L1	3009996	3009999		pgm	3
RISE505.MA873_L1	3012173	3012223		YPO_RS14405	50
RISE505.MA873_L1	3012372	3012374		YPO_RS14405	2
RISE505.MA873_L1	3016423	3016439		kdpC	16
RISE505.MA873_L1	3017279	3017287		kdpB	8
RISE505.MA873_L1	3029968	3029971		YPO_RS14495	3
RISE505.MA873_L1	3030556	3030565		YPO_RS14495	9
RISE505.MA873_L1	3042810	3042816		YPO_RS14560	6
RISE505.MA873_L1	3050881	3050886		tssL	5
RISE505.MA873_L1	3053714	3053716		tssM	2
RISE505.MA873_L1	3054658	3054661		tssM	3
RISE505.MA873_L1	3056156	3056160		YPO_RS14610	4
RISE505.MA873_L1	3056362	3056363		YPO_RS14610	1
RISE505.MA873_L1	3057618	3057629		YPO_RS14610	11
RISE505.MA873_L1	3058940	3058943		YPO_RS14620	3
RISE505.MA873_L1	3060824	3060838		YPO_RS14630	14
RISE505.MA873_L1	3061126	3061133		YPO_RS14630	7
RISE505.MA873_L1	3087251	3087255		YPO_RS14770	4
RISE505.MA873_L1	3090964	3090965		fabB	1
RISE505.MA873_L1	3109982	3109983		YPO_RS14870	1
RISE505.MA873_L1	3112548	3112551		YPO_RS14885	3
RISE505.MA873_L1	3114639	3114644		yfcE	5
RISE505.MA873_L1	3117468	3117479		YPO_RS14910	11
RISE505.MA873_L1	3118087	3118106		YPO_RS14910	19
RISE505.MA873_L1	3118458	3118460		YPO_RS14910	2
RISE505.MA873_L1	3120316	3120561		YPO_RS14920	245
RISE505.MA873_L1	3121234	3121815		YPO_RS14925	581
RISE505.MA873_L1	3122083	3122484		YPO_RS14930	401
RISE505.MA873_L1	3122717	3123118		YPO_RS14935	401
RISE505.MA873_L1	3123130	3123702		YPO_RS14940	572
RISE505.MA873_L1	3123726	3123977		YPO_RS14945	251
RISE505.MA873_L1	3124016	3124255		YPO_RS14950	239
RISE505.MA873_L1	3125064	3126980		yapC	1916
RISE505.MA873_L1	3127171	3127226		YPO_RS14960	55
RISE505.MA873_L1	3127515	3128096		YPO_RS14965	581
RISE505.MA873_L1	3130158	3132365		YPO_RS14980	2207
RISE505.MA873_L1	3132358	3132888		YPO_RS14985	530
RISE505.MA873_L1	3133047	3135428		YPO_RS14990	2381
RISE505.MA873_L1	3135507	3137135		YPO_RS14995	1628
RISE505.MA873_L1	3137608	3138459		YPO_RS15000	851
RISE505.MA873_L1	3138485	3139474		YPO_RS15005	989
RISE505.MA873_L1	3139529	3140422		YPO_RS15010	893
RISE505.MA873_L1	3142684	3142989		YPO_RS15025	305
RISE505.MA873_L1	3143086	3143487		YPO_RS15030	401
RISE505.MA873_L1	3143469	3144177		YPO_RS15035	708
RISE505.MA873_L1	3145844	3145852		YPO_RS15040	8
RISE505.MA873_L1	3151967	3151970		folD	3
RISE505.MA873_L1	3168931	3168932		mgtE	1
RISE505.MA873_L1	3172037	3172044		YPO_RS15175	7
RISE505.MA873_L1	3173201	3173202		YPO_RS15180	1
RISE505.MA873_L1	3180527	3180537		YPO_RS15205	10
RISE505.MA873_L1	3188283	3188288		YPO_RS15220	5
RISE505.MA873_L1	3197993	3197995		YPO_RS15270	2
RISE505.MA873_L1	3198222	3198233		YPO_RS15270	11
RISE505.MA873_L1	3198968	3198981		YPO_RS15275	13
RISE505.MA873_L1	3199445	3199454		YPO_RS15275	9
RISE505.MA873_L1	3200228	3200253		YPO_RS15285	25
RISE505.MA873_L1	3200343	3200355		YPO_RS15285	12
RISE505.MA873_L1	3200983	3200984		YPO_RS15290	1
RISE505.MA873_L1	3201494	3201503		YPO_RS15295	9
RISE505.MA873_L1	3201676	3201697		YPO_RS15300	21
RISE505.MA873_L1	3220434	3220441		YPO_RS15385	7
RISE505.MA873_L1	3221810	3221811		YPO_RS15385	1
RISE505.MA873_L1	3221852	3221855		YPO_RS15385	3
RISE505.MA873_L1	3222338	3222345		YPO_RS15385	7
RISE505.MA873_L1	3222648	3222651		YPO_RS15385	3
RISE505.MA873_L1	3223360	3223382		yapA	22
RISE505.MA873_L1	3225496	3225530		yapA	34
RISE505.MA873_L1	3225578	3225618		yapA	40
RISE505.MA873_L1	3228586	3228591		YPO_RS15395	5
RISE505.MA873_L1	3231860	3231863		YPO_RS15405	3
RISE505.MA873_L1	3244755	3244769		YPO_RS15480	14
RISE505.MA873_L1	3246394	3246412		csiE	18
RISE505.MA873_L1	3246447	3246448		csiE	1
RISE505.MA873_L1	3262710	3262740		YPO_RS15560	30
RISE505.MA873_L1	3262830	3262837		YPO_RS15560	7
RISE505.MA873_L1	3265854	3265855		purL	1
RISE505.MA873_L1	3268380	3268381		mltF	1
RISE505.MA873_L1	3268675	3268684		mltF	9
RISE505.MA873_L1	3280149	3280156		YPO_RS15645	7
RISE505.MA873_L1	3284268	3284272		YPO_RS15665	4
RISE505.MA873_L1	3284498	3284501		YPO_RS15665	3
RISE505.MA873_L1	3285685	3285704		YPO_RS15670	19
RISE505.MA873_L1	3285805	3285812		YPO_RS15675	7
RISE505.MA873_L1	3288014	3288016		YPO_RS15680	2
RISE505.MA873_L1	3289250	3289251		tssH	1
RISE505.MA873_L1	3294991	3294992		tssG	1
RISE505.MA873_L1	3305693	3305697		YPO_RS15745	4
RISE505.MA873_L1	3307344	3307346		YPO_RS15750	2
RISE505.MA873_L1	3311474	3311475		YPO_RS15770	1
RISE505.MA873_L1	3311820	3311835		YPO_RS15770	15
RISE505.MA873_L1	3317572	3317573		YPO_RS15790	1
RISE505.MA873_L1	3319504	3319505		YPO_RS15805	1
RISE505.MA873_L1	3327537	3327553		YPO_RS15845	16
RISE505.MA873_L1	3329177	3329184		YPO_RS15855	7
RISE505.MA873_L1	3330015	3330039		YPO_RS15860	24
RISE505.MA873_L1	3331062	3331063		YPO_RS15865	1
RISE505.MA873_L1	3335907	3335908		YPO_RS15910	1
RISE505.MA873_L1	3355557	3355566		YPO_RS16000	9
RISE505.MA873_L1	3355930	3355940		YPO_RS16005	10
RISE505.MA873_L1	3356873	3356891		YPO_RS16010	18
RISE505.MA873_L1	3357813	3357819		YPO_RS16020	6
RISE505.MA873_L1	3364067	3364069		YPO_RS16040	2
RISE505.MA873_L1	3364288	3364292		YPO_RS16040	4
RISE505.MA873_L1	3382801	3382814		yapL	13
RISE505.MA873_L1	3383813	3383826		YPO_RS16125	13
RISE505.MA873_L1	3387531	3387537		maeB	6
RISE505.MA873_L1	3390255	3390258		napC	3
RISE505.MA873_L1	3395779	3395784		YPO_RS16185	5
RISE505.MA873_L1	3405497	3405530		YPO_RS16220	33
RISE505.MA873_L1	3421352	3421364		bcp	12
RISE505.MA873_L1	3434609	3434612		YPO_RS16360	3
RISE505.MA873_L1	3437807	3438248		YPO_RS16375	441
RISE505.MA873_L1	3438325	3439194		YPO_RS16380	869
RISE505.MA873_L1	3439389	3439876		YPO_RS16385	487
RISE505.MA873_L1	3445704	3445705		YPO_RS16405	1
RISE505.MA873_L1	3450524	3450532		YPO_RS16430	8
RISE505.MA873_L1	3452686	3452690		YPO_RS16435	4
RISE505.MA873_L1	3455584	3455612		cpsG	28
RISE505.MA873_L1	3457109	3457130		YPO_RS16450	21
RISE505.MA873_L1	3457133	3457139		YPO_RS16455	6
RISE505.MA873_L1	3461362	3461391		YPO_RS16470	29
RISE505.MA873_L1	3463389	3463409		YPO_RS16480	20
RISE505.MA873_L1	3463709	3463720		YPO_RS16480	11
RISE505.MA873_L1	3464869	3464873		YPO_RS16485	4
RISE505.MA873_L1	3465232	3465247		YPO_RS16485	15
RISE505.MA873_L1	3465545	3465556		YPO_RS16485	11
RISE505.MA873_L1	3465567	3465608		YPO_RS16490	41
RISE505.MA873_L1	3466524	3466559		YPO_RS16490	35
RISE505.MA873_L1	3466783	3466819		YPO_RS16490	36
RISE505.MA873_L1	3467404	3467416		YPO_RS16495	12
RISE505.MA873_L1	3486513	3486516		mscK	3
RISE505.MA873_L1	3497896	3497899		YPO_RS16630	3
RISE505.MA873_L1	3529608	3529612		cyoB	4
RISE505.MA873_L1	3531643	3531645		cyoE	2
RISE505.MA873_L1	3544707	3544712		ribE	5
RISE505.MA873_L1	3560379	3560394		YPO_RS16925	15
RISE505.MA873_L1	3560959	3560962		malZ	3
RISE505.MA873_L1	3577873	3577878		mak	5
RISE505.MA873_L1	3588358	3588360		frsA	2
RISE505.MA873_L1	3592609	3592628		YPO_RS17055	19
RISE505.MA873_L1	3592744	3592747		YPO_RS17055	3
RISE505.MA873_L1	3598382	3598389		YPO_RS17070	7
RISE505.MA873_L1	3601783	3601785		nqrF	2
RISE505.MA873_L1	3617463	3617469		YPO_RS17145	6
RISE505.MA873_L1	3620836	3620841		YPO_RS17150	5
RISE505.MA873_L1	3625256	3625258		YPO_RS17165	2
RISE505.MA873_L1	3649931	3649936		YPO_RS17290	5
RISE505.MA873_L1	3654008	3654010		YPO_RS17305	2
RISE505.MA873_L1	3654245	3654250		YPO_RS17310	5
RISE505.MA873_L1	3662691	3662693		pheA	2
RISE505.MA873_L1	3662862	3662868		YPO_RS17350	6
RISE505.MA873_L1	3664659	3664663		YPO_RS17360	4
RISE505.MA873_L1	3695600	3695602		YPO_RS17525	2
RISE505.MA873_L1	3701808	3701825		katG	17
RISE505.MA873_L1	3701943	3701978		katG	35
RISE505.MA873_L1	3704759	3704769		cybB	10
RISE505.MA873_L1	3713791	3713793		YPO_RS17600	2
RISE505.MA873_L1	3722431	3722434		YPO_RS17635	3
RISE505.MA873_L1	3725643	3725662		YPO_RS17650	19
RISE505.MA873_L1	3766705	3766706		pyrG	1
RISE505.MA873_L1	3767044	3767050		pyrG	6
RISE505.MA873_L1	3776491	3776501		dgt	10
RISE505.MA873_L1	3776650	3776653		dgt	3
RISE505.MA873_L1	3780422	3780423		erpA	1
RISE505.MA873_L1	3783718	3783719		hemL	1
RISE505.MA873_L1	3802097	3802105		YPO_RS17990	8
RISE505.MA873_L1	3805860	3805872		can	12
RISE505.MA873_L1	3807578	3807579		cueO	1
RISE505.MA873_L1	3818443	3818446		lpdA	3
RISE505.MA873_L1	3829786	3829803		ppdD	17
RISE505.MA873_L1	3837967	3837968		YPO_RS18135	1
RISE505.MA873_L1	3849844	3849847		YPO_RS18185	3
RISE505.MA873_L1	3863231	3863233		nrdG	2
RISE505.MA873_L1	3879565	3879571		YPO_RS18330	6
RISE505.MA873_L1	3910337	3910339		glmM	2
RISE505.MA873_L1	3915523	3915528		greA	5
RISE505.MA873_L1	3943155	3943156		YPO_RS18620	1
RISE505.MA873_L1	3972794	3972796		YPO_RS18755	2
RISE505.MA873_L1	3975845	3975849		rpsI	4
RISE505.MA873_L1	3982853	3982854		murA	1
RISE505.MA873_L1	3985558	3985568		mlaD	10
RISE505.MA873_L1	3986878	3986882		mlaF	4
RISE505.MA873_L1	3987798	3987808		YPO_RS18850	10
RISE505.MA873_L1	3989426	3989430		kdsD	4
RISE505.MA873_L1	3992182	3992200		lptB	18
RISE505.MA873_L1	3996845	3996847		pyrB	2
RISE505.MA873_L1	4020406	4020410		YPO_RS19010	4
RISE505.MA873_L1	4033964	4033985		YPO_RS19060	21
RISE505.MA873_L1	4034325	4034328		YPO_RS19060	3
RISE505.MA873_L1	4062862	4062864		YPO_RS19195	2
RISE505.MA873_L1	4077283	4077285		panF	2
RISE505.MA873_L1	4078622	4078631		YPO_RS19285	9
RISE505.MA873_L1	4083404	4083407		msrP	3
RISE505.MA873_L1	4087358	4087362		YPO_RS19325	4
RISE505.MA873_L1	4088927	4088928		mreC	1
RISE505.MA873_L1	4095520	4095528		YPO_RS19350	8
RISE505.MA873_L1	4100836	4100837		YPO_RS19365	1
RISE505.MA873_L1	4100967	4101042		YPO_RS19365	75
RISE505.MA873_L1	4101076	4101086		YPO_RS19365	10
RISE505.MA873_L1	4101302	4101326		YPO_RS19365	24
RISE505.MA873_L1	4101366	4101491		YPO_RS19365	125
RISE505.MA873_L1	4101516	4102146		YPO_RS19370	630
RISE505.MA873_L1	4102177	4102556		YPO_RS19370	379
RISE505.MA873_L1	4102690	4102806		YPO_RS19370	116
RISE505.MA873_L1	4102842	4102884		YPO_RS19370	42
RISE505.MA873_L1	4102932	4102944		YPO_RS19370	12
RISE505.MA873_L1	4103043	4103055		YPO_RS19370	12
RISE505.MA873_L1	4103126	4103148		YPO_RS19370	22
RISE505.MA873_L1	4103211	4103266		YPO_RS19370	55
RISE505.MA873_L1	4103437	4103441		YPO_RS19370	4
RISE505.MA873_L1	4106672	4106680		YPO_RS19390	8
RISE505.MA873_L1	4114490	4114495		YPO_RS19405	5
RISE505.MA873_L1	4117256	4117258		YPO_RS19410	2
RISE505.MA873_L1	4133223	4133225		treR	2
RISE505.MA873_L1	4142777	4142800		YPO_RS19535	23
RISE505.MA873_L1	4144284	4144285		malM	1
RISE505.MA873_L1	4156568	4156569		YPO_RS19590	1
RISE505.MA873_L1	4176213	4176223		YPO_RS19645	10
RISE505.MA873_L1	4189938	4189949		rsd	11
RISE505.MA873_L1	4213921	4213926		YPO_RS19830	5
RISE505.MA873_L1	4214211	4214218		YPO_RS19830	7
RISE505.MA873_L1	4223142	4223147		YPO_RS19870	5
RISE505.MA873_L1	4235783	4235791		hemB	8
RISE505.MA873_L1	4253272	4253282		metE	10
RISE505.MA873_L1	4265035	4265038		YPO_RS20070	3
RISE505.MA873_L1	4269655	4269669		YPO_RS20095	14
RISE505.MA873_L1	4294551	4294554		glpQ	3
RISE505.MA873_L1	4300248	4300251		rhtC	3
RISE505.MA873_L1	4320626	4320628		hemD	2
RISE505.MA873_L1	4326470	4326471		YPO_RS20380	1
RISE505.MA873_L1	4335632	4335639		rffG	7
RISE505.MA873_L1	4348567	4348576		rep	9
RISE505.MA873_L1	4351170	4351184		YPO_RS20485	14
RISE505.MA873_L1	4353374	4353375		YPO_RS20495	1
RISE505.MA873_L1	4357746	4357753		stbD	7
RISE505.MA873_L1	4360678	4360689		YPO_RS20530	11
RISE505.MA873_L1	4365981	4365982		YPO_RS20555	1
RISE505.MA873_L1	4366189	4366194		YPO_RS20560	5
RISE505.MA873_L1	4367243	4367247		YPO_RS20565	4
RISE505.MA873_L1	4367606	4367612		YPO_RS20570	6
RISE505.MA873_L1	4367832	4367840		YPO_RS20570	8
RISE505.MA873_L1	4388486	4388487		YPO_RS20670	1
RISE505.MA873_L1	4394991	4394992		YPO_RS20695	1
RISE505.MA873_L1	4402294	4402296		YPO_RS20730	2
RISE505.MA873_L1	4406218	4406219		YPO_RS20745	1
RISE505.MA873_L1	4418147	4418151		YPO_RS20775	4
RISE505.MA873_L1	4418385	4418398		YPO_RS20775	13
RISE505.MA873_L1	4420314	4420317		YPO_RS20790	3
RISE505.MA873_L1	4444005	4444020		YPO_RS20830	15
RISE505.MA873_L1	4462168	4462199		YPO_RS20935	31
RISE505.MA873_L1	4469128	4469137		uspB	9
RISE505.MA873_L1	4472981	4472984		YPO_RS20975	3
RISE505.MA873_L1	4473758	4473770		YPO_RS20975	12
RISE505.MA873_L1	4483754	4483758		YPO_RS21020	4
RISE505.MA873_L1	4484433	4484442		YPO_RS21025	9
RISE505.MA873_L1	4485100	4485110		YPO_RS21030	10
RISE505.MA873_L1	4488133	4488138		yapE	5
RISE505.MA873_L1	4491397	4491402		YPO_RS21050	5
RISE505.MA873_L1	4501711	4501713		YPO_RS21085	2
RISE505.MA873_L1	4507310	4507313		YPO_RS21105	3
RISE505.MA873_L1	4507326	4507327		YPO_RS21105	1
RISE505.MA873_L1	4508088	4508092		YPO_RS21110	4
RISE505.MA873_L1	4516014	4516032		YPO_RS21140	18
RISE505.MA873_L1	4520559	4520573		YPO_RS21160	14
RISE505.MA873_L1	4521006	4521009		YPO_RS21165	3
RISE505.MA873_L1	4521204	4521208		YPO_RS21165	4
RISE505.MA873_L1	4523525	4523533		eptB	8
RISE505.MA873_L1	4528659	4528668		YPO_RS21190	9
RISE505.MA873_L1	4528817	4528820		YPO_RS21190	3
RISE505.MA873_L1	4544914	4544934		YPO_RS21275	20
RISE505.MA873_L1	4545437	4545451		YPO_RS21280	14
RISE505.MA873_L1	4549932	4549946		YPO_RS21300	14
RISE505.MA873_L1	4555729	4555730		xylB	1
RISE505.MA873_L1	4564590	4564593		YPO_RS21355	3
RISE505.MA873_L1	4567443	4567444		YPO_RS21365	1
RISE505.MA873_L1	4571291	4571292		YPO_RS21395	1
RISE505.MA873_L1	4583374	4583378		YPO_RS21440	4
RISE505.MA873_L1	4594610	4594612		YPO_RS21490	2
RISE505.MA873_L1	4604608	4604611		YPO_RS21530	3
RISE505.MA873_L1	4620968	4620970		yidD	2
RISE505.MA873_L1	4626204	4626205		YPO_RS21630	1
RISE505.MA873_L1	4632530	4632534		YPO_RS21665	4
RISE505.MA873_L1	4633216	4633231		YPO_RS21670	15
RISE505.MA873_L1	4641428	4641430		glmU	2
RISE509.MA877.trim.fastq.mapq0.onlymapped_	409566	409575		YPO_RS02965	9
RISE509.MA877.trim.fastq.mapq0.onlymapped_	409692	409695		YPO_RS02965	3
RISE509.MA877.trim.fastq.mapq0.onlymapped_	410385	410386		YPO_RS02965	1
RISE509.MA877.trim.fastq.mapq0.onlymapped_	410580	410582		YPO_RS02965	2
RISE509.MA877.trim.fastq.mapq0.onlymapped_	410858	410889		YPO_RS02965	31
RISE509.MA877.trim.fastq.mapq0.onlymapped_	495756	495761		YPO_RS03330	5
RISE509.MA877.trim.fastq.mapq0.onlymapped_	749634	749642		YPO_RS04405	8
RISE509.MA877.trim.fastq.mapq0.onlymapped_	749634	749642		YPO_RS04410	8
RISE509.MA877.trim.fastq.mapq0.onlymapped_	750511	750532		YPO_RS04415	21
RISE509.MA877.trim.fastq.mapq0.onlymapped_	801480	801481		fliS	1
RISE509.MA877.trim.fastq.mapq0.onlymapped_	807626	807648		YPO_RS04720	22
RISE509.MA877.trim.fastq.mapq0.onlymapped_	886606	886609		YPO_RS04980	3
RISE509.MA877.trim.fastq.mapq0.onlymapped_	888929	888930		YPO_RS04990	1
RISE509.MA877.trim.fastq.mapq0.onlymapped_	908123	908125		tnpA	2
RISE509.MA877.trim.fastq.mapq0.onlymapped_	950164	950168		YPO_RS05235	4
RISE509.MA877.trim.fastq.mapq0.onlymapped_	1043955	1043962		YPO_RS05675	7
RISE509.MA877.trim.fastq.mapq0.onlymapped_	1240948	1240951		YPO_RS06465	3
RISE509.MA877.trim.fastq.mapq0.onlymapped_	1658264	1658265		tssC	1
RISE509.MA877.trim.fastq.mapq0.onlymapped_	1668237	1668238		YPO_RS08350	1
RISE509.MA877.trim.fastq.mapq0.onlymapped_	1670493	1670496		YPO_RS08355	3
RISE509.MA877.trim.fastq.mapq0.onlymapped_	1674402	1674415		YPO_RS08370	13
RISE509.MA877.trim.fastq.mapq0.onlymapped_	1684109	1684135		YPO_RS08400	26
RISE509.MA877.trim.fastq.mapq0.onlymapped_	1727099	1727103		YPO_RS08575	4
RISE509.MA877.trim.fastq.mapq0.onlymapped_	1999866	1999871		mntP	5
RISE509.MA877.trim.fastq.mapq0.onlymapped_	2000582	2000585		YPO_RS09760	3
RISE509.MA877.trim.fastq.mapq0.onlymapped_	2126499	2126508		YPO_RS10415	9
RISE509.MA877.trim.fastq.mapq0.onlymapped_	2137256	2137257		YPO_RS10480	1
RISE509.MA877.trim.fastq.mapq0.onlymapped_	2237355	2237376		YPO_RS10835	21
RISE509.MA877.trim.fastq.mapq0.onlymapped_	2259043	2259067		YPO_RS10935	24
RISE509.MA877.trim.fastq.mapq0.onlymapped_	2259169	2259173		YPO_RS10935	4
RISE509.MA877.trim.fastq.mapq0.onlymapped_	2303899	2303901		YPO_RS11155	2
RISE509.MA877.trim.fastq.mapq0.onlymapped_	2322827	2322830		YPO_RS11225	3
RISE509.MA877.trim.fastq.mapq0.onlymapped_	2475845	2475856		YPO_RS12005	11
RISE509.MA877.trim.fastq.mapq0.onlymapped_	2554373	2554633		YPO_RS12355	260
RISE509.MA877.trim.fastq.mapq0.onlymapped_	2554658	2555065		YPO_RS12360	407
RISE509.MA877.trim.fastq.mapq0.onlymapped_	2555162	2555608		YPO_RS12365	446
RISE509.MA877.trim.fastq.mapq0.onlymapped_	2555780	2556832		YPO_RS12370	1052
RISE509.MA877.trim.fastq.mapq0.onlymapped_	2556844	2557161		YPO_RS12375	317
RISE509.MA877.trim.fastq.mapq0.onlymapped_	2557164	2557415		YPO_RS12380	251
RISE509.MA877.trim.fastq.mapq0.onlymapped_	2557451	2557684		YPO_RS12385	233
RISE509.MA877.trim.fastq.mapq0.onlymapped_	2557749	2559461		YPO_RS12390	1712
RISE509.MA877.trim.fastq.mapq0.onlymapped_	2559474	2559761		YPO_RS12395	287
RISE509.MA877.trim.fastq.mapq0.onlymapped_	2559765	2560790		YPO_RS12400	1025
RISE509.MA877.trim.fastq.mapq0.onlymapped_	2560790	2562034		YPO_RS12405	1244
RISE509.MA877.trim.fastq.mapq0.onlymapped_	2562123	2562371		YPO_RS12410	248
RISE509.MA877.trim.fastq.mapq0.onlymapped_	2562568	2562765		YPO_RS12415	197
RISE509.MA877.trim.fastq.mapq0.onlymapped_	2630107	2630109		YPO_RS12680	2
RISE509.MA877.trim.fastq.mapq0.onlymapped_	2853950	2853956		YPO_RS13690	6
RISE509.MA877.trim.fastq.mapq0.onlymapped_	2854068	2854070		YPO_RS13690	2
RISE509.MA877.trim.fastq.mapq0.onlymapped_	3114644	3114647		yfcE	3
RISE509.MA877.trim.fastq.mapq0.onlymapped_	3142026	3142029		YPO_RS15020	3
RISE509.MA877.trim.fastq.mapq0.onlymapped_	3198225	3198227		YPO_RS15270	2
RISE509.MA877.trim.fastq.mapq0.onlymapped_	3200405	3200431		YPO_RS15285	26
RISE509.MA877.trim.fastq.mapq0.onlymapped_	3201152	3201166		YPO_RS15295	14
RISE509.MA877.trim.fastq.mapq0.onlymapped_	3201651	3201659		YPO_RS15300	8
RISE509.MA877.trim.fastq.mapq0.onlymapped_	3222647	3222651		YPO_RS15385	4
RISE509.MA877.trim.fastq.mapq0.onlymapped_	3262708	3262730		YPO_RS15560	22
RISE509.MA877.trim.fastq.mapq0.onlymapped_	3311454	3311461		YPO_RS15770	7
RISE509.MA877.trim.fastq.mapq0.onlymapped_	3356949	3356951		YPO_RS16010	2
RISE509.MA877.trim.fastq.mapq0.onlymapped_	3364288	3364289		YPO_RS16040	1
RISE509.MA877.trim.fastq.mapq0.onlymapped_	3461369	3461376		YPO_RS16470	7
RISE509.MA877.trim.fastq.mapq0.onlymapped_	3463784	3463799		YPO_RS16480	15
RISE509.MA877.trim.fastq.mapq0.onlymapped_	3463908	3463912		YPO_RS16480	4
RISE509.MA877.trim.fastq.mapq0.onlymapped_	3465567	3465574		YPO_RS16490	7
RISE509.MA877.trim.fastq.mapq0.onlymapped_	3467618	3467620		YPO_RS16495	2
RISE509.MA877.trim.fastq.mapq0.onlymapped_	3625259	3625261		YPO_RS17165	2
RISE509.MA877.trim.fastq.mapq0.onlymapped_	3649933	3649936		YPO_RS17290	3
RISE509.MA877.trim.fastq.mapq0.onlymapped_	4033702	4033718		YPO_RS19060	16
RISE509.MA877.trim.fastq.mapq0.onlymapped_	4176215	4176220		YPO_RS19645	5
RISE509.MA877.trim.fastq.mapq0.onlymapped_	4223144	4223145		YPO_RS19870	1
RK1001.C0101_allcombined	276	294		mioC	18
RK1001.C0101_allcombined	334	418		mioC	84
RK1001.C0101_allcombined	690	699		mioC	9
RK1001.C0101_allcombined	885	904		asnC	19
RK1001.C0101_allcombined	950	963		asnC	13
RK1001.C0101_allcombined	1206	1223		asnC	17
RK1001.C0101_allcombined	1792	1803		YPO_RS01015	11
RK1001.C0101_allcombined	2312	2316		YPO_RS01015	4
RK1001.C0101_allcombined	2573	2580		viaA	7
RK1001.C0101_allcombined	2801	2804		viaA	3
RK1001.C0101_allcombined	3996	4025		ravA	29
RK1001.C0101_allcombined	4111	4132		ravA	21
RK1001.C0101_allcombined	4606	4610		ravA	4
RK1001.C0101_allcombined	4718	4723		ravA	5
RK1001.C0101_allcombined	5153	5162		ravA	9
RK1001.C0101_allcombined	5240	5247		ravA	7
RK1001.C0101_allcombined	5450	5492		ravA	42
RK1001.C0101_allcombined	6020	6029		kup	9
RK1001.C0101_allcombined	7119	7135		kup	16
RK1001.C0101_allcombined	7585	7610		kup	25
RK1001.C0101_allcombined	7678	7682		kup	4
RK1001.C0101_allcombined	7896	7906		rbsD	10
RK1001.C0101_allcombined	8078	8094		rbsD	16
RK1001.C0101_allcombined	9782	9806		YPO_RS01055	24
RK1001.C0101_allcombined	10023	10046		YPO_RS01055	23
RK1001.C0101_allcombined	10452	10468		YPO_RS01055	16
RK1001.C0101_allcombined	10624	10640		YPO_RS01055	16
RK1001.C0101_allcombined	10676	10682		YPO_RS01055	6
RK1001.C0101_allcombined	11378	11400		YPO_RS01060	22
RK1001.C0101_allcombined	11601	11604		YPO_RS01060	3
RK1001.C0101_allcombined	11702	11705		YPO_RS01060	3
RK1001.C0101_allcombined	12931	12932		YPO_RS01070	1
RK1001.C0101_allcombined	14892	14920		YPO_RS01080	28
RK1001.C0101_allcombined	19090	19099		YPO_RS01090	9
RK1001.C0101_allcombined	19196	19208		mobB	12
RK1001.C0101_allcombined	19294	19313		mobB	19
RK1001.C0101_allcombined	19543	19564		mobB	21
RK1001.C0101_allcombined	19625	19631		mobB	6
RK1001.C0101_allcombined	19662	19680		mobB	18
RK1001.C0101_allcombined	19807	19842		mobA	35
RK1001.C0101_allcombined	19934	19941		mobA	7
RK1001.C0101_allcombined	20083	20097		mobA	14
RK1001.C0101_allcombined	20142	20146		mobA	4
RK1001.C0101_allcombined	20182	20199		mobA	17
RK1001.C0101_allcombined	20571	20572		YPO_RS01105	1
RK1001.C0101_allcombined	20711	20712		YPO_RS01105	1
RK1001.C0101_allcombined	20853	20858		YPO_RS01110	5
RK1001.C0101_allcombined	21284	21294		YPO_RS01110	10
RK1001.C0101_allcombined	21494	21544		YPO_RS01110	50
RK1001.C0101_allcombined	21806	21844		dsbA	38
RK1001.C0101_allcombined	22007	22021		dsbA	14
RK1001.C0101_allcombined	22320	22388		dsbA	68
RK1001.C0101_allcombined	22427	22429		dsbA	2
RK1001.C0101_allcombined	23321	23348		polA	27
RK1001.C0101_allcombined	23381	23387		polA	6
RK1001.C0101_allcombined	23428	23431		polA	3
RK1001.C0101_allcombined	23871	23883		polA	12
RK1001.C0101_allcombined	24011	24019		polA	8
RK1001.C0101_allcombined	24222	24240		polA	18
RK1001.C0101_allcombined	24975	24987		polA	12
RK1001.C0101_allcombined	25254	25257		polA	3
RK1001.C0101_allcombined	25291	25293		polA	2
RK1001.C0101_allcombined	25464	25475		polA	11
RK1001.C0101_allcombined	25564	25578		polA	14
RK1001.C0101_allcombined	26365	26386		YPO_RS01125	21
RK1001.C0101_allcombined	26883	26896		YPO_RS01130	13
RK1001.C0101_allcombined	28418	28439		yihI	21
RK1001.C0101_allcombined	29319	29321		hemN	2
RK1001.C0101_allcombined	29610	29628		hemN	18
RK1001.C0101_allcombined	29976	29978		hemN	2
RK1001.C0101_allcombined	31207	31233		glnG	26
RK1001.C0101_allcombined	32340	32346		glnL	6
RK1001.C0101_allcombined	32718	32720		glnL	2
RK1001.C0101_allcombined	34186	34194		glnA	8
RK1001.C0101_allcombined	34441	34478		glnA	37
RK1001.C0101_allcombined	35460	35462		typA	2
RK1001.C0101_allcombined	36125	36141		typA	16
RK1001.C0101_allcombined	36196	36211		typA	15
RK1001.C0101_allcombined	36247	36251		typA	4
RK1001.C0101_allcombined	36309	36310		typA	1
RK1001.C0101_allcombined	36887	36925		typA	38
RK1001.C0101_allcombined	37247	37276		yihX	29
RK1001.C0101_allcombined	37687	37695		yihX	8
RK1001.C0101_allcombined	37807	37823		yihX	16
RK1001.C0101_allcombined	37996	38010		YPO_RS01170	14
RK1001.C0101_allcombined	38653	38682		YPO_RS01170	29
RK1001.C0101_allcombined	38974	38979		dtd	5
RK1001.C0101_allcombined	39222	39225		dtd	3
RK1001.C0101_allcombined	42053	42059		fabY	6
RK1001.C0101_allcombined	42132	42143		fabY	11
RK1001.C0101_allcombined	42703	42774		YPO_RS01195	71
RK1001.C0101_allcombined	42988	43022		YPO_RS01195	34
RK1001.C0101_allcombined	43408	43416		YPO_RS01195	8
RK1001.C0101_allcombined	43962	43972		YPO_RS01195	10
RK1001.C0101_allcombined	44016	44028		YPO_RS01195	12
RK1001.C0101_allcombined	44331	44374		YPO_RS01200	43
RK1001.C0101_allcombined	44724	44728		YPO_RS01200	4
RK1001.C0101_allcombined	44774	44782		YPO_RS01200	8
RK1001.C0101_allcombined	44827	44839		YPO_RS01200	12
RK1001.C0101_allcombined	45084	45119		YPO_RS01200	35
RK1001.C0101_allcombined	45218	45226		YPO_RS01200	8
RK1001.C0101_allcombined	45287	45302		YPO_RS01200	15
RK1001.C0101_allcombined	45337	45375		YPO_RS01200	38
RK1001.C0101_allcombined	46279	46285		gltS	6
RK1001.C0101_allcombined	46594	46616		gltS	22
RK1001.C0101_allcombined	46729	46731		gltS	2
RK1001.C0101_allcombined	47689	47703		recG	14
RK1001.C0101_allcombined	47981	47985		recG	4
RK1001.C0101_allcombined	48133	48137		recG	4
RK1001.C0101_allcombined	48341	48365		recG	24
RK1001.C0101_allcombined	48434	48439		recG	5
RK1001.C0101_allcombined	48945	48950		recG	5
RK1001.C0101_allcombined	49060	49062		recG	2
RK1001.C0101_allcombined	49286	49292		recG	6
RK1001.C0101_allcombined	49700	49706		trmH	6
RK1001.C0101_allcombined	49955	49968		trmH	13
RK1001.C0101_allcombined	50434	50438		spoT	4
RK1001.C0101_allcombined	50647	50658		spoT	11
RK1001.C0101_allcombined	50871	50896		spoT	25
RK1001.C0101_allcombined	51235	51241		spoT	6
RK1001.C0101_allcombined	51685	51688		spoT	3
RK1001.C0101_allcombined	52166	52211		spoT	45
RK1001.C0101_allcombined	52876	52907		gmk	31
RK1001.C0101_allcombined	53787	53832		ligB	45
RK1001.C0101_allcombined	53989	54006		ligB	17
RK1001.C0101_allcombined	54214	54215		ligB	1
RK1001.C0101_allcombined	54812	54817		ligB	5
RK1001.C0101_allcombined	55179	55183		ligB	4
RK1001.C0101_allcombined	55445	55465		ligB	20
RK1001.C0101_allcombined	55955	55970		YPO_RS01245	15
RK1001.C0101_allcombined	56102	56120		YPO_RS01245	18
RK1001.C0101_allcombined	56584	56594		YPO_RS01250	10
RK1001.C0101_allcombined	56907	56912		YPO_RS01250	5
RK1001.C0101_allcombined	58827	58841		pyrE	14
RK1001.C0101_allcombined	59300	59324		slmA	24
RK1001.C0101_allcombined	59487	59494		slmA	7
RK1001.C0101_allcombined	59567	59584		slmA	17
RK1001.C0101_allcombined	59657	59659		slmA	2
RK1001.C0101_allcombined	60110	60119		dut	9
RK1001.C0101_allcombined	60492	60501		coaBC	9
RK1001.C0101_allcombined	60799	60810		coaBC	11
RK1001.C0101_allcombined	61931	61962		YPO_RS01280	31
RK1001.C0101_allcombined	62056	62106		YPO_RS01280	50
RK1001.C0101_allcombined	62985	62989		rpmG	4
RK1001.C0101_allcombined	63042	63081		rpmG	39
RK1001.C0101_allcombined	63398	63405		mutM	7
RK1001.C0101_allcombined	63550	63577		mutM	27
RK1001.C0101_allcombined	64432	64436		coaD	4
RK1001.C0101_allcombined	64556	64580		YPO_RS01310	24
RK1001.C0101_allcombined	64812	64858		YPO_RS01310	46
RK1001.C0101_allcombined	64927	64935		YPO_RS01310	8
RK1001.C0101_allcombined	65371	65384		waaA	13
RK1001.C0101_allcombined	65416	65421		waaA	5
RK1001.C0101_allcombined	65471	65481		waaA	10
RK1001.C0101_allcombined	65631	65660		waaA	29
RK1001.C0101_allcombined	65928	65952		waaA	24
RK1001.C0101_allcombined	66012	66020		waaA	8
RK1001.C0101_allcombined	66065	66076		waaA	11
RK1001.C0101_allcombined	66159	66164		waaA	5
RK1001.C0101_allcombined	66444	66445		waaA	1
RK1001.C0101_allcombined	66524	66529		waaA	5
RK1001.C0101_allcombined	67451	67474		rfaC	23
RK1001.C0101_allcombined	67642	67650		rfaC	8
RK1001.C0101_allcombined	68688	68696		rfaF	8
RK1001.C0101_allcombined	69514	69530		rfaD	16
RK1001.C0101_allcombined	69612	69664		rfaD	52
RK1001.C0101_allcombined	70456	70457		YPO_RS01335	1
RK1001.C0101_allcombined	70794	70798		YPO_RS01335	4
RK1001.C0101_allcombined	71168	71171		YPO_RS01335	3
RK1001.C0101_allcombined	71378	71398		YPO_RS01335	20
RK1001.C0101_allcombined	71408	71409		tdh	1
RK1001.C0101_allcombined	71458	71461		tdh	3
RK1001.C0101_allcombined	71691	71695		tdh	4
RK1001.C0101_allcombined	71855	71856		tdh	1
RK1001.C0101_allcombined	72247	72274		tdh	27
RK1001.C0101_allcombined	72321	72353		tdh	32
RK1001.C0101_allcombined	72430	72433		tdh	3
RK1001.C0101_allcombined	73942	73943		envC	1
RK1001.C0101_allcombined	74278	74284		envC	6
RK1001.C0101_allcombined	74615	74667		envC	52
RK1001.C0101_allcombined	74979	74980		gpmM	1
RK1001.C0101_allcombined	75053	75060		gpmM	7
RK1001.C0101_allcombined	75981	75984		gpmM	3
RK1001.C0101_allcombined	76161	76191		gpmM	30
RK1001.C0101_allcombined	76358	76370		gpmM	12
RK1001.C0101_allcombined	76948	76955		YPO_RS01360	7
RK1001.C0101_allcombined	76996	77011		YPO_RS01360	15
RK1001.C0101_allcombined	77089	77097		YPO_RS01360	8
RK1001.C0101_allcombined	77503	77504		grxC	1
RK1001.C0101_allcombined	77742	77744		secB	2
RK1001.C0101_allcombined	77899	77923		secB	24
RK1001.C0101_allcombined	78310	78315		gpsA	5
RK1001.C0101_allcombined	78961	78964		gpsA	3
RK1001.C0101_allcombined	79549	79550		cysE	1
RK1001.C0101_allcombined	80228	80259		cysE	31
RK1001.C0101_allcombined	80869	80871		trmL	2
RK1001.C0101_allcombined	80931	80935		trmL	4
RK1001.C0101_allcombined	81883	81892		ada	9
RK1001.C0101_allcombined	82313	82319		cpxA	6
RK1001.C0101_allcombined	82529	82542		cpxA	13
RK1001.C0101_allcombined	82586	82600		cpxA	14
RK1001.C0101_allcombined	84080	84094		cpxR	14
RK1001.C0101_allcombined	84575	84584		YPO_RS01405	9
RK1001.C0101_allcombined	85570	85581		YPO_RS01415	11
RK1001.C0101_allcombined	87224	87252		fieF	28
RK1001.C0101_allcombined	87523	87569		fieF	46
RK1001.C0101_allcombined	87758	87759		fieF	1
RK1001.C0101_allcombined	87862	87863		fieF	1
RK1001.C0101_allcombined	87995	88071		fieF	76
RK1001.C0101_allcombined	88289	88316		pfkA	27
RK1001.C0101_allcombined	88459	88471		pfkA	12
RK1001.C0101_allcombined	88863	88870		pfkA	7
RK1001.C0101_allcombined	89160	89208		pfkA	48
RK1001.C0101_allcombined	89493	89577		YPO_RS01435	84
RK1001.C0101_allcombined	89742	89744		YPO_RS01435	2
RK1001.C0101_allcombined	90077	90086		YPO_RS01435	9
RK1001.C0101_allcombined	90333	90338		YPO_RS01435	5
RK1001.C0101_allcombined	90441	90482		YPO_RS01435	41
RK1001.C0101_allcombined	91067	91072		YPO_RS01440	5
RK1001.C0101_allcombined	91467	91508		YPO_RS01440	41
RK1001.C0101_allcombined	92138	92140		YPO_RS01445	2
RK1001.C0101_allcombined	92204	92250		YPO_RS01445	46
RK1001.C0101_allcombined	92311	92313		YPO_RS01445	2
RK1001.C0101_allcombined	92527	92540		YPO_RS01445	13
RK1001.C0101_allcombined	92659	92673		YPO_RS01445	14
RK1001.C0101_allcombined	92815	92818		YPO_RS01445	3
RK1001.C0101_allcombined	93027	93053		YPO_RS01445	26
RK1001.C0101_allcombined	93625	93673		ligK	48
RK1001.C0101_allcombined	94017	94018		YPO_RS01455	1
RK1001.C0101_allcombined	94458	94476		YPO_RS01455	18
RK1001.C0101_allcombined	94708	94718		YPO_RS01460	10
RK1001.C0101_allcombined	95289	95292		YPO_RS01460	3
RK1001.C0101_allcombined	95558	95587		YPO_RS01460	29
RK1001.C0101_allcombined	95669	95683		YPO_RS01460	14
RK1001.C0101_allcombined	95791	95799		YPO_RS01460	8
RK1001.C0101_allcombined	96892	96904		tpiA	12
RK1001.C0101_allcombined	97312	97328		YPO_RS01470	16
RK1001.C0101_allcombined	97359	97375		YPO_RS01470	16
RK1001.C0101_allcombined	97612	97666		YPO_RS01470	54
RK1001.C0101_allcombined	98165	98173		YPO_RS01475	8
RK1001.C0101_allcombined	101539	101541		YPO_RS01495	2
RK1001.C0101_allcombined	101823	101838		YPO_RS01495	15
RK1001.C0101_allcombined	103076	103104		zapB	28
RK1001.C0101_allcombined	106570	106589		YPO_RS01520	19
RK1001.C0101_allcombined	108366	108409		YPO_RS01530	43
RK1001.C0101_allcombined	108700	108736		YPO_RS01530	36
RK1001.C0101_allcombined	108824	108837		YPO_RS01530	13
RK1001.C0101_allcombined	108992	108995		YPO_RS01530	3
RK1001.C0101_allcombined	109258	109271		YPO_RS01530	13
RK1001.C0101_allcombined	109301	109312		YPO_RS01530	11
RK1001.C0101_allcombined	109409	109418		YPO_RS01530	9
RK1001.C0101_allcombined	109459	109513		YPO_RS01530	54
RK1001.C0101_allcombined	109863	109933		YPO_RS01535	70
RK1001.C0101_allcombined	111076	111077		YPO_RS01540	1
RK1001.C0101_allcombined	111453	111472		rraA	19
RK1001.C0101_allcombined	111852	111885		rraA	33
RK1001.C0101_allcombined	112060	112068		YPO_RS01550	8
RK1001.C0101_allcombined	112143	112158		YPO_RS01550	15
RK1001.C0101_allcombined	113335	113347		hslU	12
RK1001.C0101_allcombined	114662	114674		hslV	12
RK1001.C0101_allcombined	114986	115009		hslV	23
RK1001.C0101_allcombined	115250	115251		ftsN	1
RK1001.C0101_allcombined	115340	115358		ftsN	18
RK1001.C0101_allcombined	116150	116207		cytR	57
RK1001.C0101_allcombined	116389	116455		cytR	66
RK1001.C0101_allcombined	116791	116805		cytR	14
RK1001.C0101_allcombined	116949	116992		cytR	43
RK1001.C0101_allcombined	117136	117178		cytR	42
RK1001.C0101_allcombined	117784	117835		priA	51
RK1001.C0101_allcombined	118073	118084		priA	11
RK1001.C0101_allcombined	118228	118232		priA	4
RK1001.C0101_allcombined	119422	119455		priA	33
RK1001.C0101_allcombined	120048	120053		rpmE	5
RK1001.C0101_allcombined	120868	120876		YPO_RS01585	8
RK1001.C0101_allcombined	121839	121846		metJ	7
RK1001.C0101_allcombined	123471	123485		YPO_RS01600	14
RK1001.C0101_allcombined	123777	123785		YPO_RS01600	8
RK1001.C0101_allcombined	124131	124138		YPO_RS01600	7
RK1001.C0101_allcombined	124600	124605		YPO_RS01600	5
RK1001.C0101_allcombined	126591	126620		metF	29
RK1001.C0101_allcombined	126728	126740		metF	12
RK1001.C0101_allcombined	126943	126961		metF	18
RK1001.C0101_allcombined	127515	127556		YPO_RS01610	41
RK1001.C0101_allcombined	129389	129404		YPO_RS01615	15
RK1001.C0101_allcombined	130093	130094		glpG	1
RK1001.C0101_allcombined	130252	130256		glpG	4
RK1001.C0101_allcombined	130300	130310		glpG	10
RK1001.C0101_allcombined	130433	130435		glpE	2
RK1001.C0101_allcombined	130661	130662		glpE	1
RK1001.C0101_allcombined	131551	131553		malT	2
RK1001.C0101_allcombined	131802	131810		malT	8
RK1001.C0101_allcombined	132541	132552		malT	11
RK1001.C0101_allcombined	133352	133386		malT	34
RK1001.C0101_allcombined	133556	133569		malT	13
RK1001.C0101_allcombined	133620	133622		malT	2
RK1001.C0101_allcombined	135598	135632		malP	34
RK1001.C0101_allcombined	135688	135702		malP	14
RK1001.C0101_allcombined	136263	136266		malP	3
RK1001.C0101_allcombined	136840	136851		malQ	11
RK1001.C0101_allcombined	136938	136945		malQ	7
RK1001.C0101_allcombined	137895	137902		malQ	7
RK1001.C0101_allcombined	137991	138006		malQ	15
RK1001.C0101_allcombined	138384	138401		malQ	17
RK1001.C0101_allcombined	138445	138457		malQ	12
RK1001.C0101_allcombined	138909	138925		nfuA	16
RK1001.C0101_allcombined	139598	139603		gntX	5
RK1001.C0101_allcombined	139648	139658		gntX	10
RK1001.C0101_allcombined	140735	140745		bioH	10
RK1001.C0101_allcombined	141028	141042		bioH	14
RK1001.C0101_allcombined	141314	141319		YPO_RS01665	5
RK1001.C0101_allcombined	141391	141400		YPO_RS01665	9
RK1001.C0101_allcombined	141542	141546		YPO_RS01665	4
RK1001.C0101_allcombined	141684	141722		YPO_RS01670	38
RK1001.C0101_allcombined	142060	142082		feoB	22
RK1001.C0101_allcombined	142136	142165		feoB	29
RK1001.C0101_allcombined	142295	142302		feoB	7
RK1001.C0101_allcombined	142391	142443		feoB	52
RK1001.C0101_allcombined	142520	142540		feoB	20
RK1001.C0101_allcombined	142793	142798		feoB	5
RK1001.C0101_allcombined	142909	142915		feoB	6
RK1001.C0101_allcombined	143396	143458		feoB	62
RK1001.C0101_allcombined	143837	143839		feoB	2
RK1001.C0101_allcombined	143900	143909		feoB	9
RK1001.C0101_allcombined	144384	144415		feoA	31
RK1001.C0101_allcombined	146129	146130		YPO_RS01685	1
RK1001.C0101_allcombined	147195	147235		YPO_RS01685	40
RK1001.C0101_allcombined	148709	148715		ompR	6
RK1001.C0101_allcombined	149378	149381		ompR	3
RK1001.C0101_allcombined	149680	149683		envZ	3
RK1001.C0101_allcombined	150015	150021		envZ	6
RK1001.C0101_allcombined	150742	150760		envZ	18
RK1001.C0101_allcombined	150939	150948		pckA	9
RK1001.C0101_allcombined	151411	151420		pckA	9
RK1001.C0101_allcombined	151494	151513		pckA	19
RK1001.C0101_allcombined	151659	151674		pckA	15
RK1001.C0101_allcombined	151727	151731		pckA	4
RK1001.C0101_allcombined	152469	152472		pckA	3
RK1001.C0101_allcombined	152506	152515		pckA	9
RK1001.C0101_allcombined	153218	153223		hslO	5
RK1001.C0101_allcombined	153500	153508		hslO	8
RK1001.C0101_allcombined	153948	153954		hslR	6
RK1001.C0101_allcombined	154301	154310		yrfG	9
RK1001.C0101_allcombined	155020	155023		YPO_RS01725	3
RK1001.C0101_allcombined	155061	155076		YPO_RS01725	15
RK1001.C0101_allcombined	155258	155265		YPO_RS01725	7
RK1001.C0101_allcombined	155916	155919		YPO_RS01725	3
RK1001.C0101_allcombined	156049	156060		YPO_RS01725	11
RK1001.C0101_allcombined	156214	156239		YPO_RS01725	25
RK1001.C0101_allcombined	156360	156362		YPO_RS01725	2
RK1001.C0101_allcombined	156659	156661		YPO_RS01725	2
RK1001.C0101_allcombined	156717	156720		YPO_RS01725	3
RK1001.C0101_allcombined	157113	157158		YPO_RS01725	45
RK1001.C0101_allcombined	157752	157763		nudE	11
RK1001.C0101_allcombined	157936	157948		nudE	12
RK1001.C0101_allcombined	158124	158138		nudE	14
RK1001.C0101_allcombined	158480	158495		mrcA	15
RK1001.C0101_allcombined	158596	158618		mrcA	22
RK1001.C0101_allcombined	159215	159220		mrcA	5
RK1001.C0101_allcombined	159526	159529		mrcA	3
RK1001.C0101_allcombined	159819	159831		mrcA	12
RK1001.C0101_allcombined	160125	160152		mrcA	27
RK1001.C0101_allcombined	160628	160631		mrcA	3
RK1001.C0101_allcombined	162806	162809		YPO_RS01750	3
RK1001.C0101_allcombined	162951	162952		YPO_RS01750	1
RK1001.C0101_allcombined	163361	163370		YPO_RS01755	9
RK1001.C0101_allcombined	163792	163799		hofQ	7
RK1001.C0101_allcombined	163882	163884		hofQ	2
RK1001.C0101_allcombined	164721	164733		hofQ	12
RK1001.C0101_allcombined	164868	164872		hofQ	4
RK1001.C0101_allcombined	165767	165785		aroK	18
RK1001.C0101_allcombined	165868	165911		aroK	43
RK1001.C0101_allcombined	166177	166194		aroB	17
RK1001.C0101_allcombined	166341	166350		aroB	9
RK1001.C0101_allcombined	167532	167539		YPO_RS01775	7
RK1001.C0101_allcombined	167660	167667		YPO_RS01775	7
RK1001.C0101_allcombined	167840	167848		YPO_RS01775	8
RK1001.C0101_allcombined	168645	168660		dam	15
RK1001.C0101_allcombined	168833	168851		dam	18
RK1001.C0101_allcombined	168899	168904		dam	5
RK1001.C0101_allcombined	169955	169959		rpe	4
RK1001.C0101_allcombined	170679	170684		YPO_RS01790	5
RK1001.C0101_allcombined	171072	171078		trpS	6
RK1001.C0101_allcombined	171215	171250		trpS	35
RK1001.C0101_allcombined	171418	171429		trpS	11
RK1001.C0101_allcombined	171558	171594		trpS	36
RK1001.C0101_allcombined	172395	172432		cobA	37
RK1001.C0101_allcombined	172477	172489		cobA	12
RK1001.C0101_allcombined	172954	172980		cobA	26
RK1001.C0101_allcombined	173720	173727		nirC	7
RK1001.C0101_allcombined	173776	173783		nirC	7
RK1001.C0101_allcombined	174194	174216		nirC	22
RK1001.C0101_allcombined	175239	175248		YPO_RS01815	9
RK1001.C0101_allcombined	175305	175307		YPO_RS01815	2
RK1001.C0101_allcombined	176121	176128		YPO_RS01815	7
RK1001.C0101_allcombined	176829	176831		YPO_RS01815	2
RK1001.C0101_allcombined	177377	177389		YPO_RS01815	12
RK1001.C0101_allcombined	178356	178388		YPO_RS01820	32
RK1001.C0101_allcombined	178617	178640		YPO_RS01820	23
RK1001.C0101_allcombined	178856	178871		YPO_RS01820	15
RK1001.C0101_allcombined	179259	179277		tsgA	18
RK1001.C0101_allcombined	180270	180299		tsgA	29
RK1001.C0101_allcombined	180906	180923		YPO_RS01830	17
RK1001.C0101_allcombined	181117	181124		YPO_RS01830	7
RK1001.C0101_allcombined	181317	181322		YPO_RS01830	5
RK1001.C0101_allcombined	181816	181889		YPO_RS01830	73
RK1001.C0101_allcombined	181987	181988		YPO_RS01830	1
RK1001.C0101_allcombined	182065	182066		YPO_RS01830	1
RK1001.C0101_allcombined	182410	182411		YPO_RS01830	1
RK1001.C0101_allcombined	183407	183417		YPO_RS01835	10
RK1001.C0101_allcombined	183601	183604		YPO_RS01835	3
RK1001.C0101_allcombined	183837	183896		YPO_RS01835	59
RK1001.C0101_allcombined	184302	184339		YPO_RS01840	37
RK1001.C0101_allcombined	185290	185298		YPO_RS01840	8
RK1001.C0101_allcombined	185525	185536		YPO_RS01840	11
RK1001.C0101_allcombined	185612	185615		YPO_RS01840	3
RK1001.C0101_allcombined	186138	186166		ppiA	28
RK1001.C0101_allcombined	187227	187247		YPO_RS01850	20
RK1001.C0101_allcombined	188250	188257		YPO_RS01850	7
RK1001.C0101_allcombined	188960	188964		YPO_RS01855	4
RK1001.C0101_allcombined	190137	190139		YPO_RS01865	2
RK1001.C0101_allcombined	190177	190198		YPO_RS01865	21
RK1001.C0101_allcombined	190825	190829		YPO_RS01865	4
RK1001.C0101_allcombined	193018	193077		YPO_RS01880	59
RK1001.C0101_allcombined	193195	193205		YPO_RS01880	10
RK1001.C0101_allcombined	193248	193266		YPO_RS01880	18
RK1001.C0101_allcombined	193390	193458		YPO_RS01880	68
RK1001.C0101_allcombined	193550	193578		YPO_RS01880	28
RK1001.C0101_allcombined	193656	193660		YPO_RS01880	4
RK1001.C0101_allcombined	193697	193699		YPO_RS01880	2
RK1001.C0101_allcombined	194151	194160		YPO_RS01880	9
RK1001.C0101_allcombined	194791	194795		YPO_RS01880	4
RK1001.C0101_allcombined	195163	195188		crp	25
RK1001.C0101_allcombined	195316	195318		crp	2
RK1001.C0101_allcombined	195711	195726		crp	15
RK1001.C0101_allcombined	196226	196238		YPO_RS01890	12
RK1001.C0101_allcombined	196573	196600		YPO_RS01895	27
RK1001.C0101_allcombined	196674	196680		YPO_RS01895	6
RK1001.C0101_allcombined	196760	196826		YPO_RS01895	66
RK1001.C0101_allcombined	196862	196892		YPO_RS01895	30
RK1001.C0101_allcombined	197185	197200		YPO_RS01900	15
RK1001.C0101_allcombined	197263	197272		YPO_RS01900	9
RK1001.C0101_allcombined	197597	197602		YPO_RS01900	5
RK1001.C0101_allcombined	197754	197767		YPO_RS01900	13
RK1001.C0101_allcombined	198277	198293		YPO_RS01905	16
RK1001.C0101_allcombined	198784	198804		YPO_RS01910	20
RK1001.C0101_allcombined	198998	199033		YPO_RS01910	35
RK1001.C0101_allcombined	199588	199591		YPO_RS01915	3
RK1001.C0101_allcombined	199633	199641		YPO_RS01915	8
RK1001.C0101_allcombined	200009	200011		YPO_RS01915	2
RK1001.C0101_allcombined	200677	200698		tauA	21
RK1001.C0101_allcombined	201179	201205		tauA	26
RK1001.C0101_allcombined	201669	201673		tauB	4
RK1001.C0101_allcombined	201796	201798		tauB	2
RK1001.C0101_allcombined	202071	202089		tauB	18
RK1001.C0101_allcombined	203571	203574		tauD	3
RK1001.C0101_allcombined	203635	203650		tauD	15
RK1001.C0101_allcombined	204370	204386		YPO_RS01940	16
RK1001.C0101_allcombined	204701	204707		YPO_RS01940	6
RK1001.C0101_allcombined	205736	205786		YPO_RS01945	50
RK1001.C0101_allcombined	208318	208339		kefG	21
RK1001.C0101_allcombined	208388	208439		kefG	51
RK1001.C0101_allcombined	208885	208890		kefB	5
RK1001.C0101_allcombined	209308	209309		kefB	1
RK1001.C0101_allcombined	209653	209654		kefB	1
RK1001.C0101_allcombined	210609	210616		YPO_RS01965	7
RK1001.C0101_allcombined	212368	212381		fkpA	13
RK1001.C0101_allcombined	212516	212562		fkpA	46
RK1001.C0101_allcombined	212705	212711		fkpA	6
RK1001.C0101_allcombined	213586	213594		YPO_RS01985	8
RK1001.C0101_allcombined	213939	213940		YPO_RS01985	1
RK1001.C0101_allcombined	214071	214081		tusD	10
RK1001.C0101_allcombined	214378	214387		tusD	9
RK1001.C0101_allcombined	214637	214690		tusC	53
RK1001.C0101_allcombined	214975	214994		tusB	19
RK1001.C0101_allcombined	215358	215390		rpsL	32
RK1001.C0101_allcombined	215560	215571		rpsL	11
RK1001.C0101_allcombined	215763	215777		rpsG	14
RK1001.C0101_allcombined	216378	216383		fusA	5
RK1001.C0101_allcombined	216479	216495		fusA	16
RK1001.C0101_allcombined	217474	217481		fusA	7
RK1001.C0101_allcombined	217863	217865		fusA	2
RK1001.C0101_allcombined	218462	218530		tuf	68
RK1001.C0101_allcombined	218594	218600		tuf	6
RK1001.C0101_allcombined	218862	218870		tuf	8
RK1001.C0101_allcombined	219210	219211		tuf	1
RK1001.C0101_allcombined	220495	220520		bfd	25
RK1001.C0101_allcombined	220768	220779		bfr	11
RK1001.C0101_allcombined	220987	220993		bfr	6
RK1001.C0101_allcombined	221089	221157		bfr	68
RK1001.C0101_allcombined	223811	223821		rplB	10
RK1001.C0101_allcombined	223957	223991		rplB	34
RK1001.C0101_allcombined	224368	224379		rplB	11
RK1001.C0101_allcombined	224902	224917		rplV	15
RK1001.C0101_allcombined	225048	225108		rpsC	60
RK1001.C0101_allcombined	225422	225428		rpsC	6
RK1001.C0101_allcombined	225609	225629		rpsC	20
RK1001.C0101_allcombined	226446	226451		rpsQ	5
RK1001.C0101_allcombined	227150	227162		rplN	12
RK1001.C0101_allcombined	227429	227448		rplX	19
RK1001.C0101_allcombined	227767	227776		rplE	9
RK1001.C0101_allcombined	227961	227977		rplE	16
RK1001.C0101_allcombined	228403	228412		rpsH	9
RK1001.C0101_allcombined	228472	228479		rpsH	7
RK1001.C0101_allcombined	228924	228927		rplF	3
RK1001.C0101_allcombined	229015	229035		rplF	20
RK1001.C0101_allcombined	229658	229663		rplR	5
RK1001.C0101_allcombined	229773	229782		rpsE	9
RK1001.C0101_allcombined	229968	229969		rpsE	1
RK1001.C0101_allcombined	230022	230023		rpsE	1
RK1001.C0101_allcombined	230217	230219		rpsE	2
RK1001.C0101_allcombined	230222	230245		rpmD	23
RK1001.C0101_allcombined	230284	230300		rpmD	16
RK1001.C0101_allcombined	230348	230401		rpmD	53
RK1001.C0101_allcombined	230405	230406		rplO	1
RK1001.C0101_allcombined	231138	231150		secY	12
RK1001.C0101_allcombined	231523	231529		secY	6
RK1001.C0101_allcombined	231579	231614		secY	35
RK1001.C0101_allcombined	231729	231733		secY	4
RK1001.C0101_allcombined	231810	231838		secY	28
RK1001.C0101_allcombined	232063	232071		secY	8
RK1001.C0101_allcombined	232272	232280		rpmJ	8
RK1001.C0101_allcombined	232507	232509		rpsM	2
RK1001.C0101_allcombined	232716	232722		rpsM	6
RK1001.C0101_allcombined	232792	232795		rpsM	3
RK1001.C0101_allcombined	232890	232904		rpsK	14
RK1001.C0101_allcombined	234099	234113		rpoA	14
RK1001.C0101_allcombined	234721	234757		rpoA	36
RK1001.C0101_allcombined	236173	236206		zntR	33
RK1001.C0101_allcombined	236348	236361		YPO_RS02185	13
RK1001.C0101_allcombined	236466	236494		YPO_RS02185	28
RK1001.C0101_allcombined	236753	236792		mscL	39
RK1001.C0101_allcombined	237233	237256		trkA	23
RK1001.C0101_allcombined	237591	237592		trkA	1
RK1001.C0101_allcombined	237641	237683		trkA	42
RK1001.C0101_allcombined	237922	237923		trkA	1
RK1001.C0101_allcombined	238026	238037		trkA	11
RK1001.C0101_allcombined	238110	238144		trkA	34
RK1001.C0101_allcombined	238368	238374		trkA	6
RK1001.C0101_allcombined	238531	238532		trkA	1
RK1001.C0101_allcombined	238829	238834		rsmB	5
RK1001.C0101_allcombined	239102	239113		rsmB	11
RK1001.C0101_allcombined	239264	239300		rsmB	36
RK1001.C0101_allcombined	239532	239535		rsmB	3
RK1001.C0101_allcombined	239979	239995		fmt	16
RK1001.C0101_allcombined	240424	240426		fmt	2
RK1001.C0101_allcombined	240472	240478		fmt	6
RK1001.C0101_allcombined	240629	240635		fmt	6
RK1001.C0101_allcombined	240705	240710		fmt	5
RK1001.C0101_allcombined	241234	241267		def	33
RK1001.C0101_allcombined	241446	241455		def	9
RK1001.C0101_allcombined	242079	242097		dprA	18
RK1001.C0101_allcombined	242773	242794		YPO_RS02220	21
RK1001.C0101_allcombined	242843	242844		YPO_RS02220	1
RK1001.C0101_allcombined	242984	242985		YPO_RS02220	1
RK1001.C0101_allcombined	243060	243065		YPO_RS02220	5
RK1001.C0101_allcombined	243108	243109		YPO_RS02220	1
RK1001.C0101_allcombined	243197	243251		YPO_RS02225	54
RK1001.C0101_allcombined	243668	243684		YPO_RS02225	16
RK1001.C0101_allcombined	243911	243964		tsaC	53
RK1001.C0101_allcombined	244339	244361		aroE	22
RK1001.C0101_allcombined	244457	244459		aroE	2
RK1001.C0101_allcombined	244547	244564		aroE	17
RK1001.C0101_allcombined	244626	244631		aroE	5
RK1001.C0101_allcombined	244671	244679		aroE	8
RK1001.C0101_allcombined	244926	244971		aroE	45
RK1001.C0101_allcombined	245129	245130		aroE	1
RK1001.C0101_allcombined	245369	245422		YPO_RS02240	53
RK1001.C0101_allcombined	245539	245574		YPO_RS02240	35
RK1001.C0101_allcombined	245647	245654		YPO_RS02240	7
RK1001.C0101_allcombined	247537	247547		YPO_RS02250	10
RK1001.C0101_allcombined	247680	247713		YPO_RS02255	33
RK1001.C0101_allcombined	248049	248064		YPO_RS02255	15
RK1001.C0101_allcombined	248285	248288		YPO_RS02255	3
RK1001.C0101_allcombined	249863	249866		actP	3
RK1001.C0101_allcombined	250204	250216		actP	12
RK1001.C0101_allcombined	251147	251155		acs	8
RK1001.C0101_allcombined	251341	251356		acs	15
RK1001.C0101_allcombined	251870	251896		acs	26
RK1001.C0101_allcombined	252020	252022		acs	2
RK1001.C0101_allcombined	252391	252392		acs	1
RK1001.C0101_allcombined	252513	252521		acs	8
RK1001.C0101_allcombined	253545	253553		gltP	8
RK1001.C0101_allcombined	253608	253706		gltP	98
RK1001.C0101_allcombined	253916	253919		gltP	3
RK1001.C0101_allcombined	253960	253961		gltP	1
RK1001.C0101_allcombined	254147	254149		gltP	2
RK1001.C0101_allcombined	254607	254623		gltP	16
RK1001.C0101_allcombined	255039	255071		YPO_RS02280	32
RK1001.C0101_allcombined	255178	255190		YPO_RS02280	12
RK1001.C0101_allcombined	255243	255253		YPO_RS02280	10
RK1001.C0101_allcombined	255495	255505		YPO_RS02280	10
RK1001.C0101_allcombined	255659	255671		YPO_RS02280	12
RK1001.C0101_allcombined	255684	255693		YPO_RS02285	9
RK1001.C0101_allcombined	256485	256513		YPO_RS02285	28
RK1001.C0101_allcombined	256786	256787		YPO_RS02285	1
RK1001.C0101_allcombined	256948	256962		YPO_RS02285	14
RK1001.C0101_allcombined	257082	257090		YPO_RS02285	8
RK1001.C0101_allcombined	257221	257223		YPO_RS02285	2
RK1001.C0101_allcombined	257341	257393		YPO_RS02285	52
RK1001.C0101_allcombined	257825	257842		YPO_RS02285	17
RK1001.C0101_allcombined	258060	258065		YPO_RS02285	5
RK1001.C0101_allcombined	258192	258221		YPO_RS02285	29
RK1001.C0101_allcombined	258486	258503		YPO_RS02285	17
RK1001.C0101_allcombined	258747	258813		YPO_RS02290	66
RK1001.C0101_allcombined	258983	259045		YPO_RS02290	62
RK1001.C0101_allcombined	259169	259211		YPO_RS02290	42
RK1001.C0101_allcombined	259562	259586		YPO_RS02290	24
RK1001.C0101_allcombined	259931	259946		YPO_RS02290	15
RK1001.C0101_allcombined	260170	260181		YPO_RS02290	11
RK1001.C0101_allcombined	260277	260284		sctD	7
RK1001.C0101_allcombined	260340	260342		sctD	2
RK1001.C0101_allcombined	260981	260983		sctD	2
RK1001.C0101_allcombined	261406	261453		sctD	47
RK1001.C0101_allcombined	261517	261520		YPO_RS02300	3
RK1001.C0101_allcombined	261662	261702		YPO_RS02300	40
RK1001.C0101_allcombined	262611	262621		sctF	10
RK1001.C0101_allcombined	263968	263973		YPO_RS02325	5
RK1001.C0101_allcombined	264998	265002		sctL	4
RK1001.C0101_allcombined	266022	266043		YPO_RS02340	21
RK1001.C0101_allcombined	266295	266298		YPO_RS02340	3
RK1001.C0101_allcombined	266498	266503		YPO_RS02340	5
RK1001.C0101_allcombined	266542	266544		YPO_RS02340	2
RK1001.C0101_allcombined	267261	267285		YPO_RS02340	24
RK1001.C0101_allcombined	267827	267837		YPO_RS02345	10
RK1001.C0101_allcombined	268437	268445		YPO_RS02345	8
RK1001.C0101_allcombined	269364	269365		YPO_RS02355	1
RK1001.C0101_allcombined	270173	270180		YPO_RS02360	7
RK1001.C0101_allcombined	270288	270308		YPO_RS02360	20
RK1001.C0101_allcombined	270348	270359		YPO_RS02360	11
RK1001.C0101_allcombined	271221	271224		sctR	3
RK1001.C0101_allcombined	271316	271337		YPO_RS02370	21
RK1001.C0101_allcombined	271929	271940		sctT	11
RK1001.C0101_allcombined	271998	272006		sctT	8
RK1001.C0101_allcombined	272379	272396		sctT	17
RK1001.C0101_allcombined	272390	272396		YPO_RS02380	6
RK1001.C0101_allcombined	272447	272464		YPO_RS02380	17
RK1001.C0101_allcombined	272939	272949		YPO_RS02380	10
RK1001.C0101_allcombined	273440	273451		YPO_RS02380	11
RK1001.C0101_allcombined	273961	273987		yedE	26
RK1001.C0101_allcombined	274078	274087		yedE	9
RK1001.C0101_allcombined	274585	274606		yedE	21
RK1001.C0101_allcombined	274954	274960		yedE	6
RK1001.C0101_allcombined	275484	275601		YPO_RS02395	117
RK1001.C0101_allcombined	275825	275902		YPO_RS02395	77
RK1001.C0101_allcombined	275934	276015		YPO_RS02395	81
RK1001.C0101_allcombined	276060	276082		YPO_RS02395	22
RK1001.C0101_allcombined	276242	276285		YPO_RS02395	43
RK1001.C0101_allcombined	276326	276339		YPO_RS02395	13
RK1001.C0101_allcombined	276374	276381		YPO_RS02395	7
RK1001.C0101_allcombined	276551	276615		YPO_RS02400	64
RK1001.C0101_allcombined	276651	276702		YPO_RS02400	51
RK1001.C0101_allcombined	276748	276760		YPO_RS02400	12
RK1001.C0101_allcombined	276793	276835		YPO_RS02400	42
RK1001.C0101_allcombined	276912	276951		YPO_RS02400	39
RK1001.C0101_allcombined	276986	276988		YPO_RS02400	2
RK1001.C0101_allcombined	277038	277075		YPO_RS02400	37
RK1001.C0101_allcombined	277173	277179		YPO_RS02400	6
RK1001.C0101_allcombined	277536	277563		YPO_RS02400	27
RK1001.C0101_allcombined	277721	277766		YPO_RS02400	45
RK1001.C0101_allcombined	277892	277921		metC	29
RK1001.C0101_allcombined	278057	278070		metC	13
RK1001.C0101_allcombined	278196	278242		metC	46
RK1001.C0101_allcombined	278277	278284		metC	7
RK1001.C0101_allcombined	278652	278653		metC	1
RK1001.C0101_allcombined	278805	278813		metC	8
RK1001.C0101_allcombined	278892	278923		metC	31
RK1001.C0101_allcombined	279366	279371		YPO_RS02410	5
RK1001.C0101_allcombined	279810	279827		YPO_RS02410	17
RK1001.C0101_allcombined	279959	279977		YPO_RS02410	18
RK1001.C0101_allcombined	280116	280130		YPO_RS02415	14
RK1001.C0101_allcombined	280198	280209		YPO_RS02415	11
RK1001.C0101_allcombined	281138	281141		YPO_RS02420	3
RK1001.C0101_allcombined	282044	282074		YPO_RS02425	30
RK1001.C0101_allcombined	282428	282441		YPO_RS02425	13
RK1001.C0101_allcombined	283038	283081		YPO_RS02430	43
RK1001.C0101_allcombined	283316	283337		YPO_RS02430	21
RK1001.C0101_allcombined	283415	283426		YPO_RS02430	11
RK1001.C0101_allcombined	283825	283836		YPO_RS02430	11
RK1001.C0101_allcombined	283927	283936		YPO_RS02430	9
RK1001.C0101_allcombined	284187	284191		YPO_RS02430	4
RK1001.C0101_allcombined	284391	284395		YPO_RS02430	4
RK1001.C0101_allcombined	284884	284894		YPO_RS02430	10
RK1001.C0101_allcombined	285449	285478		YPO_RS02440	29
RK1001.C0101_allcombined	285734	285743		YPO_RS02440	9
RK1001.C0101_allcombined	286128	286139		hutX	11
RK1001.C0101_allcombined	286680	286684		YPO_RS02450	4
RK1001.C0101_allcombined	286805	286824		YPO_RS02450	19
RK1001.C0101_allcombined	287005	287008		YPO_RS02450	3
RK1001.C0101_allcombined	287635	287666		YPO_RS02450	31
RK1001.C0101_allcombined	287771	287784		YPO_RS02450	13
RK1001.C0101_allcombined	288333	288400		YPO_RS02455	67
RK1001.C0101_allcombined	288482	288500		YPO_RS02455	18
RK1001.C0101_allcombined	288695	288716		YPO_RS02455	21
RK1001.C0101_allcombined	288866	288935		YPO_RS02455	69
RK1001.C0101_allcombined	288971	289049		YPO_RS02455	78
RK1001.C0101_allcombined	289567	289574		YPO_RS02460	7
RK1001.C0101_allcombined	289799	289801		YPO_RS02460	2
RK1001.C0101_allcombined	290934	290941		YPO_RS02465	7
RK1001.C0101_allcombined	291166	291180		YPO_RS02465	14
RK1001.C0101_allcombined	291519	291545		YPO_RS02470	26
RK1001.C0101_allcombined	291693	291699		YPO_RS02470	6
RK1001.C0101_allcombined	291841	291842		YPO_RS02470	1
RK1001.C0101_allcombined	292364	292386		YPO_RS02475	22
RK1001.C0101_allcombined	292600	292613		YPO_RS02475	13
RK1001.C0101_allcombined	292676	292697		YPO_RS02475	21
RK1001.C0101_allcombined	293172	293185		YPO_RS02480	13
RK1001.C0101_allcombined	293215	293219		YPO_RS02480	4
RK1001.C0101_allcombined	293291	293308		YPO_RS02480	17
RK1001.C0101_allcombined	293472	293476		YPO_RS02480	4
RK1001.C0101_allcombined	293614	293647		YPO_RS02480	33
RK1001.C0101_allcombined	294584	294588		YPO_RS02485	4
RK1001.C0101_allcombined	294857	294884		YPO_RS02485	27
RK1001.C0101_allcombined	295298	295306		YPO_RS02485	8
RK1001.C0101_allcombined	295356	295361		YPO_RS02485	5
RK1001.C0101_allcombined	297189	297213		YPO_RS02495	24
RK1001.C0101_allcombined	297650	297679		YPO_RS02500	29
RK1001.C0101_allcombined	298143	298152		YPO_RS02505	9
RK1001.C0101_allcombined	299053	299056		YPO_RS02510	3
RK1001.C0101_allcombined	299981	300003		YPO_RS02515	22
RK1001.C0101_allcombined	300345	300360		YPO_RS02515	15
RK1001.C0101_allcombined	301799	301847		YPO_RS02525	48
RK1001.C0101_allcombined	301964	301985		YPO_RS02525	21
RK1001.C0101_allcombined	302123	302130		YPO_RS02525	7
RK1001.C0101_allcombined	302400	302424		YPO_RS02525	24
RK1001.C0101_allcombined	302895	302902		YPO_RS02530	7
RK1001.C0101_allcombined	302953	302981		YPO_RS02530	28
RK1001.C0101_allcombined	303233	303280		YPO_RS02530	47
RK1001.C0101_allcombined	303552	303560		YPO_RS02530	8
RK1001.C0101_allcombined	304334	304351		YPO_RS02530	17
RK1001.C0101_allcombined	305031	305053		YPO_RS02530	22
RK1001.C0101_allcombined	305125	305141		YPO_RS02535	16
RK1001.C0101_allcombined	305176	305226		YPO_RS02535	50
RK1001.C0101_allcombined	305423	305426		YPO_RS02535	3
RK1001.C0101_allcombined	305781	305785		YPO_RS02535	4
RK1001.C0101_allcombined	305921	305944		YPO_RS02540	23
RK1001.C0101_allcombined	306010	306050		YPO_RS02540	40
RK1001.C0101_allcombined	307463	307488		YPO_RS02550	25
RK1001.C0101_allcombined	307675	307682		YPO_RS02550	7
RK1001.C0101_allcombined	308315	308322		YPO_RS02550	7
RK1001.C0101_allcombined	309654	309687		YPO_RS02555	33
RK1001.C0101_allcombined	309731	309734		YPO_RS02555	3
RK1001.C0101_allcombined	309849	309855		YPO_RS02555	6
RK1001.C0101_allcombined	311045	311046		YPO_RS02555	1
RK1001.C0101_allcombined	311259	311270		YPO_RS02555	11
RK1001.C0101_allcombined	311509	311540		YPO_RS02555	31
RK1001.C0101_allcombined	311611	311622		YPO_RS02555	11
RK1001.C0101_allcombined	314317	314322		yapK	5
RK1001.C0101_allcombined	314387	314472		yapK	85
RK1001.C0101_allcombined	314751	314766		yapK	15
RK1001.C0101_allcombined	315032	315133		yapK	101
RK1001.C0101_allcombined	315257	315270		yapK	13
RK1001.C0101_allcombined	315649	315653		yapK	4
RK1001.C0101_allcombined	317712	317733		ubiA	21
RK1001.C0101_allcombined	317951	317974		ubiA	23
RK1001.C0101_allcombined	318450	318451		plsB	1
RK1001.C0101_allcombined	319051	319072		plsB	21
RK1001.C0101_allcombined	319469	319478		plsB	9
RK1001.C0101_allcombined	319657	319669		plsB	12
RK1001.C0101_allcombined	319959	319968		plsB	9
RK1001.C0101_allcombined	320293	320299		plsB	6
RK1001.C0101_allcombined	320456	320459		plsB	3
RK1001.C0101_allcombined	320558	320571		plsB	13
RK1001.C0101_allcombined	320835	320882		plsB	47
RK1001.C0101_allcombined	321279	321282		YPO_RS02580	3
RK1001.C0101_allcombined	321878	321902		lexA	24
RK1001.C0101_allcombined	321991	322020		lexA	29
RK1001.C0101_allcombined	322138	322142		lexA	4
RK1001.C0101_allcombined	322302	322332		zur	30
RK1001.C0101_allcombined	322389	322412		zur	23
RK1001.C0101_allcombined	323281	323305		dusA	24
RK1001.C0101_allcombined	323488	323503		dusA	15
RK1001.C0101_allcombined	324036	324044		dusA	8
RK1001.C0101_allcombined	324619	324672		pspG	53
RK1001.C0101_allcombined	325644	325658		YPO_RS02605	14
RK1001.C0101_allcombined	325887	325900		YPO_RS02605	13
RK1001.C0101_allcombined	326045	326048		YPO_RS02605	3
RK1001.C0101_allcombined	326141	326142		YPO_RS02605	1
RK1001.C0101_allcombined	326929	326950		dnaB	21
RK1001.C0101_allcombined	327119	327124		dnaB	5
RK1001.C0101_allcombined	327155	327166		dnaB	11
RK1001.C0101_allcombined	327745	327756		dnaB	11
RK1001.C0101_allcombined	328135	328172		alr	37
RK1001.C0101_allcombined	328825	328844		alr	19
RK1001.C0101_allcombined	329042	329050		alr	8
RK1001.C0101_allcombined	329287	329298		YPO_RS02620	11
RK1001.C0101_allcombined	329840	329841		YPO_RS02620	1
RK1001.C0101_allcombined	329957	329958		YPO_RS02620	1
RK1001.C0101_allcombined	330060	330069		YPO_RS02620	9
RK1001.C0101_allcombined	330985	330986		YPO_RS02625	1
RK1001.C0101_allcombined	331935	331981		uvrA	46
RK1001.C0101_allcombined	332027	332050		uvrA	23
RK1001.C0101_allcombined	332999	333003		uvrA	4
RK1001.C0101_allcombined	333149	333165		uvrA	16
RK1001.C0101_allcombined	333197	333201		uvrA	4
RK1001.C0101_allcombined	333332	333345		uvrA	13
RK1001.C0101_allcombined	333556	333571		uvrA	15
RK1001.C0101_allcombined	334009	334014		uvrA	5
RK1001.C0101_allcombined	334844	334846		ssb1	2
RK1001.C0101_allcombined	334894	334897		ssb1	3
RK1001.C0101_allcombined	335054	335095		ssb1	41
RK1001.C0101_allcombined	335582	335586		rhaM	4
RK1001.C0101_allcombined	336918	336925		fucO	7
RK1001.C0101_allcombined	337550	337560		rhaD	10
RK1001.C0101_allcombined	337826	337886		rhaD	60
RK1001.C0101_allcombined	338541	338553		YPO_RS02655	12
RK1001.C0101_allcombined	338742	338747		YPO_RS02655	5
RK1001.C0101_allcombined	339064	339066		YPO_RS02655	2
RK1001.C0101_allcombined	339155	339161		YPO_RS02655	6
RK1001.C0101_allcombined	339738	339746		rhaB	8
RK1001.C0101_allcombined	340401	340435		rhaB	34
RK1001.C0101_allcombined	341058	341069		rhaS	11
RK1001.C0101_allcombined	342158	342162		rhaR	4
RK1001.C0101_allcombined	342490	342496		rhaR	6
RK1001.C0101_allcombined	342807	342818		rhaR	11
RK1001.C0101_allcombined	343096	343097		rhaT	1
RK1001.C0101_allcombined	343247	343288		rhaT	41
RK1001.C0101_allcombined	343726	343762		rhaT	36
RK1001.C0101_allcombined	343838	343846		rhaT	8
RK1001.C0101_allcombined	344047	344052		rhaT	5
RK1001.C0101_allcombined	345114	345137		YPO_RS02690	23
RK1001.C0101_allcombined	345822	345850		YPO_RS02695	28
RK1001.C0101_allcombined	345912	346046		YPO_RS02695	134
RK1001.C0101_allcombined	346129	346142		YPO_RS02695	13
RK1001.C0101_allcombined	346559	346581		YPO_RS02695	22
RK1001.C0101_allcombined	346673	346697		YPO_RS02695	24
RK1001.C0101_allcombined	346728	346802		YPO_RS02695	74
RK1001.C0101_allcombined	346887	346947		YPO_RS02695	60
RK1001.C0101_allcombined	347050	347078		YPO_RS02695	28
RK1001.C0101_allcombined	347154	347276		YPO_RS02695	122
RK1001.C0101_allcombined	347357	347536		YPO_RS02695	179
RK1001.C0101_allcombined	347566	347620		YPO_RS02695	54
RK1001.C0101_allcombined	347666	347692		YPO_RS02695	26
RK1001.C0101_allcombined	347867	348041		YPO_RS02695	174
RK1001.C0101_allcombined	348159	348231		YPO_RS02695	72
RK1001.C0101_allcombined	350055	350078		aegA	23
RK1001.C0101_allcombined	350205	350208		aegA	3
RK1001.C0101_allcombined	350385	350410		aegA	25
RK1001.C0101_allcombined	352491	352492		YPO_RS02715	1
RK1001.C0101_allcombined	352589	352609		fdhF	20
RK1001.C0101_allcombined	353153	353204		fdhF	51
RK1001.C0101_allcombined	353763	353769		fdhF	6
RK1001.C0101_allcombined	354181	354197		fdhF	16
RK1001.C0101_allcombined	354927	354932		YPO_RS02725	5
RK1001.C0101_allcombined	355131	355142		YPO_RS02725	11
RK1001.C0101_allcombined	355585	355612		YPO_RS02725	27
RK1001.C0101_allcombined	355840	355882		YPO_RS02725	42
RK1001.C0101_allcombined	356699	356722		cutA	23
RK1001.C0101_allcombined	357380	357383		YPO_RS02735	3
RK1001.C0101_allcombined	357786	357795		YPO_RS02735	9
RK1001.C0101_allcombined	358112	358113		YPO_RS02735	1
RK1001.C0101_allcombined	358405	358406		YPO_RS02735	1
RK1001.C0101_allcombined	359488	359491		aspA	3
RK1001.C0101_allcombined	359572	359575		aspA	3
RK1001.C0101_allcombined	359633	359648		aspA	15
RK1001.C0101_allcombined	359735	359737		aspA	2
RK1001.C0101_allcombined	359940	359962		aspA	22
RK1001.C0101_allcombined	360974	360988		fxsA	14
RK1001.C0101_allcombined	360443	360451		fxsA	8
RK1001.C0101_allcombined	363142	363143		groL	1
RK1001.C0101_allcombined	363907	363914		YPO_RS02760	7
RK1001.C0101_allcombined	365066	365072		epmB	6
RK1001.C0101_allcombined	365818	365823		efp	5
RK1001.C0101_allcombined	366034	366037		efp	3
RK1001.C0101_allcombined	366427	366436		sugE	9
RK1001.C0101_allcombined	367311	367326		YPO_RS02780	15
RK1001.C0101_allcombined	367700	367718		frdD	18
RK1001.C0101_allcombined	368366	368367		frdC	1
RK1001.C0101_allcombined	368384	368386		YPO_RS02795	2
RK1001.C0101_allcombined	368446	368475		YPO_RS02795	29
RK1001.C0101_allcombined	368794	368809		YPO_RS02795	15
RK1001.C0101_allcombined	368851	368864		YPO_RS02795	13
RK1001.C0101_allcombined	369009	369012		YPO_RS02795	3
RK1001.C0101_allcombined	369242	369245		frdA	3
RK1001.C0101_allcombined	369872	369896		frdA	24
RK1001.C0101_allcombined	370574	370580		frdA	6
RK1001.C0101_allcombined	371043	371172		YPO_RS02805	129
RK1001.C0101_allcombined	371866	371869		epmA	3
RK1001.C0101_allcombined	375053	375059		mscM	6
RK1001.C0101_allcombined	375104	375113		mscM	9
RK1001.C0101_allcombined	375921	375924		psd	3
RK1001.C0101_allcombined	376040	376053		psd	13
RK1001.C0101_allcombined	378428	378436		orn	8
RK1001.C0101_allcombined	378525	378531		orn	6
RK1001.C0101_allcombined	378563	378572		orn	9
RK1001.C0101_allcombined	378617	378646		orn	29
RK1001.C0101_allcombined	378726	378739		orn	13
RK1001.C0101_allcombined	379974	379992		queG	18
RK1001.C0101_allcombined	381884	381887		nnr	3
RK1001.C0101_allcombined	382272	382284		nnr	12
RK1001.C0101_allcombined	382398	382404		nnr	6
RK1001.C0101_allcombined	382557	382564		nnr	7
RK1001.C0101_allcombined	382901	382905		tsaE	4
RK1001.C0101_allcombined	383037	383049		tsaE	12
RK1001.C0101_allcombined	383888	383903		amiB	15
RK1001.C0101_allcombined	384132	384140		amiB	8
RK1001.C0101_allcombined	384479	384483		amiB	4
RK1001.C0101_allcombined	384881	384888		amiB	7
RK1001.C0101_allcombined	385606	385607		mutL	1
RK1001.C0101_allcombined	386183	386188		mutL	5
RK1001.C0101_allcombined	386409	386411		mutL	2
RK1001.C0101_allcombined	386839	386853		mutL	14
RK1001.C0101_allcombined	387556	387563		miaA	7
RK1001.C0101_allcombined	387648	387652		miaA	4
RK1001.C0101_allcombined	387818	387828		miaA	10
RK1001.C0101_allcombined	387991	388024		hfq	33
RK1001.C0101_allcombined	388496	388506		hflX	10
RK1001.C0101_allcombined	389044	389065		hflX	21
RK1001.C0101_allcombined	389902	389936		hflK	34
RK1001.C0101_allcombined	390107	390108		hflK	1
RK1001.C0101_allcombined	390464	390467		hflK	3
RK1001.C0101_allcombined	391250	391266		hflC	16
RK1001.C0101_allcombined	391832	391842		hflC	10
RK1001.C0101_allcombined	392055	392062		hflC	7
RK1001.C0101_allcombined	392487	392502		YPO_RS02890	15
RK1001.C0101_allcombined	393066	393073		YPO_RS02895	7
RK1001.C0101_allcombined	393303	393308		YPO_RS02895	5
RK1001.C0101_allcombined	393349	393352		YPO_RS02895	3
RK1001.C0101_allcombined	393815	393826		YPO_RS02895	11
RK1001.C0101_allcombined	394281	394296		nsrR	15
RK1001.C0101_allcombined	394430	394449		nsrR	19
RK1001.C0101_allcombined	394570	394581		nsrR	11
RK1001.C0101_allcombined	394616	394622		nsrR	6
RK1001.C0101_allcombined	395213	395219		rnr	6
RK1001.C0101_allcombined	395349	395358		rnr	9
RK1001.C0101_allcombined	395899	395920		rnr	21
RK1001.C0101_allcombined	396027	396033		rnr	6
RK1001.C0101_allcombined	396505	396545		rnr	40
RK1001.C0101_allcombined	396692	396699		rnr	7
RK1001.C0101_allcombined	396867	396882		rnr	15
RK1001.C0101_allcombined	397808	397831		rlmB	23
RK1001.C0101_allcombined	398760	398766		YPO_RS02915	6
RK1001.C0101_allcombined	398884	398890		YPO_RS02915	6
RK1001.C0101_allcombined	399187	399198		YPO_RS02915	11
RK1001.C0101_allcombined	399520	399526		YPO_RS02915	6
RK1001.C0101_allcombined	399737	399741		YPO_RS02915	4
RK1001.C0101_allcombined	399843	399860		YPO_RS02915	17
RK1001.C0101_allcombined	400502	400515		bsmA	13
RK1001.C0101_allcombined	400612	400621		bsmA	9
RK1001.C0101_allcombined	401019	401049		YPO_RS02925	30
RK1001.C0101_allcombined	401576	401579		YPO_RS02930	3
RK1001.C0101_allcombined	403079	403132		YPO_RS02940	53
RK1001.C0101_allcombined	403354	403365		YPO_RS02940	11
RK1001.C0101_allcombined	403748	403758		YPO_RS02940	10
RK1001.C0101_allcombined	403959	403969		YPO_RS02940	10
RK1001.C0101_allcombined	404300	404313		YPO_RS02940	13
RK1001.C0101_allcombined	404727	404750		YPO_RS02940	23
RK1001.C0101_allcombined	405095	405099		YPO_RS02940	4
RK1001.C0101_allcombined	405422	405438		YPO_RS02945	16
RK1001.C0101_allcombined	406090	406106		YPO_RS02945	16
RK1001.C0101_allcombined	406295	406306		YPO_RS02945	11
RK1001.C0101_allcombined	406377	406425		YPO_RS02945	48
RK1001.C0101_allcombined	407646	407659		YPO_RS02955	13
RK1001.C0101_allcombined	407726	407748		YPO_RS02955	22
RK1001.C0101_allcombined	407786	407826		YPO_RS02955	40
RK1001.C0101_allcombined	407862	407908		YPO_RS02955	46
RK1001.C0101_allcombined	407973	407984		YPO_RS02955	11
RK1001.C0101_allcombined	408026	408060		YPO_RS02955	34
RK1001.C0101_allcombined	408105	408180		YPO_RS02955	75
RK1001.C0101_allcombined	408236	408338		YPO_RS02955	102
RK1001.C0101_allcombined	408383	408527		YPO_RS02955	144
RK1001.C0101_allcombined	408699	408711		YPO_RS02955	12
RK1001.C0101_allcombined	408824	408861		YPO_RS02960	37
RK1001.C0101_allcombined	408914	408985		YPO_RS02960	71
RK1001.C0101_allcombined	409027	409059		YPO_RS02960	32
RK1001.C0101_allcombined	409098	409099		YPO_RS02960	1
RK1001.C0101_allcombined	409183	409216		YPO_RS02960	33
RK1001.C0101_allcombined	409259	409322		YPO_RS02960	63
RK1001.C0101_allcombined	409466	409499		YPO_RS02960	33
RK1001.C0101_allcombined	409531	409546		YPO_RS02960	15
RK1001.C0101_allcombined	409531	409591		YPO_RS02965	60
RK1001.C0101_allcombined	409634	409742		YPO_RS02965	108
RK1001.C0101_allcombined	409776	409806		YPO_RS02965	30
RK1001.C0101_allcombined	409837	409922		YPO_RS02965	85
RK1001.C0101_allcombined	409991	410042		YPO_RS02965	51
RK1001.C0101_allcombined	410074	410077		YPO_RS02965	3
RK1001.C0101_allcombined	410149	410161		YPO_RS02965	12
RK1001.C0101_allcombined	410220	410246		YPO_RS02965	26
RK1001.C0101_allcombined	410285	410307		YPO_RS02965	22
RK1001.C0101_allcombined	410383	410395		YPO_RS02965	12
RK1001.C0101_allcombined	410463	410664		YPO_RS02965	201
RK1001.C0101_allcombined	410694	410715		YPO_RS02965	21
RK1001.C0101_allcombined	410795	410829		YPO_RS02965	34
RK1001.C0101_allcombined	410859	410891		YPO_RS02965	32
RK1001.C0101_allcombined	411235	411248		YPO_RS02970	13
RK1001.C0101_allcombined	411357	411360		YPO_RS02970	3
RK1001.C0101_allcombined	412831	412850		YPO_RS02980	19
RK1001.C0101_allcombined	414248	414249		YPO_RS02985	1
RK1001.C0101_allcombined	414560	414571		YPO_RS02985	11
RK1001.C0101_allcombined	415209	415222		YPO_RS02990	13
RK1001.C0101_allcombined	415509	415510		YPO_RS02990	1
RK1001.C0101_allcombined	415577	415586		YPO_RS02990	9
RK1001.C0101_allcombined	415641	415642		YPO_RS02990	1
RK1001.C0101_allcombined	416092	416097		YPO_RS02995	5
RK1001.C0101_allcombined	416270	416289		YPO_RS02995	19
RK1001.C0101_allcombined	416382	416386		YPO_RS02995	4
RK1001.C0101_allcombined	416812	416852		YPO_RS02995	40
RK1001.C0101_allcombined	416981	417007		YPO_RS02995	26
RK1001.C0101_allcombined	417064	417070		YPO_RS02995	6
RK1001.C0101_allcombined	417874	417877		YPO_RS03000	3
RK1001.C0101_allcombined	417909	417911		YPO_RS03000	2
RK1001.C0101_allcombined	418018	418078		YPO_RS03000	60
RK1001.C0101_allcombined	418157	418167		YPO_RS03000	10
RK1001.C0101_allcombined	418447	418455		YPO_RS03005	8
RK1001.C0101_allcombined	418506	418515		YPO_RS03005	9
RK1001.C0101_allcombined	418555	418589		YPO_RS03005	34
RK1001.C0101_allcombined	418672	418715		YPO_RS03005	43
RK1001.C0101_allcombined	418781	418825		YPO_RS03005	44
RK1001.C0101_allcombined	418914	418918		YPO_RS03005	4
RK1001.C0101_allcombined	419070	419115		YPO_RS03005	45
RK1001.C0101_allcombined	419218	419220		YPO_RS03005	2
RK1001.C0101_allcombined	419218	419225		YPO_RS03010	7
RK1001.C0101_allcombined	419421	419428		YPO_RS03010	7
RK1001.C0101_allcombined	420311	420314		YPO_RS03020	3
RK1001.C0101_allcombined	420814	420815		YPO_RS03020	1
RK1001.C0101_allcombined	421321	421327		YPO_RS03020	6
RK1001.C0101_allcombined	421382	421390		YPO_RS03020	8
RK1001.C0101_allcombined	421884	421899		ptsP	15
RK1001.C0101_allcombined	421991	422020		ptsP	29
RK1001.C0101_allcombined	422360	422369		ptsP	9
RK1001.C0101_allcombined	422478	422497		ptsP	19
RK1001.C0101_allcombined	422770	422783		ptsP	13
RK1001.C0101_allcombined	422870	422878		ptsP	8
RK1001.C0101_allcombined	423634	423639		ptsP	5
RK1001.C0101_allcombined	423750	423758		ptsP	8
RK1001.C0101_allcombined	423869	423903		ptsP	34
RK1001.C0101_allcombined	425235	425250		lsrG	15
RK1001.C0101_allcombined	425553	425562		lsrF	9
RK1001.C0101_allcombined	425940	425976		lsrF	36
RK1001.C0101_allcombined	426370	426373		lsrF	3
RK1001.C0101_allcombined	426547	426576		lsrB	29
RK1001.C0101_allcombined	426960	426997		lsrB	37
RK1001.C0101_allcombined	427431	427446		lsrB	15
RK1001.C0101_allcombined	427540	427544		lsrD	4
RK1001.C0101_allcombined	428196	428204		lsrD	8
RK1001.C0101_allcombined	428248	428259		lsrD	11
RK1001.C0101_allcombined	428375	428377		lsrD	2
RK1001.C0101_allcombined	428523	428541		lsrD	18
RK1001.C0101_allcombined	428538	428590		lsrC	52
RK1001.C0101_allcombined	428993	428996		lsrC	3
RK1001.C0101_allcombined	429670	429679		lsrA	9
RK1001.C0101_allcombined	429724	429727		lsrA	3
RK1001.C0101_allcombined	429867	429869		lsrA	2
RK1001.C0101_allcombined	430227	430254		lsrA	27
RK1001.C0101_allcombined	430599	430604		lsrA	5
RK1001.C0101_allcombined	430909	430914		lsrA	5
RK1001.C0101_allcombined	431062	431080		lsrA	18
RK1001.C0101_allcombined	431139	431159		lsrA	20
RK1001.C0101_allcombined	431280	431370		YPO_RS03065	90
RK1001.C0101_allcombined	431433	431438		YPO_RS03065	5
RK1001.C0101_allcombined	432680	432694		lsrK	14
RK1001.C0101_allcombined	432730	432731		lsrK	1
RK1001.C0101_allcombined	432889	432915		lsrK	26
RK1001.C0101_allcombined	433110	433120		lsrK	10
RK1001.C0101_allcombined	433244	433251		lsrK	7
RK1001.C0101_allcombined	433346	433348		lsrK	2
RK1001.C0101_allcombined	433553	433558		lsrK	5
RK1001.C0101_allcombined	433709	433719		lsrK	10
RK1001.C0101_allcombined	435896	435902		YPO_RS03085	6
RK1001.C0101_allcombined	435944	435968		YPO_RS03085	24
RK1001.C0101_allcombined	436054	436098		YPO_RS03085	44
RK1001.C0101_allcombined	436133	436145		YPO_RS03085	12
RK1001.C0101_allcombined	436353	436366		YPO_RS03085	13
RK1001.C0101_allcombined	436769	436807		YPO_RS03085	38
RK1001.C0101_allcombined	437948	437968		YPO_RS03090	20
RK1001.C0101_allcombined	438064	438078		YPO_RS03090	14
RK1001.C0101_allcombined	438775	438788		YPO_RS03095	13
RK1001.C0101_allcombined	438993	438997		YPO_RS03095	4
RK1001.C0101_allcombined	439241	439266		YPO_RS03100	25
RK1001.C0101_allcombined	440181	440188		YPO_RS03100	7
RK1001.C0101_allcombined	440287	440328		YPO_RS03100	41
RK1001.C0101_allcombined	440380	440399		YPO_RS03100	19
RK1001.C0101_allcombined	440430	440446		YPO_RS03100	16
RK1001.C0101_allcombined	440771	440814		YPO_RS03100	43
RK1001.C0101_allcombined	441060	441062		YPO_RS03100	2
RK1001.C0101_allcombined	441482	441489		YPO_RS03100	7
RK1001.C0101_allcombined	441654	441694		YPO_RS03100	40
RK1001.C0101_allcombined	441759	441763		YPO_RS03100	4
RK1001.C0101_allcombined	442712	442750		YPO_RS03105	38
RK1001.C0101_allcombined	442862	442866		YPO_RS03105	4
RK1001.C0101_allcombined	442907	442952		YPO_RS03105	45
RK1001.C0101_allcombined	443813	443842		YPO_RS03115	29
RK1001.C0101_allcombined	444102	444115		YPO_RS03115	13
RK1001.C0101_allcombined	444614	444623		YPO_RS03115	9
RK1001.C0101_allcombined	444783	444786		YPO_RS03115	3
RK1001.C0101_allcombined	444881	444885		YPO_RS03115	4
RK1001.C0101_allcombined	445450	445458		YPO_RS03120	8
RK1001.C0101_allcombined	446163	446233		YPO_RS03120	70
RK1001.C0101_allcombined	446335	446373		YPO_RS03120	38
RK1001.C0101_allcombined	446537	446541		YPO_RS03120	4
RK1001.C0101_allcombined	447177	447192		YPO_RS03125	15
RK1001.C0101_allcombined	448440	448443		rsmC	3
RK1001.C0101_allcombined	449073	449075		YPO_RS03140	2
RK1001.C0101_allcombined	449344	449356		rimI	12
RK1001.C0101_allcombined	450643	450657		prfC	14
RK1001.C0101_allcombined	450802	450807		prfC	5
RK1001.C0101_allcombined	451000	451019		prfC	19
RK1001.C0101_allcombined	451384	451391		prfC	7
RK1001.C0101_allcombined	452801	452814		YPO_RS03165	13
RK1001.C0101_allcombined	452966	452969		YPO_RS03165	3
RK1001.C0101_allcombined	453350	453356		YPO_RS03165	6
RK1001.C0101_allcombined	453520	453543		YPO_RS03165	23
RK1001.C0101_allcombined	453735	453738		YPO_RS03165	3
RK1001.C0101_allcombined	455595	455602		YPO_RS03175	7
RK1001.C0101_allcombined	455925	455928		YPO_RS03175	3
RK1001.C0101_allcombined	456567	456571		YPO_RS03175	4
RK1001.C0101_allcombined	457852	457858		deoC	6
RK1001.C0101_allcombined	457904	457910		deoC	6
RK1001.C0101_allcombined	459661	459668		deoB	7
RK1001.C0101_allcombined	460119	460129		deoB	10
RK1001.C0101_allcombined	460665	460667		deoB	2
RK1001.C0101_allcombined	460775	460784		deoB	9
RK1001.C0101_allcombined	460991	461001		deoD	10
RK1001.C0101_allcombined	461155	461257		deoD	102
RK1001.C0101_allcombined	461303	461322		deoD	19
RK1001.C0101_allcombined	461472	461476		deoD	4
RK1001.C0101_allcombined	462428	462430		YPO_RS03200	2
RK1001.C0101_allcombined	462461	462462		YPO_RS03200	1
RK1001.C0101_allcombined	462755	462763		serB	8
RK1001.C0101_allcombined	462884	462892		serB	8
RK1001.C0101_allcombined	462987	462990		serB	3
RK1001.C0101_allcombined	464201	464210		radA	9
RK1001.C0101_allcombined	465201	465205		radA	4
RK1001.C0101_allcombined	465430	465471		nadR	41
RK1001.C0101_allcombined	465759	465766		nadR	7
RK1001.C0101_allcombined	466020	466021		nadR	1
RK1001.C0101_allcombined	466286	466291		nadR	5
RK1001.C0101_allcombined	466408	466423		nadR	15
RK1001.C0101_allcombined	466794	466796		YPO_RS03220	2
RK1001.C0101_allcombined	467681	467723		YPO_RS03220	42
RK1001.C0101_allcombined	470123	470138		YPO_RS03230	15
RK1001.C0101_allcombined	470195	470197		YPO_RS03230	2
RK1001.C0101_allcombined	470329	470346		YPO_RS03230	17
RK1001.C0101_allcombined	470624	470638		YPO_RS03235	14
RK1001.C0101_allcombined	471109	471122		YPO_RS03235	13
RK1001.C0101_allcombined	471773	471807		YPO_RS03240	34
RK1001.C0101_allcombined	471968	472001		YPO_RS03240	33
RK1001.C0101_allcombined	472787	472821		YPO_RS03245	34
RK1001.C0101_allcombined	473255	473302		YPO_RS03245	47
RK1001.C0101_allcombined	474329	474332		YPO_RS03245	3
RK1001.C0101_allcombined	474958	474967		YPO_RS03245	9
RK1001.C0101_allcombined	475411	475425		YPO_RS03245	14
RK1001.C0101_allcombined	476144	476158		sltY	14
RK1001.C0101_allcombined	476668	476676		sltY	8
RK1001.C0101_allcombined	477579	477608		sltY	29
RK1001.C0101_allcombined	477663	477671		sltY	8
RK1001.C0101_allcombined	477749	477760		sltY	11
RK1001.C0101_allcombined	478961	478971		yjjX	10
RK1001.C0101_allcombined	479013	479038		yjjX	25
RK1001.C0101_allcombined	479528	479563		gpmB	35
RK1001.C0101_allcombined	479977	479979		robA	2
RK1001.C0101_allcombined	480182	480188		robA	6
RK1001.C0101_allcombined	480284	480295		robA	11
RK1001.C0101_allcombined	480934	480977		creA	43
RK1001.C0101_allcombined	481228	481235		creA	7
RK1001.C0101_allcombined	481265	481283		creA	18
RK1001.C0101_allcombined	481686	481706		arcA	20
RK1001.C0101_allcombined	481952	481955		arcA	3
RK1001.C0101_allcombined	482269	482283		arcA	14
RK1001.C0101_allcombined	483712	483715		thrA	3
RK1001.C0101_allcombined	485335	485340		thrA	5
RK1001.C0101_allcombined	485964	485974		thrB	10
RK1001.C0101_allcombined	486101	486103		thrB	2
RK1001.C0101_allcombined	486298	486308		thrB	10
RK1001.C0101_allcombined	486359	486378		thrB	19
RK1001.C0101_allcombined	486868	486875		thrC	7
RK1001.C0101_allcombined	486969	486984		thrC	15
RK1001.C0101_allcombined	487310	487315		thrC	5
RK1001.C0101_allcombined	489125	489148		yaaA	23
RK1001.C0101_allcombined	490053	490067		YPO_RS03310	14
RK1001.C0101_allcombined	490393	490411		tal	18
RK1001.C0101_allcombined	490763	490784		tal	21
RK1001.C0101_allcombined	490852	490876		tal	24
RK1001.C0101_allcombined	491452	491471		mog	19
RK1001.C0101_allcombined	491805	491819		mog	14
RK1001.C0101_allcombined	492275	492303		YPO_RS03325	28
RK1001.C0101_allcombined	492488	492509		YPO_RS03325	21
RK1001.C0101_allcombined	492789	492797		YPO_RS03325	8
RK1001.C0101_allcombined	492864	492877		YPO_RS03325	13
RK1001.C0101_allcombined	493282	493289		YPO_RS03325	7
RK1001.C0101_allcombined	493390	493392		YPO_RS03325	2
RK1001.C0101_allcombined	493498	493548		YPO_RS03325	50
RK1001.C0101_allcombined	493618	493649		YPO_RS03330	31
RK1001.C0101_allcombined	493727	493750		YPO_RS03330	23
RK1001.C0101_allcombined	493887	493894		YPO_RS03330	7
RK1001.C0101_allcombined	493927	493930		YPO_RS03330	3
RK1001.C0101_allcombined	494054	494056		YPO_RS03330	2
RK1001.C0101_allcombined	494108	494159		YPO_RS03330	51
RK1001.C0101_allcombined	494209	494260		YPO_RS03330	51
RK1001.C0101_allcombined	494348	494354		YPO_RS03330	6
RK1001.C0101_allcombined	494407	494509		YPO_RS03330	102
RK1001.C0101_allcombined	494542	494567		YPO_RS03330	25
RK1001.C0101_allcombined	494699	494732		YPO_RS03330	33
RK1001.C0101_allcombined	494773	494836		YPO_RS03330	63
RK1001.C0101_allcombined	494930	494949		YPO_RS03330	19
RK1001.C0101_allcombined	495018	495168		YPO_RS03330	150
RK1001.C0101_allcombined	495264	495268		YPO_RS03330	4
RK1001.C0101_allcombined	495302	495318		YPO_RS03330	16
RK1001.C0101_allcombined	495405	495434		YPO_RS03330	29
RK1001.C0101_allcombined	495581	495652		YPO_RS03330	71
RK1001.C0101_allcombined	495711	495824		YPO_RS03330	113
RK1001.C0101_allcombined	495964	495982		YPO_RS03330	18
RK1001.C0101_allcombined	496024	496036		YPO_RS03330	12
RK1001.C0101_allcombined	496506	496515		satP	9
RK1001.C0101_allcombined	497339	497352		dnaK	13
RK1001.C0101_allcombined	497406	497412		dnaK	6
RK1001.C0101_allcombined	497917	497950		dnaK	33
RK1001.C0101_allcombined	498278	498340		dnaK	62
RK1001.C0101_allcombined	498437	498456		dnaK	19
RK1001.C0101_allcombined	499692	499723		dnaJ	31
RK1001.C0101_allcombined	500098	500099		dnaJ	1
RK1001.C0101_allcombined	500498	500500		dnaJ	2
RK1001.C0101_allcombined	500926	500934		nhaA	8
RK1001.C0101_allcombined	501059	501072		nhaA	13
RK1001.C0101_allcombined	501242	501270		nhaA	28
RK1001.C0101_allcombined	501574	501583		nhaA	9
RK1001.C0101_allcombined	502124	502131		nhaR	7
RK1001.C0101_allcombined	502829	502869		nhaR	40
RK1001.C0101_allcombined	502906	502917		nhaR	11
RK1001.C0101_allcombined	504120	504187		ribF	67
RK1001.C0101_allcombined	504341	504356		ribF	15
RK1001.C0101_allcombined	504425	504433		ribF	8
RK1001.C0101_allcombined	504550	504576		ribF	26
RK1001.C0101_allcombined	505001	505006		ileS	5
RK1001.C0101_allcombined	505102	505108		ileS	6
RK1001.C0101_allcombined	506396	506397		ileS	1
RK1001.C0101_allcombined	508982	508984		ispH	2
RK1001.C0101_allcombined	509347	509365		ispH	18
RK1001.C0101_allcombined	510240	510288		YPO_RS03400	48
RK1001.C0101_allcombined	511197	511205		dapB	8
RK1001.C0101_allcombined	511607	511634		dapB	27
RK1001.C0101_allcombined	512175	512249		carA	74
RK1001.C0101_allcombined	512831	512848		carA	17
RK1001.C0101_allcombined	513079	513094		carA	15
RK1001.C0101_allcombined	513401	513425		carB	24
RK1001.C0101_allcombined	514681	514686		carB	5
RK1001.C0101_allcombined	514926	514939		carB	13
RK1001.C0101_allcombined	515974	515977		carB	3
RK1001.C0101_allcombined	516147	516154		carB	7
RK1001.C0101_allcombined	516390	516406		carB	16
RK1001.C0101_allcombined	517069	517084		YPO_RS03420	15
RK1001.C0101_allcombined	517314	517336		YPO_RS03420	22
RK1001.C0101_allcombined	517778	517779		YPO_RS03425	1
RK1001.C0101_allcombined	517882	517894		YPO_RS03425	12
RK1001.C0101_allcombined	517965	517973		YPO_RS03425	8
RK1001.C0101_allcombined	518261	518264		YPO_RS03425	3
RK1001.C0101_allcombined	518363	518365		YPO_RS03425	2
RK1001.C0101_allcombined	518628	518634		YPO_RS03430	6
RK1001.C0101_allcombined	518694	518697		YPO_RS03430	3
RK1001.C0101_allcombined	518778	518852		YPO_RS03430	74
RK1001.C0101_allcombined	518931	518944		YPO_RS03430	13
RK1001.C0101_allcombined	519256	519262		folA	6
RK1001.C0101_allcombined	519842	519843		YPO_RS03440	1
RK1001.C0101_allcombined	520793	520893		YPO_RS03445	100
RK1001.C0101_allcombined	520993	521007		YPO_RS03445	14
RK1001.C0101_allcombined	521155	521175		YPO_RS03450	20
RK1001.C0101_allcombined	521269	521355		YPO_RS03450	86
RK1001.C0101_allcombined	521434	521467		YPO_RS03450	33
RK1001.C0101_allcombined	521516	521517		YPO_RS03450	1
RK1001.C0101_allcombined	521593	521598		YPO_RS03450	5
RK1001.C0101_allcombined	521779	521789		apaH	10
RK1001.C0101_allcombined	521847	521851		apaH	4
RK1001.C0101_allcombined	522361	522364		apaH	3
RK1001.C0101_allcombined	522624	522635		apaG	11
RK1001.C0101_allcombined	522896	522924		apaG	28
RK1001.C0101_allcombined	523607	523623		rsmA	16
RK1001.C0101_allcombined	523695	523698		rsmA	3
RK1001.C0101_allcombined	523835	523839		pdxA	4
RK1001.C0101_allcombined	523969	523975		pdxA	6
RK1001.C0101_allcombined	524075	524116		pdxA	41
RK1001.C0101_allcombined	524954	524965		surA	11
RK1001.C0101_allcombined	526455	526459		lptD	4
RK1001.C0101_allcombined	526542	526571		lptD	29
RK1001.C0101_allcombined	526731	526741		lptD	10
RK1001.C0101_allcombined	526883	526926		lptD	43
RK1001.C0101_allcombined	527441	527470		lptD	29
RK1001.C0101_allcombined	527527	527572		lptD	45
RK1001.C0101_allcombined	527830	527833		lptD	3
RK1001.C0101_allcombined	528048	528093		lptD	45
RK1001.C0101_allcombined	528362	528378		lptD	16
RK1001.C0101_allcombined	529043	529046		djlA	3
RK1001.C0101_allcombined	529251	529311		djlA	60
RK1001.C0101_allcombined	529481	529487		djlA	6
RK1001.C0101_allcombined	530025	530026		rluA	1
RK1001.C0101_allcombined	530381	530405		rluA	24
RK1001.C0101_allcombined	531628	531630		YPO_RS03495	2
RK1001.C0101_allcombined	531911	531932		YPO_RS03495	21
RK1001.C0101_allcombined	531984	532018		YPO_RS03495	34
RK1001.C0101_allcombined	532076	532111		YPO_RS03495	35
RK1001.C0101_allcombined	532168	532219		YPO_RS03495	51
RK1001.C0101_allcombined	532263	532288		YPO_RS03495	25
RK1001.C0101_allcombined	532829	532836		YPO_RS03500	7
RK1001.C0101_allcombined	533054	533067		YPO_RS03500	13
RK1001.C0101_allcombined	533227	533264		YPO_RS03500	37
RK1001.C0101_allcombined	533469	533504		YPO_RS03500	35
RK1001.C0101_allcombined	533617	533622		YPO_RS03500	5
RK1001.C0101_allcombined	533763	533794		tssB	31
RK1001.C0101_allcombined	533891	533913		tssB	22
RK1001.C0101_allcombined	534126	534139		tssB	13
RK1001.C0101_allcombined	534282	534285		tssB	3
RK1001.C0101_allcombined	534616	534646		tssC	30
RK1001.C0101_allcombined	535104	535123		tssC	19
RK1001.C0101_allcombined	535708	535718		tssC	10
RK1001.C0101_allcombined	536019	536028		YPO_RS03515	9
RK1001.C0101_allcombined	536154	536158		YPO_RS03515	4
RK1001.C0101_allcombined	536255	536282		YPO_RS03515	27
RK1001.C0101_allcombined	536452	536456		YPO_RS03515	4
RK1001.C0101_allcombined	537027	537050		tssF	23
RK1001.C0101_allcombined	537695	537727		tssF	32
RK1001.C0101_allcombined	538084	538096		tssF	12
RK1001.C0101_allcombined	538253	538262		tssF	9
RK1001.C0101_allcombined	539539	539547		tssG	8
RK1001.C0101_allcombined	539909	539916		tssH	7
RK1001.C0101_allcombined	539962	539996		tssH	34
RK1001.C0101_allcombined	540107	540114		tssH	7
RK1001.C0101_allcombined	540239	540245		tssH	6
RK1001.C0101_allcombined	540299	540319		tssH	20
RK1001.C0101_allcombined	541342	541365		tssH	23
RK1001.C0101_allcombined	541516	541525		tssH	9
RK1001.C0101_allcombined	541941	541958		tssH	17
RK1001.C0101_allcombined	542148	542157		tssH	9
RK1001.C0101_allcombined	542600	542615		vgrG	15
RK1001.C0101_allcombined	542652	542656		vgrG	4
RK1001.C0101_allcombined	542766	542781		vgrG	15
RK1001.C0101_allcombined	542912	542920		vgrG	8
RK1001.C0101_allcombined	542979	542984		vgrG	5
RK1001.C0101_allcombined	543044	543060		vgrG	16
RK1001.C0101_allcombined	544158	544166		vgrG	8
RK1001.C0101_allcombined	544309	544310		vgrG	1
RK1001.C0101_allcombined	544414	544486		vgrG	72
RK1001.C0101_allcombined	544644	544666		vgrG	22
RK1001.C0101_allcombined	544790	544795		vgrG	5
RK1001.C0101_allcombined	544861	544866		vgrG	5
RK1001.C0101_allcombined	545002	545003		YPO_RS03545	1
RK1001.C0101_allcombined	545290	545299		YPO_RS03545	9
RK1001.C0101_allcombined	546445	546470		YPO_RS03550	25
RK1001.C0101_allcombined	546690	546725		YPO_RS03550	35
RK1001.C0101_allcombined	547252	547293		YPO_RS03555	41
RK1001.C0101_allcombined	547434	547474		YPO_RS03555	40
RK1001.C0101_allcombined	547679	547688		YPO_RS03555	9
RK1001.C0101_allcombined	548275	548278		YPO_RS03560	3
RK1001.C0101_allcombined	548347	548349		YPO_RS03560	2
RK1001.C0101_allcombined	548552	548577		YPO_RS03560	25
RK1001.C0101_allcombined	548790	548815		YPO_RS03560	25
RK1001.C0101_allcombined	549115	549127		YPO_RS03565	12
RK1001.C0101_allcombined	549171	549178		YPO_RS03565	7
RK1001.C0101_allcombined	549444	549463		tssJ	19
RK1001.C0101_allcombined	549866	549882		tssK	16
RK1001.C0101_allcombined	550173	550207		tssK	34
RK1001.C0101_allcombined	551075	551093		tssK	18
RK1001.C0101_allcombined	551586	551595		YPO_RS03580	9
RK1001.C0101_allcombined	551763	551793		YPO_RS03580	30
RK1001.C0101_allcombined	551898	551901		YPO_RS03580	3
RK1001.C0101_allcombined	552915	552932		tssM	17
RK1001.C0101_allcombined	553095	553096		tssM	1
RK1001.C0101_allcombined	553249	553258		tssM	9
RK1001.C0101_allcombined	553701	553705		tssM	4
RK1001.C0101_allcombined	553950	553951		tssM	1
RK1001.C0101_allcombined	554175	554186		tssM	11
RK1001.C0101_allcombined	554339	554344		tssM	5
RK1001.C0101_allcombined	554506	554516		tssM	10
RK1001.C0101_allcombined	554855	554861		tssM	6
RK1001.C0101_allcombined	555203	555214		tssM	11
RK1001.C0101_allcombined	555402	555404		tssM	2
RK1001.C0101_allcombined	555657	555658		tssM	1
RK1001.C0101_allcombined	556172	556183		tssM	11
RK1001.C0101_allcombined	556286	556299		tssM	13
RK1001.C0101_allcombined	557036	557040		rapA	4
RK1001.C0101_allcombined	557304	557306		rapA	2
RK1001.C0101_allcombined	557415	557416		rapA	1
RK1001.C0101_allcombined	557632	557644		rapA	12
RK1001.C0101_allcombined	558383	558396		rapA	13
RK1001.C0101_allcombined	560341	560345		YPO_RS03600	4
RK1001.C0101_allcombined	560471	560483		YPO_RS03600	12
RK1001.C0101_allcombined	560743	560750		YPO_RS03600	7
RK1001.C0101_allcombined	560939	560944		YPO_RS03600	5
RK1001.C0101_allcombined	561413	561415		YPO_RS03600	2
RK1001.C0101_allcombined	561515	561537		YPO_RS03600	22
RK1001.C0101_allcombined	562120	562136		YPO_RS03600	16
RK1001.C0101_allcombined	562284	562301		YPO_RS03600	17
RK1001.C0101_allcombined	563576	563597		YPO_RS03605	21
RK1001.C0101_allcombined	563630	563645		YPO_RS03605	15
RK1001.C0101_allcombined	564019	564032		thiQ	13
RK1001.C0101_allcombined	564374	564382		thiQ	8
RK1001.C0101_allcombined	564981	564985		thiP	4
RK1001.C0101_allcombined	565075	565095		thiP	20
RK1001.C0101_allcombined	566485	566494		YPO_RS03620	9
RK1001.C0101_allcombined	566591	566638		YPO_RS03620	47
RK1001.C0101_allcombined	566964	566977		YPO_RS03620	13
RK1001.C0101_allcombined	567984	568027		YPO_RS03625	43
RK1001.C0101_allcombined	568103	568109		YPO_RS03625	6
RK1001.C0101_allcombined	568427	568437		YPO_RS03625	10
RK1001.C0101_allcombined	568490	568516		YPO_RS03625	26
RK1001.C0101_allcombined	568549	568564		YPO_RS03625	15
RK1001.C0101_allcombined	568949	568955		YPO_RS03625	6
RK1001.C0101_allcombined	569051	569062		YPO_RS03625	11
RK1001.C0101_allcombined	569199	569207		YPO_RS03625	8
RK1001.C0101_allcombined	571562	571578		YPO_RS03635	16
RK1001.C0101_allcombined	571713	571717		YPO_RS03635	4
RK1001.C0101_allcombined	573140	573141		YPO_RS03645	1
RK1001.C0101_allcombined	573207	573217		YPO_RS03645	10
RK1001.C0101_allcombined	573831	573899		leuD	68
RK1001.C0101_allcombined	573967	573975		leuD	8
RK1001.C0101_allcombined	574621	574639		leuC	18
RK1001.C0101_allcombined	574944	574954		leuC	10
RK1001.C0101_allcombined	575214	575226		leuC	12
RK1001.C0101_allcombined	575337	575341		leuC	4
RK1001.C0101_allcombined	576077	576106		leuB	29
RK1001.C0101_allcombined	577296	577298		leuA	2
RK1001.C0101_allcombined	577599	577619		leuA	20
RK1001.C0101_allcombined	577733	577755		leuA	22
RK1001.C0101_allcombined	578181	578210		leuA	29
RK1001.C0101_allcombined	579547	579585		YPO_RS03675	38
RK1001.C0101_allcombined	580702	580712		leuO	10
RK1001.C0101_allcombined	580742	580750		leuO	8
RK1001.C0101_allcombined	580849	580859		leuO	10
RK1001.C0101_allcombined	580928	581010		leuO	82
RK1001.C0101_allcombined	581219	581220		leuO	1
RK1001.C0101_allcombined	581752	581795		YPO_RS03685	43
RK1001.C0101_allcombined	581920	581927		YPO_RS03685	7
RK1001.C0101_allcombined	582009	582010		YPO_RS03685	1
RK1001.C0101_allcombined	582252	582275		YPO_RS03685	23
RK1001.C0101_allcombined	583163	583172		YPO_RS03685	9
RK1001.C0101_allcombined	584062	584063		ilvI	1
RK1001.C0101_allcombined	584120	584157		ilvI	37
RK1001.C0101_allcombined	584366	584370		ilvI	4
RK1001.C0101_allcombined	584658	584660		ilvI	2
RK1001.C0101_allcombined	584854	584884		ilvI	30
RK1001.C0101_allcombined	585210	585216		ilvI	6
RK1001.C0101_allcombined	585358	585359		ilvI	1
RK1001.C0101_allcombined	585418	585432		ilvI	14
RK1001.C0101_allcombined	588241	588242		cra	1
RK1001.C0101_allcombined	588811	588821		YPO_RS03710	10
RK1001.C0101_allcombined	590086	590097		mraZ	11
RK1001.C0101_allcombined	590197	590198		mraZ	1
RK1001.C0101_allcombined	590540	590541		mraZ	1
RK1001.C0101_allcombined	590582	590620		rsmH	38
RK1001.C0101_allcombined	591191	591204		rsmH	13
RK1001.C0101_allcombined	591294	591303		rsmH	9
RK1001.C0101_allcombined	591339	591341		rsmH	2
RK1001.C0101_allcombined	591494	591509		rsmH	15
RK1001.C0101_allcombined	591506	591547		ftsL	41
RK1001.C0101_allcombined	591615	591628		ftsL	13
RK1001.C0101_allcombined	592137	592205		YPO_RS03735	68
RK1001.C0101_allcombined	592837	592842		YPO_RS03735	5
RK1001.C0101_allcombined	593060	593071		YPO_RS03735	11
RK1001.C0101_allcombined	593525	593530		YPO_RS03735	5
RK1001.C0101_allcombined	593674	593684		murE	10
RK1001.C0101_allcombined	593882	593887		murE	5
RK1001.C0101_allcombined	594066	594068		murE	2
RK1001.C0101_allcombined	594213	594227		murE	14
RK1001.C0101_allcombined	595199	595232		murF	33
RK1001.C0101_allcombined	595348	595381		murF	33
RK1001.C0101_allcombined	597361	597375		mraY	14
RK1001.C0101_allcombined	597573	597575		mraY	2
RK1001.C0101_allcombined	597578	597580		murD	2
RK1001.C0101_allcombined	597938	597941		murD	3
RK1001.C0101_allcombined	598434	598436		murD	2
RK1001.C0101_allcombined	598784	598811		murD	27
RK1001.C0101_allcombined	598944	598967		ftsW	23
RK1001.C0101_allcombined	600553	600569		murG	16
RK1001.C0101_allcombined	600630	600634		murG	4
RK1001.C0101_allcombined	600758	600766		murG	8
RK1001.C0101_allcombined	602331	602347		murC	16
RK1001.C0101_allcombined	602519	602544		murC	25
RK1001.C0101_allcombined	602948	602953		YPO_RS03775	5
RK1001.C0101_allcombined	603026	603039		YPO_RS03775	13
RK1001.C0101_allcombined	603403	603421		YPO_RS03775	18
RK1001.C0101_allcombined	604225	604237		ftsQ	12
RK1001.C0101_allcombined	604646	604697		ftsA	51
RK1001.C0101_allcombined	604826	604836		ftsA	10
RK1001.C0101_allcombined	604869	604884		ftsA	15
RK1001.C0101_allcombined	605237	605248		ftsA	11
RK1001.C0101_allcombined	605416	605496		ftsA	80
RK1001.C0101_allcombined	605604	605626		ftsA	22
RK1001.C0101_allcombined	605881	605894		ftsZ	13
RK1001.C0101_allcombined	606472	606478		ftsZ	6
RK1001.C0101_allcombined	606845	606850		ftsZ	5
RK1001.C0101_allcombined	606958	606963		ftsZ	5
RK1001.C0101_allcombined	607127	607132		lpxC	5
RK1001.C0101_allcombined	607793	607800		lpxC	7
RK1001.C0101_allcombined	608031	608045		lpxC	14
RK1001.C0101_allcombined	609206	609207		secM	1
RK1001.C0101_allcombined	609680	609685		secA	5
RK1001.C0101_allcombined	609889	609904		secA	15
RK1001.C0101_allcombined	610031	610076		secA	45
RK1001.C0101_allcombined	610348	610369		secA	21
RK1001.C0101_allcombined	610620	610639		secA	19
RK1001.C0101_allcombined	611106	611107		secA	1
RK1001.C0101_allcombined	612595	612597		mutT	2
RK1001.C0101_allcombined	613060	613061		YPO_RS03820	1
RK1001.C0101_allcombined	613934	613939		YPO_RS03825	5
RK1001.C0101_allcombined	615482	615487		YPO_RS03835	5
RK1001.C0101_allcombined	616675	616678		YPO_RS03850	3
RK1001.C0101_allcombined	617220	617224		YPO_RS03855	4
RK1001.C0101_allcombined	617763	617785		mzrA	22
RK1001.C0101_allcombined	617850	617885		mzrA	35
RK1001.C0101_allcombined	617943	617946		mzrA	3
RK1001.C0101_allcombined	617943	617963		YPO_RS03865	20
RK1001.C0101_allcombined	618078	618106		YPO_RS03865	28
RK1001.C0101_allcombined	618356	618367		YPO_RS03865	11
RK1001.C0101_allcombined	618539	618547		YPO_RS03865	8
RK1001.C0101_allcombined	618621	618641		YPO_RS03865	20
RK1001.C0101_allcombined	619745	619777		exuR	32
RK1001.C0101_allcombined	620048	620056		exuR	8
RK1001.C0101_allcombined	621841	621847		YPO_RS03880	6
RK1001.C0101_allcombined	622969	622970		uxaC	1
RK1001.C0101_allcombined	623410	623431		uxaC	21
RK1001.C0101_allcombined	623533	623535		uxaC	2
RK1001.C0101_allcombined	623723	623726		uxaC	3
RK1001.C0101_allcombined	623883	623886		uxaC	3
RK1001.C0101_allcombined	624044	624048		uxaC	4
RK1001.C0101_allcombined	624537	624551		YPO_RS03890	14
RK1001.C0101_allcombined	624771	624781		YPO_RS03890	10
RK1001.C0101_allcombined	624982	624984		YPO_RS03890	2
RK1001.C0101_allcombined	626051	626075		YPO_RS03895	24
RK1001.C0101_allcombined	626144	626169		YPO_RS03895	25
RK1001.C0101_allcombined	626290	626294		YPO_RS03895	4
RK1001.C0101_allcombined	626680	626724		YPO_RS03895	44
RK1001.C0101_allcombined	626854	626862		YPO_RS03895	8
RK1001.C0101_allcombined	626921	626932		YPO_RS03895	11
RK1001.C0101_allcombined	627141	627156		YPO_RS03895	15
RK1001.C0101_allcombined	628274	628283		YPO_RS03905	9
RK1001.C0101_allcombined	628520	628537		YPO_RS03905	17
RK1001.C0101_allcombined	628827	628831		sstT	4
RK1001.C0101_allcombined	629123	629130		sstT	7
RK1001.C0101_allcombined	629180	629183		sstT	3
RK1001.C0101_allcombined	629541	629561		sstT	20
RK1001.C0101_allcombined	630053	630073		sstT	20
RK1001.C0101_allcombined	630771	630793		YPO_RS03915	22
RK1001.C0101_allcombined	631469	631474		YPO_RS03915	5
RK1001.C0101_allcombined	631819	631821		YPO_RS03920	2
RK1001.C0101_allcombined	632196	632211		YPO_RS03920	15
RK1001.C0101_allcombined	632319	632325		YPO_RS03920	6
RK1001.C0101_allcombined	632599	632604		yapG	5
RK1001.C0101_allcombined	632786	632802		yapG	16
RK1001.C0101_allcombined	633059	633087		yapG	28
RK1001.C0101_allcombined	633657	633660		yapG	3
RK1001.C0101_allcombined	634188	634218		yapG	30
RK1001.C0101_allcombined	634303	634321		yapG	18
RK1001.C0101_allcombined	634444	634467		yapG	23
RK1001.C0101_allcombined	634505	634532		yapG	27
RK1001.C0101_allcombined	634584	634607		yapG	23
RK1001.C0101_allcombined	634734	634748		yapG	14
RK1001.C0101_allcombined	634783	634813		yapG	30
RK1001.C0101_allcombined	634943	634944		yapG	1
RK1001.C0101_allcombined	635068	635096		yapG	28
RK1001.C0101_allcombined	635169	635192		yapG	23
RK1001.C0101_allcombined	635466	635548		yapG	82
RK1001.C0101_allcombined	636805	636808		rlmG	3
RK1001.C0101_allcombined	637190	637193		rlmG	3
RK1001.C0101_allcombined	637683	637708		YPO_RS03935	25
RK1001.C0101_allcombined	637738	637755		YPO_RS03935	17
RK1001.C0101_allcombined	639137	639160		YPO_RS03935	23
RK1001.C0101_allcombined	639331	639332		YPO_RS03935	1
RK1001.C0101_allcombined	639773	639786		YPO_RS03940	13
RK1001.C0101_allcombined	640656	640665		YPO_RS03945	9
RK1001.C0101_allcombined	641194	641198		YPO_RS03945	4
RK1001.C0101_allcombined	641718	641723		YPO_RS03945	5
RK1001.C0101_allcombined	641894	641905		YPO_RS03945	11
RK1001.C0101_allcombined	642070	642071		YPO_RS03950	1
RK1001.C0101_allcombined	642227	642240		YPO_RS03950	13
RK1001.C0101_allcombined	642280	642282		YPO_RS03950	2
RK1001.C0101_allcombined	642355	642366		YPO_RS03950	11
RK1001.C0101_allcombined	642486	642524		YPO_RS03950	38
RK1001.C0101_allcombined	643344	643375		YPO_RS03950	31
RK1001.C0101_allcombined	643700	643707		YPO_RS03950	7
RK1001.C0101_allcombined	644363	644382		YPO_RS03955	19
RK1001.C0101_allcombined	644812	644817		YPO_RS03955	5
RK1001.C0101_allcombined	645196	645215		YPO_RS03960	19
RK1001.C0101_allcombined	645245	645254		YPO_RS03960	9
RK1001.C0101_allcombined	645296	645300		YPO_RS03960	4
RK1001.C0101_allcombined	646233	646262		YPO_RS03970	29
RK1001.C0101_allcombined	646830	646871		YPO_RS03970	41
RK1001.C0101_allcombined	649985	649989		cdiA	4
RK1001.C0101_allcombined	650529	650538		cdiA	9
RK1001.C0101_allcombined	650707	650719		cdiA	12
RK1001.C0101_allcombined	650760	650763		cdiA	3
RK1001.C0101_allcombined	651681	651683		cdiA	2
RK1001.C0101_allcombined	651954	651955		cdiA	1
RK1001.C0101_allcombined	652454	652462		cdiA	8
RK1001.C0101_allcombined	652815	652842		cdiA	27
RK1001.C0101_allcombined	653690	653696		cdiA	6
RK1001.C0101_allcombined	654139	654172		cdiA	33
RK1001.C0101_allcombined	654388	654420		cdiA	32
RK1001.C0101_allcombined	654771	654778		cdiA	7
RK1001.C0101_allcombined	655498	655501		cdiA	3
RK1001.C0101_allcombined	655672	655674		cdiA	2
RK1001.C0101_allcombined	656399	656401		cdiA	2
RK1001.C0101_allcombined	658571	658572		cdiA	1
RK1001.C0101_allcombined	658653	658654		cdiA	1
RK1001.C0101_allcombined	659002	659005		cdiA	3
RK1001.C0101_allcombined	659202	659206		cdiA	4
RK1001.C0101_allcombined	659203	659295		cdiI	92
RK1001.C0101_allcombined	659359	659436		cdiI	77
RK1001.C0101_allcombined	659728	659756		YPO_RS03995	28
RK1001.C0101_allcombined	659828	659835		YPO_RS03995	7
RK1001.C0101_allcombined	659953	659965		YPO_RS04000	12
RK1001.C0101_allcombined	660130	660213		YPO_RS04005	83
RK1001.C0101_allcombined	660431	660438		YPO_RS04005	7
RK1001.C0101_allcombined	660478	660485		YPO_RS04010	7
RK1001.C0101_allcombined	661419	661421		YPO_RS04015	2
RK1001.C0101_allcombined	661844	661855		yapF	11
RK1001.C0101_allcombined	661997	662003		yapF	6
RK1001.C0101_allcombined	662089	662094		yapF	5
RK1001.C0101_allcombined	662389	662401		yapF	12
RK1001.C0101_allcombined	662510	662516		yapF	6
RK1001.C0101_allcombined	663213	663221		yapF	8
RK1001.C0101_allcombined	663268	663298		yapF	30
RK1001.C0101_allcombined	663937	663944		yapF	7
RK1001.C0101_allcombined	664729	664740		YPO_RS04025	11
RK1001.C0101_allcombined	665394	665396		YPO_RS04030	2
RK1001.C0101_allcombined	666269	666291		YPO_RS04030	22
RK1001.C0101_allcombined	666536	666546		YPO_RS04030	10
RK1001.C0101_allcombined	666884	666893		YPO_RS04035	9
RK1001.C0101_allcombined	668655	668673		YPO_RS04040	18
RK1001.C0101_allcombined	669083	669090		YPO_RS04040	7
RK1001.C0101_allcombined	669189	669204		YPO_RS04040	15
RK1001.C0101_allcombined	669672	669679		YPO_RS04040	7
RK1001.C0101_allcombined	669815	669816		YPO_RS04040	1
RK1001.C0101_allcombined	670723	670746		YPO_RS04040	23
RK1001.C0101_allcombined	670939	670940		YPO_RS04040	1
RK1001.C0101_allcombined	671145	671157		YPO_RS04040	12
RK1001.C0101_allcombined	671236	671240		YPO_RS04040	4
RK1001.C0101_allcombined	671279	671284		YPO_RS04040	5
RK1001.C0101_allcombined	671583	671607		YPO_RS04045	24
RK1001.C0101_allcombined	672371	672400		YPO_RS04045	29
RK1001.C0101_allcombined	672515	672518		YPO_RS04045	3
RK1001.C0101_allcombined	672595	672600		YPO_RS04050	5
RK1001.C0101_allcombined	672738	672778		YPO_RS04050	40
RK1001.C0101_allcombined	674138	674139		YPO_RS04055	1
RK1001.C0101_allcombined	674508	674516		YPO_RS04055	8
RK1001.C0101_allcombined	674633	674639		YPO_RS04055	6
RK1001.C0101_allcombined	674735	674741		YPO_RS04055	6
RK1001.C0101_allcombined	674805	674870		YPO_RS04060	65
RK1001.C0101_allcombined	675231	675242		YPO_RS04060	11
RK1001.C0101_allcombined	675377	675379		YPO_RS04060	2
RK1001.C0101_allcombined	677265	677278		YPO_RS04070	13
RK1001.C0101_allcombined	677839	677840		YPO_RS04070	1
RK1001.C0101_allcombined	677940	677949		YPO_RS04070	9
RK1001.C0101_allcombined	678030	678034		YPO_RS04070	4
RK1001.C0101_allcombined	678330	678338		YPO_RS04070	8
RK1001.C0101_allcombined	678556	678570		YPO_RS04075	14
RK1001.C0101_allcombined	679094	679097		YPO_RS04075	3
RK1001.C0101_allcombined	679347	679349		YPO_RS04075	2
RK1001.C0101_allcombined	679599	679610		YPO_RS04075	11
RK1001.C0101_allcombined	679926	679928		YPO_RS04075	2
RK1001.C0101_allcombined	679964	679999		YPO_RS04080	35
RK1001.C0101_allcombined	680343	680350		YPO_RS04080	7
RK1001.C0101_allcombined	680406	680430		YPO_RS04080	24
RK1001.C0101_allcombined	680616	680618		YPO_RS04080	2
RK1001.C0101_allcombined	681047	681063		YPO_RS04080	16
RK1001.C0101_allcombined	681185	681188		YPO_RS04080	3
RK1001.C0101_allcombined	681636	681655		YPO_RS04080	19
RK1001.C0101_allcombined	682056	682074		mdtN	18
RK1001.C0101_allcombined	682153	682162		mdtN	9
RK1001.C0101_allcombined	682338	682344		mdtN	6
RK1001.C0101_allcombined	682528	682535		mdtN	7
RK1001.C0101_allcombined	682732	682777		mdtN	45
RK1001.C0101_allcombined	682882	682893		YPO_RS04090	11
RK1001.C0101_allcombined	683067	683081		YPO_RS04090	14
RK1001.C0101_allcombined	683384	683400		YPO_RS04095	16
RK1001.C0101_allcombined	684175	684176		YPO_RS04100	1
RK1001.C0101_allcombined	684250	684291		YPO_RS04100	41
RK1001.C0101_allcombined	684379	684403		YPO_RS04100	24
RK1001.C0101_allcombined	684552	684605		YPO_RS04100	53
RK1001.C0101_allcombined	684910	684913		YPO_RS04100	3
RK1001.C0101_allcombined	685003	685014		YPO_RS04100	11
RK1001.C0101_allcombined	685181	685220		YPO_RS04100	39
RK1001.C0101_allcombined	685314	685315		YPO_RS04100	1
RK1001.C0101_allcombined	685628	685673		YPO_RS04105	45
RK1001.C0101_allcombined	685773	685810		YPO_RS04105	37
RK1001.C0101_allcombined	685928	685938		YPO_RS04105	10
RK1001.C0101_allcombined	686191	686243		YPO_RS04105	52
RK1001.C0101_allcombined	686321	686328		YPO_RS04105	7
RK1001.C0101_allcombined	686626	686720		YPO_RS04105	94
RK1001.C0101_allcombined	686864	686896		YPO_RS04110	32
RK1001.C0101_allcombined	687069	687086		YPO_RS04110	17
RK1001.C0101_allcombined	687121	687197		YPO_RS04110	76
RK1001.C0101_allcombined	687456	687485		YPO_RS04115	29
RK1001.C0101_allcombined	687538	687573		YPO_RS04115	35
RK1001.C0101_allcombined	687658	687661		YPO_RS04115	3
RK1001.C0101_allcombined	687698	687736		YPO_RS04115	38
RK1001.C0101_allcombined	688001	688009		YPO_RS04115	8
RK1001.C0101_allcombined	688191	688225		YPO_RS04120	34
RK1001.C0101_allcombined	688268	688368		YPO_RS04120	100
RK1001.C0101_allcombined	688445	688457		YPO_RS04120	12
RK1001.C0101_allcombined	689522	689529		YPO_RS04130	7
RK1001.C0101_allcombined	690055	690068		YPO_RS04135	13
RK1001.C0101_allcombined	690159	690170		YPO_RS04135	11
RK1001.C0101_allcombined	690608	690626		YPO_RS04135	18
RK1001.C0101_allcombined	691619	691624		YPO_RS04140	5
RK1001.C0101_allcombined	693833	693869		YPO_RS04160	36
RK1001.C0101_allcombined	696051	696060		YPO_RS04170	9
RK1001.C0101_allcombined	696363	696381		YPO_RS04170	18
RK1001.C0101_allcombined	696691	696712		YPO_RS04170	21
RK1001.C0101_allcombined	696905	696928		YPO_RS04170	23
RK1001.C0101_allcombined	697071	697101		YPO_RS04170	30
RK1001.C0101_allcombined	697202	697205		YPO_RS04175	3
RK1001.C0101_allcombined	697417	697450		YPO_RS04175	33
RK1001.C0101_allcombined	697528	697589		YPO_RS04175	61
RK1001.C0101_allcombined	697616	697622		YPO_RS04180	6
RK1001.C0101_allcombined	697934	697944		YPO_RS04180	10
RK1001.C0101_allcombined	698019	698039		YPO_RS04180	20
RK1001.C0101_allcombined	699553	699555		rpoD	2
RK1001.C0101_allcombined	699680	699685		rpoD	5
RK1001.C0101_allcombined	700088	700109		rpoD	21
RK1001.C0101_allcombined	701465	701471		dnaG	6
RK1001.C0101_allcombined	701599	701614		dnaG	15
RK1001.C0101_allcombined	701981	701998		dnaG	17
RK1001.C0101_allcombined	702208	702235		dnaG	27
RK1001.C0101_allcombined	702626	702628		dnaG	2
RK1001.C0101_allcombined	702676	702678		dnaG	2
RK1001.C0101_allcombined	703713	703715		tsaD	2
RK1001.C0101_allcombined	703799	703800		tsaD	1
RK1001.C0101_allcombined	704709	704724		tsaD	15
RK1001.C0101_allcombined	705053	705065		plsY	12
RK1001.C0101_allcombined	705296	705322		plsY	26
RK1001.C0101_allcombined	705616	705620		plsY	4
RK1001.C0101_allcombined	705813	705815		folB	2
RK1001.C0101_allcombined	707783	707787		YPO_RS04230	4
RK1001.C0101_allcombined	708315	708316		YPO_RS04230	1
RK1001.C0101_allcombined	708519	708594		YPO_RS04230	75
RK1001.C0101_allcombined	708632	708652		YPO_RS04230	20
RK1001.C0101_allcombined	708914	708929		YPO_RS04235	15
RK1001.C0101_allcombined	710471	710490		YPO_RS04240	19
RK1001.C0101_allcombined	712545	712604		glnE	59
RK1001.C0101_allcombined	713299	713323		glnE	24
RK1001.C0101_allcombined	714518	714528		hldE	10
RK1001.C0101_allcombined	714767	714768		hldE	1
RK1001.C0101_allcombined	714820	714821		hldE	1
RK1001.C0101_allcombined	714892	714920		hldE	28
RK1001.C0101_allcombined	715082	715105		hldE	23
RK1001.C0101_allcombined	715573	715577		hldE	4
RK1001.C0101_allcombined	715876	715891		yjeH	15
RK1001.C0101_allcombined	716179	716184		yjeH	5
RK1001.C0101_allcombined	716356	716358		yjeH	2
RK1001.C0101_allcombined	716519	716524		yjeH	5
RK1001.C0101_allcombined	719365	719377		ygiD	12
RK1001.C0101_allcombined	719445	719450		ygiD	5
RK1001.C0101_allcombined	719582	719625		ygiD	43
RK1001.C0101_allcombined	719935	719945		ygiD	10
RK1001.C0101_allcombined	720403	720413		YPO_RS04275	10
RK1001.C0101_allcombined	720707	720713		YPO_RS04275	6
RK1001.C0101_allcombined	720774	720786		YPO_RS04275	12
RK1001.C0101_allcombined	721111	721116		YPO_RS04275	5
RK1001.C0101_allcombined	721465	721471		YPO_RS04275	6
RK1001.C0101_allcombined	720865	720907		YPO_RS04275	42
RK1001.C0101_allcombined	722936	722940		tolC	4
RK1001.C0101_allcombined	723375	723405		tolC	30
RK1001.C0101_allcombined	724353	724372		nudF	19
RK1001.C0101_allcombined	724554	724558		nudF	4
RK1001.C0101_allcombined	725075	725076		YPO_RS04295	1
RK1001.C0101_allcombined	725563	725569		cpdA	6
RK1001.C0101_allcombined	726101	726110		cpdA	9
RK1001.C0101_allcombined	726214	726264		cpdA	50
RK1001.C0101_allcombined	726695	726700		yqiA	5
RK1001.C0101_allcombined	727046	727056		parE	10
RK1001.C0101_allcombined	727231	727277		parE	46
RK1001.C0101_allcombined	727344	727421		parE	77
RK1001.C0101_allcombined	727747	727758		parE	11
RK1001.C0101_allcombined	728343	728364		parE	21
RK1001.C0101_allcombined	728464	728481		parE	17
RK1001.C0101_allcombined	728562	728578		parE	16
RK1001.C0101_allcombined	729057	729067		YPO_RS04315	10
RK1001.C0101_allcombined	729356	729366		YPO_RS04315	10
RK1001.C0101_allcombined	730306	730344		YPO_RS04320	38
RK1001.C0101_allcombined	731961	731992		parC	31
RK1001.C0101_allcombined	732111	732114		parC	3
RK1001.C0101_allcombined	732148	732171		parC	23
RK1001.C0101_allcombined	733566	733572		YPO_RS04335	6
RK1001.C0101_allcombined	733649	733659		YPO_RS04335	10
RK1001.C0101_allcombined	733767	733769		YPO_RS04335	2
RK1001.C0101_allcombined	733899	733906		YPO_RS04335	7
RK1001.C0101_allcombined	734338	734373		ftsP	35
RK1001.C0101_allcombined	734585	734593		ftsP	8
RK1001.C0101_allcombined	735161	735168		ftsP	7
RK1001.C0101_allcombined	735217	735238		ftsP	21
RK1001.C0101_allcombined	735337	735361		ftsP	24
RK1001.C0101_allcombined	738362	738371		dkgA	9
RK1001.C0101_allcombined	738489	738510		dkgA	21
RK1001.C0101_allcombined	738874	738877		dkgA	3
RK1001.C0101_allcombined	739184	739189		dkgA	5
RK1001.C0101_allcombined	739351	739365		YPO_RS04355	14
RK1001.C0101_allcombined	739505	739510		YPO_RS04355	5
RK1001.C0101_allcombined	739997	740009		yqhD	12
RK1001.C0101_allcombined	740159	740179		yqhD	20
RK1001.C0101_allcombined	740221	740222		yqhD	1
RK1001.C0101_allcombined	741311	741379		YPO_RS04365	68
RK1001.C0101_allcombined	741514	741517		YPO_RS04365	3
RK1001.C0101_allcombined	741967	741969		YPO_RS04365	2
RK1001.C0101_allcombined	742256	742270		YPO_RS04370	14
RK1001.C0101_allcombined	742360	742361		YPO_RS04370	1
RK1001.C0101_allcombined	742710	742738		YPO_RS04370	28
RK1001.C0101_allcombined	743205	743217		metC	12
RK1001.C0101_allcombined	743615	743637		metC	22
RK1001.C0101_allcombined	743796	743806		metC	10
RK1001.C0101_allcombined	744120	744144		metC	24
RK1001.C0101_allcombined	744819	744825		exbB	6
RK1001.C0101_allcombined	744976	744981		exbB	5
RK1001.C0101_allcombined	746131	746134		exbD	3
RK1001.C0101_allcombined	746275	746296		YPO_RS04390	21
RK1001.C0101_allcombined	746334	746400		YPO_RS04390	66
RK1001.C0101_allcombined	746473	746475		YPO_RS04390	2
RK1001.C0101_allcombined	746667	746672		YPO_RS04390	5
RK1001.C0101_allcombined	746802	746941		YPO_RS04390	139
RK1001.C0101_allcombined	747063	747109		YPO_RS04390	46
RK1001.C0101_allcombined	747171	747184		YPO_RS04390	13
RK1001.C0101_allcombined	747240	747259		YPO_RS04390	19
RK1001.C0101_allcombined	747407	747436		YPO_RS04390	29
RK1001.C0101_allcombined	747577	747606		YPO_RS04390	29
RK1001.C0101_allcombined	747759	747822		YPO_RS04390	63
RK1001.C0101_allcombined	747903	747914		YPO_RS04395	11
RK1001.C0101_allcombined	747948	747949		YPO_RS04395	1
RK1001.C0101_allcombined	748433	748471		YPO_RS04400	38
RK1001.C0101_allcombined	748515	748627		YPO_RS04400	112
RK1001.C0101_allcombined	748687	748698		YPO_RS04400	11
RK1001.C0101_allcombined	748812	748841		YPO_RS04400	29
RK1001.C0101_allcombined	748947	748958		YPO_RS04405	11
RK1001.C0101_allcombined	749040	749080		YPO_RS04405	40
RK1001.C0101_allcombined	749274	749333		YPO_RS04405	59
RK1001.C0101_allcombined	749471	749542		YPO_RS04405	71
RK1001.C0101_allcombined	749624	749645		YPO_RS04405	21
RK1001.C0101_allcombined	749629	749664		YPO_RS04410	35
RK1001.C0101_allcombined	749713	749717		YPO_RS04410	4
RK1001.C0101_allcombined	749898	749910		YPO_RS04410	12
RK1001.C0101_allcombined	749973	750002		YPO_RS04410	29
RK1001.C0101_allcombined	750129	750151		YPO_RS04410	22
RK1001.C0101_allcombined	750189	750210		YPO_RS04410	21
RK1001.C0101_allcombined	750263	750284		YPO_RS04410	21
RK1001.C0101_allcombined	750371	750430		YPO_RS04410	59
RK1001.C0101_allcombined	750461	750462		YPO_RS04410	1
RK1001.C0101_allcombined	750461	750543		YPO_RS04415	82
RK1001.C0101_allcombined	750573	750645		YPO_RS04415	72
RK1001.C0101_allcombined	750714	750806		YPO_RS04415	92
RK1001.C0101_allcombined	750889	750899		YPO_RS04415	10
RK1001.C0101_allcombined	751108	751221		YPO_RS04415	113
RK1001.C0101_allcombined	751415	751430		YPO_RS04420	15
RK1001.C0101_allcombined	751894	751911		YPO_RS04420	17
RK1001.C0101_allcombined	751998	752000		YPO_RS04420	2
RK1001.C0101_allcombined	752059	752087		YPO_RS04420	28
RK1001.C0101_allcombined	752122	752135		YPO_RS04420	13
RK1001.C0101_allcombined	752364	752393		YPO_RS04420	29
RK1001.C0101_allcombined	752427	752475		YPO_RS04420	48
RK1001.C0101_allcombined	752528	752600		YPO_RS04420	72
RK1001.C0101_allcombined	752716	752723		YPO_RS04425	7
RK1001.C0101_allcombined	752826	752882		YPO_RS04425	56
RK1001.C0101_allcombined	753076	753093		YPO_RS04425	17
RK1001.C0101_allcombined	753227	753260		YPO_RS04425	33
RK1001.C0101_allcombined	753331	753359		YPO_RS04425	28
RK1001.C0101_allcombined	753402	753417		YPO_RS04425	15
RK1001.C0101_allcombined	753512	753591		YPO_RS04425	79
RK1001.C0101_allcombined	753665	753712		YPO_RS04425	47
RK1001.C0101_allcombined	753784	753831		YPO_RS04430	47
RK1001.C0101_allcombined	753877	753884		YPO_RS04430	7
RK1001.C0101_allcombined	753918	753956		YPO_RS04430	38
RK1001.C0101_allcombined	754124	754161		YPO_RS04435	37
RK1001.C0101_allcombined	754449	754453		YPO_RS04435	4
RK1001.C0101_allcombined	754520	754559		YPO_RS04440	39
RK1001.C0101_allcombined	754622	754684		YPO_RS04440	62
RK1001.C0101_allcombined	754843	754864		YPO_RS04440	21
RK1001.C0101_allcombined	754990	755003		YPO_RS04440	13
RK1001.C0101_allcombined	755057	755072		YPO_RS04440	15
RK1001.C0101_allcombined	755241	755245		YPO_RS04440	4
RK1001.C0101_allcombined	755341	755372		YPO_RS04440	31
RK1001.C0101_allcombined	755369	755399		YPO_RS04445	30
RK1001.C0101_allcombined	755444	755452		YPO_RS04445	8
RK1001.C0101_allcombined	755566	755586		YPO_RS04445	20
RK1001.C0101_allcombined	755643	755812		YPO_RS04445	169
RK1001.C0101_allcombined	755904	755916		YPO_RS04445	12
RK1001.C0101_allcombined	756108	756157		YPO_RS04445	49
RK1001.C0101_allcombined	756199	756200		YPO_RS04445	1
RK1001.C0101_allcombined	756287	756302		YPO_RS04450	15
RK1001.C0101_allcombined	756527	756608		YPO_RS04450	81
RK1001.C0101_allcombined	756677	756707		YPO_RS04450	30
RK1001.C0101_allcombined	758430	758458		YPO_RS04465	28
RK1001.C0101_allcombined	758903	758904		YPO_RS04465	1
RK1001.C0101_allcombined	759965	759969		YPO_RS04465	4
RK1001.C0101_allcombined	760523	760545		YPO_RS04465	22
RK1001.C0101_allcombined	760660	760679		YPO_RS04465	19
RK1001.C0101_allcombined	760840	760846		YPO_RS04465	6
RK1001.C0101_allcombined	761336	761346		YPO_RS04470	10
RK1001.C0101_allcombined	761558	761577		YPO_RS04470	19
RK1001.C0101_allcombined	762043	762045		YPO_RS04475	2
RK1001.C0101_allcombined	762220	762223		YPO_RS04475	3
RK1001.C0101_allcombined	762463	762492		YPO_RS04475	29
RK1001.C0101_allcombined	763016	763048		fepB	32
RK1001.C0101_allcombined	763260	763301		fepB	41
RK1001.C0101_allcombined	763698	763728		fepB	30
RK1001.C0101_allcombined	763790	763799		fepB	9
RK1001.C0101_allcombined	764033	764069		fepB	36
RK1001.C0101_allcombined	764925	764932		YPO_RS04485	7
RK1001.C0101_allcombined	764998	765015		YPO_RS04485	17
RK1001.C0101_allcombined	765152	765164		YPO_RS04485	12
RK1001.C0101_allcombined	765901	765920		YPO_RS04485	19
RK1001.C0101_allcombined	766215	766223		YPO_RS04490	8
RK1001.C0101_allcombined	769321	769356		flhB	35
RK1001.C0101_allcombined	769869	769882		flhB	13
RK1001.C0101_allcombined	770010	770020		YPO_RS04505	10
RK1001.C0101_allcombined	770069	770076		YPO_RS04505	7
RK1001.C0101_allcombined	771679	771681		fliP	2
RK1001.C0101_allcombined	771720	771736		fliP	16
RK1001.C0101_allcombined	771864	771873		fliN	9
RK1001.C0101_allcombined	772022	772057		fliN	35
RK1001.C0101_allcombined	772506	772621		YPO_RS04525	115
RK1001.C0101_allcombined	772832	772835		YPO_RS04525	3
RK1001.C0101_allcombined	772955	773009		YPO_RS04525	54
RK1001.C0101_allcombined	773097	773122		YPO_RS04525	25
RK1001.C0101_allcombined	773770	773863		YPO_RS04530	93
RK1001.C0101_allcombined	774248	774278		YPO_RS04530	30
RK1001.C0101_allcombined	774493	774534		YPO_RS04530	41
RK1001.C0101_allcombined	775052	775084		fliE	32
RK1001.C0101_allcombined	775094	775125		fliF	31
RK1001.C0101_allcombined	776517	776530		fliF	13
RK1001.C0101_allcombined	776749	776782		YPO_RS04545	33
RK1001.C0101_allcombined	777440	777451		YPO_RS04545	11
RK1001.C0101_allcombined	777786	777787		YPO_RS04550	1
RK1001.C0101_allcombined	778071	778077		YPO_RS04550	6
RK1001.C0101_allcombined	779312	779315		fliI	3
RK1001.C0101_allcombined	779643	779665		fliI	22
RK1001.C0101_allcombined	780156	780159		fliJ	3
RK1001.C0101_allcombined	780878	780886		YPO_RS04565	8
RK1001.C0101_allcombined	780986	780988		flgM	2
RK1001.C0101_allcombined	782005	782017		flgA	12
RK1001.C0101_allcombined	782235	782267		flgA	32
RK1001.C0101_allcombined	782402	782408		flgB	6
RK1001.C0101_allcombined	782649	782668		flgB	19
RK1001.C0101_allcombined	784636	784646		flaE	10
RK1001.C0101_allcombined	784688	784696		flaE	8
RK1001.C0101_allcombined	784773	784781		flaE	8
RK1001.C0101_allcombined	784817	784819		flaE	2
RK1001.C0101_allcombined	785169	785179		flaE	10
RK1001.C0101_allcombined	785289	785340		YPO_RS04600	51
RK1001.C0101_allcombined	785689	785691		YPO_RS04605	2
RK1001.C0101_allcombined	785757	785781		YPO_RS04605	24
RK1001.C0101_allcombined	786029	786036		flgF	7
RK1001.C0101_allcombined	786146	786147		flgF	1
RK1001.C0101_allcombined	786335	786341		flgF	6
RK1001.C0101_allcombined	787157	787159		flgG	2
RK1001.C0101_allcombined	788673	788679		YPO_RS04625	6
RK1001.C0101_allcombined	789389	789404		flgJ	15
RK1001.C0101_allcombined	789483	789487		flgJ	4
RK1001.C0101_allcombined	789920	789963		flgK	43
RK1001.C0101_allcombined	790220	790221		flgK	1
RK1001.C0101_allcombined	790294	790350		flgK	56
RK1001.C0101_allcombined	790404	790422		flgK	18
RK1001.C0101_allcombined	790850	790853		flgK	3
RK1001.C0101_allcombined	791026	791041		flgK	15
RK1001.C0101_allcombined	791127	791141		flgK	14
RK1001.C0101_allcombined	791170	791228		flgL	58
RK1001.C0101_allcombined	791448	791451		flgL	3
RK1001.C0101_allcombined	791699	791751		flgL	52
RK1001.C0101_allcombined	791835	791871		flgL	36
RK1001.C0101_allcombined	791907	791916		flgL	9
RK1001.C0101_allcombined	792018	792034		flgL	16
RK1001.C0101_allcombined	792081	792093		flgL	12
RK1001.C0101_allcombined	792130	792139		YPO_RS04645	9
RK1001.C0101_allcombined	792745	792750		YPO_RS04645	5
RK1001.C0101_allcombined	793465	793552		YPO_RS04650	87
RK1001.C0101_allcombined	793672	793723		YPO_RS04650	51
RK1001.C0101_allcombined	793709	793723		YPO_RS04655	14
RK1001.C0101_allcombined	793774	793805		YPO_RS04655	31
RK1001.C0101_allcombined	793881	793887		YPO_RS04655	6
RK1001.C0101_allcombined	793918	793966		YPO_RS04655	48
RK1001.C0101_allcombined	794724	794726		YPO_RS04655	2
RK1001.C0101_allcombined	795863	795880		YPO_RS04660	17
RK1001.C0101_allcombined	796055	796094		YPO_RS04660	39
RK1001.C0101_allcombined	796155	796159		YPO_RS04660	4
RK1001.C0101_allcombined	797889	797901		YPO_RS04665	12
RK1001.C0101_allcombined	798597	798615		YPO_RS04670	18
RK1001.C0101_allcombined	799194	799209		YPO_RS04670	15
RK1001.C0101_allcombined	800089	800098		fliD	9
RK1001.C0101_allcombined	800329	800336		fliD	7
RK1001.C0101_allcombined	800701	800702		fliD	1
RK1001.C0101_allcombined	800900	800911		fliD	11
RK1001.C0101_allcombined	801015	801018		fliD	3
RK1001.C0101_allcombined	801066	801076		fliD	10
RK1001.C0101_allcombined	801162	801197		fliD	35
RK1001.C0101_allcombined	801456	801500		fliS	44
RK1001.C0101_allcombined	801572	801574		fliS	2
RK1001.C0101_allcombined	801964	801973		YPO_RS04685	9
RK1001.C0101_allcombined	802095	802123		YPO_RS04690	28
RK1001.C0101_allcombined	802196	802202		YPO_RS04690	6
RK1001.C0101_allcombined	802653	802706		YPO_RS04690	53
RK1001.C0101_allcombined	803029	803036		YPO_RS04690	7
RK1001.C0101_allcombined	803164	803195		YPO_RS04690	31
RK1001.C0101_allcombined	803265	803276		YPO_RS04695	11
RK1001.C0101_allcombined	803326	803365		YPO_RS04695	39
RK1001.C0101_allcombined	803419	803432		YPO_RS04695	13
RK1001.C0101_allcombined	803570	803585		YPO_RS04695	15
RK1001.C0101_allcombined	803698	803704		YPO_RS04695	6
RK1001.C0101_allcombined	803710	803716		YPO_RS04700	6
RK1001.C0101_allcombined	803880	803896		YPO_RS04700	16
RK1001.C0101_allcombined	804207	804232		YPO_RS04700	25
RK1001.C0101_allcombined	804325	804398		YPO_RS04700	73
RK1001.C0101_allcombined	804656	804658		motA	2
RK1001.C0101_allcombined	805053	805058		motA	5
RK1001.C0101_allcombined	805823	805857		lafU	34
RK1001.C0101_allcombined	805934	805942		lafU	8
RK1001.C0101_allcombined	806114	806127		lafU	13
RK1001.C0101_allcombined	806658	806669		YPO_RS04715	11
RK1001.C0101_allcombined	806763	806776		YPO_RS04715	13
RK1001.C0101_allcombined	806986	806994		YPO_RS04715	8
RK1001.C0101_allcombined	807451	807463		YPO_RS04720	12
RK1001.C0101_allcombined	807607	807658		YPO_RS04720	51
RK1001.C0101_allcombined	807742	807744		YPO_RS04725	2
RK1001.C0101_allcombined	807801	807817		YPO_RS04725	16
RK1001.C0101_allcombined	807853	807857		YPO_RS04725	4
RK1001.C0101_allcombined	807996	808004		YPO_RS04725	8
RK1001.C0101_allcombined	808961	809074		YPO_RS04735	113
RK1001.C0101_allcombined	809173	809228		YPO_RS04735	55
RK1001.C0101_allcombined	810818	810819		YPO_RS04740	1
RK1001.C0101_allcombined	811104	811115		YPO_RS04740	11
RK1001.C0101_allcombined	811104	811115		YPO_RS04745	11
RK1001.C0101_allcombined	811350	811364		YPO_RS04745	14
RK1001.C0101_allcombined	811512	811520		YPO_RS04745	8
RK1001.C0101_allcombined	811755	811765		YPO_RS04745	10
RK1001.C0101_allcombined	811978	811983		YPO_RS04745	5
RK1001.C0101_allcombined	812723	812759		YPO_RS04750	36
RK1001.C0101_allcombined	812905	812911		YPO_RS04750	6
RK1001.C0101_allcombined	813060	813079		YPO_RS04750	19
RK1001.C0101_allcombined	813188	813218		YPO_RS04750	30
RK1001.C0101_allcombined	813374	813377		YPO_RS04750	3
RK1001.C0101_allcombined	813981	813983		YPO_RS04755	2
RK1001.C0101_allcombined	814097	814114		YPO_RS04755	17
RK1001.C0101_allcombined	814376	814392		YPO_RS04755	16
RK1001.C0101_allcombined	815131	815132		YPO_RS04755	1
RK1001.C0101_allcombined	816363	816455		YPO_RS04765	92
RK1001.C0101_allcombined	816487	816490		YPO_RS04765	3
RK1001.C0101_allcombined	816577	816594		YPO_RS04765	17
RK1001.C0101_allcombined	816676	816685		YPO_RS04765	9
RK1001.C0101_allcombined	816723	816737		YPO_RS04765	14
RK1001.C0101_allcombined	816868	816977		YPO_RS04770	109
RK1001.C0101_allcombined	817176	817193		YPO_RS04770	17
RK1001.C0101_allcombined	817977	817980		YPO_RS04770	3
RK1001.C0101_allcombined	818569	818575		YPO_RS04770	6
RK1001.C0101_allcombined	819760	819798		YPO_RS04770	38
RK1001.C0101_allcombined	820042	820055		YPO_RS04770	13
RK1001.C0101_allcombined	821093	821102		YPO_RS04770	9
RK1001.C0101_allcombined	821465	821474		YPO_RS04775	9
RK1001.C0101_allcombined	822176	822183		YPO_RS04775	7
RK1001.C0101_allcombined	822289	822302		YPO_RS04775	13
RK1001.C0101_allcombined	822489	822517		YPO_RS04775	28
RK1001.C0101_allcombined	822582	822623		vgrG	41
RK1001.C0101_allcombined	822655	822657		vgrG	2
RK1001.C0101_allcombined	822730	822737		vgrG	7
RK1001.C0101_allcombined	822869	822877		vgrG	8
RK1001.C0101_allcombined	823309	823313		vgrG	4
RK1001.C0101_allcombined	823851	823852		vgrG	1
RK1001.C0101_allcombined	830689	830699		gntP	10
RK1001.C0101_allcombined	831413	831434		gntP	21
RK1001.C0101_allcombined	833177	833189		YPO_RS04795	12
RK1001.C0101_allcombined	833274	833292		YPO_RS04795	18
RK1001.C0101_allcombined	834043	834118		YPO_RS04800	75
RK1001.C0101_allcombined	834353	834427		YPO_RS04800	74
RK1001.C0101_allcombined	835158	835186		YPO_RS04805	28
RK1001.C0101_allcombined	835719	835745		YPO_RS04805	26
RK1001.C0101_allcombined	835823	835845		YPO_RS04805	22
RK1001.C0101_allcombined	835924	835975		YPO_RS04805	51
RK1001.C0101_allcombined	836041	836045		YPO_RS04805	4
RK1001.C0101_allcombined	836090	836099		YPO_RS04805	9
RK1001.C0101_allcombined	836182	836215		YPO_RS04805	33
RK1001.C0101_allcombined	836410	836416		YPO_RS04805	6
RK1001.C0101_allcombined	836455	836465		YPO_RS04805	10
RK1001.C0101_allcombined	836613	836617		YPO_RS04805	4
RK1001.C0101_allcombined	836661	836664		YPO_RS04805	3
RK1001.C0101_allcombined	837244	837268		YPO_RS04810	24
RK1001.C0101_allcombined	837348	837355		YPO_RS04810	7
RK1001.C0101_allcombined	837663	837675		YPO_RS04810	12
RK1001.C0101_allcombined	837720	837723		YPO_RS04810	3
RK1001.C0101_allcombined	837839	837854		YPO_RS04810	15
RK1001.C0101_allcombined	837985	837989		YPO_RS04810	4
RK1001.C0101_allcombined	838174	838185		YPO_RS04810	11
RK1001.C0101_allcombined	838386	838395		YPO_RS04810	9
RK1001.C0101_allcombined	838658	838673		YPO_RS04815	15
RK1001.C0101_allcombined	839443	839445		YPO_RS04815	2
RK1001.C0101_allcombined	839622	839625		YPO_RS04815	3
RK1001.C0101_allcombined	839969	839973		YPO_RS04820	4
RK1001.C0101_allcombined	840178	840180		YPO_RS04820	2
RK1001.C0101_allcombined	840879	840890		YPO_RS04825	11
RK1001.C0101_allcombined	841122	841128		YPO_RS04825	6
RK1001.C0101_allcombined	841216	841224		YPO_RS04825	8
RK1001.C0101_allcombined	841549	841575		YPO_RS04825	26
RK1001.C0101_allcombined	842074	842090		YPO_RS04830	16
RK1001.C0101_allcombined	842260	842277		YPO_RS04830	17
RK1001.C0101_allcombined	842620	842623		YPO_RS04830	3
RK1001.C0101_allcombined	843354	843363		YPO_RS04835	9
RK1001.C0101_allcombined	843453	843483		YPO_RS04835	30
RK1001.C0101_allcombined	843634	843665		YPO_RS04835	31
RK1001.C0101_allcombined	843831	843849		YPO_RS04835	18
RK1001.C0101_allcombined	844559	844607		YPO_RS04835	48
RK1001.C0101_allcombined	844886	844896		YPO_RS04835	10
RK1001.C0101_allcombined	845037	845057		YPO_RS04835	20
RK1001.C0101_allcombined	845397	845410		YPO_RS04835	13
RK1001.C0101_allcombined	845453	845472		YPO_RS04835	19
RK1001.C0101_allcombined	845530	845540		YPO_RS04835	10
RK1001.C0101_allcombined	845594	845639		YPO_RS04835	45
RK1001.C0101_allcombined	845751	845782		YPO_RS04835	31
RK1001.C0101_allcombined	845995	846009		YPO_RS04835	14
RK1001.C0101_allcombined	846426	846432		YPO_RS04835	6
RK1001.C0101_allcombined	846638	846651		YPO_RS04835	13
RK1001.C0101_allcombined	846769	846773		YPO_RS04835	4
RK1001.C0101_allcombined	846834	846841		YPO_RS04835	7
RK1001.C0101_allcombined	846894	846905		YPO_RS04835	11
RK1001.C0101_allcombined	847031	847083		YPO_RS04835	52
RK1001.C0101_allcombined	847200	847204		YPO_RS04835	4
RK1001.C0101_allcombined	847445	847446		YPO_RS04835	1
RK1001.C0101_allcombined	847798	847801		YPO_RS04835	3
RK1001.C0101_allcombined	848601	848622		YPO_RS04835	21
RK1001.C0101_allcombined	848851	848855		YPO_RS04840	4
RK1001.C0101_allcombined	849081	849091		YPO_RS04840	10
RK1001.C0101_allcombined	849544	849547		YPO_RS04840	3
RK1001.C0101_allcombined	849689	849692		YPO_RS04840	3
RK1001.C0101_allcombined	849728	849730		YPO_RS04840	2
RK1001.C0101_allcombined	850088	850091		YPO_RS04840	3
RK1001.C0101_allcombined	850251	850261		YPO_RS04840	10
RK1001.C0101_allcombined	850356	850361		YPO_RS04845	5
RK1001.C0101_allcombined	850905	850922		YPO_RS04845	17
RK1001.C0101_allcombined	850979	850988		YPO_RS04845	9
RK1001.C0101_allcombined	851051	851061		YPO_RS04845	10
RK1001.C0101_allcombined	851561	851568		YPO_RS04845	7
RK1001.C0101_allcombined	852510	852527		YPO_RS04845	17
RK1001.C0101_allcombined	852658	852685		YPO_RS04845	27
RK1001.C0101_allcombined	852716	852718		YPO_RS04845	2
RK1001.C0101_allcombined	852852	852862		YPO_RS04845	10
RK1001.C0101_allcombined	852922	852940		YPO_RS04845	18
RK1001.C0101_allcombined	853147	853155		YPO_RS04845	8
RK1001.C0101_allcombined	853280	853293		YPO_RS04845	13
RK1001.C0101_allcombined	853374	853410		YPO_RS04845	36
RK1001.C0101_allcombined	853668	853686		YPO_RS04845	18
RK1001.C0101_allcombined	853767	853775		YPO_RS04845	8
RK1001.C0101_allcombined	854242	854259		YPO_RS04845	17
RK1001.C0101_allcombined	854583	854591		YPO_RS04845	8
RK1001.C0101_allcombined	854658	854679		YPO_RS04845	21
RK1001.C0101_allcombined	854908	854943		YPO_RS04845	35
RK1001.C0101_allcombined	854987	855004		YPO_RS04845	17
RK1001.C0101_allcombined	856113	856139		YPO_RS04845	26
RK1001.C0101_allcombined	856425	856436		YPO_RS04845	11
RK1001.C0101_allcombined	856521	856559		YPO_RS04845	38
RK1001.C0101_allcombined	856658	856667		YPO_RS04845	9
RK1001.C0101_allcombined	858731	858778		YPO_RS04855	47
RK1001.C0101_allcombined	858884	858887		YPO_RS04860	3
RK1001.C0101_allcombined	859124	859176		YPO_RS04860	52
RK1001.C0101_allcombined	859544	859597		thyA	53
RK1001.C0101_allcombined	860476	860516		lgt	40
RK1001.C0101_allcombined	860709	860729		lgt	20
RK1001.C0101_allcombined	860984	860987		lgt	3
RK1001.C0101_allcombined	861699	861705		ptsP	6
RK1001.C0101_allcombined	863094	863119		ptsP	25
RK1001.C0101_allcombined	863800	863808		rppH	8
RK1001.C0101_allcombined	863881	863928		rppH	47
RK1001.C0101_allcombined	864032	864061		rppH	29
RK1001.C0101_allcombined	864956	864959		mutH	3
RK1001.C0101_allcombined	865197	865200		mutH	3
RK1001.C0101_allcombined	867825	867849		YPO_RS04900	24
RK1001.C0101_allcombined	868215	868218		lplT	3
RK1001.C0101_allcombined	870199	870208		aas	9
RK1001.C0101_allcombined	870431	870464		aas	33
RK1001.C0101_allcombined	870991	870992		aas	1
RK1001.C0101_allcombined	871138	871154		aas	16
RK1001.C0101_allcombined	871957	871964		YPO_RS04915	7
RK1001.C0101_allcombined	872141	872145		YPO_RS04915	4
RK1001.C0101_allcombined	872203	872220		YPO_RS04915	17
RK1001.C0101_allcombined	872308	872348		YPO_RS04915	40
RK1001.C0101_allcombined	872595	872632		YPO_RS04915	37
RK1001.C0101_allcombined	872803	872821		YPO_RS04915	18
RK1001.C0101_allcombined	873228	873240		YPO_RS04915	12
RK1001.C0101_allcombined	874017	874020		YPO_RS04915	3
RK1001.C0101_allcombined	874781	874815		galR	34
RK1001.C0101_allcombined	875898	875903		lysA	5
RK1001.C0101_allcombined	876074	876088		lysA	14
RK1001.C0101_allcombined	876502	876515		lysA	13
RK1001.C0101_allcombined	878686	878726		YPO_RS04935	40
RK1001.C0101_allcombined	879520	879521		YPO_RS04940	1
RK1001.C0101_allcombined	879708	879742		YPO_RS04940	34
RK1001.C0101_allcombined	880543	880559		YPO_RS04945	16
RK1001.C0101_allcombined	880824	880858		YPO_RS04945	34
RK1001.C0101_allcombined	881054	881062		YPO_RS04945	8
RK1001.C0101_allcombined	881596	881597		YPO_RS04950	1
RK1001.C0101_allcombined	881755	881771		YPO_RS04950	16
RK1001.C0101_allcombined	882006	882039		YPO_RS04955	33
RK1001.C0101_allcombined	882531	882535		YPO_RS04955	4
RK1001.C0101_allcombined	882763	882769		YPO_RS04955	6
RK1001.C0101_allcombined	882806	882816		YPO_RS04955	10
RK1001.C0101_allcombined	883043	883073		YPO_RS04955	30
RK1001.C0101_allcombined	883476	883525		YPO_RS04955	49
RK1001.C0101_allcombined	883587	883601		YPO_RS04955	14
RK1001.C0101_allcombined	883835	884003		YPO_RS04960	168
RK1001.C0101_allcombined	884076	884136		YPO_RS04960	60
RK1001.C0101_allcombined	884204	884220		YPO_RS04965	16
RK1001.C0101_allcombined	884327	884398		YPO_RS04965	71
RK1001.C0101_allcombined	884475	884508		YPO_RS04965	33
RK1001.C0101_allcombined	884549	884557		YPO_RS04965	8
RK1001.C0101_allcombined	884610	884613		YPO_RS04965	3
RK1001.C0101_allcombined	884661	884678		YPO_RS04965	17
RK1001.C0101_allcombined	884824	884907		YPO_RS04965	83
RK1001.C0101_allcombined	884716	884750		YPO_RS04965	34
RK1001.C0101_allcombined	885548	885591		YPO_RS04975	43
RK1001.C0101_allcombined	885654	885734		YPO_RS04975	80
RK1001.C0101_allcombined	885782	885785		YPO_RS04975	3
RK1001.C0101_allcombined	886022	886032		YPO_RS04975	10
RK1001.C0101_allcombined	886067	886099		YPO_RS04975	32
RK1001.C0101_allcombined	886152	886189		YPO_RS04975	37
RK1001.C0101_allcombined	886246	886324		YPO_RS04975	78
RK1001.C0101_allcombined	886372	886390		YPO_RS04975	18
RK1001.C0101_allcombined	886475	886735		YPO_RS04980	260
RK1001.C0101_allcombined	886769	886794		YPO_RS04980	25
RK1001.C0101_allcombined	886874	886885		gspL	11
RK1001.C0101_allcombined	886964	887133		gspL	169
RK1001.C0101_allcombined	887222	887256		gspL	34
RK1001.C0101_allcombined	887549	887601		gspL	52
RK1001.C0101_allcombined	887723	887772		gspL	49
RK1001.C0101_allcombined	887806	887829		gspL	23
RK1001.C0101_allcombined	887890	887902		gspL	12
RK1001.C0101_allcombined	888106	888253		YPO_RS04990	147
RK1001.C0101_allcombined	888364	888430		YPO_RS04990	66
RK1001.C0101_allcombined	888485	888559		YPO_RS04990	74
RK1001.C0101_allcombined	888680	888710		YPO_RS04990	30
RK1001.C0101_allcombined	888740	888747		YPO_RS04990	7
RK1001.C0101_allcombined	888787	888801		YPO_RS04990	14
RK1001.C0101_allcombined	888930	888969		YPO_RS04990	39
RK1001.C0101_allcombined	889013	889014		gspJ	1
RK1001.C0101_allcombined	889085	889089		gspJ	4
RK1001.C0101_allcombined	889122	889172		gspJ	50
RK1001.C0101_allcombined	889308	889401		gspJ	93
RK1001.C0101_allcombined	889449	889531		gspJ	82
RK1001.C0101_allcombined	889606	889609		gspJ	3
RK1001.C0101_allcombined	889606	889626		gspI	20
RK1001.C0101_allcombined	889676	889699		gspI	23
RK1001.C0101_allcombined	889951	889957		gspI	6
RK1001.C0101_allcombined	889997	890038		YPO_RS05005	41
RK1001.C0101_allcombined	890068	890075		YPO_RS05005	7
RK1001.C0101_allcombined	890147	890211		YPO_RS05005	64
RK1001.C0101_allcombined	890242	890275		YPO_RS05005	33
RK1001.C0101_allcombined	890430	890465		YPO_RS05005	35
RK1001.C0101_allcombined	890611	890612		gspG	1
RK1001.C0101_allcombined	890659	890673		gspG	14
RK1001.C0101_allcombined	890793	890801		gspG	8
RK1001.C0101_allcombined	890934	890942		gspG	8
RK1001.C0101_allcombined	892187	892211		gspE	24
RK1001.C0101_allcombined	892368	892399		gspE	31
RK1001.C0101_allcombined	892933	892964		gspE	31
RK1001.C0101_allcombined	893070	893071		gspE	1
RK1001.C0101_allcombined	893188	893218		gspE	30
RK1001.C0101_allcombined	893271	893287		gspE	16
RK1001.C0101_allcombined	893435	893436		gspE	1
RK1001.C0101_allcombined	893702	893809		gspD	107
RK1001.C0101_allcombined	893861	893892		gspD	31
RK1001.C0101_allcombined	893937	893946		gspD	9
RK1001.C0101_allcombined	894002	894016		gspD	14
RK1001.C0101_allcombined	894055	894104		gspD	49
RK1001.C0101_allcombined	894266	894273		gspD	7
RK1001.C0101_allcombined	894315	894340		gspD	25
RK1001.C0101_allcombined	894436	894491		gspD	55
RK1001.C0101_allcombined	894597	894619		gspD	22
RK1001.C0101_allcombined	894748	894806		gspD	58
RK1001.C0101_allcombined	894841	894892		gspD	51
RK1001.C0101_allcombined	894946	895023		gspD	77
RK1001.C0101_allcombined	895087	895091		gspD	4
RK1001.C0101_allcombined	895179	895186		gspD	7
RK1001.C0101_allcombined	895216	895239		gspD	23
RK1001.C0101_allcombined	895364	895606		gspD	242
RK1001.C0101_allcombined	895696	895702		YPO_RS05030	6
RK1001.C0101_allcombined	895736	895815		YPO_RS05030	79
RK1001.C0101_allcombined	895905	895937		YPO_RS05030	32
RK1001.C0101_allcombined	896033	896063		YPO_RS05030	30
RK1001.C0101_allcombined	896103	896149		YPO_RS05030	46
RK1001.C0101_allcombined	896179	896190		YPO_RS05030	11
RK1001.C0101_allcombined	896258	896325		YPO_RS05035	67
RK1001.C0101_allcombined	896407	896491		YPO_RS05035	84
RK1001.C0101_allcombined	896548	896575		YPO_RS05035	27
RK1001.C0101_allcombined	896609	896674		YPO_RS05035	65
RK1001.C0101_allcombined	897436	897446		YPO_RS05040	10
RK1001.C0101_allcombined	897615	897616		YPO_RS05040	1
RK1001.C0101_allcombined	897966	897992		YPO_RS05040	26
RK1001.C0101_allcombined	898797	898806		YPO_RS05045	9
RK1001.C0101_allcombined	899723	899759		YPO_RS05050	36
RK1001.C0101_allcombined	900058	900066		YPO_RS05050	8
RK1001.C0101_allcombined	900366	900409		YPO_RS05050	43
RK1001.C0101_allcombined	900744	900761		yapM	17
RK1001.C0101_allcombined	900829	900881		yapM	52
RK1001.C0101_allcombined	901157	901243		yapM	86
RK1001.C0101_allcombined	901280	901366		yapM	86
RK1001.C0101_allcombined	901489	901527		yapM	38
RK1001.C0101_allcombined	901738	901774		yapM	36
RK1001.C0101_allcombined	902037	902047		yapM	10
RK1001.C0101_allcombined	902376	902385		yapM	9
RK1001.C0101_allcombined	902552	902561		yapM	9
RK1001.C0101_allcombined	902620	902635		yapM	15
RK1001.C0101_allcombined	902826	902827		YPO_RS05060	1
RK1001.C0101_allcombined	903352	903355		YPO_RS05060	3
RK1001.C0101_allcombined	903480	903514		YPO_RS05060	34
RK1001.C0101_allcombined	903724	903728		YPO_RS05060	4
RK1001.C0101_allcombined	903777	903785		YPO_RS05060	8
RK1001.C0101_allcombined	903919	903932		YPO_RS05060	13
RK1001.C0101_allcombined	904132	904143		YPO_RS05060	11
RK1001.C0101_allcombined	904954	904979		YPO_RS05060	25
RK1001.C0101_allcombined	905177	905204		YPO_RS05060	27
RK1001.C0101_allcombined	905297	905299		YPO_RS05060	2
RK1001.C0101_allcombined	905610	905624		YPO_RS05060	14
RK1001.C0101_allcombined	907351	907360		YPO_RS05070	9
RK1001.C0101_allcombined	908126	908136		tnpA	10
RK1001.C0101_allcombined	908505	908507		tnpA	2
RK1001.C0101_allcombined	909125	909185		YPO_RS05080	60
RK1001.C0101_allcombined	909266	909267		YPO_RS05080	1
RK1001.C0101_allcombined	909515	909534		YPO_RS05080	19
RK1001.C0101_allcombined	909802	909823		YPO_RS05080	21
RK1001.C0101_allcombined	910026	910034		YPO_RS05080	8
RK1001.C0101_allcombined	910093	910095		YPO_RS05080	2
RK1001.C0101_allcombined	910139	910170		YPO_RS05080	31
RK1001.C0101_allcombined	910224	910249		YPO_RS05080	25
RK1001.C0101_allcombined	910346	910367		YPO_RS05080	21
RK1001.C0101_allcombined	912118	912151		YPO_RS05085	33
RK1001.C0101_allcombined	912201	912209		kbaZ	8
RK1001.C0101_allcombined	913747	913750		YPO_RS05095	3
RK1001.C0101_allcombined	914103	914104		YPO_RS05095	1
RK1001.C0101_allcombined	914145	914208		YPO_RS05095	63
RK1001.C0101_allcombined	914530	914532		YPO_RS05095	2
RK1001.C0101_allcombined	916082	916100		YPO_RS05110	18
RK1001.C0101_allcombined	916353	916354		YPO_RS05110	1
RK1001.C0101_allcombined	916512	916519		YPO_RS05110	7
RK1001.C0101_allcombined	917572	917582		nagA	10
RK1001.C0101_allcombined	918459	918461		nagA	2
RK1001.C0101_allcombined	918976	918984		kduD	8
RK1001.C0101_allcombined	919224	919279		kduD	55
RK1001.C0101_allcombined	919698	919699		YPO_RS05130	1
RK1001.C0101_allcombined	921037	921039		YPO_RS05135	2
RK1001.C0101_allcombined	922221	922222		YPO_RS05140	1
RK1001.C0101_allcombined	922256	922261		YPO_RS05140	5
RK1001.C0101_allcombined	922304	922307		YPO_RS05140	3
RK1001.C0101_allcombined	922502	922505		YPO_RS05140	3
RK1001.C0101_allcombined	923133	923143		YPO_RS05140	10
RK1001.C0101_allcombined	923499	923508		YPO_RS05140	9
RK1001.C0101_allcombined	923540	923596		YPO_RS05140	56
RK1001.C0101_allcombined	923635	923675		YPO_RS05140	40
RK1001.C0101_allcombined	923904	923925		YPO_RS05145	21
RK1001.C0101_allcombined	924072	924084		YPO_RS05145	12
RK1001.C0101_allcombined	924587	924616		YPO_RS05145	29
RK1001.C0101_allcombined	924738	924753		YPO_RS05145	15
RK1001.C0101_allcombined	924904	924911		YPO_RS05145	7
RK1001.C0101_allcombined	925038	925071		YPO_RS05145	33
RK1001.C0101_allcombined	925152	925167		YPO_RS05145	15
RK1001.C0101_allcombined	926040	926053		YPO_RS05150	13
RK1001.C0101_allcombined	926193	926204		YPO_RS05150	11
RK1001.C0101_allcombined	926723	926767		YPO_RS05155	44
RK1001.C0101_allcombined	926865	926885		YPO_RS05155	20
RK1001.C0101_allcombined	927665	927691		YPO_RS05160	26
RK1001.C0101_allcombined	927970	927976		YPO_RS05160	6
RK1001.C0101_allcombined	928126	928208		YPO_RS05160	82
RK1001.C0101_allcombined	928602	928611		YPO_RS05165	9
RK1001.C0101_allcombined	928704	928731		YPO_RS05165	27
RK1001.C0101_allcombined	929072	929093		YPO_RS05165	21
RK1001.C0101_allcombined	929264	929284		YPO_RS05165	20
RK1001.C0101_allcombined	930215	930216		YPO_RS05170	1
RK1001.C0101_allcombined	930376	930397		YPO_RS05170	21
RK1001.C0101_allcombined	931134	931142		YPO_RS05170	8
RK1001.C0101_allcombined	931243	931247		YPO_RS05170	4
RK1001.C0101_allcombined	931281	931302		YPO_RS05170	21
RK1001.C0101_allcombined	931516	931520		YPO_RS05170	4
RK1001.C0101_allcombined	931797	931806		YPO_RS05170	9
RK1001.C0101_allcombined	932976	932985		YPO_RS05175	9
RK1001.C0101_allcombined	933373	933375		YPO_RS05175	2
RK1001.C0101_allcombined	933471	933475		YPO_RS05175	4
RK1001.C0101_allcombined	933513	933516		YPO_RS05175	3
RK1001.C0101_allcombined	934325	934326		YPO_RS05180	1
RK1001.C0101_allcombined	934359	934366		YPO_RS05180	7
RK1001.C0101_allcombined	934589	934602		YPO_RS05180	13
RK1001.C0101_allcombined	934804	934815		YPO_RS05180	11
RK1001.C0101_allcombined	934886	934902		YPO_RS05180	16
RK1001.C0101_allcombined	934954	934957		YPO_RS05180	3
RK1001.C0101_allcombined	935157	935172		YPO_RS05180	15
RK1001.C0101_allcombined	935334	935368		YPO_RS05180	34
RK1001.C0101_allcombined	935883	935894		YPO_RS05185	11
RK1001.C0101_allcombined	935943	935970		YPO_RS05185	27
RK1001.C0101_allcombined	936248	936257		YPO_RS05190	9
RK1001.C0101_allcombined	937402	937408		YPO_RS05190	6
RK1001.C0101_allcombined	937497	937517		YPO_RS05190	20
RK1001.C0101_allcombined	937651	937655		YPO_RS05190	4
RK1001.C0101_allcombined	937860	937864		YPO_RS05190	4
RK1001.C0101_allcombined	937962	937996		YPO_RS05190	34
RK1001.C0101_allcombined	938476	938479		YPO_RS05195	3
RK1001.C0101_allcombined	938765	938772		YPO_RS05195	7
RK1001.C0101_allcombined	938803	938810		YPO_RS05195	7
RK1001.C0101_allcombined	938969	938994		YPO_RS05195	25
RK1001.C0101_allcombined	939111	939122		YPO_RS05195	11
RK1001.C0101_allcombined	939350	939352		YPO_RS05195	2
RK1001.C0101_allcombined	939490	939559		YPO_RS05200	69
RK1001.C0101_allcombined	940214	940257		YPO_RS05200	43
RK1001.C0101_allcombined	940458	940462		YPO_RS05205	4
RK1001.C0101_allcombined	940901	940916		YPO_RS05205	15
RK1001.C0101_allcombined	941004	941014		YPO_RS05205	10
RK1001.C0101_allcombined	941080	941103		YPO_RS05205	23
RK1001.C0101_allcombined	941325	941336		YPO_RS05205	11
RK1001.C0101_allcombined	941456	941459		YPO_RS05205	3
RK1001.C0101_allcombined	942031	942033		YPO_RS05210	2
RK1001.C0101_allcombined	942459	942500		YPO_RS05210	41
RK1001.C0101_allcombined	942752	942777		YPO_RS05210	25
RK1001.C0101_allcombined	943026	943047		YPO_RS05210	21
RK1001.C0101_allcombined	943546	943547		YPO_RS05215	1
RK1001.C0101_allcombined	943968	943974		YPO_RS05215	6
RK1001.C0101_allcombined	944177	944189		YPO_RS05215	12
RK1001.C0101_allcombined	944281	944291		YPO_RS05215	10
RK1001.C0101_allcombined	944342	944346		YPO_RS05215	4
RK1001.C0101_allcombined	945245	945257		YPO_RS05220	12
RK1001.C0101_allcombined	945838	945842		YPO_RS05220	4
RK1001.C0101_allcombined	945950	945968		YPO_RS05220	18
RK1001.C0101_allcombined	946173	946176		YPO_RS05220	3
RK1001.C0101_allcombined	946264	946271		YPO_RS05220	7
RK1001.C0101_allcombined	946326	946341		YPO_RS05220	15
RK1001.C0101_allcombined	946390	946402		YPO_RS05220	12
RK1001.C0101_allcombined	946485	946489		YPO_RS05220	4
RK1001.C0101_allcombined	946639	946644		YPO_RS05225	5
RK1001.C0101_allcombined	946830	946831		YPO_RS05225	1
RK1001.C0101_allcombined	947168	947190		YPO_RS05225	22
RK1001.C0101_allcombined	947324	947342		YPO_RS05225	18
RK1001.C0101_allcombined	947641	947643		YPO_RS05225	2
RK1001.C0101_allcombined	948242	948259		YPO_RS05230	17
RK1001.C0101_allcombined	948334	948336		YPO_RS05230	2
RK1001.C0101_allcombined	948831	948842		YPO_RS05230	11
RK1001.C0101_allcombined	948942	948949		YPO_RS05230	7
RK1001.C0101_allcombined	949935	949940		YPO_RS05235	5
RK1001.C0101_allcombined	950006	950008		YPO_RS05235	2
RK1001.C0101_allcombined	950117	950209		YPO_RS05235	92
RK1001.C0101_allcombined	951180	951208		YPO_RS05240	28
RK1001.C0101_allcombined	952309	952332		YPO_RS05245	23
RK1001.C0101_allcombined	952698	952709		YPO_RS05245	11
RK1001.C0101_allcombined	952756	952787		YPO_RS05250	31
RK1001.C0101_allcombined	952937	952945		YPO_RS05250	8
RK1001.C0101_allcombined	953011	953025		YPO_RS05250	14
RK1001.C0101_allcombined	953147	953149		YPO_RS05255	2
RK1001.C0101_allcombined	953266	953273		YPO_RS05255	7
RK1001.C0101_allcombined	953357	953382		YPO_RS05255	25
RK1001.C0101_allcombined	953641	953721		YPO_RS05260	80
RK1001.C0101_allcombined	953755	953764		YPO_RS05260	9
RK1001.C0101_allcombined	953823	953838		YPO_RS05260	15
RK1001.C0101_allcombined	953957	953971		YPO_RS05260	14
RK1001.C0101_allcombined	954027	954069		YPO_RS05260	42
RK1001.C0101_allcombined	954115	954149		YPO_RS05260	34
RK1001.C0101_allcombined	954294	954306		YPO_RS05260	12
RK1001.C0101_allcombined	954384	954417		YPO_RS05260	33
RK1001.C0101_allcombined	955312	955317		YPO_RS05265	5
RK1001.C0101_allcombined	955843	955888		YPO_RS05270	45
RK1001.C0101_allcombined	956142	956143		YPO_RS05270	1
RK1001.C0101_allcombined	956271	956291		YPO_RS05270	20
RK1001.C0101_allcombined	956613	956616		YPO_RS05270	3
RK1001.C0101_allcombined	956820	956824		YPO_RS05270	4
RK1001.C0101_allcombined	957630	957642		YPO_RS05270	12
RK1001.C0101_allcombined	957751	957756		YPO_RS05270	5
RK1001.C0101_allcombined	957810	957815		YPO_RS05270	5
RK1001.C0101_allcombined	957850	957862		YPO_RS05270	12
RK1001.C0101_allcombined	958339	958523		YPO_RS05275	184
RK1001.C0101_allcombined	958761	958767		YPO_RS05280	6
RK1001.C0101_allcombined	959235	959236		YPO_RS05285	1
RK1001.C0101_allcombined	959318	959385		YPO_RS05285	67
RK1001.C0101_allcombined	959538	959544		YPO_RS05290	6
RK1001.C0101_allcombined	959585	959617		YPO_RS05290	32
RK1001.C0101_allcombined	959650	959667		YPO_RS05290	17
RK1001.C0101_allcombined	959749	959756		YPO_RS05290	7
RK1001.C0101_allcombined	960572	960586		YPO_RS05290	14
RK1001.C0101_allcombined	960649	960659		YPO_RS05290	10
RK1001.C0101_allcombined	960951	960957		YPO_RS05290	6
RK1001.C0101_allcombined	961521	961530		YPO_RS05295	9
RK1001.C0101_allcombined	961601	961602		YPO_RS05295	1
RK1001.C0101_allcombined	961843	961870		YPO_RS05295	27
RK1001.C0101_allcombined	961959	961992		YPO_RS05295	33
RK1001.C0101_allcombined	962482	962508		YPO_RS05295	26
RK1001.C0101_allcombined	962591	962610		YPO_RS05295	19
RK1001.C0101_allcombined	963236	963243		YPO_RS05300	7
RK1001.C0101_allcombined	963466	963493		YPO_RS05305	27
RK1001.C0101_allcombined	963558	963561		YPO_RS05310	3
RK1001.C0101_allcombined	964129	964131		YPO_RS05315	2
RK1001.C0101_allcombined	964242	964246		YPO_RS05320	4
RK1001.C0101_allcombined	964434	964440		YPO_RS05325	6
RK1001.C0101_allcombined	964525	964535		YPO_RS05325	10
RK1001.C0101_allcombined	964565	964570		YPO_RS05325	5
RK1001.C0101_allcombined	964686	964690		YPO_RS05325	4
RK1001.C0101_allcombined	965776	965777		YPO_RS05330	1
RK1001.C0101_allcombined	967689	967703		YPO_RS05335	14
RK1001.C0101_allcombined	968169	968191		YPO_RS05340	22
RK1001.C0101_allcombined	968344	968365		YPO_RS05340	21
RK1001.C0101_allcombined	968634	968647		YPO_RS05345	13
RK1001.C0101_allcombined	968972	968974		YPO_RS05350	2
RK1001.C0101_allcombined	969037	969049		YPO_RS05350	12
RK1001.C0101_allcombined	969108	969113		YPO_RS05350	5
RK1001.C0101_allcombined	969871	969875		YPO_RS05355	4
RK1001.C0101_allcombined	969931	969946		YPO_RS05355	15
RK1001.C0101_allcombined	970182	970183		YPO_RS05360	1
RK1001.C0101_allcombined	970216	970224		YPO_RS05360	8
RK1001.C0101_allcombined	970494	970497		YPO_RS05360	3
RK1001.C0101_allcombined	971812	971836		lysS	24
RK1001.C0101_allcombined	972005	972007		lysS	2
RK1001.C0101_allcombined	972409	972442		lysS	33
RK1001.C0101_allcombined	972939	972960		lysS	21
RK1001.C0101_allcombined	973784	973800		prfB	16
RK1001.C0101_allcombined	974334	974369		prfB	35
RK1001.C0101_allcombined	975226	975227		recJ	1
RK1001.C0101_allcombined	977212	977229		xerD	17
RK1001.C0101_allcombined	977442	977453		xerD	11
RK1001.C0101_allcombined	978147	978193		fldB	46
RK1001.C0101_allcombined	978533	978534		fldB	1
RK1001.C0101_allcombined	978713	978722		creD	9
RK1001.C0101_allcombined	979112	979127		creD	15
RK1001.C0101_allcombined	979435	979446		creD	11
RK1001.C0101_allcombined	979565	979576		creD	11
RK1001.C0101_allcombined	979643	979655		creD	12
RK1001.C0101_allcombined	980039	980042		creD	3
RK1001.C0101_allcombined	980335	980352		creC	17
RK1001.C0101_allcombined	980421	980437		creC	16
RK1001.C0101_allcombined	980805	980815		creC	10
RK1001.C0101_allcombined	981509	981533		creC	24
RK1001.C0101_allcombined	981874	981886		creB	12
RK1001.C0101_allcombined	982032	982041		creB	9
RK1001.C0101_allcombined	982496	982509		YPO_RS05415	13
RK1001.C0101_allcombined	982668	982690		YPO_RS05415	22
RK1001.C0101_allcombined	983535	983542		ygfZ	7
RK1001.C0101_allcombined	984297	984304		ygfZ	7
RK1001.C0101_allcombined	984422	984467		YPO_RS05430	45
RK1001.C0101_allcombined	984540	984558		YPO_RS05430	18
RK1001.C0101_allcombined	984649	984654		YPO_RS05430	5
RK1001.C0101_allcombined	984796	984833		YPO_RS05430	37
RK1001.C0101_allcombined	985284	985302		YPO_RS05435	18
RK1001.C0101_allcombined	985538	985539		YPO_RS05435	1
RK1001.C0101_allcombined	985874	985878		YPO_RS05435	4
RK1001.C0101_allcombined	986219	986229		YPO_RS05440	10
RK1001.C0101_allcombined	986538	986557		YPO_RS05440	19
RK1001.C0101_allcombined	986747	986764		YPO_RS05440	17
RK1001.C0101_allcombined	986948	986962		YPO_RS05440	14
RK1001.C0101_allcombined	990604	990617		YPO_RS05455	13
RK1001.C0101_allcombined	990807	990815		YPO_RS05455	8
RK1001.C0101_allcombined	991588	991589		gcvP	1
RK1001.C0101_allcombined	993139	993149		gcvP	10
RK1001.C0101_allcombined	993524	993535		gcvP	11
RK1001.C0101_allcombined	993884	993887		gcvP	3
RK1001.C0101_allcombined	994441	994457		gcvH	16
RK1001.C0101_allcombined	994652	994656		gcvH	4
RK1001.C0101_allcombined	994755	994765		gcvH	10
RK1001.C0101_allcombined	995912	995913		gcvT	1
RK1001.C0101_allcombined	997362	997374		ubiI	12
RK1001.C0101_allcombined	997626	997628		ubiI	2
RK1001.C0101_allcombined	999292	999295		pepP	3
RK1001.C0101_allcombined	999673	999683		pepP	10
RK1001.C0101_allcombined	1000318	1000333		pepP	15
RK1001.C0101_allcombined	1001206	1001219		YPO_RS05490	13
RK1001.C0101_allcombined	1001788	1001790		zapA	2
RK1001.C0101_allcombined	1001855	1001856		zapA	1
RK1001.C0101_allcombined	1002045	1002047		ssrS	2
RK1001.C0101_allcombined	1002705	1002707		YPO_RS05505	2
RK1001.C0101_allcombined	1003413	1003436		serA	23
RK1001.C0101_allcombined	1003797	1003798		serA	1
RK1001.C0101_allcombined	1003841	1003850		serA	9
RK1001.C0101_allcombined	1004970	1004996		rpiA	26
RK1001.C0101_allcombined	1005149	1005167		rpiA	18
RK1001.C0101_allcombined	1005326	1005342		rpiA	16
RK1001.C0101_allcombined	1006472	1006489		YPO_RS05520	17
RK1001.C0101_allcombined	1006826	1006850		YPO_RS05525	24
RK1001.C0101_allcombined	1006963	1006964		YPO_RS05525	1
RK1001.C0101_allcombined	1007720	1007743		argO	23
RK1001.C0101_allcombined	1007785	1007795		argO	10
RK1001.C0101_allcombined	1008752	1008754		mscS	2
RK1001.C0101_allcombined	1008843	1008852		mscS	9
RK1001.C0101_allcombined	1008982	1008984		mscS	2
RK1001.C0101_allcombined	1009074	1009075		mscS	1
RK1001.C0101_allcombined	1009256	1009263		mscS	7
RK1001.C0101_allcombined	1009317	1009329		mscS	12
RK1001.C0101_allcombined	1010179	1010189		fbaA	10
RK1001.C0101_allcombined	1010347	1010387		fbaA	40
RK1001.C0101_allcombined	1010832	1010852		fbaA	20
RK1001.C0101_allcombined	1012289	1012293		epd	4
RK1001.C0101_allcombined	1012332	1012347		epd	15
RK1001.C0101_allcombined	1012429	1012439		epd	10
RK1001.C0101_allcombined	1012976	1012987		epd	11
RK1001.C0101_allcombined	1015331	1015335		YPO_RS05560	4
RK1001.C0101_allcombined	1015564	1015568		YPO_RS05565	4
RK1001.C0101_allcombined	1015918	1015935		YPO_RS05565	17
RK1001.C0101_allcombined	1016514	1016526		tkt	12
RK1001.C0101_allcombined	1016853	1016858		tkt	5
RK1001.C0101_allcombined	1017748	1017751		tkt	3
RK1001.C0101_allcombined	1017954	1017967		tkt	13
RK1001.C0101_allcombined	1017999	1018010		tkt	11
RK1001.C0101_allcombined	1019789	1019811		YPO_RS05580	22
RK1001.C0101_allcombined	1019981	1019998		YPO_RS05585	17
RK1001.C0101_allcombined	1020626	1020628		speA	2
RK1001.C0101_allcombined	1020668	1020692		speA	24
RK1001.C0101_allcombined	1020995	1021005		speA	10
RK1001.C0101_allcombined	1021179	1021199		speA	20
RK1001.C0101_allcombined	1021918	1021942		speA	24
RK1001.C0101_allcombined	1022202	1022221		speA	19
RK1001.C0101_allcombined	1023523	1023549		metK	26
RK1001.C0101_allcombined	1023673	1023697		metK	24
RK1001.C0101_allcombined	1023778	1023780		metK	2
RK1001.C0101_allcombined	1024531	1024557		metK	26
RK1001.C0101_allcombined	1025110	1025115		YPO_RS05600	5
RK1001.C0101_allcombined	1025326	1025341		YPO_RS05600	15
RK1001.C0101_allcombined	1025525	1025531		endA	6
RK1001.C0101_allcombined	1026065	1026067		endA	2
RK1001.C0101_allcombined	1026468	1026470		rsmE	2
RK1001.C0101_allcombined	1026576	1026583		rsmE	7
RK1001.C0101_allcombined	1026682	1026688		rsmE	6
RK1001.C0101_allcombined	1026959	1026970		rsmE	11
RK1001.C0101_allcombined	1027196	1027209		gshB	13
RK1001.C0101_allcombined	1027307	1027313		gshB	6
RK1001.C0101_allcombined	1027483	1027497		gshB	14
RK1001.C0101_allcombined	1027596	1027602		gshB	6
RK1001.C0101_allcombined	1028027	1028036		gshB	9
RK1001.C0101_allcombined	1028628	1028644		YPO_RS05620	16
RK1001.C0101_allcombined	1029045	1029048		ruvX	3
RK1001.C0101_allcombined	1029659	1029684		aguB	25
RK1001.C0101_allcombined	1030804	1030811		aguA	7
RK1001.C0101_allcombined	1030943	1030945		aguA	2
RK1001.C0101_allcombined	1031221	1031229		aguA	8
RK1001.C0101_allcombined	1032621	1032641		YPO_RS05640	20
RK1001.C0101_allcombined	1032174	1032219		YPO_RS05640	45
RK1001.C0101_allcombined	1033388	1033390		YPO_RS05645	2
RK1001.C0101_allcombined	1033694	1033714		YPO_RS05650	20
RK1001.C0101_allcombined	1033917	1033926		YPO_RS05650	9
RK1001.C0101_allcombined	1033975	1033983		YPO_RS05650	8
RK1001.C0101_allcombined	1034273	1034280		YPO_RS05650	7
RK1001.C0101_allcombined	1034338	1034344		YPO_RS05650	6
RK1001.C0101_allcombined	1034707	1034756		YPO_RS05655	49
RK1001.C0101_allcombined	1034873	1034903		YPO_RS05655	30
RK1001.C0101_allcombined	1035978	1035994		YPO_RS05665	16
RK1001.C0101_allcombined	1036981	1037005		hemW	24
RK1001.C0101_allcombined	1037279	1037289		hemW	10
RK1001.C0101_allcombined	1037483	1037484		YPO_RS05675	1
RK1001.C0101_allcombined	1037579	1037639		YPO_RS05675	60
RK1001.C0101_allcombined	1037698	1037737		YPO_RS05675	39
RK1001.C0101_allcombined	1037814	1037826		YPO_RS05675	12
RK1001.C0101_allcombined	1037862	1037871		YPO_RS05675	9
RK1001.C0101_allcombined	1038254	1038260		YPO_RS05675	6
RK1001.C0101_allcombined	1038367	1038368		YPO_RS05675	1
RK1001.C0101_allcombined	1038581	1038591		YPO_RS05675	10
RK1001.C0101_allcombined	1038679	1038715		YPO_RS05675	36
RK1001.C0101_allcombined	1038749	1038805		YPO_RS05675	56
RK1001.C0101_allcombined	1038908	1038979		YPO_RS05675	71
RK1001.C0101_allcombined	1039017	1039057		YPO_RS05675	40
RK1001.C0101_allcombined	1039154	1039167		YPO_RS05675	13
RK1001.C0101_allcombined	1039214	1039265		YPO_RS05675	51
RK1001.C0101_allcombined	1039461	1039466		YPO_RS05675	5
RK1001.C0101_allcombined	1039513	1039528		YPO_RS05675	15
RK1001.C0101_allcombined	1039645	1039649		YPO_RS05675	4
RK1001.C0101_allcombined	1039716	1039781		YPO_RS05675	65
RK1001.C0101_allcombined	1039827	1039889		YPO_RS05675	62
RK1001.C0101_allcombined	1040019	1040066		YPO_RS05675	47
RK1001.C0101_allcombined	1040123	1040130		YPO_RS05675	7
RK1001.C0101_allcombined	1040214	1040233		YPO_RS05675	19
RK1001.C0101_allcombined	1040295	1040308		YPO_RS05675	13
RK1001.C0101_allcombined	1040377	1040381		YPO_RS05675	4
RK1001.C0101_allcombined	1040514	1040574		YPO_RS05675	60
RK1001.C0101_allcombined	1040729	1040751		YPO_RS05675	22
RK1001.C0101_allcombined	1040790	1040862		YPO_RS05675	72
RK1001.C0101_allcombined	1040972	1041045		YPO_RS05675	73
RK1001.C0101_allcombined	1041206	1041331		YPO_RS05675	125
RK1001.C0101_allcombined	1041397	1041398		YPO_RS05675	1
RK1001.C0101_allcombined	1041465	1041540		YPO_RS05675	75
RK1001.C0101_allcombined	1041712	1041733		YPO_RS05675	21
RK1001.C0101_allcombined	1041840	1041847		YPO_RS05675	7
RK1001.C0101_allcombined	1041919	1041930		YPO_RS05675	11
RK1001.C0101_allcombined	1041974	1041986		YPO_RS05675	12
RK1001.C0101_allcombined	1042081	1042097		YPO_RS05675	16
RK1001.C0101_allcombined	1042507	1042606		YPO_RS05675	99
RK1001.C0101_allcombined	1042825	1042852		YPO_RS05675	27
RK1001.C0101_allcombined	1042882	1042917		YPO_RS05675	35
RK1001.C0101_allcombined	1042957	1043025		YPO_RS05675	68
RK1001.C0101_allcombined	1043159	1043161		YPO_RS05675	2
RK1001.C0101_allcombined	1043368	1043399		YPO_RS05675	31
RK1001.C0101_allcombined	1043432	1043473		YPO_RS05675	41
RK1001.C0101_allcombined	1043819	1043899		YPO_RS05675	80
RK1001.C0101_allcombined	1043940	1043972		YPO_RS05675	32
RK1001.C0101_allcombined	1044182	1044200		YPO_RS05675	18
RK1001.C0101_allcombined	1044250	1044343		YPO_RS05675	93
RK1001.C0101_allcombined	1044399	1044417		YPO_RS05675	18
RK1001.C0101_allcombined	1044453	1044555		YPO_RS05675	102
RK1001.C0101_allcombined	1044633	1044659		YPO_RS05675	26
RK1001.C0101_allcombined	1044714	1044725		YPO_RS05675	11
RK1001.C0101_allcombined	1044755	1044826		YPO_RS05675	71
RK1001.C0101_allcombined	1044890	1045025		YPO_RS05675	135
RK1001.C0101_allcombined	1045071	1045143		YPO_RS05675	72
RK1001.C0101_allcombined	1045200	1045227		YPO_RS05675	27
RK1001.C0101_allcombined	1045274	1045334		YPO_RS05675	60
RK1001.C0101_allcombined	1045386	1045445		YPO_RS05675	59
RK1001.C0101_allcombined	1045521	1045554		YPO_RS05675	33
RK1001.C0101_allcombined	1045700	1045741		YPO_RS05675	41
RK1001.C0101_allcombined	1045807	1045842		YPO_RS05675	35
RK1001.C0101_allcombined	1045964	1045980		YPO_RS05675	16
RK1001.C0101_allcombined	1046022	1046034		YPO_RS05675	12
RK1001.C0101_allcombined	1046240	1046248		YPO_RS05675	8
RK1001.C0101_allcombined	1046306	1046402		YPO_RS05675	96
RK1001.C0101_allcombined	1046482	1046510		YPO_RS05675	28
RK1001.C0101_allcombined	1046604	1046688		YPO_RS05675	84
RK1001.C0101_allcombined	1048504	1048519		glsB	15
RK1001.C0101_allcombined	1048550	1048556		glsB	6
RK1001.C0101_allcombined	1048922	1048930		glsB	8
RK1001.C0101_allcombined	1049216	1049221		YPO_RS05690	5
RK1001.C0101_allcombined	1049941	1049945		trmB	4
RK1001.C0101_allcombined	1050129	1050140		trmB	11
RK1001.C0101_allcombined	1050646	1050668		mutY	22
RK1001.C0101_allcombined	1051298	1051320		mutY	22
RK1001.C0101_allcombined	1051480	1051484		mutY	4
RK1001.C0101_allcombined	1051553	1051561		mutY	8
RK1001.C0101_allcombined	1051980	1051990		YPO_RS05705	10
RK1001.C0101_allcombined	1052048	1052056		YPO_RS05705	8
RK1001.C0101_allcombined	1052138	1052140		YPO_RS05705	2
RK1001.C0101_allcombined	1052363	1052369		mltC	6
RK1001.C0101_allcombined	1052563	1052572		mltC	9
RK1001.C0101_allcombined	1052643	1052699		mltC	56
RK1001.C0101_allcombined	1053148	1053181		mltC	33
RK1001.C0101_allcombined	1053228	1053231		mltC	3
RK1001.C0101_allcombined	1053264	1053306		mltC	42
RK1001.C0101_allcombined	1054947	1054954		YPO_RS05720	7
RK1001.C0101_allcombined	1055398	1055401		YPO_RS05720	3
RK1001.C0101_allcombined	1055517	1055522		YPO_RS05720	5
RK1001.C0101_allcombined	1055757	1055763		YPO_RS05720	6
RK1001.C0101_allcombined	1056004	1056009		YPO_RS05720	5
RK1001.C0101_allcombined	1056192	1056202		YPO_RS05720	10
RK1001.C0101_allcombined	1057135	1057157		YPO_RS05725	22
RK1001.C0101_allcombined	1057483	1057500		YPO_RS05725	17
RK1001.C0101_allcombined	1057912	1057923		YPO_RS05725	11
RK1001.C0101_allcombined	1057958	1057962		YPO_RS05725	4
RK1001.C0101_allcombined	1057997	1058002		YPO_RS05725	5
RK1001.C0101_allcombined	1058035	1058039		YPO_RS05730	4
RK1001.C0101_allcombined	1058171	1058175		YPO_RS05730	4
RK1001.C0101_allcombined	1058997	1059011		YPO_RS05730	14
RK1001.C0101_allcombined	1059531	1059534		YPO_RS05730	3
RK1001.C0101_allcombined	1059609	1059645		YPO_RS05735	36
RK1001.C0101_allcombined	1060192	1060206		YPO_RS05735	14
RK1001.C0101_allcombined	1061095	1061121		speF	26
RK1001.C0101_allcombined	1062132	1062172		speF	40
RK1001.C0101_allcombined	1063242	1063257		speF	15
RK1001.C0101_allcombined	1064586	1064603		YPO_RS05755	17
RK1001.C0101_allcombined	1065829	1065841		YPO_RS05760	12
RK1001.C0101_allcombined	1066696	1066712		YPO_RS05765	16
RK1001.C0101_allcombined	1066815	1066833		YPO_RS05765	18
RK1001.C0101_allcombined	1066884	1066905		YPO_RS05765	21
RK1001.C0101_allcombined	1066956	1067027		YPO_RS05765	71
RK1001.C0101_allcombined	1067087	1067090		YPO_RS05765	3
RK1001.C0101_allcombined	1067137	1067166		YPO_RS05765	29
RK1001.C0101_allcombined	1067204	1067231		YPO_RS05765	27
RK1001.C0101_allcombined	1067280	1067389		YPO_RS05765	109
RK1001.C0101_allcombined	1067376	1067394		YPO_RS05770	18
RK1001.C0101_allcombined	1067443	1067462		YPO_RS05770	19
RK1001.C0101_allcombined	1067527	1067574		YPO_RS05770	47
RK1001.C0101_allcombined	1067659	1067661		YPO_RS05770	2
RK1001.C0101_allcombined	1067748	1067763		YPO_RS05770	15
RK1001.C0101_allcombined	1067851	1067872		YPO_RS05770	21
RK1001.C0101_allcombined	1067908	1067916		YPO_RS05770	8
RK1001.C0101_allcombined	1068091	1068093		YPO_RS05770	2
RK1001.C0101_allcombined	1068129	1068182		YPO_RS05770	53
RK1001.C0101_allcombined	1069649	1069671		YPO_RS05770	22
RK1001.C0101_allcombined	1071652	1071722		YPO_RS05785	70
RK1001.C0101_allcombined	1071950	1071986		YPO_RS05790	36
RK1001.C0101_allcombined	1072218	1072254		YPO_RS05790	36
RK1001.C0101_allcombined	1072398	1072411		YPO_RS05795	13
RK1001.C0101_allcombined	1072586	1072590		YPO_RS05795	4
RK1001.C0101_allcombined	1072666	1072703		YPO_RS05795	37
RK1001.C0101_allcombined	1072771	1072839		YPO_RS05795	68
RK1001.C0101_allcombined	1073084	1073209		YPO_RS05795	125
RK1001.C0101_allcombined	1073276	1073279		YPO_RS05795	3
RK1001.C0101_allcombined	1073447	1073460		YPO_RS05795	13
RK1001.C0101_allcombined	1073812	1073814		YPO_RS05795	2
RK1001.C0101_allcombined	1074260	1074273		YPO_RS05795	13
RK1001.C0101_allcombined	1076136	1076169		YPO_RS05800	33
RK1001.C0101_allcombined	1076961	1076980		YPO_RS05800	19
RK1001.C0101_allcombined	1077033	1077035		tssH	2
RK1001.C0101_allcombined	1077490	1077513		tssH	23
RK1001.C0101_allcombined	1077605	1077613		tssH	8
RK1001.C0101_allcombined	1079386	1079390		tssH	4
RK1001.C0101_allcombined	1079428	1079434		tssH	6
RK1001.C0101_allcombined	1080319	1080323		YPO_RS05810	4
RK1001.C0101_allcombined	1080599	1080602		YPO_RS05815	3
RK1001.C0101_allcombined	1081523	1081532		YPO_RS05815	9
RK1001.C0101_allcombined	1082316	1082333		YPO_RS05820	17
RK1001.C0101_allcombined	1082912	1082923		YPO_RS05820	11
RK1001.C0101_allcombined	1084850	1084855		tssC	5
RK1001.C0101_allcombined	1085035	1085049		tssC	14
RK1001.C0101_allcombined	1085360	1085366		tssC	6
RK1001.C0101_allcombined	1088708	1088733		YPO_RS05845	25
RK1001.C0101_allcombined	1088854	1088856		YPO_RS05845	2
RK1001.C0101_allcombined	1088949	1088964		YPO_RS05845	15
RK1001.C0101_allcombined	1089000	1089009		YPO_RS05845	9
RK1001.C0101_allcombined	1089061	1089082		YPO_RS05845	21
RK1001.C0101_allcombined	1089801	1089802		YPO_RS05850	1
RK1001.C0101_allcombined	1091363	1091408		YPO_RS05855	45
RK1001.C0101_allcombined	1091450	1091452		YPO_RS05855	2
RK1001.C0101_allcombined	1091546	1091649		YPO_RS05855	103
RK1001.C0101_allcombined	1091710	1091727		YPO_RS05855	17
RK1001.C0101_allcombined	1091857	1091883		YPO_RS05855	26
RK1001.C0101_allcombined	1092081	1092116		YPO_RS05860	35
RK1001.C0101_allcombined	1092440	1092464		YPO_RS05860	24
RK1001.C0101_allcombined	1092564	1092599		YPO_RS05860	35
RK1001.C0101_allcombined	1092639	1092646		YPO_RS05860	7
RK1001.C0101_allcombined	1092702	1092703		YPO_RS05860	1
RK1001.C0101_allcombined	1093310	1093318		YPO_RS05865	8
RK1001.C0101_allcombined	1093566	1093582		YPO_RS05865	16
RK1001.C0101_allcombined	1093926	1093944		YPO_RS05865	18
RK1001.C0101_allcombined	1094187	1094190		YPO_RS05865	3
RK1001.C0101_allcombined	1094314	1094329		YPO_RS05865	15
RK1001.C0101_allcombined	1095478	1095525		YPO_RS05870	47
RK1001.C0101_allcombined	1095626	1095630		YPO_RS05870	4
RK1001.C0101_allcombined	1095789	1095793		YPO_RS05870	4
RK1001.C0101_allcombined	1095856	1095885		YPO_RS05870	29
RK1001.C0101_allcombined	1096333	1096342		YPO_RS05880	9
RK1001.C0101_allcombined	1096775	1096812		YPO_RS05880	37
RK1001.C0101_allcombined	1099294	1099303		YPO_RS05890	9
RK1001.C0101_allcombined	1099381	1099406		YPO_RS05890	25
RK1001.C0101_allcombined	1099574	1099594		YPO_RS05890	20
RK1001.C0101_allcombined	1099957	1099959		YPO_RS05890	2
RK1001.C0101_allcombined	1100233	1100235		YPO_RS05890	2
RK1001.C0101_allcombined	1101449	1101463		iucC	14
RK1001.C0101_allcombined	1102422	1102430		YPO_RS05900	8
RK1001.C0101_allcombined	1102597	1102601		YPO_RS05900	4
RK1001.C0101_allcombined	1104327	1104359		YPO_RS05905	32
RK1001.C0101_allcombined	1104408	1104436		YPO_RS05905	28
RK1001.C0101_allcombined	1104570	1104603		YPO_RS05905	33
RK1001.C0101_allcombined	1104653	1104655		YPO_RS05905	2
RK1001.C0101_allcombined	1105047	1105071		YPO_RS05905	24
RK1001.C0101_allcombined	1105338	1105359		YPO_RS05905	21
RK1001.C0101_allcombined	1105853	1105864		YPO_RS05910	11
RK1001.C0101_allcombined	1106443	1106471		YPO_RS05910	28
RK1001.C0101_allcombined	1106558	1106582		YPO_RS05910	24
RK1001.C0101_allcombined	1106892	1106912		YPO_RS05910	20
RK1001.C0101_allcombined	1106967	1106992		YPO_RS05910	25
RK1001.C0101_allcombined	1107069	1107070		YPO_RS05910	1
RK1001.C0101_allcombined	1107642	1107644		YPO_RS05915	2
RK1001.C0101_allcombined	1108464	1108484		YPO_RS05915	20
RK1001.C0101_allcombined	1108840	1108849		YPO_RS05915	9
RK1001.C0101_allcombined	1109720	1109734		YPO_RS05920	14
RK1001.C0101_allcombined	1110223	1110254		YPO_RS05920	31
RK1001.C0101_allcombined	1111370	1111378		YPO_RS05920	8
RK1001.C0101_allcombined	1111565	1111582		YPO_RS05925	17
RK1001.C0101_allcombined	1112150	1112156		YPO_RS05930	6
RK1001.C0101_allcombined	1112420	1112425		YPO_RS05930	5
RK1001.C0101_allcombined	1112845	1112894		YPO_RS05930	49
RK1001.C0101_allcombined	1112978	1112994		YPO_RS05930	16
RK1001.C0101_allcombined	1113265	1113277		YPO_RS05930	12
RK1001.C0101_allcombined	1113547	1113557		YPO_RS05935	10
RK1001.C0101_allcombined	1113593	1113598		YPO_RS05935	5
RK1001.C0101_allcombined	1113780	1113787		YPO_RS05935	7
RK1001.C0101_allcombined	1113819	1113876		YPO_RS05935	57
RK1001.C0101_allcombined	1114374	1114378		YPO_RS05935	4
RK1001.C0101_allcombined	1114707	1114711		YPO_RS05935	4
RK1001.C0101_allcombined	1115149	1115177		YPO_RS05935	28
RK1001.C0101_allcombined	1115755	1115761		YPO_RS05935	6
RK1001.C0101_allcombined	1116083	1116100		YPO_RS05935	17
RK1001.C0101_allcombined	1116214	1116225		YPO_RS05935	11
RK1001.C0101_allcombined	1116700	1116712		YPO_RS05940	12
RK1001.C0101_allcombined	1116805	1116816		YPO_RS05940	11
RK1001.C0101_allcombined	1116864	1116866		YPO_RS05940	2
RK1001.C0101_allcombined	1116938	1116951		YPO_RS05940	13
RK1001.C0101_allcombined	1116986	1117117		YPO_RS05940	131
RK1001.C0101_allcombined	1117225	1117240		YPO_RS05940	15
RK1001.C0101_allcombined	1117271	1117341		YPO_RS05940	70
RK1001.C0101_allcombined	1117446	1117530		YPO_RS05940	84
RK1001.C0101_allcombined	1117611	1117617		YPO_RS05940	6
RK1001.C0101_allcombined	1117725	1117795		YPO_RS05940	70
RK1001.C0101_allcombined	1117906	1117925		YPO_RS05940	19
RK1001.C0101_allcombined	1117985	1118110		YPO_RS05940	125
RK1001.C0101_allcombined	1118447	1118448		YPO_RS05945	1
RK1001.C0101_allcombined	1118688	1118719		YPO_RS05945	31
RK1001.C0101_allcombined	1118805	1118821		YPO_RS05945	16
RK1001.C0101_allcombined	1120323	1120355		yapH	32
RK1001.C0101_allcombined	1120886	1120936		yapH	50
RK1001.C0101_allcombined	1121052	1121162		yapH	110
RK1001.C0101_allcombined	1121492	1121496		yapH	4
RK1001.C0101_allcombined	1121553	1121586		yapH	33
RK1001.C0101_allcombined	1121646	1121648		yapH	2
RK1001.C0101_allcombined	1121777	1121784		yapH	7
RK1001.C0101_allcombined	1121829	1121832		yapH	3
RK1001.C0101_allcombined	1122192	1122193		yapH	1
RK1001.C0101_allcombined	1122460	1122465		yapH	5
RK1001.C0101_allcombined	1122753	1122763		yapH	10
RK1001.C0101_allcombined	1122903	1122910		yapH	7
RK1001.C0101_allcombined	1123372	1123380		yapH	8
RK1001.C0101_allcombined	1125193	1125201		yapH	8
RK1001.C0101_allcombined	1125476	1125477		yapH	1
RK1001.C0101_allcombined	1125793	1125805		yapH	12
RK1001.C0101_allcombined	1125967	1125979		yapH	12
RK1001.C0101_allcombined	1126038	1126044		yapH	6
RK1001.C0101_allcombined	1126212	1126215		yapH	3
RK1001.C0101_allcombined	1126276	1126287		yapH	11
RK1001.C0101_allcombined	1126599	1126630		yapH	31
RK1001.C0101_allcombined	1127124	1127128		yapH	4
RK1001.C0101_allcombined	1127285	1127289		yapH	4
RK1001.C0101_allcombined	1127784	1127806		yapH	22
RK1001.C0101_allcombined	1128857	1128871		yapH	14
RK1001.C0101_allcombined	1129055	1129061		yapH	6
RK1001.C0101_allcombined	1129219	1129228		yapH	9
RK1001.C0101_allcombined	1129563	1129591		yapH	28
RK1001.C0101_allcombined	1129683	1129696		yapH	13
RK1001.C0101_allcombined	1129726	1129727		yapH	1
RK1001.C0101_allcombined	1130501	1130504		yapH	3
RK1001.C0101_allcombined	1130939	1130946		yapH	7
RK1001.C0101_allcombined	1131750	1131753		YPO_RS05955	3
RK1001.C0101_allcombined	1132025	1132043		YPO_RS05955	18
RK1001.C0101_allcombined	1132158	1132167		YPO_RS05955	9
RK1001.C0101_allcombined	1132462	1132463		YPO_RS05955	1
RK1001.C0101_allcombined	1132695	1132709		YPO_RS05955	14
RK1001.C0101_allcombined	1133651	1133675		YPO_RS05965	24
RK1001.C0101_allcombined	1133791	1133816		YPO_RS05965	25
RK1001.C0101_allcombined	1133947	1133988		YPO_RS05965	41
RK1001.C0101_allcombined	1134112	1134113		YPO_RS05965	1
RK1001.C0101_allcombined	1134322	1134324		YPO_RS05965	2
RK1001.C0101_allcombined	1134357	1134367		YPO_RS05965	10
RK1001.C0101_allcombined	1134986	1135007		YPO_RS05970	21
RK1001.C0101_allcombined	1135474	1135484		YPO_RS05970	10
RK1001.C0101_allcombined	1135655	1135689		YPO_RS05970	34
RK1001.C0101_allcombined	1136008	1136026		YPO_RS05970	18
RK1001.C0101_allcombined	1136370	1136392		YPO_RS05970	22
RK1001.C0101_allcombined	1137238	1137262		YPO_RS05975	24
RK1001.C0101_allcombined	1137326	1137337		YPO_RS05975	11
RK1001.C0101_allcombined	1137903	1137908		YPO_RS05975	5
RK1001.C0101_allcombined	1138391	1138404		YPO_RS05975	13
RK1001.C0101_allcombined	1138489	1138495		YPO_RS05975	6
RK1001.C0101_allcombined	1138985	1138991		pepT	6
RK1001.C0101_allcombined	1139843	1139849		pepT	6
RK1001.C0101_allcombined	1140365	1140424		YPO_RS05985	59
RK1001.C0101_allcombined	1140476	1140478		YPO_RS05985	2
RK1001.C0101_allcombined	1140512	1140584		YPO_RS05985	72
RK1001.C0101_allcombined	1140695	1140703		YPO_RS05985	8
RK1001.C0101_allcombined	1140742	1140765		YPO_RS05985	23
RK1001.C0101_allcombined	1140825	1140919		YPO_RS05985	94
RK1001.C0101_allcombined	1141000	1141001		YPO_RS05985	1
RK1001.C0101_allcombined	1141070	1141159		YPO_RS05985	89
RK1001.C0101_allcombined	1141193	1141240		YPO_RS05985	47
RK1001.C0101_allcombined	1141403	1141441		YPO_RS05985	38
RK1001.C0101_allcombined	1141499	1141508		YPO_RS05985	9
RK1001.C0101_allcombined	1142045	1142094		YPO_RS05985	49
RK1001.C0101_allcombined	1142238	1142254		YPO_RS05985	16
RK1001.C0101_allcombined	1142309	1142336		YPO_RS05985	27
RK1001.C0101_allcombined	1142423	1142437		YPO_RS05985	14
RK1001.C0101_allcombined	1146910	1146914		YPO_RS05995	4
RK1001.C0101_allcombined	1147801	1147803		YPO_RS06000	2
RK1001.C0101_allcombined	1147996	1148004		YPO_RS06005	8
RK1001.C0101_allcombined	1148260	1148264		YPO_RS06010	4
RK1001.C0101_allcombined	1148628	1148638		YPO_RS06010	10
RK1001.C0101_allcombined	1149255	1149265		YPO_RS06020	10
RK1001.C0101_allcombined	1149375	1149382		YPO_RS06020	7
RK1001.C0101_allcombined	1149777	1149782		recC	5
RK1001.C0101_allcombined	1149943	1149954		recC	11
RK1001.C0101_allcombined	1150285	1150375		recC	90
RK1001.C0101_allcombined	1150770	1150788		recC	18
RK1001.C0101_allcombined	1150819	1150825		recC	6
RK1001.C0101_allcombined	1150964	1150966		recC	2
RK1001.C0101_allcombined	1151265	1151274		recC	9
RK1001.C0101_allcombined	1151727	1151733		recC	6
RK1001.C0101_allcombined	1151892	1151893		recC	1
RK1001.C0101_allcombined	1152287	1152305		recC	18
RK1001.C0101_allcombined	1152979	1152983		recC	4
RK1001.C0101_allcombined	1153269	1153301		ptrA	32
RK1001.C0101_allcombined	1153457	1153471		ptrA	14
RK1001.C0101_allcombined	1153520	1153524		ptrA	4
RK1001.C0101_allcombined	1153885	1153901		ptrA	16
RK1001.C0101_allcombined	1154040	1154055		ptrA	15
RK1001.C0101_allcombined	1154155	1154180		ptrA	25
RK1001.C0101_allcombined	1154261	1154326		ptrA	65
RK1001.C0101_allcombined	1154356	1154371		ptrA	15
RK1001.C0101_allcombined	1154848	1154863		ptrA	15
RK1001.C0101_allcombined	1155410	1155412		ptrA	2
RK1001.C0101_allcombined	1155488	1155497		ptrA	9
RK1001.C0101_allcombined	1155557	1155590		ptrA	33
RK1001.C0101_allcombined	1155773	1155786		ptrA	13
RK1001.C0101_allcombined	1155957	1155983		ptrA	26
RK1001.C0101_allcombined	1156054	1156080		recB	26
RK1001.C0101_allcombined	1156166	1156178		recB	12
RK1001.C0101_allcombined	1156929	1156958		recB	29
RK1001.C0101_allcombined	1157380	1157383		recB	3
RK1001.C0101_allcombined	1157507	1157547		recB	40
RK1001.C0101_allcombined	1158158	1158160		recB	2
RK1001.C0101_allcombined	1159032	1159035		recB	3
RK1001.C0101_allcombined	1159235	1159241		recB	6
RK1001.C0101_allcombined	1159618	1159636		recB	18
RK1001.C0101_allcombined	1159957	1159977		recD	20
RK1001.C0101_allcombined	1160081	1160111		recD	30
RK1001.C0101_allcombined	1160301	1160306		recD	5
RK1001.C0101_allcombined	1160713	1160757		recD	44
RK1001.C0101_allcombined	1161285	1161308		recD	23
RK1001.C0101_allcombined	1161445	1161448		recD	3
RK1001.C0101_allcombined	1161769	1161771		argA	2
RK1001.C0101_allcombined	1162028	1162034		argA	6
RK1001.C0101_allcombined	1162083	1162092		argA	9
RK1001.C0101_allcombined	1162664	1162670		argA	6
RK1001.C0101_allcombined	1162910	1162929		argA	19
RK1001.C0101_allcombined	1163081	1163094		argA	13
RK1001.C0101_allcombined	1163382	1163385		YPO_RS06050	3
RK1001.C0101_allcombined	1163558	1163568		YPO_RS06050	10
RK1001.C0101_allcombined	1163822	1163844		YPO_RS06050	22
RK1001.C0101_allcombined	1164185	1164192		YPO_RS06050	7
RK1001.C0101_allcombined	1164341	1164348		YPO_RS06050	7
RK1001.C0101_allcombined	1164411	1164428		YPO_RS06050	17
RK1001.C0101_allcombined	1165331	1165333		mltA	2
RK1001.C0101_allcombined	1166236	1166240		mltA	4
RK1001.C0101_allcombined	1166435	1166449		mltA	14
RK1001.C0101_allcombined	1166981	1166991		tcdA	10
RK1001.C0101_allcombined	1167630	1167638		csdE	8
RK1001.C0101_allcombined	1167901	1167923		csdE	22
RK1001.C0101_allcombined	1168357	1168362		csdA	5
RK1001.C0101_allcombined	1168631	1168649		csdA	18
RK1001.C0101_allcombined	1168793	1168797		csdA	4
RK1001.C0101_allcombined	1170430	1170490		YPO_RS06090	60
RK1001.C0101_allcombined	1170780	1170784		YPO_RS06090	4
RK1001.C0101_allcombined	1171071	1171072		YPO_RS06095	1
RK1001.C0101_allcombined	1171517	1171518		rlmM	1
RK1001.C0101_allcombined	1171898	1171929		rlmM	31
RK1001.C0101_allcombined	1171975	1171987		rlmM	12
RK1001.C0101_allcombined	1172182	1172195		rlmM	13
RK1001.C0101_allcombined	1172367	1172376		rlmM	9
RK1001.C0101_allcombined	1172751	1172786		xni	35
RK1001.C0101_allcombined	1172990	1172991		xni	1
RK1001.C0101_allcombined	1173170	1173183		xni	13
RK1001.C0101_allcombined	1173781	1173817		YPO_RS06110	36
RK1001.C0101_allcombined	1174315	1174339		YPO_RS06110	24
RK1001.C0101_allcombined	1174815	1174820		YPO_RS06110	5
RK1001.C0101_allcombined	1175022	1175053		YPO_RS06110	31
RK1001.C0101_allcombined	1175596	1175601		queF	5
RK1001.C0101_allcombined	1175725	1175746		queF	21
RK1001.C0101_allcombined	1175831	1175837		queF	6
RK1001.C0101_allcombined	1176125	1176128		queF	3
RK1001.C0101_allcombined	1176352	1176367		syd	15
RK1001.C0101_allcombined	1176736	1176741		syd	5
RK1001.C0101_allcombined	1178331	1178336		YPO_RS06130	5
RK1001.C0101_allcombined	1178880	1178894		truC	14
RK1001.C0101_allcombined	1179078	1179080		truC	2
RK1001.C0101_allcombined	1179367	1179375		YPO_RS06140	8
RK1001.C0101_allcombined	1179432	1179438		YPO_RS06140	6
RK1001.C0101_allcombined	1179559	1179614		YPO_RS06140	55
RK1001.C0101_allcombined	1180051	1180054		YPO_RS06145	3
RK1001.C0101_allcombined	1180541	1180546		dapD	5
RK1001.C0101_allcombined	1180836	1180842		dapD	6
RK1001.C0101_allcombined	1181473	1181500		glnD	27
RK1001.C0101_allcombined	1181533	1181541		glnD	8
RK1001.C0101_allcombined	1182380	1182384		glnD	4
RK1001.C0101_allcombined	1182655	1182657		glnD	2
RK1001.C0101_allcombined	1182821	1182824		glnD	3
RK1001.C0101_allcombined	1182901	1182902		glnD	1
RK1001.C0101_allcombined	1183050	1183052		glnD	2
RK1001.C0101_allcombined	1183082	1183104		glnD	22
RK1001.C0101_allcombined	1183896	1183911		glnD	15
RK1001.C0101_allcombined	1184160	1184168		map	8
RK1001.C0101_allcombined	1184430	1184441		map	11
RK1001.C0101_allcombined	1184747	1184749		map	2
RK1001.C0101_allcombined	1185544	1185567		rpsB	23
RK1001.C0101_allcombined	1185687	1185688		rpsB	1
RK1001.C0101_allcombined	1188332	1188336		frr	4
RK1001.C0101_allcombined	1188545	1188546		frr	1
RK1001.C0101_allcombined	1188932	1188987		ispC	55
RK1001.C0101_allcombined	1189955	1190036		ispC	81
RK1001.C0101_allcombined	1190362	1190373		ispU	11
RK1001.C0101_allcombined	1190632	1190646		ispU	14
RK1001.C0101_allcombined	1191345	1191365		cdsA	20
RK1001.C0101_allcombined	1191510	1191526		cdsA	16
RK1001.C0101_allcombined	1191643	1191666		cdsA	23
RK1001.C0101_allcombined	1192022	1192032		rseP	10
RK1001.C0101_allcombined	1192613	1192614		rseP	1
RK1001.C0101_allcombined	1192722	1192732		rseP	10
RK1001.C0101_allcombined	1192813	1192848		rseP	35
RK1001.C0101_allcombined	1192884	1192918		rseP	34
RK1001.C0101_allcombined	1193107	1193124		rseP	17
RK1001.C0101_allcombined	1193754	1193842		bamA	88
RK1001.C0101_allcombined	1194327	1194329		bamA	2
RK1001.C0101_allcombined	1194444	1194451		bamA	7
RK1001.C0101_allcombined	1194735	1194737		bamA	2
RK1001.C0101_allcombined	1194873	1194890		bamA	17
RK1001.C0101_allcombined	1195121	1195134		bamA	13
RK1001.C0101_allcombined	1195282	1195285		bamA	3
RK1001.C0101_allcombined	1195419	1195439		bamA	20
RK1001.C0101_allcombined	1196353	1196357		skp	4
RK1001.C0101_allcombined	1196476	1196486		lpxD	10
RK1001.C0101_allcombined	1196640	1196642		lpxD	2
RK1001.C0101_allcombined	1196694	1196702		lpxD	8
RK1001.C0101_allcombined	1197599	1197651		fabZ	52
RK1001.C0101_allcombined	1198368	1198407		lpxA	39
RK1001.C0101_allcombined	1198457	1198470		lpxA	13
RK1001.C0101_allcombined	1198533	1198593		lpxA	60
RK1001.C0101_allcombined	1198969	1198990		lpxB	21
RK1001.C0101_allcombined	1199146	1199166		lpxB	20
RK1001.C0101_allcombined	1199305	1199314		lpxB	9
RK1001.C0101_allcombined	1199447	1199470		lpxB	23
RK1001.C0101_allcombined	1199771	1199776		lpxB	5
RK1001.C0101_allcombined	1199864	1199866		lpxB	2
RK1001.C0101_allcombined	1199908	1199915		lpxB	7
RK1001.C0101_allcombined	1200068	1200070		lpxB	2
RK1001.C0101_allcombined	1200920	1200955		dnaE	35
RK1001.C0101_allcombined	1201721	1201745		dnaE	24
RK1001.C0101_allcombined	1202057	1202060		dnaE	3
RK1001.C0101_allcombined	1202111	1202113		dnaE	2
RK1001.C0101_allcombined	1202244	1202258		dnaE	14
RK1001.C0101_allcombined	1203165	1203173		dnaE	8
RK1001.C0101_allcombined	1203315	1203319		dnaE	4
RK1001.C0101_allcombined	1203456	1203462		dnaE	6
RK1001.C0101_allcombined	1203768	1203788		dnaE	20
RK1001.C0101_allcombined	1204852	1204869		accA	17
RK1001.C0101_allcombined	1205570	1205591		YPO_RS06250	21
RK1001.C0101_allcombined	1205839	1205851		YPO_RS06250	12
RK1001.C0101_allcombined	1205936	1205940		tilS	4
RK1001.C0101_allcombined	1206012	1206045		tilS	33
RK1001.C0101_allcombined	1206582	1206593		tilS	11
RK1001.C0101_allcombined	1207236	1207244		tilS	8
RK1001.C0101_allcombined	1207292	1207297		tilS	5
RK1001.C0101_allcombined	1207666	1207687		YPO_RS06260	21
RK1001.C0101_allcombined	1208359	1208365		rof	6
RK1001.C0101_allcombined	1208807	1208819		YPO_RS06275	12
RK1001.C0101_allcombined	1209115	1209118		YPO_RS06275	3
RK1001.C0101_allcombined	1210115	1210153		nlpE	38
RK1001.C0101_allcombined	1211513	1211527		proS	14
RK1001.C0101_allcombined	1211866	1211895		proS	29
RK1001.C0101_allcombined	1213019	1213035		tsaA	16
RK1001.C0101_allcombined	1213181	1213205		tsaA	24
RK1001.C0101_allcombined	1213202	1213205		rcsF	3
RK1001.C0101_allcombined	1213311	1213313		rcsF	2
RK1001.C0101_allcombined	1213566	1213570		rcsF	4
RK1001.C0101_allcombined	1213727	1213732		YPO_RS06305	5
RK1001.C0101_allcombined	1214011	1214020		YPO_RS06305	9
RK1001.C0101_allcombined	1214124	1214148		YPO_RS06305	24
RK1001.C0101_allcombined	1214509	1214510		YPO_RS06305	1
RK1001.C0101_allcombined	1214640	1214682		metI	42
RK1001.C0101_allcombined	1214713	1214728		metI	15
RK1001.C0101_allcombined	1214760	1214789		metI	29
RK1001.C0101_allcombined	1215026	1215067		metI	41
RK1001.C0101_allcombined	1215146	1215152		metI	6
RK1001.C0101_allcombined	1215576	1215594		metN	18
RK1001.C0101_allcombined	1215765	1215778		metN	13
RK1001.C0101_allcombined	1215920	1215939		metN	19
RK1001.C0101_allcombined	1216562	1216574		gmhB	12
RK1001.C0101_allcombined	1216788	1216800		gmhB	12
RK1001.C0101_allcombined	1217033	1217036		gmhB	3
RK1001.C0101_allcombined	1217372	1217376		YPO_RS06325	4
RK1001.C0101_allcombined	1218075	1218080		YPO_RS06330	5
RK1001.C0101_allcombined	1219636	1219637		YPO_RS06340	1
RK1001.C0101_allcombined	1220118	1220132		YPO_RS06340	14
RK1001.C0101_allcombined	1221219	1221232		YPO_RS06340	13
RK1001.C0101_allcombined	1221600	1221606		YPO_RS06340	6
RK1001.C0101_allcombined	1222287	1222288		YPO_RS06340	1
RK1001.C0101_allcombined	1223348	1223382		dkgB	34
RK1001.C0101_allcombined	1223482	1223502		dkgB	20
RK1001.C0101_allcombined	1223696	1223714		dkgB	18
RK1001.C0101_allcombined	1225130	1225134		YPO_RS06365	4
RK1001.C0101_allcombined	1225336	1225346		YPO_RS06365	10
RK1001.C0101_allcombined	1225567	1225587		YPO_RS06365	20
RK1001.C0101_allcombined	1225829	1225830		mltD	1
RK1001.C0101_allcombined	1226040	1226057		mltD	17
RK1001.C0101_allcombined	1226662	1226667		mltD	5
RK1001.C0101_allcombined	1226747	1226757		mltD	10
RK1001.C0101_allcombined	1227317	1227379		gloB	62
RK1001.C0101_allcombined	1227624	1227659		gloB	35
RK1001.C0101_allcombined	1227693	1227701		gloB	8
RK1001.C0101_allcombined	1228065	1228070		YPO_RS06380	5
RK1001.C0101_allcombined	1228172	1228180		YPO_RS06380	8
RK1001.C0101_allcombined	1228264	1228271		YPO_RS06380	7
RK1001.C0101_allcombined	1228448	1228456		YPO_RS06380	8
RK1001.C0101_allcombined	1228939	1228957		rnhA	18
RK1001.C0101_allcombined	1229157	1229162		rnhA	5
RK1001.C0101_allcombined	1229233	1229234		dnaQ	1
RK1001.C0101_allcombined	1230394	1230416		YPO_RS06400	22
RK1001.C0101_allcombined	1230488	1230519		YPO_RS06400	31
RK1001.C0101_allcombined	1230614	1230637		YPO_RS06400	23
RK1001.C0101_allcombined	1231660	1231700		YPO_RS06400	40
RK1001.C0101_allcombined	1232244	1232250		YPO_RS06405	6
RK1001.C0101_allcombined	1232283	1232284		YPO_RS06405	1
RK1001.C0101_allcombined	1232768	1232770		YPO_RS06410	2
RK1001.C0101_allcombined	1234086	1234089		YPO_RS06415	3
RK1001.C0101_allcombined	1234132	1234145		YPO_RS06415	13
RK1001.C0101_allcombined	1235321	1235324		YPO_RS06430	3
RK1001.C0101_allcombined	1236299	1236302		YPO_RS06435	3
RK1001.C0101_allcombined	1237263	1237311		YPO_RS06440	48
RK1001.C0101_allcombined	1238498	1238500		YPO_RS06450	2
RK1001.C0101_allcombined	1238555	1238574		YPO_RS06455	19
RK1001.C0101_allcombined	1238684	1238701		YPO_RS06455	17
RK1001.C0101_allcombined	1239205	1239250		YPO_RS06455	45
RK1001.C0101_allcombined	1240354	1240370		YPO_RS06460	16
RK1001.C0101_allcombined	1240645	1240674		YPO_RS06465	29
RK1001.C0101_allcombined	1240938	1240988		YPO_RS06465	50
RK1001.C0101_allcombined	1241094	1241123		YPO_RS06465	29
RK1001.C0101_allcombined	1241352	1241394		YPO_RS06465	42
RK1001.C0101_allcombined	1241586	1241596		YPO_RS06465	10
RK1001.C0101_allcombined	1241696	1241700		YPO_RS06465	4
RK1001.C0101_allcombined	1241906	1241926		YPO_RS06465	20
RK1001.C0101_allcombined	1241988	1242011		YPO_RS06465	23
RK1001.C0101_allcombined	1242151	1242188		YPO_RS06465	37
RK1001.C0101_allcombined	1242245	1242259		YPO_RS06465	14
RK1001.C0101_allcombined	1242334	1242395		YPO_RS06470	61
RK1001.C0101_allcombined	1242433	1242489		YPO_RS06470	56
RK1001.C0101_allcombined	1242520	1242724		YPO_RS06470	204
RK1001.C0101_allcombined	1242757	1242790		YPO_RS06470	33
RK1001.C0101_allcombined	1242968	1243045		YPO_RS06470	77
RK1001.C0101_allcombined	1243105	1243113		YPO_RS06470	8
RK1001.C0101_allcombined	1243167	1243269		YPO_RS06470	102
RK1001.C0101_allcombined	1244026	1244042		YPO_RS06475	16
RK1001.C0101_allcombined	1244239	1244251		YPO_RS06475	12
RK1001.C0101_allcombined	1244477	1244490		YPO_RS06475	13
RK1001.C0101_allcombined	1244581	1244583		YPO_RS06475	2
RK1001.C0101_allcombined	1244672	1244679		YPO_RS06475	7
RK1001.C0101_allcombined	1245276	1245306		YPO_RS06480	30
RK1001.C0101_allcombined	1245614	1245641		ssrA	27
RK1001.C0101_allcombined	1245711	1245713		ssrA	2
RK1001.C0101_allcombined	1245779	1245819		ssrA	40
RK1001.C0101_allcombined	1246097	1246114		smpB	17
RK1001.C0101_allcombined	1246833	1246850		YPO_RS06495	17
RK1001.C0101_allcombined	1246957	1246958		YPO_RS06495	1
RK1001.C0101_allcombined	1247147	1247163		YPO_RS06500	16
RK1001.C0101_allcombined	1247678	1247733		bamE	55
RK1001.C0101_allcombined	1248560	1248602		recN	42
RK1001.C0101_allcombined	1248813	1248828		recN	15
RK1001.C0101_allcombined	1249212	1249214		recN	2
RK1001.C0101_allcombined	1249288	1249296		recN	8
RK1001.C0101_allcombined	1249707	1249743		nadK	36
RK1001.C0101_allcombined	1249820	1249836		nadK	16
RK1001.C0101_allcombined	1249952	1249976		nadK	24
RK1001.C0101_allcombined	1251132	1251142		grpE	10
RK1001.C0101_allcombined	1251559	1251566		YPO_RS06525	7
RK1001.C0101_allcombined	1251692	1251700		YPO_RS06525	8
RK1001.C0101_allcombined	1251895	1251918		YPO_RS06525	23
RK1001.C0101_allcombined	1252036	1252093		YPO_RS06525	57
RK1001.C0101_allcombined	1252145	1252147		YPO_RS06525	2
RK1001.C0101_allcombined	1252272	1252288		YPO_RS06525	16
RK1001.C0101_allcombined	1252347	1252350		YPO_RS06525	3
RK1001.C0101_allcombined	1253592	1253608		sdhC	16
RK1001.C0101_allcombined	1253852	1253881		sdhD	29
RK1001.C0101_allcombined	1254001	1254017		sdhD	16
RK1001.C0101_allcombined	1254277	1254285		sdhA	8
RK1001.C0101_allcombined	1254338	1254345		sdhA	7
RK1001.C0101_allcombined	1254663	1254670		sdhA	7
RK1001.C0101_allcombined	1254862	1254926		sdhA	64
RK1001.C0101_allcombined	1255048	1255066		sdhA	18
RK1001.C0101_allcombined	1255324	1255329		sdhA	5
RK1001.C0101_allcombined	1255408	1255428		sdhA	20
RK1001.C0101_allcombined	1255998	1256006		YPO_RS06545	8
RK1001.C0101_allcombined	1256049	1256081		YPO_RS06545	32
RK1001.C0101_allcombined	1256266	1256280		YPO_RS06545	14
RK1001.C0101_allcombined	1256567	1256592		YPO_RS06545	25
RK1001.C0101_allcombined	1257151	1257163		sucA	12
RK1001.C0101_allcombined	1257525	1257541		sucA	16
RK1001.C0101_allcombined	1257699	1257706		sucA	7
RK1001.C0101_allcombined	1258055	1258076		sucA	21
RK1001.C0101_allcombined	1258168	1258183		sucA	15
RK1001.C0101_allcombined	1258927	1258934		sucA	7
RK1001.C0101_allcombined	1259644	1259652		sucA	8
RK1001.C0101_allcombined	1259759	1259765		sucA	6
RK1001.C0101_allcombined	1259956	1259960		odhB	4
RK1001.C0101_allcombined	1260460	1260462		odhB	2
RK1001.C0101_allcombined	1260654	1260678		odhB	24
RK1001.C0101_allcombined	1260914	1260957		odhB	43
RK1001.C0101_allcombined	1261180	1261219		sucC	39
RK1001.C0101_allcombined	1261605	1261620		sucC	15
RK1001.C0101_allcombined	1262733	1262745		sucD	12
RK1001.C0101_allcombined	1262916	1262954		sucD	38
RK1001.C0101_allcombined	1263207	1263218		sucD	11
RK1001.C0101_allcombined	1263985	1263989		cydA	4
RK1001.C0101_allcombined	1264028	1264033		cydA	5
RK1001.C0101_allcombined	1264259	1264264		cydA	5
RK1001.C0101_allcombined	1264717	1264723		cydA	6
RK1001.C0101_allcombined	1264778	1264803		cydA	25
RK1001.C0101_allcombined	1264865	1264881		cydA	16
RK1001.C0101_allcombined	1264989	1264996		cydA	7
RK1001.C0101_allcombined	1266039	1266040		cydB	1
RK1001.C0101_allcombined	1266355	1266367		cydB	12
RK1001.C0101_allcombined	1266888	1266892		ybgE	4
RK1001.C0101_allcombined	1267494	1267499		ybgC	5
RK1001.C0101_allcombined	1268438	1268446		tolR	8
RK1001.C0101_allcombined	1268571	1268588		tolR	17
RK1001.C0101_allcombined	1269074	1269086		tolA	12
RK1001.C0101_allcombined	1269263	1269272		tolA	9
RK1001.C0101_allcombined	1269749	1269768		tolA	19
RK1001.C0101_allcombined	1269932	1269949		tolA	17
RK1001.C0101_allcombined	1270251	1270286		tolB	35
RK1001.C0101_allcombined	1270603	1270621		tolB	18
RK1001.C0101_allcombined	1270805	1270807		tolB	2
RK1001.C0101_allcombined	1271096	1271153		tolB	57
RK1001.C0101_allcombined	1271477	1271481		tolB	4
RK1001.C0101_allcombined	1271547	1271551		pal	4
RK1001.C0101_allcombined	1272104	1272115		cpoB	11
RK1001.C0101_allcombined	1272363	1272367		cpoB	4
RK1001.C0101_allcombined	1272564	1272585		cpoB	21
RK1001.C0101_allcombined	1273780	1273811		nadA	31
RK1001.C0101_allcombined	1273875	1273878		nadA	3
RK1001.C0101_allcombined	1274491	1274501		nadA	10
RK1001.C0101_allcombined	1274631	1274643		nadA	12
RK1001.C0101_allcombined	1275238	1275259		YPO_RS06645	21
RK1001.C0101_allcombined	1275739	1275756		zitB	17
RK1001.C0101_allcombined	1275929	1275958		zitB	29
RK1001.C0101_allcombined	1276106	1276107		zitB	1
RK1001.C0101_allcombined	1276234	1276253		zitB	19
RK1001.C0101_allcombined	1277727	1277731		aroG	4
RK1001.C0101_allcombined	1277802	1277822		aroG	20
RK1001.C0101_allcombined	1278003	1278009		aroG	6
RK1001.C0101_allcombined	1278056	1278067		aroG	11
RK1001.C0101_allcombined	1280390	1280407		gpmA	17
RK1001.C0101_allcombined	1281723	1281730		YPO_RS06680	7
RK1001.C0101_allcombined	1282309	1282325		galM	16
RK1001.C0101_allcombined	1282422	1282433		galM	11
RK1001.C0101_allcombined	1282837	1282846		galM	9
RK1001.C0101_allcombined	1282969	1282978		YPO_RS06690	9
RK1001.C0101_allcombined	1283159	1283176		galK	17
RK1001.C0101_allcombined	1283332	1283351		galK	19
RK1001.C0101_allcombined	1283458	1283481		galK	23
RK1001.C0101_allcombined	1283670	1283682		galK	12
RK1001.C0101_allcombined	1284719	1284737		galT	18
RK1001.C0101_allcombined	1285799	1285800		galE	1
RK1001.C0101_allcombined	1286142	1286163		galE	21
RK1001.C0101_allcombined	1286283	1286312		galE	29
RK1001.C0101_allcombined	1286672	1286694		YPO_RS06710	22
RK1001.C0101_allcombined	1287430	1287436		YPO_RS06710	6
RK1001.C0101_allcombined	1287468	1287490		YPO_RS06710	22
RK1001.C0101_allcombined	1288396	1288405		modF	9
RK1001.C0101_allcombined	1289672	1289705		modE	33
RK1001.C0101_allcombined	1289866	1289877		modE	11
RK1001.C0101_allcombined	1290415	1290441		YPO_RS06725	26
RK1001.C0101_allcombined	1290551	1290555		YPO_RS06725	4
RK1001.C0101_allcombined	1291232	1291242		modA	10
RK1001.C0101_allcombined	1291272	1291292		modA	20
RK1001.C0101_allcombined	1291396	1291397		modA	1
RK1001.C0101_allcombined	1292253	1292266		modB	13
RK1001.C0101_allcombined	1293975	1293998		YPO_RS06745	23
RK1001.C0101_allcombined	1294031	1294059		YPO_RS06745	28
RK1001.C0101_allcombined	1295077	1295101		pgl	24
RK1001.C0101_allcombined	1295392	1295413		pgl	21
RK1001.C0101_allcombined	1295723	1295753		bioA	30
RK1001.C0101_allcombined	1296902	1296904		bioA	2
RK1001.C0101_allcombined	1296967	1296974		bioA	7
RK1001.C0101_allcombined	1297610	1297624		bioB	14
RK1001.C0101_allcombined	1297827	1297834		bioB	7
RK1001.C0101_allcombined	1297940	1297952		bioB	12
RK1001.C0101_allcombined	1298063	1298075		bioB	12
RK1001.C0101_allcombined	1298310	1298317		bioF	7
RK1001.C0101_allcombined	1298442	1298454		bioF	12
RK1001.C0101_allcombined	1299148	1299162		bioF	14
RK1001.C0101_allcombined	1299269	1299282		bioC	13
RK1001.C0101_allcombined	1299561	1299562		bioC	1
RK1001.C0101_allcombined	1300028	1300032		bioC	4
RK1001.C0101_allcombined	1300308	1300320		bioD	12
RK1001.C0101_allcombined	1300664	1300673		bioD	9
RK1001.C0101_allcombined	1300709	1300710		bioD	1
RK1001.C0101_allcombined	1301324	1301328		YPO_RS06780	4
RK1001.C0101_allcombined	1301365	1301368		YPO_RS06780	3
RK1001.C0101_allcombined	1301421	1301431		YPO_RS06780	10
RK1001.C0101_allcombined	1302810	1302818		uvrB	8
RK1001.C0101_allcombined	1303175	1303178		uvrB	3
RK1001.C0101_allcombined	1303403	1303404		uvrB	1
RK1001.C0101_allcombined	1304639	1304644		uvrB	5
RK1001.C0101_allcombined	1305022	1305024		YPO_RS06790	2
RK1001.C0101_allcombined	1305241	1305247		YPO_RS06790	6
RK1001.C0101_allcombined	1306000	1306005		yvcK	5
RK1001.C0101_allcombined	1306139	1306143		yvcK	4
RK1001.C0101_allcombined	1306230	1306231		yvcK	1
RK1001.C0101_allcombined	1307276	1307281		moaA	5
RK1001.C0101_allcombined	1308299	1308316		moaC	17
RK1001.C0101_allcombined	1308402	1308409		moaC	7
RK1001.C0101_allcombined	1308716	1308723		moaE	7
RK1001.C0101_allcombined	1308806	1308811		moaE	5
RK1001.C0101_allcombined	1309338	1309346		YPO_RS06820	8
RK1001.C0101_allcombined	1310310	1310317		YPO_RS06825	7
RK1001.C0101_allcombined	1310633	1310646		YPO_RS06825	13
RK1001.C0101_allcombined	1311094	1311111		betA	17
RK1001.C0101_allcombined	1311904	1311911		betA	7
RK1001.C0101_allcombined	1312002	1312007		betA	5
RK1001.C0101_allcombined	1312611	1312622		betB	11
RK1001.C0101_allcombined	1312720	1312726		betB	6
RK1001.C0101_allcombined	1312966	1312986		betB	20
RK1001.C0101_allcombined	1313564	1313578		betB	14
RK1001.C0101_allcombined	1314082	1314083		betB	1
RK1001.C0101_allcombined	1314336	1314383		betI	47
RK1001.C0101_allcombined	1314719	1314721		betI	2
RK1001.C0101_allcombined	1315161	1315169		YPO_RS06845	8
RK1001.C0101_allcombined	1315932	1315938		YPO_RS06845	6
RK1001.C0101_allcombined	1316303	1316309		YPO_RS06845	6
RK1001.C0101_allcombined	1316444	1316446		YPO_RS06845	2
RK1001.C0101_allcombined	1316672	1316694		YPO_RS06845	22
RK1001.C0101_allcombined	1316973	1317016		YPO_RS06845	43
RK1001.C0101_allcombined	1317111	1317123		YPO_RS06845	12
RK1001.C0101_allcombined	1317355	1317370		YPO_RS06850	15
RK1001.C0101_allcombined	1317606	1317617		YPO_RS06850	11
RK1001.C0101_allcombined	1317676	1317692		YPO_RS06850	16
RK1001.C0101_allcombined	1317756	1317783		YPO_RS06850	27
RK1001.C0101_allcombined	1317908	1317922		YPO_RS06850	14
RK1001.C0101_allcombined	1317993	1318012		YPO_RS06850	19
RK1001.C0101_allcombined	1318128	1318138		YPO_RS06850	10
RK1001.C0101_allcombined	1318197	1318203		YPO_RS06850	6
RK1001.C0101_allcombined	1318306	1318310		YPO_RS06855	4
RK1001.C0101_allcombined	1319480	1319516		xapA	36
RK1001.C0101_allcombined	1319548	1319549		xapA	1
RK1001.C0101_allcombined	1319636	1319660		xapA	24
RK1001.C0101_allcombined	1321342	1321382		YPO_RS06870	40
RK1001.C0101_allcombined	1321710	1321720		YPO_RS06870	10
RK1001.C0101_allcombined	1322221	1322311		YPO_RS06875	90
RK1001.C0101_allcombined	1322380	1322420		YPO_RS06875	40
RK1001.C0101_allcombined	1322457	1322472		YPO_RS06875	15
RK1001.C0101_allcombined	1322533	1322544		YPO_RS06875	11
RK1001.C0101_allcombined	1322673	1322739		YPO_RS06875	66
RK1001.C0101_allcombined	1322772	1322864		YPO_RS06875	92
RK1001.C0101_allcombined	1322960	1323028		YPO_RS06875	68
RK1001.C0101_allcombined	1323515	1323526		dusC	11
RK1001.C0101_allcombined	1324209	1324216		dusC	7
RK1001.C0101_allcombined	1324311	1324312		dusC	1
RK1001.C0101_allcombined	1324423	1324430		YPO_RS06885	7
RK1001.C0101_allcombined	1325326	1325341		pbpG	15
RK1001.C0101_allcombined	1325960	1325961		dld	1
RK1001.C0101_allcombined	1326153	1326165		dld	12
RK1001.C0101_allcombined	1326205	1326261		dld	56
RK1001.C0101_allcombined	1326431	1326435		dld	4
RK1001.C0101_allcombined	1326518	1326537		dld	19
RK1001.C0101_allcombined	1326667	1326689		dld	22
RK1001.C0101_allcombined	1327360	1327385		dld	25
RK1001.C0101_allcombined	1327601	1327604		dld	3
RK1001.C0101_allcombined	1327982	1328026		cyaB	44
RK1001.C0101_allcombined	1328197	1328248		cyaB	51
RK1001.C0101_allcombined	1328583	1328609		YPO_RS06905	26
RK1001.C0101_allcombined	1328762	1328763		YPO_RS06905	1
RK1001.C0101_allcombined	1329614	1329617		YPO_RS06910	3
RK1001.C0101_allcombined	1329728	1329741		YPO_RS06910	13
RK1001.C0101_allcombined	1329876	1329884		YPO_RS06910	8
RK1001.C0101_allcombined	1329947	1329950		YPO_RS06910	3
RK1001.C0101_allcombined	1330022	1330048		YPO_RS06910	26
RK1001.C0101_allcombined	1330126	1330129		YPO_RS06910	3
RK1001.C0101_allcombined	1330389	1330408		YPO_RS06915	19
RK1001.C0101_allcombined	1330486	1330542		YPO_RS06915	56
RK1001.C0101_allcombined	1330911	1330992		phnC	81
RK1001.C0101_allcombined	1331040	1331076		phnC	36
RK1001.C0101_allcombined	1331485	1331546		phnC	61
RK1001.C0101_allcombined	1331878	1331906		phnD	28
RK1001.C0101_allcombined	1332169	1332186		phnD	17
RK1001.C0101_allcombined	1332303	1332330		phnD	27
RK1001.C0101_allcombined	1332585	1332611		phnD	26
RK1001.C0101_allcombined	1333409	1333470		phnE	61
RK1001.C0101_allcombined	1333511	1333553		phnE	42
RK1001.C0101_allcombined	1333736	1333756		phnE	20
RK1001.C0101_allcombined	1333935	1333939		phnE	4
RK1001.C0101_allcombined	1334243	1334270		phnE	27
RK1001.C0101_allcombined	1334386	1334494		phnE	108
RK1001.C0101_allcombined	1334787	1334797		YPO_RS06940	10
RK1001.C0101_allcombined	1334941	1334944		YPO_RS06940	3
RK1001.C0101_allcombined	1336018	1336038		urtA	20
RK1001.C0101_allcombined	1336161	1336162		urtA	1
RK1001.C0101_allcombined	1336363	1336366		urtA	3
RK1001.C0101_allcombined	1337576	1337603		urtB	27
RK1001.C0101_allcombined	1337758	1337759		urtB	1
RK1001.C0101_allcombined	1337951	1337972		urtB	21
RK1001.C0101_allcombined	1338170	1338189		urtB	19
RK1001.C0101_allcombined	1338435	1338436		urtB	1
RK1001.C0101_allcombined	1338588	1338626		urtB	38
RK1001.C0101_allcombined	1339114	1339127		urtC	13
RK1001.C0101_allcombined	1339281	1339294		urtC	13
RK1001.C0101_allcombined	1339457	1339466		urtC	9
RK1001.C0101_allcombined	1339696	1339698		urtC	2
RK1001.C0101_allcombined	1339855	1339876		urtD	21
RK1001.C0101_allcombined	1339993	1339996		urtD	3
RK1001.C0101_allcombined	1340096	1340104		urtD	8
RK1001.C0101_allcombined	1341281	1341289		urtE	8
RK1001.C0101_allcombined	1341623	1341642		YPO_RS06970	19
RK1001.C0101_allcombined	1341677	1341702		YPO_RS06970	25
RK1001.C0101_allcombined	1342302	1342305		YPO_RS06970	3
RK1001.C0101_allcombined	1342567	1342569		YPO_RS06975	2
RK1001.C0101_allcombined	1342618	1342623		YPO_RS06975	5
RK1001.C0101_allcombined	1342815	1342818		YPO_RS06975	3
RK1001.C0101_allcombined	1343282	1343291		YPO_RS06975	9
RK1001.C0101_allcombined	1343412	1343419		YPO_RS06975	7
RK1001.C0101_allcombined	1343515	1343516		YPO_RS06975	1
RK1001.C0101_allcombined	1344017	1344023		sseA	6
RK1001.C0101_allcombined	1344518	1344519		sseA	1
RK1001.C0101_allcombined	1344647	1344656		sseA	9
RK1001.C0101_allcombined	1345835	1345846		YPO_RS06985	11
RK1001.C0101_allcombined	1346094	1346095		YPO_RS06990	1
RK1001.C0101_allcombined	1346348	1346356		YPO_RS06990	8
RK1001.C0101_allcombined	1346395	1346416		YPO_RS06990	21
RK1001.C0101_allcombined	1346855	1346862		YPO_RS06995	7
RK1001.C0101_allcombined	1346927	1346934		YPO_RS06995	7
RK1001.C0101_allcombined	1347527	1347535		YPO_RS06995	8
RK1001.C0101_allcombined	1347696	1347700		YPO_RS06995	4
RK1001.C0101_allcombined	1347741	1347757		YPO_RS06995	16
RK1001.C0101_allcombined	1347917	1347966		YPO_RS07000	49
RK1001.C0101_allcombined	1348404	1348414		YPO_RS07000	10
RK1001.C0101_allcombined	1348554	1348581		YPO_RS07000	27
RK1001.C0101_allcombined	1349323	1349330		YPO_RS07005	7
RK1001.C0101_allcombined	1350091	1350161		adiC	70
RK1001.C0101_allcombined	1350240	1350249		adiC	9
RK1001.C0101_allcombined	1350292	1350302		adiC	10
RK1001.C0101_allcombined	1350445	1350474		adiC	29
RK1001.C0101_allcombined	1350631	1350667		adiC	36
RK1001.C0101_allcombined	1351335	1351380		adiC	45
RK1001.C0101_allcombined	1351495	1351500		YPO_RS07015	5
RK1001.C0101_allcombined	1351695	1351701		YPO_RS07015	6
RK1001.C0101_allcombined	1352492	1352502		YPO_RS07015	10
RK1001.C0101_allcombined	1352773	1352777		YPO_RS07015	4
RK1001.C0101_allcombined	1352880	1352882		YPO_RS07015	2
RK1001.C0101_allcombined	1353010	1353014		YPO_RS07015	4
RK1001.C0101_allcombined	1353081	1353083		YPO_RS07015	2
RK1001.C0101_allcombined	1353409	1353425		YPO_RS07015	16
RK1001.C0101_allcombined	1353689	1353703		YPO_RS07015	14
RK1001.C0101_allcombined	1354778	1354781		yedA	3
RK1001.C0101_allcombined	1354889	1354903		yedA	14
RK1001.C0101_allcombined	1355549	1355556		ompF2	7
RK1001.C0101_allcombined	1355596	1355742		ompF2	146
RK1001.C0101_allcombined	1356626	1356634		ompF2	8
RK1001.C0101_allcombined	1357197	1357213		dinG	16
RK1001.C0101_allcombined	1357816	1357831		dinG	15
RK1001.C0101_allcombined	1358005	1358036		dinG	31
RK1001.C0101_allcombined	1358221	1358223		dinG	2
RK1001.C0101_allcombined	1358813	1358838		dinG	25
RK1001.C0101_allcombined	1358946	1358968		dinG	22
RK1001.C0101_allcombined	1359182	1359210		YPO_RS07040	28
RK1001.C0101_allcombined	1359577	1359578		YPO_RS07040	1
RK1001.C0101_allcombined	1359641	1359660		YPO_RS07040	19
RK1001.C0101_allcombined	1360008	1360051		YPO_RS07040	43
RK1001.C0101_allcombined	1360610	1360615		YPO_RS07040	5
RK1001.C0101_allcombined	1361096	1361099		YPO_RS07045	3
RK1001.C0101_allcombined	1361133	1361153		YPO_RS07045	20
RK1001.C0101_allcombined	1361336	1361338		YPO_RS07045	2
RK1001.C0101_allcombined	1361494	1361511		YPO_RS07045	17
RK1001.C0101_allcombined	1362125	1362128		tyrP	3
RK1001.C0101_allcombined	1362466	1362469		tyrP	3
RK1001.C0101_allcombined	1362513	1362522		tyrP	9
RK1001.C0101_allcombined	1362709	1362726		tyrP	17
RK1001.C0101_allcombined	1362818	1362820		tyrP	2
RK1001.C0101_allcombined	1363609	1363616		YPO_RS07055	7
RK1001.C0101_allcombined	1364295	1364296		YPO_RS07055	1
RK1001.C0101_allcombined	1364486	1364492		YPO_RS07055	6
RK1001.C0101_allcombined	1364912	1364933		eco	21
RK1001.C0101_allcombined	1365085	1365091		eco	6
RK1001.C0101_allcombined	1365316	1365344		eco	28
RK1001.C0101_allcombined	1365456	1365460		YPO_RS07065	4
RK1001.C0101_allcombined	1365717	1365719		nrdB	2
RK1001.C0101_allcombined	1365779	1365794		nrdB	15
RK1001.C0101_allcombined	1366243	1366249		nrdB	6
RK1001.C0101_allcombined	1367492	1367496		nrdA	4
RK1001.C0101_allcombined	1368108	1368119		nrdA	11
RK1001.C0101_allcombined	1368158	1368162		nrdA	4
RK1001.C0101_allcombined	1368406	1368412		nrdA	6
RK1001.C0101_allcombined	1368591	1368603		nrdA	12
RK1001.C0101_allcombined	1368912	1368920		nrdA	8
RK1001.C0101_allcombined	1370084	1370087		YPO_RS07080	3
RK1001.C0101_allcombined	1371112	1371113		gyrA	1
RK1001.C0101_allcombined	1371331	1371349		gyrA	18
RK1001.C0101_allcombined	1371898	1371910		gyrA	12
RK1001.C0101_allcombined	1372261	1372272		gyrA	11
RK1001.C0101_allcombined	1373109	1373200		gyrA	91
RK1001.C0101_allcombined	1373885	1373894		rcsC	9
RK1001.C0101_allcombined	1374074	1374109		rcsC	35
RK1001.C0101_allcombined	1374150	1374154		rcsC	4
RK1001.C0101_allcombined	1374197	1374209		rcsC	12
RK1001.C0101_allcombined	1374256	1374266		rcsC	10
RK1001.C0101_allcombined	1374394	1374402		rcsC	8
RK1001.C0101_allcombined	1374488	1374536		rcsC	48
RK1001.C0101_allcombined	1374758	1374807		rcsC	49
RK1001.C0101_allcombined	1375187	1375245		rcsC	58
RK1001.C0101_allcombined	1375522	1375539		rcsC	17
RK1001.C0101_allcombined	1375794	1375796		rcsC	2
RK1001.C0101_allcombined	1375955	1375967		rcsC	12
RK1001.C0101_allcombined	1376224	1376228		rcsC	4
RK1001.C0101_allcombined	1376929	1376981		rcsB	52
RK1001.C0101_allcombined	1377047	1377099		rcsB	52
RK1001.C0101_allcombined	1377237	1377250		YPO_RS07100	13
RK1001.C0101_allcombined	1377288	1377289		YPO_RS07100	1
RK1001.C0101_allcombined	1377472	1377514		YPO_RS07100	42
RK1001.C0101_allcombined	1377607	1377630		YPO_RS07100	23
RK1001.C0101_allcombined	1377683	1377688		YPO_RS07100	5
RK1001.C0101_allcombined	1378028	1378041		rcsD	13
RK1001.C0101_allcombined	1378149	1378153		rcsD	4
RK1001.C0101_allcombined	1378280	1378298		rcsD	18
RK1001.C0101_allcombined	1378361	1378364		rcsD	3
RK1001.C0101_allcombined	1378441	1378443		rcsD	2
RK1001.C0101_allcombined	1378600	1378654		rcsD	54
RK1001.C0101_allcombined	1378825	1378835		rcsD	10
RK1001.C0101_allcombined	1378948	1378959		rcsD	11
RK1001.C0101_allcombined	1378993	1379033		rcsD	40
RK1001.C0101_allcombined	1379629	1379675		rcsD	46
RK1001.C0101_allcombined	1379775	1379776		rcsD	1
RK1001.C0101_allcombined	1380323	1380326		YPO_RS07110	3
RK1001.C0101_allcombined	1380716	1380727		YPO_RS07110	11
RK1001.C0101_allcombined	1381032	1381034		YPO_RS07110	2
RK1001.C0101_allcombined	1382162	1382195		YPO_RS07115	33
RK1001.C0101_allcombined	1382262	1382300		YPO_RS07115	38
RK1001.C0101_allcombined	1382692	1382708		YPO_RS07115	16
RK1001.C0101_allcombined	1382781	1382792		YPO_RS07115	11
RK1001.C0101_allcombined	1383090	1383114		YPO_RS07115	24
RK1001.C0101_allcombined	1383255	1383277		YPO_RS07115	22
RK1001.C0101_allcombined	1383523	1383567		YPO_RS07120	44
RK1001.C0101_allcombined	1384762	1384770		ampH	8
RK1001.C0101_allcombined	1384854	1384866		ampH	12
RK1001.C0101_allcombined	1385492	1385540		ampH	48
RK1001.C0101_allcombined	1386363	1386413		YPO_RS07140	50
RK1001.C0101_allcombined	1387148	1387161		YPO_RS07140	13
RK1001.C0101_allcombined	1387325	1387354		YPO_RS07140	29
RK1001.C0101_allcombined	1387412	1387425		YPO_RS07140	13
RK1001.C0101_allcombined	1387505	1387509		YPO_RS07140	4
RK1001.C0101_allcombined	1388142	1388152		YPO_RS07145	10
RK1001.C0101_allcombined	1388565	1388567		YPO_RS07145	2
RK1001.C0101_allcombined	1388893	1388913		YPO_RS07145	20
RK1001.C0101_allcombined	1388957	1388960		YPO_RS07145	3
RK1001.C0101_allcombined	1388995	1388996		YPO_RS07145	1
RK1001.C0101_allcombined	1389075	1389079		YPO_RS07145	4
RK1001.C0101_allcombined	1389365	1389378		YPO_RS07150	13
RK1001.C0101_allcombined	1390102	1390111		YPO_RS07150	9
RK1001.C0101_allcombined	1390142	1390165		YPO_RS07150	23
RK1001.C0101_allcombined	1390281	1390286		YPO_RS07150	5
RK1001.C0101_allcombined	1390551	1390575		YPO_RS07150	24
RK1001.C0101_allcombined	1390684	1390707		YPO_RS07150	23
RK1001.C0101_allcombined	1391391	1391433		ycoA	42
RK1001.C0101_allcombined	1391656	1391735		ycoA	79
RK1001.C0101_allcombined	1391789	1391818		ycoA	29
RK1001.C0101_allcombined	1393041	1393042		YPO_RS07165	1
RK1001.C0101_allcombined	1394093	1394114		YPO_RS07170	21
RK1001.C0101_allcombined	1394343	1394365		YPO_RS07170	22
RK1001.C0101_allcombined	1394721	1394751		YPO_RS07175	30
RK1001.C0101_allcombined	1395314	1395342		YPO_RS07175	28
RK1001.C0101_allcombined	1397004	1397032		YPO_RS07185	28
RK1001.C0101_allcombined	1397262	1397284		YPO_RS07185	22
RK1001.C0101_allcombined	1397322	1397326		YPO_RS07185	4
RK1001.C0101_allcombined	1397782	1397851		YPO_RS07190	69
RK1001.C0101_allcombined	1397905	1397942		YPO_RS07190	37
RK1001.C0101_allcombined	1398008	1398010		YPO_RS07190	2
RK1001.C0101_allcombined	1398069	1398089		YPO_RS07190	20
RK1001.C0101_allcombined	1398952	1398963		YPO_RS07195	11
RK1001.C0101_allcombined	1399581	1399585		YPO_RS07200	4
RK1001.C0101_allcombined	1399723	1399752		YPO_RS07200	29
RK1001.C0101_allcombined	1400079	1400089		YPO_RS07210	10
RK1001.C0101_allcombined	1400593	1400597		YPO_RS07210	4
RK1001.C0101_allcombined	1400675	1400704		YPO_RS07210	29
RK1001.C0101_allcombined	1401297	1401301		YPO_RS07210	4
RK1001.C0101_allcombined	1401718	1401724		YPO_RS07215	6
RK1001.C0101_allcombined	1402050	1402054		YPO_RS07220	4
RK1001.C0101_allcombined	1402468	1402488		YPO_RS07225	20
RK1001.C0101_allcombined	1402527	1402549		YPO_RS07225	22
RK1001.C0101_allcombined	1402824	1402847		YPO_RS07225	23
RK1001.C0101_allcombined	1402962	1402977		YPO_RS07225	15
RK1001.C0101_allcombined	1403009	1403021		YPO_RS07225	12
RK1001.C0101_allcombined	1403441	1403488		YPO_RS07225	47
RK1001.C0101_allcombined	1403581	1403587		YPO_RS07225	6
RK1001.C0101_allcombined	1403726	1403739		YPO_RS07225	13
RK1001.C0101_allcombined	1405416	1405421		YPO_RS07230	5
RK1001.C0101_allcombined	1405547	1405577		YPO_RS07235	30
RK1001.C0101_allcombined	1405923	1405930		YPO_RS07235	7
RK1001.C0101_allcombined	1406003	1406012		YPO_RS07235	9
RK1001.C0101_allcombined	1406135	1406143		YPO_RS07235	8
RK1001.C0101_allcombined	1406517	1406523		YPO_RS07240	6
RK1001.C0101_allcombined	1407019	1407020		YPO_RS07240	1
RK1001.C0101_allcombined	1407090	1407112		YPO_RS07240	22
RK1001.C0101_allcombined	1407110	1407112		YPO_RS07245	2
RK1001.C0101_allcombined	1407148	1407150		YPO_RS07245	2
RK1001.C0101_allcombined	1407289	1407291		YPO_RS07245	2
RK1001.C0101_allcombined	1407633	1407639		YPO_RS07250	6
RK1001.C0101_allcombined	1408142	1408168		YPO_RS07250	26
RK1001.C0101_allcombined	1408357	1408361		YPO_RS07250	4
RK1001.C0101_allcombined	1409403	1409418		YPO_RS07265	15
RK1001.C0101_allcombined	1409741	1409744		YPO_RS07265	3
RK1001.C0101_allcombined	1409775	1409783		YPO_RS07265	8
RK1001.C0101_allcombined	1410163	1410182		YPO_RS07265	19
RK1001.C0101_allcombined	1410480	1410495		YPO_RS07270	15
RK1001.C0101_allcombined	1410628	1410705		YPO_RS07270	77
RK1001.C0101_allcombined	1410833	1410835		YPO_RS07270	2
RK1001.C0101_allcombined	1410865	1410933		YPO_RS07270	68
RK1001.C0101_allcombined	1411143	1411151		YPO_RS07270	8
RK1001.C0101_allcombined	1411210	1411220		YPO_RS07270	10
RK1001.C0101_allcombined	1411888	1411898		YPO_RS07275	10
RK1001.C0101_allcombined	1412025	1412036		YPO_RS07275	11
RK1001.C0101_allcombined	1412100	1412117		YPO_RS07275	17
RK1001.C0101_allcombined	1412385	1412400		YPO_RS07275	15
RK1001.C0101_allcombined	1412706	1412708		YPO_RS07275	2
RK1001.C0101_allcombined	1412777	1412791		YPO_RS07275	14
RK1001.C0101_allcombined	1412908	1412920		YPO_RS07275	12
RK1001.C0101_allcombined	1413235	1413250		YPO_RS07280	15
RK1001.C0101_allcombined	1413284	1413344		YPO_RS07280	60
RK1001.C0101_allcombined	1413391	1413410		YPO_RS07280	19
RK1001.C0101_allcombined	1414135	1414140		YPO_RS07285	5
RK1001.C0101_allcombined	1414171	1414175		YPO_RS07285	4
RK1001.C0101_allcombined	1414211	1414223		YPO_RS07285	12
RK1001.C0101_allcombined	1414268	1414301		YPO_RS07285	33
RK1001.C0101_allcombined	1414400	1414410		YPO_RS07285	10
RK1001.C0101_allcombined	1414494	1414532		YPO_RS07285	38
RK1001.C0101_allcombined	1414769	1414814		YPO_RS07290	45
RK1001.C0101_allcombined	1414907	1414918		YPO_RS07290	11
RK1001.C0101_allcombined	1415028	1415037		YPO_RS07290	9
RK1001.C0101_allcombined	1415463	1415466		YPO_RS07290	3
RK1001.C0101_allcombined	1416848	1416854		YPO_RS07305	6
RK1001.C0101_allcombined	1418746	1418752		YPO_RS07310	6
RK1001.C0101_allcombined	1419336	1419354		yejK	18
RK1001.C0101_allcombined	1421257	1421282		YPO_RS07330	25
RK1001.C0101_allcombined	1422030	1422036		YPO_RS07330	6
RK1001.C0101_allcombined	1422139	1422142		YPO_RS07330	3
RK1001.C0101_allcombined	1422426	1422440		YPO_RS07330	14
RK1001.C0101_allcombined	1422475	1422484		YPO_RS07330	9
RK1001.C0101_allcombined	1422530	1422534		YPO_RS07330	4
RK1001.C0101_allcombined	1422942	1422945		YPO_RS07330	3
RK1001.C0101_allcombined	1423596	1423602		rsuA	6
RK1001.C0101_allcombined	1423770	1423778		rsuA	8
RK1001.C0101_allcombined	1424145	1424153		rsuA	8
RK1001.C0101_allcombined	1424504	1424508		YPO_RS07340	4
RK1001.C0101_allcombined	1424754	1424771		YPO_RS07340	17
RK1001.C0101_allcombined	1425067	1425071		YPO_RS07340	4
RK1001.C0101_allcombined	1425498	1425518		YPO_RS07340	20
RK1001.C0101_allcombined	1426900	1426946		yejF	46
RK1001.C0101_allcombined	1427055	1427059		yejF	4
RK1001.C0101_allcombined	1427136	1427147		yejF	11
RK1001.C0101_allcombined	1427496	1427515		yejF	19
RK1001.C0101_allcombined	1427844	1427847		yejF	3
RK1001.C0101_allcombined	1428044	1428056		yejF	12
RK1001.C0101_allcombined	1428772	1428775		YPO_RS07355	3
RK1001.C0101_allcombined	1428968	1428974		YPO_RS07355	6
RK1001.C0101_allcombined	1429007	1429014		YPO_RS07355	7
RK1001.C0101_allcombined	1429560	1429569		YPO_RS07360	9
RK1001.C0101_allcombined	1429974	1429993		YPO_RS07360	19
RK1001.C0101_allcombined	1430068	1430080		YPO_RS07360	12
RK1001.C0101_allcombined	1430298	1430328		YPO_RS07360	30
RK1001.C0101_allcombined	1430443	1430454		YPO_RS07360	11
RK1001.C0101_allcombined	1430529	1430530		YPO_RS07360	1
RK1001.C0101_allcombined	1430632	1430634		YPO_RS07365	2
RK1001.C0101_allcombined	1430766	1430769		YPO_RS07365	3
RK1001.C0101_allcombined	1430985	1430997		YPO_RS07365	12
RK1001.C0101_allcombined	1431161	1431171		YPO_RS07365	10
RK1001.C0101_allcombined	1431989	1431999		YPO_RS07365	10
RK1001.C0101_allcombined	1432284	1432291		YPO_RS07365	7
RK1001.C0101_allcombined	1433421	1433497		YPO_RS07370	76
RK1001.C0101_allcombined	1433915	1433947		YPO_RS07370	32
RK1001.C0101_allcombined	1433985	1433987		YPO_RS07370	2
RK1001.C0101_allcombined	1434690	1434696		mepS	6
RK1001.C0101_allcombined	1434775	1434777		mepS	2
RK1001.C0101_allcombined	1435018	1435037		mepS	19
RK1001.C0101_allcombined	1435254	1435255		mepS	1
RK1001.C0101_allcombined	1435811	1435825		YPO_RS07380	14
RK1001.C0101_allcombined	1436047	1436064		YPO_RS07380	17
RK1001.C0101_allcombined	1436170	1436194		YPO_RS07380	24
RK1001.C0101_allcombined	1436300	1436367		YPO_RS07380	67
RK1001.C0101_allcombined	1436476	1436515		YPO_RS07385	39
RK1001.C0101_allcombined	1436595	1436611		YPO_RS07385	16
RK1001.C0101_allcombined	1437445	1437459		YPO_RS07385	14
RK1001.C0101_allcombined	1438656	1438690		YPO_RS07390	34
RK1001.C0101_allcombined	1439573	1439596		YPO_RS07395	23
RK1001.C0101_allcombined	1439847	1439881		YPO_RS07395	34
RK1001.C0101_allcombined	1441282	1441291		uxuA	9
RK1001.C0101_allcombined	1441626	1441644		uxuA	18
RK1001.C0101_allcombined	1442024	1442039		uxuA	15
RK1001.C0101_allcombined	1442147	1442160		uxuA	13
RK1001.C0101_allcombined	1442403	1442404		uxuA	1
RK1001.C0101_allcombined	1442949	1442965		yeiP	16
RK1001.C0101_allcombined	1442999	1443020		yeiP	21
RK1001.C0101_allcombined	1443431	1443437		mtr	6
RK1001.C0101_allcombined	1444145	1444155		mtr	10
RK1001.C0101_allcombined	1444205	1444210		mtr	5
RK1001.C0101_allcombined	1444317	1444324		mtr	7
RK1001.C0101_allcombined	1444463	1444464		mtr	1
RK1001.C0101_allcombined	1445183	1445186		YPO_RS07420	3
RK1001.C0101_allcombined	1445278	1445284		YPO_RS07420	6
RK1001.C0101_allcombined	1445396	1445407		YPO_RS07420	11
RK1001.C0101_allcombined	1445639	1445652		YPO_RS07420	13
RK1001.C0101_allcombined	1445860	1445865		YPO_RS07420	5
RK1001.C0101_allcombined	1446015	1446025		YPO_RS07425	10
RK1001.C0101_allcombined	1446244	1446246		YPO_RS07425	2
RK1001.C0101_allcombined	1446331	1446344		YPO_RS07425	13
RK1001.C0101_allcombined	1446567	1446578		YPO_RS07425	11
RK1001.C0101_allcombined	1447165	1447167		YPO_RS07430	2
RK1001.C0101_allcombined	1448915	1448921		YPO_RS07435	6
RK1001.C0101_allcombined	1449018	1449026		YPO_RS07435	8
RK1001.C0101_allcombined	1449259	1449291		YPO_RS07435	32
RK1001.C0101_allcombined	1449520	1449521		YPO_RS07435	1
RK1001.C0101_allcombined	1449663	1449672		YPO_RS07435	9
RK1001.C0101_allcombined	1449836	1449837		YPO_RS07435	1
RK1001.C0101_allcombined	1449920	1449933		YPO_RS07435	13
RK1001.C0101_allcombined	1450796	1450798		xylB	2
RK1001.C0101_allcombined	1450925	1450926		xylB	1
RK1001.C0101_allcombined	1451377	1451381		xylB	4
RK1001.C0101_allcombined	1451814	1451820		rpiA	6
RK1001.C0101_allcombined	1451980	1451985		rpiA	5
RK1001.C0101_allcombined	1452469	1452491		YPO_RS07450	22
RK1001.C0101_allcombined	1452725	1452738		YPO_RS07450	13
RK1001.C0101_allcombined	1452953	1452959		YPO_RS07450	6
RK1001.C0101_allcombined	1453602	1453604		YPO_RS07455	2
RK1001.C0101_allcombined	1454038	1454043		YPO_RS07455	5
RK1001.C0101_allcombined	1454705	1454723		YPO_RS07455	18
RK1001.C0101_allcombined	1455503	1455524		YPO_RS07460	21
RK1001.C0101_allcombined	1455703	1455708		YPO_RS07460	5
RK1001.C0101_allcombined	1455765	1455767		YPO_RS07460	2
RK1001.C0101_allcombined	1456314	1456318		YPO_RS07465	4
RK1001.C0101_allcombined	1456544	1456552		YPO_RS07465	8
RK1001.C0101_allcombined	1457202	1457207		YPO_RS07470	5
RK1001.C0101_allcombined	1457633	1457638		YPO_RS07470	5
RK1001.C0101_allcombined	1458126	1458127		YPO_RS07470	1
RK1001.C0101_allcombined	1458126	1458164		fruK	38
RK1001.C0101_allcombined	1458376	1458387		fruK	11
RK1001.C0101_allcombined	1458459	1458470		fruK	11
RK1001.C0101_allcombined	1459263	1459264		fruA	1
RK1001.C0101_allcombined	1459438	1459453		fruA	15
RK1001.C0101_allcombined	1460609	1460613		fruA	4
RK1001.C0101_allcombined	1461102	1461142		YPO_RS07485	40
RK1001.C0101_allcombined	1461312	1461390		YPO_RS07485	78
RK1001.C0101_allcombined	1461550	1461630		YPO_RS07485	80
RK1001.C0101_allcombined	1461774	1461844		YPO_RS07490	70
RK1001.C0101_allcombined	1461880	1461890		YPO_RS07490	10
RK1001.C0101_allcombined	1461934	1462024		YPO_RS07490	90
RK1001.C0101_allcombined	1462148	1462165		YPO_RS07490	17
RK1001.C0101_allcombined	1462196	1462231		YPO_RS07490	35
RK1001.C0101_allcombined	1462986	1462995		psaA	9
RK1001.C0101_allcombined	1463037	1463084		psaA	47
RK1001.C0101_allcombined	1463132	1463174		psaA	42
RK1001.C0101_allcombined	1463379	1463398		YPO_RS07500	19
RK1001.C0101_allcombined	1463484	1463515		YPO_RS07500	31
RK1001.C0101_allcombined	1463549	1463564		YPO_RS07500	15
RK1001.C0101_allcombined	1463600	1463610		YPO_RS07500	10
RK1001.C0101_allcombined	1463645	1463664		YPO_RS07500	19
RK1001.C0101_allcombined	1463851	1464014		YPO_RS07500	163
RK1001.C0101_allcombined	1464073	1464081		YPO_RS07500	8
RK1001.C0101_allcombined	1464140	1464173		YPO_RS07500	33
RK1001.C0101_allcombined	1464284	1464296		psaC	12
RK1001.C0101_allcombined	1464331	1464350		psaC	19
RK1001.C0101_allcombined	1464434	1464435		psaC	1
RK1001.C0101_allcombined	1464635	1464663		psaC	28
RK1001.C0101_allcombined	1464881	1464899		psaC	18
RK1001.C0101_allcombined	1465074	1465075		psaC	1
RK1001.C0101_allcombined	1465117	1465129		psaC	12
RK1001.C0101_allcombined	1465350	1465360		psaC	10
RK1001.C0101_allcombined	1465426	1465430		psaC	4
RK1001.C0101_allcombined	1465617	1465654		psaC	37
RK1001.C0101_allcombined	1465845	1465875		psaC	30
RK1001.C0101_allcombined	1465920	1465928		psaC	8
RK1001.C0101_allcombined	1466164	1466166		psaC	2
RK1001.C0101_allcombined	1466212	1466244		psaC	32
RK1001.C0101_allcombined	1467167	1467177		nfo	10
RK1001.C0101_allcombined	1468460	1468465		YPO_RS07515	5
RK1001.C0101_allcombined	1468600	1468613		YPO_RS07515	13
RK1001.C0101_allcombined	1468691	1468752		YPO_RS07515	61
RK1001.C0101_allcombined	1468843	1468849		YPO_RS07515	6
RK1001.C0101_allcombined	1469609	1469615		YPO_RS07520	6
RK1001.C0101_allcombined	1470110	1470116		YPO_RS07520	6
RK1001.C0101_allcombined	1470341	1470343		YPO_RS07520	2
RK1001.C0101_allcombined	1470396	1470416		YPO_RS07520	20
RK1001.C0101_allcombined	1471056	1471067		YPO_RS07525	11
RK1001.C0101_allcombined	1471260	1471277		YPO_RS07525	17
RK1001.C0101_allcombined	1471844	1471875		YPO_RS07525	31
RK1001.C0101_allcombined	1472695	1472720		YPO_RS07530	25
RK1001.C0101_allcombined	1472913	1472946		YPO_RS07530	33
RK1001.C0101_allcombined	1473086	1473120		YPO_RS07530	34
RK1001.C0101_allcombined	1473293	1473297		YPO_RS07530	4
RK1001.C0101_allcombined	1473949	1473977		YPO_RS07535	28
RK1001.C0101_allcombined	1474436	1474443		YPO_RS07535	7
RK1001.C0101_allcombined	1474917	1474949		YPO_RS07535	32
RK1001.C0101_allcombined	1475467	1475474		YPO_RS07540	7
RK1001.C0101_allcombined	1476003	1476012		YPO_RS07545	9
RK1001.C0101_allcombined	1476339	1476354		YPO_RS07545	15
RK1001.C0101_allcombined	1476462	1476486		YPO_RS07545	24
RK1001.C0101_allcombined	1476616	1476643		YPO_RS07545	27
RK1001.C0101_allcombined	1476691	1476700		YPO_RS07545	9
RK1001.C0101_allcombined	1476780	1476786		YPO_RS07545	6
RK1001.C0101_allcombined	1476860	1476907		YPO_RS07545	47
RK1001.C0101_allcombined	1476978	1476996		YPO_RS07545	18
RK1001.C0101_allcombined	1477029	1477058		YPO_RS07545	29
RK1001.C0101_allcombined	1477187	1477191		YPO_RS07545	4
RK1001.C0101_allcombined	1477432	1477483		YPO_RS07545	51
RK1001.C0101_allcombined	1477519	1477543		YPO_RS07545	24
RK1001.C0101_allcombined	1478772	1478774		YPO_RS07550	2
RK1001.C0101_allcombined	1479061	1479068		YPO_RS07555	7
RK1001.C0101_allcombined	1479135	1479144		YPO_RS07555	9
RK1001.C0101_allcombined	1479242	1479262		YPO_RS07555	20
RK1001.C0101_allcombined	1480261	1480276		YPO_RS07560	15
RK1001.C0101_allcombined	1481476	1481497		YPO_RS07565	21
RK1001.C0101_allcombined	1481729	1481735		YPO_RS07565	6
RK1001.C0101_allcombined	1482165	1482168		YPO_RS07565	3
RK1001.C0101_allcombined	1482330	1482340		YPO_RS07570	10
RK1001.C0101_allcombined	1482972	1482989		YPO_RS07570	17
RK1001.C0101_allcombined	1483213	1483216		YPO_RS07570	3
RK1001.C0101_allcombined	1484286	1484311		YPO_RS07580	25
RK1001.C0101_allcombined	1484380	1484389		YPO_RS07580	9
RK1001.C0101_allcombined	1485991	1486028		YPO_RS07585	37
RK1001.C0101_allcombined	1486140	1486157		YPO_RS07585	17
RK1001.C0101_allcombined	1486392	1486399		YPO_RS07585	7
RK1001.C0101_allcombined	1486677	1486689		YPO_RS07585	12
RK1001.C0101_allcombined	1487139	1487146		YPO_RS07585	7
RK1001.C0101_allcombined	1488670	1488678		deoR	8
RK1001.C0101_allcombined	1488866	1488876		deoR	10
RK1001.C0101_allcombined	1489877	1489887		YPO_RS07595	10
RK1001.C0101_allcombined	1489966	1489997		YPO_RS07595	31
RK1001.C0101_allcombined	1490278	1490310		ybjG	32
RK1001.C0101_allcombined	1490470	1490477		ybjG	7
RK1001.C0101_allcombined	1490728	1490736		ybjG	8
RK1001.C0101_allcombined	1490869	1490887		YPO_RS07605	18
RK1001.C0101_allcombined	1491192	1491200		YPO_RS07605	8
RK1001.C0101_allcombined	1491458	1491470		YPO_RS07605	12
RK1001.C0101_allcombined	1491504	1491531		YPO_RS07605	27
RK1001.C0101_allcombined	1492502	1492519		YPO_RS07610	17
RK1001.C0101_allcombined	1492785	1492808		YPO_RS07610	23
RK1001.C0101_allcombined	1492954	1492956		YPO_RS07610	2
RK1001.C0101_allcombined	1493551	1493556		YPO_RS07610	5
RK1001.C0101_allcombined	1493695	1493696		YPO_RS07610	1
RK1001.C0101_allcombined	1494880	1494922		YPO_RS07620	42
RK1001.C0101_allcombined	1496471	1496490		potF	19
RK1001.C0101_allcombined	1497806	1497826		potG	20
RK1001.C0101_allcombined	1498120	1498139		potG	19
RK1001.C0101_allcombined	1499006	1499022		potH	16
RK1001.C0101_allcombined	1499503	1499524		potH	21
RK1001.C0101_allcombined	1499750	1499755		potI	5
RK1001.C0101_allcombined	1500049	1500058		potI	9
RK1001.C0101_allcombined	1501768	1501770		rlmC	2
RK1001.C0101_allcombined	1503510	1503517		YPO_RS07665	7
RK1001.C0101_allcombined	1505404	1505406		YPO_RS07680	2
RK1001.C0101_allcombined	1505599	1505634		YPO_RS07680	35
RK1001.C0101_allcombined	1506180	1506293		YPO_RS07685	113
RK1001.C0101_allcombined	1506351	1506375		YPO_RS07685	24
RK1001.C0101_allcombined	1506435	1506437		YPO_RS07685	2
RK1001.C0101_allcombined	1506490	1506529		YPO_RS07685	39
RK1001.C0101_allcombined	1506887	1506901		YPO_RS07685	14
RK1001.C0101_allcombined	1507920	1507937		YPO_RS07690	17
RK1001.C0101_allcombined	1507978	1507982		YPO_RS07690	4
RK1001.C0101_allcombined	1509111	1509132		YPO_RS07705	21
RK1001.C0101_allcombined	1509357	1509360		YPO_RS07705	3
RK1001.C0101_allcombined	1510980	1511004		YPO_RS07715	24
RK1001.C0101_allcombined	1511096	1511117		YPO_RS07720	21
RK1001.C0101_allcombined	1511577	1511588		YPO_RS07720	11
RK1001.C0101_allcombined	1511660	1511685		YPO_RS07720	25
RK1001.C0101_allcombined	1512241	1512247		YPO_RS07720	6
RK1001.C0101_allcombined	1512588	1512593		YPO_RS07725	5
RK1001.C0101_allcombined	1512806	1512812		YPO_RS07725	6
RK1001.C0101_allcombined	1512953	1512957		YPO_RS07725	4
RK1001.C0101_allcombined	1513534	1513540		artM	6
RK1001.C0101_allcombined	1513928	1513935		artM	7
RK1001.C0101_allcombined	1514066	1514077		artM	11
RK1001.C0101_allcombined	1514188	1514200		artQ	12
RK1001.C0101_allcombined	1514258	1514264		artQ	6
RK1001.C0101_allcombined	1514297	1514301		artQ	4
RK1001.C0101_allcombined	1514473	1514486		artQ	13
RK1001.C0101_allcombined	1514660	1514674		artQ	14
RK1001.C0101_allcombined	1514837	1514845		artJ	8
RK1001.C0101_allcombined	1515007	1515013		artJ	6
RK1001.C0101_allcombined	1515139	1515157		artJ	18
RK1001.C0101_allcombined	1515287	1515293		artJ	6
RK1001.C0101_allcombined	1515538	1515549		artJ	11
RK1001.C0101_allcombined	1515609	1515614		artP	5
RK1001.C0101_allcombined	1515705	1515715		artP	10
RK1001.C0101_allcombined	1515855	1515859		artP	4
RK1001.C0101_allcombined	1516184	1516196		artP	12
RK1001.C0101_allcombined	1516278	1516288		artP	10
RK1001.C0101_allcombined	1516603	1516620		YPO_RS07755	17
RK1001.C0101_allcombined	1517034	1517048		YPO_RS07755	14
RK1001.C0101_allcombined	1517549	1517550		YPO_RS07760	1
RK1001.C0101_allcombined	1517897	1517898		YPO_RS07760	1
RK1001.C0101_allcombined	1518051	1518057		YPO_RS07765	6
RK1001.C0101_allcombined	1518093	1518104		YPO_RS07765	11
RK1001.C0101_allcombined	1518650	1518670		YPO_RS07765	20
RK1001.C0101_allcombined	1519456	1519458		YPO_RS07770	2
RK1001.C0101_allcombined	1519651	1519655		YPO_RS07770	4
RK1001.C0101_allcombined	1519846	1519878		YPO_RS07770	32
RK1001.C0101_allcombined	1520355	1520364		YPO_RS07770	9
RK1001.C0101_allcombined	1521208	1521211		ltaE	3
RK1001.C0101_allcombined	1521295	1521304		ltaE	9
RK1001.C0101_allcombined	1522014	1522031		poxB	17
RK1001.C0101_allcombined	1522281	1522305		poxB	24
RK1001.C0101_allcombined	1522376	1522385		poxB	9
RK1001.C0101_allcombined	1522530	1522536		poxB	6
RK1001.C0101_allcombined	1523480	1523482		poxB	2
RK1001.C0101_allcombined	1524427	1524434		hcr	7
RK1001.C0101_allcombined	1525059	1525092		hcp	33
RK1001.C0101_allcombined	1525396	1525406		hcp	10
RK1001.C0101_allcombined	1525995	1526001		hcp	6
RK1001.C0101_allcombined	1526274	1526276		hcp	2
RK1001.C0101_allcombined	1526812	1526813		YPO_RS07795	1
RK1001.C0101_allcombined	1527515	1527521		YPO_RS07795	6
RK1001.C0101_allcombined	1527576	1527603		YPO_RS07795	27
RK1001.C0101_allcombined	1528261	1528265		YPO_RS07800	4
RK1001.C0101_allcombined	1528428	1528434		YPO_RS07800	6
RK1001.C0101_allcombined	1529378	1529382		YPO_RS07800	4
RK1001.C0101_allcombined	1529516	1529521		YPO_RS07800	5
RK1001.C0101_allcombined	1529651	1529652		YPO_RS07800	1
RK1001.C0101_allcombined	1530105	1530118		YPO_RS07805	13
RK1001.C0101_allcombined	1530455	1530462		YPO_RS07805	7
RK1001.C0101_allcombined	1530606	1530613		YPO_RS07805	7
RK1001.C0101_allcombined	1530649	1530663		YPO_RS07805	14
RK1001.C0101_allcombined	1530747	1530807		YPO_RS07805	60
RK1001.C0101_allcombined	1531246	1531275		macA	29
RK1001.C0101_allcombined	1531714	1531715		macA	1
RK1001.C0101_allcombined	1531762	1531770		macA	8
RK1001.C0101_allcombined	1531997	1532012		macA	15
RK1001.C0101_allcombined	1532754	1532757		macB	3
RK1001.C0101_allcombined	1533140	1533149		macB	9
RK1001.C0101_allcombined	1533595	1533619		macB	24
RK1001.C0101_allcombined	1533666	1533687		macB	21
RK1001.C0101_allcombined	1534434	1534442		cspD	8
RK1001.C0101_allcombined	1534638	1534643		cspD	5
RK1001.C0101_allcombined	1535089	1535114		clpS	25
RK1001.C0101_allcombined	1535183	1535197		clpS	14
RK1001.C0101_allcombined	1535314	1535329		clpS	15
RK1001.C0101_allcombined	1535565	1535577		clpA	12
RK1001.C0101_allcombined	1536238	1536246		clpA	8
RK1001.C0101_allcombined	1536387	1536452		clpA	65
RK1001.C0101_allcombined	1536837	1536861		clpA	24
RK1001.C0101_allcombined	1536963	1537010		clpA	47
RK1001.C0101_allcombined	1537377	1537393		clpA	16
RK1001.C0101_allcombined	1538807	1538819		infA	12
RK1001.C0101_allcombined	1539286	1539320		aat	34
RK1001.C0101_allcombined	1539369	1539381		aat	12
RK1001.C0101_allcombined	1540122	1540127		cydC	5
RK1001.C0101_allcombined	1540177	1540194		cydC	17
RK1001.C0101_allcombined	1540993	1541012		cydC	19
RK1001.C0101_allcombined	1541859	1541863		cydD	4
RK1001.C0101_allcombined	1542466	1542473		cydD	7
RK1001.C0101_allcombined	1542744	1542746		cydD	2
RK1001.C0101_allcombined	1543030	1543031		cydD	1
RK1001.C0101_allcombined	1543108	1543112		cydD	4
RK1001.C0101_allcombined	1544231	1544236		trxB	5
RK1001.C0101_allcombined	1544334	1544351		trxB	17
RK1001.C0101_allcombined	1544916	1544918		trxB	2
RK1001.C0101_allcombined	1545754	1545763		lrp	9
RK1001.C0101_allcombined	1545795	1545844		lrp	49
RK1001.C0101_allcombined	1546376	1546390		YPO_RS07870	14
RK1001.C0101_allcombined	1546509	1546517		YPO_RS07870	8
RK1001.C0101_allcombined	1546779	1546809		YPO_RS07870	30
RK1001.C0101_allcombined	1547010	1547018		YPO_RS07870	8
RK1001.C0101_allcombined	1548028	1548041		YPO_RS07870	13
RK1001.C0101_allcombined	1548249	1548266		YPO_RS07870	17
RK1001.C0101_allcombined	1548433	1548437		YPO_RS07870	4
RK1001.C0101_allcombined	1548609	1548628		YPO_RS07870	19
RK1001.C0101_allcombined	1548936	1548938		YPO_RS07870	2
RK1001.C0101_allcombined	1549392	1549394		YPO_RS07870	2
RK1001.C0101_allcombined	1549885	1549889		YPO_RS07870	4
RK1001.C0101_allcombined	1550711	1550746		lolA	35
RK1001.C0101_allcombined	1550807	1550826		lolA	19
RK1001.C0101_allcombined	1551112	1551116		YPO_RS07880	4
RK1001.C0101_allcombined	1551317	1551319		YPO_RS07880	2
RK1001.C0101_allcombined	1551494	1551507		YPO_RS07880	13
RK1001.C0101_allcombined	1551947	1551964		YPO_RS07880	17
RK1001.C0101_allcombined	1551996	1551998		YPO_RS07880	2
RK1001.C0101_allcombined	1552916	1552941		serS	25
RK1001.C0101_allcombined	1553290	1553292		serS	2
RK1001.C0101_allcombined	1553326	1553327		serS	1
RK1001.C0101_allcombined	1553924	1553931		serS	7
RK1001.C0101_allcombined	1554474	1554478		YPO_RS07890	4
RK1001.C0101_allcombined	1554598	1554610		YPO_RS07890	12
RK1001.C0101_allcombined	1554693	1554747		YPO_RS07890	54
RK1001.C0101_allcombined	1554841	1554864		YPO_RS07890	23
RK1001.C0101_allcombined	1554918	1554957		YPO_RS07890	39
RK1001.C0101_allcombined	1555230	1555235		YPO_RS07890	5
RK1001.C0101_allcombined	1555717	1555718		pflA	1
RK1001.C0101_allcombined	1557274	1557298		YPO_RS07900	24
RK1001.C0101_allcombined	1557391	1557398		YPO_RS07900	7
RK1001.C0101_allcombined	1557510	1557511		YPO_RS07900	1
RK1001.C0101_allcombined	1557547	1557626		YPO_RS07900	79
RK1001.C0101_allcombined	1557774	1557786		YPO_RS07900	12
RK1001.C0101_allcombined	1557823	1557828		YPO_RS07900	5
RK1001.C0101_allcombined	1557936	1557937		YPO_RS07900	1
RK1001.C0101_allcombined	1558646	1558655		pflB	9
RK1001.C0101_allcombined	1559141	1559168		pflB	27
RK1001.C0101_allcombined	1559246	1559259		pflB	13
RK1001.C0101_allcombined	1559394	1559395		pflB	1
RK1001.C0101_allcombined	1560746	1560760		focA	14
RK1001.C0101_allcombined	1560913	1560914		focA	1
RK1001.C0101_allcombined	1560989	1560999		focA	10
RK1001.C0101_allcombined	1561081	1561083		focA	2
RK1001.C0101_allcombined	1561136	1561170		focA	34
RK1001.C0101_allcombined	1562205	1562210		YPO_RS07915	5
RK1001.C0101_allcombined	1562455	1562484		YPO_RS07915	29
RK1001.C0101_allcombined	1562553	1562586		YPO_RS07915	33
RK1001.C0101_allcombined	1562703	1562711		YPO_RS07915	8
RK1001.C0101_allcombined	1563178	1563185		YPO_RS07915	7
RK1001.C0101_allcombined	1563396	1563400		YPO_RS07915	4
RK1001.C0101_allcombined	1563442	1563449		YPO_RS07915	7
RK1001.C0101_allcombined	1563567	1563615		YPO_RS07915	48
RK1001.C0101_allcombined	1563862	1563864		ansB	2
RK1001.C0101_allcombined	1563959	1563969		ansB	10
RK1001.C0101_allcombined	1564168	1564196		ansB	28
RK1001.C0101_allcombined	1564413	1564427		ansB	14
RK1001.C0101_allcombined	1564569	1564577		ansB	8
RK1001.C0101_allcombined	1564748	1564761		ansB	13
RK1001.C0101_allcombined	1564876	1564892		ansB	16
RK1001.C0101_allcombined	1565168	1565176		YPO_RS07925	8
RK1001.C0101_allcombined	1565401	1565407		YPO_RS07925	6
RK1001.C0101_allcombined	1565519	1565524		YPO_RS07925	5
RK1001.C0101_allcombined	1565670	1565689		YPO_RS07925	19
RK1001.C0101_allcombined	1565833	1565931		YPO_RS07925	98
RK1001.C0101_allcombined	1565969	1566050		YPO_RS07925	81
RK1001.C0101_allcombined	1566089	1566096		YPO_RS07925	7
RK1001.C0101_allcombined	1566299	1566399		YPO_RS07930	100
RK1001.C0101_allcombined	1566429	1566459		YPO_RS07930	30
RK1001.C0101_allcombined	1566493	1566514		YPO_RS07930	21
RK1001.C0101_allcombined	1566599	1566604		YPO_RS07930	5
RK1001.C0101_allcombined	1566660	1566685		YPO_RS07930	25
RK1001.C0101_allcombined	1566817	1566829		YPO_RS07930	12
RK1001.C0101_allcombined	1566861	1566872		YPO_RS07930	11
RK1001.C0101_allcombined	1566928	1566972		YPO_RS07930	44
RK1001.C0101_allcombined	1567037	1567047		YPO_RS07930	10
RK1001.C0101_allcombined	1567346	1567347		YPO_RS07930	1
RK1001.C0101_allcombined	1567401	1567461		YPO_RS07930	60
RK1001.C0101_allcombined	1567506	1567551		YPO_RS07930	45
RK1001.C0101_allcombined	1567616	1567655		YPO_RS07930	39
RK1001.C0101_allcombined	1567698	1567837		YPO_RS07930	139
RK1001.C0101_allcombined	1568102	1568115		YPO_RS07930	13
RK1001.C0101_allcombined	1568621	1568626		serC	5
RK1001.C0101_allcombined	1569005	1569032		serC	27
RK1001.C0101_allcombined	1569177	1569183		serC	6
RK1001.C0101_allcombined	1569365	1569401		serC	36
RK1001.C0101_allcombined	1569778	1569791		aroA	13
RK1001.C0101_allcombined	1569857	1569859		aroA	2
RK1001.C0101_allcombined	1569905	1569931		aroA	26
RK1001.C0101_allcombined	1570210	1570220		aroA	10
RK1001.C0101_allcombined	1570348	1570352		aroA	4
RK1001.C0101_allcombined	1570388	1570399		aroA	11
RK1001.C0101_allcombined	1571608	1571624		cmk	16
RK1001.C0101_allcombined	1572306	1572318		rpsA	12
RK1001.C0101_allcombined	1572684	1572687		rpsA	3
RK1001.C0101_allcombined	1572806	1572809		rpsA	3
RK1001.C0101_allcombined	1573564	1573581		rpsA	17
RK1001.C0101_allcombined	1573791	1573808		rpsA	17
RK1001.C0101_allcombined	1575220	1575226		YPO_RS07960	6
RK1001.C0101_allcombined	1575419	1575425		YPO_RS07960	6
RK1001.C0101_allcombined	1575930	1575974		YPO_RS07960	44
RK1001.C0101_allcombined	1576585	1576592		YPO_RS07960	7
RK1001.C0101_allcombined	1577102	1577109		msbA	7
RK1001.C0101_allcombined	1577221	1577248		msbA	27
RK1001.C0101_allcombined	1577647	1577654		msbA	7
RK1001.C0101_allcombined	1578484	1578518		msbA	34
RK1001.C0101_allcombined	1578665	1578674		msbA	9
RK1001.C0101_allcombined	1578720	1578724		msbA	4
RK1001.C0101_allcombined	1578863	1578879		lpxK	16
RK1001.C0101_allcombined	1578917	1578936		lpxK	19
RK1001.C0101_allcombined	1579013	1579037		lpxK	24
RK1001.C0101_allcombined	1579461	1579466		lpxK	5
RK1001.C0101_allcombined	1579819	1579833		lpxK	14
RK1001.C0101_allcombined	1580113	1580165		YPO_RS07975	52
RK1001.C0101_allcombined	1580767	1580776		YPO_RS07975	9
RK1001.C0101_allcombined	1580964	1580989		YPO_RS07975	25
RK1001.C0101_allcombined	1581179	1581195		YPO_RS07975	16
RK1001.C0101_allcombined	1582071	1582083		YPO_RS07980	12
RK1001.C0101_allcombined	1582155	1582159		YPO_RS07980	4
RK1001.C0101_allcombined	1582816	1582823		YPO_RS07985	7
RK1001.C0101_allcombined	1583115	1583151		kdsB	36
RK1001.C0101_allcombined	1583385	1583392		kdsB	7
RK1001.C0101_allcombined	1583483	1583491		kdsB	8
RK1001.C0101_allcombined	1584932	1584940		YPO_RS07995	8
RK1001.C0101_allcombined	1585759	1585770		cmoM	11
RK1001.C0101_allcombined	1586069	1586083		cmoM	14
RK1001.C0101_allcombined	1586263	1586324		cmoM	61
RK1001.C0101_allcombined	1587271	1587273		mukF	2
RK1001.C0101_allcombined	1587496	1587507		mukF	11
RK1001.C0101_allcombined	1588745	1588774		mukB	29
RK1001.C0101_allcombined	1590734	1590736		mukB	2
RK1001.C0101_allcombined	1591530	1591533		mukB	3
RK1001.C0101_allcombined	1591739	1591755		mukB	16
RK1001.C0101_allcombined	1592527	1592554		mukB	27
RK1001.C0101_allcombined	1592700	1592720		mukB	20
RK1001.C0101_allcombined	1594335	1594341		ldtD	6
RK1001.C0101_allcombined	1594393	1594420		ldtD	27
RK1001.C0101_allcombined	1594956	1594961		ldtD	5
RK1001.C0101_allcombined	1595075	1595111		ldtD	36
RK1001.C0101_allcombined	1595783	1595794		ldtD	11
RK1001.C0101_allcombined	1596297	1596308		YPO_RS08030	11
RK1001.C0101_allcombined	1596475	1596500		YPO_RS08030	25
RK1001.C0101_allcombined	1596692	1596792		YPO_RS08035	100
RK1001.C0101_allcombined	1597213	1597218		YPO_RS08035	5
RK1001.C0101_allcombined	1597441	1597469		YPO_RS08040	28
RK1001.C0101_allcombined	1597955	1597958		YPO_RS08045	3
RK1001.C0101_allcombined	1598851	1598877		YPO_RS08045	26
RK1001.C0101_allcombined	1599427	1599438		ompF	11
RK1001.C0101_allcombined	1599489	1599499		ompF	10
RK1001.C0101_allcombined	1600094	1600110		ompF	16
RK1001.C0101_allcombined	1600573	1600587		asnS	14
RK1001.C0101_allcombined	1601261	1601264		asnS	3
RK1001.C0101_allcombined	1601711	1601722		asnS	11
RK1001.C0101_allcombined	1602552	1602566		pncB	14
RK1001.C0101_allcombined	1602708	1602721		pncB	13
RK1001.C0101_allcombined	1603140	1603150		pncB	10
RK1001.C0101_allcombined	1603406	1603446		pncB	40
RK1001.C0101_allcombined	1604823	1604827		pepN	4
RK1001.C0101_allcombined	1604971	1605002		pepN	31
RK1001.C0101_allcombined	1605045	1605046		pepN	1
RK1001.C0101_allcombined	1605078	1605088		pepN	10
RK1001.C0101_allcombined	1605150	1605156		pepN	6
RK1001.C0101_allcombined	1605221	1605342		pepN	121
RK1001.C0101_allcombined	1605718	1605724		pepN	6
RK1001.C0101_allcombined	1605812	1605825		pepN	13
RK1001.C0101_allcombined	1605956	1605978		pepN	22
RK1001.C0101_allcombined	1606078	1606088		pepN	10
RK1001.C0101_allcombined	1606775	1606779		pepN	4
RK1001.C0101_allcombined	1606958	1606960		pepN	2
RK1001.C0101_allcombined	1607578	1607581		pyrD	3
RK1001.C0101_allcombined	1607671	1607676		pyrD	5
RK1001.C0101_allcombined	1607844	1607879		pyrD	35
RK1001.C0101_allcombined	1607915	1607931		pyrD	16
RK1001.C0101_allcombined	1608051	1608157		pyrD	106
RK1001.C0101_allcombined	1608322	1608338		pyrD	16
RK1001.C0101_allcombined	1609036	1609062		YPO_RS08075	26
RK1001.C0101_allcombined	1609267	1609274		YPO_RS08075	7
RK1001.C0101_allcombined	1609536	1609560		YPO_RS08080	24
RK1001.C0101_allcombined	1609927	1609934		YPO_RS08080	7
RK1001.C0101_allcombined	1610017	1610025		YPO_RS08080	8
RK1001.C0101_allcombined	1610446	1610457		YPO_RS08080	11
RK1001.C0101_allcombined	1610659	1610661		rlmKL	2
RK1001.C0101_allcombined	1611137	1611153		rlmKL	16
RK1001.C0101_allcombined	1611193	1611235		rlmKL	42
RK1001.C0101_allcombined	1611444	1611492		rlmKL	48
RK1001.C0101_allcombined	1612099	1612107		rlmKL	8
RK1001.C0101_allcombined	1612811	1612818		YPO_RS08090	7
RK1001.C0101_allcombined	1613592	1613598		YPO_RS08090	6
RK1001.C0101_allcombined	1613700	1613704		YPO_RS08090	4
RK1001.C0101_allcombined	1614196	1614201		YPO_RS08090	5
RK1001.C0101_allcombined	1614399	1614467		YPO_RS08090	68
RK1001.C0101_allcombined	1614762	1614792		pqiA	30
RK1001.C0101_allcombined	1615557	1615564		pqiA	7
RK1001.C0101_allcombined	1615987	1615993		pqiA	6
RK1001.C0101_allcombined	1616114	1616135		pqiB	21
RK1001.C0101_allcombined	1616191	1616193		pqiB	2
RK1001.C0101_allcombined	1616295	1616297		pqiB	2
RK1001.C0101_allcombined	1616491	1616517		pqiB	26
RK1001.C0101_allcombined	1616799	1616801		pqiB	2
RK1001.C0101_allcombined	1616840	1616843		pqiB	3
RK1001.C0101_allcombined	1616873	1616881		pqiB	8
RK1001.C0101_allcombined	1616956	1616971		pqiB	15
RK1001.C0101_allcombined	1617893	1617896		pqiC	3
RK1001.C0101_allcombined	1618072	1618095		pqiC	23
RK1001.C0101_allcombined	1618540	1618549		rmf	9
RK1001.C0101_allcombined	1619212	1619240		YPO_RS08115	28
RK1001.C0101_allcombined	1621383	1621388		YPO_RS08130	5
RK1001.C0101_allcombined	1622216	1622259		YPO_RS08130	43
RK1001.C0101_allcombined	1622920	1622934		YPO_RS08140	14
RK1001.C0101_allcombined	1622973	1623008		YPO_RS08140	35
RK1001.C0101_allcombined	1623411	1623422		fabA	11
RK1001.C0101_allcombined	1623747	1623776		fabA	29
RK1001.C0101_allcombined	1624206	1624226		YPO_RS08150	20
RK1001.C0101_allcombined	1624650	1624656		YPO_RS08150	6
RK1001.C0101_allcombined	1625003	1625010		YPO_RS08150	7
RK1001.C0101_allcombined	1625268	1625281		YPO_RS08150	13
RK1001.C0101_allcombined	1625484	1625492		YPO_RS08150	8
RK1001.C0101_allcombined	1625640	1625647		YPO_RS08150	7
RK1001.C0101_allcombined	1626270	1626274		matP	4
RK1001.C0101_allcombined	1626549	1626559		YPO_RS08160	10
RK1001.C0101_allcombined	1626754	1626769		YPO_RS08160	15
RK1001.C0101_allcombined	1626918	1626921		YPO_RS08160	3
RK1001.C0101_allcombined	1627481	1627502		ompA	21
RK1001.C0101_allcombined	1627901	1627902		ompA	1
RK1001.C0101_allcombined	1628120	1628144		ompA	24
RK1001.C0101_allcombined	1628237	1628239		ompA	2
RK1001.C0101_allcombined	1628611	1628623		sulA	12
RK1001.C0101_allcombined	1628994	1629010		sulA	16
RK1001.C0101_allcombined	1629061	1629078		sulA	17
RK1001.C0101_allcombined	1629421	1629461		YPO_RS08175	40
RK1001.C0101_allcombined	1629709	1629731		YPO_RS08175	22
RK1001.C0101_allcombined	1629913	1629920		YPO_RS08175	7
RK1001.C0101_allcombined	1630164	1630170		yccS	6
RK1001.C0101_allcombined	1630665	1630685		yccS	20
RK1001.C0101_allcombined	1630719	1630750		yccS	31
RK1001.C0101_allcombined	1631125	1631146		yccS	21
RK1001.C0101_allcombined	1631336	1631412		yccS	76
RK1001.C0101_allcombined	1631626	1631639		yccS	13
RK1001.C0101_allcombined	1631817	1631832		yccS	15
RK1001.C0101_allcombined	1632173	1632182		yccS	9
RK1001.C0101_allcombined	1632383	1632423		YPO_RS08185	40
RK1001.C0101_allcombined	1632464	1632488		YPO_RS08185	24
RK1001.C0101_allcombined	1632668	1632685		YPO_RS08185	17
RK1001.C0101_allcombined	1632929	1632939		helD	10
RK1001.C0101_allcombined	1632995	1633028		helD	33
RK1001.C0101_allcombined	1633133	1633157		helD	24
RK1001.C0101_allcombined	1633395	1633406		helD	11
RK1001.C0101_allcombined	1633686	1633710		helD	24
RK1001.C0101_allcombined	1634324	1634340		helD	16
RK1001.C0101_allcombined	1634656	1634659		helD	3
RK1001.C0101_allcombined	1635070	1635083		YPO_RS08195	13
RK1001.C0101_allcombined	1635141	1635199		YPO_RS08195	58
RK1001.C0101_allcombined	1635580	1635608		YPO_RS08200	28
RK1001.C0101_allcombined	1635760	1635764		YPO_RS08200	4
RK1001.C0101_allcombined	1635836	1635838		YPO_RS08200	2
RK1001.C0101_allcombined	1635881	1635903		YPO_RS08200	22
RK1001.C0101_allcombined	1636095	1636100		YPO_RS08200	5
RK1001.C0101_allcombined	1636576	1636581		YPO_RS08205	5
RK1001.C0101_allcombined	1636662	1636694		YPO_RS08205	32
RK1001.C0101_allcombined	1637318	1637338		hspQ	20
RK1001.C0101_allcombined	1638286	1638300		rlmI	14
RK1001.C0101_allcombined	1638360	1638361		rlmI	1
RK1001.C0101_allcombined	1638622	1638631		rlmI	9
RK1001.C0101_allcombined	1639295	1639315		tusE	20
RK1001.C0101_allcombined	1643667	1643680		YPO_RS08245	13
RK1001.C0101_allcombined	1644011	1644022		YPO_RS08245	11
RK1001.C0101_allcombined	1644461	1644477		YPO_RS08245	16
RK1001.C0101_allcombined	1644601	1644620		YPO_RS08245	19
RK1001.C0101_allcombined	1644999	1645066		YPO_RS08245	67
RK1001.C0101_allcombined	1645163	1645194		YPO_RS08245	31
RK1001.C0101_allcombined	1645337	1645346		YPO_RS08245	9
RK1001.C0101_allcombined	1645686	1645805		YPO_RS08250	119
RK1001.C0101_allcombined	1646051	1646065		YPO_RS08250	14
RK1001.C0101_allcombined	1646187	1646230		YPO_RS08250	43
RK1001.C0101_allcombined	1646372	1646385		YPO_RS08250	13
RK1001.C0101_allcombined	1647181	1647204		YPO_RS08255	23
RK1001.C0101_allcombined	1647598	1647610		YPO_RS08260	12
RK1001.C0101_allcombined	1647646	1647714		YPO_RS08260	68
RK1001.C0101_allcombined	1647760	1647801		YPO_RS08260	41
RK1001.C0101_allcombined	1647845	1647865		YPO_RS08260	20
RK1001.C0101_allcombined	1648073	1648122		YPO_RS08260	49
RK1001.C0101_allcombined	1648112	1648196		YPO_RS08265	84
RK1001.C0101_allcombined	1648322	1648334		YPO_RS08265	12
RK1001.C0101_allcombined	1648378	1648383		YPO_RS08265	5
RK1001.C0101_allcombined	1648499	1648500		YPO_RS08265	1
RK1001.C0101_allcombined	1648681	1648714		YPO_RS08265	33
RK1001.C0101_allcombined	1648970	1648979		YPO_RS08265	9
RK1001.C0101_allcombined	1649087	1649091		YPO_RS08265	4
RK1001.C0101_allcombined	1649369	1649390		YPO_RS08265	21
RK1001.C0101_allcombined	1649584	1649607		YPO_RS08270	23
RK1001.C0101_allcombined	1649731	1649770		YPO_RS08270	39
RK1001.C0101_allcombined	1650150	1650178		YPO_RS08275	28
RK1001.C0101_allcombined	1650568	1650581		YPO_RS08275	13
RK1001.C0101_allcombined	1650895	1650949		YPO_RS08275	54
RK1001.C0101_allcombined	1651086	1651087		YPO_RS08275	1
RK1001.C0101_allcombined	1651161	1651167		YPO_RS08275	6
RK1001.C0101_allcombined	1651284	1651305		YPO_RS08275	21
RK1001.C0101_allcombined	1651359	1651388		YPO_RS08275	29
RK1001.C0101_allcombined	1651381	1651398		YPO_RS08280	17
RK1001.C0101_allcombined	1651516	1651534		YPO_RS08280	18
RK1001.C0101_allcombined	1651785	1651789		YPO_RS08280	4
RK1001.C0101_allcombined	1651856	1651915		YPO_RS08280	59
RK1001.C0101_allcombined	1651971	1652000		YPO_RS08280	29
RK1001.C0101_allcombined	1652032	1652100		YPO_RS08280	68
RK1001.C0101_allcombined	1652102	1652160		YPO_RS08285	58
RK1001.C0101_allcombined	1652200	1652210		YPO_RS08285	10
RK1001.C0101_allcombined	1652403	1652429		YPO_RS08285	26
RK1001.C0101_allcombined	1652511	1652527		YPO_RS08285	16
RK1001.C0101_allcombined	1652562	1652564		YPO_RS08285	2
RK1001.C0101_allcombined	1652713	1652739		YPO_RS08285	26
RK1001.C0101_allcombined	1653115	1653172		YPO_RS08290	57
RK1001.C0101_allcombined	1653287	1653301		YPO_RS08290	14
RK1001.C0101_allcombined	1653405	1653411		YPO_RS08290	6
RK1001.C0101_allcombined	1653528	1653531		YPO_RS08290	3
RK1001.C0101_allcombined	1653644	1653645		YPO_RS08290	1
RK1001.C0101_allcombined	1653793	1653920		YPO_RS08295	127
RK1001.C0101_allcombined	1654009	1654043		YPO_RS08295	34
RK1001.C0101_allcombined	1654429	1654451		YPO_RS08300	22
RK1001.C0101_allcombined	1655070	1655087		YPO_RS08305	17
RK1001.C0101_allcombined	1655135	1655136		YPO_RS08305	1
RK1001.C0101_allcombined	1655175	1655177		YPO_RS08305	2
RK1001.C0101_allcombined	1655241	1655297		YPO_RS08305	56
RK1001.C0101_allcombined	1655353	1655395		YPO_RS08305	42
RK1001.C0101_allcombined	1654757	1654797		YPO_RS08305	40
RK1001.C0101_allcombined	1656636	1656658		tssB	22
RK1001.C0101_allcombined	1657438	1657442		tssC	4
RK1001.C0101_allcombined	1658250	1658276		tssC	26
RK1001.C0101_allcombined	1659887	1659898		YPO_RS08325	11
RK1001.C0101_allcombined	1661499	1661500		YPO_RS08330	1
RK1001.C0101_allcombined	1661804	1661817		YPO_RS08330	13
RK1001.C0101_allcombined	1662186	1662193		YPO_RS08330	7
RK1001.C0101_allcombined	1662401	1662408		YPO_RS08335	7
RK1001.C0101_allcombined	1662484	1662491		YPO_RS08335	7
RK1001.C0101_allcombined	1663330	1663354		tssH	24
RK1001.C0101_allcombined	1664462	1664466		tssH	4
RK1001.C0101_allcombined	1664836	1664843		tssH	7
RK1001.C0101_allcombined	1665356	1665363		tssH	7
RK1001.C0101_allcombined	1667475	1667478		YPO_RS08345	3
RK1001.C0101_allcombined	1667801	1667843		YPO_RS08345	42
RK1001.C0101_allcombined	1668232	1668239		YPO_RS08350	7
RK1001.C0101_allcombined	1668452	1668456		YPO_RS08350	4
RK1001.C0101_allcombined	1668732	1668739		YPO_RS08350	7
RK1001.C0101_allcombined	1669653	1669685		YPO_RS08350	32
RK1001.C0101_allcombined	1669856	1669860		YPO_RS08350	4
RK1001.C0101_allcombined	1669917	1669932		YPO_RS08350	15
RK1001.C0101_allcombined	1669991	1670006		YPO_RS08350	15
RK1001.C0101_allcombined	1670108	1670115		YPO_RS08350	7
RK1001.C0101_allcombined	1670150	1670230		YPO_RS08350	80
RK1001.C0101_allcombined	1670267	1670285		YPO_RS08350	18
RK1001.C0101_allcombined	1670316	1670325		YPO_RS08350	9
RK1001.C0101_allcombined	1670454	1670462		YPO_RS08350	8
RK1001.C0101_allcombined	1670459	1670479		YPO_RS08355	20
RK1001.C0101_allcombined	1670525	1670612		YPO_RS08355	87
RK1001.C0101_allcombined	1670702	1670728		YPO_RS08355	26
RK1001.C0101_allcombined	1670760	1670852		YPO_RS08355	92
RK1001.C0101_allcombined	1670957	1670968		YPO_RS08355	11
RK1001.C0101_allcombined	1671043	1671069		YPO_RS08355	26
RK1001.C0101_allcombined	1671212	1671232		YPO_RS08355	20
RK1001.C0101_allcombined	1671460	1671467		YPO_RS08360	7
RK1001.C0101_allcombined	1671509	1671510		YPO_RS08360	1
RK1001.C0101_allcombined	1671614	1671646		YPO_RS08360	32
RK1001.C0101_allcombined	1671662	1671669		YPO_RS08365	7
RK1001.C0101_allcombined	1672004	1672034		YPO_RS08365	30
RK1001.C0101_allcombined	1672418	1672424		YPO_RS08365	6
RK1001.C0101_allcombined	1672574	1672577		YPO_RS08365	3
RK1001.C0101_allcombined	1672735	1672746		YPO_RS08365	11
RK1001.C0101_allcombined	1672936	1672945		YPO_RS08365	9
RK1001.C0101_allcombined	1672994	1673001		YPO_RS08365	7
RK1001.C0101_allcombined	1673126	1673137		YPO_RS08365	11
RK1001.C0101_allcombined	1673221	1673237		YPO_RS08365	16
RK1001.C0101_allcombined	1673338	1673444		YPO_RS08365	106
RK1001.C0101_allcombined	1673710	1673718		YPO_RS08365	8
RK1001.C0101_allcombined	1673830	1673841		YPO_RS08365	11
RK1001.C0101_allcombined	1674131	1674142		YPO_RS08370	11
RK1001.C0101_allcombined	1674238	1674278		YPO_RS08370	40
RK1001.C0101_allcombined	1674415	1674488		YPO_RS08370	73
RK1001.C0101_allcombined	1677507	1677528		YPO_RS08380	21
RK1001.C0101_allcombined	1678253	1678254		YPO_RS08385	1
RK1001.C0101_allcombined	1678358	1678363		YPO_RS08385	5
RK1001.C0101_allcombined	1678553	1678560		YPO_RS08385	7
RK1001.C0101_allcombined	1679750	1679752		YPO_RS08385	2
RK1001.C0101_allcombined	1680007	1680008		YPO_RS08385	1
RK1001.C0101_allcombined	1680195	1680202		YPO_RS08385	7
RK1001.C0101_allcombined	1681469	1681483		tssA	14
RK1001.C0101_allcombined	1682145	1682157		tssA	12
RK1001.C0101_allcombined	1682499	1682500		tssA	1
RK1001.C0101_allcombined	1683247	1683297		YPO_RS08395	50
RK1001.C0101_allcombined	1683346	1683459		YPO_RS08395	113
RK1001.C0101_allcombined	1683569	1683581		YPO_RS08395	12
RK1001.C0101_allcombined	1683652	1683654		YPO_RS08395	2
RK1001.C0101_allcombined	1683690	1683726		YPO_RS08395	36
RK1001.C0101_allcombined	1683771	1683772		YPO_RS08395	1
RK1001.C0101_allcombined	1683830	1683846		YPO_RS08395	16
RK1001.C0101_allcombined	1683890	1683891		YPO_RS08395	1
RK1001.C0101_allcombined	1683949	1683953		YPO_RS08395	4
RK1001.C0101_allcombined	1684040	1684155		YPO_RS08400	115
RK1001.C0101_allcombined	1684217	1684228		YPO_RS08400	11
RK1001.C0101_allcombined	1684287	1684298		YPO_RS08400	11
RK1001.C0101_allcombined	1684379	1684413		YPO_RS08400	34
RK1001.C0101_allcombined	1684448	1684495		YPO_RS08400	47
RK1001.C0101_allcombined	1685007	1685020		tssF	13
RK1001.C0101_allcombined	1685664	1685681		tssF	17
RK1001.C0101_allcombined	1685856	1685887		tssF	31
RK1001.C0101_allcombined	1686170	1686173		tssF	3
RK1001.C0101_allcombined	1686382	1686417		tssF	35
RK1001.C0101_allcombined	1687760	1687789		tssJ	29
RK1001.C0101_allcombined	1688325	1688332		tssE	7
RK1001.C0101_allcombined	1688364	1688386		tssE	22
RK1001.C0101_allcombined	1688462	1688470		tssE	8
RK1001.C0101_allcombined	1688561	1688562		YPO_RS08425	1
RK1001.C0101_allcombined	1688633	1688637		YPO_RS08425	4
RK1001.C0101_allcombined	1689333	1689336		YPO_RS08425	3
RK1001.C0101_allcombined	1690140	1690162		YPO_RS08430	22
RK1001.C0101_allcombined	1690210	1690284		YPO_RS08430	74
RK1001.C0101_allcombined	1690341	1690434		YPO_RS08430	93
RK1001.C0101_allcombined	1690588	1690644		YPO_RS08430	56
RK1001.C0101_allcombined	1690716	1690730		YPO_RS08430	14
RK1001.C0101_allcombined	1691586	1691593		YPO_RS08435	7
RK1001.C0101_allcombined	1692198	1692203		YPO_RS08435	5
RK1001.C0101_allcombined	1692605	1692606		YPO_RS08435	1
RK1001.C0101_allcombined	1692832	1692850		YPO_RS08435	18
RK1001.C0101_allcombined	1693020	1693041		YPO_RS08435	21
RK1001.C0101_allcombined	1693269	1693299		YPO_RS08440	30
RK1001.C0101_allcombined	1693442	1693459		YPO_RS08440	17
RK1001.C0101_allcombined	1693492	1693511		YPO_RS08440	19
RK1001.C0101_allcombined	1693551	1693559		YPO_RS08440	8
RK1001.C0101_allcombined	1693688	1693782		YPO_RS08440	94
RK1001.C0101_allcombined	1693854	1693922		YPO_RS08440	68
RK1001.C0101_allcombined	1693980	1693988		YPO_RS08445	8
RK1001.C0101_allcombined	1695310	1695320		moeB	10
RK1001.C0101_allcombined	1695761	1695764		moeB	3
RK1001.C0101_allcombined	1696047	1696067		moeB	20
RK1001.C0101_allcombined	1696760	1696769		moeA	9
RK1001.C0101_allcombined	1697333	1697356		moeA	23
RK1001.C0101_allcombined	1698271	1698370		darE	99
RK1001.C0101_allcombined	1698447	1698499		darE	52
RK1001.C0101_allcombined	1698551	1698583		darE	32
RK1001.C0101_allcombined	1698653	1698686		darE	33
RK1001.C0101_allcombined	1698917	1698972		darE	55
RK1001.C0101_allcombined	1699037	1699201		darE	164
RK1001.C0101_allcombined	1699211	1699317		darD	106
RK1001.C0101_allcombined	1699841	1699879		darD	38
RK1001.C0101_allcombined	1699881	1699926		darC	45
RK1001.C0101_allcombined	1700082	1700141		darC	59
RK1001.C0101_allcombined	1700225	1700229		darC	4
RK1001.C0101_allcombined	1700306	1700427		darC	121
RK1001.C0101_allcombined	1700483	1700596		darC	113
RK1001.C0101_allcombined	1700654	1700690		darC	36
RK1001.C0101_allcombined	1700850	1700855		darC	5
RK1001.C0101_allcombined	1700890	1700921		darC	31
RK1001.C0101_allcombined	1700995	1701038		darC	43
RK1001.C0101_allcombined	1701083	1701143		darC	60
RK1001.C0101_allcombined	1701145	1701183		darB	38
RK1001.C0101_allcombined	1701288	1701399		darB	111
RK1001.C0101_allcombined	1701516	1701582		darB	66
RK1001.C0101_allcombined	1701716	1701780		darB	64
RK1001.C0101_allcombined	1701849	1701943		darB	94
RK1001.C0101_allcombined	1702033	1702067		darB	34
RK1001.C0101_allcombined	1702182	1702307		darB	125
RK1001.C0101_allcombined	1702530	1702531		darB	1
RK1001.C0101_allcombined	1702612	1702633		darB	21
RK1001.C0101_allcombined	1702721	1702738		darB	17
RK1001.C0101_allcombined	1703060	1703068		darB	8
RK1001.C0101_allcombined	1703243	1703282		darB	39
RK1001.C0101_allcombined	1703335	1703446		darB	111
RK1001.C0101_allcombined	1703500	1703505		darB	5
RK1001.C0101_allcombined	1703639	1703722		darA-c	83
RK1001.C0101_allcombined	1704103	1704122		fghA	19
RK1001.C0101_allcombined	1704265	1704291		fghA	26
RK1001.C0101_allcombined	1704490	1704503		fghA	13
RK1001.C0101_allcombined	1704541	1704542		fghA	1
RK1001.C0101_allcombined	1704660	1704665		fghA	5
RK1001.C0101_allcombined	1704950	1704963		YPO_RS08490	13
RK1001.C0101_allcombined	1705313	1705324		YPO_RS08490	11
RK1001.C0101_allcombined	1705610	1705649		YPO_RS08490	39
RK1001.C0101_allcombined	1706491	1706508		YPO_RS08495	17
RK1001.C0101_allcombined	1706689	1706694		YPO_RS08495	5
RK1001.C0101_allcombined	1707187	1707203		YPO_RS08495	16
RK1001.C0101_allcombined	1708918	1708923		folE	5
RK1001.C0101_allcombined	1709175	1709184		folE	9
RK1001.C0101_allcombined	1709552	1709570		YPO_RS08510	18
RK1001.C0101_allcombined	1709902	1709910		YPO_RS08510	8
RK1001.C0101_allcombined	1710370	1710383		YPO_RS08510	13
RK1001.C0101_allcombined	1711781	1711787		mglB	6
RK1001.C0101_allcombined	1712289	1712309		mglB	20
RK1001.C0101_allcombined	1712585	1712588		mglA	3
RK1001.C0101_allcombined	1712645	1712656		mglA	11
RK1001.C0101_allcombined	1712738	1712744		mglA	6
RK1001.C0101_allcombined	1712815	1712842		mglA	27
RK1001.C0101_allcombined	1712876	1712939		mglA	63
RK1001.C0101_allcombined	1713217	1713223		mglA	6
RK1001.C0101_allcombined	1713541	1713542		mglA	1
RK1001.C0101_allcombined	1713630	1713645		mglA	15
RK1001.C0101_allcombined	1713825	1713843		mglA	18
RK1001.C0101_allcombined	1714045	1714062		mglA	17
RK1001.C0101_allcombined	1714083	1714109		mglC	26
RK1001.C0101_allcombined	1714140	1714187		mglC	47
RK1001.C0101_allcombined	1714621	1714666		mglC	45
RK1001.C0101_allcombined	1714795	1714796		mglC	1
RK1001.C0101_allcombined	1714954	1714977		mglC	23
RK1001.C0101_allcombined	1715008	1715012		mglC	4
RK1001.C0101_allcombined	1715695	1715696		sanA	1
RK1001.C0101_allcombined	1716048	1716061		sanA	13
RK1001.C0101_allcombined	1716251	1716255		sanA	4
RK1001.C0101_allcombined	1716640	1716646		YPO_RS08535	6
RK1001.C0101_allcombined	1716846	1716859		YPO_RS08535	13
RK1001.C0101_allcombined	1717356	1717401		YPO_RS08535	45
RK1001.C0101_allcombined	1717627	1717631		YPO_RS08535	4
RK1001.C0101_allcombined	1717720	1717746		YPO_RS08535	26
RK1001.C0101_allcombined	1717842	1717843		YPO_RS08535	1
RK1001.C0101_allcombined	1717916	1717917		YPO_RS08535	1
RK1001.C0101_allcombined	1718030	1718036		YPO_RS08535	6
RK1001.C0101_allcombined	1718123	1718133		YPO_RS08535	10
RK1001.C0101_allcombined	1718772	1718782		cdd	10
RK1001.C0101_allcombined	1719125	1719129		cdd	4
RK1001.C0101_allcombined	1719283	1719304		cdd	21
RK1001.C0101_allcombined	1719338	1719346		cdd	8
RK1001.C0101_allcombined	1720149	1720156		YPO_RS08545	7
RK1001.C0101_allcombined	1720187	1720221		YPO_RS08545	34
RK1001.C0101_allcombined	1720395	1720404		YPO_RS08545	9
RK1001.C0101_allcombined	1720743	1720745		YPO_RS08550	2
RK1001.C0101_allcombined	1721195	1721196		YPO_RS08555	1
RK1001.C0101_allcombined	1721313	1721317		YPO_RS08555	4
RK1001.C0101_allcombined	1721420	1721433		YPO_RS08555	13
RK1001.C0101_allcombined	1721577	1721590		YPO_RS08555	13
RK1001.C0101_allcombined	1721629	1721638		YPO_RS08555	9
RK1001.C0101_allcombined	1721886	1721891		YPO_RS08555	5
RK1001.C0101_allcombined	1722159	1722165		YPO_RS08555	6
RK1001.C0101_allcombined	1722205	1722206		YPO_RS08555	1
RK1001.C0101_allcombined	1722674	1722681		YPO_RS08560	7
RK1001.C0101_allcombined	1722712	1722746		YPO_RS08560	34
RK1001.C0101_allcombined	1722845	1722927		YPO_RS08560	82
RK1001.C0101_allcombined	1723321	1723348		YPO_RS08560	27
RK1001.C0101_allcombined	1723830	1723833		YPO_RS08560	3
RK1001.C0101_allcombined	1724163	1724167		YPO_RS08565	4
RK1001.C0101_allcombined	1724305	1724306		YPO_RS08565	1
RK1001.C0101_allcombined	1724899	1724906		YPO_RS08565	7
RK1001.C0101_allcombined	1725719	1725729		YPO_RS08570	10
RK1001.C0101_allcombined	1725916	1725987		YPO_RS08570	71
RK1001.C0101_allcombined	1726242	1726283		YPO_RS08570	41
RK1001.C0101_allcombined	1726318	1726322		YPO_RS08570	4
RK1001.C0101_allcombined	1727317	1727331		YPO_RS08575	14
RK1001.C0101_allcombined	1728409	1728425		YPO_RS08580	16
RK1001.C0101_allcombined	1728995	1729010		YPO_RS08585	15
RK1001.C0101_allcombined	1729365	1729415		metG	50
RK1001.C0101_allcombined	1729543	1729549		metG	6
RK1001.C0101_allcombined	1729898	1729918		metG	20
RK1001.C0101_allcombined	1730127	1730139		metG	12
RK1001.C0101_allcombined	1730409	1730442		metG	33
RK1001.C0101_allcombined	1731033	1731039		metG	6
RK1001.C0101_allcombined	1731569	1731588		apbC	19
RK1001.C0101_allcombined	1731733	1731735		apbC	2
RK1001.C0101_allcombined	1731784	1731794		apbC	10
RK1001.C0101_allcombined	1732161	1732178		apbC	17
RK1001.C0101_allcombined	1732829	1732835		udk	6
RK1001.C0101_allcombined	1733319	1733344		udk	25
RK1001.C0101_allcombined	1733376	1733378		udk	2
RK1001.C0101_allcombined	1733594	1733602		dcd	8
RK1001.C0101_allcombined	1734684	1734686		asmA	2
RK1001.C0101_allcombined	1734915	1734923		asmA	8
RK1001.C0101_allcombined	1735138	1735141		asmA	3
RK1001.C0101_allcombined	1735189	1735195		asmA	6
RK1001.C0101_allcombined	1735334	1735335		asmA	1
RK1001.C0101_allcombined	1735392	1735414		asmA	22
RK1001.C0101_allcombined	1735726	1735735		asmA	9
RK1001.C0101_allcombined	1736374	1736378		YPO_RS08615	4
RK1001.C0101_allcombined	1736880	1736883		YPO_RS08615	3
RK1001.C0101_allcombined	1737289	1737316		YPO_RS08615	27
RK1001.C0101_allcombined	1737684	1737706		YPO_RS08615	22
RK1001.C0101_allcombined	1737843	1737864		YPO_RS08615	21
RK1001.C0101_allcombined	1738372	1738412		fhuF	40
RK1001.C0101_allcombined	1738482	1738573		fhuF	91
RK1001.C0101_allcombined	1738673	1738719		fhuF	46
RK1001.C0101_allcombined	1738999	1739011		fhuF	12
RK1001.C0101_allcombined	1739303	1739493		YPO_RS08625	190
RK1001.C0101_allcombined	1739602	1739609		YPO_RS08625	7
RK1001.C0101_allcombined	1739678	1739683		YPO_RS08625	5
RK1001.C0101_allcombined	1739924	1739949		YPO_RS08625	25
RK1001.C0101_allcombined	1740083	1740085		YPO_RS08625	2
RK1001.C0101_allcombined	1740227	1740231		YPO_RS08625	4
RK1001.C0101_allcombined	1740595	1740607		YPO_RS08625	12
RK1001.C0101_allcombined	1740707	1740712		YPO_RS08625	5
RK1001.C0101_allcombined	1740820	1740834		YPO_RS08625	14
RK1001.C0101_allcombined	1740948	1740950		YPO_RS08630	2
RK1001.C0101_allcombined	1741046	1741110		YPO_RS08630	64
RK1001.C0101_allcombined	1741165	1741172		YPO_RS08630	7
RK1001.C0101_allcombined	1741698	1741728		YPO_RS08630	30
RK1001.C0101_allcombined	1741912	1741951		YPO_RS08630	39
RK1001.C0101_allcombined	1742326	1742333		YPO_RS08635	7
RK1001.C0101_allcombined	1742763	1742776		YPO_RS08640	13
RK1001.C0101_allcombined	1742909	1742931		YPO_RS08640	22
RK1001.C0101_allcombined	1743186	1743203		YPO_RS08640	17
RK1001.C0101_allcombined	1743453	1743456		YPO_RS08640	3
RK1001.C0101_allcombined	1743589	1743602		YPO_RS08640	13
RK1001.C0101_allcombined	1743717	1743718		YPO_RS08640	1
RK1001.C0101_allcombined	1744130	1744174		YPO_RS08640	44
RK1001.C0101_allcombined	1745439	1745440		YPO_RS08645	1
RK1001.C0101_allcombined	1746095	1746100		YPO_RS08650	5
RK1001.C0101_allcombined	1746595	1746596		YPO_RS08650	1
RK1001.C0101_allcombined	1746595	1746604		YPO_RS08655	9
RK1001.C0101_allcombined	1746672	1746687		YPO_RS08655	15
RK1001.C0101_allcombined	1746794	1746839		YPO_RS08655	45
RK1001.C0101_allcombined	1747466	1747473		YPO_RS08655	7
RK1001.C0101_allcombined	1747576	1747580		YPO_RS08655	4
RK1001.C0101_allcombined	1748129	1748132		YPO_RS08660	3
RK1001.C0101_allcombined	1748403	1748407		YPO_RS08660	4
RK1001.C0101_allcombined	1748918	1748924		YPO_RS08665	6
RK1001.C0101_allcombined	1749144	1749192		YPO_RS08665	48
RK1001.C0101_allcombined	1749345	1749400		YPO_RS08665	55
RK1001.C0101_allcombined	1750211	1750228		YPO_RS08665	17
RK1001.C0101_allcombined	1750721	1750751		YPO_RS08665	30
RK1001.C0101_allcombined	1750814	1750829		YPO_RS08665	15
RK1001.C0101_allcombined	1751039	1751050		YPO_RS08665	11
RK1001.C0101_allcombined	1751732	1751738		YPO_RS08670	6
RK1001.C0101_allcombined	1751839	1751913		YPO_RS08670	74
RK1001.C0101_allcombined	1751991	1751993		YPO_RS08670	2
RK1001.C0101_allcombined	1752277	1752282		YPO_RS08670	5
RK1001.C0101_allcombined	1752530	1752545		YPO_RS08670	15
RK1001.C0101_allcombined	1752683	1752700		YPO_RS08670	17
RK1001.C0101_allcombined	1753006	1753050		YPO_RS08670	44
RK1001.C0101_allcombined	1754163	1754180		galU	17
RK1001.C0101_allcombined	1754211	1754250		galU	39
RK1001.C0101_allcombined	1754345	1754367		galU	22
RK1001.C0101_allcombined	1754668	1754713		galU	45
RK1001.C0101_allcombined	1754860	1754887		galU	27
RK1001.C0101_allcombined	1756630	1756631		gndA	1
RK1001.C0101_allcombined	1757185	1757196		gndA	11
RK1001.C0101_allcombined	1757655	1757661		gndA	6
RK1001.C0101_allcombined	1758382	1758403		YPO_RS08690	21
RK1001.C0101_allcombined	1758630	1758639		hisF	9
RK1001.C0101_allcombined	1758869	1758872		hisF	3
RK1001.C0101_allcombined	1759113	1759144		hisF	31
RK1001.C0101_allcombined	1759692	1759693		hisA	1
RK1001.C0101_allcombined	1760329	1760351		hisH	22
RK1001.C0101_allcombined	1760520	1760530		hisH	10
RK1001.C0101_allcombined	1760572	1760584		hisH	12
RK1001.C0101_allcombined	1760584	1760592		hisB	8
RK1001.C0101_allcombined	1760737	1760746		hisB	9
RK1001.C0101_allcombined	1760969	1760977		hisB	8
RK1001.C0101_allcombined	1761697	1761745		hisC	48
RK1001.C0101_allcombined	1762532	1762561		hisC	29
RK1001.C0101_allcombined	1762994	1763000		hisD	6
RK1001.C0101_allcombined	1763377	1763380		hisD	3
RK1001.C0101_allcombined	1764634	1764635		hisG	1
RK1001.C0101_allcombined	1765029	1765033		hisG	4
RK1001.C0101_allcombined	1765317	1765321		hisL	4
RK1001.C0101_allcombined	1765813	1765819		YPO_RS08735	6
RK1001.C0101_allcombined	1765940	1765950		YPO_RS08735	10
RK1001.C0101_allcombined	1766074	1766087		YPO_RS08735	13
RK1001.C0101_allcombined	1766731	1766756		YPO_RS08740	25
RK1001.C0101_allcombined	1766960	1766962		YPO_RS08740	2
RK1001.C0101_allcombined	1767439	1767459		YPO_RS08745	20
RK1001.C0101_allcombined	1767960	1767961		YPO_RS08745	1
RK1001.C0101_allcombined	1768215	1768220		YPO_RS08745	5
RK1001.C0101_allcombined	1768317	1768336		YPO_RS08745	19
RK1001.C0101_allcombined	1769178	1769181		YPO_RS08755	3
RK1001.C0101_allcombined	1769833	1769850		YPO_RS08755	17
RK1001.C0101_allcombined	1770555	1770565		YPO_RS08760	10
RK1001.C0101_allcombined	1772090	1772108		YPO_RS08770	18
RK1001.C0101_allcombined	1772639	1772641		YPO_RS08770	2
RK1001.C0101_allcombined	1773006	1773021		YPO_RS08770	15
RK1001.C0101_allcombined	1773981	1774006		sbcB	25
RK1001.C0101_allcombined	1774599	1774607		sbcB	8
RK1001.C0101_allcombined	1774701	1774705		sbcB	4
RK1001.C0101_allcombined	1775139	1775141		sbcB	2
RK1001.C0101_allcombined	1775685	1775720		YPO_RS08785	35
RK1001.C0101_allcombined	1775779	1775819		YPO_RS08785	40
RK1001.C0101_allcombined	1775849	1775852		YPO_RS08785	3
RK1001.C0101_allcombined	1775953	1775961		YPO_RS08785	8
RK1001.C0101_allcombined	1776065	1776077		YPO_RS08785	12
RK1001.C0101_allcombined	1776249	1776251		YPO_RS08785	2
RK1001.C0101_allcombined	1776310	1776322		YPO_RS08785	12
RK1001.C0101_allcombined	1776369	1776379		YPO_RS08785	10
RK1001.C0101_allcombined	1776434	1776463		YPO_RS08785	29
RK1001.C0101_allcombined	1776603	1776607		YPO_RS08785	4
RK1001.C0101_allcombined	1777213	1777216		YPO_RS08790	3
RK1001.C0101_allcombined	1779050	1779059		YPO_RS08795	9
RK1001.C0101_allcombined	1779050	1779066		YPO_RS08800	16
RK1001.C0101_allcombined	1779351	1779358		YPO_RS08800	7
RK1001.C0101_allcombined	1779536	1779538		YPO_RS08800	2
RK1001.C0101_allcombined	1779724	1779744		YPO_RS08800	20
RK1001.C0101_allcombined	1779944	1779946		YPO_RS08800	2
RK1001.C0101_allcombined	1780164	1780204		YPO_RS08800	40
RK1001.C0101_allcombined	1780581	1780600		YPO_RS08800	19
RK1001.C0101_allcombined	1780793	1780797		YPO_RS08800	4
RK1001.C0101_allcombined	1780845	1780893		YPO_RS08800	48
RK1001.C0101_allcombined	1781132	1781133		YPO_RS08800	1
RK1001.C0101_allcombined	1781684	1781710		YPO_RS08800	26
RK1001.C0101_allcombined	1782168	1782174		YPO_RS08800	6
RK1001.C0101_allcombined	1783482	1783495		YPO_RS08805	13
RK1001.C0101_allcombined	1783895	1783906		YPO_RS08805	11
RK1001.C0101_allcombined	1784105	1784113		YPO_RS08805	8
RK1001.C0101_allcombined	1784487	1784496		YPO_RS08805	9
RK1001.C0101_allcombined	1784603	1784607		YPO_RS08810	4
RK1001.C0101_allcombined	1784872	1784876		YPO_RS08810	4
RK1001.C0101_allcombined	1785742	1785747		YPO_RS08815	5
RK1001.C0101_allcombined	1786022	1786032		YPO_RS08815	10
RK1001.C0101_allcombined	1786649	1786682		YPO_RS08820	33
RK1001.C0101_allcombined	1786875	1786880		YPO_RS08820	5
RK1001.C0101_allcombined	1788115	1788128		YPO_RS08825	13
RK1001.C0101_allcombined	1790333	1790339		argG	6
RK1001.C0101_allcombined	1790379	1790432		argG	53
RK1001.C0101_allcombined	1790921	1790933		argG	12
RK1001.C0101_allcombined	1791281	1791315		argG	34
RK1001.C0101_allcombined	1791741	1791760		YPO_RS08840	19
RK1001.C0101_allcombined	1792028	1792053		YPO_RS08840	25
RK1001.C0101_allcombined	1792190	1792203		YPO_RS08840	13
RK1001.C0101_allcombined	1793295	1793306		YPO_RS08845	11
RK1001.C0101_allcombined	1794710	1794722		YPO_RS08850	12
RK1001.C0101_allcombined	1795128	1795140		YPO_RS08850	12
RK1001.C0101_allcombined	1796029	1796049		YPO_RS08855	20
RK1001.C0101_allcombined	1796116	1796220		YPO_RS08855	104
RK1001.C0101_allcombined	1796291	1796320		YPO_RS08855	29
RK1001.C0101_allcombined	1796434	1796438		YPO_RS08855	4
RK1001.C0101_allcombined	1796545	1796549		YPO_RS08855	4
RK1001.C0101_allcombined	1796886	1796989		YPO_RS08860	103
RK1001.C0101_allcombined	1797210	1797213		YPO_RS08860	3
RK1001.C0101_allcombined	1798115	1798132		YPO_RS08870	17
RK1001.C0101_allcombined	1798383	1798389		YPO_RS08870	6
RK1001.C0101_allcombined	1798688	1798721		YPO_RS08870	33
RK1001.C0101_allcombined	1798979	1798986		YPO_RS08875	7
RK1001.C0101_allcombined	1799297	1799342		YPO_RS08875	45
RK1001.C0101_allcombined	1799757	1799765		YPO_RS08875	8
RK1001.C0101_allcombined	1800081	1800116		YPO_RS08875	35
RK1001.C0101_allcombined	1800363	1800386		YPO_RS08880	23
RK1001.C0101_allcombined	1800476	1800491		YPO_RS08880	15
RK1001.C0101_allcombined	1801241	1801289		YPO_RS08885	48
RK1001.C0101_allcombined	1801421	1801437		YPO_RS08885	16
RK1001.C0101_allcombined	1802822	1802829		YPO_RS08890	7
RK1001.C0101_allcombined	1802888	1802905		YPO_RS08890	17
RK1001.C0101_allcombined	1803155	1803176		YPO_RS08890	21
RK1001.C0101_allcombined	1803800	1803802		YPO_RS08900	2
RK1001.C0101_allcombined	1804222	1804230		YPO_RS08900	8
RK1001.C0101_allcombined	1804565	1804609		YPO_RS08900	44
RK1001.C0101_allcombined	1804770	1804775		YPO_RS08900	5
RK1001.C0101_allcombined	1804896	1804929		YPO_RS08900	33
RK1001.C0101_allcombined	1805419	1805422		YPO_RS08900	3
RK1001.C0101_allcombined	1805667	1805689		YPO_RS08900	22
RK1001.C0101_allcombined	1806036	1806083		YPO_RS08905	47
RK1001.C0101_allcombined	1806574	1806577		YPO_RS08905	3
RK1001.C0101_allcombined	1806912	1806918		YPO_RS08905	6
RK1001.C0101_allcombined	1806951	1807018		YPO_RS08905	67
RK1001.C0101_allcombined	1808271	1808277		YPO_RS08910	6
RK1001.C0101_allcombined	1808271	1808343		bssS	72
RK1001.C0101_allcombined	1808476	1808484		bssS	8
RK1001.C0101_allcombined	1808518	1808536		bssS	18
RK1001.C0101_allcombined	1809241	1809247		dinI	6
RK1001.C0101_allcombined	1810411	1810415		pyrC	4
RK1001.C0101_allcombined	1810915	1810935		YPO_RS08930	20
RK1001.C0101_allcombined	1810968	1810990		YPO_RS08930	22
RK1001.C0101_allcombined	1811059	1811081		YPO_RS08930	22
RK1001.C0101_allcombined	1811156	1811159		YPO_RS08930	3
RK1001.C0101_allcombined	1812956	1812959		rne	3
RK1001.C0101_allcombined	1813231	1813238		rne	7
RK1001.C0101_allcombined	1813553	1813571		rne	18
RK1001.C0101_allcombined	1813972	1813978		rne	6
RK1001.C0101_allcombined	1814194	1814201		rne	7
RK1001.C0101_allcombined	1814686	1814698		rne	12
RK1001.C0101_allcombined	1815147	1815179		rne	32
RK1001.C0101_allcombined	1815532	1815540		rne	8
RK1001.C0101_allcombined	1815918	1815936		rne	18
RK1001.C0101_allcombined	1816157	1816169		rne	12
RK1001.C0101_allcombined	1816343	1816365		rne	22
RK1001.C0101_allcombined	1817178	1817191		rluC	13
RK1001.C0101_allcombined	1817276	1817294		rluC	18
RK1001.C0101_allcombined	1817824	1817828		rluC	4
RK1001.C0101_allcombined	1819076	1819078		YPO_RS08960	2
RK1001.C0101_allcombined	1820039	1820044		yceD	5
RK1001.C0101_allcombined	1820298	1820387		plsX	89
RK1001.C0101_allcombined	1820977	1820981		plsX	4
RK1001.C0101_allcombined	1821292	1821294		plsX	2
RK1001.C0101_allcombined	1821301	1821302		YPO_RS08980	1
RK1001.C0101_allcombined	1821712	1821723		YPO_RS08980	11
RK1001.C0101_allcombined	1822040	1822045		YPO_RS08980	5
RK1001.C0101_allcombined	1822404	1822412		fabD	8
RK1001.C0101_allcombined	1823338	1823371		fabG	33
RK1001.C0101_allcombined	1823957	1823966		fabG	9
RK1001.C0101_allcombined	1824120	1824129		acpP	9
RK1001.C0101_allcombined	1824601	1824613		fabF	12
RK1001.C0101_allcombined	1824991	1825043		fabF	52
RK1001.C0101_allcombined	1825624	1825638		fabF	14
RK1001.C0101_allcombined	1825892	1825898		YPO_RS09005	6
RK1001.C0101_allcombined	1826853	1826858		pabC	5
RK1001.C0101_allcombined	1827328	1827341		pabC	13
RK1001.C0101_allcombined	1827516	1827558		pabC	42
RK1001.C0101_allcombined	1828045	1828058		mltG	13
RK1001.C0101_allcombined	1828460	1828508		mltG	48
RK1001.C0101_allcombined	1828671	1828683		mltG	12
RK1001.C0101_allcombined	1828717	1828719		mltG	2
RK1001.C0101_allcombined	1828900	1828908		YPO_RS09020	8
RK1001.C0101_allcombined	1828982	1829002		YPO_RS09020	20
RK1001.C0101_allcombined	1829067	1829084		YPO_RS09020	17
RK1001.C0101_allcombined	1829743	1829756		holB	13
RK1001.C0101_allcombined	1830138	1830167		holB	29
RK1001.C0101_allcombined	1830495	1830536		holB	41
RK1001.C0101_allcombined	1830551	1830593		YPO_RS09030	42
RK1001.C0101_allcombined	1831308	1831325		YPO_RS09030	17
RK1001.C0101_allcombined	1832780	1832789		ptsG	9
RK1001.C0101_allcombined	1833087	1833099		ptsG	12
RK1001.C0101_allcombined	1834285	1834332		YPO_RS09045	47
RK1001.C0101_allcombined	1834411	1834418		YPO_RS09045	7
RK1001.C0101_allcombined	1834517	1834530		YPO_RS09045	13
RK1001.C0101_allcombined	1834702	1834715		YPO_RS09045	13
RK1001.C0101_allcombined	1834958	1834959		YPO_RS09045	1
RK1001.C0101_allcombined	1835319	1835328		hinT	9
RK1001.C0101_allcombined	1835529	1835535		hinT	6
RK1001.C0101_allcombined	1836657	1836686		thiK	29
RK1001.C0101_allcombined	1837073	1837078		thiK	5
RK1001.C0101_allcombined	1837944	1837957		nagZ	13
RK1001.C0101_allcombined	1838251	1838257		nagZ	6
RK1001.C0101_allcombined	1839093	1839167		YPO_RS09075	74
RK1001.C0101_allcombined	1839795	1839843		YPO_RS09080	48
RK1001.C0101_allcombined	1840003	1840016		YPO_RS09080	13
RK1001.C0101_allcombined	1840454	1840461		YPO_RS09080	7
RK1001.C0101_allcombined	1840722	1840734		YPO_RS09080	12
RK1001.C0101_allcombined	1840771	1840811		YPO_RS09080	40
RK1001.C0101_allcombined	1841438	1841491		YPO_RS09085	53
RK1001.C0101_allcombined	1841589	1841607		YPO_RS09085	18
RK1001.C0101_allcombined	1841669	1841692		YPO_RS09085	23
RK1001.C0101_allcombined	1841763	1841787		YPO_RS09085	24
RK1001.C0101_allcombined	1841887	1841901		YPO_RS09085	14
RK1001.C0101_allcombined	1841974	1841980		YPO_RS09085	6
RK1001.C0101_allcombined	1841988	1841989		YPO_RS09090	1
RK1001.C0101_allcombined	1842263	1842350		YPO_RS09090	87
RK1001.C0101_allcombined	1842392	1842401		YPO_RS09090	9
RK1001.C0101_allcombined	1843185	1843188		YPO_RS09095	3
RK1001.C0101_allcombined	1843684	1843705		YPO_RS09095	21
RK1001.C0101_allcombined	1844990	1844994		YPO_RS09105	4
RK1001.C0101_allcombined	1846326	1846358		YPO_RS09110	32
RK1001.C0101_allcombined	1846846	1846857		mfd	11
RK1001.C0101_allcombined	1846909	1846937		mfd	28
RK1001.C0101_allcombined	1846979	1846983		mfd	4
RK1001.C0101_allcombined	1847774	1847782		mfd	8
RK1001.C0101_allcombined	1848650	1848690		mfd	40
RK1001.C0101_allcombined	1849212	1849225		mfd	13
RK1001.C0101_allcombined	1849880	1849890		mfd	10
RK1001.C0101_allcombined	1849999	1850013		mfd	14
RK1001.C0101_allcombined	1850168	1850175		mfd	7
RK1001.C0101_allcombined	1851068	1851072		lolC	4
RK1001.C0101_allcombined	1851132	1851135		lolC	3
RK1001.C0101_allcombined	1851699	1851718		lolD	19
RK1001.C0101_allcombined	1852253	1852273		lolD	20
RK1001.C0101_allcombined	1852433	1852449		lolE	16
RK1001.C0101_allcombined	1852652	1852654		lolE	2
RK1001.C0101_allcombined	1853027	1853053		lolE	26
RK1001.C0101_allcombined	1853117	1853122		lolE	5
RK1001.C0101_allcombined	1853175	1853187		lolE	12
RK1001.C0101_allcombined	1854697	1854701		cobB	4
RK1001.C0101_allcombined	1855307	1855317		cobB	10
RK1001.C0101_allcombined	1855805	1855819		pepT	14
RK1001.C0101_allcombined	1856138	1856183		pepT	45
RK1001.C0101_allcombined	1856226	1856256		pepT	30
RK1001.C0101_allcombined	1856709	1856730		pepT	21
RK1001.C0101_allcombined	1856794	1856811		pepT	17
RK1001.C0101_allcombined	1857425	1857433		YPO_RS09150	8
RK1001.C0101_allcombined	1857845	1857857		YPO_RS09150	12
RK1001.C0101_allcombined	1857917	1857919		YPO_RS09150	2
RK1001.C0101_allcombined	1858266	1858274		YPO_RS09150	8
RK1001.C0101_allcombined	1858510	1858522		phoQ	12
RK1001.C0101_allcombined	1858812	1858855		phoQ	43
RK1001.C0101_allcombined	1859477	1859510		phoQ	33
RK1001.C0101_allcombined	1860019	1860025		phoP	6
RK1001.C0101_allcombined	1861028	1861044		YPO_RS09165	16
RK1001.C0101_allcombined	1861373	1861404		YPO_RS09165	31
RK1001.C0101_allcombined	1861610	1861611		purB	1
RK1001.C0101_allcombined	1861707	1861710		purB	3
RK1001.C0101_allcombined	1861902	1861907		purB	5
RK1001.C0101_allcombined	1862161	1862164		purB	3
RK1001.C0101_allcombined	1862975	1862980		purB	5
RK1001.C0101_allcombined	1863380	1863395		hflD	15
RK1001.C0101_allcombined	1863763	1863792		mnmA	29
RK1001.C0101_allcombined	1863874	1863889		mnmA	15
RK1001.C0101_allcombined	1864018	1864025		mnmA	7
RK1001.C0101_allcombined	1864068	1864139		mnmA	71
RK1001.C0101_allcombined	1864178	1864180		mnmA	2
RK1001.C0101_allcombined	1864714	1864716		mnmA	2
RK1001.C0101_allcombined	1865239	1865246		YPO_RS09185	7
RK1001.C0101_allcombined	1865413	1865431		YPO_RS09185	18
RK1001.C0101_allcombined	1865582	1865598		rluE	16
RK1001.C0101_allcombined	1865937	1865953		rluE	16
RK1001.C0101_allcombined	1866273	1866291		icd	18
RK1001.C0101_allcombined	1866326	1866338		icd	12
RK1001.C0101_allcombined	1866432	1866458		icd	26
RK1001.C0101_allcombined	1867036	1867039		icd	3
RK1001.C0101_allcombined	1867300	1867345		icd	45
RK1001.C0101_allcombined	1867461	1867476		icd	15
RK1001.C0101_allcombined	1867690	1867695		YPO_RS09200	5
RK1001.C0101_allcombined	1867886	1867887		YPO_RS09200	1
RK1001.C0101_allcombined	1867953	1867980		YPO_RS09200	27
RK1001.C0101_allcombined	1868287	1868291		YPO_RS09200	4
RK1001.C0101_allcombined	1868459	1868460		YPO_RS09200	1
RK1001.C0101_allcombined	1867772	1867824		YPO_RS09200	52
RK1001.C0101_allcombined	1869176	1869201		YPO_RS09205	25
RK1001.C0101_allcombined	1869391	1869398		YPO_RS09210	7
RK1001.C0101_allcombined	1870099	1870100		YPO_RS09210	1
RK1001.C0101_allcombined	1872073	1872079		YPO_RS09215	6
RK1001.C0101_allcombined	1872476	1872495		YPO_RS09215	19
RK1001.C0101_allcombined	1872530	1872533		YPO_RS09215	3
RK1001.C0101_allcombined	1872970	1872972		YPO_RS09220	2
RK1001.C0101_allcombined	1873753	1873763		YPO_RS09230	10
RK1001.C0101_allcombined	1874441	1874476		YPO_RS09230	35
RK1001.C0101_allcombined	1874664	1874684		YPO_RS09230	20
RK1001.C0101_allcombined	1875558	1875571		ydfZ	13
RK1001.C0101_allcombined	1875889	1875893		YPO_RS09240	4
RK1001.C0101_allcombined	1876565	1876566		YPO_RS09240	1
RK1001.C0101_allcombined	1876605	1876641		YPO_RS09240	36
RK1001.C0101_allcombined	1876750	1876785		YPO_RS09240	35
RK1001.C0101_allcombined	1876979	1876987		YPO_RS09245	8
RK1001.C0101_allcombined	1877905	1877951		YPO_RS09250	46
RK1001.C0101_allcombined	1878134	1878171		YPO_RS09250	37
RK1001.C0101_allcombined	1878344	1878350		YPO_RS09250	6
RK1001.C0101_allcombined	1879444	1879445		YPO_RS09255	1
RK1001.C0101_allcombined	1879593	1879599		YPO_RS09255	6
RK1001.C0101_allcombined	1880050	1880058		YPO_RS09260	8
RK1001.C0101_allcombined	1880095	1880102		YPO_RS09260	7
RK1001.C0101_allcombined	1880212	1880217		YPO_RS09260	5
RK1001.C0101_allcombined	1880394	1880406		YPO_RS09260	12
RK1001.C0101_allcombined	1880541	1880544		YPO_RS09260	3
RK1001.C0101_allcombined	1880885	1880892		YPO_RS09260	7
RK1001.C0101_allcombined	1881261	1881275		YPO_RS09260	14
RK1001.C0101_allcombined	1882126	1882153		YPO_RS09260	27
RK1001.C0101_allcombined	1882418	1882437		YPO_RS09260	19
RK1001.C0101_allcombined	1882904	1882922		YPO_RS09260	18
RK1001.C0101_allcombined	1883203	1883208		YPO_RS09260	5
RK1001.C0101_allcombined	1883773	1883787		cspE	14
RK1001.C0101_allcombined	1883904	1883925		cspE	21
RK1001.C0101_allcombined	1884168	1884174		dsrB	6
RK1001.C0101_allcombined	1884245	1884248		dsrB	3
RK1001.C0101_allcombined	1887434	1887448		YPO_RS09280	14
RK1001.C0101_allcombined	1887866	1887886		YPO_RS09280	20
RK1001.C0101_allcombined	1888562	1888577		mgtA	15
RK1001.C0101_allcombined	1888827	1888853		mgtA	26
RK1001.C0101_allcombined	1889281	1889308		mgtA	27
RK1001.C0101_allcombined	1890565	1890571		mgtA	6
RK1001.C0101_allcombined	1890631	1890664		mgtA	33
RK1001.C0101_allcombined	1892930	1892931		flhC	1
RK1001.C0101_allcombined	1893314	1893318		flhC	4
RK1001.C0101_allcombined	1893784	1893797		motA	13
RK1001.C0101_allcombined	1893950	1893982		motA	32
RK1001.C0101_allcombined	1894659	1894694		motB	35
RK1001.C0101_allcombined	1894793	1894807		motB	14
RK1001.C0101_allcombined	1895019	1895027		motB	8
RK1001.C0101_allcombined	1895306	1895312		motB	6
RK1001.C0101_allcombined	1895350	1895359		motB	9
RK1001.C0101_allcombined	1895521	1895535		motB	14
RK1001.C0101_allcombined	1898181	1898232		cheW	51
RK1001.C0101_allcombined	1898300	1898314		cheW	14
RK1001.C0101_allcombined	1898926	1898966		YPO_RS09320	40
RK1001.C0101_allcombined	1899474	1899480		YPO_RS09320	6
RK1001.C0101_allcombined	1899662	1899671		YPO_RS09320	9
RK1001.C0101_allcombined	1899953	1900018		YPO_RS09320	65
RK1001.C0101_allcombined	1900221	1900286		YPO_RS09325	65
RK1001.C0101_allcombined	1900373	1900378		YPO_RS09325	5
RK1001.C0101_allcombined	1900690	1900694		YPO_RS09330	4
RK1001.C0101_allcombined	1901116	1901122		YPO_RS09330	6
RK1001.C0101_allcombined	1901437	1901470		YPO_RS09330	33
RK1001.C0101_allcombined	1901660	1901722		YPO_RS09335	62
RK1001.C0101_allcombined	1901894	1902077		YPO_RS09335	183
RK1001.C0101_allcombined	1902132	1902176		YPO_RS09335	44
RK1001.C0101_allcombined	1902800	1902804		yapJ	4
RK1001.C0101_allcombined	1903177	1903186		yapJ	9
RK1001.C0101_allcombined	1903258	1903299		yapJ	41
RK1001.C0101_allcombined	1903396	1903397		yapJ	1
RK1001.C0101_allcombined	1903594	1903638		yapJ	44
RK1001.C0101_allcombined	1903780	1903794		yapJ	14
RK1001.C0101_allcombined	1903882	1903893		yapJ	11
RK1001.C0101_allcombined	1904049	1904058		yapJ	9
RK1001.C0101_allcombined	1904204	1904217		yapJ	13
RK1001.C0101_allcombined	1904265	1904299		yapJ	34
RK1001.C0101_allcombined	1904332	1904346		yapJ	14
RK1001.C0101_allcombined	1904870	1904873		yapJ	3
RK1001.C0101_allcombined	1905170	1905178		yapJ	8
RK1001.C0101_allcombined	1905593	1905606		yapJ	13
RK1001.C0101_allcombined	1907134	1907139		YPO_RS09345	5
RK1001.C0101_allcombined	1907170	1907189		YPO_RS09345	19
RK1001.C0101_allcombined	1908100	1908104		YPO_RS09345	4
RK1001.C0101_allcombined	1908181	1908223		YPO_RS09345	42
RK1001.C0101_allcombined	1908631	1908652		YPO_RS09345	21
RK1001.C0101_allcombined	1908917	1908947		YPO_RS09345	30
RK1001.C0101_allcombined	1909068	1909070		YPO_RS09345	2
RK1001.C0101_allcombined	1909561	1909636		YPO_RS09345	75
RK1001.C0101_allcombined	1910261	1910264		YPO_RS09350	3
RK1001.C0101_allcombined	1910407	1910412		YPO_RS09350	5
RK1001.C0101_allcombined	1910535	1910541		YPO_RS09350	6
RK1001.C0101_allcombined	1910640	1910662		YPO_RS09350	22
RK1001.C0101_allcombined	1911460	1911461		YPO_RS09355	1
RK1001.C0101_allcombined	1914777	1914781		cheR	4
RK1001.C0101_allcombined	1914836	1914847		cheR	11
RK1001.C0101_allcombined	1914895	1914897		cheR	2
RK1001.C0101_allcombined	1915157	1915159		cheR	2
RK1001.C0101_allcombined	1915232	1915238		cheR	6
RK1001.C0101_allcombined	1915774	1915802		YPO_RS09370	28
RK1001.C0101_allcombined	1916014	1916027		YPO_RS09370	13
RK1001.C0101_allcombined	1916215	1916220		YPO_RS09370	5
RK1001.C0101_allcombined	1916255	1916288		YPO_RS09370	33
RK1001.C0101_allcombined	1917062	1917072		cheY	10
RK1001.C0101_allcombined	1917572	1917574		cheZ	2
RK1001.C0101_allcombined	1918291	1918305		YPO_RS09385	14
RK1001.C0101_allcombined	1918350	1918380		YPO_RS09385	30
RK1001.C0101_allcombined	1918441	1918471		YPO_RS09385	30
RK1001.C0101_allcombined	1918694	1918710		YPO_RS09385	16
RK1001.C0101_allcombined	1918805	1918807		YPO_RS09385	2
RK1001.C0101_allcombined	1918932	1918935		YPO_RS09385	3
RK1001.C0101_allcombined	1919001	1919003		YPO_RS09385	2
RK1001.C0101_allcombined	1919417	1919445		YPO_RS09390	28
RK1001.C0101_allcombined	1919609	1919682		YPO_RS09390	73
RK1001.C0101_allcombined	1919737	1919756		YPO_RS09390	19
RK1001.C0101_allcombined	1919834	1919855		YPO_RS09390	21
RK1001.C0101_allcombined	1920494	1920531		YPO_RS09390	37
RK1001.C0101_allcombined	1920809	1920812		YPO_RS09390	3
RK1001.C0101_allcombined	1921767	1921813		YPO_RS09395	46
RK1001.C0101_allcombined	1922159	1922191		YPO_RS09400	32
RK1001.C0101_allcombined	1922235	1922254		YPO_RS09400	19
RK1001.C0101_allcombined	1922563	1922616		YPO_RS09400	53
RK1001.C0101_allcombined	1922895	1922952		YPO_RS09400	57
RK1001.C0101_allcombined	1923018	1923022		YPO_RS09400	4
RK1001.C0101_allcombined	1923843	1923894		YPO_RS09405	51
RK1001.C0101_allcombined	1924093	1924102		YPO_RS09405	9
RK1001.C0101_allcombined	1924428	1924436		YPO_RS09405	8
RK1001.C0101_allcombined	1924715	1924753		YPO_RS09405	38
RK1001.C0101_allcombined	1925396	1925410		YPO_RS09410	14
RK1001.C0101_allcombined	1925447	1925454		YPO_RS09410	7
RK1001.C0101_allcombined	1926217	1926233		YPO_RS09415	16
RK1001.C0101_allcombined	1926349	1926367		YPO_RS09415	18
RK1001.C0101_allcombined	1927105	1927114		YPO_RS09420	9
RK1001.C0101_allcombined	1927172	1927179		YPO_RS09420	7
RK1001.C0101_allcombined	1927239	1927244		YPO_RS09420	5
RK1001.C0101_allcombined	1927585	1927618		YPO_RS09420	33
RK1001.C0101_allcombined	1927655	1927669		YPO_RS09420	14
RK1001.C0101_allcombined	1928242	1928276		YPO_RS09425	34
RK1001.C0101_allcombined	1931419	1931429		YPO_RS09440	10
RK1001.C0101_allcombined	1931469	1931470		YPO_RS09440	1
RK1001.C0101_allcombined	1931677	1931687		YPO_RS09445	10
RK1001.C0101_allcombined	1931753	1931788		YPO_RS09445	35
RK1001.C0101_allcombined	1932109	1932116		YPO_RS09450	7
RK1001.C0101_allcombined	1932506	1932507		YPO_RS09450	1
RK1001.C0101_allcombined	1932647	1932661		YPO_RS09450	14
RK1001.C0101_allcombined	1932729	1932757		YPO_RS09450	28
RK1001.C0101_allcombined	1932814	1932832		YPO_RS09450	18
RK1001.C0101_allcombined	1932953	1932991		YPO_RS09450	38
RK1001.C0101_allcombined	1933540	1933542		YPO_RS09455	2
RK1001.C0101_allcombined	1933594	1933603		YPO_RS09455	9
RK1001.C0101_allcombined	1933921	1933923		YPO_RS09455	2
RK1001.C0101_allcombined	1934062	1934069		YPO_RS09455	7
RK1001.C0101_allcombined	1934322	1934389		YPO_RS09455	67
RK1001.C0101_allcombined	1934797	1934806		YPO_RS09455	9
RK1001.C0101_allcombined	1934930	1934945		YPO_RS09455	15
RK1001.C0101_allcombined	1935094	1935120		YPO_RS09455	26
RK1001.C0101_allcombined	1935287	1935292		YPO_RS09455	5
RK1001.C0101_allcombined	1935539	1935564		YPO_RS09455	25
RK1001.C0101_allcombined	1935632	1935653		YPO_RS09455	21
RK1001.C0101_allcombined	1935697	1935700		YPO_RS09455	3
RK1001.C0101_allcombined	1935923	1935941		YPO_RS09460	18
RK1001.C0101_allcombined	1936288	1936328		YPO_RS09460	40
RK1001.C0101_allcombined	1936486	1936515		YPO_RS09460	29
RK1001.C0101_allcombined	1936623	1936660		YPO_RS09460	37
RK1001.C0101_allcombined	1936706	1936733		YPO_RS09465	27
RK1001.C0101_allcombined	1936773	1936787		YPO_RS09465	14
RK1001.C0101_allcombined	1936830	1936854		YPO_RS09465	24
RK1001.C0101_allcombined	1937175	1937211		YPO_RS09465	36
RK1001.C0101_allcombined	1937296	1937309		YPO_RS09470	13
RK1001.C0101_allcombined	1937425	1937430		YPO_RS09470	5
RK1001.C0101_allcombined	1937565	1937572		YPO_RS09470	7
RK1001.C0101_allcombined	1937824	1937852		YPO_RS09475	28
RK1001.C0101_allcombined	1938007	1938037		YPO_RS09475	30
RK1001.C0101_allcombined	1938123	1938128		YPO_RS09475	5
RK1001.C0101_allcombined	1938293	1938374		YPO_RS09475	81
RK1001.C0101_allcombined	1939141	1939148		YPO_RS09480	7
RK1001.C0101_allcombined	1939319	1939322		YPO_RS09480	3
RK1001.C0101_allcombined	1939746	1939756		YPO_RS09480	10
RK1001.C0101_allcombined	1939879	1939887		YPO_RS09480	8
RK1001.C0101_allcombined	1939996	1940042		YPO_RS09480	46
RK1001.C0101_allcombined	1940372	1940400		YPO_RS09480	28
RK1001.C0101_allcombined	1940486	1940519		YPO_RS09480	33
RK1001.C0101_allcombined	1940580	1940585		YPO_RS09480	5
RK1001.C0101_allcombined	1940806	1940810		YPO_RS09480	4
RK1001.C0101_allcombined	1940917	1940920		YPO_RS09480	3
RK1001.C0101_allcombined	1941110	1941112		YPO_RS09480	2
RK1001.C0101_allcombined	1941214	1941259		YPO_RS09480	45
RK1001.C0101_allcombined	1941503	1941504		YPO_RS09480	1
RK1001.C0101_allcombined	1941503	1941510		yebS	7
RK1001.C0101_allcombined	1942036	1942044		yebS	8
RK1001.C0101_allcombined	1942172	1942183		yebS	11
RK1001.C0101_allcombined	1942275	1942278		yebS	3
RK1001.C0101_allcombined	1943151	1943161		YPO_RS09490	10
RK1001.C0101_allcombined	1943799	1943806		proQ	7
RK1001.C0101_allcombined	1944965	1944992		prc	27
RK1001.C0101_allcombined	1945052	1945053		prc	1
RK1001.C0101_allcombined	1945244	1945249		prc	5
RK1001.C0101_allcombined	1945721	1945739		prc	18
RK1001.C0101_allcombined	1945931	1945955		prc	24
RK1001.C0101_allcombined	1946085	1946086		prc	1
RK1001.C0101_allcombined	1946182	1946202		prc	20
RK1001.C0101_allcombined	1946824	1946831		htpX	7
RK1001.C0101_allcombined	1947422	1947454		htpX	32
RK1001.C0101_allcombined	1947602	1947705		htpX	103
RK1001.C0101_allcombined	1948570	1948596		YPO_RS09510	26
RK1001.C0101_allcombined	1949210	1949227		YPO_RS09515	17
RK1001.C0101_allcombined	1949320	1949385		YPO_RS09515	65
RK1001.C0101_allcombined	1949672	1949725		YPO_RS09515	53
RK1001.C0101_allcombined	1949954	1949959		YPO_RS09520	5
RK1001.C0101_allcombined	1950094	1950095		YPO_RS09520	1
RK1001.C0101_allcombined	1950745	1950749		YPO_RS09520	4
RK1001.C0101_allcombined	1950865	1950875		YPO_RS09520	10
RK1001.C0101_allcombined	1951081	1951117		YPO_RS09520	36
RK1001.C0101_allcombined	1951157	1951158		YPO_RS09520	1
RK1001.C0101_allcombined	1951261	1951271		YPO_RS09520	10
RK1001.C0101_allcombined	1951959	1951978		YPO_RS09520	19
RK1001.C0101_allcombined	1952154	1952165		YPO_RS09520	11
RK1001.C0101_allcombined	1952253	1952256		YPO_RS09520	3
RK1001.C0101_allcombined	1952472	1952474		YPO_RS09520	2
RK1001.C0101_allcombined	1952542	1952545		YPO_RS09525	3
RK1001.C0101_allcombined	1952693	1952700		YPO_RS09525	7
RK1001.C0101_allcombined	1953564	1953574		YPO_RS09525	10
RK1001.C0101_allcombined	1953648	1953654		YPO_RS09525	6
RK1001.C0101_allcombined	1955013	1955023		YPO_RS09535	10
RK1001.C0101_allcombined	1955478	1955487		YPO_RS09535	9
RK1001.C0101_allcombined	1955909	1955912		YPO_RS09535	3
RK1001.C0101_allcombined	1956239	1956270		YPO_RS09540	31
RK1001.C0101_allcombined	1956467	1956489		YPO_RS09540	22
RK1001.C0101_allcombined	1957014	1957056		YPO_RS09540	42
RK1001.C0101_allcombined	1957101	1957112		YPO_RS09540	11
RK1001.C0101_allcombined	1957145	1957256		YPO_RS09540	111
RK1001.C0101_allcombined	1957730	1957754		kdgR	24
RK1001.C0101_allcombined	1957923	1957957		kdgR	34
RK1001.C0101_allcombined	1958366	1958383		kdgR	17
RK1001.C0101_allcombined	1958768	1958776		YPO_RS09550	8
RK1001.C0101_allcombined	1958880	1958888		YPO_RS09550	8
RK1001.C0101_allcombined	1959296	1959311		YPO_RS09550	15
RK1001.C0101_allcombined	1959583	1959616		YPO_RS09550	33
RK1001.C0101_allcombined	1959871	1959877		YPO_RS09555	6
RK1001.C0101_allcombined	1961031	1961055		YPO_RS09555	24
RK1001.C0101_allcombined	1961429	1961451		YPO_RS09560	22
RK1001.C0101_allcombined	1961511	1961526		YPO_RS09560	15
RK1001.C0101_allcombined	1961589	1961598		YPO_RS09560	9
RK1001.C0101_allcombined	1961668	1961691		YPO_RS09560	23
RK1001.C0101_allcombined	1961962	1961977		YPO_RS09560	15
RK1001.C0101_allcombined	1962596	1962599		YPO_RS09565	3
RK1001.C0101_allcombined	1962876	1962888		YPO_RS09565	12
RK1001.C0101_allcombined	1963047	1963063		YPO_RS09565	16
RK1001.C0101_allcombined	1963116	1963157		YPO_RS09565	41
RK1001.C0101_allcombined	1963507	1963552		YPO_RS09570	45
RK1001.C0101_allcombined	1964013	1964063		YPO_RS09570	50
RK1001.C0101_allcombined	1964098	1964113		YPO_RS09570	15
RK1001.C0101_allcombined	1964154	1964183		YPO_RS09570	29
RK1001.C0101_allcombined	1964251	1964277		YPO_RS09570	26
RK1001.C0101_allcombined	1964328	1964352		YPO_RS09570	24
RK1001.C0101_allcombined	1964574	1964660		YPO_RS09570	86
RK1001.C0101_allcombined	1964730	1964737		YPO_RS09570	7
RK1001.C0101_allcombined	1965427	1965443		YPO_RS09575	16
RK1001.C0101_allcombined	1965664	1965673		YPO_RS09575	9
RK1001.C0101_allcombined	1965880	1965892		YPO_RS09575	12
RK1001.C0101_allcombined	1966056	1966078		YPO_RS09580	22
RK1001.C0101_allcombined	1966199	1966207		YPO_RS09580	8
RK1001.C0101_allcombined	1966413	1966415		YPO_RS09580	2
RK1001.C0101_allcombined	1966533	1966537		YPO_RS09580	4
RK1001.C0101_allcombined	1966604	1966621		YPO_RS09580	17
RK1001.C0101_allcombined	1966969	1966977		YPO_RS09585	8
RK1001.C0101_allcombined	1967578	1967717		YPO_RS09585	139
RK1001.C0101_allcombined	1967758	1967764		YPO_RS09590	6
RK1001.C0101_allcombined	1967862	1967867		YPO_RS09590	5
RK1001.C0101_allcombined	1967911	1967927		YPO_RS09590	16
RK1001.C0101_allcombined	1968078	1968085		YPO_RS09590	7
RK1001.C0101_allcombined	1968201	1968208		YPO_RS09590	7
RK1001.C0101_allcombined	1968964	1969009		YPO_RS09590	45
RK1001.C0101_allcombined	1970614	1970615		kduI	1
RK1001.C0101_allcombined	1970866	1970875		kduI	9
RK1001.C0101_allcombined	1970947	1970996		kduI	49
RK1001.C0101_allcombined	1971059	1971067		kduI	8
RK1001.C0101_allcombined	1971786	1971820		YPO_RS09605	34
RK1001.C0101_allcombined	1972101	1972104		YPO_RS09605	3
RK1001.C0101_allcombined	1972339	1972340		YPO_RS09610	1
RK1001.C0101_allcombined	1974768	1974775		YPO_RS09620	7
RK1001.C0101_allcombined	1975451	1975455		YPO_RS09620	4
RK1001.C0101_allcombined	1976741	1976751		YPO_RS09630	10
RK1001.C0101_allcombined	1977806	1977815		mtfA	9
RK1001.C0101_allcombined	1979095	1979096		YPO_RS09650	1
RK1001.C0101_allcombined	1979159	1979188		YPO_RS09650	29
RK1001.C0101_allcombined	1979963	1979980		YPO_RS09655	17
RK1001.C0101_allcombined	1980016	1980033		YPO_RS09655	17
RK1001.C0101_allcombined	1980406	1980407		YPO_RS09655	1
RK1001.C0101_allcombined	1980755	1980780		YPO_RS09655	25
RK1001.C0101_allcombined	1981049	1981070		YPO_RS09655	21
RK1001.C0101_allcombined	1981107	1981113		YPO_RS09655	6
RK1001.C0101_allcombined	1981272	1981347		YPO_RS09655	75
RK1001.C0101_allcombined	1982364	1982400		YPO_RS09660	36
RK1001.C0101_allcombined	1982557	1982597		YPO_RS09665	40
RK1001.C0101_allcombined	1982766	1982767		YPO_RS09665	1
RK1001.C0101_allcombined	1983477	1983491		YPO_RS09670	14
RK1001.C0101_allcombined	1984418	1984419		mgrB	1
RK1001.C0101_allcombined	1984822	1984829		YPO_RS09685	7
RK1001.C0101_allcombined	1985307	1985320		YPO_RS09690	13
RK1001.C0101_allcombined	1985586	1985612		YPO_RS09695	26
RK1001.C0101_allcombined	1985801	1985814		YPO_RS09695	13
RK1001.C0101_allcombined	1986181	1986200		YPO_RS09700	19
RK1001.C0101_allcombined	1986469	1986475		YPO_RS09700	6
RK1001.C0101_allcombined	1986550	1986556		YPO_RS09700	6
RK1001.C0101_allcombined	1986804	1986810		YPO_RS09700	6
RK1001.C0101_allcombined	1986961	1986988		YPO_RS09700	27
RK1001.C0101_allcombined	1987041	1987047		YPO_RS09700	6
RK1001.C0101_allcombined	1987244	1987260		YPO_RS09700	16
RK1001.C0101_allcombined	1987301	1987330		YPO_RS09700	29
RK1001.C0101_allcombined	1987758	1987767		YPO_RS09705	9
RK1001.C0101_allcombined	1987814	1987873		YPO_RS09705	59
RK1001.C0101_allcombined	1989343	1989363		YPO_RS09710	20
RK1001.C0101_allcombined	1989415	1989446		YPO_RS09710	31
RK1001.C0101_allcombined	1989489	1989494		cspE	5
RK1001.C0101_allcombined	1989905	1989908		pgeF	3
RK1001.C0101_allcombined	1989946	1989957		pgeF	11
RK1001.C0101_allcombined	1990211	1990234		pgeF	23
RK1001.C0101_allcombined	1990421	1990426		pgeF	5
RK1001.C0101_allcombined	1990462	1990472		pgeF	10
RK1001.C0101_allcombined	1990944	1990966		rlmA	22
RK1001.C0101_allcombined	1991635	1991636		rlmA	1
RK1001.C0101_allcombined	1992176	1992215		YPO_RS09730	39
RK1001.C0101_allcombined	1992271	1992278		YPO_RS09730	7
RK1001.C0101_allcombined	1993538	1993545		YPO_RS09735	7
RK1001.C0101_allcombined	1994507	1994512		YPO_RS09745	5
RK1001.C0101_allcombined	1994823	1994842		YPO_RS09745	19
RK1001.C0101_allcombined	1995131	1995157		YPO_RS09745	26
RK1001.C0101_allcombined	1995219	1995222		YPO_RS09745	3
RK1001.C0101_allcombined	1995271	1995307		YPO_RS09745	36
RK1001.C0101_allcombined	1995676	1995694		YPO_RS09745	18
RK1001.C0101_allcombined	1995817	1995829		YPO_RS09745	12
RK1001.C0101_allcombined	1995891	1995896		YPO_RS09745	5
RK1001.C0101_allcombined	1996016	1996063		YPO_RS09745	47
RK1001.C0101_allcombined	1996190	1996215		YPO_RS09745	25
RK1001.C0101_allcombined	1996470	1996481		YPO_RS09745	11
RK1001.C0101_allcombined	1997477	1997496		YPO_RS09750	19
RK1001.C0101_allcombined	1998130	1998141		YPO_RS09750	11
RK1001.C0101_allcombined	1998187	1998197		YPO_RS09750	10
RK1001.C0101_allcombined	1998256	1998267		YPO_RS09750	11
RK1001.C0101_allcombined	1998344	1998348		YPO_RS09750	4
RK1001.C0101_allcombined	1998480	1998483		YPO_RS09750	3
RK1001.C0101_allcombined	1998574	1998597		YPO_RS09750	23
RK1001.C0101_allcombined	1998939	1998950		YPO_RS09750	11
RK1001.C0101_allcombined	1999336	1999364		mntP	28
RK1001.C0101_allcombined	1999656	1999666		mntP	10
RK1001.C0101_allcombined	1999863	1999881		mntP	18
RK1001.C0101_allcombined	2000359	2000381		YPO_RS09760	22
RK1001.C0101_allcombined	2000420	2000443		YPO_RS09760	23
RK1001.C0101_allcombined	2000473	2000479		YPO_RS09760	6
RK1001.C0101_allcombined	2000721	2000736		YPO_RS09760	15
RK1001.C0101_allcombined	2001155	2001158		YPO_RS09765	3
RK1001.C0101_allcombined	2001237	2001258		YPO_RS09765	21
RK1001.C0101_allcombined	2001457	2001477		YPO_RS09765	20
RK1001.C0101_allcombined	2001656	2001669		YPO_RS09765	13
RK1001.C0101_allcombined	2001821	2001844		YPO_RS09765	23
RK1001.C0101_allcombined	2001975	2001981		YPO_RS09770	6
RK1001.C0101_allcombined	2002068	2002079		YPO_RS09770	11
RK1001.C0101_allcombined	2002160	2002189		YPO_RS09770	29
RK1001.C0101_allcombined	2002464	2002467		YPO_RS09770	3
RK1001.C0101_allcombined	2002684	2002686		YPO_RS09770	2
RK1001.C0101_allcombined	2002780	2002803		manX	23
RK1001.C0101_allcombined	2002861	2002887		manX	26
RK1001.C0101_allcombined	2002923	2002924		manX	1
RK1001.C0101_allcombined	2003569	2003570		manX	1
RK1001.C0101_allcombined	2003614	2003623		manX	9
RK1001.C0101_allcombined	2003731	2003734		manX	3
RK1001.C0101_allcombined	2004523	2004536		YPO_RS09780	13
RK1001.C0101_allcombined	2005174	2005191		YPO_RS09780	17
RK1001.C0101_allcombined	2005498	2005504		YPO_RS09780	6
RK1001.C0101_allcombined	2005690	2005706		YPO_RS09780	16
RK1001.C0101_allcombined	2006034	2006035		hpaR	1
RK1001.C0101_allcombined	2006198	2006207		hpaR	9
RK1001.C0101_allcombined	2007049	2007065		YPO_RS09790	16
RK1001.C0101_allcombined	2007542	2007545		YPO_RS09795	3
RK1001.C0101_allcombined	2007577	2007596		YPO_RS09795	19
RK1001.C0101_allcombined	2008098	2008099		YPO_RS09795	1
RK1001.C0101_allcombined	2008209	2008227		YPO_RS09795	18
RK1001.C0101_allcombined	2008271	2008275		YPO_RS09800	4
RK1001.C0101_allcombined	2008770	2008777		YPO_RS09800	7
RK1001.C0101_allcombined	2008852	2008856		YPO_RS09800	4
RK1001.C0101_allcombined	2009176	2009191		YPO_RS09800	15
RK1001.C0101_allcombined	2009275	2009281		YPO_RS09800	6
RK1001.C0101_allcombined	2009959	2010019		hpaD	60
RK1001.C0101_allcombined	2010785	2010787		YPO_RS09810	2
RK1001.C0101_allcombined	2011816	2011832		hpaH	16
RK1001.C0101_allcombined	2011871	2011882		hpaI	11
RK1001.C0101_allcombined	2012205	2012206		hpaI	1
RK1001.C0101_allcombined	2012909	2012982		hpaX	73
RK1001.C0101_allcombined	2013014	2013022		hpaX	8
RK1001.C0101_allcombined	2013115	2013126		hpaX	11
RK1001.C0101_allcombined	2013507	2013548		hpaX	41
RK1001.C0101_allcombined	2013781	2013788		hpaX	7
RK1001.C0101_allcombined	2013972	2013980		hpaX	8
RK1001.C0101_allcombined	2014765	2014766		hpaB	1
RK1001.C0101_allcombined	2014942	2014955		hpaB	13
RK1001.C0101_allcombined	2015115	2015118		hpaB	3
RK1001.C0101_allcombined	2015396	2015413		hpaB	17
RK1001.C0101_allcombined	2015558	2015564		hpaB	6
RK1001.C0101_allcombined	2015851	2015895		hpaC	44
RK1001.C0101_allcombined	2015932	2015937		hpaC	5
RK1001.C0101_allcombined	2016110	2016118		hpaC	8
RK1001.C0101_allcombined	2016543	2016559		YPO_RS09840	16
RK1001.C0101_allcombined	2016719	2016721		YPO_RS09840	2
RK1001.C0101_allcombined	2016948	2016958		YPO_RS09840	10
RK1001.C0101_allcombined	2017071	2017094		YPO_RS09840	23
RK1001.C0101_allcombined	2017281	2017297		YPO_RS09840	16
RK1001.C0101_allcombined	2017727	2017728		YPO_RS09840	1
RK1001.C0101_allcombined	2018785	2018792		YPO_RS09845	7
RK1001.C0101_allcombined	2019081	2019086		YPO_RS09845	5
RK1001.C0101_allcombined	2020298	2020317		pabB	19
RK1001.C0101_allcombined	2020402	2020420		pabB	18
RK1001.C0101_allcombined	2020700	2020705		YPO_RS09855	5
RK1001.C0101_allcombined	2020767	2020780		YPO_RS09855	13
RK1001.C0101_allcombined	2020940	2020953		YPO_RS09855	13
RK1001.C0101_allcombined	2023135	2023137		dbpA	2
RK1001.C0101_allcombined	2023280	2023293		dbpA	13
RK1001.C0101_allcombined	2023325	2023338		dbpA	13
RK1001.C0101_allcombined	2023816	2023818		dbpA	2
RK1001.C0101_allcombined	2023932	2023947		dbpA	15
RK1001.C0101_allcombined	2024180	2024191		YPO_RS09870	11
RK1001.C0101_allcombined	2024245	2024265		YPO_RS09870	20
RK1001.C0101_allcombined	2024481	2024493		YPO_RS09875	12
RK1001.C0101_allcombined	2025102	2025116		YPO_RS09880	14
RK1001.C0101_allcombined	2025622	2025638		YPO_RS09885	16
RK1001.C0101_allcombined	2026000	2026025		YPO_RS09885	25
RK1001.C0101_allcombined	2026136	2026173		YPO_RS09885	37
RK1001.C0101_allcombined	2026571	2026585		YPO_RS09885	14
RK1001.C0101_allcombined	2026743	2026777		YPO_RS09885	34
RK1001.C0101_allcombined	2026910	2026945		YPO_RS09885	35
RK1001.C0101_allcombined	2027055	2027089		YPO_RS09885	34
RK1001.C0101_allcombined	2027332	2027371		YPO_RS09885	39
RK1001.C0101_allcombined	2027573	2027578		YPO_RS09885	5
RK1001.C0101_allcombined	2028437	2028468		pip	31
RK1001.C0101_allcombined	2029350	2029365		YPO_RS09895	15
RK1001.C0101_allcombined	2030105	2030128		ftnA	23
RK1001.C0101_allcombined	2030294	2030365		ftnA	71
RK1001.C0101_allcombined	2031235	2031246		yobA	11
RK1001.C0101_allcombined	2031311	2031312		copD	1
RK1001.C0101_allcombined	2031843	2031883		copD	40
RK1001.C0101_allcombined	2032238	2032273		YPO_RS09915	35
RK1001.C0101_allcombined	2032433	2032512		YPO_RS09915	79
RK1001.C0101_allcombined	2033189	2033202		YPO_RS09920	13
RK1001.C0101_allcombined	2033234	2033281		YPO_RS09920	47
RK1001.C0101_allcombined	2033317	2033340		YPO_RS09920	23
RK1001.C0101_allcombined	2033443	2033450		YPO_RS09925	7
RK1001.C0101_allcombined	2033621	2033628		YPO_RS09925	7
RK1001.C0101_allcombined	2033684	2033700		YPO_RS09925	16
RK1001.C0101_allcombined	2034743	2034744		flhB	1
RK1001.C0101_allcombined	2034988	2034992		flhB	4
RK1001.C0101_allcombined	2035561	2035570		flhB	9
RK1001.C0101_allcombined	2035970	2035981		flhA	11
RK1001.C0101_allcombined	2036013	2036037		flhA	24
RK1001.C0101_allcombined	2036212	2036234		flhA	22
RK1001.C0101_allcombined	2036361	2036373		flhA	12
RK1001.C0101_allcombined	2036645	2036651		flhA	6
RK1001.C0101_allcombined	2036826	2036828		flhA	2
RK1001.C0101_allcombined	2037114	2037117		flhA	3
RK1001.C0101_allcombined	2037147	2037185		flhA	38
RK1001.C0101_allcombined	2037416	2037427		flhA	11
RK1001.C0101_allcombined	2037625	2037642		flhA	17
RK1001.C0101_allcombined	2040069	2040070		YPO_RS09950	1
RK1001.C0101_allcombined	2042646	2042679		YPO_RS09960	33
RK1001.C0101_allcombined	2043977	2044014		flgA	37
RK1001.C0101_allcombined	2044654	2044664		flgB	10
RK1001.C0101_allcombined	2044816	2044829		flgC	13
RK1001.C0101_allcombined	2046449	2046460		YPO_RS09990	11
RK1001.C0101_allcombined	2046944	2046952		YPO_RS09990	8
RK1001.C0101_allcombined	2047077	2047080		YPO_RS09990	3
RK1001.C0101_allcombined	2048272	2048282		flgG	10
RK1001.C0101_allcombined	2048411	2048414		flgG	3
RK1001.C0101_allcombined	2048464	2048470		flgG	6
RK1001.C0101_allcombined	2048665	2048691		flgG	26
RK1001.C0101_allcombined	2049261	2049269		flgH	8
RK1001.C0101_allcombined	2049519	2049545		flgH	26
RK1001.C0101_allcombined	2049939	2049958		YPO_RS10010	19
RK1001.C0101_allcombined	2050004	2050010		YPO_RS10010	6
RK1001.C0101_allcombined	2050709	2050712		flgJ	3
RK1001.C0101_allcombined	2050995	2051006		flgJ	11
RK1001.C0101_allcombined	2051224	2051244		flgJ	20
RK1001.C0101_allcombined	2051420	2051424		flgJ	4
RK1001.C0101_allcombined	2051581	2051583		flgJ	2
RK1001.C0101_allcombined	2052494	2052500		flgK	6
RK1001.C0101_allcombined	2052956	2052964		flgK	8
RK1001.C0101_allcombined	2053469	2053476		flgK	7
RK1001.C0101_allcombined	2053828	2053841		flgK	13
RK1001.C0101_allcombined	2054021	2054050		flgK	29
RK1001.C0101_allcombined	2054401	2054407		flgL	6
RK1001.C0101_allcombined	2054632	2054633		flgL	1
RK1001.C0101_allcombined	2055138	2055145		flgL	7
RK1001.C0101_allcombined	2055180	2055185		flgL	5
RK1001.C0101_allcombined	2055226	2055233		flgL	7
RK1001.C0101_allcombined	2055360	2055371		YPO_RS10030	11
RK1001.C0101_allcombined	2055511	2055520		YPO_RS10030	9
RK1001.C0101_allcombined	2055731	2055742		YPO_RS10030	11
RK1001.C0101_allcombined	2056582	2056596		YPO_RS10035	14
RK1001.C0101_allcombined	2056656	2056676		YPO_RS10035	20
RK1001.C0101_allcombined	2056828	2056830		YPO_RS10035	2
RK1001.C0101_allcombined	2057024	2057034		YPO_RS10035	10
RK1001.C0101_allcombined	2057490	2057497		YPO_RS10035	7
RK1001.C0101_allcombined	2058237	2058254		YPO_RS10035	17
RK1001.C0101_allcombined	2058759	2058776		YPO_RS10040	17
RK1001.C0101_allcombined	2059581	2059591		YPO_RS10040	10
RK1001.C0101_allcombined	2060008	2060031		YPO_RS10045	23
RK1001.C0101_allcombined	2060125	2060133		YPO_RS10045	8
RK1001.C0101_allcombined	2060388	2060413		YPO_RS10045	25
RK1001.C0101_allcombined	2060615	2060617		YPO_RS10045	2
RK1001.C0101_allcombined	2060775	2060778		YPO_RS10045	3
RK1001.C0101_allcombined	2061220	2061237		YPO_RS10050	17
RK1001.C0101_allcombined	2061379	2061384		YPO_RS10050	5
RK1001.C0101_allcombined	2061717	2061741		YPO_RS10050	24
RK1001.C0101_allcombined	2062324	2062331		YPO_RS10050	7
RK1001.C0101_allcombined	2062478	2062481		YPO_RS10050	3
RK1001.C0101_allcombined	2062484	2062492		YPO_RS10055	8
RK1001.C0101_allcombined	2062616	2062624		YPO_RS10055	8
RK1001.C0101_allcombined	2062833	2062845		YPO_RS10055	12
RK1001.C0101_allcombined	2062925	2062935		YPO_RS10055	10
RK1001.C0101_allcombined	2063598	2063640		YPO_RS10060	42
RK1001.C0101_allcombined	2063816	2063820		YPO_RS10060	4
RK1001.C0101_allcombined	2064026	2064029		YPO_RS10060	3
RK1001.C0101_allcombined	2064260	2064267		YPO_RS10060	7
RK1001.C0101_allcombined	2065403	2065408		YPO_RS10070	5
RK1001.C0101_allcombined	2065722	2065728		fliR	6
RK1001.C0101_allcombined	2065819	2065834		fliR	15
RK1001.C0101_allcombined	2066202	2066219		fliR	17
RK1001.C0101_allcombined	2066277	2066278		fliR	1
RK1001.C0101_allcombined	2066510	2066516		fliQ	6
RK1001.C0101_allcombined	2067422	2067423		fliP	1
RK1001.C0101_allcombined	2067500	2067505		fliP	5
RK1001.C0101_allcombined	2067958	2067970		fliO	12
RK1001.C0101_allcombined	2068599	2068651		fliM	52
RK1001.C0101_allcombined	2068974	2069006		fliM	32
RK1001.C0101_allcombined	2069482	2069483		fliM	1
RK1001.C0101_allcombined	2069917	2069925		fliL	8
RK1001.C0101_allcombined	2070030	2070032		fliL	2
RK1001.C0101_allcombined	2070384	2070386		YPO_RS10110	2
RK1001.C0101_allcombined	2070962	2070966		YPO_RS10110	4
RK1001.C0101_allcombined	2071999	2072014		fliJ	15
RK1001.C0101_allcombined	2073252	2073291		fliI	39
RK1001.C0101_allcombined	2074306	2074318		fliH	12
RK1001.C0101_allcombined	2074581	2074582		fliG	1
RK1001.C0101_allcombined	2076112	2076113		fliF	1
RK1001.C0101_allcombined	2076716	2076727		fliF	11
RK1001.C0101_allcombined	2077399	2077423		fliE	24
RK1001.C0101_allcombined	2077667	2077685		fliE	18
RK1001.C0101_allcombined	2078240	2078252		YPO_RS10150	12
RK1001.C0101_allcombined	2078263	2078285		YPO_RS10155	22
RK1001.C0101_allcombined	2078567	2078571		YPO_RS10155	4
RK1001.C0101_allcombined	2078720	2078724		YPO_RS10155	4
RK1001.C0101_allcombined	2079327	2079345		YPO_RS10160	18
RK1001.C0101_allcombined	2079959	2080006		YPO_RS10165	47
RK1001.C0101_allcombined	2080193	2080209		YPO_RS10165	16
RK1001.C0101_allcombined	2080562	2080592		YPO_RS10165	30
RK1001.C0101_allcombined	2080750	2080760		YPO_RS10170	10
RK1001.C0101_allcombined	2080826	2080841		YPO_RS10170	15
RK1001.C0101_allcombined	2080875	2080889		YPO_RS10170	14
RK1001.C0101_allcombined	2080927	2080940		YPO_RS10170	13
RK1001.C0101_allcombined	2081169	2081188		YPO_RS10170	19
RK1001.C0101_allcombined	2081222	2081259		YPO_RS10170	37
RK1001.C0101_allcombined	2081398	2081408		YPO_RS10170	10
RK1001.C0101_allcombined	2081464	2081489		YPO_RS10170	25
RK1001.C0101_allcombined	2081527	2081550		YPO_RS10170	23
RK1001.C0101_allcombined	2081649	2081667		YPO_RS10170	18
RK1001.C0101_allcombined	2082059	2082072		YPO_RS10170	13
RK1001.C0101_allcombined	2082319	2082331		YPO_RS10170	12
RK1001.C0101_allcombined	2082536	2082545		YPO_RS10170	9
RK1001.C0101_allcombined	2082583	2082595		YPO_RS10170	12
RK1001.C0101_allcombined	2082638	2082641		YPO_RS10170	3
RK1001.C0101_allcombined	2083246	2083247		YPO_RS10175	1
RK1001.C0101_allcombined	2083438	2083510		YPO_RS10175	72
RK1001.C0101_allcombined	2083837	2083838		YPO_RS10175	1
RK1001.C0101_allcombined	2084364	2084375		fliT	11
RK1001.C0101_allcombined	2084951	2084953		fliS	2
RK1001.C0101_allcombined	2085111	2085115		fliD	4
RK1001.C0101_allcombined	2085391	2085415		fliD	24
RK1001.C0101_allcombined	2085602	2085625		fliD	23
RK1001.C0101_allcombined	2085728	2085729		fliD	1
RK1001.C0101_allcombined	2085814	2085820		fliD	6
RK1001.C0101_allcombined	2086019	2086022		fliD	3
RK1001.C0101_allcombined	2086080	2086089		fliD	9
RK1001.C0101_allcombined	2086225	2086230		fliD	5
RK1001.C0101_allcombined	2086661	2086669		YPO_RS10195	8
RK1001.C0101_allcombined	2086976	2086985		YPO_RS10195	9
RK1001.C0101_allcombined	2087039	2087044		YPO_RS10195	5
RK1001.C0101_allcombined	2087157	2087195		YPO_RS10195	38
RK1001.C0101_allcombined	2087296	2087300		YPO_RS10195	4
RK1001.C0101_allcombined	2087355	2087396		YPO_RS10195	41
RK1001.C0101_allcombined	2087565	2087589		YPO_RS10195	24
RK1001.C0101_allcombined	2087684	2087693		YPO_RS10195	9
RK1001.C0101_allcombined	2088320	2088335		YPO_RS10200	15
RK1001.C0101_allcombined	2088722	2088730		YPO_RS10200	8
RK1001.C0101_allcombined	2089061	2089063		fliZ	2
RK1001.C0101_allcombined	2089490	2089506		fliZ	16
RK1001.C0101_allcombined	2089935	2089969		YPO_RS10210	34
RK1001.C0101_allcombined	2090051	2090054		YPO_RS10210	3
RK1001.C0101_allcombined	2090661	2090675		YPO_RS10210	14
RK1001.C0101_allcombined	2090840	2090851		YPO_RS10210	11
RK1001.C0101_allcombined	2090975	2090978		tcyJ	3
RK1001.C0101_allcombined	2091259	2091269		tcyJ	10
RK1001.C0101_allcombined	2091322	2091370		tcyJ	48
RK1001.C0101_allcombined	2091450	2091465		tcyJ	15
RK1001.C0101_allcombined	2091683	2091693		tcyJ	10
RK1001.C0101_allcombined	2092202	2092209		tcyL	7
RK1001.C0101_allcombined	2092568	2092569		yecC	1
RK1001.C0101_allcombined	2092762	2092771		yecC	9
RK1001.C0101_allcombined	2092952	2092955		yecC	3
RK1001.C0101_allcombined	2092991	2093015		yecC	24
RK1001.C0101_allcombined	2094152	2094158		YPO_RS10235	6
RK1001.C0101_allcombined	2095548	2095557		putA	9
RK1001.C0101_allcombined	2096021	2096070		putA	49
RK1001.C0101_allcombined	2096525	2096531		putA	6
RK1001.C0101_allcombined	2096811	2096826		putA	15
RK1001.C0101_allcombined	2097113	2097117		putA	4
RK1001.C0101_allcombined	2097626	2097633		putA	7
RK1001.C0101_allcombined	2097724	2097734		putA	10
RK1001.C0101_allcombined	2098186	2098202		putA	16
RK1001.C0101_allcombined	2098251	2098256		putA	5
RK1001.C0101_allcombined	2099002	2099024		YPO_RS10245	22
RK1001.C0101_allcombined	2099168	2099177		YPO_RS10245	9
RK1001.C0101_allcombined	2099344	2099403		putP	59
RK1001.C0101_allcombined	2099935	2099947		putP	12
RK1001.C0101_allcombined	2100013	2100036		putP	23
RK1001.C0101_allcombined	2100245	2100281		putP	36
RK1001.C0101_allcombined	2100535	2100561		putP	26
RK1001.C0101_allcombined	2101199	2101208		YPO_RS10255	9
RK1001.C0101_allcombined	2101707	2101715		YPO_RS10255	8
RK1001.C0101_allcombined	2101756	2101758		YPO_RS10255	2
RK1001.C0101_allcombined	2102101	2102116		YPO_RS10260	15
RK1001.C0101_allcombined	2102572	2102623		YPO_RS10260	51
RK1001.C0101_allcombined	2103330	2103337		efeB	7
RK1001.C0101_allcombined	2103581	2103593		efeB	12
RK1001.C0101_allcombined	2103646	2103674		efeB	28
RK1001.C0101_allcombined	2103742	2103767		efeB	25
RK1001.C0101_allcombined	2103833	2103836		efeB	3
RK1001.C0101_allcombined	2104132	2104145		efeB	13
RK1001.C0101_allcombined	2104265	2104286		efeB	21
RK1001.C0101_allcombined	2104658	2104708		wrbA	50
RK1001.C0101_allcombined	2104989	2104996		wrbA	7
RK1001.C0101_allcombined	2105445	2105448		YPO_RS10275	3
RK1001.C0101_allcombined	2105980	2106047		YPO_RS10275	67
RK1001.C0101_allcombined	2106233	2106255		YPO_RS10275	22
RK1001.C0101_allcombined	2106810	2106814		cycA	4
RK1001.C0101_allcombined	2107350	2107366		cycA	16
RK1001.C0101_allcombined	2107698	2107714		cycA	16
RK1001.C0101_allcombined	2107962	2107968		cycA	6
RK1001.C0101_allcombined	2108087	2108125		cycA	38
RK1001.C0101_allcombined	2109302	2109306		YPO_RS10290	4
RK1001.C0101_allcombined	2109410	2109551		YPO_RS10290	141
RK1001.C0101_allcombined	2109659	2109671		YPO_RS10290	12
RK1001.C0101_allcombined	2109810	2109820		YPO_RS10290	10
RK1001.C0101_allcombined	2110331	2110355		YPO_RS10295	24
RK1001.C0101_allcombined	2110575	2110583		YPO_RS10300	8
RK1001.C0101_allcombined	2110621	2110660		YPO_RS10300	39
RK1001.C0101_allcombined	2110749	2110783		YPO_RS10300	34
RK1001.C0101_allcombined	2110971	2110981		YPO_RS10305	10
RK1001.C0101_allcombined	2111929	2111952		uvrY	23
RK1001.C0101_allcombined	2112088	2112098		uvrY	10
RK1001.C0101_allcombined	2112352	2112380		uvrY	28
RK1001.C0101_allcombined	2112521	2112522		uvrC	1
RK1001.C0101_allcombined	2112710	2112784		uvrC	74
RK1001.C0101_allcombined	2113273	2113280		uvrC	7
RK1001.C0101_allcombined	2113522	2113526		uvrC	4
RK1001.C0101_allcombined	2113611	2113624		uvrC	13
RK1001.C0101_allcombined	2113734	2113740		uvrC	6
RK1001.C0101_allcombined	2113785	2113806		uvrC	21
RK1001.C0101_allcombined	2114123	2114144		uvrC	21
RK1001.C0101_allcombined	2114823	2114831		pgsA	8
RK1001.C0101_allcombined	2115585	2115590		YPO_RS10340	5
RK1001.C0101_allcombined	2117239	2117275		YPO_RS10350	36
RK1001.C0101_allcombined	2117383	2117412		YPO_RS10350	29
RK1001.C0101_allcombined	2117676	2117710		YPO_RS10355	34
RK1001.C0101_allcombined	2118003	2118036		hcp	33
RK1001.C0101_allcombined	2118075	2118131		hcp	56
RK1001.C0101_allcombined	2118290	2118291		hcp	1
RK1001.C0101_allcombined	2118764	2118782		YPO_RS10365	18
RK1001.C0101_allcombined	2119114	2119126		YPO_RS10365	12
RK1001.C0101_allcombined	2119927	2119929		YPO_RS10365	2
RK1001.C0101_allcombined	2121904	2121907		YPO_RS10380	3
RK1001.C0101_allcombined	2122488	2122498		YPO_RS10390	10
RK1001.C0101_allcombined	2122634	2122664		YPO_RS10395	30
RK1001.C0101_allcombined	2122807	2122827		YPO_RS10395	20
RK1001.C0101_allcombined	2123331	2123349		YPO_RS10405	18
RK1001.C0101_allcombined	2123385	2123392		YPO_RS10405	7
RK1001.C0101_allcombined	2123437	2123495		YPO_RS10405	58
RK1001.C0101_allcombined	2123531	2123592		YPO_RS10405	61
RK1001.C0101_allcombined	2123632	2123640		YPO_RS10405	8
RK1001.C0101_allcombined	2123719	2123728		YPO_RS10405	9
RK1001.C0101_allcombined	2123773	2123783		YPO_RS10405	10
RK1001.C0101_allcombined	2123951	2123969		YPO_RS10405	18
RK1001.C0101_allcombined	2124008	2124022		YPO_RS10405	14
RK1001.C0101_allcombined	2124115	2124148		YPO_RS10405	33
RK1001.C0101_allcombined	2124197	2124226		YPO_RS10405	29
RK1001.C0101_allcombined	2126053	2126062		YPO_RS10415	9
RK1001.C0101_allcombined	2126102	2126121		YPO_RS10415	19
RK1001.C0101_allcombined	2126169	2126171		YPO_RS10415	2
RK1001.C0101_allcombined	2126285	2126362		YPO_RS10415	77
RK1001.C0101_allcombined	2126392	2126444		YPO_RS10415	52
RK1001.C0101_allcombined	2126474	2126512		YPO_RS10415	38
RK1001.C0101_allcombined	2126564	2126582		YPO_RS10420	18
RK1001.C0101_allcombined	2126633	2126693		YPO_RS10420	60
RK1001.C0101_allcombined	2126743	2126808		YPO_RS10420	65
RK1001.C0101_allcombined	2126876	2126893		YPO_RS10420	17
RK1001.C0101_allcombined	2128037	2128064		YPO_RS10430	27
RK1001.C0101_allcombined	2129586	2129590		YPO_RS10435	4
RK1001.C0101_allcombined	2130005	2130028		YPO_RS10435	23
RK1001.C0101_allcombined	2130228	2130254		YPO_RS10435	26
RK1001.C0101_allcombined	2130487	2130498		YPO_RS10440	11
RK1001.C0101_allcombined	2130910	2130933		YPO_RS10440	23
RK1001.C0101_allcombined	2131008	2131012		YPO_RS10440	4
RK1001.C0101_allcombined	2131143	2131159		YPO_RS10440	16
RK1001.C0101_allcombined	2131265	2131276		YPO_RS10440	11
RK1001.C0101_allcombined	2131419	2131425		YPO_RS10440	6
RK1001.C0101_allcombined	2131508	2131516		YPO_RS10440	8
RK1001.C0101_allcombined	2131854	2131873		YPO_RS10445	19
RK1001.C0101_allcombined	2132178	2132182		YPO_RS10445	4
RK1001.C0101_allcombined	2132345	2132351		YPO_RS10445	6
RK1001.C0101_allcombined	2132746	2132752		YPO_RS10450	6
RK1001.C0101_allcombined	2133051	2133054		YPO_RS10450	3
RK1001.C0101_allcombined	2134072	2134134		YPO_RS10455	62
RK1001.C0101_allcombined	2134331	2134336		YPO_RS10455	5
RK1001.C0101_allcombined	2134470	2134506		YPO_RS10460	36
RK1001.C0101_allcombined	2134597	2134611		YPO_RS10460	14
RK1001.C0101_allcombined	2135091	2135095		YPO_RS10470	4
RK1001.C0101_allcombined	2137406	2137419		YPO_RS10485	13
RK1001.C0101_allcombined	2138182	2138189		YPO_RS10495	7
RK1001.C0101_allcombined	2138344	2138391		YPO_RS10495	47
RK1001.C0101_allcombined	2138466	2138526		YPO_RS10495	60
RK1001.C0101_allcombined	2139153	2139182		YPO_RS10505	29
RK1001.C0101_allcombined	2139268	2139272		YPO_RS10505	4
RK1001.C0101_allcombined	2139391	2139413		YPO_RS10505	22
RK1001.C0101_allcombined	2141141	2141147		fyuA	6
RK1001.C0101_allcombined	2141510	2141511		fyuA	1
RK1001.C0101_allcombined	2142272	2142300		fyuA	28
RK1001.C0101_allcombined	2142564	2142567		fyuA	3
RK1001.C0101_allcombined	2143718	2143728		ybtE	10
RK1001.C0101_allcombined	2144295	2144297		ybtE	2
RK1001.C0101_allcombined	2145539	2145549		ybtU	10
RK1001.C0101_allcombined	2146673	2146679		irp1	6
RK1001.C0101_allcombined	2146955	2146965		irp1	10
RK1001.C0101_allcombined	2147674	2147675		irp1	1
RK1001.C0101_allcombined	2148742	2148743		irp1	1
RK1001.C0101_allcombined	2151070	2151073		irp1	3
RK1001.C0101_allcombined	2151726	2151741		irp1	15
RK1001.C0101_allcombined	2152468	2152470		irp1	2
RK1001.C0101_allcombined	2152989	2152998		irp1	9
RK1001.C0101_allcombined	2155459	2155460		irp1	1
RK1001.C0101_allcombined	2156966	2156979		irp2	13
RK1001.C0101_allcombined	2157424	2157431		irp2	7
RK1001.C0101_allcombined	2159389	2159391		irp2	2
RK1001.C0101_allcombined	2159747	2159762		irp2	15
RK1001.C0101_allcombined	2159968	2159987		irp2	19
RK1001.C0101_allcombined	2160797	2160802		irp2	5
RK1001.C0101_allcombined	2161425	2161438		irp2	13
RK1001.C0101_allcombined	2161749	2161750		irp2	1
RK1001.C0101_allcombined	2162941	2162943		ybtA	2
RK1001.C0101_allcombined	2163700	2163703		ybtP	3
RK1001.C0101_allcombined	2164368	2164370		ybtP	2
RK1001.C0101_allcombined	2164951	2164956		ybtP	5
RK1001.C0101_allcombined	2165511	2165513		ybtQ	2
RK1001.C0101_allcombined	2166238	2166239		ybtQ	1
RK1001.C0101_allcombined	2166593	2166619		ybtQ	26
RK1001.C0101_allcombined	2167465	2167471		ybtX	6
RK1001.C0101_allcombined	2168823	2168824		ybtS	1
RK1001.C0101_allcombined	2169884	2169886		YPO_RS10570	2
RK1001.C0101_allcombined	2170142	2170150		YPO_RS10570	8
RK1001.C0101_allcombined	2170859	2170875		YPO_RS10570	16
RK1001.C0101_allcombined	2171013	2171015		YPO_RS10570	2
RK1001.C0101_allcombined	2171756	2171764		YPO_RS10580	8
RK1001.C0101_allcombined	2171908	2171956		YPO_RS10580	48
RK1001.C0101_allcombined	2173070	2173084		YPO_RS10585	14
RK1001.C0101_allcombined	2173268	2173275		YPO_RS10585	7
RK1001.C0101_allcombined	2173367	2173377		YPO_RS10585	10
RK1001.C0101_allcombined	2173770	2173774		YPO_RS10590	4
RK1001.C0101_allcombined	2173971	2173983		YPO_RS10590	12
RK1001.C0101_allcombined	2174253	2174254		YPO_RS10590	1
RK1001.C0101_allcombined	2174494	2174508		YPO_RS10590	14
RK1001.C0101_allcombined	2174751	2174779		YPO_RS10590	28
RK1001.C0101_allcombined	2174824	2174840		YPO_RS10590	16
RK1001.C0101_allcombined	2175098	2175140		YPO_RS10590	42
RK1001.C0101_allcombined	2175430	2175471		YPO_RS10590	41
RK1001.C0101_allcombined	2175794	2175838		YPO_RS10590	44
RK1001.C0101_allcombined	2176047	2176051		YPO_RS10590	4
RK1001.C0101_allcombined	2176270	2176277		YPO_RS10590	7
RK1001.C0101_allcombined	2176409	2176411		YPO_RS10595	2
RK1001.C0101_allcombined	2176448	2176451		YPO_RS10595	3
RK1001.C0101_allcombined	2176564	2176575		YPO_RS10595	11
RK1001.C0101_allcombined	2176616	2176677		YPO_RS10595	61
RK1001.C0101_allcombined	2176890	2176916		YPO_RS10595	26
RK1001.C0101_allcombined	2177146	2177152		YPO_RS10600	6
RK1001.C0101_allcombined	2177204	2177213		YPO_RS10600	9
RK1001.C0101_allcombined	2177320	2177348		YPO_RS10600	28
RK1001.C0101_allcombined	2177565	2177572		YPO_RS10600	7
RK1001.C0101_allcombined	2177661	2177674		YPO_RS10600	13
RK1001.C0101_allcombined	2178187	2178192		YPO_RS10605	5
RK1001.C0101_allcombined	2178367	2178371		YPO_RS10605	4
RK1001.C0101_allcombined	2178477	2178540		YPO_RS10605	63
RK1001.C0101_allcombined	2178914	2178923		YPO_RS10605	9
RK1001.C0101_allcombined	2179235	2179266		YPO_RS10605	31
RK1001.C0101_allcombined	2179352	2179365		YPO_RS10605	13
RK1001.C0101_allcombined	2179941	2179954		YPO_RS10605	13
RK1001.C0101_allcombined	2180004	2180039		YPO_RS10605	35
RK1001.C0101_allcombined	2180457	2180464		YPO_RS10605	7
RK1001.C0101_allcombined	2180934	2180991		YPO_RS10610	57
RK1001.C0101_allcombined	2181211	2181215		YPO_RS10610	4
RK1001.C0101_allcombined	2181459	2181460		YPO_RS10610	1
RK1001.C0101_allcombined	2181655	2181661		YPO_RS10610	6
RK1001.C0101_allcombined	2181693	2181701		YPO_RS10610	8
RK1001.C0101_allcombined	2182012	2182021		YPO_RS10615	9
RK1001.C0101_allcombined	2182259	2182291		YPO_RS10615	32
RK1001.C0101_allcombined	2183575	2183591		YPO_RS10620	16
RK1001.C0101_allcombined	2183719	2183751		YPO_RS10620	32
RK1001.C0101_allcombined	2183979	2183994		YPO_RS10620	15
RK1001.C0101_allcombined	2184029	2184117		YPO_RS10620	88
RK1001.C0101_allcombined	2184279	2184280		YPO_RS10620	1
RK1001.C0101_allcombined	2184434	2184491		YPO_RS10620	57
RK1001.C0101_allcombined	2185320	2185342		YPO_RS10625	22
RK1001.C0101_allcombined	2185407	2185424		YPO_RS10630	17
RK1001.C0101_allcombined	2185637	2185678		YPO_RS10630	41
RK1001.C0101_allcombined	2186030	2186032		YPO_RS10630	2
RK1001.C0101_allcombined	2186188	2186193		YPO_RS10630	5
RK1001.C0101_allcombined	2186344	2186354		YPO_RS10635	10
RK1001.C0101_allcombined	2186538	2186558		YPO_RS10635	20
RK1001.C0101_allcombined	2187663	2187770		YPO_RS10640	107
RK1001.C0101_allcombined	2187795	2187815		YPO_RS10645	20
RK1001.C0101_allcombined	2187981	2188074		YPO_RS10645	93
RK1001.C0101_allcombined	2188302	2188332		YPO_RS10645	30
RK1001.C0101_allcombined	2189261	2189275		YPO_RS10650	14
RK1001.C0101_allcombined	2189870	2189887		YPO_RS10655	17
RK1001.C0101_allcombined	2189919	2189921		YPO_RS10655	2
RK1001.C0101_allcombined	2190113	2190123		YPO_RS10655	10
RK1001.C0101_allcombined	2190298	2190308		YPO_RS10655	10
RK1001.C0101_allcombined	2190375	2190396		YPO_RS10655	21
RK1001.C0101_allcombined	2190547	2190552		YPO_RS10655	5
RK1001.C0101_allcombined	2190590	2190625		YPO_RS10655	35
RK1001.C0101_allcombined	2191369	2191372		YPO_RS10660	3
RK1001.C0101_allcombined	2191780	2191790		YPO_RS10660	10
RK1001.C0101_allcombined	2192128	2192137		nqrE	9
RK1001.C0101_allcombined	2192232	2192246		nqrE	14
RK1001.C0101_allcombined	2192477	2192485		nqrE	8
RK1001.C0101_allcombined	2192520	2192572		nqrE	52
RK1001.C0101_allcombined	2192659	2192717		nqrE	58
RK1001.C0101_allcombined	2193668	2193674		YPO_RS10670	6
RK1001.C0101_allcombined	2193816	2193819		YPO_RS10670	3
RK1001.C0101_allcombined	2193898	2193906		YPO_RS10670	8
RK1001.C0101_allcombined	2194112	2194114		YPO_RS10670	2
RK1001.C0101_allcombined	2194571	2194588		ansP	17
RK1001.C0101_allcombined	2194945	2194952		ansP	7
RK1001.C0101_allcombined	2195033	2195046		ansP	13
RK1001.C0101_allcombined	2195545	2195546		ansP	1
RK1001.C0101_allcombined	2195684	2195707		ansP	23
RK1001.C0101_allcombined	2195855	2195857		ansP	2
RK1001.C0101_allcombined	2196897	2196912		YPO_RS10680	15
RK1001.C0101_allcombined	2197363	2197365		YPO_RS10680	2
RK1001.C0101_allcombined	2198197	2198202		YPO_RS10685	5
RK1001.C0101_allcombined	2198769	2198788		glsA	19
RK1001.C0101_allcombined	2198998	2199031		glsA	33
RK1001.C0101_allcombined	2199813	2199840		YPO_RS10695	27
RK1001.C0101_allcombined	2201193	2201205		YPO_RS10695	12
RK1001.C0101_allcombined	2202031	2202075		YPO_RS10700	44
RK1001.C0101_allcombined	2202121	2202123		YPO_RS10700	2
RK1001.C0101_allcombined	2202396	2202440		YPO_RS10700	44
RK1001.C0101_allcombined	2202947	2202952		YPO_RS10700	5
RK1001.C0101_allcombined	2203671	2203677		YPO_RS10700	6
RK1001.C0101_allcombined	2204283	2204289		YPO_RS10705	6
RK1001.C0101_allcombined	2204399	2204425		YPO_RS10705	26
RK1001.C0101_allcombined	2205262	2205275		YPO_RS10710	13
RK1001.C0101_allcombined	2205493	2205520		YPO_RS10710	27
RK1001.C0101_allcombined	2205831	2205837		YPO_RS10710	6
RK1001.C0101_allcombined	2206050	2206074		YPO_RS10710	24
RK1001.C0101_allcombined	2206342	2206352		YPO_RS10710	10
RK1001.C0101_allcombined	2206721	2206728		YPO_RS10715	7
RK1001.C0101_allcombined	2206954	2206971		YPO_RS10715	17
RK1001.C0101_allcombined	2207450	2207458		YPO_RS10715	8
RK1001.C0101_allcombined	2207741	2207744		YPO_RS10720	3
RK1001.C0101_allcombined	2207879	2207888		YPO_RS10720	9
RK1001.C0101_allcombined	2208149	2208168		YPO_RS10720	19
RK1001.C0101_allcombined	2208449	2208470		YPO_RS10720	21
RK1001.C0101_allcombined	2208911	2208917		YPO_RS10725	6
RK1001.C0101_allcombined	2208962	2208966		YPO_RS10725	4
RK1001.C0101_allcombined	2209219	2209227		YPO_RS10725	8
RK1001.C0101_allcombined	2209469	2209513		YPO_RS10725	44
RK1001.C0101_allcombined	2209511	2209513		YPO_RS10730	2
RK1001.C0101_allcombined	2209601	2209603		YPO_RS10730	2
RK1001.C0101_allcombined	2209988	2209997		YPO_RS10730	9
RK1001.C0101_allcombined	2210263	2210266		YPO_RS10735	3
RK1001.C0101_allcombined	2210991	2211019		tehB	28
RK1001.C0101_allcombined	2211520	2211548		YPO_RS10745	28
RK1001.C0101_allcombined	2211696	2211699		YPO_RS10745	3
RK1001.C0101_allcombined	2211767	2211775		YPO_RS10745	8
RK1001.C0101_allcombined	2212291	2212302		YPO_RS10745	11
RK1001.C0101_allcombined	2212730	2212737		YPO_RS10745	7
RK1001.C0101_allcombined	2213406	2213416		pgaA	10
RK1001.C0101_allcombined	2213507	2213513		pgaA	6
RK1001.C0101_allcombined	2213670	2213675		pgaA	5
RK1001.C0101_allcombined	2213836	2213844		pgaA	8
RK1001.C0101_allcombined	2213939	2213945		pgaA	6
RK1001.C0101_allcombined	2214960	2214970		pgaA	10
RK1001.C0101_allcombined	2215009	2215012		pgaA	3
RK1001.C0101_allcombined	2215159	2215164		pgaA	5
RK1001.C0101_allcombined	2215466	2215471		pgaA	5
RK1001.C0101_allcombined	2215780	2215809		pgaA	29
RK1001.C0101_allcombined	2216279	2216283		pgaB	4
RK1001.C0101_allcombined	2216537	2216548		pgaB	11
RK1001.C0101_allcombined	2216807	2216817		pgaB	10
RK1001.C0101_allcombined	2216945	2216975		pgaB	30
RK1001.C0101_allcombined	2217207	2217222		pgaB	15
RK1001.C0101_allcombined	2217846	2217893		pgaB	47
RK1001.C0101_allcombined	2217925	2217930		YPO_RS10760	5
RK1001.C0101_allcombined	2217990	2217995		YPO_RS10760	5
RK1001.C0101_allcombined	2218035	2218049		YPO_RS10760	14
RK1001.C0101_allcombined	2218923	2218927		YPO_RS10760	4
RK1001.C0101_allcombined	2219101	2219131		YPO_RS10760	30
RK1001.C0101_allcombined	2220389	2220421		YPO_RS10770	32
RK1001.C0101_allcombined	2220629	2220656		YPO_RS10770	27
RK1001.C0101_allcombined	2220787	2220788		YPO_RS10770	1
RK1001.C0101_allcombined	2220821	2220826		YPO_RS10770	5
RK1001.C0101_allcombined	2220877	2220879		YPO_RS10770	2
RK1001.C0101_allcombined	2220923	2220928		YPO_RS10770	5
RK1001.C0101_allcombined	2221810	2221832		phoH	22
RK1001.C0101_allcombined	2223072	2223106		chaA	34
RK1001.C0101_allcombined	2223502	2223509		chaA	7
RK1001.C0101_allcombined	2223695	2223696		chaA	1
RK1001.C0101_allcombined	2224420	2224441		narX	21
RK1001.C0101_allcombined	2224558	2224564		narX	6
RK1001.C0101_allcombined	2224907	2224916		narX	9
RK1001.C0101_allcombined	2225022	2225035		narX	13
RK1001.C0101_allcombined	2225285	2225286		narX	1
RK1001.C0101_allcombined	2225537	2225541		narX	4
RK1001.C0101_allcombined	2225839	2225842		narX	3
RK1001.C0101_allcombined	2226674	2226684		YPO_RS10800	10
RK1001.C0101_allcombined	2226862	2226882		YPO_RS10800	20
RK1001.C0101_allcombined	2227417	2227448		YPO_RS10800	31
RK1001.C0101_allcombined	2228505	2228512		YPO_RS10805	7
RK1001.C0101_allcombined	2228944	2228954		YPO_RS10805	10
RK1001.C0101_allcombined	2229095	2229104		YPO_RS10805	9
RK1001.C0101_allcombined	2230046	2230082		astA	36
RK1001.C0101_allcombined	2230357	2230374		astA	17
RK1001.C0101_allcombined	2230828	2230831		astD	3
RK1001.C0101_allcombined	2231039	2231052		astD	13
RK1001.C0101_allcombined	2231428	2231435		astD	7
RK1001.C0101_allcombined	2231798	2231802		astD	4
RK1001.C0101_allcombined	2232259	2232274		astB	15
RK1001.C0101_allcombined	2232683	2232689		astB	6
RK1001.C0101_allcombined	2232812	2232823		astB	11
RK1001.C0101_allcombined	2233052	2233053		astB	1
RK1001.C0101_allcombined	2233472	2233519		astB	47
RK1001.C0101_allcombined	2233987	2233989		astE	2
RK1001.C0101_allcombined	2234090	2234105		astE	15
RK1001.C0101_allcombined	2234348	2234356		astE	8
RK1001.C0101_allcombined	2234539	2234553		astE	14
RK1001.C0101_allcombined	2236385	2236397		YPO_RS10835	12
RK1001.C0101_allcombined	2237356	2237397		YPO_RS10835	41
RK1001.C0101_allcombined	2237397	2237398		YPO_RS10840	1
RK1001.C0101_allcombined	2238726	2238734		hutG	8
RK1001.C0101_allcombined	2238895	2238899		hutG	4
RK1001.C0101_allcombined	2239302	2239318		hutG	16
RK1001.C0101_allcombined	2239457	2239473		hutG	16
RK1001.C0101_allcombined	2239513	2239524		hutG	11
RK1001.C0101_allcombined	2239886	2239934		YPO_RS10855	48
RK1001.C0101_allcombined	2240165	2240172		YPO_RS10855	7
RK1001.C0101_allcombined	2240560	2240568		YPO_RS10855	8
RK1001.C0101_allcombined	2240748	2240749		YPO_RS10855	1
RK1001.C0101_allcombined	2240973	2240981		hutC	8
RK1001.C0101_allcombined	2241478	2241485		hutC	7
RK1001.C0101_allcombined	2241515	2241527		hutC	12
RK1001.C0101_allcombined	2242265	2242268		YPO_RS10865	3
RK1001.C0101_allcombined	2242493	2242512		YPO_RS10865	19
RK1001.C0101_allcombined	2242553	2242559		YPO_RS10865	6
RK1001.C0101_allcombined	2243420	2243428		YPO_RS10870	8
RK1001.C0101_allcombined	2243526	2243544		YPO_RS10870	18
RK1001.C0101_allcombined	2243703	2243731		YPO_RS10870	28
RK1001.C0101_allcombined	2244455	2244481		YPO_RS10875	26
RK1001.C0101_allcombined	2244537	2244538		YPO_RS10875	1
RK1001.C0101_allcombined	2244906	2244951		YPO_RS10875	45
RK1001.C0101_allcombined	2245129	2245137		YPO_RS10875	8
RK1001.C0101_allcombined	2245328	2245336		YPO_RS10875	8
RK1001.C0101_allcombined	2245528	2245542		YPO_RS10875	14
RK1001.C0101_allcombined	2247623	2247641		YPO_RS10885	18
RK1001.C0101_allcombined	2247883	2247884		YPO_RS10885	1
RK1001.C0101_allcombined	2248109	2248120		YPO_RS10885	11
RK1001.C0101_allcombined	2248647	2248651		YPO_RS10890	4
RK1001.C0101_allcombined	2248913	2248915		YPO_RS10890	2
RK1001.C0101_allcombined	2249426	2249432		YPO_RS10890	6
RK1001.C0101_allcombined	2249612	2249614		YPO_RS10895	2
RK1001.C0101_allcombined	2250214	2250221		YPO_RS10895	7
RK1001.C0101_allcombined	2251084	2251095		YPO_RS10900	11
RK1001.C0101_allcombined	2251366	2251372		YPO_RS10900	6
RK1001.C0101_allcombined	2251679	2251687		YPO_RS10900	8
RK1001.C0101_allcombined	2251797	2251802		YPO_RS10900	5
RK1001.C0101_allcombined	2252050	2252052		YPO_RS10905	2
RK1001.C0101_allcombined	2252111	2252126		YPO_RS10905	15
RK1001.C0101_allcombined	2252397	2252428		YPO_RS10905	31
RK1001.C0101_allcombined	2252947	2252971		YPO_RS10905	24
RK1001.C0101_allcombined	2252968	2252984		YPO_RS10910	16
RK1001.C0101_allcombined	2253456	2253458		YPO_RS10910	2
RK1001.C0101_allcombined	2253674	2253682		YPO_RS10915	8
RK1001.C0101_allcombined	2254590	2254606		YPO_RS10915	16
RK1001.C0101_allcombined	2254666	2254673		YPO_RS10915	7
RK1001.C0101_allcombined	2254945	2254994		YPO_RS10920	49
RK1001.C0101_allcombined	2255609	2255620		YPO_RS10925	11
RK1001.C0101_allcombined	2255973	2255992		YPO_RS10925	19
RK1001.C0101_allcombined	2256094	2256159		YPO_RS10925	65
RK1001.C0101_allcombined	2256476	2256524		YPO_RS10925	48
RK1001.C0101_allcombined	2256624	2256628		YPO_RS10925	4
RK1001.C0101_allcombined	2256723	2256754		YPO_RS10925	31
RK1001.C0101_allcombined	2257097	2257110		YPO_RS10925	13
RK1001.C0101_allcombined	2257587	2257590		YPO_RS10930	3
RK1001.C0101_allcombined	2258475	2258500		YPO_RS10930	25
RK1001.C0101_allcombined	2259009	2259011		YPO_RS10935	2
RK1001.C0101_allcombined	2259144	2259258		YPO_RS10935	114
RK1001.C0101_allcombined	2259317	2259319		YPO_RS10935	2
RK1001.C0101_allcombined	2259397	2259424		YPO_RS10935	27
RK1001.C0101_allcombined	2259462	2259476		YPO_RS10935	14
RK1001.C0101_allcombined	2259522	2259546		YPO_RS10935	24
RK1001.C0101_allcombined	2259674	2259889		YPO_RS10935	215
RK1001.C0101_allcombined	2260018	2260139		YPO_RS10935	121
RK1001.C0101_allcombined	2260392	2260428		YPO_RS10935	36
RK1001.C0101_allcombined	2260507	2260508		YPO_RS10935	1
RK1001.C0101_allcombined	2260743	2260798		YPO_RS10935	55
RK1001.C0101_allcombined	2262282	2262290		YPO_RS10940	8
RK1001.C0101_allcombined	2262909	2262912		YPO_RS10940	3
RK1001.C0101_allcombined	2263160	2263168		YPO_RS10940	8
RK1001.C0101_allcombined	2263477	2263487		YPO_RS10940	10
RK1001.C0101_allcombined	2263824	2263830		YPO_RS10945	6
RK1001.C0101_allcombined	2263964	2263972		YPO_RS10945	8
RK1001.C0101_allcombined	2264245	2264293		YPO_RS10945	48
RK1001.C0101_allcombined	2264631	2264656		YPO_RS10950	25
RK1001.C0101_allcombined	2264934	2264951		YPO_RS10950	17
RK1001.C0101_allcombined	2265115	2265166		YPO_RS10950	51
RK1001.C0101_allcombined	2265271	2265280		YPO_RS10955	9
RK1001.C0101_allcombined	2265620	2265635		YPO_RS10955	15
RK1001.C0101_allcombined	2265682	2265718		YPO_RS10955	36
RK1001.C0101_allcombined	2265848	2265882		YPO_RS10955	34
RK1001.C0101_allcombined	2265943	2265951		YPO_RS10955	8
RK1001.C0101_allcombined	2266239	2266246		YPO_RS10960	7
RK1001.C0101_allcombined	2266292	2266338		YPO_RS10965	46
RK1001.C0101_allcombined	2266411	2266415		YPO_RS10965	4
RK1001.C0101_allcombined	2266596	2266599		YPO_RS10965	3
RK1001.C0101_allcombined	2266681	2266767		YPO_RS10965	86
RK1001.C0101_allcombined	2266904	2266930		YPO_RS10965	26
RK1001.C0101_allcombined	2266971	2267020		YPO_RS10965	49
RK1001.C0101_allcombined	2267308	2267328		YPO_RS10970	20
RK1001.C0101_allcombined	2267681	2267725		YPO_RS10970	44
RK1001.C0101_allcombined	2268167	2268181		YPO_RS10975	14
RK1001.C0101_allcombined	2268270	2268288		YPO_RS10975	18
RK1001.C0101_allcombined	2268432	2268443		YPO_RS10975	11
RK1001.C0101_allcombined	2268671	2268702		YPO_RS10975	31
RK1001.C0101_allcombined	2268774	2268846		YPO_RS10975	72
RK1001.C0101_allcombined	2268978	2268983		YPO_RS10975	5
RK1001.C0101_allcombined	2269024	2269046		YPO_RS10975	22
RK1001.C0101_allcombined	2269863	2269959		YPO_RS10980	96
RK1001.C0101_allcombined	2270111	2270120		YPO_RS10980	9
RK1001.C0101_allcombined	2270725	2270754		YPO_RS10980	29
RK1001.C0101_allcombined	2270922	2270933		YPO_RS10980	11
RK1001.C0101_allcombined	2271490	2271491		YPO_RS10985	1
RK1001.C0101_allcombined	2271677	2271705		YPO_RS10990	28
RK1001.C0101_allcombined	2271844	2271847		YPO_RS10990	3
RK1001.C0101_allcombined	2272380	2272383		YPO_RS10995	3
RK1001.C0101_allcombined	2272586	2272587		YPO_RS10995	1
RK1001.C0101_allcombined	2272644	2272661		YPO_RS10995	17
RK1001.C0101_allcombined	2272734	2272744		YPO_RS10995	10
RK1001.C0101_allcombined	2272797	2272814		YPO_RS10995	17
RK1001.C0101_allcombined	2272887	2272914		YPO_RS10995	27
RK1001.C0101_allcombined	2273448	2273453		YPO_RS10995	5
RK1001.C0101_allcombined	2273656	2273684		YPO_RS10995	28
RK1001.C0101_allcombined	2273822	2273825		YPO_RS11000	3
RK1001.C0101_allcombined	2274232	2274233		YPO_RS11000	1
RK1001.C0101_allcombined	2274730	2274753		YPO_RS11005	23
RK1001.C0101_allcombined	2274851	2274857		YPO_RS11005	6
RK1001.C0101_allcombined	2274963	2274970		YPO_RS11005	7
RK1001.C0101_allcombined	2275174	2275194		YPO_RS11005	20
RK1001.C0101_allcombined	2276009	2276018		YPO_RS11010	9
RK1001.C0101_allcombined	2276311	2276330		YPO_RS11010	19
RK1001.C0101_allcombined	2276506	2276509		YPO_RS11010	3
RK1001.C0101_allcombined	2276658	2276662		YPO_RS11010	4
RK1001.C0101_allcombined	2276815	2276830		YPO_RS11015	15
RK1001.C0101_allcombined	2277593	2277622		YPO_RS11020	29
RK1001.C0101_allcombined	2278129	2278162		YPO_RS11020	33
RK1001.C0101_allcombined	2278406	2278435		YPO_RS11020	29
RK1001.C0101_allcombined	2280597	2280608		YPO_RS11035	11
RK1001.C0101_allcombined	2280691	2280699		YPO_RS11035	8
RK1001.C0101_allcombined	2280745	2280808		YPO_RS11035	63
RK1001.C0101_allcombined	2282141	2282182		ychF	41
RK1001.C0101_allcombined	2282332	2282344		ychF	12
RK1001.C0101_allcombined	2282387	2282391		ychF	4
RK1001.C0101_allcombined	2282499	2282506		ychF	7
RK1001.C0101_allcombined	2283225	2283232		ychF	7
RK1001.C0101_allcombined	2283559	2283590		pth	31
RK1001.C0101_allcombined	2283894	2283905		pth	11
RK1001.C0101_allcombined	2285100	2285106		YPO_RS11060	6
RK1001.C0101_allcombined	2286445	2286459		ispE	14
RK1001.C0101_allcombined	2286520	2286522		ispE	2
RK1001.C0101_allcombined	2286808	2286816		ispE	8
RK1001.C0101_allcombined	2287007	2287009		ispE	2
RK1001.C0101_allcombined	2287011	2287012		lolB	1
RK1001.C0101_allcombined	2287099	2287114		lolB	15
RK1001.C0101_allcombined	2287170	2287200		lolB	30
RK1001.C0101_allcombined	2287340	2287400		lolB	60
RK1001.C0101_allcombined	2287554	2287563		lolB	9
RK1001.C0101_allcombined	2289933	2289958		prfA	25
RK1001.C0101_allcombined	2290887	2290932		prmC	45
RK1001.C0101_allcombined	2291008	2291032		prmC	24
RK1001.C0101_allcombined	2291211	2291215		YPO_RS11090	4
RK1001.C0101_allcombined	2291348	2291383		YPO_RS11090	35
RK1001.C0101_allcombined	2291552	2291612		YPO_RS11090	60
RK1001.C0101_allcombined	2291609	2291641		YPO_RS11095	32
RK1001.C0101_allcombined	2292076	2292084		YPO_RS11095	8
RK1001.C0101_allcombined	2292346	2292365		YPO_RS11095	19
RK1001.C0101_allcombined	2293049	2293050		kdsA	1
RK1001.C0101_allcombined	2293261	2293307		kdsA	46
RK1001.C0101_allcombined	2293358	2293362		kdsA	4
RK1001.C0101_allcombined	2294204	2294229		YPO_RS11105	25
RK1001.C0101_allcombined	2294432	2294439		YPO_RS11110	7
RK1001.C0101_allcombined	2294527	2294532		YPO_RS11110	5
RK1001.C0101_allcombined	2294841	2294854		YPO_RS11110	13
RK1001.C0101_allcombined	2296671	2296684		YPO_RS11120	13
RK1001.C0101_allcombined	2299206	2299207		YPO_RS11135	1
RK1001.C0101_allcombined	2299955	2300030		YPO_RS11135	75
RK1001.C0101_allcombined	2300859	2300879		YPO_RS11140	20
RK1001.C0101_allcombined	2301725	2301727		YPO_RS11145	2
RK1001.C0101_allcombined	2301913	2301914		YPO_RS11145	1
RK1001.C0101_allcombined	2301997	2302010		YPO_RS11145	13
RK1001.C0101_allcombined	2302111	2302131		YPO_RS11145	20
RK1001.C0101_allcombined	2303312	2303333		YPO_RS11155	21
RK1001.C0101_allcombined	2303513	2303529		YPO_RS11155	16
RK1001.C0101_allcombined	2303719	2303721		YPO_RS11155	2
RK1001.C0101_allcombined	2303850	2303853		YPO_RS11155	3
RK1001.C0101_allcombined	2303894	2303926		YPO_RS11155	32
RK1001.C0101_allcombined	2304471	2304472		YPO_RS11160	1
RK1001.C0101_allcombined	2305879	2305886		YPO_RS11170	7
RK1001.C0101_allcombined	2306092	2306095		YPO_RS11175	3
RK1001.C0101_allcombined	2306868	2306887		YPO_RS11175	19
RK1001.C0101_allcombined	2307063	2307077		YPO_RS11175	14
RK1001.C0101_allcombined	2307716	2307741		YPO_RS11185	25
RK1001.C0101_allcombined	2308101	2308111		YPO_RS11185	10
RK1001.C0101_allcombined	2308209	2308214		YPO_RS11185	5
RK1001.C0101_allcombined	2308530	2308575		YPO_RS11190	45
RK1001.C0101_allcombined	2309693	2309727		YPO_RS11195	34
RK1001.C0101_allcombined	2309926	2309944		YPO_RS11195	18
RK1001.C0101_allcombined	2309981	2310007		YPO_RS11195	26
RK1001.C0101_allcombined	2310528	2310542		mdtH	14
RK1001.C0101_allcombined	2310738	2310780		mdtH	42
RK1001.C0101_allcombined	2311964	2311994		rimJ	30
RK1001.C0101_allcombined	2312094	2312102		rimJ	8
RK1001.C0101_allcombined	2312531	2312535		rimJ	4
RK1001.C0101_allcombined	2312611	2312645		YPO_RS11210	34
RK1001.C0101_allcombined	2312731	2312749		YPO_RS11210	18
RK1001.C0101_allcombined	2313238	2313261		YPO_RS11210	23
RK1001.C0101_allcombined	2313312	2313327		YPO_RS11210	15
RK1001.C0101_allcombined	2313521	2313526		YPO_RS11210	5
RK1001.C0101_allcombined	2314758	2314788		murJ	30
RK1001.C0101_allcombined	2315254	2315277		murJ	23
RK1001.C0101_allcombined	2315331	2315342		murJ	11
RK1001.C0101_allcombined	2315528	2315597		murJ	69
RK1001.C0101_allcombined	2315811	2315820		murJ	9
RK1001.C0101_allcombined	2315875	2315900		murJ	25
RK1001.C0101_allcombined	2316441	2316539		YPO_RS11220	98
RK1001.C0101_allcombined	2316621	2316781		YPO_RS11220	160
RK1001.C0101_allcombined	2316894	2316917		YPO_RS11220	23
RK1001.C0101_allcombined	2317016	2317034		YPO_RS11220	18
RK1001.C0101_allcombined	2317093	2317135		YPO_RS11220	42
RK1001.C0101_allcombined	2317181	2317196		YPO_RS11220	15
RK1001.C0101_allcombined	2317257	2317306		YPO_RS11220	49
RK1001.C0101_allcombined	2317350	2317427		YPO_RS11220	77
RK1001.C0101_allcombined	2317466	2317527		YPO_RS11220	61
RK1001.C0101_allcombined	2317674	2317751		YPO_RS11220	77
RK1001.C0101_allcombined	2317816	2317825		YPO_RS11220	9
RK1001.C0101_allcombined	2317892	2317896		YPO_RS11220	4
RK1001.C0101_allcombined	2317970	2317997		YPO_RS11220	27
RK1001.C0101_allcombined	2318058	2318102		YPO_RS11220	44
RK1001.C0101_allcombined	2318153	2318162		YPO_RS11225	9
RK1001.C0101_allcombined	2318222	2318242		YPO_RS11225	20
RK1001.C0101_allcombined	2318353	2318383		YPO_RS11225	30
RK1001.C0101_allcombined	2318435	2318438		YPO_RS11225	3
RK1001.C0101_allcombined	2318739	2318771		YPO_RS11225	32
RK1001.C0101_allcombined	2318830	2318957		YPO_RS11225	127
RK1001.C0101_allcombined	2319086	2319113		YPO_RS11225	27
RK1001.C0101_allcombined	2319197	2319248		YPO_RS11225	51
RK1001.C0101_allcombined	2319280	2319289		YPO_RS11225	9
RK1001.C0101_allcombined	2319336	2319344		YPO_RS11225	8
RK1001.C0101_allcombined	2319416	2319556		YPO_RS11225	140
RK1001.C0101_allcombined	2319651	2319653		YPO_RS11225	2
RK1001.C0101_allcombined	2319713	2319721		YPO_RS11225	8
RK1001.C0101_allcombined	2319908	2320006		YPO_RS11225	98
RK1001.C0101_allcombined	2320048	2320109		YPO_RS11225	61
RK1001.C0101_allcombined	2320283	2320327		YPO_RS11225	44
RK1001.C0101_allcombined	2320417	2320440		YPO_RS11225	23
RK1001.C0101_allcombined	2320512	2320535		YPO_RS11225	23
RK1001.C0101_allcombined	2320593	2320607		YPO_RS11225	14
RK1001.C0101_allcombined	2320785	2320807		YPO_RS11225	22
RK1001.C0101_allcombined	2320860	2320867		YPO_RS11225	7
RK1001.C0101_allcombined	2321092	2321105		YPO_RS11225	13
RK1001.C0101_allcombined	2321162	2321169		YPO_RS11225	7
RK1001.C0101_allcombined	2321358	2321428		YPO_RS11225	70
RK1001.C0101_allcombined	2321966	2321996		YPO_RS11225	30
RK1001.C0101_allcombined	2322197	2322221		YPO_RS11225	24
RK1001.C0101_allcombined	2322294	2322340		YPO_RS11225	46
RK1001.C0101_allcombined	2322434	2322447		YPO_RS11225	13
RK1001.C0101_allcombined	2322691	2322709		YPO_RS11225	18
RK1001.C0101_allcombined	2322804	2322845		YPO_RS11225	41
RK1001.C0101_allcombined	2323115	2323135		argS	20
RK1001.C0101_allcombined	2323264	2323265		argS	1
RK1001.C0101_allcombined	2323866	2323872		argS	6
RK1001.C0101_allcombined	2324350	2324354		argS	4
RK1001.C0101_allcombined	2325730	2325759		YPO_RS11235	29
RK1001.C0101_allcombined	2325852	2325853		YPO_RS11235	1
RK1001.C0101_allcombined	2325921	2325923		YPO_RS11235	2
RK1001.C0101_allcombined	2326261	2326280		cutC	19
RK1001.C0101_allcombined	2326320	2326360		cutC	40
RK1001.C0101_allcombined	2326974	2326979		cutC	5
RK1001.C0101_allcombined	2327244	2327259		cmoB	15
RK1001.C0101_allcombined	2327460	2327470		cmoB	10
RK1001.C0101_allcombined	2327584	2327596		cmoB	12
RK1001.C0101_allcombined	2328472	2328473		cmoA	1
RK1001.C0101_allcombined	2329172	2329219		YPO_RS11255	47
RK1001.C0101_allcombined	2329406	2329452		YPO_RS11255	46
RK1001.C0101_allcombined	2332253	2332258		aspS	5
RK1001.C0101_allcombined	2332583	2332585		aspS	2
RK1001.C0101_allcombined	2332902	2332909		aspS	7
RK1001.C0101_allcombined	2333383	2333387		aspS	4
RK1001.C0101_allcombined	2333539	2333549		nudB	10
RK1001.C0101_allcombined	2334523	2334545		YPO_RS11275	22
RK1001.C0101_allcombined	2334601	2334637		YPO_RS11275	36
RK1001.C0101_allcombined	2335036	2335050		ruvC	14
RK1001.C0101_allcombined	2336085	2336107		ruvA	22
RK1001.C0101_allcombined	2336205	2336214		ruvA	9
RK1001.C0101_allcombined	2336510	2336523		ruvB	13
RK1001.C0101_allcombined	2337440	2337453		ruvB	13
RK1001.C0101_allcombined	2338029	2338042		znuB	13
RK1001.C0101_allcombined	2338502	2338555		znuC	53
RK1001.C0101_allcombined	2338884	2338903		znuC	19
RK1001.C0101_allcombined	2339041	2339048		znuC	7
RK1001.C0101_allcombined	2339276	2339278		znuA	2
RK1001.C0101_allcombined	2339461	2339466		znuA	5
RK1001.C0101_allcombined	2339719	2339747		znuA	28
RK1001.C0101_allcombined	2339817	2339853		znuA	36
RK1001.C0101_allcombined	2340373	2340431		mepM	58
RK1001.C0101_allcombined	2340605	2340615		mepM	10
RK1001.C0101_allcombined	2340895	2340934		mepM	39
RK1001.C0101_allcombined	2341174	2341187		mepM	13
RK1001.C0101_allcombined	2341310	2341323		mepM	13
RK1001.C0101_allcombined	2341397	2341417		mepM	20
RK1001.C0101_allcombined	2341757	2341775		lpxM	18
RK1001.C0101_allcombined	2342232	2342237		lpxM	5
RK1001.C0101_allcombined	2343132	2343136		pyk	4
RK1001.C0101_allcombined	2343306	2343314		pyk	8
RK1001.C0101_allcombined	2344185	2344196		pyk	11
RK1001.C0101_allcombined	2344244	2344249		pyk	5
RK1001.C0101_allcombined	2344816	2344821		YPO_RS11325	5
RK1001.C0101_allcombined	2345090	2345107		YPO_RS11325	17
RK1001.C0101_allcombined	2346185	2346187		zwf	2
RK1001.C0101_allcombined	2346504	2346509		zwf	5
RK1001.C0101_allcombined	2346748	2346764		zwf	16
RK1001.C0101_allcombined	2347203	2347211		zwf	8
RK1001.C0101_allcombined	2347432	2347437		zwf	5
RK1001.C0101_allcombined	2347757	2347766		YPO_RS11335	9
RK1001.C0101_allcombined	2348065	2348074		YPO_RS11335	9
RK1001.C0101_allcombined	2348215	2348220		YPO_RS11335	5
RK1001.C0101_allcombined	2349111	2349123		mdtJ	12
RK1001.C0101_allcombined	2349430	2349434		mdtJ	4
RK1001.C0101_allcombined	2349765	2349773		mdtI	8
RK1001.C0101_allcombined	2349821	2349825		mdtI	4
RK1001.C0101_allcombined	2351020	2351023		YPO_RS11355	3
RK1001.C0101_allcombined	2351345	2351377		YPO_RS11355	32
RK1001.C0101_allcombined	2351472	2351507		YPO_RS11355	35
RK1001.C0101_allcombined	2351599	2351619		YPO_RS11355	20
RK1001.C0101_allcombined	2352638	2352639		tsaB	1
RK1001.C0101_allcombined	2353291	2353293		YPO_RS11365	2
RK1001.C0101_allcombined	2355004	2355023		fadD	19
RK1001.C0101_allcombined	2355295	2355303		fadD	8
RK1001.C0101_allcombined	2355363	2355432		fadD	69
RK1001.C0101_allcombined	2355595	2355623		fadD	28
RK1001.C0101_allcombined	2356461	2356491		rnd	30
RK1001.C0101_allcombined	2358013	2358020		minD	7
RK1001.C0101_allcombined	2358480	2358485		minD	5
RK1001.C0101_allcombined	2358567	2358585		minD	18
RK1001.C0101_allcombined	2358750	2358757		minD	7
RK1001.C0101_allcombined	2358819	2358821		minC	2
RK1001.C0101_allcombined	2359273	2359282		minC	9
RK1001.C0101_allcombined	2360231	2360262		YPO_RS11400	31
RK1001.C0101_allcombined	2360486	2360487		YPO_RS11400	1
RK1001.C0101_allcombined	2360651	2360652		YPO_RS11405	1
RK1001.C0101_allcombined	2360709	2360777		YPO_RS11405	68
RK1001.C0101_allcombined	2360920	2360969		YPO_RS11405	49
RK1001.C0101_allcombined	2361172	2361202		YPO_RS11405	30
RK1001.C0101_allcombined	2361233	2361252		YPO_RS11405	19
RK1001.C0101_allcombined	2361339	2361388		YPO_RS11405	49
RK1001.C0101_allcombined	2361667	2361682		YPO_RS11405	15
RK1001.C0101_allcombined	2361784	2361792		YPO_RS11410	8
RK1001.C0101_allcombined	2361888	2361939		YPO_RS11410	51
RK1001.C0101_allcombined	2362275	2362307		YPO_RS11410	32
RK1001.C0101_allcombined	2362731	2362740		YPO_RS11415	9
RK1001.C0101_allcombined	2362852	2362864		YPO_RS11415	12
RK1001.C0101_allcombined	2363079	2363132		YPO_RS11420	53
RK1001.C0101_allcombined	2363233	2363236		YPO_RS11420	3
RK1001.C0101_allcombined	2363502	2363541		YPO_RS11420	39
RK1001.C0101_allcombined	2363729	2363755		YPO_RS11420	26
RK1001.C0101_allcombined	2363873	2363881		YPO_RS11420	8
RK1001.C0101_allcombined	2364222	2364226		YPO_RS11420	4
RK1001.C0101_allcombined	2364336	2364385		YPO_RS11425	49
RK1001.C0101_allcombined	2366548	2366553		YPO_RS11435	5
RK1001.C0101_allcombined	2367179	2367182		YPO_RS11440	3
RK1001.C0101_allcombined	2367435	2367463		YPO_RS11440	28
RK1001.C0101_allcombined	2367597	2367598		YPO_RS11440	1
RK1001.C0101_allcombined	2367597	2367598		YPO_RS11445	1
RK1001.C0101_allcombined	2367908	2367913		YPO_RS11445	5
RK1001.C0101_allcombined	2368199	2368201		YPO_RS11450	2
RK1001.C0101_allcombined	2368419	2368430		YPO_RS11450	11
RK1001.C0101_allcombined	2368520	2368537		YPO_RS11450	17
RK1001.C0101_allcombined	2368719	2368720		YPO_RS11455	1
RK1001.C0101_allcombined	2368754	2368765		YPO_RS11455	11
RK1001.C0101_allcombined	2369139	2369146		YPO_RS11460	7
RK1001.C0101_allcombined	2370490	2370500		YPO_RS11470	10
RK1001.C0101_allcombined	2370566	2370589		YPO_RS11475	23
RK1001.C0101_allcombined	2370681	2370682		YPO_RS11475	1
RK1001.C0101_allcombined	2370714	2370749		YPO_RS11475	35
RK1001.C0101_allcombined	2370795	2370815		YPO_RS11475	20
RK1001.C0101_allcombined	2372116	2372120		YPO_RS11490	4
RK1001.C0101_allcombined	2372807	2372821		YPO_RS11495	14
RK1001.C0101_allcombined	2372875	2372879		YPO_RS11495	4
RK1001.C0101_allcombined	2373325	2373337		YPO_RS11495	12
RK1001.C0101_allcombined	2374223	2374241		YPO_RS11500	18
RK1001.C0101_allcombined	2374712	2374751		YPO_RS11505	39
RK1001.C0101_allcombined	2375158	2375161		YPO_RS11510	3
RK1001.C0101_allcombined	2375410	2375435		YPO_RS11510	25
RK1001.C0101_allcombined	2375649	2375677		YPO_RS11510	28
RK1001.C0101_allcombined	2376276	2376278		YPO_RS11515	2
RK1001.C0101_allcombined	2376926	2376936		YPO_RS11515	10
RK1001.C0101_allcombined	2376941	2376970		YPO_RS11520	29
RK1001.C0101_allcombined	2377040	2377055		YPO_RS11520	15
RK1001.C0101_allcombined	2377093	2377108		YPO_RS11520	15
RK1001.C0101_allcombined	2377497	2377503		YPO_RS11520	6
RK1001.C0101_allcombined	2377928	2377942		YPO_RS11525	14
RK1001.C0101_allcombined	2378310	2378312		YPO_RS11525	2
RK1001.C0101_allcombined	2381325	2381336		YPO_RS11545	11
RK1001.C0101_allcombined	2381800	2381804		YPO_RS11545	4
RK1001.C0101_allcombined	2381959	2381960		YPO_RS11545	1
RK1001.C0101_allcombined	2382052	2382054		YPO_RS11545	2
RK1001.C0101_allcombined	2382790	2382806		YPO_RS11550	16
RK1001.C0101_allcombined	2383071	2383072		YPO_RS11555	1
RK1001.C0101_allcombined	2383217	2383233		YPO_RS11555	16
RK1001.C0101_allcombined	2383295	2383311		YPO_RS11555	16
RK1001.C0101_allcombined	2383493	2383502		YPO_RS11560	9
RK1001.C0101_allcombined	2383714	2383752		YPO_RS11565	38
RK1001.C0101_allcombined	2384224	2384244		YPO_RS11565	20
RK1001.C0101_allcombined	2384355	2384357		YPO_RS11570	2
RK1001.C0101_allcombined	2384739	2384757		YPO_RS11575	18
RK1001.C0101_allcombined	2384972	2385000		YPO_RS11575	28
RK1001.C0101_allcombined	2386376	2386379		YPO_RS11590	3
RK1001.C0101_allcombined	2387269	2387287		YPO_RS11590	18
RK1001.C0101_allcombined	2388230	2388241		YPO_RS11590	11
RK1001.C0101_allcombined	2388351	2388367		YPO_RS11590	16
RK1001.C0101_allcombined	2388549	2388568		YPO_RS11590	19
RK1001.C0101_allcombined	2388626	2388632		YPO_RS11590	6
RK1001.C0101_allcombined	2388699	2388726		YPO_RS11590	27
RK1001.C0101_allcombined	2388829	2388830		YPO_RS11590	1
RK1001.C0101_allcombined	2389285	2389288		YPO_RS11590	3
RK1001.C0101_allcombined	2389350	2389354		YPO_RS11590	4
RK1001.C0101_allcombined	2390513	2390519		YPO_RS11600	6
RK1001.C0101_allcombined	2390870	2390876		YPO_RS11600	6
RK1001.C0101_allcombined	2391003	2391005		YPO_RS11605	2
RK1001.C0101_allcombined	2391516	2391550		YPO_RS11605	34
RK1001.C0101_allcombined	2392152	2392158		YPO_RS11610	6
RK1001.C0101_allcombined	2392428	2392449		YPO_RS11610	21
RK1001.C0101_allcombined	2393465	2393468		YPO_RS11620	3
RK1001.C0101_allcombined	2393539	2393544		YPO_RS11620	5
RK1001.C0101_allcombined	2393586	2393620		YPO_RS11620	34
RK1001.C0101_allcombined	2393659	2393694		YPO_RS11620	35
RK1001.C0101_allcombined	2393870	2393871		YPO_RS11620	1
RK1001.C0101_allcombined	2394104	2394137		YPO_RS11625	33
RK1001.C0101_allcombined	2394752	2394760		YPO_RS11630	8
RK1001.C0101_allcombined	2395035	2395046		YPO_RS11630	11
RK1001.C0101_allcombined	2395211	2395229		YPO_RS11630	18
RK1001.C0101_allcombined	2395410	2395412		YPO_RS11635	2
RK1001.C0101_allcombined	2395516	2395534		YPO_RS11635	18
RK1001.C0101_allcombined	2395624	2395631		YPO_RS11635	7
RK1001.C0101_allcombined	2395681	2395711		YPO_RS11635	30
RK1001.C0101_allcombined	2395772	2395819		YPO_RS11635	47
RK1001.C0101_allcombined	2395876	2395886		YPO_RS11635	10
RK1001.C0101_allcombined	2396132	2396185		YPO_RS11640	53
RK1001.C0101_allcombined	2396394	2396402		YPO_RS11645	8
RK1001.C0101_allcombined	2396921	2396927		YPO_RS11645	6
RK1001.C0101_allcombined	2397028	2397037		YPO_RS11650	9
RK1001.C0101_allcombined	2397207	2397214		YPO_RS11655	7
RK1001.C0101_allcombined	2397315	2397323		YPO_RS11655	8
RK1001.C0101_allcombined	2397667	2397695		YPO_RS11660	28
RK1001.C0101_allcombined	2397815	2397826		YPO_RS11660	11
RK1001.C0101_allcombined	2398218	2398294		YPO_RS11660	76
RK1001.C0101_allcombined	2398325	2398331		YPO_RS11660	6
RK1001.C0101_allcombined	2398406	2398408		YPO_RS11660	2
RK1001.C0101_allcombined	2398489	2398502		YPO_RS11660	13
RK1001.C0101_allcombined	2398893	2398913		YPO_RS11660	20
RK1001.C0101_allcombined	2399203	2399219		YPO_RS11660	16
RK1001.C0101_allcombined	2399306	2399315		YPO_RS11660	9
RK1001.C0101_allcombined	2399698	2399713		YPO_RS11660	15
RK1001.C0101_allcombined	2399867	2399869		YPO_RS11660	2
RK1001.C0101_allcombined	2400334	2400360		YPO_RS11660	26
RK1001.C0101_allcombined	2400488	2400558		YPO_RS11660	70
RK1001.C0101_allcombined	2400616	2400621		YPO_RS11660	5
RK1001.C0101_allcombined	2400723	2400732		YPO_RS11665	9
RK1001.C0101_allcombined	2400795	2400850		YPO_RS11665	55
RK1001.C0101_allcombined	2401044	2401071		YPO_RS11665	27
RK1001.C0101_allcombined	2401205	2401215		YPO_RS11665	10
RK1001.C0101_allcombined	2401615	2401619		YPO_RS11665	4
RK1001.C0101_allcombined	2401873	2401884		YPO_RS11670	11
RK1001.C0101_allcombined	2401957	2401960		YPO_RS11670	3
RK1001.C0101_allcombined	2402261	2402272		YPO_RS11670	11
RK1001.C0101_allcombined	2402362	2402397		YPO_RS11670	35
RK1001.C0101_allcombined	2402428	2402470		YPO_RS11670	42
RK1001.C0101_allcombined	2402802	2402803		YPO_RS11675	1
RK1001.C0101_allcombined	2402981	2403013		YPO_RS11675	32
RK1001.C0101_allcombined	2405309	2405385		YPO_RS11685	76
RK1001.C0101_allcombined	2405444	2405457		YPO_RS11685	13
RK1001.C0101_allcombined	2405492	2405515		YPO_RS11685	23
RK1001.C0101_allcombined	2406165	2406177		YPO_RS11690	12
RK1001.C0101_allcombined	2406533	2406547		YPO_RS11690	14
RK1001.C0101_allcombined	2406764	2406817		YPO_RS11690	53
RK1001.C0101_allcombined	2407432	2407439		YPO_RS11695	7
RK1001.C0101_allcombined	2407867	2407878		YPO_RS11695	11
RK1001.C0101_allcombined	2409022	2409037		YPO_RS11700	15
RK1001.C0101_allcombined	2409138	2409140		YPO_RS11700	2
RK1001.C0101_allcombined	2410194	2410242		dsbB	48
RK1001.C0101_allcombined	2410324	2410325		dsbB	1
RK1001.C0101_allcombined	2410698	2410713		nhaB	15
RK1001.C0101_allcombined	2411633	2411634		nhaB	1
RK1001.C0101_allcombined	2411777	2411786		nhaB	9
RK1001.C0101_allcombined	2412034	2412068		nhaB	34
RK1001.C0101_allcombined	2412132	2412135		nhaB	3
RK1001.C0101_allcombined	2412882	2412913		fadR	31
RK1001.C0101_allcombined	2412970	2412979		fadR	9
RK1001.C0101_allcombined	2413733	2413739		YPO_RS11720	6
RK1001.C0101_allcombined	2413866	2413876		YPO_RS11720	10
RK1001.C0101_allcombined	2414002	2414004		YPO_RS11720	2
RK1001.C0101_allcombined	2414604	2414644		YPO_RS11720	40
RK1001.C0101_allcombined	2414741	2414752		YPO_RS11720	11
RK1001.C0101_allcombined	2415458	2415477		YPO_RS11725	19
RK1001.C0101_allcombined	2416019	2416035		YPO_RS11725	16
RK1001.C0101_allcombined	2416139	2416151		YPO_RS11725	12
RK1001.C0101_allcombined	2416245	2416252		YPO_RS11725	7
RK1001.C0101_allcombined	2416449	2416459		YPO_RS11725	10
RK1001.C0101_allcombined	2416708	2416714		YPO_RS11730	6
RK1001.C0101_allcombined	2417531	2417534		YPO_RS11730	3
RK1001.C0101_allcombined	2417752	2417757		YPO_RS11730	5
RK1001.C0101_allcombined	2417812	2417820		YPO_RS11730	8
RK1001.C0101_allcombined	2418402	2418404		YPO_RS11735	2
RK1001.C0101_allcombined	2418575	2418596		YPO_RS11735	21
RK1001.C0101_allcombined	2418875	2418881		YPO_RS11735	6
RK1001.C0101_allcombined	2419441	2419451		YPO_RS11740	10
RK1001.C0101_allcombined	2419817	2419828		YPO_RS11740	11
RK1001.C0101_allcombined	2420110	2420117		YPO_RS11745	7
RK1001.C0101_allcombined	2420981	2420984		YPO_RS11745	3
RK1001.C0101_allcombined	2422187	2422195		YPO_RS11750	8
RK1001.C0101_allcombined	2422252	2422285		YPO_RS11750	33
RK1001.C0101_allcombined	2422349	2422353		YPO_RS11750	4
RK1001.C0101_allcombined	2422784	2422827		yeaG	43
RK1001.C0101_allcombined	2422892	2422894		yeaG	2
RK1001.C0101_allcombined	2423389	2423390		yeaG	1
RK1001.C0101_allcombined	2423649	2423663		yeaG	14
RK1001.C0101_allcombined	2423890	2423896		yeaG	6
RK1001.C0101_allcombined	2424436	2424441		yeaG	5
RK1001.C0101_allcombined	2425333	2425335		YPO_RS11760	2
RK1001.C0101_allcombined	2425375	2425412		YPO_RS11760	37
RK1001.C0101_allcombined	2425646	2425701		YPO_RS11760	55
RK1001.C0101_allcombined	2425846	2425859		YPO_RS11760	13
RK1001.C0101_allcombined	2425960	2425976		YPO_RS11765	16
RK1001.C0101_allcombined	2426478	2426484		YPO_RS11765	6
RK1001.C0101_allcombined	2426588	2426645		YPO_RS11765	57
RK1001.C0101_allcombined	2427152	2427197		gapA	45
RK1001.C0101_allcombined	2427614	2427621		gapA	7
RK1001.C0101_allcombined	2427761	2427765		gapA	4
RK1001.C0101_allcombined	2428732	2428750		msrB	18
RK1001.C0101_allcombined	2429190	2429197		YPO_RS11780	7
RK1001.C0101_allcombined	2429497	2429575		pncA	78
RK1001.C0101_allcombined	2430044	2430059		ansA	15
RK1001.C0101_allcombined	2430566	2430574		ansA	8
RK1001.C0101_allcombined	2430761	2430773		ansA	12
RK1001.C0101_allcombined	2430863	2430873		ansA	10
RK1001.C0101_allcombined	2431055	2431060		ansA	5
RK1001.C0101_allcombined	2431651	2431672		sppA	21
RK1001.C0101_allcombined	2431772	2431776		sppA	4
RK1001.C0101_allcombined	2432494	2432502		sppA	8
RK1001.C0101_allcombined	2432805	2432840		sppA	35
RK1001.C0101_allcombined	2432951	2432959		sppA	8
RK1001.C0101_allcombined	2434029	2434037		selD	8
RK1001.C0101_allcombined	2434244	2434268		selD	24
RK1001.C0101_allcombined	2434460	2434465		selD	5
RK1001.C0101_allcombined	2434754	2434831		selD	77
RK1001.C0101_allcombined	2435404	2435417		YPO_RS11810	13
RK1001.C0101_allcombined	2435713	2435750		YPO_RS11810	37
RK1001.C0101_allcombined	2435803	2435805		YPO_RS11810	2
RK1001.C0101_allcombined	2436709	2436712		YPO_RS11810	3
RK1001.C0101_allcombined	2436922	2436947		YPO_RS11810	25
RK1001.C0101_allcombined	2436992	2436999		YPO_RS11810	7
RK1001.C0101_allcombined	2436996	2437013		YPO_RS11815	17
RK1001.C0101_allcombined	2437284	2437286		YPO_RS11815	2
RK1001.C0101_allcombined	2437478	2437480		YPO_RS11820	2
RK1001.C0101_allcombined	2439405	2439407		YPO_RS11830	2
RK1001.C0101_allcombined	2439484	2439489		YPO_RS11830	5
RK1001.C0101_allcombined	2439575	2439608		YPO_RS11830	33
RK1001.C0101_allcombined	2439670	2439713		YPO_RS11830	43
RK1001.C0101_allcombined	2439797	2439827		YPO_RS11830	30
RK1001.C0101_allcombined	2439884	2439976		YPO_RS11830	92
RK1001.C0101_allcombined	2440023	2440033		YPO_RS11830	10
RK1001.C0101_allcombined	2440184	2440259		YPO_RS11830	75
RK1001.C0101_allcombined	2440595	2440599		YPO_RS11840	4
RK1001.C0101_allcombined	2441415	2441422		YPO_RS11850	7
RK1001.C0101_allcombined	2441824	2441828		YPO_RS11850	4
RK1001.C0101_allcombined	2442332	2442339		YPO_RS11850	7
RK1001.C0101_allcombined	2442332	2442344		purU	12
RK1001.C0101_allcombined	2442379	2442381		purU	2
RK1001.C0101_allcombined	2443072	2443089		purU	17
RK1001.C0101_allcombined	2443153	2443167		purU	14
RK1001.C0101_allcombined	2443315	2443354		YPO_RS11860	39
RK1001.C0101_allcombined	2443561	2443577		YPO_RS11860	16
RK1001.C0101_allcombined	2445202	2445209		rssB	7
RK1001.C0101_allcombined	2445240	2445286		rssB	46
RK1001.C0101_allcombined	2445349	2445365		rssB	16
RK1001.C0101_allcombined	2445692	2445728		rssB	36
RK1001.C0101_allcombined	2446398	2446406		YPO_RS11870	8
RK1001.C0101_allcombined	2446456	2446458		YPO_RS11870	2
RK1001.C0101_allcombined	2446541	2446551		YPO_RS11870	10
RK1001.C0101_allcombined	2446627	2446639		YPO_RS11870	12
RK1001.C0101_allcombined	2446709	2446711		YPO_RS11870	2
RK1001.C0101_allcombined	2446792	2446802		YPO_RS11870	10
RK1001.C0101_allcombined	2446900	2446901		YPO_RS11870	1
RK1001.C0101_allcombined	2447056	2447071		YPO_RS11870	15
RK1001.C0101_allcombined	2447471	2447513		YPO_RS11870	42
RK1001.C0101_allcombined	2447614	2447623		YPO_RS11870	9
RK1001.C0101_allcombined	2448196	2448209		hns	13
RK1001.C0101_allcombined	2448277	2448282		hns	5
RK1001.C0101_allcombined	2449530	2449538		YPO_RS11880	8
RK1001.C0101_allcombined	2452717	2452721		adhE	4
RK1001.C0101_allcombined	2453327	2453334		adhE	7
RK1001.C0101_allcombined	2453460	2453490		adhE	30
RK1001.C0101_allcombined	2453773	2453788		adhE	15
RK1001.C0101_allcombined	2454253	2454260		adhE	7
RK1001.C0101_allcombined	2454562	2454576		adhE	14
RK1001.C0101_allcombined	2454882	2454970		adhE	88
RK1001.C0101_allcombined	2455004	2455048		adhE	44
RK1001.C0101_allcombined	2456133	2456140		YPO_RS11900	7
RK1001.C0101_allcombined	2456445	2456457		YPO_RS11900	12
RK1001.C0101_allcombined	2456556	2456559		YPO_RS11900	3
RK1001.C0101_allcombined	2456621	2456646		YPO_RS11900	25
RK1001.C0101_allcombined	2457569	2457579		oppA	10
RK1001.C0101_allcombined	2457694	2457704		oppA	10
RK1001.C0101_allcombined	2457867	2457892		oppA	25
RK1001.C0101_allcombined	2457923	2457926		oppA	3
RK1001.C0101_allcombined	2458185	2458251		oppA	66
RK1001.C0101_allcombined	2458305	2458349		oppA	44
RK1001.C0101_allcombined	2458381	2458502		oppA	121
RK1001.C0101_allcombined	2458738	2458754		oppA	16
RK1001.C0101_allcombined	2458848	2458855		oppA	7
RK1001.C0101_allcombined	2458926	2458960		oppA	34
RK1001.C0101_allcombined	2459433	2459459		oppB	26
RK1001.C0101_allcombined	2459679	2459682		oppB	3
RK1001.C0101_allcombined	2459861	2459867		oppB	6
RK1001.C0101_allcombined	2459939	2459947		oppB	8
RK1001.C0101_allcombined	2460356	2460359		oppC	3
RK1001.C0101_allcombined	2460661	2460689		oppC	28
RK1001.C0101_allcombined	2461180	2461185		YPO_RS11920	5
RK1001.C0101_allcombined	2461503	2461564		YPO_RS11920	61
RK1001.C0101_allcombined	2462114	2462127		YPO_RS11920	13
RK1001.C0101_allcombined	2462194	2462225		YPO_RS11925	31
RK1001.C0101_allcombined	2462301	2462318		YPO_RS11925	17
RK1001.C0101_allcombined	2462600	2462611		YPO_RS11925	11
RK1001.C0101_allcombined	2462804	2462833		YPO_RS11925	29
RK1001.C0101_allcombined	2462880	2462918		YPO_RS11925	38
RK1001.C0101_allcombined	2463709	2463711		YPO_RS11930	2
RK1001.C0101_allcombined	2463771	2463791		YPO_RS11930	20
RK1001.C0101_allcombined	2463864	2463900		YPO_RS11930	36
RK1001.C0101_allcombined	2464223	2464234		YPO_RS11935	11
RK1001.C0101_allcombined	2464711	2464717		cls	6
RK1001.C0101_allcombined	2465100	2465123		cls	23
RK1001.C0101_allcombined	2465199	2465207		cls	8
RK1001.C0101_allcombined	2465311	2465327		cls	16
RK1001.C0101_allcombined	2465453	2465464		cls	11
RK1001.C0101_allcombined	2465556	2465558		cls	2
RK1001.C0101_allcombined	2467259	2467262		YPO_RS11950	3
RK1001.C0101_allcombined	2467326	2467332		YPO_RS11950	6
RK1001.C0101_allcombined	2467371	2467378		YPO_RS11950	7
RK1001.C0101_allcombined	2467441	2467460		YPO_RS11950	19
RK1001.C0101_allcombined	2467674	2467750		YPO_RS11950	76
RK1001.C0101_allcombined	2467971	2467983		YPO_RS11955	12
RK1001.C0101_allcombined	2468127	2468163		YPO_RS11955	36
RK1001.C0101_allcombined	2468360	2468391		YPO_RS11960	31
RK1001.C0101_allcombined	2468818	2468876		YPO_RS11965	58
RK1001.C0101_allcombined	2469112	2469114		YPO_RS11965	2
RK1001.C0101_allcombined	2469466	2469483		tonB	17
RK1001.C0101_allcombined	2469750	2469757		tonB	7
RK1001.C0101_allcombined	2470045	2470069		tonB	24
RK1001.C0101_allcombined	2470866	2470868		YPO_RS11975	2
RK1001.C0101_allcombined	2471725	2471748		yciA	23
RK1001.C0101_allcombined	2471962	2471971		yciA	9
RK1001.C0101_allcombined	2472230	2472247		YPO_RS11985	17
RK1001.C0101_allcombined	2472300	2472329		YPO_RS11985	29
RK1001.C0101_allcombined	2472580	2472603		YPO_RS11985	23
RK1001.C0101_allcombined	2472938	2472961		YPO_RS11990	23
RK1001.C0101_allcombined	2473190	2473193		YPO_RS11990	3
RK1001.C0101_allcombined	2473283	2473307		YPO_RS11990	24
RK1001.C0101_allcombined	2473457	2473459		YPO_RS11990	2
RK1001.C0101_allcombined	2473570	2473592		YPO_RS11990	22
RK1001.C0101_allcombined	2473633	2473649		YPO_RS11990	16
RK1001.C0101_allcombined	2473719	2473730		YPO_RS11990	11
RK1001.C0101_allcombined	2474175	2474214		YPO_RS11995	39
RK1001.C0101_allcombined	2474723	2474764		YPO_RS12000	41
RK1001.C0101_allcombined	2475091	2475107		YPO_RS12000	16
RK1001.C0101_allcombined	2475460	2475492		YPO_RS12000	32
RK1001.C0101_allcombined	2475854	2475869		YPO_RS12005	15
RK1001.C0101_allcombined	2476063	2476069		ompW	6
RK1001.C0101_allcombined	2476336	2476359		ompW	23
RK1001.C0101_allcombined	2476416	2476418		ompW	2
RK1001.C0101_allcombined	2476606	2476613		ompW	7
RK1001.C0101_allcombined	2476760	2476788		YPO_RS12015	28
RK1001.C0101_allcombined	2477417	2477419		trpA	2
RK1001.C0101_allcombined	2477635	2477658		trpA	23
RK1001.C0101_allcombined	2477700	2477701		trpA	1
RK1001.C0101_allcombined	2477989	2477997		trpA	8
RK1001.C0101_allcombined	2478324	2478329		trpB	5
RK1001.C0101_allcombined	2478374	2478393		trpB	19
RK1001.C0101_allcombined	2478597	2478628		trpB	31
RK1001.C0101_allcombined	2479193	2479213		trpB	20
RK1001.C0101_allcombined	2479249	2479257		trpB	8
RK1001.C0101_allcombined	2479367	2479370		trpB	3
RK1001.C0101_allcombined	2479911	2479912		trpCF	1
RK1001.C0101_allcombined	2479969	2479970		trpCF	1
RK1001.C0101_allcombined	2480353	2480359		trpCF	6
RK1001.C0101_allcombined	2480689	2480703		trpCF	14
RK1001.C0101_allcombined	2480785	2480786		trpCF	1
RK1001.C0101_allcombined	2480934	2480940		trpCF	6
RK1001.C0101_allcombined	2481369	2481406		trpD	37
RK1001.C0101_allcombined	2483231	2483241		YPO_RS12045	10
RK1001.C0101_allcombined	2483743	2483760		YPO_RS12045	17
RK1001.C0101_allcombined	2483969	2483978		YPO_RS12045	9
RK1001.C0101_allcombined	2484125	2484146		YPO_RS12045	21
RK1001.C0101_allcombined	2484288	2484307		trpL	19
RK1001.C0101_allcombined	2484697	2484701		YPO_RS12055	4
RK1001.C0101_allcombined	2484903	2484913		YPO_RS12055	10
RK1001.C0101_allcombined	2485525	2485534		YPO_RS12060	9
RK1001.C0101_allcombined	2485792	2485803		YPO_RS12060	11
RK1001.C0101_allcombined	2486765	2486784		rluB	19
RK1001.C0101_allcombined	2487037	2487050		rluB	13
RK1001.C0101_allcombined	2487100	2487113		rluB	13
RK1001.C0101_allcombined	2487494	2487495		rluB	1
RK1001.C0101_allcombined	2487649	2487659		cobO	10
RK1001.C0101_allcombined	2487821	2487822		cobO	1
RK1001.C0101_allcombined	2487938	2487939		cobO	1
RK1001.C0101_allcombined	2488125	2488138		cobO	13
RK1001.C0101_allcombined	2488467	2488471		YPO_RS12075	4
RK1001.C0101_allcombined	2488889	2488895		YPO_RS12075	6
RK1001.C0101_allcombined	2489301	2489304		sohB	3
RK1001.C0101_allcombined	2489546	2489551		sohB	5
RK1001.C0101_allcombined	2490135	2490142		sohB	7
RK1001.C0101_allcombined	2490479	2490480		YPO_RS12085	1
RK1001.C0101_allcombined	2490591	2490605		YPO_RS12085	14
RK1001.C0101_allcombined	2490896	2490942		YPO_RS12090	46
RK1001.C0101_allcombined	2491036	2491072		topA	36
RK1001.C0101_allcombined	2491216	2491248		topA	32
RK1001.C0101_allcombined	2491939	2491942		topA	3
RK1001.C0101_allcombined	2491997	2492008		topA	11
RK1001.C0101_allcombined	2492281	2492292		topA	11
RK1001.C0101_allcombined	2492409	2492423		topA	14
RK1001.C0101_allcombined	2492532	2492534		topA	2
RK1001.C0101_allcombined	2492566	2492577		topA	11
RK1001.C0101_allcombined	2493571	2493577		topA	6
RK1001.C0101_allcombined	2494036	2494105		cysB	69
RK1001.C0101_allcombined	2494202	2494217		cysB	15
RK1001.C0101_allcombined	2494609	2494631		cysB	22
RK1001.C0101_allcombined	2494960	2495010		cysB	50
RK1001.C0101_allcombined	2495492	2495525		YPO_RS12105	33
RK1001.C0101_allcombined	2495643	2495644		YPO_RS12105	1
RK1001.C0101_allcombined	2495679	2495745		YPO_RS12105	66
RK1001.C0101_allcombined	2495782	2496048		YPO_RS12105	266
RK1001.C0101_allcombined	2496097	2496100		YPO_RS12105	3
RK1001.C0101_allcombined	2496155	2496203		YPO_RS12105	48
RK1001.C0101_allcombined	2497111	2497115		acnA	4
RK1001.C0101_allcombined	2497685	2497704		acnA	19
RK1001.C0101_allcombined	2497874	2497875		acnA	1
RK1001.C0101_allcombined	2498694	2498699		acnA	5
RK1001.C0101_allcombined	2499008	2499048		acnA	40
RK1001.C0101_allcombined	2499199	2499200		acnA	1
RK1001.C0101_allcombined	2499574	2499575		ribA	1
RK1001.C0101_allcombined	2499990	2499993		ribA	3
RK1001.C0101_allcombined	2500590	2500606		pgpB	16
RK1001.C0101_allcombined	2501429	2501431		YPO_RS12125	2
RK1001.C0101_allcombined	2501914	2501919		lapB	5
RK1001.C0101_allcombined	2502196	2502230		lapB	34
RK1001.C0101_allcombined	2502860	2502862		lapB	2
RK1001.C0101_allcombined	2502906	2502916		lapB	10
RK1001.C0101_allcombined	2503176	2503185		YPO_RS12135	9
RK1001.C0101_allcombined	2503311	2503337		YPO_RS12135	26
RK1001.C0101_allcombined	2503830	2503854		pyrF	24
RK1001.C0101_allcombined	2504543	2504544		pyrF	1
RK1001.C0101_allcombined	2504544	2504564		yciH	20
RK1001.C0101_allcombined	2504670	2504676		yciH	6
RK1001.C0101_allcombined	2504853	2504866		yciH	13
RK1001.C0101_allcombined	2505228	2505277		osmB	49
RK1001.C0101_allcombined	2506247	2506300		araD	53
RK1001.C0101_allcombined	2506330	2506333		araD	3
RK1001.C0101_allcombined	2506745	2506755		YPO_RS12160	10
RK1001.C0101_allcombined	2507225	2507227		fsa	2
RK1001.C0101_allcombined	2507352	2507356		fsa	4
RK1001.C0101_allcombined	2507421	2507443		fsa	22
RK1001.C0101_allcombined	2507540	2507573		fsa	33
RK1001.C0101_allcombined	2507741	2507774		fsa	33
RK1001.C0101_allcombined	2507974	2507975		YPO_RS12170	1
RK1001.C0101_allcombined	2508408	2508421		YPO_RS12175	13
RK1001.C0101_allcombined	2508649	2508660		YPO_RS12175	11
RK1001.C0101_allcombined	2508752	2508757		YPO_RS12175	5
RK1001.C0101_allcombined	2508869	2508885		YPO_RS12175	16
RK1001.C0101_allcombined	2509607	2509610		YPO_RS12175	3
RK1001.C0101_allcombined	2510001	2510011		YPO_RS12175	10
RK1001.C0101_allcombined	2510712	2510716		YPO_RS12180	4
RK1001.C0101_allcombined	2511062	2511063		YPO_RS12180	1
RK1001.C0101_allcombined	2511574	2511586		YPO_RS12180	12
RK1001.C0101_allcombined	2511926	2511928		YPO_RS12180	2
RK1001.C0101_allcombined	2512054	2512076		YPO_RS12180	22
RK1001.C0101_allcombined	2513585	2513597		YPO_RS12185	12
RK1001.C0101_allcombined	2513802	2513817		YPO_RS12185	15
RK1001.C0101_allcombined	2513964	2514039		YPO_RS12185	75
RK1001.C0101_allcombined	2514241	2514247		YPO_RS12185	6
RK1001.C0101_allcombined	2514384	2514409		YPO_RS12185	25
RK1001.C0101_allcombined	2514669	2514694		YPO_RS12190	25
RK1001.C0101_allcombined	2514980	2514982		YPO_RS12190	2
RK1001.C0101_allcombined	2515182	2515192		YPO_RS12190	10
RK1001.C0101_allcombined	2515754	2515765		nth	11
RK1001.C0101_allcombined	2515806	2515811		nth	5
RK1001.C0101_allcombined	2515919	2515923		nth	4
RK1001.C0101_allcombined	2516121	2516182		nth	61
RK1001.C0101_allcombined	2516633	2516657		YPO_RS12200	24
RK1001.C0101_allcombined	2516756	2516767		YPO_RS12200	11
RK1001.C0101_allcombined	2516920	2516936		YPO_RS12200	16
RK1001.C0101_allcombined	2517088	2517102		rsxG	14
RK1001.C0101_allcombined	2517247	2517265		rsxG	18
RK1001.C0101_allcombined	2517692	2517693		rsxD	1
RK1001.C0101_allcombined	2517728	2517729		rsxD	1
RK1001.C0101_allcombined	2517905	2517918		rsxD	13
RK1001.C0101_allcombined	2518469	2518505		rsxD	36
RK1001.C0101_allcombined	2518765	2518781		rsxD	16
RK1001.C0101_allcombined	2519652	2519659		YPO_RS12215	7
RK1001.C0101_allcombined	2519953	2519989		YPO_RS12215	36
RK1001.C0101_allcombined	2520036	2520038		YPO_RS12215	2
RK1001.C0101_allcombined	2520850	2520859		rsxC	9
RK1001.C0101_allcombined	2520943	2520974		rsxC	31
RK1001.C0101_allcombined	2521094	2521141		rsxC	47
RK1001.C0101_allcombined	2521176	2521181		rsxC	5
RK1001.C0101_allcombined	2521794	2521804		rsxC	10
RK1001.C0101_allcombined	2522313	2522316		rsxB	3
RK1001.C0101_allcombined	2522572	2522583		rsxB	11
RK1001.C0101_allcombined	2523007	2523016		rsxA	9
RK1001.C0101_allcombined	2523297	2523332		rsxA	35
RK1001.C0101_allcombined	2523711	2523712		YPO_RS12235	1
RK1001.C0101_allcombined	2526817	2526850		YPO_RS12245	33
RK1001.C0101_allcombined	2527385	2527388		YPO_RS12245	3
RK1001.C0101_allcombined	2527430	2527431		YPO_RS12245	1
RK1001.C0101_allcombined	2528323	2528327		YPO_RS12255	4
RK1001.C0101_allcombined	2529252	2529293		YPO_RS12255	41
RK1001.C0101_allcombined	2529631	2529637		YPO_RS12255	6
RK1001.C0101_allcombined	2530160	2530177		araA	17
RK1001.C0101_allcombined	2530549	2530555		araA	6
RK1001.C0101_allcombined	2530681	2530703		araA	22
RK1001.C0101_allcombined	2531513	2531516		araA	3
RK1001.C0101_allcombined	2531973	2532016		YPO_RS12265	43
RK1001.C0101_allcombined	2532532	2532551		YPO_RS12265	19
RK1001.C0101_allcombined	2532787	2532802		YPO_RS12265	15
RK1001.C0101_allcombined	2532840	2532867		YPO_RS12265	27
RK1001.C0101_allcombined	2533173	2533182		YPO_RS12265	9
RK1001.C0101_allcombined	2533318	2533325		YPO_RS12265	7
RK1001.C0101_allcombined	2533857	2533875		YPO_RS12270	18
RK1001.C0101_allcombined	2534614	2534618		YPO_RS12270	4
RK1001.C0101_allcombined	2534671	2534720		YPO_RS12270	49
RK1001.C0101_allcombined	2535129	2535183		YPO_RS12275	54
RK1001.C0101_allcombined	2535575	2535580		YPO_RS12275	5
RK1001.C0101_allcombined	2535611	2535620		YPO_RS12275	9
RK1001.C0101_allcombined	2535703	2535723		YPO_RS12275	20
RK1001.C0101_allcombined	2536216	2536217		YPO_RS12275	1
RK1001.C0101_allcombined	2536408	2536418		YPO_RS12275	10
RK1001.C0101_allcombined	2536932	2536933		YPO_RS12280	1
RK1001.C0101_allcombined	2537113	2537147		YPO_RS12280	34
RK1001.C0101_allcombined	2537556	2537568		YPO_RS12280	12
RK1001.C0101_allcombined	2537856	2537858		araC	2
RK1001.C0101_allcombined	2537976	2538015		araC	39
RK1001.C0101_allcombined	2538078	2538113		araC	35
RK1001.C0101_allcombined	2538158	2538167		araC	9
RK1001.C0101_allcombined	2538296	2538306		araC	10
RK1001.C0101_allcombined	2538337	2538344		araC	7
RK1001.C0101_allcombined	2538481	2538506		araC	25
RK1001.C0101_allcombined	2538857	2538868		YPO_RS12290	11
RK1001.C0101_allcombined	2539004	2539052		YPO_RS12290	48
RK1001.C0101_allcombined	2539887	2539906		YPO_RS12290	19
RK1001.C0101_allcombined	2540117	2540147		YPO_RS12295	30
RK1001.C0101_allcombined	2540177	2540180		YPO_RS12295	3
RK1001.C0101_allcombined	2540350	2540366		YPO_RS12295	16
RK1001.C0101_allcombined	2540998	2541023		YPO_RS12295	25
RK1001.C0101_allcombined	2541334	2541351		YPO_RS12300	17
RK1001.C0101_allcombined	2541471	2541513		YPO_RS12300	42
RK1001.C0101_allcombined	2541568	2541598		YPO_RS12300	30
RK1001.C0101_allcombined	2541679	2541733		YPO_RS12300	54
RK1001.C0101_allcombined	2541843	2541851		YPO_RS12300	8
RK1001.C0101_allcombined	2541907	2541933		YPO_RS12300	26
RK1001.C0101_allcombined	2542171	2542181		YPO_RS12305	10
RK1001.C0101_allcombined	2542691	2542705		YPO_RS12305	14
RK1001.C0101_allcombined	2542902	2542932		YPO_RS12305	30
RK1001.C0101_allcombined	2543298	2543306		YPO_RS12305	8
RK1001.C0101_allcombined	2543459	2543462		YPO_RS12305	3
RK1001.C0101_allcombined	2543899	2543900		manA	1
RK1001.C0101_allcombined	2543943	2543971		manA	28
RK1001.C0101_allcombined	2544073	2544085		manA	12
RK1001.C0101_allcombined	2544504	2544505		manA	1
RK1001.C0101_allcombined	2544730	2544738		manA	8
RK1001.C0101_allcombined	2544867	2544870		manA	3
RK1001.C0101_allcombined	2544939	2544941		manA	2
RK1001.C0101_allcombined	2545490	2545497		fumC	7
RK1001.C0101_allcombined	2545801	2545806		fumC	5
RK1001.C0101_allcombined	2546607	2546622		fumC	15
RK1001.C0101_allcombined	2546882	2546923		YPO_RS12320	41
RK1001.C0101_allcombined	2547295	2547302		YPO_RS12320	7
RK1001.C0101_allcombined	2547558	2547577		YPO_RS12320	19
RK1001.C0101_allcombined	2547647	2547676		YPO_RS12320	29
RK1001.C0101_allcombined	2548160	2548177		YPO_RS12325	17
RK1001.C0101_allcombined	2548236	2548266		YPO_RS12325	30
RK1001.C0101_allcombined	2548336	2548368		YPO_RS12325	32
RK1001.C0101_allcombined	2548898	2548919		YPO_RS12325	21
RK1001.C0101_allcombined	2549046	2549049		YPO_RS12325	3
RK1001.C0101_allcombined	2549445	2549450		YPO_RS12330	5
RK1001.C0101_allcombined	2549511	2549513		YPO_RS12330	2
RK1001.C0101_allcombined	2549729	2549748		YPO_RS12335	19
RK1001.C0101_allcombined	2549796	2549811		YPO_RS12335	15
RK1001.C0101_allcombined	2550006	2550013		YPO_RS12335	7
RK1001.C0101_allcombined	2550194	2550217		YPO_RS12335	23
RK1001.C0101_allcombined	2550485	2550490		YPO_RS12340	5
RK1001.C0101_allcombined	2550669	2550678		YPO_RS12340	9
RK1001.C0101_allcombined	2550727	2550739		YPO_RS12340	12
RK1001.C0101_allcombined	2550939	2550965		YPO_RS12340	26
RK1001.C0101_allcombined	2551090	2551096		YPO_RS12340	6
RK1001.C0101_allcombined	2551144	2551158		YPO_RS12340	14
RK1001.C0101_allcombined	2551390	2551432		YPO_RS12340	42
RK1001.C0101_allcombined	2552098	2552149		bioD	51
RK1001.C0101_allcombined	2552291	2552294		bioD	3
RK1001.C0101_allcombined	2552326	2552347		bioD	21
RK1001.C0101_allcombined	2553060	2553063		clcB	3
RK1001.C0101_allcombined	2553119	2553151		clcB	32
RK1001.C0101_allcombined	2553203	2553218		clcB	15
RK1001.C0101_allcombined	2553301	2553308		clcB	7
RK1001.C0101_allcombined	2554373	2554633		YPO_RS12355	260
RK1001.C0101_allcombined	2554658	2555065		YPO_RS12360	407
RK1001.C0101_allcombined	2555162	2555608		YPO_RS12365	446
RK1001.C0101_allcombined	2555780	2556832		YPO_RS12370	1052
RK1001.C0101_allcombined	2556844	2557161		YPO_RS12375	317
RK1001.C0101_allcombined	2557164	2557415		YPO_RS12380	251
RK1001.C0101_allcombined	2557451	2557684		YPO_RS12385	233
RK1001.C0101_allcombined	2557749	2559461		YPO_RS12390	1712
RK1001.C0101_allcombined	2559474	2559761		YPO_RS12395	287
RK1001.C0101_allcombined	2559765	2560790		YPO_RS12400	1025
RK1001.C0101_allcombined	2560790	2562034		YPO_RS12405	1244
RK1001.C0101_allcombined	2562123	2562371		YPO_RS12410	248
RK1001.C0101_allcombined	2562568	2562765		YPO_RS12415	197
RK1001.C0101_allcombined	2563490	2563493		YPO_RS12420	3
RK1001.C0101_allcombined	2563618	2563666		YPO_RS12420	48
RK1001.C0101_allcombined	2563902	2563931		YPO_RS12420	29
RK1001.C0101_allcombined	2564233	2564252		YPO_RS12420	19
RK1001.C0101_allcombined	2564438	2564479		YPO_RS12425	41
RK1001.C0101_allcombined	2564519	2564549		YPO_RS12425	30
RK1001.C0101_allcombined	2564638	2564640		YPO_RS12425	2
RK1001.C0101_allcombined	2564830	2564870		YPO_RS12425	40
RK1001.C0101_allcombined	2565808	2565874		YPO_RS12435	66
RK1001.C0101_allcombined	2566034	2566046		YPO_RS12435	12
RK1001.C0101_allcombined	2566217	2566228		YPO_RS12435	11
RK1001.C0101_allcombined	2566432	2566480		YPO_RS12435	48
RK1001.C0101_allcombined	2566608	2566611		YPO_RS12435	3
RK1001.C0101_allcombined	2566851	2566897		YPO_RS12440	46
RK1001.C0101_allcombined	2567272	2567304		YPO_RS12440	32
RK1001.C0101_allcombined	2567446	2567451		YPO_RS12440	5
RK1001.C0101_allcombined	2567652	2567664		YPO_RS12440	12
RK1001.C0101_allcombined	2568114	2568168		YPO_RS12445	54
RK1001.C0101_allcombined	2568762	2568769		YPO_RS12445	7
RK1001.C0101_allcombined	2568882	2568883		YPO_RS12445	1
RK1001.C0101_allcombined	2569237	2569241		YPO_RS12445	4
RK1001.C0101_allcombined	2569414	2569426		YPO_RS12445	12
RK1001.C0101_allcombined	2569886	2569919		YPO_RS12450	33
RK1001.C0101_allcombined	2571280	2571292		YPO_RS12455	12
RK1001.C0101_allcombined	2571421	2571432		YPO_RS12455	11
RK1001.C0101_allcombined	2571541	2571546		YPO_RS12455	5
RK1001.C0101_allcombined	2571613	2571626		YPO_RS12455	13
RK1001.C0101_allcombined	2572102	2572110		YPO_RS12455	8
RK1001.C0101_allcombined	2572210	2572222		YPO_RS12455	12
RK1001.C0101_allcombined	2572480	2572497		YPO_RS12455	17
RK1001.C0101_allcombined	2572790	2572822		YPO_RS12455	32
RK1001.C0101_allcombined	2572978	2572986		YPO_RS12455	8
RK1001.C0101_allcombined	2573275	2573277		YPO_RS12455	2
RK1001.C0101_allcombined	2573500	2573515		YPO_RS12455	15
RK1001.C0101_allcombined	2573725	2573761		YPO_RS12455	36
RK1001.C0101_allcombined	2574326	2574371		YPO_RS12460	45
RK1001.C0101_allcombined	2575124	2575138		YPO_RS12460	14
RK1001.C0101_allcombined	2575324	2575328		YPO_RS12460	4
RK1001.C0101_allcombined	2575773	2575799		YPO_RS12460	26
RK1001.C0101_allcombined	2575841	2575879		YPO_RS12460	38
RK1001.C0101_allcombined	2576016	2576037		YPO_RS12460	21
RK1001.C0101_allcombined	2576298	2576301		YPO_RS12460	3
RK1001.C0101_allcombined	2576381	2576385		YPO_RS12460	4
RK1001.C0101_allcombined	2576626	2576644		YPO_RS12460	18
RK1001.C0101_allcombined	2576691	2576738		YPO_RS12460	47
RK1001.C0101_allcombined	2577042	2577049		YPO_RS12465	7
RK1001.C0101_allcombined	2577190	2577236		YPO_RS12465	46
RK1001.C0101_allcombined	2577325	2577334		YPO_RS12465	9
RK1001.C0101_allcombined	2577420	2577478		YPO_RS12465	58
RK1001.C0101_allcombined	2577522	2577548		YPO_RS12465	26
RK1001.C0101_allcombined	2577713	2577716		YPO_RS12465	3
RK1001.C0101_allcombined	2577780	2577810		YPO_RS12465	30
RK1001.C0101_allcombined	2578193	2578200		ivbL	7
RK1001.C0101_allcombined	2578699	2578757		ilvB	58
RK1001.C0101_allcombined	2579700	2579720		ilvB	20
RK1001.C0101_allcombined	2579977	2579990		ilvB	13
RK1001.C0101_allcombined	2580063	2580065		ilvB	2
RK1001.C0101_allcombined	2580067	2580082		ilvN	15
RK1001.C0101_allcombined	2580608	2580624		yjjG	16
RK1001.C0101_allcombined	2580701	2580702		yjjG	1
RK1001.C0101_allcombined	2580924	2580929		yjjG	5
RK1001.C0101_allcombined	2581745	2581762		YPO_RS12490	17
RK1001.C0101_allcombined	2582812	2582841		YPO_RS12495	29
RK1001.C0101_allcombined	2583289	2583313		YPO_RS12495	24
RK1001.C0101_allcombined	2583566	2583577		YPO_RS12495	11
RK1001.C0101_allcombined	2585171	2585178		phoA	7
RK1001.C0101_allcombined	2585230	2585276		phoA	46
RK1001.C0101_allcombined	2586362	2586386		ogt	24
RK1001.C0101_allcombined	2586801	2586818		YPO_RS12510	17
RK1001.C0101_allcombined	2587469	2587478		uspE	9
RK1001.C0101_allcombined	2587736	2587744		uspE	8
RK1001.C0101_allcombined	2587854	2587869		uspE	15
RK1001.C0101_allcombined	2588267	2588268		uspE	1
RK1001.C0101_allcombined	2588623	2588632		pntB	9
RK1001.C0101_allcombined	2588734	2588741		pntB	7
RK1001.C0101_allcombined	2588879	2588897		pntB	18
RK1001.C0101_allcombined	2589075	2589078		pntB	3
RK1001.C0101_allcombined	2589201	2589208		pntB	7
RK1001.C0101_allcombined	2589425	2589436		pntB	11
RK1001.C0101_allcombined	2590053	2590059		pntA	6
RK1001.C0101_allcombined	2590258	2590263		pntA	5
RK1001.C0101_allcombined	2590456	2590470		pntA	14
RK1001.C0101_allcombined	2590582	2590584		pntA	2
RK1001.C0101_allcombined	2590635	2590640		pntA	5
RK1001.C0101_allcombined	2591374	2591383		pntA	9
RK1001.C0101_allcombined	2592463	2592475		YPO_RS12530	12
RK1001.C0101_allcombined	2593050	2593053		YPO_RS12530	3
RK1001.C0101_allcombined	2593900	2593907		YPO_RS12535	7
RK1001.C0101_allcombined	2593942	2593944		YPO_RS12535	2
RK1001.C0101_allcombined	2594330	2594331		YPO_RS12535	1
RK1001.C0101_allcombined	2594568	2594612		YPO_RS12535	44
RK1001.C0101_allcombined	2595647	2595651		rstA	4
RK1001.C0101_allcombined	2595893	2595904		rstA	11
RK1001.C0101_allcombined	2596636	2596679		rstB	43
RK1001.C0101_allcombined	2596837	2596851		rstB	14
RK1001.C0101_allcombined	2597026	2597034		rstB	8
RK1001.C0101_allcombined	2597112	2597124		rstB	12
RK1001.C0101_allcombined	2598070	2598092		YPO_RS12555	22
RK1001.C0101_allcombined	2598389	2598396		YPO_RS12555	7
RK1001.C0101_allcombined	2599041	2599042		YPO_RS12555	1
RK1001.C0101_allcombined	2599289	2599316		YPO_RS12560	27
RK1001.C0101_allcombined	2604468	2604490		YPO_RS12575	22
RK1001.C0101_allcombined	2604579	2604603		YPO_RS12575	24
RK1001.C0101_allcombined	2604935	2604936		YPO_RS12575	1
RK1001.C0101_allcombined	2605030	2605033		YPO_RS12575	3
RK1001.C0101_allcombined	2605195	2605204		YPO_RS12580	9
RK1001.C0101_allcombined	2605467	2605493		YPO_RS12580	26
RK1001.C0101_allcombined	2605554	2605575		YPO_RS12580	21
RK1001.C0101_allcombined	2606285	2606289		asr	4
RK1001.C0101_allcombined	2606407	2606409		asr	2
RK1001.C0101_allcombined	2606499	2606501		asr	2
RK1001.C0101_allcombined	2606841	2606877		YPO_RS12590	36
RK1001.C0101_allcombined	2607264	2607270		YPO_RS12590	6
RK1001.C0101_allcombined	2607652	2607671		YPO_RS12590	19
RK1001.C0101_allcombined	2607813	2607819		YPO_RS12595	6
RK1001.C0101_allcombined	2608754	2608780		hrpA	26
RK1001.C0101_allcombined	2609305	2609368		hrpA	63
RK1001.C0101_allcombined	2609405	2609421		hrpA	16
RK1001.C0101_allcombined	2609540	2609562		hrpA	22
RK1001.C0101_allcombined	2609991	2609995		hrpA	4
RK1001.C0101_allcombined	2610091	2610099		hrpA	8
RK1001.C0101_allcombined	2610571	2610582		hrpA	11
RK1001.C0101_allcombined	2610621	2610622		hrpA	1
RK1001.C0101_allcombined	2610775	2610795		hrpA	20
RK1001.C0101_allcombined	2611160	2611164		hrpA	4
RK1001.C0101_allcombined	2611381	2611386		hrpA	5
RK1001.C0101_allcombined	2611945	2611949		hrpA	4
RK1001.C0101_allcombined	2613025	2613041		azoR	16
RK1001.C0101_allcombined	2613073	2613074		azoR	1
RK1001.C0101_allcombined	2614944	2614946		YPO_RS12620	2
RK1001.C0101_allcombined	2615160	2615181		YPO_RS12620	21
RK1001.C0101_allcombined	2615644	2615686		YPO_RS12620	42
RK1001.C0101_allcombined	2616296	2616308		YPO_RS12620	12
RK1001.C0101_allcombined	2617281	2617311		YPO_RS12635	30
RK1001.C0101_allcombined	2617709	2617726		YPO_RS12635	17
RK1001.C0101_allcombined	2617804	2617851		YPO_RS12635	47
RK1001.C0101_allcombined	2617915	2617919		YPO_RS12635	4
RK1001.C0101_allcombined	2618000	2618005		YPO_RS12635	5
RK1001.C0101_allcombined	2618190	2618192		YPO_RS12635	2
RK1001.C0101_allcombined	2618935	2618940		YPO_RS12635	5
RK1001.C0101_allcombined	2620072	2620075		YPO_RS12640	3
RK1001.C0101_allcombined	2620721	2620723		YPO_RS12640	2
RK1001.C0101_allcombined	2620798	2620805		YPO_RS12640	7
RK1001.C0101_allcombined	2621138	2621146		hslJ	8
RK1001.C0101_allcombined	2621180	2621192		hslJ	12
RK1001.C0101_allcombined	2621316	2621318		hslJ	2
RK1001.C0101_allcombined	2621490	2621499		hslJ	9
RK1001.C0101_allcombined	2621869	2621871		YPO_RS12650	2
RK1001.C0101_allcombined	2622613	2622619		YPO_RS12655	6
RK1001.C0101_allcombined	2622863	2622874		YPO_RS12655	11
RK1001.C0101_allcombined	2623189	2623196		YPO_RS12660	7
RK1001.C0101_allcombined	2623839	2623853		nifJ	14
RK1001.C0101_allcombined	2624014	2624022		nifJ	8
RK1001.C0101_allcombined	2624142	2624151		nifJ	9
RK1001.C0101_allcombined	2624395	2624405		nifJ	10
RK1001.C0101_allcombined	2624591	2624615		nifJ	24
RK1001.C0101_allcombined	2624785	2624809		nifJ	24
RK1001.C0101_allcombined	2625290	2625295		nifJ	5
RK1001.C0101_allcombined	2625639	2625646		nifJ	7
RK1001.C0101_allcombined	2626003	2626011		nifJ	8
RK1001.C0101_allcombined	2626259	2626271		nifJ	12
RK1001.C0101_allcombined	2626999	2627002		nifJ	3
RK1001.C0101_allcombined	2627236	2627241		nifJ	5
RK1001.C0101_allcombined	2628055	2628102		ttcA	47
RK1001.C0101_allcombined	2628275	2628279		ttcA	4
RK1001.C0101_allcombined	2628360	2628386		ttcA	26
RK1001.C0101_allcombined	2628906	2628907		YPO_RS12675	1
RK1001.C0101_allcombined	2628980	2628999		YPO_RS12675	19
RK1001.C0101_allcombined	2629266	2629281		YPO_RS12675	15
RK1001.C0101_allcombined	2629475	2629478		YPO_RS12675	3
RK1001.C0101_allcombined	2629543	2629555		YPO_RS12675	12
RK1001.C0101_allcombined	2629671	2629684		YPO_RS12675	13
RK1001.C0101_allcombined	2630107	2630133		YPO_RS12680	26
RK1001.C0101_allcombined	2630206	2630220		YPO_RS12680	14
RK1001.C0101_allcombined	2630313	2630322		YPO_RS12680	9
RK1001.C0101_allcombined	2630535	2630567		YPO_RS12680	32
RK1001.C0101_allcombined	2630606	2630613		YPO_RS12680	7
RK1001.C0101_allcombined	2630659	2630665		YPO_RS12680	6
RK1001.C0101_allcombined	2630728	2630733		YPO_RS12680	5
RK1001.C0101_allcombined	2630766	2630768		YPO_RS12680	2
RK1001.C0101_allcombined	2630880	2630895		YPO_RS12680	15
RK1001.C0101_allcombined	2631392	2631415		zntB	23
RK1001.C0101_allcombined	2631580	2631584		zntB	4
RK1001.C0101_allcombined	2632298	2632303		zntB	5
RK1001.C0101_allcombined	2632546	2632569		YPO_RS12690	23
RK1001.C0101_allcombined	2632694	2632718		YPO_RS12690	24
RK1001.C0101_allcombined	2632765	2632774		YPO_RS12690	9
RK1001.C0101_allcombined	2632813	2632849		YPO_RS12690	36
RK1001.C0101_allcombined	2632898	2632904		YPO_RS12690	6
RK1001.C0101_allcombined	2632968	2633002		YPO_RS12690	34
RK1001.C0101_allcombined	2633168	2633208		YPO_RS12690	40
RK1001.C0101_allcombined	2633308	2633320		YPO_RS12690	12
RK1001.C0101_allcombined	2633367	2633395		YPO_RS12690	28
RK1001.C0101_allcombined	2633454	2633467		YPO_RS12690	13
RK1001.C0101_allcombined	2633583	2633586		YPO_RS12690	3
RK1001.C0101_allcombined	2633820	2633888		YPO_RS12690	68
RK1001.C0101_allcombined	2634130	2634133		YPO_RS12690	3
RK1001.C0101_allcombined	2634672	2634685		mpaA	13
RK1001.C0101_allcombined	2635730	2635737		ycjG	7
RK1001.C0101_allcombined	2638022	2638028		tyrR	6
RK1001.C0101_allcombined	2638425	2638426		tyrR	1
RK1001.C0101_allcombined	2638964	2638999		tyrR	35
RK1001.C0101_allcombined	2639337	2639341		tyrR	4
RK1001.C0101_allcombined	2639881	2639888		YPO_RS12720	7
RK1001.C0101_allcombined	2639927	2639939		YPO_RS12720	12
RK1001.C0101_allcombined	2640481	2640486		YPO_RS12725	5
RK1001.C0101_allcombined	2640738	2640768		YPO_RS12730	30
RK1001.C0101_allcombined	2641052	2641061		YPO_RS12730	9
RK1001.C0101_allcombined	2641477	2641481		YPO_RS12730	4
RK1001.C0101_allcombined	2642188	2642194		YPO_RS12735	6
RK1001.C0101_allcombined	2642384	2642409		YPO_RS12735	25
RK1001.C0101_allcombined	2643720	2643723		pspC	3
RK1001.C0101_allcombined	2643794	2643807		pspC	13
RK1001.C0101_allcombined	2643880	2643891		pspB	11
RK1001.C0101_allcombined	2645159	2645161		pspF	2
RK1001.C0101_allcombined	2645342	2645351		pspF	9
RK1001.C0101_allcombined	2645979	2645980		pspF	1
RK1001.C0101_allcombined	2646370	2646372		YPO_RS12765	2
RK1001.C0101_allcombined	2646460	2646471		YPO_RS12765	11
RK1001.C0101_allcombined	2646632	2646636		YPO_RS12765	4
RK1001.C0101_allcombined	2647618	2647638		sapA	20
RK1001.C0101_allcombined	2647672	2647696		sapA	24
RK1001.C0101_allcombined	2647974	2647980		sapA	6
RK1001.C0101_allcombined	2648726	2648736		sapA	10
RK1001.C0101_allcombined	2648788	2648791		sapA	3
RK1001.C0101_allcombined	2648879	2648893		sapA	14
RK1001.C0101_allcombined	2650589	2650594		sapC	5
RK1001.C0101_allcombined	2651404	2651429		sapD	25
RK1001.C0101_allcombined	2651681	2651713		sapD	32
RK1001.C0101_allcombined	2651763	2651772		sapD	9
RK1001.C0101_allcombined	2652363	2652368		sapF	5
RK1001.C0101_allcombined	2652485	2652494		sapF	9
RK1001.C0101_allcombined	2652559	2652577		sapF	18
RK1001.C0101_allcombined	2653157	2653168		YPO_RS12795	11
RK1001.C0101_allcombined	2653299	2653301		YPO_RS12795	2
RK1001.C0101_allcombined	2653435	2653442		YPO_RS12795	7
RK1001.C0101_allcombined	2653790	2653795		YPO_RS12795	5
RK1001.C0101_allcombined	2654363	2654366		YPO_RS12795	3
RK1001.C0101_allcombined	2655149	2655166		dtpA	17
RK1001.C0101_allcombined	2655197	2655199		dtpA	2
RK1001.C0101_allcombined	2655376	2655389		dtpA	13
RK1001.C0101_allcombined	2655744	2655748		dtpA	4
RK1001.C0101_allcombined	2655843	2655867		dtpA	24
RK1001.C0101_allcombined	2656048	2656050		dtpA	2
RK1001.C0101_allcombined	2656090	2656103		dtpA	13
RK1001.C0101_allcombined	2656212	2656255		dtpA	43
RK1001.C0101_allcombined	2656359	2656363		dtpA	4
RK1001.C0101_allcombined	2656526	2656540		dtpA	14
RK1001.C0101_allcombined	2656882	2656892		YPO_RS12805	10
RK1001.C0101_allcombined	2659890	2659892		YPO_RS12820	2
RK1001.C0101_allcombined	2660168	2660188		gstA	20
RK1001.C0101_allcombined	2660470	2660499		gstA	29
RK1001.C0101_allcombined	2660571	2660575		gstA	4
RK1001.C0101_allcombined	2660874	2660890		pdxY	16
RK1001.C0101_allcombined	2661284	2661310		pdxY	26
RK1001.C0101_allcombined	2661342	2661354		pdxY	12
RK1001.C0101_allcombined	2662239	2662270		tyrS	31
RK1001.C0101_allcombined	2662374	2662376		tyrS	2
RK1001.C0101_allcombined	2662928	2662938		tyrS	10
RK1001.C0101_allcombined	2662987	2662992		tyrS	5
RK1001.C0101_allcombined	2664085	2664090		YPO_RS12845	5
RK1001.C0101_allcombined	2664395	2664415		anmK	20
RK1001.C0101_allcombined	2664614	2664620		anmK	6
RK1001.C0101_allcombined	2664943	2664975		anmK	32
RK1001.C0101_allcombined	2665178	2665197		anmK	19
RK1001.C0101_allcombined	2666148	2666161		YPO_RS12855	13
RK1001.C0101_allcombined	2667073	2667082		rovA	9
RK1001.C0101_allcombined	2668151	2668158		YPO_RS12865	7
RK1001.C0101_allcombined	2668332	2668333		YPO_RS12865	1
RK1001.C0101_allcombined	2668509	2668511		YPO_RS12865	2
RK1001.C0101_allcombined	2668796	2668799		YPO_RS12865	3
RK1001.C0101_allcombined	2669461	2669477		eptA	16
RK1001.C0101_allcombined	2669549	2669561		eptA	12
RK1001.C0101_allcombined	2669866	2669870		eptA	4
RK1001.C0101_allcombined	2669976	2669980		eptA	4
RK1001.C0101_allcombined	2670412	2670415		eptA	3
RK1001.C0101_allcombined	2670456	2670465		eptA	9
RK1001.C0101_allcombined	2670505	2670516		eptA	11
RK1001.C0101_allcombined	2670616	2670625		eptA	9
RK1001.C0101_allcombined	2670863	2670924		eptA	61
RK1001.C0101_allcombined	2671213	2671235		YPO_RS12880	22
RK1001.C0101_allcombined	2671318	2671331		YPO_RS12880	13
RK1001.C0101_allcombined	2672650	2672655		YPO_RS12885	5
RK1001.C0101_allcombined	2673643	2673711		YPO_RS12890	68
RK1001.C0101_allcombined	2673780	2673781		YPO_RS12890	1
RK1001.C0101_allcombined	2673963	2673978		YPO_RS12890	15
RK1001.C0101_allcombined	2674881	2674894		YPO_RS12890	13
RK1001.C0101_allcombined	2674929	2675001		YPO_RS12890	72
RK1001.C0101_allcombined	2675066	2675068		YPO_RS12890	2
RK1001.C0101_allcombined	2675610	2675636		YPO_RS12890	26
RK1001.C0101_allcombined	2675769	2675778		YPO_RS12890	9
RK1001.C0101_allcombined	2675858	2675860		YPO_RS12890	2
RK1001.C0101_allcombined	2675902	2675910		YPO_RS12890	8
RK1001.C0101_allcombined	2675943	2675945		YPO_RS12890	2
RK1001.C0101_allcombined	2676506	2676511		gloA	5
RK1001.C0101_allcombined	2676798	2676814		gloA	16
RK1001.C0101_allcombined	2677009	2677035		rnt	26
RK1001.C0101_allcombined	2677111	2677140		rnt	29
RK1001.C0101_allcombined	2677631	2677633		YPO_RS12905	2
RK1001.C0101_allcombined	2678106	2678116		YPO_RS12910	10
RK1001.C0101_allcombined	2678148	2678151		YPO_RS12910	3
RK1001.C0101_allcombined	2678185	2678192		YPO_RS12910	7
RK1001.C0101_allcombined	2678790	2678793		YPO_RS12915	3
RK1001.C0101_allcombined	2678825	2678831		YPO_RS12915	6
RK1001.C0101_allcombined	2679256	2679259		YPO_RS12915	3
RK1001.C0101_allcombined	2679427	2679428		YPO_RS12915	1
RK1001.C0101_allcombined	2679476	2679480		YPO_RS12915	4
RK1001.C0101_allcombined	2679948	2679957		sodB	9
RK1001.C0101_allcombined	2679999	2680035		sodB	36
RK1001.C0101_allcombined	2681277	2681332		purR	55
RK1001.C0101_allcombined	2681656	2681665		purR	9
RK1001.C0101_allcombined	2681991	2681997		purR	6
RK1001.C0101_allcombined	2682266	2682284		YPO_RS12935	18
RK1001.C0101_allcombined	2683878	2683897		YPO_RS12940	19
RK1001.C0101_allcombined	2684081	2684082		YPO_RS12940	1
RK1001.C0101_allcombined	2684161	2684200		YPO_RS12940	39
RK1001.C0101_allcombined	2684318	2684335		YPO_RS12940	17
RK1001.C0101_allcombined	2685054	2685070		cfa	16
RK1001.C0101_allcombined	2685224	2685237		cfa	13
RK1001.C0101_allcombined	2685440	2685444		cfa	4
RK1001.C0101_allcombined	2685586	2685593		cfa	7
RK1001.C0101_allcombined	2685806	2685815		cfa	9
RK1001.C0101_allcombined	2686255	2686263		YPO_RS12950	8
RK1001.C0101_allcombined	2686561	2686610		YPO_RS12950	49
RK1001.C0101_allcombined	2686673	2686682		YPO_RS12950	9
RK1001.C0101_allcombined	2687062	2687093		YPO_RS12955	31
RK1001.C0101_allcombined	2687165	2687170		YPO_RS12960	5
RK1001.C0101_allcombined	2687375	2687378		YPO_RS12960	3
RK1001.C0101_allcombined	2687490	2687493		YPO_RS12960	3
RK1001.C0101_allcombined	2687754	2687757		YPO_RS12960	3
RK1001.C0101_allcombined	2688284	2688314		YPO_RS12960	30
RK1001.C0101_allcombined	2689583	2689596		pykF	13
RK1001.C0101_allcombined	2690006	2690023		pykF	17
RK1001.C0101_allcombined	2690151	2690164		pykF	13
RK1001.C0101_allcombined	2690693	2690711		pykF	18
RK1001.C0101_allcombined	2690955	2690976		pykF	21
RK1001.C0101_allcombined	2691297	2691301		YPO_RS12980	4
RK1001.C0101_allcombined	2692163	2692173		YPO_RS12985	10
RK1001.C0101_allcombined	2692795	2692802		YPO_RS12990	7
RK1001.C0101_allcombined	2694850	2694856		YPO_RS13000	6
RK1001.C0101_allcombined	2694924	2694925		YPO_RS13000	1
RK1001.C0101_allcombined	2695048	2695054		YPO_RS13000	6
RK1001.C0101_allcombined	2695196	2695199		YPO_RS13000	3
RK1001.C0101_allcombined	2695236	2695240		YPO_RS13000	4
RK1001.C0101_allcombined	2695279	2695285		YPO_RS13000	6
RK1001.C0101_allcombined	2695355	2695378		YPO_RS13000	23
RK1001.C0101_allcombined	2695415	2695439		YPO_RS13000	24
RK1001.C0101_allcombined	2695576	2695586		YPO_RS13000	10
RK1001.C0101_allcombined	2696090	2696094		sufE	4
RK1001.C0101_allcombined	2696812	2696823		sufS	11
RK1001.C0101_allcombined	2697160	2697178		sufS	18
RK1001.C0101_allcombined	2697468	2697474		sufS	6
RK1001.C0101_allcombined	2698124	2698130		sufD	6
RK1001.C0101_allcombined	2698460	2698462		sufD	2
RK1001.C0101_allcombined	2698524	2698541		sufD	17
RK1001.C0101_allcombined	2698591	2698599		sufD	8
RK1001.C0101_allcombined	2698779	2698782		sufD	3
RK1001.C0101_allcombined	2699041	2699074		sufC	33
RK1001.C0101_allcombined	2699575	2699594		sufC	19
RK1001.C0101_allcombined	2700284	2700289		sufB	5
RK1001.C0101_allcombined	2700689	2700692		sufB	3
RK1001.C0101_allcombined	2700790	2700819		sufB	29
RK1001.C0101_allcombined	2701127	2701133		sufB	6
RK1001.C0101_allcombined	2702948	2702956		YPO_RS13040	8
RK1001.C0101_allcombined	2703254	2703259		YPO_RS13040	5
RK1001.C0101_allcombined	2703299	2703323		YPO_RS13040	24
RK1001.C0101_allcombined	2703800	2703801		YPO_RS13040	1
RK1001.C0101_allcombined	2703965	2703971		YPO_RS13040	6
RK1001.C0101_allcombined	2704417	2704448		YPO_RS13040	31
RK1001.C0101_allcombined	2704558	2704587		YPO_RS13040	29
RK1001.C0101_allcombined	2705052	2705056		YPO_RS13040	4
RK1001.C0101_allcombined	2705222	2705227		YPO_RS13040	5
RK1001.C0101_allcombined	2705933	2705945		YPO_RS13040	12
RK1001.C0101_allcombined	2703353	2703380		YPO_RS13040	27
RK1001.C0101_allcombined	2706566	2706583		ydiK	17
RK1001.C0101_allcombined	2706616	2706619		ydiK	3
RK1001.C0101_allcombined	2706691	2706692		ydiK	1
RK1001.C0101_allcombined	2707021	2707026		ydiK	5
RK1001.C0101_allcombined	2707268	2707300		ydiK	32
RK1001.C0101_allcombined	2707360	2707400		ydiK	40
RK1001.C0101_allcombined	2707498	2707511		ydiK	13
RK1001.C0101_allcombined	2707667	2707669		ydiK	2
RK1001.C0101_allcombined	2707945	2708010		rprA	65
RK1001.C0101_allcombined	2708311	2708360		ppsA	49
RK1001.C0101_allcombined	2708889	2708900		ppsA	11
RK1001.C0101_allcombined	2709131	2709157		ppsA	26
RK1001.C0101_allcombined	2709596	2709606		ppsA	10
RK1001.C0101_allcombined	2709812	2709818		ppsA	6
RK1001.C0101_allcombined	2709920	2709960		ppsA	40
RK1001.C0101_allcombined	2710110	2710111		ppsA	1
RK1001.C0101_allcombined	2710194	2710203		ppsA	9
RK1001.C0101_allcombined	2710423	2710427		ppsA	4
RK1001.C0101_allcombined	2710556	2710565		ppsA	9
RK1001.C0101_allcombined	2711012	2711015		YPO_RS13060	3
RK1001.C0101_allcombined	2711156	2711166		YPO_RS13060	10
RK1001.C0101_allcombined	2711455	2711456		YPO_RS13060	1
RK1001.C0101_allcombined	2711787	2711810		YPO_RS13060	23
RK1001.C0101_allcombined	2712052	2712056		YPO_RS13065	4
RK1001.C0101_allcombined	2712395	2712398		YPO_RS13065	3
RK1001.C0101_allcombined	2712753	2712757		YPO_RS13065	4
RK1001.C0101_allcombined	2712969	2712985		YPO_RS13065	16
RK1001.C0101_allcombined	2714797	2714803		YPO_RS13075	6
RK1001.C0101_allcombined	2714924	2714926		YPO_RS13075	2
RK1001.C0101_allcombined	2715120	2715136		YPO_RS13075	16
RK1001.C0101_allcombined	2715266	2715271		YPO_RS13075	5
RK1001.C0101_allcombined	2715332	2715341		YPO_RS13075	9
RK1001.C0101_allcombined	2715373	2715382		YPO_RS13075	9
RK1001.C0101_allcombined	2715940	2715943		YPO_RS13080	3
RK1001.C0101_allcombined	2716136	2716137		YPO_RS13080	1
RK1001.C0101_allcombined	2716622	2716648		arnF	26
RK1001.C0101_allcombined	2716808	2716874		arnF	66
RK1001.C0101_allcombined	2717103	2717122		arnE	19
RK1001.C0101_allcombined	2717285	2717309		arnE	24
RK1001.C0101_allcombined	2717306	2717340		arnT	34
RK1001.C0101_allcombined	2717512	2717532		arnT	20
RK1001.C0101_allcombined	2717680	2717699		arnT	19
RK1001.C0101_allcombined	2717859	2717882		arnT	23
RK1001.C0101_allcombined	2718006	2718045		arnT	39
RK1001.C0101_allcombined	2718158	2718186		arnT	28
RK1001.C0101_allcombined	2718355	2718380		arnT	25
RK1001.C0101_allcombined	2718758	2718815		arnT	57
RK1001.C0101_allcombined	2718915	2718926		arnT	11
RK1001.C0101_allcombined	2719064	2719073		YPO_RS13105	9
RK1001.C0101_allcombined	2719177	2719184		YPO_RS13105	7
RK1001.C0101_allcombined	2719315	2719325		YPO_RS13105	10
RK1001.C0101_allcombined	2719458	2719484		YPO_RS13105	26
RK1001.C0101_allcombined	2720160	2720193		arnA	33
RK1001.C0101_allcombined	2720601	2720603		arnA	2
RK1001.C0101_allcombined	2720763	2720798		arnA	35
RK1001.C0101_allcombined	2720903	2720953		arnA	50
RK1001.C0101_allcombined	2721328	2721329		arnA	1
RK1001.C0101_allcombined	2721446	2721471		arnA	25
RK1001.C0101_allcombined	2721794	2721807		arnA	13
RK1001.C0101_allcombined	2721932	2721935		arnC	3
RK1001.C0101_allcombined	2721995	2721998		arnC	3
RK1001.C0101_allcombined	2722189	2722190		arnC	1
RK1001.C0101_allcombined	2722820	2722852		arnC	32
RK1001.C0101_allcombined	2722839	2722868		arnB	29
RK1001.C0101_allcombined	2723032	2723035		arnB	3
RK1001.C0101_allcombined	2723428	2723434		arnB	6
RK1001.C0101_allcombined	2723762	2723768		arnB	6
RK1001.C0101_allcombined	2723902	2723907		arnB	5
RK1001.C0101_allcombined	2724343	2724393		btuD	50
RK1001.C0101_allcombined	2724496	2724497		btuD	1
RK1001.C0101_allcombined	2725135	2725155		YPO_RS13130	20
RK1001.C0101_allcombined	2725765	2725785		btuC	20
RK1001.C0101_allcombined	2726145	2726148		btuC	3
RK1001.C0101_allcombined	2726544	2726552		btuC	8
RK1001.C0101_allcombined	2726733	2726735		btuC	2
RK1001.C0101_allcombined	2727020	2727028		YPO_RS13140	8
RK1001.C0101_allcombined	2727422	2727442		YPO_RS13140	20
RK1001.C0101_allcombined	2727776	2727806		ihfA	30
RK1001.C0101_allcombined	2728896	2728897		pheT	1
RK1001.C0101_allcombined	2729126	2729127		pheT	1
RK1001.C0101_allcombined	2729650	2729655		pheT	5
RK1001.C0101_allcombined	2729918	2729926		pheT	8
RK1001.C0101_allcombined	2730069	2730071		pheT	2
RK1001.C0101_allcombined	2730107	2730114		pheT	7
RK1001.C0101_allcombined	2730306	2730331		pheT	25
RK1001.C0101_allcombined	2731167	2731173		pheS	6
RK1001.C0101_allcombined	2732913	2732915		infC	2
RK1001.C0101_allcombined	2733541	2733555		thrS	14
RK1001.C0101_allcombined	2733930	2733934		thrS	4
RK1001.C0101_allcombined	2734268	2734270		thrS	2
RK1001.C0101_allcombined	2734436	2734473		thrS	37
RK1001.C0101_allcombined	2735113	2735131		thrS	18
RK1001.C0101_allcombined	2736493	2736496		YPO_RS13190	3
RK1001.C0101_allcombined	2736569	2736588		YPO_RS13190	19
RK1001.C0101_allcombined	2737082	2737085		YPO_RS13195	3
RK1001.C0101_allcombined	2737275	2737278		YPO_RS13195	3
RK1001.C0101_allcombined	2737414	2737425		YPO_RS13195	11
RK1001.C0101_allcombined	2737662	2737721		YPO_RS13195	59
RK1001.C0101_allcombined	2739014	2739029		yfeA	15
RK1001.C0101_allcombined	2739132	2739138		yfeA	6
RK1001.C0101_allcombined	2739420	2739423		yfeA	3
RK1001.C0101_allcombined	2740642	2740646		yfeC	4
RK1001.C0101_allcombined	2741033	2741054		yfeC	21
RK1001.C0101_allcombined	2741109	2741118		yfeC	9
RK1001.C0101_allcombined	2741364	2741365		yfeC	1
RK1001.C0101_allcombined	2741459	2741481		yfeC	22
RK1001.C0101_allcombined	2741478	2741491		yfeD	13
RK1001.C0101_allcombined	2742158	2742176		yfeD	18
RK1001.C0101_allcombined	2742278	2742285		yfeD	7
RK1001.C0101_allcombined	2742492	2742503		YPO_RS13225	11
RK1001.C0101_allcombined	2742624	2742651		YPO_RS13225	27
RK1001.C0101_allcombined	2742738	2742747		YPO_RS13230	9
RK1001.C0101_allcombined	2742869	2742879		YPO_RS13230	10
RK1001.C0101_allcombined	2742927	2742941		YPO_RS13230	14
RK1001.C0101_allcombined	2743074	2743079		YPO_RS13230	5
RK1001.C0101_allcombined	2743889	2743913		YPO_RS13235	24
RK1001.C0101_allcombined	2743946	2743967		YPO_RS13235	21
RK1001.C0101_allcombined	2744000	2744005		YPO_RS13235	5
RK1001.C0101_allcombined	2745309	2745310		hxpB	1
RK1001.C0101_allcombined	2745561	2745569		YPO_RS13245	8
RK1001.C0101_allcombined	2746115	2746117		YPO_RS13245	2
RK1001.C0101_allcombined	2747473	2747486		solA	13
RK1001.C0101_allcombined	2747663	2747672		solA	9
RK1001.C0101_allcombined	2747858	2747859		solA	1
RK1001.C0101_allcombined	2748112	2748118		solA	6
RK1001.C0101_allcombined	2748574	2748580		YPO_RS13255	6
RK1001.C0101_allcombined	2748768	2748820		YPO_RS13255	52
RK1001.C0101_allcombined	2749053	2749066		YPO_RS13255	13
RK1001.C0101_allcombined	2749104	2749126		YPO_RS13255	22
RK1001.C0101_allcombined	2749505	2749514		YPO_RS13260	9
RK1001.C0101_allcombined	2749904	2749919		YPO_RS13265	15
RK1001.C0101_allcombined	2750750	2750751		YPO_RS13265	1
RK1001.C0101_allcombined	2750944	2750954		YPO_RS13270	10
RK1001.C0101_allcombined	2751282	2751284		YPO_RS13270	2
RK1001.C0101_allcombined	2751486	2751579		YPO_RS13270	93
RK1001.C0101_allcombined	2751693	2751705		YPO_RS13270	12
RK1001.C0101_allcombined	2751849	2751891		YPO_RS13270	42
RK1001.C0101_allcombined	2751957	2751972		YPO_RS13270	15
RK1001.C0101_allcombined	2753027	2753058		YPO_RS13280	31
RK1001.C0101_allcombined	2753221	2753234		YPO_RS13280	13
RK1001.C0101_allcombined	2753307	2753313		YPO_RS13280	6
RK1001.C0101_allcombined	2753421	2753427		YPO_RS13280	6
RK1001.C0101_allcombined	2754131	2754175		YPO_RS13285	44
RK1001.C0101_allcombined	2754468	2754482		YPO_RS13285	14
RK1001.C0101_allcombined	2754568	2754581		YPO_RS13285	13
RK1001.C0101_allcombined	2754763	2754774		YPO_RS13285	11
RK1001.C0101_allcombined	2754768	2754774		YPO_RS13290	6
RK1001.C0101_allcombined	2754817	2754862		YPO_RS13290	45
RK1001.C0101_allcombined	2755134	2755145		YPO_RS13290	11
RK1001.C0101_allcombined	2755177	2755183		YPO_RS13290	6
RK1001.C0101_allcombined	2755310	2755316		YPO_RS13290	6
RK1001.C0101_allcombined	2755377	2755389		YPO_RS13290	12
RK1001.C0101_allcombined	2755441	2755450		YPO_RS13290	9
RK1001.C0101_allcombined	2755504	2755505		YPO_RS13290	1
RK1001.C0101_allcombined	2756714	2756717		YPO_RS13295	3
RK1001.C0101_allcombined	2757227	2757235		YPO_RS13300	8
RK1001.C0101_allcombined	2757371	2757410		YPO_RS13305	39
RK1001.C0101_allcombined	2757503	2757523		YPO_RS13305	20
RK1001.C0101_allcombined	2757656	2757671		YPO_RS13305	15
RK1001.C0101_allcombined	2757752	2757762		YPO_RS13305	10
RK1001.C0101_allcombined	2758425	2758439		YPO_RS13305	14
RK1001.C0101_allcombined	2758572	2758592		YPO_RS13305	20
RK1001.C0101_allcombined	2758796	2758805		fae	9
RK1001.C0101_allcombined	2758897	2758900		fae	3
RK1001.C0101_allcombined	2759526	2759535		YPO_RS13315	9
RK1001.C0101_allcombined	2760478	2760491		cas6f	13
RK1001.C0101_allcombined	2760634	2760643		cas6f	9
RK1001.C0101_allcombined	2760934	2760936		cas6f	2
RK1001.C0101_allcombined	2761280	2761295		csy3	15
RK1001.C0101_allcombined	2761813	2761814		csy3	1
RK1001.C0101_allcombined	2761969	2761992		csy2	23
RK1001.C0101_allcombined	2762207	2762209		csy2	2
RK1001.C0101_allcombined	2763073	2763074		csy1	1
RK1001.C0101_allcombined	2763350	2763363		csy1	13
RK1001.C0101_allcombined	2763479	2763501		csy1	22
RK1001.C0101_allcombined	2763600	2763604		csy1	4
RK1001.C0101_allcombined	2763800	2763817		csy1	17
RK1001.C0101_allcombined	2763980	2764002		csy1	22
RK1001.C0101_allcombined	2764672	2764716		cas3f	44
RK1001.C0101_allcombined	2765010	2765024		cas3f	14
RK1001.C0101_allcombined	2765186	2765187		cas3f	1
RK1001.C0101_allcombined	2765346	2765352		cas3f	6
RK1001.C0101_allcombined	2765471	2765496		cas3f	25
RK1001.C0101_allcombined	2766068	2766078		cas3f	10
RK1001.C0101_allcombined	2766208	2766216		cas3f	8
RK1001.C0101_allcombined	2766909	2766941		cas3f	32
RK1001.C0101_allcombined	2767229	2767277		cas3f	48
RK1001.C0101_allcombined	2767309	2767314		cas3f	5
RK1001.C0101_allcombined	2767509	2767534		cas3f	25
RK1001.C0101_allcombined	2768186	2768233		cas1f	47
RK1001.C0101_allcombined	2768327	2768340		cas1f	13
RK1001.C0101_allcombined	2768436	2768440		cas1f	4
RK1001.C0101_allcombined	2768845	2768864		cas1f	19
RK1001.C0101_allcombined	2770140	2770148		YPO_RS13350	8
RK1001.C0101_allcombined	2770831	2770839		YPO_RS13350	8
RK1001.C0101_allcombined	2771268	2771274		YPO_RS13350	6
RK1001.C0101_allcombined	2772107	2772154		YPO_RS13355	47
RK1001.C0101_allcombined	2772473	2772478		YPO_RS13355	5
RK1001.C0101_allcombined	2772510	2772515		YPO_RS13355	5
RK1001.C0101_allcombined	2772871	2772920		YPO_RS13355	49
RK1001.C0101_allcombined	2773048	2773054		YPO_RS13355	6
RK1001.C0101_allcombined	2773095	2773114		YPO_RS13355	19
RK1001.C0101_allcombined	2773228	2773241		YPO_RS13355	13
RK1001.C0101_allcombined	2773280	2773285		YPO_RS13360	5
RK1001.C0101_allcombined	2773431	2773445		YPO_RS13360	14
RK1001.C0101_allcombined	2773514	2773530		YPO_RS13360	16
RK1001.C0101_allcombined	2773687	2773697		YPO_RS13360	10
RK1001.C0101_allcombined	2773755	2773796		YPO_RS13360	41
RK1001.C0101_allcombined	2773987	2774014		YPO_RS13360	27
RK1001.C0101_allcombined	2774268	2774278		YPO_RS13360	10
RK1001.C0101_allcombined	2774394	2774395		YPO_RS13360	1
RK1001.C0101_allcombined	2774644	2774694		YPO_RS13365	50
RK1001.C0101_allcombined	2775812	2775823		YPO_RS13370	11
RK1001.C0101_allcombined	2776690	2776720		YPO_RS13375	30
RK1001.C0101_allcombined	2777048	2777050		YPO_RS13375	2
RK1001.C0101_allcombined	2777086	2777103		YPO_RS13375	17
RK1001.C0101_allcombined	2777266	2777304		YPO_RS13375	38
RK1001.C0101_allcombined	2777345	2777396		YPO_RS13375	51
RK1001.C0101_allcombined	2777488	2777492		YPO_RS13375	4
RK1001.C0101_allcombined	2777834	2777849		YPO_RS13380	15
RK1001.C0101_allcombined	2778069	2778075		YPO_RS13380	6
RK1001.C0101_allcombined	2778140	2778151		YPO_RS13380	11
RK1001.C0101_allcombined	2778237	2778246		YPO_RS13380	9
RK1001.C0101_allcombined	2778318	2778325		YPO_RS13380	7
RK1001.C0101_allcombined	2778829	2778843		YPO_RS13385	14
RK1001.C0101_allcombined	2778880	2778898		YPO_RS13385	18
RK1001.C0101_allcombined	2780193	2780222		YPO_RS13390	29
RK1001.C0101_allcombined	2781120	2781140		YPO_RS13395	20
RK1001.C0101_allcombined	2781402	2781418		YPO_RS13395	16
RK1001.C0101_allcombined	2781723	2781747		YPO_RS13395	24
RK1001.C0101_allcombined	2781985	2782028		YPO_RS13395	43
RK1001.C0101_allcombined	2782186	2782201		YPO_RS13395	15
RK1001.C0101_allcombined	2782396	2782408		YPO_RS13395	12
RK1001.C0101_allcombined	2783941	2783956		YPO_RS13405	15
RK1001.C0101_allcombined	2784028	2784086		YPO_RS13405	58
RK1001.C0101_allcombined	2784188	2784255		YPO_RS13405	67
RK1001.C0101_allcombined	2784288	2784309		YPO_RS13405	21
RK1001.C0101_allcombined	2784752	2784761		YPO_RS13410	9
RK1001.C0101_allcombined	2784825	2784882		YPO_RS13410	57
RK1001.C0101_allcombined	2785011	2785032		YPO_RS13410	21
RK1001.C0101_allcombined	2785318	2785356		YPO_RS13415	38
RK1001.C0101_allcombined	2785401	2785431		YPO_RS13415	30
RK1001.C0101_allcombined	2785601	2785634		YPO_RS13415	33
RK1001.C0101_allcombined	2786262	2786281		YPO_RS13425	19
RK1001.C0101_allcombined	2786419	2786460		YPO_RS13430	41
RK1001.C0101_allcombined	2786540	2786604		YPO_RS13430	64
RK1001.C0101_allcombined	2786645	2786659		YPO_RS13430	14
RK1001.C0101_allcombined	2786706	2786711		YPO_RS13430	5
RK1001.C0101_allcombined	2786831	2786842		YPO_RS13430	11
RK1001.C0101_allcombined	2786918	2786942		YPO_RS13430	24
RK1001.C0101_allcombined	2786997	2787046		YPO_RS13430	49
RK1001.C0101_allcombined	2787575	2787590		YPO_RS13430	15
RK1001.C0101_allcombined	2787625	2787647		YPO_RS13430	22
RK1001.C0101_allcombined	2788628	2788652		YPO_RS13435	24
RK1001.C0101_allcombined	2788765	2788883		YPO_RS13435	118
RK1001.C0101_allcombined	2788916	2788927		YPO_RS13435	11
RK1001.C0101_allcombined	2789226	2789260		YPO_RS13440	34
RK1001.C0101_allcombined	2789355	2789364		YPO_RS13440	9
RK1001.C0101_allcombined	2789638	2789647		YPO_RS13445	9
RK1001.C0101_allcombined	2789821	2789834		YPO_RS13445	13
RK1001.C0101_allcombined	2789889	2789934		YPO_RS13445	45
RK1001.C0101_allcombined	2790063	2790121		YPO_RS13445	58
RK1001.C0101_allcombined	2790123	2790133		cdiA	10
RK1001.C0101_allcombined	2790166	2790169		cdiA	3
RK1001.C0101_allcombined	2790208	2790265		cdiA	57
RK1001.C0101_allcombined	2790608	2790616		cdiA	8
RK1001.C0101_allcombined	2791908	2791913		cdiA	5
RK1001.C0101_allcombined	2792627	2792646		cdiA	19
RK1001.C0101_allcombined	2794181	2794182		cdiA	1
RK1001.C0101_allcombined	2794471	2794491		cdiA	20
RK1001.C0101_allcombined	2794969	2795000		cdiA	31
RK1001.C0101_allcombined	2795834	2795858		cdiA	24
RK1001.C0101_allcombined	2795974	2795976		cdiA	2
RK1001.C0101_allcombined	2796454	2796470		cdiA	16
RK1001.C0101_allcombined	2796573	2796585		cdiA	12
RK1001.C0101_allcombined	2797193	2797199		cdiA	6
RK1001.C0101_allcombined	2797979	2797984		YPO_RS13455	5
RK1001.C0101_allcombined	2798084	2798111		YPO_RS13455	27
RK1001.C0101_allcombined	2798227	2798230		YPO_RS13455	3
RK1001.C0101_allcombined	2798399	2798403		YPO_RS13455	4
RK1001.C0101_allcombined	2800365	2800368		YPO_RS13460	3
RK1001.C0101_allcombined	2800580	2800605		YPO_RS13460	25
RK1001.C0101_allcombined	2801329	2801330		YPO_RS13465	1
RK1001.C0101_allcombined	2801633	2801639		YPO_RS13465	6
RK1001.C0101_allcombined	2801800	2801813		YPO_RS13465	13
RK1001.C0101_allcombined	2802052	2802086		YPO_RS13465	34
RK1001.C0101_allcombined	2802779	2802805		YPO_RS13470	26
RK1001.C0101_allcombined	2803016	2803081		YPO_RS13470	65
RK1001.C0101_allcombined	2803425	2803433		YPO_RS13470	8
RK1001.C0101_allcombined	2803585	2803610		YPO_RS13470	25
RK1001.C0101_allcombined	2803831	2803863		YPO_RS13470	32
RK1001.C0101_allcombined	2803918	2803922		YPO_RS13470	4
RK1001.C0101_allcombined	2804814	2804816		YPO_RS13475	2
RK1001.C0101_allcombined	2805005	2805034		YPO_RS13475	29
RK1001.C0101_allcombined	2805209	2805216		YPO_RS13475	7
RK1001.C0101_allcombined	2805707	2805716		YPO_RS13475	9
RK1001.C0101_allcombined	2805790	2805799		YPO_RS13475	9
RK1001.C0101_allcombined	2807251	2807254		YPO_RS13485	3
RK1001.C0101_allcombined	2807363	2807388		YPO_RS13485	25
RK1001.C0101_allcombined	2807654	2807667		YPO_RS13485	13
RK1001.C0101_allcombined	2807729	2807861		YPO_RS13485	132
RK1001.C0101_allcombined	2807947	2807969		YPO_RS13485	22
RK1001.C0101_allcombined	2808093	2808096		YPO_RS13485	3
RK1001.C0101_allcombined	2808684	2808720		YPO_RS13490	36
RK1001.C0101_allcombined	2808799	2808829		YPO_RS13490	30
RK1001.C0101_allcombined	2809270	2809275		YPO_RS13490	5
RK1001.C0101_allcombined	2810216	2810223		YPO_RS13495	7
RK1001.C0101_allcombined	2810617	2810624		YPO_RS13495	7
RK1001.C0101_allcombined	2811249	2811255		YPO_RS13500	6
RK1001.C0101_allcombined	2811903	2811924		YPO_RS13505	21
RK1001.C0101_allcombined	2812270	2812286		YPO_RS13505	16
RK1001.C0101_allcombined	2812436	2812464		YPO_RS13505	28
RK1001.C0101_allcombined	2812508	2812522		YPO_RS13505	14
RK1001.C0101_allcombined	2813712	2813755		YPO_RS13510	43
RK1001.C0101_allcombined	2813786	2813804		YPO_RS13510	18
RK1001.C0101_allcombined	2813885	2813917		YPO_RS13510	32
RK1001.C0101_allcombined	2813948	2814004		YPO_RS13510	56
RK1001.C0101_allcombined	2814067	2814103		YPO_RS13510	36
RK1001.C0101_allcombined	2814135	2814270		YPO_RS13510	135
RK1001.C0101_allcombined	2814357	2814380		YPO_RS13510	23
RK1001.C0101_allcombined	2814622	2814655		YPO_RS13515	33
RK1001.C0101_allcombined	2814712	2814725		YPO_RS13515	13
RK1001.C0101_allcombined	2814855	2814865		YPO_RS13515	10
RK1001.C0101_allcombined	2814992	2815006		YPO_RS13515	14
RK1001.C0101_allcombined	2815537	2815553		YPO_RS13520	16
RK1001.C0101_allcombined	2815670	2815691		YPO_RS13520	21
RK1001.C0101_allcombined	2815891	2815895		YPO_RS13520	4
RK1001.C0101_allcombined	2816119	2816120		YPO_RS13520	1
RK1001.C0101_allcombined	2816168	2816200		YPO_RS13520	32
RK1001.C0101_allcombined	2816293	2816294		YPO_RS13520	1
RK1001.C0101_allcombined	2816638	2816651		ompX	13
RK1001.C0101_allcombined	2816826	2816859		ompX	33
RK1001.C0101_allcombined	2817543	2817546		rhtA	3
RK1001.C0101_allcombined	2817776	2817793		rhtA	17
RK1001.C0101_allcombined	2819073	2819087		tam	14
RK1001.C0101_allcombined	2820041	2820049		dps	8
RK1001.C0101_allcombined	2820427	2820435		dps	8
RK1001.C0101_allcombined	2821040	2821085		YPO_RS13550	45
RK1001.C0101_allcombined	2821128	2821186		YPO_RS13550	58
RK1001.C0101_allcombined	2821362	2821363		YPO_RS13550	1
RK1001.C0101_allcombined	2821573	2821622		YPO_RS13550	49
RK1001.C0101_allcombined	2821790	2821792		YPO_RS13550	2
RK1001.C0101_allcombined	2823078	2823087		glnH	9
RK1001.C0101_allcombined	2823151	2823167		glnH	16
RK1001.C0101_allcombined	2823230	2823258		glnH	28
RK1001.C0101_allcombined	2823526	2823530		glnP	4
RK1001.C0101_allcombined	2823865	2823867		glnP	2
RK1001.C0101_allcombined	2823927	2823949		glnP	22
RK1001.C0101_allcombined	2823946	2823995		glnQ	49
RK1001.C0101_allcombined	2824030	2824051		glnQ	21
RK1001.C0101_allcombined	2824133	2824140		glnQ	7
RK1001.C0101_allcombined	2824315	2824322		glnQ	7
RK1001.C0101_allcombined	2824908	2824909		YPO_RS13570	1
RK1001.C0101_allcombined	2825043	2825050		YPO_RS13570	7
RK1001.C0101_allcombined	2825750	2825751		YPO_RS13570	1
RK1001.C0101_allcombined	2825890	2825891		YPO_RS13570	1
RK1001.C0101_allcombined	2826035	2826048		YPO_RS13570	13
RK1001.C0101_allcombined	2826120	2826125		YPO_RS13570	5
RK1001.C0101_allcombined	2826303	2826308		YPO_RS13575	5
RK1001.C0101_allcombined	2828440	2828458		YPO_RS13585	18
RK1001.C0101_allcombined	2829500	2829507		rlmF	7
RK1001.C0101_allcombined	2829696	2829724		rlmF	28
RK1001.C0101_allcombined	2829808	2829811		rlmF	3
RK1001.C0101_allcombined	2829867	2829881		rlmF	14
RK1001.C0101_allcombined	2831167	2831200		ybiB	33
RK1001.C0101_allcombined	2831343	2831346		ybiB	3
RK1001.C0101_allcombined	2831574	2831583		ybiB	9
RK1001.C0101_allcombined	2832550	2832575		menE	25
RK1001.C0101_allcombined	2833788	2833797		menC	9
RK1001.C0101_allcombined	2834234	2834236		menC	2
RK1001.C0101_allcombined	2835121	2835124		menB	3
RK1001.C0101_allcombined	2836027	2836059		menD	32
RK1001.C0101_allcombined	2837122	2837133		menD	11
RK1001.C0101_allcombined	2837338	2837341		menD	3
RK1001.C0101_allcombined	2838299	2838304		menF	5
RK1001.C0101_allcombined	2838829	2838849		menF	20
RK1001.C0101_allcombined	2839779	2839781		YPO_RS13635	2
RK1001.C0101_allcombined	2839926	2839933		YPO_RS13635	7
RK1001.C0101_allcombined	2840370	2840423		YPO_RS13635	53
RK1001.C0101_allcombined	2842509	2842525		YPO_RS13645	16
RK1001.C0101_allcombined	2842766	2842773		YPO_RS13645	7
RK1001.C0101_allcombined	2842860	2842868		YPO_RS13645	8
RK1001.C0101_allcombined	2843237	2843262		YPO_RS13645	25
RK1001.C0101_allcombined	2843720	2843729		YPO_RS13645	9
RK1001.C0101_allcombined	2843850	2843868		YPO_RS13645	18
RK1001.C0101_allcombined	2844141	2844158		YPO_RS13650	17
RK1001.C0101_allcombined	2844802	2844810		YPO_RS13655	8
RK1001.C0101_allcombined	2845044	2845048		YPO_RS13655	4
RK1001.C0101_allcombined	2845090	2845105		YPO_RS13655	15
RK1001.C0101_allcombined	2845411	2845422		YPO_RS13655	11
RK1001.C0101_allcombined	2846500	2846522		YPO_RS13660	22
RK1001.C0101_allcombined	2847177	2847189		YPO_RS13660	12
RK1001.C0101_allcombined	2847281	2847301		YPO_RS13660	20
RK1001.C0101_allcombined	2847954	2847974		YPO_RS13665	20
RK1001.C0101_allcombined	2848554	2848562		YPO_RS13665	8
RK1001.C0101_allcombined	2848759	2848760		YPO_RS13665	1
RK1001.C0101_allcombined	2848877	2848880		YPO_RS13665	3
RK1001.C0101_allcombined	2849377	2849379		YPO_RS13670	2
RK1001.C0101_allcombined	2849517	2849537		YPO_RS13670	20
RK1001.C0101_allcombined	2849710	2849744		YPO_RS13670	34
RK1001.C0101_allcombined	2849790	2849806		YPO_RS13670	16
RK1001.C0101_allcombined	2850015	2850065		YPO_RS13670	50
RK1001.C0101_allcombined	2850626	2850632		YPO_RS13670	6
RK1001.C0101_allcombined	2851449	2851477		idnO	28
RK1001.C0101_allcombined	2851811	2851821		idnO	10
RK1001.C0101_allcombined	2851882	2851910		idnO	28
RK1001.C0101_allcombined	2852553	2852567		YPO_RS13680	14
RK1001.C0101_allcombined	2853061	2853070		YPO_RS13685	9
RK1001.C0101_allcombined	2853651	2853683		YPO_RS13690	32
RK1001.C0101_allcombined	2853961	2853965		YPO_RS13690	4
RK1001.C0101_allcombined	2854069	2854096		YPO_RS13690	27
RK1001.C0101_allcombined	2854168	2854200		YPO_RS13690	32
RK1001.C0101_allcombined	2854239	2854248		YPO_RS13690	9
RK1001.C0101_allcombined	2854310	2854350		YPO_RS13690	40
RK1001.C0101_allcombined	2854400	2854443		YPO_RS13690	43
RK1001.C0101_allcombined	2854538	2854570		YPO_RS13690	32
RK1001.C0101_allcombined	2854619	2854669		YPO_RS13690	50
RK1001.C0101_allcombined	2854704	2854710		YPO_RS13690	6
RK1001.C0101_allcombined	2854762	2854778		YPO_RS13690	16
RK1001.C0101_allcombined	2854809	2854816		YPO_RS13690	7
RK1001.C0101_allcombined	2855151	2855181		nuoN	30
RK1001.C0101_allcombined	2855751	2855798		nuoN	47
RK1001.C0101_allcombined	2855830	2855850		nuoN	20
RK1001.C0101_allcombined	2856129	2856140		nuoN	11
RK1001.C0101_allcombined	2856650	2856673		nuoM	23
RK1001.C0101_allcombined	2857085	2857101		nuoM	16
RK1001.C0101_allcombined	2857606	2857639		nuoM	33
RK1001.C0101_allcombined	2857795	2857798		nuoM	3
RK1001.C0101_allcombined	2858179	2858182		nuoL	3
RK1001.C0101_allcombined	2858497	2858500		nuoL	3
RK1001.C0101_allcombined	2858818	2858820		nuoL	2
RK1001.C0101_allcombined	2859114	2859121		nuoL	7
RK1001.C0101_allcombined	2860037	2860043		nuoK	6
RK1001.C0101_allcombined	2860969	2860977		nuoI	8
RK1001.C0101_allcombined	2861117	2861123		nuoI	6
RK1001.C0101_allcombined	2861353	2861356		nuoI	3
RK1001.C0101_allcombined	2862122	2862126		nuoH	4
RK1001.C0101_allcombined	2862355	2862360		nuoG	5
RK1001.C0101_allcombined	2862573	2862580		nuoG	7
RK1001.C0101_allcombined	2862746	2862779		nuoG	33
RK1001.C0101_allcombined	2864007	2864009		nuoG	2
RK1001.C0101_allcombined	2864188	2864204		nuoG	16
RK1001.C0101_allcombined	2864246	2864271		nuoG	25
RK1001.C0101_allcombined	2864762	2864804		nuoG	42
RK1001.C0101_allcombined	2864868	2864875		nuoG	7
RK1001.C0101_allcombined	2864905	2864908		nuoG	3
RK1001.C0101_allcombined	2866208	2866213		nuoF	5
RK1001.C0101_allcombined	2866473	2866495		nuoF	22
RK1001.C0101_allcombined	2866643	2866644		nuoE	1
RK1001.C0101_allcombined	2866757	2866775		nuoE	18
RK1001.C0101_allcombined	2867140	2867150		nuoC	10
RK1001.C0101_allcombined	2867271	2867291		nuoC	20
RK1001.C0101_allcombined	2867927	2867941		nuoC	14
RK1001.C0101_allcombined	2868394	2868410		nuoC	16
RK1001.C0101_allcombined	2869617	2869630		YPO_RS13750	13
RK1001.C0101_allcombined	2869711	2869737		YPO_RS13750	26
RK1001.C0101_allcombined	2870081	2870102		YPO_RS13755	21
RK1001.C0101_allcombined	2871035	2871061		lrhA	26
RK1001.C0101_allcombined	2871106	2871107		lrhA	1
RK1001.C0101_allcombined	2871156	2871163		lrhA	7
RK1001.C0101_allcombined	2871236	2871270		lrhA	34
RK1001.C0101_allcombined	2871394	2871398		lrhA	4
RK1001.C0101_allcombined	2871490	2871492		lrhA	2
RK1001.C0101_allcombined	2871670	2871697		lrhA	27
RK1001.C0101_allcombined	2871950	2871953		lrhA	3
RK1001.C0101_allcombined	2872868	2872892		YPO_RS13765	24
RK1001.C0101_allcombined	2873104	2873165		YPO_RS13765	61
RK1001.C0101_allcombined	2873513	2873520		YPO_RS13765	7
RK1001.C0101_allcombined	2873898	2873907		YPO_RS13765	9
RK1001.C0101_allcombined	2874017	2874023		YPO_RS13765	6
RK1001.C0101_allcombined	2874311	2874358		yfbR	47
RK1001.C0101_allcombined	2874406	2874441		yfbR	35
RK1001.C0101_allcombined	2874512	2874564		yfbR	52
RK1001.C0101_allcombined	2874648	2874665		yfbR	17
RK1001.C0101_allcombined	2875893	2875912		YPO_RS13775	19
RK1001.C0101_allcombined	2877845	2877874		YPO_RS13780	29
RK1001.C0101_allcombined	2878202	2878221		YPO_RS13785	19
RK1001.C0101_allcombined	2878366	2878374		YPO_RS13785	8
RK1001.C0101_allcombined	2878542	2878549		YPO_RS13785	7
RK1001.C0101_allcombined	2879073	2879080		YPO_RS13790	7
RK1001.C0101_allcombined	2880357	2880365		ackA	8
RK1001.C0101_allcombined	2880435	2880483		ackA	48
RK1001.C0101_allcombined	2880562	2880568		ackA	6
RK1001.C0101_allcombined	2881615	2881616		pta	1
RK1001.C0101_allcombined	2882390	2882404		pta	14
RK1001.C0101_allcombined	2882479	2882491		pta	12
RK1001.C0101_allcombined	2882599	2882613		pta	14
RK1001.C0101_allcombined	2882671	2882678		pta	7
RK1001.C0101_allcombined	2882962	2882963		pta	1
RK1001.C0101_allcombined	2883536	2883541		YPO_RS13805	5
RK1001.C0101_allcombined	2883634	2883642		YPO_RS13805	8
RK1001.C0101_allcombined	2884099	2884116		YPO_RS13805	17
RK1001.C0101_allcombined	2884947	2884948		YPO_RS13810	1
RK1001.C0101_allcombined	2885302	2885317		YPO_RS13810	15
RK1001.C0101_allcombined	2885538	2885559		YPO_RS13815	21
RK1001.C0101_allcombined	2885594	2885600		YPO_RS13815	6
RK1001.C0101_allcombined	2885770	2885790		YPO_RS13815	20
RK1001.C0101_allcombined	2885812	2885834		YPO_RS13820	22
RK1001.C0101_allcombined	2887076	2887094		YPO_RS13825	18
RK1001.C0101_allcombined	2887262	2887278		YPO_RS13825	16
RK1001.C0101_allcombined	2887416	2887419		YPO_RS13825	3
RK1001.C0101_allcombined	2887796	2887815		YPO_RS13825	19
RK1001.C0101_allcombined	2888114	2888126		YPO_RS13830	12
RK1001.C0101_allcombined	2888615	2888616		YPO_RS13830	1
RK1001.C0101_allcombined	2888757	2888774		YPO_RS13830	17
RK1001.C0101_allcombined	2889047	2889070		YPO_RS13830	23
RK1001.C0101_allcombined	2889269	2889279		YPO_RS13830	10
RK1001.C0101_allcombined	2889847	2889876		YPO_RS13830	29
RK1001.C0101_allcombined	2890042	2890075		YPO_RS13830	33
RK1001.C0101_allcombined	2890335	2890360		YPO_RS13830	25
RK1001.C0101_allcombined	2890723	2890733		YPO_RS13830	10
RK1001.C0101_allcombined	2890873	2890874		YPO_RS13830	1
RK1001.C0101_allcombined	2891053	2891065		YPO_RS13830	12
RK1001.C0101_allcombined	2891643	2891661		YPO_RS13830	18
RK1001.C0101_allcombined	2892644	2892657		YPO_RS13830	13
RK1001.C0101_allcombined	2893731	2893737		YPO_RS13830	6
RK1001.C0101_allcombined	2893925	2893934		YPO_RS13830	9
RK1001.C0101_allcombined	2894374	2894387		YPO_RS13835	13
RK1001.C0101_allcombined	2894484	2894493		YPO_RS13835	9
RK1001.C0101_allcombined	2895716	2895734		YPO_RS13840	18
RK1001.C0101_allcombined	2896016	2896027		YPO_RS13840	11
RK1001.C0101_allcombined	2897625	2897653		YPO_RS13845	28
RK1001.C0101_allcombined	2898079	2898095		YPO_RS13845	16
RK1001.C0101_allcombined	2898376	2898381		iolD	5
RK1001.C0101_allcombined	2899137	2899155		iolD	18
RK1001.C0101_allcombined	2899267	2899281		iolD	14
RK1001.C0101_allcombined	2899694	2899695		iolD	1
RK1001.C0101_allcombined	2899699	2899708		iolD	9
RK1001.C0101_allcombined	2899957	2899964		iolD	7
RK1001.C0101_allcombined	2901713	2901715		YPO_RS13860	2
RK1001.C0101_allcombined	2902186	2902198		YPO_RS13860	12
RK1001.C0101_allcombined	2902405	2902409		YPO_RS13860	4
RK1001.C0101_allcombined	2902711	2902738		YPO_RS13865	27
RK1001.C0101_allcombined	2903331	2903340		YPO_RS13865	9
RK1001.C0101_allcombined	2903663	2903685		YPO_RS13865	22
RK1001.C0101_allcombined	2904023	2904031		YPO_RS13865	8
RK1001.C0101_allcombined	2904522	2904527		YPO_RS13870	5
RK1001.C0101_allcombined	2905502	2905506		YPO_RS13875	4
RK1001.C0101_allcombined	2905639	2905658		YPO_RS13875	19
RK1001.C0101_allcombined	2906422	2906424		iolC	2
RK1001.C0101_allcombined	2906647	2906655		iolC	8
RK1001.C0101_allcombined	2906764	2906765		iolC	1
RK1001.C0101_allcombined	2907234	2907254		iolC	20
RK1001.C0101_allcombined	2908194	2908200		iolC	6
RK1001.C0101_allcombined	2908545	2908553		iolE	8
RK1001.C0101_allcombined	2908858	2908882		iolE	24
RK1001.C0101_allcombined	2909334	2909340		iolE	6
RK1001.C0101_allcombined	2909464	2909465		iolE	1
RK1001.C0101_allcombined	2909475	2909507		iolB	32
RK1001.C0101_allcombined	2910263	2910290		iolB	27
RK1001.C0101_allcombined	2910493	2910505		YPO_RS13895	12
RK1001.C0101_allcombined	2910639	2910645		YPO_RS13895	6
RK1001.C0101_allcombined	2910860	2910864		YPO_RS13900	4
RK1001.C0101_allcombined	2910921	2910988		YPO_RS13900	67
RK1001.C0101_allcombined	2911070	2911072		YPO_RS13900	2
RK1001.C0101_allcombined	2911157	2911165		YPO_RS13900	8
RK1001.C0101_allcombined	2911245	2911246		YPO_RS13900	1
RK1001.C0101_allcombined	2911394	2911395		YPO_RS13900	1
RK1001.C0101_allcombined	2911487	2911513		YPO_RS13900	26
RK1001.C0101_allcombined	2911681	2911697		YPO_RS13900	16
RK1001.C0101_allcombined	2911745	2911773		YPO_RS13900	28
RK1001.C0101_allcombined	2912606	2912610		YPO_RS13900	4
RK1001.C0101_allcombined	2912763	2912765		YPO_RS13905	2
RK1001.C0101_allcombined	2912815	2912901		YPO_RS13905	86
RK1001.C0101_allcombined	2913582	2913590		YPO_RS13910	8
RK1001.C0101_allcombined	2913608	2913616		YPO_RS13915	8
RK1001.C0101_allcombined	2913972	2914023		YPO_RS13920	51
RK1001.C0101_allcombined	2914113	2914123		YPO_RS13920	10
RK1001.C0101_allcombined	2914175	2914181		YPO_RS13920	6
RK1001.C0101_allcombined	2914323	2914332		YPO_RS13920	9
RK1001.C0101_allcombined	2914478	2914507		YPO_RS13920	29
RK1001.C0101_allcombined	2914542	2914559		YPO_RS13920	17
RK1001.C0101_allcombined	2914589	2914605		YPO_RS13920	16
RK1001.C0101_allcombined	2914674	2914713		YPO_RS13920	39
RK1001.C0101_allcombined	2914843	2914863		YPO_RS13920	20
RK1001.C0101_allcombined	2915422	2915425		YPO_RS13925	3
RK1001.C0101_allcombined	2915456	2915463		YPO_RS13925	7
RK1001.C0101_allcombined	2915569	2915577		YPO_RS13925	8
RK1001.C0101_allcombined	2915620	2915674		YPO_RS13925	54
RK1001.C0101_allcombined	2915766	2915779		YPO_RS13925	13
RK1001.C0101_allcombined	2915832	2915844		YPO_RS13925	12
RK1001.C0101_allcombined	2915881	2915885		YPO_RS13925	4
RK1001.C0101_allcombined	2915934	2915977		YPO_RS13925	43
RK1001.C0101_allcombined	2917934	2917940		crcB	6
RK1001.C0101_allcombined	2918639	2918643		tatA	4
RK1001.C0101_allcombined	2919612	2919638		lipA	26
RK1001.C0101_allcombined	2919803	2919824		lipA	21
RK1001.C0101_allcombined	2920262	2920263		lipB	1
RK1001.C0101_allcombined	2920498	2920533		lipB	35
RK1001.C0101_allcombined	2920702	2920714		lipB	12
RK1001.C0101_allcombined	2921177	2921219		YPO_RS13960	42
RK1001.C0101_allcombined	2921294	2921295		YPO_RS13960	1
RK1001.C0101_allcombined	2921725	2921728		dacA	3
RK1001.C0101_allcombined	2921796	2921801		dacA	5
RK1001.C0101_allcombined	2921950	2921959		dacA	9
RK1001.C0101_allcombined	2922115	2922123		dacA	8
RK1001.C0101_allcombined	2922184	2922204		dacA	20
RK1001.C0101_allcombined	2922293	2922296		dacA	3
RK1001.C0101_allcombined	2923810	2923841		rlpA	31
RK1001.C0101_allcombined	2924040	2924047		rlpA	7
RK1001.C0101_allcombined	2924083	2924101		rlpA	18
RK1001.C0101_allcombined	2925183	2925193		mrdB	10
RK1001.C0101_allcombined	2925375	2925387		mrdB	12
RK1001.C0101_allcombined	2925677	2925683		mrdA	6
RK1001.C0101_allcombined	2925761	2925764		mrdA	3
RK1001.C0101_allcombined	2925797	2925801		mrdA	4
RK1001.C0101_allcombined	2925977	2925982		mrdA	5
RK1001.C0101_allcombined	2926079	2926083		mrdA	4
RK1001.C0101_allcombined	2926216	2926237		mrdA	21
RK1001.C0101_allcombined	2926460	2926483		mrdA	23
RK1001.C0101_allcombined	2926546	2926553		mrdA	7
RK1001.C0101_allcombined	2926682	2926756		mrdA	74
RK1001.C0101_allcombined	2926834	2926841		mrdA	7
RK1001.C0101_allcombined	2927382	2927396		mrdA	14
RK1001.C0101_allcombined	2928617	2928638		nadD	21
RK1001.C0101_allcombined	2928684	2928718		nadD	34
RK1001.C0101_allcombined	2929635	2929641		holA	6
RK1001.C0101_allcombined	2929898	2929904		holA	6
RK1001.C0101_allcombined	2930488	2930490		lptE	2
RK1001.C0101_allcombined	2930674	2930699		lptE	25
RK1001.C0101_allcombined	2930739	2930746		lptE	7
RK1001.C0101_allcombined	2930817	2930818		lptE	1
RK1001.C0101_allcombined	2931197	2931208		leuS	11
RK1001.C0101_allcombined	2931758	2931780		leuS	22
RK1001.C0101_allcombined	2931857	2931882		leuS	25
RK1001.C0101_allcombined	2932045	2932051		leuS	6
RK1001.C0101_allcombined	2932199	2932201		leuS	2
RK1001.C0101_allcombined	2933056	2933058		leuS	2
RK1001.C0101_allcombined	2933089	2933090		leuS	1
RK1001.C0101_allcombined	2933172	2933177		leuS	5
RK1001.C0101_allcombined	2933347	2933405		leuS	58
RK1001.C0101_allcombined	2933756	2933781		YPO_RS14015	25
RK1001.C0101_allcombined	2934041	2934051		YPO_RS14015	10
RK1001.C0101_allcombined	2935022	2935044		YPO_RS14020	22
RK1001.C0101_allcombined	2935082	2935092		YPO_RS14020	10
RK1001.C0101_allcombined	2935135	2935138		gltK	3
RK1001.C0101_allcombined	2935268	2935291		gltK	23
RK1001.C0101_allcombined	2935685	2935691		gltK	6
RK1001.C0101_allcombined	2935725	2935735		gltK	10
RK1001.C0101_allcombined	2936253	2936295		YPO_RS14030	42
RK1001.C0101_allcombined	2936485	2936487		YPO_RS14030	2
RK1001.C0101_allcombined	2936685	2936696		YPO_RS14035	11
RK1001.C0101_allcombined	2937157	2937210		YPO_RS14035	53
RK1001.C0101_allcombined	2938783	2938831		lnt	48
RK1001.C0101_allcombined	2939234	2939240		lnt	6
RK1001.C0101_allcombined	2939416	2939432		lnt	16
RK1001.C0101_allcombined	2939852	2939856		lnt	4
RK1001.C0101_allcombined	2939886	2939914		lnt	28
RK1001.C0101_allcombined	2940099	2940106		corC	7
RK1001.C0101_allcombined	2940727	2940741		corC	14
RK1001.C0101_allcombined	2941562	2941563		YPO_RS14055	1
RK1001.C0101_allcombined	2942195	2942202		YPO_RS14055	7
RK1001.C0101_allcombined	2942431	2942436		YPO_RS14055	5
RK1001.C0101_allcombined	2942951	2942959		miaB	8
RK1001.C0101_allcombined	2943045	2943062		miaB	17
RK1001.C0101_allcombined	2943170	2943177		miaB	7
RK1001.C0101_allcombined	2943216	2943217		miaB	1
RK1001.C0101_allcombined	2943985	2943989		miaB	4
RK1001.C0101_allcombined	2944020	2944032		miaB	12
RK1001.C0101_allcombined	2947018	2947019		asnB	1
RK1001.C0101_allcombined	2947916	2947932		asnB	16
RK1001.C0101_allcombined	2948207	2948236		asnB	29
RK1001.C0101_allcombined	2948311	2948338		asnB	27
RK1001.C0101_allcombined	2948583	2948597		asnB	14
RK1001.C0101_allcombined	2949678	2949719		YPO_RS14100	41
RK1001.C0101_allcombined	2949830	2949831		YPO_RS14105	1
RK1001.C0101_allcombined	2950049	2950055		YPO_RS14105	6
RK1001.C0101_allcombined	2950119	2950129		YPO_RS14105	10
RK1001.C0101_allcombined	2950255	2950264		YPO_RS14105	9
RK1001.C0101_allcombined	2950599	2950611		YPO_RS14105	12
RK1001.C0101_allcombined	2950716	2950730		YPO_RS14105	14
RK1001.C0101_allcombined	2950938	2950978		YPO_RS14105	40
RK1001.C0101_allcombined	2951055	2951057		nagA	2
RK1001.C0101_allcombined	2951759	2951779		nagA	20
RK1001.C0101_allcombined	2951810	2951819		nagA	9
RK1001.C0101_allcombined	2951883	2951897		nagA	14
RK1001.C0101_allcombined	2952132	2952140		nagA	8
RK1001.C0101_allcombined	2952174	2952180		nagA	6
RK1001.C0101_allcombined	2952584	2952587		nagB	3
RK1001.C0101_allcombined	2952728	2952731		nagB	3
RK1001.C0101_allcombined	2952999	2953000		nagB	1
RK1001.C0101_allcombined	2953603	2953613		YPO_RS14120	10
RK1001.C0101_allcombined	2953863	2953870		YPO_RS14120	7
RK1001.C0101_allcombined	2953911	2953955		YPO_RS14120	44
RK1001.C0101_allcombined	2954481	2954547		YPO_RS14120	66
RK1001.C0101_allcombined	2954745	2954806		YPO_RS14120	61
RK1001.C0101_allcombined	2954928	2954929		YPO_RS14120	1
RK1001.C0101_allcombined	2955238	2955249		YPO_RS14120	11
RK1001.C0101_allcombined	2955778	2955786		YPO_RS14125	8
RK1001.C0101_allcombined	2956367	2956395		glnS	28
RK1001.C0101_allcombined	2956635	2956639		glnS	4
RK1001.C0101_allcombined	2956731	2956739		glnS	8
RK1001.C0101_allcombined	2957035	2957050		glnS	15
RK1001.C0101_allcombined	2957479	2957489		glnS	10
RK1001.C0101_allcombined	2959323	2959340		YPO_RS14135	17
RK1001.C0101_allcombined	2959834	2959848		YPO_RS14135	14
RK1001.C0101_allcombined	2960108	2960152		YPO_RS14135	44
RK1001.C0101_allcombined	2963585	2963591		fur	6
RK1001.C0101_allcombined	2963794	2963814		fur	20
RK1001.C0101_allcombined	2963902	2963918		fur	16
RK1001.C0101_allcombined	2966173	2966190		ybfF	17
RK1001.C0101_allcombined	2968016	2968018		YPO_RS14170	2
RK1001.C0101_allcombined	2970048	2970053		YPO_RS14190	5
RK1001.C0101_allcombined	2972751	2972757		proX	6
RK1001.C0101_allcombined	2972875	2972904		proW	29
RK1001.C0101_allcombined	2973184	2973212		proW	28
RK1001.C0101_allcombined	2973425	2973450		proW	25
RK1001.C0101_allcombined	2973496	2973500		proW	4
RK1001.C0101_allcombined	2973651	2973656		proW	5
RK1001.C0101_allcombined	2974453	2974461		proV	8
RK1001.C0101_allcombined	2974514	2974529		proV	15
RK1001.C0101_allcombined	2974621	2974630		proV	9
RK1001.C0101_allcombined	2974737	2974757		proV	20
RK1001.C0101_allcombined	2974833	2974862		proV	29
RK1001.C0101_allcombined	2975096	2975100		proV	4
RK1001.C0101_allcombined	2976105	2976137		nrdF	32
RK1001.C0101_allcombined	2976292	2976372		nrdF	80
RK1001.C0101_allcombined	2976449	2976491		nrdF	42
RK1001.C0101_allcombined	2976554	2976562		nrdF	8
RK1001.C0101_allcombined	2976594	2976619		nrdF	25
RK1001.C0101_allcombined	2976831	2976839		nrdF	8
RK1001.C0101_allcombined	2976980	2977003		nrdE	23
RK1001.C0101_allcombined	2977206	2977209		nrdE	3
RK1001.C0101_allcombined	2977308	2977316		nrdE	8
RK1001.C0101_allcombined	2977875	2977878		nrdE	3
RK1001.C0101_allcombined	2977995	2978008		nrdE	13
RK1001.C0101_allcombined	2978135	2978137		nrdE	2
RK1001.C0101_allcombined	2978209	2978253		nrdE	44
RK1001.C0101_allcombined	2978340	2978346		nrdE	6
RK1001.C0101_allcombined	2978404	2978412		nrdE	8
RK1001.C0101_allcombined	2978753	2978759		nrdE	6
RK1001.C0101_allcombined	2978792	2978800		nrdE	8
RK1001.C0101_allcombined	2978868	2978919		nrdE	51
RK1001.C0101_allcombined	2979135	2979170		nrdI	35
RK1001.C0101_allcombined	2979337	2979365		nrdI	28
RK1001.C0101_allcombined	2980562	2980569		YPO_RS14235	7
RK1001.C0101_allcombined	2981100	2981108		YPO_RS14240	8
RK1001.C0101_allcombined	2981163	2981183		YPO_RS14240	20
RK1001.C0101_allcombined	2981303	2981306		YPO_RS14240	3
RK1001.C0101_allcombined	2981339	2981348		YPO_RS14240	9
RK1001.C0101_allcombined	2981878	2981882		YPO_RS14245	4
RK1001.C0101_allcombined	2983548	2983556		YPO_RS14250	8
RK1001.C0101_allcombined	2984316	2984318		cspA	2
RK1001.C0101_allcombined	2986317	2986337		YPO_RS14265	20
RK1001.C0101_allcombined	2986639	2986713		YPO_RS14265	74
RK1001.C0101_allcombined	2986914	2986939		YPO_RS14265	25
RK1001.C0101_allcombined	2986976	2986982		YPO_RS14265	6
RK1001.C0101_allcombined	2986976	2986984		YPO_RS14270	8
RK1001.C0101_allcombined	2987049	2987083		YPO_RS14270	34
RK1001.C0101_allcombined	2987654	2987665		YPO_RS14270	11
RK1001.C0101_allcombined	2987752	2987755		YPO_RS14270	3
RK1001.C0101_allcombined	2987848	2987865		YPO_RS14270	17
RK1001.C0101_allcombined	2988439	2988455		YPO_RS14275	16
RK1001.C0101_allcombined	2988506	2988507		YPO_RS14275	1
RK1001.C0101_allcombined	2989179	2989185		YPO_RS14280	6
RK1001.C0101_allcombined	2989343	2989347		YPO_RS14280	4
RK1001.C0101_allcombined	2989738	2989752		YPO_RS14285	14
RK1001.C0101_allcombined	2989817	2989825		YPO_RS14285	8
RK1001.C0101_allcombined	2990103	2990125		YPO_RS14285	22
RK1001.C0101_allcombined	2991812	2991829		YPO_RS14295	17
RK1001.C0101_allcombined	2991921	2991980		YPO_RS14295	59
RK1001.C0101_allcombined	2992616	2992649		YPO_RS14300	33
RK1001.C0101_allcombined	2993211	2993214		YPO_RS14300	3
RK1001.C0101_allcombined	2993551	2993559		YPO_RS14300	8
RK1001.C0101_allcombined	2993948	2993960		YPO_RS14300	12
RK1001.C0101_allcombined	2994309	2994311		ureE	2
RK1001.C0101_allcombined	2994448	2994488		ureE	40
RK1001.C0101_allcombined	2994737	2994744		ureE	7
RK1001.C0101_allcombined	2994936	2994969		ureE	33
RK1001.C0101_allcombined	2995232	2995261		YPO_RS14310	29
RK1001.C0101_allcombined	2996216	2996241		ureG	25
RK1001.C0101_allcombined	2996327	2996336		ureG	9
RK1001.C0101_allcombined	2996470	2996474		ureG	4
RK1001.C0101_allcombined	2997940	2997945		yut	5
RK1001.C0101_allcombined	2998237	2998257		yut	20
RK1001.C0101_allcombined	2998486	2998510		yut	24
RK1001.C0101_allcombined	2998610	2998647		yut	37
RK1001.C0101_allcombined	2999246	2999371		YPO_RS14330	125
RK1001.C0101_allcombined	2999607	2999629		YPO_RS14330	22
RK1001.C0101_allcombined	2999745	2999803		YPO_RS14330	58
RK1001.C0101_allcombined	3000059	3000098		hdeB	39
RK1001.C0101_allcombined	3000140	3000176		hdeB	36
RK1001.C0101_allcombined	3000234	3000235		hdeB	1
RK1001.C0101_allcombined	3000343	3000353		hdeB	10
RK1001.C0101_allcombined	3000987	3001026		kch	39
RK1001.C0101_allcombined	3001171	3001240		kch	69
RK1001.C0101_allcombined	3001479	3001485		kch	6
RK1001.C0101_allcombined	3001539	3001547		kch	8
RK1001.C0101_allcombined	3001725	3001762		kch	37
RK1001.C0101_allcombined	3001842	3001854		kch	12
RK1001.C0101_allcombined	3001915	3001923		kch	8
RK1001.C0101_allcombined	3002013	3002019		kch	6
RK1001.C0101_allcombined	3002106	3002111		kch	5
RK1001.C0101_allcombined	3002435	3002467		crcB	32
RK1001.C0101_allcombined	3002803	3002840		crcB	37
RK1001.C0101_allcombined	3002886	3002954		crcB	68
RK1001.C0101_allcombined	3003191	3003245		YPO_RS14355	54
RK1001.C0101_allcombined	3004085	3004091		YPO_RS14360	6
RK1001.C0101_allcombined	3004181	3004188		YPO_RS14360	7
RK1001.C0101_allcombined	3004382	3004391		YPO_RS14360	9
RK1001.C0101_allcombined	3004545	3004590		chbC	45
RK1001.C0101_allcombined	3004845	3004851		chbC	6
RK1001.C0101_allcombined	3005544	3005569		chbC	25
RK1001.C0101_allcombined	3005609	3005652		chbC	43
RK1001.C0101_allcombined	3006185	3006214		chbA	29
RK1001.C0101_allcombined	3006350	3006356		chbR	6
RK1001.C0101_allcombined	3006699	3006731		chbR	32
RK1001.C0101_allcombined	3007219	3007223		chbG	4
RK1001.C0101_allcombined	3007503	3007521		chbG	18
RK1001.C0101_allcombined	3008642	3008643		YPO_RS14385	1
RK1001.C0101_allcombined	3009365	3009380		seqA	15
RK1001.C0101_allcombined	3010172	3010195		pgm	23
RK1001.C0101_allcombined	3010526	3010550		pgm	24
RK1001.C0101_allcombined	3010727	3010757		pgm	30
RK1001.C0101_allcombined	3010844	3010855		pgm	11
RK1001.C0101_allcombined	3011147	3011169		pgm	22
RK1001.C0101_allcombined	3011202	3011204		pgm	2
RK1001.C0101_allcombined	3011825	3011828		YPO_RS14400	3
RK1001.C0101_allcombined	3011901	3011991		YPO_RS14400	90
RK1001.C0101_allcombined	3012296	3012304		YPO_RS14405	8
RK1001.C0101_allcombined	3012738	3012740		kdpE	2
RK1001.C0101_allcombined	3012891	3012896		kdpE	5
RK1001.C0101_allcombined	3012973	3012987		kdpE	14
RK1001.C0101_allcombined	3013586	3013605		kdbD	19
RK1001.C0101_allcombined	3013803	3013806		kdbD	3
RK1001.C0101_allcombined	3015235	3015237		kdbD	2
RK1001.C0101_allcombined	3015323	3015330		kdbD	7
RK1001.C0101_allcombined	3015876	3015881		kdbD	5
RK1001.C0101_allcombined	3016158	3016174		kdbD	16
RK1001.C0101_allcombined	3016424	3016428		kdpC	4
RK1001.C0101_allcombined	3016481	3016491		kdpC	10
RK1001.C0101_allcombined	3017584	3017594		kdpB	10
RK1001.C0101_allcombined	3018333	3018346		kdpB	13
RK1001.C0101_allcombined	3018463	3018466		kdpB	3
RK1001.C0101_allcombined	3019067	3019081		kdpB	14
RK1001.C0101_allcombined	3019343	3019362		kdpA	19
RK1001.C0101_allcombined	3021066	3021092		YPO_RS14440	26
RK1001.C0101_allcombined	3021134	3021183		YPO_RS14440	49
RK1001.C0101_allcombined	3021509	3021511		YPO_RS14445	2
RK1001.C0101_allcombined	3021610	3021620		YPO_RS14445	10
RK1001.C0101_allcombined	3023331	3023343		phrB	12
RK1001.C0101_allcombined	3024102	3024110		YPO_RS14460	8
RK1001.C0101_allcombined	3024169	3024170		YPO_RS14460	1
RK1001.C0101_allcombined	3024217	3024218		YPO_RS14460	1
RK1001.C0101_allcombined	3024419	3024430		YPO_RS14460	11
RK1001.C0101_allcombined	3024572	3024580		YPO_RS14460	8
RK1001.C0101_allcombined	3024658	3024703		YPO_RS14460	45
RK1001.C0101_allcombined	3024889	3024892		YPO_RS14460	3
RK1001.C0101_allcombined	3025009	3025055		YPO_RS14460	46
RK1001.C0101_allcombined	3025754	3025767		YPO_RS14465	13
RK1001.C0101_allcombined	3025976	3025980		YPO_RS14465	4
RK1001.C0101_allcombined	3026135	3026189		YPO_RS14470	54
RK1001.C0101_allcombined	3027257	3027284		YPO_RS14480	27
RK1001.C0101_allcombined	3027916	3027929		YPO_RS14480	13
RK1001.C0101_allcombined	3028092	3028095		YPO_RS14480	3
RK1001.C0101_allcombined	3028166	3028195		YPO_RS14480	29
RK1001.C0101_allcombined	3028358	3028375		pxpA	17
RK1001.C0101_allcombined	3028484	3028493		pxpA	9
RK1001.C0101_allcombined	3029176	3029195		YPO_RS14490	19
RK1001.C0101_allcombined	3029347	3029363		YPO_RS14490	16
RK1001.C0101_allcombined	3029658	3029665		YPO_RS14490	7
RK1001.C0101_allcombined	3029724	3029725		YPO_RS14490	1
RK1001.C0101_allcombined	3030795	3030838		pcp	43
RK1001.C0101_allcombined	3031648	3031660		ung	12
RK1001.C0101_allcombined	3031928	3031966		ung	38
RK1001.C0101_allcombined	3032143	3032199		ung	56
RK1001.C0101_allcombined	3032552	3032553		grcA	1
RK1001.C0101_allcombined	3032756	3032759		grcA	3
RK1001.C0101_allcombined	3032865	3032881		grcA	16
RK1001.C0101_allcombined	3034337	3034345		YPO_RS14520	8
RK1001.C0101_allcombined	3034589	3034596		YPO_RS14520	7
RK1001.C0101_allcombined	3034703	3034708		YPO_RS14520	5
RK1001.C0101_allcombined	3035022	3035027		srmB	5
RK1001.C0101_allcombined	3035059	3035078		srmB	19
RK1001.C0101_allcombined	3035263	3035264		srmB	1
RK1001.C0101_allcombined	3035809	3035810		srmB	1
RK1001.C0101_allcombined	3037109	3037122		YPO_RS14530	13
RK1001.C0101_allcombined	3037244	3037264		YPO_RS14530	20
RK1001.C0101_allcombined	3038067	3038068		nadB	1
RK1001.C0101_allcombined	3038123	3038149		nadB	26
RK1001.C0101_allcombined	3038226	3038228		nadB	2
RK1001.C0101_allcombined	3039156	3039169		nadB	13
RK1001.C0101_allcombined	3039737	3039784		rpoE	47
RK1001.C0101_allcombined	3041309	3041319		rseB	10
RK1001.C0101_allcombined	3041813	3041837		rseC	24
RK1001.C0101_allcombined	3042156	3042170		YPO_RS14560	14
RK1001.C0101_allcombined	3042202	3042218		YPO_RS14560	16
RK1001.C0101_allcombined	3042351	3042381		YPO_RS14560	30
RK1001.C0101_allcombined	3042456	3042493		YPO_RS14560	37
RK1001.C0101_allcombined	3042605	3042633		YPO_RS14560	28
RK1001.C0101_allcombined	3042667	3042707		YPO_RS14560	40
RK1001.C0101_allcombined	3042744	3042747		YPO_RS14560	3
RK1001.C0101_allcombined	3042837	3042838		YPO_RS14560	1
RK1001.C0101_allcombined	3043471	3043480		lepA	9
RK1001.C0101_allcombined	3044111	3044128		lepA	17
RK1001.C0101_allcombined	3044362	3044408		lepA	46
RK1001.C0101_allcombined	3044455	3044459		lepA	4
RK1001.C0101_allcombined	3044672	3044693		lepA	21
RK1001.C0101_allcombined	3045075	3045077		lepA	2
RK1001.C0101_allcombined	3045259	3045260		lepB	1
RK1001.C0101_allcombined	3045571	3045587		lepB	16
RK1001.C0101_allcombined	3045712	3045721		lepB	9
RK1001.C0101_allcombined	3046021	3046024		lepB	3
RK1001.C0101_allcombined	3046059	3046063		lepB	4
RK1001.C0101_allcombined	3046571	3046585		rnc	14
RK1001.C0101_allcombined	3046625	3046645		rnc	20
RK1001.C0101_allcombined	3046758	3046759		rnc	1
RK1001.C0101_allcombined	3047388	3047419		YPO_RS14580	31
RK1001.C0101_allcombined	3048399	3048408		recO	9
RK1001.C0101_allcombined	3049032	3049044		YPO_RS14590	12
RK1001.C0101_allcombined	3050882	3050888		tssL	6
RK1001.C0101_allcombined	3051360	3051385		tssL	25
RK1001.C0101_allcombined	3051453	3051475		tssL	22
RK1001.C0101_allcombined	3052289	3052293		tssM	4
RK1001.C0101_allcombined	3052382	3052397		tssM	15
RK1001.C0101_allcombined	3052878	3052900		tssM	22
RK1001.C0101_allcombined	3052991	3053009		tssM	18
RK1001.C0101_allcombined	3053049	3053117		tssM	68
RK1001.C0101_allcombined	3053166	3053169		tssM	3
RK1001.C0101_allcombined	3053603	3053639		tssM	36
RK1001.C0101_allcombined	3054013	3054034		tssM	21
RK1001.C0101_allcombined	3054312	3054321		tssM	9
RK1001.C0101_allcombined	3054734	3054777		tssM	43
RK1001.C0101_allcombined	3054831	3054832		tssM	1
RK1001.C0101_allcombined	3055085	3055106		tssM	21
RK1001.C0101_allcombined	3055140	3055176		tssM	36
RK1001.C0101_allcombined	3055918	3055947		YPO_RS14610	29
RK1001.C0101_allcombined	3056181	3056239		YPO_RS14610	58
RK1001.C0101_allcombined	3056314	3056317		YPO_RS14610	3
RK1001.C0101_allcombined	3056365	3056369		YPO_RS14610	4
RK1001.C0101_allcombined	3056449	3056455		YPO_RS14610	6
RK1001.C0101_allcombined	3056770	3056777		YPO_RS14610	7
RK1001.C0101_allcombined	3057642	3057658		YPO_RS14610	16
RK1001.C0101_allcombined	3057776	3057777		YPO_RS14610	1
RK1001.C0101_allcombined	3058908	3058928		YPO_RS14615	20
RK1001.C0101_allcombined	3058934	3058946		YPO_RS14620	12
RK1001.C0101_allcombined	3059344	3059369		YPO_RS14620	25
RK1001.C0101_allcombined	3059510	3059515		YPO_RS14620	5
RK1001.C0101_allcombined	3059597	3059647		YPO_RS14620	50
RK1001.C0101_allcombined	3059677	3059706		YPO_RS14620	29
RK1001.C0101_allcombined	3059928	3059934		YPO_RS14625	6
RK1001.C0101_allcombined	3059999	3060023		YPO_RS14625	24
RK1001.C0101_allcombined	3060356	3060368		YPO_RS14625	12
RK1001.C0101_allcombined	3060546	3060551		YPO_RS14625	5
RK1001.C0101_allcombined	3060582	3060602		YPO_RS14625	20
RK1001.C0101_allcombined	3060815	3060843		YPO_RS14630	28
RK1001.C0101_allcombined	3060990	3060992		YPO_RS14630	2
RK1001.C0101_allcombined	3061421	3061422		YPO_RS14635	1
RK1001.C0101_allcombined	3061491	3061509		YPO_RS14635	18
RK1001.C0101_allcombined	3062804	3062811		YPO_RS14645	7
RK1001.C0101_allcombined	3062912	3062935		YPO_RS14645	23
RK1001.C0101_allcombined	3063206	3063209		YPO_RS14645	3
RK1001.C0101_allcombined	3063280	3063291		YPO_RS14645	11
RK1001.C0101_allcombined	3063511	3063519		YPO_RS14645	8
RK1001.C0101_allcombined	3063805	3063817		YPO_RS14645	12
RK1001.C0101_allcombined	3065227	3065232		YPO_RS14655	5
RK1001.C0101_allcombined	3065526	3065559		YPO_RS14660	33
RK1001.C0101_allcombined	3065594	3065608		YPO_RS14660	14
RK1001.C0101_allcombined	3065698	3065734		YPO_RS14660	36
RK1001.C0101_allcombined	3065783	3065792		YPO_RS14660	9
RK1001.C0101_allcombined	3065877	3065961		YPO_RS14660	84
RK1001.C0101_allcombined	3066502	3066513		ccmA	11
RK1001.C0101_allcombined	3066793	3066818		ccmA	25
RK1001.C0101_allcombined	3067293	3067327		ccmB	34
RK1001.C0101_allcombined	3067444	3067446		ccmB	2
RK1001.C0101_allcombined	3068194	3068225		YPO_RS14675	31
RK1001.C0101_allcombined	3068304	3068307		YPO_RS14675	3
RK1001.C0101_allcombined	3068363	3068374		YPO_RS14675	11
RK1001.C0101_allcombined	3068929	3068942		ccmE	13
RK1001.C0101_allcombined	3069481	3069513		YPO_RS14690	32
RK1001.C0101_allcombined	3070440	3070459		YPO_RS14690	19
RK1001.C0101_allcombined	3070887	3070891		YPO_RS14690	4
RK1001.C0101_allcombined	3070938	3070940		YPO_RS14690	2
RK1001.C0101_allcombined	3071007	3071025		YPO_RS14690	18
RK1001.C0101_allcombined	3071067	3071069		YPO_RS14690	2
RK1001.C0101_allcombined	3071526	3071530		YPO_RS14695	4
RK1001.C0101_allcombined	3072180	3072186		YPO_RS14700	6
RK1001.C0101_allcombined	3072298	3072314		YPO_RS14700	16
RK1001.C0101_allcombined	3073572	3073578		ccmI	6
RK1001.C0101_allcombined	3073642	3073661		mlaA	19
RK1001.C0101_allcombined	3073889	3073895		mlaA	6
RK1001.C0101_allcombined	3074036	3074063		mlaA	27
RK1001.C0101_allcombined	3074786	3074815		fadL	29
RK1001.C0101_allcombined	3074889	3074895		fadL	6
RK1001.C0101_allcombined	3075099	3075112		fadL	13
RK1001.C0101_allcombined	3075521	3075536		fadL	15
RK1001.C0101_allcombined	3077424	3077427		fadI	3
RK1001.C0101_allcombined	3077869	3077915		fadI	46
RK1001.C0101_allcombined	3078189	3078191		fadJ	2
RK1001.C0101_allcombined	3078882	3078892		fadJ	10
RK1001.C0101_allcombined	3079294	3079309		fadJ	15
RK1001.C0101_allcombined	3079578	3079604		fadJ	26
RK1001.C0101_allcombined	3079753	3079756		fadJ	3
RK1001.C0101_allcombined	3079860	3079875		fadJ	15
RK1001.C0101_allcombined	3079908	3079922		fadJ	14
RK1001.C0101_allcombined	3080009	3080035		fadJ	26
RK1001.C0101_allcombined	3080086	3080099		fadJ	13
RK1001.C0101_allcombined	3082051	3082071		smrB	20
RK1001.C0101_allcombined	3082336	3082339		smrB	3
RK1001.C0101_allcombined	3083099	3083110		prmB	11
RK1001.C0101_allcombined	3083344	3083345		prmB	1
RK1001.C0101_allcombined	3084084	3084097		aroC	13
RK1001.C0101_allcombined	3084762	3084768		aroC	6
RK1001.C0101_allcombined	3085081	3085095		mepA	14
RK1001.C0101_allcombined	3086019	3086027		YPO_RS14760	8
RK1001.C0101_allcombined	3087676	3087678		mnmC	2
RK1001.C0101_allcombined	3088724	3088727		mnmC	3
RK1001.C0101_allcombined	3088762	3088809		mnmC	47
RK1001.C0101_allcombined	3089604	3089641		mnmC	37
RK1001.C0101_allcombined	3090499	3090509		fabB	10
RK1001.C0101_allcombined	3090885	3090895		fabB	10
RK1001.C0101_allcombined	3091605	3091613		YPO_RS14785	8
RK1001.C0101_allcombined	3091797	3091800		YPO_RS14785	3
RK1001.C0101_allcombined	3091835	3091840		YPO_RS14785	5
RK1001.C0101_allcombined	3092131	3092163		YPO_RS14785	32
RK1001.C0101_allcombined	3094542	3094562		YPO_RS14795	20
RK1001.C0101_allcombined	3094600	3094601		YPO_RS14795	1
RK1001.C0101_allcombined	3095263	3095287		YPO_RS14800	24
RK1001.C0101_allcombined	3095348	3095357		YPO_RS14800	9
RK1001.C0101_allcombined	3095860	3095866		YPO_RS14800	6
RK1001.C0101_allcombined	3096063	3096086		YPO_RS14800	23
RK1001.C0101_allcombined	3096337	3096338		YPO_RS14805	1
RK1001.C0101_allcombined	3096841	3096855		YPO_RS14805	14
RK1001.C0101_allcombined	3097382	3097406		pdxB	24
RK1001.C0101_allcombined	3097564	3097571		pdxB	7
RK1001.C0101_allcombined	3098243	3098251		pdxB	8
RK1001.C0101_allcombined	3098756	3098770		YPO_RS14815	14
RK1001.C0101_allcombined	3099623	3099625		YPO_RS14820	2
RK1001.C0101_allcombined	3099793	3099805		YPO_RS14820	12
RK1001.C0101_allcombined	3100144	3100162		YPO_RS14820	18
RK1001.C0101_allcombined	3100623	3100630		truA	7
RK1001.C0101_allcombined	3100782	3100800		truA	18
RK1001.C0101_allcombined	3101233	3101239		YPO_RS14830	6
RK1001.C0101_allcombined	3101271	3101287		YPO_RS14830	16
RK1001.C0101_allcombined	3101732	3101781		YPO_RS14830	49
RK1001.C0101_allcombined	3102437	3102438		accD	1
RK1001.C0101_allcombined	3103633	3103642		folC	9
RK1001.C0101_allcombined	3103982	3103985		folC	3
RK1001.C0101_allcombined	3104530	3104554		folC	24
RK1001.C0101_allcombined	3104720	3104739		dedD	19
RK1001.C0101_allcombined	3104876	3104889		dedD	13
RK1001.C0101_allcombined	3105014	3105028		dedD	14
RK1001.C0101_allcombined	3106026	3106038		cvpA	12
RK1001.C0101_allcombined	3106160	3106169		cvpA	9
RK1001.C0101_allcombined	3106433	3106451		purF	18
RK1001.C0101_allcombined	3106719	3106720		purF	1
RK1001.C0101_allcombined	3107621	3107649		purF	28
RK1001.C0101_allcombined	3108373	3108378		YPO_RS14860	5
RK1001.C0101_allcombined	3108513	3108537		YPO_RS14860	24
RK1001.C0101_allcombined	3109371	3109376		hisJ	5
RK1001.C0101_allcombined	3109982	3109997		YPO_RS14870	15
RK1001.C0101_allcombined	3110132	3110141		YPO_RS14870	9
RK1001.C0101_allcombined	3110244	3110272		YPO_RS14870	28
RK1001.C0101_allcombined	3110913	3110918		YPO_RS14875	5
RK1001.C0101_allcombined	3111406	3111410		hisP	4
RK1001.C0101_allcombined	3111616	3111628		hisP	12
RK1001.C0101_allcombined	3111918	3111924		hisP	6
RK1001.C0101_allcombined	3112341	3112356		YPO_RS14885	15
RK1001.C0101_allcombined	3113578	3113598		YPO_RS14890	20
RK1001.C0101_allcombined	3113698	3113717		YPO_RS14890	19
RK1001.C0101_allcombined	3113810	3113811		YPO_RS14890	1
RK1001.C0101_allcombined	3113952	3113974		YPO_RS14890	22
RK1001.C0101_allcombined	3114035	3114039		YPO_RS14890	4
RK1001.C0101_allcombined	3114094	3114129		YPO_RS14890	35
RK1001.C0101_allcombined	3114216	3114229		YPO_RS14890	13
RK1001.C0101_allcombined	3114549	3114551		yfcE	2
RK1001.C0101_allcombined	3114645	3114670		yfcE	25
RK1001.C0101_allcombined	3114978	3114989		yfcE	11
RK1001.C0101_allcombined	3115390	3115402		yfcD	12
RK1001.C0101_allcombined	3115553	3115561		yfcD	8
RK1001.C0101_allcombined	3116380	3116387		YPO_RS14905	7
RK1001.C0101_allcombined	3116658	3116682		YPO_RS14905	24
RK1001.C0101_allcombined	3116862	3116877		YPO_RS14905	15
RK1001.C0101_allcombined	3117064	3117097		YPO_RS14905	33
RK1001.C0101_allcombined	3118030	3118046		YPO_RS14910	16
RK1001.C0101_allcombined	3121234	3121406		YPO_RS14925	172
RK1001.C0101_allcombined	3121475	3121479		YPO_RS14925	4
RK1001.C0101_allcombined	3121570	3121715		YPO_RS14925	145
RK1001.C0101_allcombined	3121787	3121815		YPO_RS14925	28
RK1001.C0101_allcombined	3122181	3122202		YPO_RS14930	21
RK1001.C0101_allcombined	3122241	3122252		YPO_RS14930	11
RK1001.C0101_allcombined	3122378	3122384		YPO_RS14930	6
RK1001.C0101_allcombined	3122434	3122484		YPO_RS14930	50
RK1001.C0101_allcombined	3122793	3122843		YPO_RS14935	50
RK1001.C0101_allcombined	3122963	3123022		YPO_RS14935	59
RK1001.C0101_allcombined	3123078	3123118		YPO_RS14935	40
RK1001.C0101_allcombined	3123163	3123245		YPO_RS14940	82
RK1001.C0101_allcombined	3123288	3123363		YPO_RS14940	75
RK1001.C0101_allcombined	3123446	3123464		YPO_RS14940	18
RK1001.C0101_allcombined	3123573	3123585		YPO_RS14940	12
RK1001.C0101_allcombined	3123955	3123977		YPO_RS14945	22
RK1001.C0101_allcombined	3124016	3124021		YPO_RS14950	5
RK1001.C0101_allcombined	3124123	3124163		YPO_RS14950	40
RK1001.C0101_allcombined	3125066	3125130		yapC	64
RK1001.C0101_allcombined	3125415	3125453		yapC	38
RK1001.C0101_allcombined	3125513	3125515		yapC	2
RK1001.C0101_allcombined	3125598	3125605		yapC	7
RK1001.C0101_allcombined	3125692	3125696		yapC	4
RK1001.C0101_allcombined	3125965	3125979		yapC	14
RK1001.C0101_allcombined	3126257	3126280		yapC	23
RK1001.C0101_allcombined	3126811	3126817		yapC	6
RK1001.C0101_allcombined	3126963	3126980		yapC	17
RK1001.C0101_allcombined	3127172	3127226		YPO_RS14960	54
RK1001.C0101_allcombined	3127864	3127882		YPO_RS14965	18
RK1001.C0101_allcombined	3128072	3128096		YPO_RS14965	24
RK1001.C0101_allcombined	3128498	3128525		YPO_RS14975	27
RK1001.C0101_allcombined	3129647	3129651		YPO_RS14975	4
RK1001.C0101_allcombined	3130353	3130355		YPO_RS14980	2
RK1001.C0101_allcombined	3130910	3130952		YPO_RS14980	42
RK1001.C0101_allcombined	3131573	3131585		YPO_RS14980	12
RK1001.C0101_allcombined	3131731	3131734		YPO_RS14980	3
RK1001.C0101_allcombined	3131813	3131826		YPO_RS14980	13
RK1001.C0101_allcombined	3131913	3131914		YPO_RS14980	1
RK1001.C0101_allcombined	3132174	3132178		YPO_RS14980	4
RK1001.C0101_allcombined	3132716	3132751		YPO_RS14985	35
RK1001.C0101_allcombined	3133871	3133877		YPO_RS14990	6
RK1001.C0101_allcombined	3133928	3133943		YPO_RS14990	15
RK1001.C0101_allcombined	3134127	3134156		YPO_RS14990	29
RK1001.C0101_allcombined	3134728	3134753		YPO_RS14990	25
RK1001.C0101_allcombined	3134891	3134926		YPO_RS14990	35
RK1001.C0101_allcombined	3135080	3135094		YPO_RS14990	14
RK1001.C0101_allcombined	3135141	3135155		YPO_RS14990	14
RK1001.C0101_allcombined	3136923	3136930		YPO_RS14995	7
RK1001.C0101_allcombined	3137116	3137135		YPO_RS14995	19
RK1001.C0101_allcombined	3137775	3137785		YPO_RS15000	10
RK1001.C0101_allcombined	3138034	3138037		YPO_RS15000	3
RK1001.C0101_allcombined	3138541	3138543		YPO_RS15005	2
RK1001.C0101_allcombined	3138649	3138661		YPO_RS15005	12
RK1001.C0101_allcombined	3139347	3139352		YPO_RS15005	5
RK1001.C0101_allcombined	3139593	3139597		YPO_RS15010	4
RK1001.C0101_allcombined	3140029	3140043		YPO_RS15010	14
RK1001.C0101_allcombined	3140551	3140562		YPO_RS15015	11
RK1001.C0101_allcombined	3142776	3142850		YPO_RS15025	74
RK1001.C0101_allcombined	3144624	3144629		YPO_RS15035	5
RK1001.C0101_allcombined	3144882	3144909		YPO_RS15040	27
RK1001.C0101_allcombined	3145276	3145286		YPO_RS15040	10
RK1001.C0101_allcombined	3145738	3145772		YPO_RS15040	34
RK1001.C0101_allcombined	3146318	3146322		YPO_RS15040	4
RK1001.C0101_allcombined	3146714	3146715		YPO_RS15045	1
RK1001.C0101_allcombined	3147270	3147275		YPO_RS15050	5
RK1001.C0101_allcombined	3149176	3149184		YPO_RS15060	8
RK1001.C0101_allcombined	3149245	3149283		YPO_RS15060	38
RK1001.C0101_allcombined	3150148	3150151		YPO_RS15070	3
RK1001.C0101_allcombined	3150360	3150371		YPO_RS15075	11
RK1001.C0101_allcombined	3150544	3150546		YPO_RS15075	2
RK1001.C0101_allcombined	3150710	3150717		YPO_RS15075	7
RK1001.C0101_allcombined	3151482	3151504		YPO_RS15085	22
RK1001.C0101_allcombined	3151967	3151969		folD	2
RK1001.C0101_allcombined	3152658	3152660		folD	2
RK1001.C0101_allcombined	3152881	3152891		ybcJ	10
RK1001.C0101_allcombined	3153579	3153583		YPO_RS15105	4
RK1001.C0101_allcombined	3153977	3153987		upp	10
RK1001.C0101_allcombined	3154047	3154082		upp	35
RK1001.C0101_allcombined	3154164	3154169		upp	5
RK1001.C0101_allcombined	3154355	3154359		upp	4
RK1001.C0101_allcombined	3154864	3154905		purM	41
RK1001.C0101_allcombined	3156255	3156260		purN	5
RK1001.C0101_allcombined	3157130	3157139		speG	9
RK1001.C0101_allcombined	3157260	3157288		speG	28
RK1001.C0101_allcombined	3158959	3158981		pstB	22
RK1001.C0101_allcombined	3159030	3159038		pstB	8
RK1001.C0101_allcombined	3159100	3159120		pstB	20
RK1001.C0101_allcombined	3159353	3159355		pstB	2
RK1001.C0101_allcombined	3159500	3159519		pstB	19
RK1001.C0101_allcombined	3160024	3160034		pstA	10
RK1001.C0101_allcombined	3161043	3161045		pstA	2
RK1001.C0101_allcombined	3161932	3161970		YPO_RS15145	38
RK1001.C0101_allcombined	3162034	3162038		YPO_RS15145	4
RK1001.C0101_allcombined	3162554	3162555		YPO_RS15145	1
RK1001.C0101_allcombined	3162673	3162692		YPO_RS15145	19
RK1001.C0101_allcombined	3164038	3164039		ppk1	1
RK1001.C0101_allcombined	3164386	3164403		ppk1	17
RK1001.C0101_allcombined	3164464	3164473		ppk1	9
RK1001.C0101_allcombined	3164869	3164900		ppk1	31
RK1001.C0101_allcombined	3165613	3165629		ppk1	16
RK1001.C0101_allcombined	3165912	3165921		ppk1	9
RK1001.C0101_allcombined	3166027	3166060		ppk1	33
RK1001.C0101_allcombined	3166463	3166469		ppx	6
RK1001.C0101_allcombined	3166971	3166975		ppx	4
RK1001.C0101_allcombined	3167253	3167261		ppx	8
RK1001.C0101_allcombined	3167543	3167545		ppx	2
RK1001.C0101_allcombined	3167624	3167632		ppx	8
RK1001.C0101_allcombined	3168930	3168934		mgtE	4
RK1001.C0101_allcombined	3169250	3169259		mgtE	9
RK1001.C0101_allcombined	3169886	3169936		yegD	50
RK1001.C0101_allcombined	3170257	3170287		yegD	30
RK1001.C0101_allcombined	3170469	3170476		yegD	7
RK1001.C0101_allcombined	3170595	3170621		yegD	26
RK1001.C0101_allcombined	3170836	3170847		yegD	11
RK1001.C0101_allcombined	3171281	3171285		YPO_RS15175	4
RK1001.C0101_allcombined	3171761	3171765		YPO_RS15175	4
RK1001.C0101_allcombined	3171840	3171850		YPO_RS15175	10
RK1001.C0101_allcombined	3172328	3172335		YPO_RS15180	7
RK1001.C0101_allcombined	3172613	3172618		YPO_RS15180	5
RK1001.C0101_allcombined	3172971	3172972		YPO_RS15180	1
RK1001.C0101_allcombined	3173192	3173195		YPO_RS15180	3
RK1001.C0101_allcombined	3173626	3173628		YPO_RS15185	2
RK1001.C0101_allcombined	3173720	3173774		YPO_RS15185	54
RK1001.C0101_allcombined	3174478	3174497		YPO_RS15185	19
RK1001.C0101_allcombined	3174633	3174652		YPO_RS15190	19
RK1001.C0101_allcombined	3175213	3175229		YPO_RS15190	16
RK1001.C0101_allcombined	3175578	3175599		YPO_RS15190	21
RK1001.C0101_allcombined	3176329	3176357		YPO_RS15195	28
RK1001.C0101_allcombined	3176621	3176634		YPO_RS15195	13
RK1001.C0101_allcombined	3178416	3178447		YPO_RS15200	31
RK1001.C0101_allcombined	3178969	3178993		YPO_RS15200	24
RK1001.C0101_allcombined	3178487	3178522		YPO_RS15200	35
RK1001.C0101_allcombined	3180082	3180083		YPO_RS15205	1
RK1001.C0101_allcombined	3180238	3180245		YPO_RS15205	7
RK1001.C0101_allcombined	3180531	3180544		YPO_RS15205	13
RK1001.C0101_allcombined	3180944	3180978		YPO_RS15210	34
RK1001.C0101_allcombined	3181151	3181167		YPO_RS15210	16
RK1001.C0101_allcombined	3181960	3181970		YPO_RS15210	10
RK1001.C0101_allcombined	3183684	3183701		YPO_RS15210	17
RK1001.C0101_allcombined	3183745	3183749		YPO_RS15210	4
RK1001.C0101_allcombined	3184736	3184743		mdtC	7
RK1001.C0101_allcombined	3185103	3185132		mdtC	29
RK1001.C0101_allcombined	3185555	3185561		mdtC	6
RK1001.C0101_allcombined	3185770	3185774		mdtC	4
RK1001.C0101_allcombined	3186861	3186876		mdtC	15
RK1001.C0101_allcombined	3186917	3186921		mdtC	4
RK1001.C0101_allcombined	3187128	3187145		YPO_RS15220	17
RK1001.C0101_allcombined	3187696	3187735		YPO_RS15220	39
RK1001.C0101_allcombined	3187788	3187792		YPO_RS15220	4
RK1001.C0101_allcombined	3188264	3188269		YPO_RS15220	5
RK1001.C0101_allcombined	3189972	3189981		baeR	9
RK1001.C0101_allcombined	3190356	3190369		baeR	13
RK1001.C0101_allcombined	3190456	3190457		baeR	1
RK1001.C0101_allcombined	3190644	3190664		YPO_RS15235	20
RK1001.C0101_allcombined	3190962	3190971		YPO_RS15235	9
RK1001.C0101_allcombined	3191246	3191262		YPO_RS15240	16
RK1001.C0101_allcombined	3191423	3191428		YPO_RS15240	5
RK1001.C0101_allcombined	3191687	3191692		YPO_RS15240	5
RK1001.C0101_allcombined	3192256	3192307		YPO_RS15240	51
RK1001.C0101_allcombined	3192426	3192429		YPO_RS15240	3
RK1001.C0101_allcombined	3194861	3194942		YPO_RS15250	81
RK1001.C0101_allcombined	3196405	3196412		thiD	7
RK1001.C0101_allcombined	3196560	3196564		thiD	4
RK1001.C0101_allcombined	3196782	3196800		thiD	18
RK1001.C0101_allcombined	3197478	3197491		YPO_RS15265	13
RK1001.C0101_allcombined	3197581	3197590		YPO_RS15265	9
RK1001.C0101_allcombined	3197666	3197694		YPO_RS15265	28
RK1001.C0101_allcombined	3197724	3197725		YPO_RS15265	1
RK1001.C0101_allcombined	3197789	3197912		YPO_RS15265	123
RK1001.C0101_allcombined	3197971	3197972		YPO_RS15270	1
RK1001.C0101_allcombined	3198005	3198007		YPO_RS15270	2
RK1001.C0101_allcombined	3198063	3198105		YPO_RS15270	42
RK1001.C0101_allcombined	3198223	3198232		YPO_RS15270	9
RK1001.C0101_allcombined	3199719	3199720		YPO_RS15280	1
RK1001.C0101_allcombined	3199878	3199898		YPO_RS15280	20
RK1001.C0101_allcombined	3200046	3200117		YPO_RS15280	71
RK1001.C0101_allcombined	3200197	3200289		YPO_RS15285	92
RK1001.C0101_allcombined	3200340	3200433		YPO_RS15285	93
RK1001.C0101_allcombined	3200483	3200517		YPO_RS15285	34
RK1001.C0101_allcombined	3200571	3200587		YPO_RS15285	16
RK1001.C0101_allcombined	3200651	3200720		YPO_RS15290	69
RK1001.C0101_allcombined	3200752	3200926		YPO_RS15290	174
RK1001.C0101_allcombined	3200974	3201046		YPO_RS15290	72
RK1001.C0101_allcombined	3201113	3201181		YPO_RS15295	68
RK1001.C0101_allcombined	3201229	3201247		YPO_RS15295	18
RK1001.C0101_allcombined	3201281	3201288		YPO_RS15295	7
RK1001.C0101_allcombined	3201339	3201352		YPO_RS15295	13
RK1001.C0101_allcombined	3201386	3201410		YPO_RS15295	24
RK1001.C0101_allcombined	3201494	3201503		YPO_RS15295	9
RK1001.C0101_allcombined	3201626	3201701		YPO_RS15300	75
RK1001.C0101_allcombined	3201734	3201738		YPO_RS15300	4
RK1001.C0101_allcombined	3201768	3201876		YPO_RS15300	108
RK1001.C0101_allcombined	3201989	3201995		YPO_RS15305	6
RK1001.C0101_allcombined	3202103	3202123		YPO_RS15305	20
RK1001.C0101_allcombined	3202202	3202295		YPO_RS15305	93
RK1001.C0101_allcombined	3202367	3202375		YPO_RS15305	8
RK1001.C0101_allcombined	3202446	3202468		YPO_RS15305	22
RK1001.C0101_allcombined	3204328	3204330		guaA	2
RK1001.C0101_allcombined	3204544	3204556		guaA	12
RK1001.C0101_allcombined	3205218	3205244		guaB	26
RK1001.C0101_allcombined	3206366	3206388		guaB	22
RK1001.C0101_allcombined	3207112	3207124		xseA	12
RK1001.C0101_allcombined	3207236	3207240		xseA	4
RK1001.C0101_allcombined	3207830	3207831		xseA	1
RK1001.C0101_allcombined	3208128	3208145		xseA	17
RK1001.C0101_allcombined	3208648	3208654		YPO_RS15335	6
RK1001.C0101_allcombined	3209177	3209214		YPO_RS15335	37
RK1001.C0101_allcombined	3209463	3209470		YPO_RS15335	7
RK1001.C0101_allcombined	3210781	3210791		der	10
RK1001.C0101_allcombined	3211731	3211756		bamB	25
RK1001.C0101_allcombined	3212401	3212412		bamB	11
RK1001.C0101_allcombined	3212529	3212535		bamB	6
RK1001.C0101_allcombined	3212566	3212580		bamB	14
RK1001.C0101_allcombined	3212661	3212668		bamB	7
RK1001.C0101_allcombined	3212769	3212775		YPO_RS15350	6
RK1001.C0101_allcombined	3213174	3213221		YPO_RS15350	47
RK1001.C0101_allcombined	3213574	3213575		hisS	1
RK1001.C0101_allcombined	3213846	3213851		hisS	5
RK1001.C0101_allcombined	3213900	3213952		hisS	52
RK1001.C0101_allcombined	3214538	3214567		hisS	29
RK1001.C0101_allcombined	3214899	3214917		ispG	18
RK1001.C0101_allcombined	3215313	3215314		ispG	1
RK1001.C0101_allcombined	3215488	3215509		ispG	21
RK1001.C0101_allcombined	3215625	3215626		ispG	1
RK1001.C0101_allcombined	3215677	3215682		ispG	5
RK1001.C0101_allcombined	3216185	3216187		rodZ	2
RK1001.C0101_allcombined	3216228	3216245		rodZ	17
RK1001.C0101_allcombined	3216730	3216800		rodZ	70
RK1001.C0101_allcombined	3217260	3217287		pilW	27
RK1001.C0101_allcombined	3217527	3217542		pilW	15
RK1001.C0101_allcombined	3217795	3217822		pilW	27
RK1001.C0101_allcombined	3218515	3218530		trmG/rlmN	15
RK1001.C0101_allcombined	3218653	3218656		trmG/rlmN	3
RK1001.C0101_allcombined	3219854	3219864		ndk	10
RK1001.C0101_allcombined	3220231	3220348		YPO_RS15385	117
RK1001.C0101_allcombined	3220503	3220513		YPO_RS15385	10
RK1001.C0101_allcombined	3220894	3220905		YPO_RS15385	11
RK1001.C0101_allcombined	3221169	3221173		YPO_RS15385	4
RK1001.C0101_allcombined	3221258	3221314		YPO_RS15385	56
RK1001.C0101_allcombined	3221351	3221377		YPO_RS15385	26
RK1001.C0101_allcombined	3221472	3221497		YPO_RS15385	25
RK1001.C0101_allcombined	3221615	3221684		YPO_RS15385	69
RK1001.C0101_allcombined	3221738	3221858		YPO_RS15385	120
RK1001.C0101_allcombined	3221965	3221985		YPO_RS15385	20
RK1001.C0101_allcombined	3222141	3222150		YPO_RS15385	9
RK1001.C0101_allcombined	3222312	3222359		YPO_RS15385	47
RK1001.C0101_allcombined	3222475	3222490		YPO_RS15385	15
RK1001.C0101_allcombined	3222587	3222651		YPO_RS15385	64
RK1001.C0101_allcombined	3223350	3223392		yapA	42
RK1001.C0101_allcombined	3223453	3223478		yapA	25
RK1001.C0101_allcombined	3223960	3223976		yapA	16
RK1001.C0101_allcombined	3224029	3224032		yapA	3
RK1001.C0101_allcombined	3224112	3224130		yapA	18
RK1001.C0101_allcombined	3224241	3224247		yapA	6
RK1001.C0101_allcombined	3224746	3224761		yapA	15
RK1001.C0101_allcombined	3225262	3225300		yapA	38
RK1001.C0101_allcombined	3225620	3225635		yapA	15
RK1001.C0101_allcombined	3225671	3225676		yapA	5
RK1001.C0101_allcombined	3225707	3225721		yapA	14
RK1001.C0101_allcombined	3225793	3225809		yapA	16
RK1001.C0101_allcombined	3226883	3226902		yapA	19
RK1001.C0101_allcombined	3227101	3227117		yapA	16
RK1001.C0101_allcombined	3227173	3227186		yapA	13
RK1001.C0101_allcombined	3227440	3227445		yapA	5
RK1001.C0101_allcombined	3227516	3227518		yapA	2
RK1001.C0101_allcombined	3227681	3227686		yapA	5
RK1001.C0101_allcombined	3228344	3228346		YPO_RS15395	2
RK1001.C0101_allcombined	3228588	3228589		YPO_RS15395	1
RK1001.C0101_allcombined	3228832	3228849		YPO_RS15395	17
RK1001.C0101_allcombined	3228887	3228913		YPO_RS15395	26
RK1001.C0101_allcombined	3229048	3229059		YPO_RS15395	11
RK1001.C0101_allcombined	3229097	3229166		YPO_RS15395	69
RK1001.C0101_allcombined	3229653	3229656		YPO_RS15395	3
RK1001.C0101_allcombined	3230873	3230884		YPO_RS15395	11
RK1001.C0101_allcombined	3230961	3230962		YPO_RS15395	1
RK1001.C0101_allcombined	3231163	3231168		YPO_RS15395	5
RK1001.C0101_allcombined	3232069	3232090		sseB	21
RK1001.C0101_allcombined	3232682	3232734		sseB	52
RK1001.C0101_allcombined	3232992	3233022		sseB	30
RK1001.C0101_allcombined	3233644	3233647		pepB	3
RK1001.C0101_allcombined	3234064	3234092		pepB	28
RK1001.C0101_allcombined	3234267	3234271		pepB	4
RK1001.C0101_allcombined	3234303	3234309		pepB	6
RK1001.C0101_allcombined	3234539	3234552		iscX	13
RK1001.C0101_allcombined	3235259	3235261		hscA	2
RK1001.C0101_allcombined	3235546	3235549		hscA	3
RK1001.C0101_allcombined	3236382	3236383		hscA	1
RK1001.C0101_allcombined	3236653	3236654		hscA	1
RK1001.C0101_allcombined	3236773	3236780		hscA	7
RK1001.C0101_allcombined	3236833	3236884		hscA	51
RK1001.C0101_allcombined	3238066	3238068		iscA	2
RK1001.C0101_allcombined	3238174	3238181		iscA	7
RK1001.C0101_allcombined	3239094	3239098		YPO_RS15450	4
RK1001.C0101_allcombined	3239241	3239259		YPO_RS15450	18
RK1001.C0101_allcombined	3239608	3239621		YPO_RS15450	13
RK1001.C0101_allcombined	3239967	3239978		YPO_RS15450	11
RK1001.C0101_allcombined	3240312	3240322		iscR	10
RK1001.C0101_allcombined	3240424	3240426		iscR	2
RK1001.C0101_allcombined	3240597	3240609		iscR	12
RK1001.C0101_allcombined	3241397	3241411		trmJ	14
RK1001.C0101_allcombined	3241927	3241962		suhB	35
RK1001.C0101_allcombined	3242006	3242028		suhB	22
RK1001.C0101_allcombined	3243012	3243024		YPO_RS15470	12
RK1001.C0101_allcombined	3243214	3243226		YPO_RS15470	12
RK1001.C0101_allcombined	3244021	3244026		YPO_RS15475	5
RK1001.C0101_allcombined	3244094	3244100		YPO_RS15475	6
RK1001.C0101_allcombined	3244613	3244617		YPO_RS15480	4
RK1001.C0101_allcombined	3244895	3244949		YPO_RS15480	54
RK1001.C0101_allcombined	3245463	3245482		csiE	19
RK1001.C0101_allcombined	3245534	3245541		csiE	7
RK1001.C0101_allcombined	3245875	3245897		csiE	22
RK1001.C0101_allcombined	3245952	3245962		csiE	10
RK1001.C0101_allcombined	3246154	3246164		csiE	10
RK1001.C0101_allcombined	3246386	3246392		csiE	6
RK1001.C0101_allcombined	3247046	3247072		YPO_RS15490	26
RK1001.C0101_allcombined	3247237	3247263		YPO_RS15490	26
RK1001.C0101_allcombined	3247643	3247645		YPO_RS15490	2
RK1001.C0101_allcombined	3248451	3248463		ail	12
RK1001.C0101_allcombined	3248556	3248619		ail	63
RK1001.C0101_allcombined	3249230	3249235		YPO_RS15505	5
RK1001.C0101_allcombined	3250141	3250153		YPO_RS15505	12
RK1001.C0101_allcombined	3250974	3251003		hmpA	29
RK1001.C0101_allcombined	3251066	3251067		hmpA	1
RK1001.C0101_allcombined	3251104	3251127		hmpA	23
RK1001.C0101_allcombined	3251294	3251305		hmpA	11
RK1001.C0101_allcombined	3251689	3251699		hmpA	10
RK1001.C0101_allcombined	3251883	3251900		hmpA	17
RK1001.C0101_allcombined	3252045	3252056		hmpA	11
RK1001.C0101_allcombined	3253833	3253843		glnB	10
RK1001.C0101_allcombined	3254287	3254298		YPO_RS15525	11
RK1001.C0101_allcombined	3254735	3254740		YPO_RS15525	5
RK1001.C0101_allcombined	3255038	3255047		YPO_RS15525	9
RK1001.C0101_allcombined	3255306	3255311		YPO_RS15525	5
RK1001.C0101_allcombined	3255834	3255854		glrR	20
RK1001.C0101_allcombined	3256163	3256175		glrR	12
RK1001.C0101_allcombined	3257667	3257677		qseG	10
RK1001.C0101_allcombined	3257815	3257839		qseG	24
RK1001.C0101_allcombined	3258649	3258657		YPO_RS15540	8
RK1001.C0101_allcombined	3258722	3258723		YPO_RS15540	1
RK1001.C0101_allcombined	3259110	3259165		YPO_RS15540	55
RK1001.C0101_allcombined	3259241	3259290		YPO_RS15540	49
RK1001.C0101_allcombined	3260313	3260327		YPO_RS15550	14
RK1001.C0101_allcombined	3260360	3260376		YPO_RS15550	16
RK1001.C0101_allcombined	3261498	3261544		YPO_RS15555	46
RK1001.C0101_allcombined	3261593	3261600		YPO_RS15555	7
RK1001.C0101_allcombined	3261672	3261686		YPO_RS15555	14
RK1001.C0101_allcombined	3262567	3262580		YPO_RS15560	13
RK1001.C0101_allcombined	3262612	3262741		YPO_RS15560	129
RK1001.C0101_allcombined	3262831	3262898		YPO_RS15560	67
RK1001.C0101_allcombined	3264548	3264554		purL	6
RK1001.C0101_allcombined	3264942	3264949		purL	7
RK1001.C0101_allcombined	3265335	3265340		purL	5
RK1001.C0101_allcombined	3265855	3265858		purL	3
RK1001.C0101_allcombined	3265946	3265961		purL	15
RK1001.C0101_allcombined	3266445	3266502		purL	57
RK1001.C0101_allcombined	3267136	3267137		purL	1
RK1001.C0101_allcombined	3267540	3267541		mltF	1
RK1001.C0101_allcombined	3267763	3267791		mltF	28
RK1001.C0101_allcombined	3268404	3268414		mltF	10
RK1001.C0101_allcombined	3268712	3268720		mltF	8
RK1001.C0101_allcombined	3269166	3269178		tadA	12
RK1001.C0101_allcombined	3269612	3269614		tadA	2
RK1001.C0101_allcombined	3270226	3270246		yfhb	20
RK1001.C0101_allcombined	3272037	3272039		YPO_RS15595	2
RK1001.C0101_allcombined	3272589	3272595		YPO_RS15595	6
RK1001.C0101_allcombined	3272798	3272811		YPO_RS15600	13
RK1001.C0101_allcombined	3273270	3273289		YPO_RS15605	19
RK1001.C0101_allcombined	3273561	3273579		YPO_RS15605	18
RK1001.C0101_allcombined	3274688	3274714		pdxJ	26
RK1001.C0101_allcombined	3274784	3274826		pdxJ	42
RK1001.C0101_allcombined	3276891	3276907		YPO_RS15625	16
RK1001.C0101_allcombined	3278162	3278167		tssK	5
RK1001.C0101_allcombined	3278815	3278843		tssK	28
RK1001.C0101_allcombined	3279027	3279042		tssJ	15
RK1001.C0101_allcombined	3279320	3279331		tssJ	11
RK1001.C0101_allcombined	3279460	3279525		tssJ	65
RK1001.C0101_allcombined	3279821	3279834		YPO_RS15645	13
RK1001.C0101_allcombined	3279873	3279898		YPO_RS15645	25
RK1001.C0101_allcombined	3280050	3280053		YPO_RS15645	3
RK1001.C0101_allcombined	3280253	3280284		YPO_RS15645	31
RK1001.C0101_allcombined	3280610	3280612		tssC	2
RK1001.C0101_allcombined	3281184	3281210		tssC	26
RK1001.C0101_allcombined	3281519	3281529		tssC	10
RK1001.C0101_allcombined	3281667	3281711		tssC	44
RK1001.C0101_allcombined	3281873	3281926		tssC	53
RK1001.C0101_allcombined	3282138	3282140		tssB	2
RK1001.C0101_allcombined	3282765	3282772		YPO_RS15660	7
RK1001.C0101_allcombined	3282807	3282848		YPO_RS15660	41
RK1001.C0101_allcombined	3282889	3282969		YPO_RS15660	80
RK1001.C0101_allcombined	3283001	3283008		YPO_RS15660	7
RK1001.C0101_allcombined	3283056	3283072		YPO_RS15660	16
RK1001.C0101_allcombined	3283426	3283460		YPO_RS15665	34
RK1001.C0101_allcombined	3283545	3283548		YPO_RS15665	3
RK1001.C0101_allcombined	3283586	3283629		YPO_RS15665	43
RK1001.C0101_allcombined	3284277	3284288		YPO_RS15665	11
RK1001.C0101_allcombined	3284377	3284394		YPO_RS15665	17
RK1001.C0101_allcombined	3284429	3284476		YPO_RS15665	47
RK1001.C0101_allcombined	3284506	3284548		YPO_RS15665	42
RK1001.C0101_allcombined	3285809	3285849		YPO_RS15675	40
RK1001.C0101_allcombined	3285898	3285919		YPO_RS15675	21
RK1001.C0101_allcombined	3285973	3286004		YPO_RS15675	31
RK1001.C0101_allcombined	3286067	3286082		YPO_RS15675	15
RK1001.C0101_allcombined	3286307	3286322		YPO_RS15675	15
RK1001.C0101_allcombined	3286383	3286410		YPO_RS15675	27
RK1001.C0101_allcombined	3286575	3286588		YPO_RS15675	13
RK1001.C0101_allcombined	3286854	3286870		YPO_RS15675	16
RK1001.C0101_allcombined	3286907	3286910		YPO_RS15675	3
RK1001.C0101_allcombined	3287127	3287135		YPO_RS15675	8
RK1001.C0101_allcombined	3287209	3287238		YPO_RS15675	29
RK1001.C0101_allcombined	3287270	3287281		YPO_RS15675	11
RK1001.C0101_allcombined	3287321	3287339		YPO_RS15675	18
RK1001.C0101_allcombined	3287481	3287507		YPO_RS15680	26
RK1001.C0101_allcombined	3287712	3287721		YPO_RS15680	9
RK1001.C0101_allcombined	3287801	3287822		YPO_RS15680	21
RK1001.C0101_allcombined	3287875	3287885		YPO_RS15680	10
RK1001.C0101_allcombined	3288406	3288409		YPO_RS15685	3
RK1001.C0101_allcombined	3288496	3288513		YPO_RS15685	17
RK1001.C0101_allcombined	3288847	3288854		YPO_RS15685	7
RK1001.C0101_allcombined	3289145	3289161		tssH	16
RK1001.C0101_allcombined	3289237	3289249		tssH	12
RK1001.C0101_allcombined	3289376	3289380		tssH	4
RK1001.C0101_allcombined	3289583	3289584		tssH	1
RK1001.C0101_allcombined	3289629	3289649		tssH	20
RK1001.C0101_allcombined	3289690	3289701		tssH	11
RK1001.C0101_allcombined	3289849	3289876		tssH	27
RK1001.C0101_allcombined	3290500	3290511		tssH	11
RK1001.C0101_allcombined	3290725	3290741		tssH	16
RK1001.C0101_allcombined	3291301	3291306		tssH	5
RK1001.C0101_allcombined	3292603	3292608		tssF	5
RK1001.C0101_allcombined	3292902	3292909		tssF	7
RK1001.C0101_allcombined	3293530	3293538		tssF	8
RK1001.C0101_allcombined	3294025	3294041		tssF	16
RK1001.C0101_allcombined	3294141	3294149		tssF	8
RK1001.C0101_allcombined	3294249	3294262		tssF	13
RK1001.C0101_allcombined	3294337	3294348		tssF	11
RK1001.C0101_allcombined	3296199	3296215		YPO_RS15705	16
RK1001.C0101_allcombined	3296509	3296514		YPO_RS15705	5
RK1001.C0101_allcombined	3296555	3296596		YPO_RS15705	41
RK1001.C0101_allcombined	3296799	3296817		YPO_RS15710	18
RK1001.C0101_allcombined	3296858	3296859		YPO_RS15710	1
RK1001.C0101_allcombined	3296976	3297008		YPO_RS15710	32
RK1001.C0101_allcombined	3297264	3297298		YPO_RS15710	34
RK1001.C0101_allcombined	3297334	3297338		YPO_RS15710	4
RK1001.C0101_allcombined	3297446	3297521		YPO_RS15710	75
RK1001.C0101_allcombined	3297591	3297597		YPO_RS15710	6
RK1001.C0101_allcombined	3297814	3297826		YPO_RS15710	12
RK1001.C0101_allcombined	3297866	3297905		YPO_RS15715	39
RK1001.C0101_allcombined	3297981	3298016		YPO_RS15715	35
RK1001.C0101_allcombined	3298065	3298077		YPO_RS15715	12
RK1001.C0101_allcombined	3298449	3298469		YPO_RS15715	20
RK1001.C0101_allcombined	3298556	3298558		YPO_RS15715	2
RK1001.C0101_allcombined	3298602	3298633		YPO_RS15715	31
RK1001.C0101_allcombined	3298747	3298772		YPO_RS15715	25
RK1001.C0101_allcombined	3298932	3298957		YPO_RS15715	25
RK1001.C0101_allcombined	3299169	3299203		YPO_RS15715	34
RK1001.C0101_allcombined	3299200	3299209		YPO_RS15720	9
RK1001.C0101_allcombined	3299257	3299261		YPO_RS15720	4
RK1001.C0101_allcombined	3299426	3299471		YPO_RS15720	45
RK1001.C0101_allcombined	3299536	3299555		YPO_RS15720	19
RK1001.C0101_allcombined	3300049	3300069		YPO_RS15725	20
RK1001.C0101_allcombined	3300373	3300405		YPO_RS15725	32
RK1001.C0101_allcombined	3300552	3300553		YPO_RS15725	1
RK1001.C0101_allcombined	3300617	3300632		YPO_RS15725	15
RK1001.C0101_allcombined	3300809	3300836		YPO_RS15725	27
RK1001.C0101_allcombined	3300927	3300944		YPO_RS15725	17
RK1001.C0101_allcombined	3301225	3301250		YPO_RS15725	25
RK1001.C0101_allcombined	3301413	3301436		YPO_RS15725	23
RK1001.C0101_allcombined	3301528	3301566		YPO_RS15725	38
RK1001.C0101_allcombined	3301563	3301583		YPO_RS15730	20
RK1001.C0101_allcombined	3301664	3301728		YPO_RS15730	64
RK1001.C0101_allcombined	3301861	3301863		YPO_RS15730	2
RK1001.C0101_allcombined	3301952	3301959		YPO_RS15730	7
RK1001.C0101_allcombined	3302447	3302458		YPO_RS15735	11
RK1001.C0101_allcombined	3302555	3302563		YPO_RS15735	8
RK1001.C0101_allcombined	3302611	3302618		YPO_RS15735	7
RK1001.C0101_allcombined	3302800	3302914		YPO_RS15735	114
RK1001.C0101_allcombined	3302987	3303005		YPO_RS15735	18
RK1001.C0101_allcombined	3304387	3304389		mltB	2
RK1001.C0101_allcombined	3304982	3304996		mltB	14
RK1001.C0101_allcombined	3305190	3305192		mltB	2
RK1001.C0101_allcombined	3305347	3305354		mltB	7
RK1001.C0101_allcombined	3305696	3305697		YPO_RS15745	1
RK1001.C0101_allcombined	3305912	3305916		YPO_RS15745	4
RK1001.C0101_allcombined	3306259	3306270		YPO_RS15745	11
RK1001.C0101_allcombined	3306819	3306830		YPO_RS15750	11
RK1001.C0101_allcombined	3306885	3306904		YPO_RS15750	19
RK1001.C0101_allcombined	3307148	3307153		YPO_RS15750	5
RK1001.C0101_allcombined	3307339	3307348		YPO_RS15750	9
RK1001.C0101_allcombined	3307928	3307932		YPO_RS15750	4
RK1001.C0101_allcombined	3307980	3308010		YPO_RS15750	30
RK1001.C0101_allcombined	3308230	3308239		YPO_RS15750	9
RK1001.C0101_allcombined	3308350	3308367		YPO_RS15755	17
RK1001.C0101_allcombined	3309117	3309122		YPO_RS15755	5
RK1001.C0101_allcombined	3309929	3309963		YPO_RS15760	34
RK1001.C0101_allcombined	3309535	3309606		YPO_RS15760	71
RK1001.C0101_allcombined	3310454	3310498		YPO_RS15765	44
RK1001.C0101_allcombined	3310543	3310563		YPO_RS15765	20
RK1001.C0101_allcombined	3310676	3310759		YPO_RS15765	83
RK1001.C0101_allcombined	3310846	3310847		YPO_RS15765	1
RK1001.C0101_allcombined	3310906	3310910		YPO_RS15765	4
RK1001.C0101_allcombined	3311182	3311196		YPO_RS15770	14
RK1001.C0101_allcombined	3311374	3311397		YPO_RS15770	23
RK1001.C0101_allcombined	3311427	3311457		YPO_RS15770	30
RK1001.C0101_allcombined	3311590	3311596		YPO_RS15770	6
RK1001.C0101_allcombined	3311630	3311635		YPO_RS15770	5
RK1001.C0101_allcombined	3311791	3311819		YPO_RS15770	28
RK1001.C0101_allcombined	3311885	3311909		YPO_RS15770	24
RK1001.C0101_allcombined	3311963	3311991		YPO_RS15770	28
RK1001.C0101_allcombined	3312918	3312926		YPO_RS15775	8
RK1001.C0101_allcombined	3313352	3313368		YPO_RS15775	16
RK1001.C0101_allcombined	3314285	3314311		YPO_RS15775	26
RK1001.C0101_allcombined	3314399	3314404		YPO_RS15775	5
RK1001.C0101_allcombined	3314446	3314448		YPO_RS15775	2
RK1001.C0101_allcombined	3314578	3314592		YPO_RS15775	14
RK1001.C0101_allcombined	3314809	3314811		YPO_RS15775	2
RK1001.C0101_allcombined	3314845	3314853		YPO_RS15775	8
RK1001.C0101_allcombined	3314886	3314921		YPO_RS15775	35
RK1001.C0101_allcombined	3315204	3315216		YPO_RS15775	12
RK1001.C0101_allcombined	3315437	3315442		dmsB	5
RK1001.C0101_allcombined	3315478	3315500		dmsB	22
RK1001.C0101_allcombined	3315663	3315664		dmsB	1
RK1001.C0101_allcombined	3315864	3315865		dmsB	1
RK1001.C0101_allcombined	3315983	3315990		YPO_RS15785	7
RK1001.C0101_allcombined	3317473	3317481		YPO_RS15790	8
RK1001.C0101_allcombined	3318169	3318171		YPO_RS15795	2
RK1001.C0101_allcombined	3318316	3318319		YPO_RS15795	3
RK1001.C0101_allcombined	3318565	3318575		YPO_RS15800	10
RK1001.C0101_allcombined	3318855	3318864		YPO_RS15800	9
RK1001.C0101_allcombined	3319169	3319178		YPO_RS15800	9
RK1001.C0101_allcombined	3319484	3319492		YPO_RS15805	8
RK1001.C0101_allcombined	3319777	3319785		YPO_RS15810	8
RK1001.C0101_allcombined	3320102	3320105		YPO_RS15810	3
RK1001.C0101_allcombined	3320163	3320177		YPO_RS15810	14
RK1001.C0101_allcombined	3320232	3320241		YPO_RS15810	9
RK1001.C0101_allcombined	3320909	3320928		YPO_RS15815	19
RK1001.C0101_allcombined	3321095	3321100		YPO_RS15815	5
RK1001.C0101_allcombined	3321454	3321459		YPO_RS15820	5
RK1001.C0101_allcombined	3321850	3321867		YPO_RS15820	17
RK1001.C0101_allcombined	3324668	3324670		YPO_RS15830	2
RK1001.C0101_allcombined	3324763	3324778		YPO_RS15830	15
RK1001.C0101_allcombined	3324865	3324887		YPO_RS15830	22
RK1001.C0101_allcombined	3325079	3325080		glk	1
RK1001.C0101_allcombined	3325438	3325445		glk	7
RK1001.C0101_allcombined	3325612	3325639		glk	27
RK1001.C0101_allcombined	3325820	3325834		glk	14
RK1001.C0101_allcombined	3325925	3325951		glk	26
RK1001.C0101_allcombined	3326283	3326309		YPO_RS15840	26
RK1001.C0101_allcombined	3327340	3327342		YPO_RS15845	2
RK1001.C0101_allcombined	3327544	3327558		YPO_RS15845	14
RK1001.C0101_allcombined	3327913	3327932		YPO_RS15850	19
RK1001.C0101_allcombined	3328128	3328134		YPO_RS15850	6
RK1001.C0101_allcombined	3328532	3328533		YPO_RS15850	1
RK1001.C0101_allcombined	3329413	3329441		YPO_RS15860	28
RK1001.C0101_allcombined	3329532	3329533		YPO_RS15860	1
RK1001.C0101_allcombined	3329604	3329606		YPO_RS15860	2
RK1001.C0101_allcombined	3329659	3329674		YPO_RS15860	15
RK1001.C0101_allcombined	3329829	3329837		YPO_RS15860	8
RK1001.C0101_allcombined	3329957	3329959		YPO_RS15860	2
RK1001.C0101_allcombined	3330014	3330024		YPO_RS15860	10
RK1001.C0101_allcombined	3330464	3330490		YPO_RS15860	26
RK1001.C0101_allcombined	3331066	3331077		YPO_RS15865	11
RK1001.C0101_allcombined	3331362	3331376		YPO_RS15865	14
RK1001.C0101_allcombined	3331513	3331544		YPO_RS15865	31
RK1001.C0101_allcombined	3331694	3331703		YPO_RS15865	9
RK1001.C0101_allcombined	3331945	3331966		YPO_RS15865	21
RK1001.C0101_allcombined	3332052	3332060		YPO_RS15865	8
RK1001.C0101_allcombined	3332549	3332558		YPO_RS15870	9
RK1001.C0101_allcombined	3332692	3332694		YPO_RS15875	2
RK1001.C0101_allcombined	3332721	3332723		YPO_RS15880	2
RK1001.C0101_allcombined	3333847	3333877		gltX	30
RK1001.C0101_allcombined	3333992	3334019		gltX	27
RK1001.C0101_allcombined	3334056	3334063		gltX	7
RK1001.C0101_allcombined	3334464	3334503		gltX	39
RK1001.C0101_allcombined	3334734	3334740		gltX	6
RK1001.C0101_allcombined	3336054	3336061		YPO_RS15915	7
RK1001.C0101_allcombined	3336279	3336295		YPO_RS15920	16
RK1001.C0101_allcombined	3336397	3336456		YPO_RS15920	59
RK1001.C0101_allcombined	3336993	3336996		YPO_RS15925	3
RK1001.C0101_allcombined	3337474	3337481		YPO_RS15930	7
RK1001.C0101_allcombined	3337588	3337609		YPO_RS15930	21
RK1001.C0101_allcombined	3338812	3338834		ligA	22
RK1001.C0101_allcombined	3339241	3339245		ligA	4
RK1001.C0101_allcombined	3339619	3339625		ligA	6
RK1001.C0101_allcombined	3339975	3339988		zipA	13
RK1001.C0101_allcombined	3340530	3340551		zipA	21
RK1001.C0101_allcombined	3341533	3341536		cysZ	3
RK1001.C0101_allcombined	3342176	3342182		cysK	6
RK1001.C0101_allcombined	3342223	3342225		cysK	2
RK1001.C0101_allcombined	3342384	3342406		cysK	22
RK1001.C0101_allcombined	3342623	3342636		cysK	13
RK1001.C0101_allcombined	3343730	3343740		ptsI	10
RK1001.C0101_allcombined	3344288	3344345		ptsI	57
RK1001.C0101_allcombined	3344619	3344625		ptsI	6
RK1001.C0101_allcombined	3344875	3344888		ptsI	13
RK1001.C0101_allcombined	3345077	3345115		ptsI	38
RK1001.C0101_allcombined	3345488	3345493		crr	5
RK1001.C0101_allcombined	3345532	3345553		crr	21
RK1001.C0101_allcombined	3345866	3345889		crr	23
RK1001.C0101_allcombined	3346475	3346511		YPO_RS15970	36
RK1001.C0101_allcombined	3347459	3347464		YPO_RS15975	5
RK1001.C0101_allcombined	3347609	3347616		YPO_RS15975	7
RK1001.C0101_allcombined	3347697	3347705		YPO_RS15975	8
RK1001.C0101_allcombined	3347870	3347914		YPO_RS15975	44
RK1001.C0101_allcombined	3348209	3348237		YPO_RS15980	28
RK1001.C0101_allcombined	3348391	3348393		YPO_RS15980	2
RK1001.C0101_allcombined	3349292	3349305		YPO_RS15985	13
RK1001.C0101_allcombined	3349936	3349942		YPO_RS15985	6
RK1001.C0101_allcombined	3350289	3350291		macB	2
RK1001.C0101_allcombined	3350465	3350469		macB	4
RK1001.C0101_allcombined	3350501	3350511		macB	10
RK1001.C0101_allcombined	3350882	3350909		macB	27
RK1001.C0101_allcombined	3351041	3351072		macB	31
RK1001.C0101_allcombined	3351658	3351669		macB	11
RK1001.C0101_allcombined	3352137	3352147		macB	10
RK1001.C0101_allcombined	3352580	3352625		YPO_RS15995	45
RK1001.C0101_allcombined	3352767	3352820		YPO_RS15995	53
RK1001.C0101_allcombined	3352908	3352917		YPO_RS15995	9
RK1001.C0101_allcombined	3353027	3353038		YPO_RS15995	11
RK1001.C0101_allcombined	3353386	3353389		YPO_RS15995	3
RK1001.C0101_allcombined	3353514	3353556		YPO_RS15995	42
RK1001.C0101_allcombined	3353908	3354000		YPO_RS15995	92
RK1001.C0101_allcombined	3354062	3354063		YPO_RS15995	1
RK1001.C0101_allcombined	3354116	3354123		YPO_RS15995	7
RK1001.C0101_allcombined	3354305	3354324		YPO_RS16000	19
RK1001.C0101_allcombined	3354368	3354373		YPO_RS16000	5
RK1001.C0101_allcombined	3354411	3354438		YPO_RS16000	27
RK1001.C0101_allcombined	3354604	3354636		YPO_RS16000	32
RK1001.C0101_allcombined	3354931	3354941		YPO_RS16000	10
RK1001.C0101_allcombined	3355098	3355146		YPO_RS16000	48
RK1001.C0101_allcombined	3355346	3355481		YPO_RS16000	135
RK1001.C0101_allcombined	3355520	3355563		YPO_RS16000	43
RK1001.C0101_allcombined	3355700	3355709		YPO_RS16000	9
RK1001.C0101_allcombined	3355887	3355940		YPO_RS16005	53
RK1001.C0101_allcombined	3356083	3356105		YPO_RS16010	22
RK1001.C0101_allcombined	3356145	3356226		YPO_RS16010	81
RK1001.C0101_allcombined	3356271	3356279		YPO_RS16010	8
RK1001.C0101_allcombined	3356795	3356824		YPO_RS16010	29
RK1001.C0101_allcombined	3356860	3356865		YPO_RS16010	5
RK1001.C0101_allcombined	3356932	3356965		YPO_RS16010	33
RK1001.C0101_allcombined	3357017	3357020		YPO_RS16010	3
RK1001.C0101_allcombined	3357180	3357193		YPO_RS16015	13
RK1001.C0101_allcombined	3357336	3357372		YPO_RS16020	36
RK1001.C0101_allcombined	3357404	3357408		YPO_RS16020	4
RK1001.C0101_allcombined	3357743	3357825		YPO_RS16020	82
RK1001.C0101_allcombined	3357933	3357945		YPO_RS16020	12
RK1001.C0101_allcombined	3358150	3358159		YPO_RS16020	9
RK1001.C0101_allcombined	3358267	3358333		YPO_RS16020	66
RK1001.C0101_allcombined	3359225	3359253		YPO_RS16025	28
RK1001.C0101_allcombined	3359309	3359326		YPO_RS16025	17
RK1001.C0101_allcombined	3359406	3359412		YPO_RS16025	6
RK1001.C0101_allcombined	3360102	3360104		YPO_RS16025	2
RK1001.C0101_allcombined	3360135	3360176		YPO_RS16025	41
RK1001.C0101_allcombined	3360286	3360293		YPO_RS16025	7
RK1001.C0101_allcombined	3360349	3360364		YPO_RS16025	15
RK1001.C0101_allcombined	3360608	3360615		YPO_RS16025	7
RK1001.C0101_allcombined	3361141	3361196		YPO_RS16030	55
RK1001.C0101_allcombined	3361612	3361623		YPO_RS16030	11
RK1001.C0101_allcombined	3361739	3361763		YPO_RS16030	24
RK1001.C0101_allcombined	3362018	3362023		YPO_RS16030	5
RK1001.C0101_allcombined	3362239	3362270		YPO_RS16030	31
RK1001.C0101_allcombined	3362533	3362566		YPO_RS16035	33
RK1001.C0101_allcombined	3362676	3362677		YPO_RS16035	1
RK1001.C0101_allcombined	3363063	3363076		YPO_RS16035	13
RK1001.C0101_allcombined	3363505	3363569		YPO_RS16040	64
RK1001.C0101_allcombined	3363599	3363637		YPO_RS16040	38
RK1001.C0101_allcombined	3363675	3363733		YPO_RS16040	58
RK1001.C0101_allcombined	3363789	3363861		YPO_RS16040	72
RK1001.C0101_allcombined	3363907	3363962		YPO_RS16040	55
RK1001.C0101_allcombined	3364049	3364113		YPO_RS16040	64
RK1001.C0101_allcombined	3364144	3364222		YPO_RS16040	78
RK1001.C0101_allcombined	3364291	3364304		YPO_RS16040	13
RK1001.C0101_allcombined	3364365	3364383		YPO_RS16040	18
RK1001.C0101_allcombined	3364433	3364518		YPO_RS16040	85
RK1001.C0101_allcombined	3364643	3364712		YPO_RS16040	69
RK1001.C0101_allcombined	3365082	3365112		cysM	30
RK1001.C0101_allcombined	3365331	3365341		cysM	10
RK1001.C0101_allcombined	3365442	3365446		cysM	4
RK1001.C0101_allcombined	3365677	3365687		cysM	10
RK1001.C0101_allcombined	3366259	3366281		cysA	22
RK1001.C0101_allcombined	3366388	3366390		cysA	2
RK1001.C0101_allcombined	3366914	3366915		cysA	1
RK1001.C0101_allcombined	3367100	3367111		cysA	11
RK1001.C0101_allcombined	3367364	3367366		cysW	2
RK1001.C0101_allcombined	3367511	3367519		cysW	8
RK1001.C0101_allcombined	3369487	3369488		YPO_RS16065	1
RK1001.C0101_allcombined	3370221	3370224		YPO_RS16070	3
RK1001.C0101_allcombined	3370307	3370315		YPO_RS16070	8
RK1001.C0101_allcombined	3370529	3370546		YPO_RS16070	17
RK1001.C0101_allcombined	3370889	3370890		YPO_RS16070	1
RK1001.C0101_allcombined	3370999	3371012		YPO_RS16070	13
RK1001.C0101_allcombined	3371402	3371447		YPO_RS16070	45
RK1001.C0101_allcombined	3372447	3372455		YPO_RS16075	8
RK1001.C0101_allcombined	3372718	3372723		YPO_RS16075	5
RK1001.C0101_allcombined	3372777	3372806		YPO_RS16075	29
RK1001.C0101_allcombined	3373376	3373416		YPO_RS16080	40
RK1001.C0101_allcombined	3374327	3374332		YPO_RS16085	5
RK1001.C0101_allcombined	3374409	3374411		YPO_RS16085	2
RK1001.C0101_allcombined	3374455	3374462		YPO_RS16085	7
RK1001.C0101_allcombined	3374788	3374793		YPO_RS16085	5
RK1001.C0101_allcombined	3376358	3376371		YPO_RS16095	13
RK1001.C0101_allcombined	3376520	3376532		YPO_RS16095	12
RK1001.C0101_allcombined	3377572	3377591		YPO_RS16100	19
RK1001.C0101_allcombined	3378009	3378012		YPO_RS16100	3
RK1001.C0101_allcombined	3378043	3378059		YPO_RS16100	16
RK1001.C0101_allcombined	3378171	3378184		YPO_RS16105	13
RK1001.C0101_allcombined	3378247	3378258		YPO_RS16105	11
RK1001.C0101_allcombined	3378439	3378441		YPO_RS16105	2
RK1001.C0101_allcombined	3378758	3378763		YPO_RS16105	5
RK1001.C0101_allcombined	3379334	3379357		YPO_RS16110	23
RK1001.C0101_allcombined	3379498	3379502		YPO_RS16110	4
RK1001.C0101_allcombined	3379792	3379801		YPO_RS16110	9
RK1001.C0101_allcombined	3380237	3380255		YPO_RS16115	18
RK1001.C0101_allcombined	3380547	3380575		YPO_RS16115	28
RK1001.C0101_allcombined	3381105	3381146		yapL	41
RK1001.C0101_allcombined	3381190	3381215		yapL	25
RK1001.C0101_allcombined	3381280	3381300		yapL	20
RK1001.C0101_allcombined	3381634	3381658		yapL	24
RK1001.C0101_allcombined	3382156	3382157		yapL	1
RK1001.C0101_allcombined	3382699	3382712		yapL	13
RK1001.C0101_allcombined	3382789	3382821		yapL	32
RK1001.C0101_allcombined	3383134	3383145		yapL	11
RK1001.C0101_allcombined	3383219	3383239		yapL	20
RK1001.C0101_allcombined	3383343	3383344		yapL	1
RK1001.C0101_allcombined	3383499	3383517		YPO_RS16125	18
RK1001.C0101_allcombined	3383560	3383562		YPO_RS16125	2
RK1001.C0101_allcombined	3383618	3383768		YPO_RS16125	150
RK1001.C0101_allcombined	3383809	3383873		YPO_RS16125	64
RK1001.C0101_allcombined	3385086	3385088		hemF	2
RK1001.C0101_allcombined	3385639	3385648		hemF	9
RK1001.C0101_allcombined	3386266	3386268		YPO_RS16140	2
RK1001.C0101_allcombined	3386736	3386737		maeB	1
RK1001.C0101_allcombined	3387099	3387104		maeB	5
RK1001.C0101_allcombined	3387381	3387383		maeB	2
RK1001.C0101_allcombined	3387538	3387545		maeB	7
RK1001.C0101_allcombined	3388226	3388232		maeB	6
RK1001.C0101_allcombined	3389603	3389670		nudK	67
RK1001.C0101_allcombined	3390148	3390190		napC	42
RK1001.C0101_allcombined	3390243	3390254		napC	11
RK1001.C0101_allcombined	3390350	3390358		napC	8
RK1001.C0101_allcombined	3390675	3390680		napB	5
RK1001.C0101_allcombined	3390919	3390954		napB	35
RK1001.C0101_allcombined	3391341	3391343		napA	2
RK1001.C0101_allcombined	3391759	3391767		napA	8
RK1001.C0101_allcombined	3391869	3391884		napA	15
RK1001.C0101_allcombined	3392379	3392388		napA	9
RK1001.C0101_allcombined	3392716	3392762		napA	46
RK1001.C0101_allcombined	3392942	3392943		napA	1
RK1001.C0101_allcombined	3393035	3393049		napA	14
RK1001.C0101_allcombined	3393182	3393204		napA	22
RK1001.C0101_allcombined	3393374	3393387		napA	13
RK1001.C0101_allcombined	3395331	3395335		YPO_RS16180	4
RK1001.C0101_allcombined	3395535	3395557		YPO_RS16180	22
RK1001.C0101_allcombined	3395799	3395803		YPO_RS16185	4
RK1001.C0101_allcombined	3396776	3396788		acrD	12
RK1001.C0101_allcombined	3397037	3397052		acrD	15
RK1001.C0101_allcombined	3397163	3397185		acrD	22
RK1001.C0101_allcombined	3397946	3397950		acrD	4
RK1001.C0101_allcombined	3398195	3398217		acrD	22
RK1001.C0101_allcombined	3398874	3398889		acrD	15
RK1001.C0101_allcombined	3399163	3399172		acrD	9
RK1001.C0101_allcombined	3399337	3399380		acrD	43
RK1001.C0101_allcombined	3399586	3399596		acrD	10
RK1001.C0101_allcombined	3399827	3399883		YPO_RS16195	56
RK1001.C0101_allcombined	3399926	3399974		YPO_RS16195	48
RK1001.C0101_allcombined	3400032	3400045		YPO_RS16195	13
RK1001.C0101_allcombined	3400323	3400338		YPO_RS16195	15
RK1001.C0101_allcombined	3400396	3400411		YPO_RS16195	15
RK1001.C0101_allcombined	3400734	3400739		YPO_RS16200	5
RK1001.C0101_allcombined	3401176	3401177		YPO_RS16200	1
RK1001.C0101_allcombined	3402131	3402178		YPO_RS16205	47
RK1001.C0101_allcombined	3402614	3402711		YPO_RS16205	97
RK1001.C0101_allcombined	3402859	3402860		YPO_RS16205	1
RK1001.C0101_allcombined	3403128	3403177		YPO_RS16205	49
RK1001.C0101_allcombined	3403274	3403276		YPO_RS16210	2
RK1001.C0101_allcombined	3403368	3403488		YPO_RS16210	120
RK1001.C0101_allcombined	3403827	3403843		YPO_RS16210	16
RK1001.C0101_allcombined	3404026	3404049		YPO_RS16210	23
RK1001.C0101_allcombined	3404222	3404224		YPO_RS16210	2
RK1001.C0101_allcombined	3404428	3404434		YPO_RS16210	6
RK1001.C0101_allcombined	3404626	3404629		YPO_RS16210	3
RK1001.C0101_allcombined	3404671	3404672		YPO_RS16210	1
RK1001.C0101_allcombined	3404821	3404826		YPO_RS16210	5
RK1001.C0101_allcombined	3404884	3404905		YPO_RS16210	21
RK1001.C0101_allcombined	3405166	3405170		YPO_RS16215	4
RK1001.C0101_allcombined	3405236	3405296		YPO_RS16215	60
RK1001.C0101_allcombined	3405348	3405365		YPO_RS16215	17
RK1001.C0101_allcombined	3405523	3405528		YPO_RS16220	5
RK1001.C0101_allcombined	3405648	3405649		YPO_RS16220	1
RK1001.C0101_allcombined	3406071	3406092		YPO_RS16220	21
RK1001.C0101_allcombined	3406429	3406434		YPO_RS16220	5
RK1001.C0101_allcombined	3407809	3407817		YPO_RS16225	8
RK1001.C0101_allcombined	3408078	3408155		YPO_RS16225	77
RK1001.C0101_allcombined	3408560	3408582		YPO_RS16230	22
RK1001.C0101_allcombined	3408616	3408632		YPO_RS16230	16
RK1001.C0101_allcombined	3408684	3408711		YPO_RS16230	27
RK1001.C0101_allcombined	3408782	3408798		YPO_RS16230	16
RK1001.C0101_allcombined	3408966	3408967		YPO_RS16230	1
RK1001.C0101_allcombined	3409392	3409401		YPO_RS16230	9
RK1001.C0101_allcombined	3409867	3409872		YPO_RS16235	5
RK1001.C0101_allcombined	3410071	3410087		YPO_RS16235	16
RK1001.C0101_allcombined	3410959	3410962		dapE	3
RK1001.C0101_allcombined	3411116	3411126		dapE	10
RK1001.C0101_allcombined	3411950	3411954		YPO_RS16250	4
RK1001.C0101_allcombined	3412651	3412804		YPO_RS16255	153
RK1001.C0101_allcombined	3413013	3413035		YPO_RS16260	22
RK1001.C0101_allcombined	3413178	3413184		YPO_RS16260	6
RK1001.C0101_allcombined	3413512	3413540		YPO_RS16260	28
RK1001.C0101_allcombined	3414258	3414260		YPO_RS16260	2
RK1001.C0101_allcombined	3414458	3414466		YPO_RS16260	8
RK1001.C0101_allcombined	3415169	3415173		YPO_RS16265	4
RK1001.C0101_allcombined	3415444	3415455		YPO_RS16265	11
RK1001.C0101_allcombined	3415502	3415517		YPO_RS16265	15
RK1001.C0101_allcombined	3416147	3416169		YPO_RS16270	22
RK1001.C0101_allcombined	3416441	3416450		YPO_RS16270	9
RK1001.C0101_allcombined	3416874	3416890		purC	16
RK1001.C0101_allcombined	3417055	3417068		purC	13
RK1001.C0101_allcombined	3417228	3417247		purC	19
RK1001.C0101_allcombined	3417457	3417458		purC	1
RK1001.C0101_allcombined	3417990	3417992		YPO_RS16280	2
RK1001.C0101_allcombined	3418730	3418734		bamC	4
RK1001.C0101_allcombined	3418786	3418803		bamC	17
RK1001.C0101_allcombined	3419259	3419277		bamC	18
RK1001.C0101_allcombined	3419592	3419619		dapA	27
RK1001.C0101_allcombined	3419674	3419715		dapA	41
RK1001.C0101_allcombined	3420648	3420650		YPO_RS16295	2
RK1001.C0101_allcombined	3421361	3421364		bcp	3
RK1001.C0101_allcombined	3422076	3422090		YPO_RS16305	14
RK1001.C0101_allcombined	3422121	3422131		YPO_RS16305	10
RK1001.C0101_allcombined	3422189	3422192		YPO_RS16305	3
RK1001.C0101_allcombined	3422249	3422250		YPO_RS16305	1
RK1001.C0101_allcombined	3422395	3422430		YPO_RS16305	35
RK1001.C0101_allcombined	3422589	3422594		YPO_RS16305	5
RK1001.C0101_allcombined	3422652	3422660		YPO_RS16305	8
RK1001.C0101_allcombined	3423490	3423510		YPO_RS16310	20
RK1001.C0101_allcombined	3424360	3424363		YPO_RS16310	3
RK1001.C0101_allcombined	3425052	3425073		YPO_RS16315	21
RK1001.C0101_allcombined	3425244	3425261		YPO_RS16315	17
RK1001.C0101_allcombined	3425775	3425782		YPO_RS16315	7
RK1001.C0101_allcombined	3425893	3425895		YPO_RS16315	2
RK1001.C0101_allcombined	3425935	3425941		YPO_RS16315	6
RK1001.C0101_allcombined	3426921	3426926		hda	5
RK1001.C0101_allcombined	3429205	3429218		cysS	13
RK1001.C0101_allcombined	3429512	3429557		cysS	45
RK1001.C0101_allcombined	3429779	3429786		cysS	7
RK1001.C0101_allcombined	3429929	3429932		cysS	3
RK1001.C0101_allcombined	3430215	3430238		ppiB	23
RK1001.C0101_allcombined	3430797	3430825		YPO_RS16345	28
RK1001.C0101_allcombined	3431165	3431180		YPO_RS16345	15
RK1001.C0101_allcombined	3431879	3431953		purE	74
RK1001.C0101_allcombined	3432700	3432703		purK	3
RK1001.C0101_allcombined	3433269	3433295		purK	26
RK1001.C0101_allcombined	3433759	3433763		YPO_RS16360	4
RK1001.C0101_allcombined	3434081	3434093		YPO_RS16360	12
RK1001.C0101_allcombined	3434374	3434392		YPO_RS16360	18
RK1001.C0101_allcombined	3434766	3434772		YPO_RS16360	6
RK1001.C0101_allcombined	3435209	3435215		YPO_RS16360	6
RK1001.C0101_allcombined	3435412	3435416		YPO_RS16360	4
RK1001.C0101_allcombined	3435570	3435586		YPO_RS16360	16
RK1001.C0101_allcombined	3436143	3436145		YPO_RS16365	2
RK1001.C0101_allcombined	3437059	3437081		tesA	22
RK1001.C0101_allcombined	3438339	3438340		YPO_RS16380	1
RK1001.C0101_allcombined	3439389	3439397		YPO_RS16385	8
RK1001.C0101_allcombined	3440294	3440303		YPO_RS16385	9
RK1001.C0101_allcombined	3440864	3440876		cueR	12
RK1001.C0101_allcombined	3441280	3441283		cueR	3
RK1001.C0101_allcombined	3441598	3441607		copA	9
RK1001.C0101_allcombined	3441784	3441807		copA	23
RK1001.C0101_allcombined	3441995	3442033		copA	38
RK1001.C0101_allcombined	3442743	3442752		copA	9
RK1001.C0101_allcombined	3444939	3444960		YPO_RS16405	21
RK1001.C0101_allcombined	3445969	3445975		ybaK	6
RK1001.C0101_allcombined	3446281	3446284		ybaK	3
RK1001.C0101_allcombined	3446802	3446810		YPO_RS16415	8
RK1001.C0101_allcombined	3449136	3449167		YPO_RS16425	31
RK1001.C0101_allcombined	3449252	3449262		YPO_RS16425	10
RK1001.C0101_allcombined	3449340	3449343		YPO_RS16425	3
RK1001.C0101_allcombined	3449761	3449804		YPO_RS16425	43
RK1001.C0101_allcombined	3449929	3450042		YPO_RS16425	113
RK1001.C0101_allcombined	3450164	3450185		YPO_RS16425	21
RK1001.C0101_allcombined	3450537	3450561		YPO_RS16430	24
RK1001.C0101_allcombined	3450601	3450615		YPO_RS16430	14
RK1001.C0101_allcombined	3450911	3450924		YPO_RS16430	13
RK1001.C0101_allcombined	3451483	3451492		YPO_RS16430	9
RK1001.C0101_allcombined	3452809	3452814		YPO_RS16435	5
RK1001.C0101_allcombined	3452909	3452927		YPO_RS16435	18
RK1001.C0101_allcombined	3453106	3453112		YPO_RS16435	6
RK1001.C0101_allcombined	3453193	3453202		YPO_RS16435	9
RK1001.C0101_allcombined	3453360	3453398		YPO_RS16435	38
RK1001.C0101_allcombined	3453996	3454027		fepE	31
RK1001.C0101_allcombined	3454129	3454135		fepE	6
RK1001.C0101_allcombined	3454272	3454323		fepE	51
RK1001.C0101_allcombined	3454435	3454478		fepE	43
RK1001.C0101_allcombined	3454514	3454549		fepE	35
RK1001.C0101_allcombined	3454580	3454587		fepE	7
RK1001.C0101_allcombined	3454676	3454688		fepE	12
RK1001.C0101_allcombined	3454766	3454872		fepE	106
RK1001.C0101_allcombined	3455009	3455021		cpsG	12
RK1001.C0101_allcombined	3455124	3455136		cpsG	12
RK1001.C0101_allcombined	3455247	3455326		cpsG	79
RK1001.C0101_allcombined	3455437	3455457		cpsG	20
RK1001.C0101_allcombined	3455510	3455535		cpsG	25
RK1001.C0101_allcombined	3455820	3455832		cpsG	12
RK1001.C0101_allcombined	3455897	3455959		cpsG	62
RK1001.C0101_allcombined	3456103	3456188		cpsG	85
RK1001.C0101_allcombined	3456229	3456258		cpsG	29
RK1001.C0101_allcombined	3456351	3456382		cpsG	31
RK1001.C0101_allcombined	3456387	3456404		YPO_RS16450	17
RK1001.C0101_allcombined	3456535	3456607		YPO_RS16450	72
RK1001.C0101_allcombined	3456641	3456651		YPO_RS16450	10
RK1001.C0101_allcombined	3456744	3456765		YPO_RS16450	21
RK1001.C0101_allcombined	3456810	3456854		YPO_RS16450	44
RK1001.C0101_allcombined	3456927	3456960		YPO_RS16450	33
RK1001.C0101_allcombined	3457012	3457019		YPO_RS16450	7
RK1001.C0101_allcombined	3457063	3457130		YPO_RS16450	67
RK1001.C0101_allcombined	3457133	3457143		YPO_RS16455	10
RK1001.C0101_allcombined	3457350	3457359		YPO_RS16455	9
RK1001.C0101_allcombined	3457539	3457555		YPO_RS16455	16
RK1001.C0101_allcombined	3457643	3457651		YPO_RS16455	8
RK1001.C0101_allcombined	3457743	3457778		YPO_RS16455	35
RK1001.C0101_allcombined	3458224	3458226		YPO_RS16455	2
RK1001.C0101_allcombined	3458447	3458456		YPO_RS16455	9
RK1001.C0101_allcombined	3458533	3458539		YPO_RS16455	6
RK1001.C0101_allcombined	3460841	3460894		YPO_RS16470	53
RK1001.C0101_allcombined	3461221	3461285		YPO_RS16470	64
RK1001.C0101_allcombined	3461346	3461405		YPO_RS16470	59
RK1001.C0101_allcombined	3461579	3461677		YPO_RS16470	98
RK1001.C0101_allcombined	3461803	3461854		YPO_RS16470	51
RK1001.C0101_allcombined	3463321	3463430		YPO_RS16480	109
RK1001.C0101_allcombined	3463475	3463500		YPO_RS16480	25
RK1001.C0101_allcombined	3463634	3463645		YPO_RS16480	11
RK1001.C0101_allcombined	3463700	3463720		YPO_RS16480	20
RK1001.C0101_allcombined	3463760	3463824		YPO_RS16480	64
RK1001.C0101_allcombined	3463856	3463976		YPO_RS16480	120
RK1001.C0101_allcombined	3464016	3464181		YPO_RS16480	165
RK1001.C0101_allcombined	3464257	3464268		YPO_RS16480	11
RK1001.C0101_allcombined	3464301	3464347		YPO_RS16480	46
RK1001.C0101_allcombined	3464431	3464435		YPO_RS16480	4
RK1001.C0101_allcombined	3464843	3464902		YPO_RS16485	59
RK1001.C0101_allcombined	3464981	3465099		YPO_RS16485	118
RK1001.C0101_allcombined	3465180	3465247		YPO_RS16485	67
RK1001.C0101_allcombined	3465316	3465338		YPO_RS16485	22
RK1001.C0101_allcombined	3465371	3465410		YPO_RS16485	39
RK1001.C0101_allcombined	3465483	3465556		YPO_RS16485	73
RK1001.C0101_allcombined	3465567	3465571		YPO_RS16490	4
RK1001.C0101_allcombined	3465619	3465638		YPO_RS16490	19
RK1001.C0101_allcombined	3465676	3465689		YPO_RS16490	13
RK1001.C0101_allcombined	3465753	3465764		YPO_RS16490	11
RK1001.C0101_allcombined	3465829	3465982		YPO_RS16490	153
RK1001.C0101_allcombined	3466031	3466054		YPO_RS16490	23
RK1001.C0101_allcombined	3466133	3466135		YPO_RS16490	2
RK1001.C0101_allcombined	3466259	3466431		YPO_RS16490	172
RK1001.C0101_allcombined	3466520	3466528		YPO_RS16490	8
RK1001.C0101_allcombined	3466586	3466630		YPO_RS16490	44
RK1001.C0101_allcombined	3466677	3466690		YPO_RS16490	13
RK1001.C0101_allcombined	3466762	3466862		YPO_RS16490	100
RK1001.C0101_allcombined	3466984	3467029		YPO_RS16495	45
RK1001.C0101_allcombined	3467079	3467239		YPO_RS16495	160
RK1001.C0101_allcombined	3467336	3467460		YPO_RS16495	124
RK1001.C0101_allcombined	3467525	3467617		YPO_RS16495	92
RK1001.C0101_allcombined	3467670	3467690		YPO_RS16495	20
RK1001.C0101_allcombined	3468014	3468087		YPO_RS16495	73
RK1001.C0101_allcombined	3468188	3468195		YPO_RS16495	7
RK1001.C0101_allcombined	3468483	3468485		YPO_RS16500	2
RK1001.C0101_allcombined	3468538	3468553		YPO_RS16500	15
RK1001.C0101_allcombined	3468613	3468730		YPO_RS16500	117
RK1001.C0101_allcombined	3468760	3468764		YPO_RS16500	4
RK1001.C0101_allcombined	3468843	3468995		YPO_RS16500	152
RK1001.C0101_allcombined	3469101	3469116		YPO_RS16500	15
RK1001.C0101_allcombined	3469176	3469208		rfbH	32
RK1001.C0101_allcombined	3469268	3469275		rfbH	7
RK1001.C0101_allcombined	3469305	3469308		rfbH	3
RK1001.C0101_allcombined	3469508	3469526		rfbH	18
RK1001.C0101_allcombined	3469614	3469632		rfbH	18
RK1001.C0101_allcombined	3470086	3470137		rfbH	51
RK1001.C0101_allcombined	3470245	3470263		rfbH	18
RK1001.C0101_allcombined	3470498	3470534		rfbG	36
RK1001.C0101_allcombined	3470823	3470828		rfbG	5
RK1001.C0101_allcombined	3471090	3471119		rfbG	29
RK1001.C0101_allcombined	3471171	3471179		rfbG	8
RK1001.C0101_allcombined	3471713	3471718		rfbF	5
RK1001.C0101_allcombined	3471973	3471977		rfbF	4
RK1001.C0101_allcombined	3472193	3472231		rfbF	38
RK1001.C0101_allcombined	3472384	3472402		YPO_RS16520	18
RK1001.C0101_allcombined	3472492	3472502		YPO_RS16520	10
RK1001.C0101_allcombined	3472533	3472625		YPO_RS16520	92
RK1001.C0101_allcombined	3472671	3472691		YPO_RS16520	20
RK1001.C0101_allcombined	3472865	3472886		YPO_RS16520	21
RK1001.C0101_allcombined	3472937	3472951		YPO_RS16520	14
RK1001.C0101_allcombined	3473048	3473141		YPO_RS16520	93
RK1001.C0101_allcombined	3473305	3473338		YPO_RS16520	33
RK1001.C0101_allcombined	3474173	3474202		hemH	29
RK1001.C0101_allcombined	3474299	3474306		hemH	7
RK1001.C0101_allcombined	3475101	3475112		adk	11
RK1001.C0101_allcombined	3475920	3475935		htpG	15
RK1001.C0101_allcombined	3476372	3476401		htpG	29
RK1001.C0101_allcombined	3476512	3476519		htpG	7
RK1001.C0101_allcombined	3476950	3476963		htpG	13
RK1001.C0101_allcombined	3477271	3477291		htpG	20
RK1001.C0101_allcombined	3477476	3477510		htpG	34
RK1001.C0101_allcombined	3477960	3477968		recR	8
RK1001.C0101_allcombined	3478048	3478049		recR	1
RK1001.C0101_allcombined	3478213	3478217		recR	4
RK1001.C0101_allcombined	3479234	3479287		dnaX	53
RK1001.C0101_allcombined	3479521	3479529		dnaX	8
RK1001.C0101_allcombined	3480378	3480380		dnaX	2
RK1001.C0101_allcombined	3480594	3480602		dnaX	8
RK1001.C0101_allcombined	3480808	3480815		dnaX	7
RK1001.C0101_allcombined	3480894	3480895		dnaX	1
RK1001.C0101_allcombined	3481811	3481835		apt	24
RK1001.C0101_allcombined	3481889	3481909		apt	20
RK1001.C0101_allcombined	3482083	3482110		apt	27
RK1001.C0101_allcombined	3483020	3483045		YPO_RS16560	25
RK1001.C0101_allcombined	3485198	3485218		YPO_RS16575	20
RK1001.C0101_allcombined	3486230	3486256		mscK	26
RK1001.C0101_allcombined	3486403	3486425		mscK	22
RK1001.C0101_allcombined	3486473	3486518		mscK	45
RK1001.C0101_allcombined	3487023	3487056		mscK	33
RK1001.C0101_allcombined	3487093	3487094		mscK	1
RK1001.C0101_allcombined	3487389	3487418		mscK	29
RK1001.C0101_allcombined	3487521	3487528		mscK	7
RK1001.C0101_allcombined	3487871	3487882		mscK	11
RK1001.C0101_allcombined	3487945	3487960		mscK	15
RK1001.C0101_allcombined	3488186	3488203		mscK	17
RK1001.C0101_allcombined	3488580	3488607		mscK	27
RK1001.C0101_allcombined	3489281	3489289		mscK	8
RK1001.C0101_allcombined	3490094	3490139		YPO_RS16590	45
RK1001.C0101_allcombined	3490581	3490593		acrR	12
RK1001.C0101_allcombined	3490665	3490683		acrR	18
RK1001.C0101_allcombined	3490771	3490778		acrR	7
RK1001.C0101_allcombined	3491542	3491544		YPO_RS16600	2
RK1001.C0101_allcombined	3491857	3491862		YPO_RS16600	5
RK1001.C0101_allcombined	3492830	3492835		YPO_RS16605	5
RK1001.C0101_allcombined	3492880	3492898		YPO_RS16605	18
RK1001.C0101_allcombined	3493128	3493134		YPO_RS16605	6
RK1001.C0101_allcombined	3493164	3493205		YPO_RS16605	41
RK1001.C0101_allcombined	3493597	3493631		YPO_RS16605	34
RK1001.C0101_allcombined	3493921	3493958		YPO_RS16605	37
RK1001.C0101_allcombined	3494521	3494526		YPO_RS16605	5
RK1001.C0101_allcombined	3494649	3494653		YPO_RS16605	4
RK1001.C0101_allcombined	3494742	3494749		YPO_RS16605	7
RK1001.C0101_allcombined	3495119	3495133		YPO_RS16605	14
RK1001.C0101_allcombined	3495175	3495201		YPO_RS16605	26
RK1001.C0101_allcombined	3495659	3495664		YPO_RS16610	5
RK1001.C0101_allcombined	3495910	3495914		rpmJ	4
RK1001.C0101_allcombined	3496840	3496898		YPO_RS16620	58
RK1001.C0101_allcombined	3497028	3497087		YPO_RS16620	59
RK1001.C0101_allcombined	3497480	3497482		tomB	2
RK1001.C0101_allcombined	3497522	3497549		tomB	27
RK1001.C0101_allcombined	3497636	3497668		tomB	32
RK1001.C0101_allcombined	3498557	3498558		ffs	1
RK1001.C0101_allcombined	3498840	3498841		YPO_RS16640	1
RK1001.C0101_allcombined	3500483	3500488		tesB	5
RK1001.C0101_allcombined	3501247	3501261		amtB	14
RK1001.C0101_allcombined	3501294	3501297		amtB	3
RK1001.C0101_allcombined	3501667	3501682		amtB	15
RK1001.C0101_allcombined	3502241	3502244		amtB	3
RK1001.C0101_allcombined	3503345	3503354		YPO_RS16665	9
RK1001.C0101_allcombined	3504041	3504042		YPO_RS16665	1
RK1001.C0101_allcombined	3504108	3504119		YPO_RS16665	11
RK1001.C0101_allcombined	3504356	3504373		YPO_RS16665	17
RK1001.C0101_allcombined	3504513	3504530		YPO_RS16665	17
RK1001.C0101_allcombined	3504790	3504805		YPO_RS16665	15
RK1001.C0101_allcombined	3504986	3504990		YPO_RS16665	4
RK1001.C0101_allcombined	3505896	3505926		YPO_RS16670	30
RK1001.C0101_allcombined	3506057	3506110		YPO_RS16670	53
RK1001.C0101_allcombined	3506463	3506485		YPO_RS16670	22
RK1001.C0101_allcombined	3506738	3506778		YPO_RS16670	40
RK1001.C0101_allcombined	3507221	3507228		YPO_RS16675	7
RK1001.C0101_allcombined	3507421	3507453		YPO_RS16675	32
RK1001.C0101_allcombined	3507579	3507596		YPO_RS16680	17
RK1001.C0101_allcombined	3507703	3507769		YPO_RS16680	66
RK1001.C0101_allcombined	3508002	3508011		YPO_RS16680	9
RK1001.C0101_allcombined	3508261	3508275		YPO_RS16680	14
RK1001.C0101_allcombined	3508547	3508564		YPO_RS16680	17
RK1001.C0101_allcombined	3508831	3508836		cof	5
RK1001.C0101_allcombined	3509068	3509091		cof	23
RK1001.C0101_allcombined	3509368	3509374		cof	6
RK1001.C0101_allcombined	3509494	3509495		cof	1
RK1001.C0101_allcombined	3510096	3510100		YPO_RS16690	4
RK1001.C0101_allcombined	3510203	3510221		YPO_RS16690	18
RK1001.C0101_allcombined	3511402	3511411		YPO_RS16690	9
RK1001.C0101_allcombined	3512034	3512061		queC	27
RK1001.C0101_allcombined	3512270	3512279		queC	9
RK1001.C0101_allcombined	3512721	3512737		YPO_RS16700	16
RK1001.C0101_allcombined	3512886	3512916		YPO_RS16700	30
RK1001.C0101_allcombined	3513624	3513634		YPO_RS16705	10
RK1001.C0101_allcombined	3513671	3513716		YPO_RS16705	45
RK1001.C0101_allcombined	3514473	3514480		ppiD	7
RK1001.C0101_allcombined	3514938	3515000		ppiD	62
RK1001.C0101_allcombined	3515381	3515414		ppiD	33
RK1001.C0101_allcombined	3516291	3516314		hupB	23
RK1001.C0101_allcombined	3516689	3516702		lon	13
RK1001.C0101_allcombined	3517038	3517068		lon	30
RK1001.C0101_allcombined	3517420	3517426		lon	6
RK1001.C0101_allcombined	3517474	3517503		lon	29
RK1001.C0101_allcombined	3517638	3517663		lon	25
RK1001.C0101_allcombined	3517749	3517761		lon	12
RK1001.C0101_allcombined	3517805	3517814		lon	9
RK1001.C0101_allcombined	3518230	3518231		lon	1
RK1001.C0101_allcombined	3518365	3518369		lon	4
RK1001.C0101_allcombined	3518670	3518677		lon	7
RK1001.C0101_allcombined	3519093	3519098		clpX	5
RK1001.C0101_allcombined	3519375	3519381		clpX	6
RK1001.C0101_allcombined	3519602	3519617		clpX	15
RK1001.C0101_allcombined	3519753	3519755		clpX	2
RK1001.C0101_allcombined	3520029	3520036		clpX	7
RK1001.C0101_allcombined	3520652	3520677		clpP	25
RK1001.C0101_allcombined	3520841	3520845		clpP	4
RK1001.C0101_allcombined	3520942	3520954		clpP	12
RK1001.C0101_allcombined	3521024	3521033		clpP	9
RK1001.C0101_allcombined	3521179	3521182		clpP	3
RK1001.C0101_allcombined	3522605	3522620		tig	15
RK1001.C0101_allcombined	3522676	3522706		tig	30
RK1001.C0101_allcombined	3522738	3522752		tig	14
RK1001.C0101_allcombined	3524146	3524155		YPO_RS16745	9
RK1001.C0101_allcombined	3524558	3524562		YPO_RS16745	4
RK1001.C0101_allcombined	3525174	3525181		ampG	7
RK1001.C0101_allcombined	3525663	3525696		ampG	33
RK1001.C0101_allcombined	3525929	3525930		ampG	1
RK1001.C0101_allcombined	3526007	3526020		ampG	13
RK1001.C0101_allcombined	3526079	3526081		ampG	2
RK1001.C0101_allcombined	3526780	3526792		YPO_RS16755	12
RK1001.C0101_allcombined	3526829	3526901		YPO_RS16755	72
RK1001.C0101_allcombined	3527199	3527221		YPO_RS16755	22
RK1001.C0101_allcombined	3527664	3527666		cyoA	2
RK1001.C0101_allcombined	3528060	3528067		cyoA	7
RK1001.C0101_allcombined	3528833	3528834		cyoB	1
RK1001.C0101_allcombined	3529162	3529172		cyoB	10
RK1001.C0101_allcombined	3529356	3529405		cyoB	49
RK1001.C0101_allcombined	3529494	3529499		cyoB	5
RK1001.C0101_allcombined	3529741	3529745		cyoB	4
RK1001.C0101_allcombined	3530187	3530197		cyoB	10
RK1001.C0101_allcombined	3530609	3530622		YPO_RS16770	13
RK1001.C0101_allcombined	3530732	3530756		YPO_RS16770	24
RK1001.C0101_allcombined	3530873	3530874		YPO_RS16770	1
RK1001.C0101_allcombined	3531368	3531378		YPO_RS16775	10
RK1001.C0101_allcombined	3531597	3531602		cyoE	5
RK1001.C0101_allcombined	3531691	3531706		cyoE	15
RK1001.C0101_allcombined	3531920	3531934		cyoE	14
RK1001.C0101_allcombined	3532141	3532145		cyoE	4
RK1001.C0101_allcombined	3532176	3532179		cyoE	3
RK1001.C0101_allcombined	3533125	3533131		YPO_RS16785	6
RK1001.C0101_allcombined	3534218	3534219		YPO_RS16785	1
RK1001.C0101_allcombined	3534551	3534562		YPO_RS16790	11
RK1001.C0101_allcombined	3534600	3534612		YPO_RS16790	12
RK1001.C0101_allcombined	3535320	3535411		panE	91
RK1001.C0101_allcombined	3535582	3535603		panE	21
RK1001.C0101_allcombined	3535846	3535862		panE	16
RK1001.C0101_allcombined	3536398	3536415		yajL	17
RK1001.C0101_allcombined	3536455	3536456		yajL	1
RK1001.C0101_allcombined	3537962	3537970		thiI	8
RK1001.C0101_allcombined	3538076	3538099		thiI	23
RK1001.C0101_allcombined	3538720	3538735		ispA	15
RK1001.C0101_allcombined	3538946	3538961		ispA	15
RK1001.C0101_allcombined	3539444	3539459		ispA	15
RK1001.C0101_allcombined	3539619	3539633		ispA	14
RK1001.C0101_allcombined	3540246	3540261		dxs	15
RK1001.C0101_allcombined	3540480	3540558		dxs	78
RK1001.C0101_allcombined	3540711	3540725		dxs	14
RK1001.C0101_allcombined	3541128	3541132		dxs	4
RK1001.C0101_allcombined	3541446	3541481		dxs	35
RK1001.C0101_allcombined	3542881	3542918		pgpA	37
RK1001.C0101_allcombined	3542981	3542984		pgpA	3
RK1001.C0101_allcombined	3542981	3542998		thiL	17
RK1001.C0101_allcombined	3543092	3543096		thiL	4
RK1001.C0101_allcombined	3543249	3543260		thiL	11
RK1001.C0101_allcombined	3543583	3543637		thiL	54
RK1001.C0101_allcombined	3544644	3544657		ribE	13
RK1001.C0101_allcombined	3544712	3544717		ribE	5
RK1001.C0101_allcombined	3545520	3545539		ribD	19
RK1001.C0101_allcombined	3546603	3546604		nrdR	1
RK1001.C0101_allcombined	3546752	3546756		nrdR	4
RK1001.C0101_allcombined	3547227	3547239		YPO_RS16860	12
RK1001.C0101_allcombined	3547354	3547365		YPO_RS16860	11
RK1001.C0101_allcombined	3547414	3547523		YPO_RS16860	109
RK1001.C0101_allcombined	3547682	3547693		YPO_RS16865	11
RK1001.C0101_allcombined	3547948	3547974		YPO_RS16865	26
RK1001.C0101_allcombined	3548034	3548035		YPO_RS16865	1
RK1001.C0101_allcombined	3548097	3548104		YPO_RS16865	7
RK1001.C0101_allcombined	3548254	3548291		YPO_RS16865	37
RK1001.C0101_allcombined	3550158	3550161		secF	3
RK1001.C0101_allcombined	3550231	3550247		secF	16
RK1001.C0101_allcombined	3550587	3550599		secD	12
RK1001.C0101_allcombined	3551017	3551157		secD	140
RK1001.C0101_allcombined	3551350	3551360		secD	10
RK1001.C0101_allcombined	3551736	3551738		secD	2
RK1001.C0101_allcombined	3552418	3552420		yajC	2
RK1001.C0101_allcombined	3552614	3552636		tgt	22
RK1001.C0101_allcombined	3552669	3552675		tgt	6
RK1001.C0101_allcombined	3553017	3553018		tgt	1
RK1001.C0101_allcombined	3553389	3553401		tgt	12
RK1001.C0101_allcombined	3553602	3553623		tgt	21
RK1001.C0101_allcombined	3553730	3553738		tgt	8
RK1001.C0101_allcombined	3553934	3553952		queA	18
RK1001.C0101_allcombined	3553992	3554021		queA	29
RK1001.C0101_allcombined	3554246	3554249		queA	3
RK1001.C0101_allcombined	3555206	3555218		YPO_RS16900	12
RK1001.C0101_allcombined	3559739	3559750		YPO_RS16920	11
RK1001.C0101_allcombined	3559794	3559831		YPO_RS16920	37
RK1001.C0101_allcombined	3560229	3560245		YPO_RS16920	16
RK1001.C0101_allcombined	3560323	3560326		YPO_RS16920	3
RK1001.C0101_allcombined	3560323	3560326		YPO_RS16925	3
RK1001.C0101_allcombined	3560514	3560517		malZ	3
RK1001.C0101_allcombined	3560663	3560719		malZ	56
RK1001.C0101_allcombined	3560806	3560810		malZ	4
RK1001.C0101_allcombined	3560848	3560861		malZ	13
RK1001.C0101_allcombined	3560956	3560959		malZ	3
RK1001.C0101_allcombined	3561451	3561466		malZ	15
RK1001.C0101_allcombined	3561541	3561543		malZ	2
RK1001.C0101_allcombined	3561677	3561714		malZ	37
RK1001.C0101_allcombined	3561770	3561788		malZ	18
RK1001.C0101_allcombined	3562924	3562961		proY	37
RK1001.C0101_allcombined	3562997	3563015		proY	18
RK1001.C0101_allcombined	3563144	3563151		proY	7
RK1001.C0101_allcombined	3563452	3563475		proY	23
RK1001.C0101_allcombined	3563749	3563773		proY	24
RK1001.C0101_allcombined	3563889	3563890		proY	1
RK1001.C0101_allcombined	3564124	3564142		proY	18
RK1001.C0101_allcombined	3564261	3564276		proY	15
RK1001.C0101_allcombined	3564723	3564729		brnQ	6
RK1001.C0101_allcombined	3565278	3565295		brnQ	17
RK1001.C0101_allcombined	3565635	3565637		brnQ	2
RK1001.C0101_allcombined	3567005	3567007		YPO_RS16945	2
RK1001.C0101_allcombined	3567287	3567305		phoR	18
RK1001.C0101_allcombined	3567387	3567405		phoR	18
RK1001.C0101_allcombined	3567984	3567988		phoR	4
RK1001.C0101_allcombined	3568308	3568348		phoR	40
RK1001.C0101_allcombined	3568475	3568479		phoR	4
RK1001.C0101_allcombined	3568689	3568712		phoB	23
RK1001.C0101_allcombined	3568772	3568774		phoB	2
RK1001.C0101_allcombined	3568831	3568832		phoB	1
RK1001.C0101_allcombined	3569529	3569557		sbcD	28
RK1001.C0101_allcombined	3569791	3569862		sbcD	71
RK1001.C0101_allcombined	3570137	3570162		sbcD	25
RK1001.C0101_allcombined	3570798	3570807		YPO_RS16965	9
RK1001.C0101_allcombined	3571577	3571594		YPO_RS16965	17
RK1001.C0101_allcombined	3571738	3571751		YPO_RS16965	13
RK1001.C0101_allcombined	3573137	3573143		YPO_RS16965	6
RK1001.C0101_allcombined	3573656	3573686		YPO_RS16965	30
RK1001.C0101_allcombined	3573955	3573957		YPO_RS16965	2
RK1001.C0101_allcombined	3574353	3574376		YPO_RS16965	23
RK1001.C0101_allcombined	3574420	3574426		YPO_RS16965	6
RK1001.C0101_allcombined	3574784	3574791		YPO_RS16970	7
RK1001.C0101_allcombined	3575381	3575386		YPO_RS16975	5
RK1001.C0101_allcombined	3576249	3576254		YPO_RS16975	5
RK1001.C0101_allcombined	3577020	3577021		mak	1
RK1001.C0101_allcombined	3577093	3577148		mak	55
RK1001.C0101_allcombined	3577185	3577188		mak	3
RK1001.C0101_allcombined	3577463	3577489		mak	26
RK1001.C0101_allcombined	3577906	3577910		mak	4
RK1001.C0101_allcombined	3578427	3578433		rdgC	6
RK1001.C0101_allcombined	3578661	3578669		rdgC	8
RK1001.C0101_allcombined	3578914	3578920		rdgC	6
RK1001.C0101_allcombined	3579042	3579046		rdgC	4
RK1001.C0101_allcombined	3579594	3579620		ppnP	26
RK1001.C0101_allcombined	3580191	3580194		aroL	3
RK1001.C0101_allcombined	3580474	3580516		aroL	42
RK1001.C0101_allcombined	3580561	3580565		aroL	4
RK1001.C0101_allcombined	3581069	3581073		YPO_RS17000	4
RK1001.C0101_allcombined	3581321	3581332		YPO_RS17000	11
RK1001.C0101_allcombined	3582443	3582479		YPO_RS17005	36
RK1001.C0101_allcombined	3582729	3582732		YPO_RS17005	3
RK1001.C0101_allcombined	3583021	3583078		YPO_RS17010	57
RK1001.C0101_allcombined	3583113	3583118		YPO_RS17010	5
RK1001.C0101_allcombined	3583159	3583173		YPO_RS17010	14
RK1001.C0101_allcombined	3583259	3583270		YPO_RS17010	11
RK1001.C0101_allcombined	3583788	3583794		YPO_RS17015	6
RK1001.C0101_allcombined	3583902	3583968		YPO_RS17015	66
RK1001.C0101_allcombined	3584772	3584774		proA	2
RK1001.C0101_allcombined	3585049	3585058		proA	9
RK1001.C0101_allcombined	3585363	3585365		proA	2
RK1001.C0101_allcombined	3585909	3585913		proB	4
RK1001.C0101_allcombined	3586233	3586236		proB	3
RK1001.C0101_allcombined	3586395	3586402		proB	7
RK1001.C0101_allcombined	3587496	3587504		YPO_RS17030	8
RK1001.C0101_allcombined	3588558	3588562		frsA	4
RK1001.C0101_allcombined	3588691	3588717		frsA	26
RK1001.C0101_allcombined	3589889	3589922		YPO_RS17045	33
RK1001.C0101_allcombined	3590035	3590063		YPO_RS17045	28
RK1001.C0101_allcombined	3590099	3590128		YPO_RS17045	29
RK1001.C0101_allcombined	3590668	3590688		YPO_RS17050	20
RK1001.C0101_allcombined	3590804	3590822		YPO_RS17050	18
RK1001.C0101_allcombined	3590856	3590875		YPO_RS17050	19
RK1001.C0101_allcombined	3590932	3590933		YPO_RS17050	1
RK1001.C0101_allcombined	3591324	3591330		YPO_RS17050	6
RK1001.C0101_allcombined	3591642	3591649		YPO_RS17050	7
RK1001.C0101_allcombined	3591708	3591725		YPO_RS17050	17
RK1001.C0101_allcombined	3591923	3591929		YPO_RS17050	6
RK1001.C0101_allcombined	3592389	3592535		YPO_RS17055	146
RK1001.C0101_allcombined	3592591	3592664		YPO_RS17055	73
RK1001.C0101_allcombined	3592713	3592769		YPO_RS17055	56
RK1001.C0101_allcombined	3592802	3592814		YPO_RS17055	12
RK1001.C0101_allcombined	3592900	3592911		YPO_RS17055	11
RK1001.C0101_allcombined	3592972	3593125		YPO_RS17055	153
RK1001.C0101_allcombined	3593264	3593300		YPO_RS17055	36
RK1001.C0101_allcombined	3595175	3595181		pepD	6
RK1001.C0101_allcombined	3595738	3595740		pepD	2
RK1001.C0101_allcombined	3596162	3596175		pepD	13
RK1001.C0101_allcombined	3596603	3596635		pepD	32
RK1001.C0101_allcombined	3597184	3597214		dinB	30
RK1001.C0101_allcombined	3597341	3597344		dinB	3
RK1001.C0101_allcombined	3598163	3598180		YPO_RS17070	17
RK1001.C0101_allcombined	3598553	3598600		YPO_RS17070	47
RK1001.C0101_allcombined	3598821	3598834		YPO_RS17070	13
RK1001.C0101_allcombined	3599006	3599010		YPO_RS17070	4
RK1001.C0101_allcombined	3599104	3599110		YPO_RS17070	6
RK1001.C0101_allcombined	3599506	3599508		nqrM	2
RK1001.C0101_allcombined	3599846	3599854		YPO_RS17080	8
RK1001.C0101_allcombined	3600001	3600020		YPO_RS17080	19
RK1001.C0101_allcombined	3600126	3600139		YPO_RS17080	13
RK1001.C0101_allcombined	3600433	3600445		YPO_RS17080	12
RK1001.C0101_allcombined	3600507	3600521		YPO_RS17080	14
RK1001.C0101_allcombined	3600558	3600602		YPO_RS17080	44
RK1001.C0101_allcombined	3600811	3600812		nqrF	1
RK1001.C0101_allcombined	3601121	3601123		nqrF	2
RK1001.C0101_allcombined	3601206	3601209		nqrF	3
RK1001.C0101_allcombined	3601427	3601452		nqrF	25
RK1001.C0101_allcombined	3601489	3601500		nqrF	11
RK1001.C0101_allcombined	3601764	3601795		nqrF	31
RK1001.C0101_allcombined	3601848	3601854		nqrF	6
RK1001.C0101_allcombined	3601917	3601972		nqrE	55
RK1001.C0101_allcombined	3602182	3602185		nqrE	3
RK1001.C0101_allcombined	3602987	3602988		YPO_RS17095	1
RK1001.C0101_allcombined	3603409	3603412		YPO_RS17100	3
RK1001.C0101_allcombined	3604075	3604081		YPO_RS17105	6
RK1001.C0101_allcombined	3604205	3604210		YPO_RS17105	5
RK1001.C0101_allcombined	3604317	3604332		YPO_RS17105	15
RK1001.C0101_allcombined	3604708	3604709		YPO_RS17105	1
RK1001.C0101_allcombined	3604758	3604779		YPO_RS17105	21
RK1001.C0101_allcombined	3604838	3604856		YPO_RS17105	18
RK1001.C0101_allcombined	3605552	3605568		YPO_RS17110	16
RK1001.C0101_allcombined	3605601	3605611		YPO_RS17110	10
RK1001.C0101_allcombined	3606011	3606012		YPO_RS17110	1
RK1001.C0101_allcombined	3606352	3606356		YPO_RS17110	4
RK1001.C0101_allcombined	3606493	3606499		YPO_RS17110	6
RK1001.C0101_allcombined	3607099	3607115		YPO_RS17115	16
RK1001.C0101_allcombined	3607156	3607187		YPO_RS17115	31
RK1001.C0101_allcombined	3607363	3607365		YPO_RS17115	2
RK1001.C0101_allcombined	3607426	3607443		YPO_RS17115	17
RK1001.C0101_allcombined	3607816	3607826		YPO_RS17120	10
RK1001.C0101_allcombined	3607954	3607984		YPO_RS17120	30
RK1001.C0101_allcombined	3608031	3608039		YPO_RS17120	8
RK1001.C0101_allcombined	3608130	3608143		YPO_RS17120	13
RK1001.C0101_allcombined	3608676	3608735		lpcA	59
RK1001.C0101_allcombined	3609011	3609016		lpcA	5
RK1001.C0101_allcombined	3609765	3609818		YPO_RS17130	53
RK1001.C0101_allcombined	3610016	3610023		YPO_RS17130	7
RK1001.C0101_allcombined	3610143	3610160		YPO_RS17130	17
RK1001.C0101_allcombined	3610263	3610265		YPO_RS17130	2
RK1001.C0101_allcombined	3610399	3610428		YPO_RS17130	29
RK1001.C0101_allcombined	3611132	3611133		YPO_RS17130	1
RK1001.C0101_allcombined	3611185	3611186		YPO_RS17130	1
RK1001.C0101_allcombined	3611422	3611431		YPO_RS17130	9
RK1001.C0101_allcombined	3611655	3611661		YPO_RS17130	6
RK1001.C0101_allcombined	3612130	3612145		YPO_RS17135	15
RK1001.C0101_allcombined	3612402	3612405		YPO_RS17135	3
RK1001.C0101_allcombined	3612435	3612448		YPO_RS17135	13
RK1001.C0101_allcombined	3612513	3612545		YPO_RS17135	32
RK1001.C0101_allcombined	3612680	3612706		YPO_RS17135	26
RK1001.C0101_allcombined	3613012	3613014		YPO_RS17140	2
RK1001.C0101_allcombined	3613044	3613061		YPO_RS17140	17
RK1001.C0101_allcombined	3613218	3613221		YPO_RS17140	3
RK1001.C0101_allcombined	3613301	3613315		YPO_RS17140	14
RK1001.C0101_allcombined	3613635	3613638		YPO_RS17140	3
RK1001.C0101_allcombined	3613897	3613899		YPO_RS17140	2
RK1001.C0101_allcombined	3613954	3614006		YPO_RS17140	52
RK1001.C0101_allcombined	3614345	3614374		YPO_RS17140	29
RK1001.C0101_allcombined	3614592	3614599		YPO_RS17140	7
RK1001.C0101_allcombined	3614666	3614698		YPO_RS17140	32
RK1001.C0101_allcombined	3615065	3615092		YPO_RS17145	27
RK1001.C0101_allcombined	3616279	3616289		YPO_RS17145	10
RK1001.C0101_allcombined	3616452	3616477		YPO_RS17145	25
RK1001.C0101_allcombined	3616551	3616573		YPO_RS17145	22
RK1001.C0101_allcombined	3616761	3616831		YPO_RS17145	70
RK1001.C0101_allcombined	3617003	3617019		YPO_RS17145	16
RK1001.C0101_allcombined	3617084	3617096		YPO_RS17145	12
RK1001.C0101_allcombined	3617201	3617222		YPO_RS17145	21
RK1001.C0101_allcombined	3617569	3617664		YPO_RS17145	95
RK1001.C0101_allcombined	3617768	3617790		YPO_RS17145	22
RK1001.C0101_allcombined	3617926	3617987		YPO_RS17145	61
RK1001.C0101_allcombined	3618054	3618079		YPO_RS17145	25
RK1001.C0101_allcombined	3618172	3618175		YPO_RS17145	3
RK1001.C0101_allcombined	3618251	3618259		YPO_RS17145	8
RK1001.C0101_allcombined	3618447	3618460		YPO_RS17145	13
RK1001.C0101_allcombined	3618497	3618531		YPO_RS17145	34
RK1001.C0101_allcombined	3618592	3618606		YPO_RS17145	14
RK1001.C0101_allcombined	3618851	3618882		YPO_RS17145	31
RK1001.C0101_allcombined	3619009	3619017		YPO_RS17145	8
RK1001.C0101_allcombined	3619051	3619090		YPO_RS17145	39
RK1001.C0101_allcombined	3619173	3619214		YPO_RS17145	41
RK1001.C0101_allcombined	3619346	3619353		YPO_RS17145	7
RK1001.C0101_allcombined	3619454	3619516		YPO_RS17145	62
RK1001.C0101_allcombined	3619552	3619554		YPO_RS17145	2
RK1001.C0101_allcombined	3619715	3619719		YPO_RS17145	4
RK1001.C0101_allcombined	3619849	3619850		YPO_RS17145	1
RK1001.C0101_allcombined	3619915	3619931		YPO_RS17145	16
RK1001.C0101_allcombined	3620658	3620666		YPO_RS17150	8
RK1001.C0101_allcombined	3621065	3621076		YPO_RS17150	11
RK1001.C0101_allcombined	3621398	3621431		YPO_RS17150	33
RK1001.C0101_allcombined	3621866	3621884		YPO_RS17150	18
RK1001.C0101_allcombined	3622103	3622108		YPO_RS17150	5
RK1001.C0101_allcombined	3622379	3622387		YPO_RS17150	8
RK1001.C0101_allcombined	3622432	3622435		YPO_RS17150	3
RK1001.C0101_allcombined	3623151	3623160		YPO_RS17155	9
RK1001.C0101_allcombined	3623795	3623800		YPO_RS17160	5
RK1001.C0101_allcombined	3624050	3624052		YPO_RS17160	2
RK1001.C0101_allcombined	3624391	3624393		YPO_RS17160	2
RK1001.C0101_allcombined	3625167	3625199		YPO_RS17165	32
RK1001.C0101_allcombined	3625257	3625259		YPO_RS17165	2
RK1001.C0101_allcombined	3626681	3626682		YPO_RS17175	1
RK1001.C0101_allcombined	3627213	3627215		YPO_RS17180	2
RK1001.C0101_allcombined	3627404	3627414		YPO_RS17180	10
RK1001.C0101_allcombined	3628873	3628876		YPO_RS17185	3
RK1001.C0101_allcombined	3629617	3629621		YPO_RS17195	4
RK1001.C0101_allcombined	3630242	3630255		YPO_RS17200	13
RK1001.C0101_allcombined	3631410	3631424		YPO_RS17205	14
RK1001.C0101_allcombined	3632531	3632538		hpxX	7
RK1001.C0101_allcombined	3633032	3633035		YPO_RS17215	3
RK1001.C0101_allcombined	3633214	3633222		YPO_RS17215	8
RK1001.C0101_allcombined	3633449	3633470		YPO_RS17215	21
RK1001.C0101_allcombined	3633578	3633590		YPO_RS17215	12
RK1001.C0101_allcombined	3634789	3634791		YPO_RS17225	2
RK1001.C0101_allcombined	3636667	3636670		YPO_RS17230	3
RK1001.C0101_allcombined	3637119	3637141		ygaH	22
RK1001.C0101_allcombined	3638434	3638483		emrA	49
RK1001.C0101_allcombined	3638963	3638967		emrA	4
RK1001.C0101_allcombined	3640023	3640039		emrB	16
RK1001.C0101_allcombined	3640364	3640378		emrB	14
RK1001.C0101_allcombined	3640422	3640427		emrB	5
RK1001.C0101_allcombined	3640792	3640796		emrB	4
RK1001.C0101_allcombined	3641040	3641042		emrB	2
RK1001.C0101_allcombined	3641354	3641365		YPO_RS17255	11
RK1001.C0101_allcombined	3642248	3642257		YPO_RS17255	9
RK1001.C0101_allcombined	3642614	3642625		trxC	11
RK1001.C0101_allcombined	3642900	3642902		trxC	2
RK1001.C0101_allcombined	3643016	3643051		trxC	35
RK1001.C0101_allcombined	3643567	3643574		YPO_RS17265	7
RK1001.C0101_allcombined	3643604	3643608		YPO_RS17265	4
RK1001.C0101_allcombined	3644388	3644398		YPO_RS17270	10
RK1001.C0101_allcombined	3645293	3645300		YPO_RS17270	7
RK1001.C0101_allcombined	3645620	3645622		YPO_RS17270	2
RK1001.C0101_allcombined	3645813	3645828		YPO_RS17270	15
RK1001.C0101_allcombined	3646244	3646262		YPO_RS17270	18
RK1001.C0101_allcombined	3646374	3646381		YPO_RS17270	7
RK1001.C0101_allcombined	3646452	3646461		YPO_RS17270	9
RK1001.C0101_allcombined	3647007	3647010		pssA	3
RK1001.C0101_allcombined	3647306	3647331		pssA	25
RK1001.C0101_allcombined	3647577	3647580		pssA	3
RK1001.C0101_allcombined	3647700	3647711		pssA	11
RK1001.C0101_allcombined	3647751	3647785		pssA	34
RK1001.C0101_allcombined	3647913	3647926		pssA	13
RK1001.C0101_allcombined	3648071	3648081		pssA	10
RK1001.C0101_allcombined	3648170	3648175		pssA	5
RK1001.C0101_allcombined	3648463	3648468		YPO_RS17280	5
RK1001.C0101_allcombined	3649303	3649305		YPO_RS17290	2
RK1001.C0101_allcombined	3649927	3649936		YPO_RS17290	9
RK1001.C0101_allcombined	3654232	3654261		YPO_RS17310	29
RK1001.C0101_allcombined	3656449	3656475		clpB	26
RK1001.C0101_allcombined	3656895	3656906		clpB	11
RK1001.C0101_allcombined	3656941	3656976		clpB	35
RK1001.C0101_allcombined	3657012	3657021		clpB	9
RK1001.C0101_allcombined	3657121	3657128		clpB	7
RK1001.C0101_allcombined	3657607	3657608		pgeF	1
RK1001.C0101_allcombined	3658044	3658070		pgeF	26
RK1001.C0101_allcombined	3658152	3658160		rluD	8
RK1001.C0101_allcombined	3658317	3658322		rluD	5
RK1001.C0101_allcombined	3658352	3658360		rluD	8
RK1001.C0101_allcombined	3658584	3658585		rluD	1
RK1001.C0101_allcombined	3658806	3658849		rluD	43
RK1001.C0101_allcombined	3659294	3659321		bamD	27
RK1001.C0101_allcombined	3659556	3659562		bamD	6
RK1001.C0101_allcombined	3661026	3661038		YPO_RS17340	12
RK1001.C0101_allcombined	3661371	3661389		YPO_RS17340	18
RK1001.C0101_allcombined	3661934	3661946		pheA	12
RK1001.C0101_allcombined	3662105	3662106		pheA	1
RK1001.C0101_allcombined	3662236	3662259		pheA	23
RK1001.C0101_allcombined	3662371	3662376		pheA	5
RK1001.C0101_allcombined	3662696	3662699		pheA	3
RK1001.C0101_allcombined	3662824	3662827		YPO_RS17350	3
RK1001.C0101_allcombined	3664876	3664877		YPO_RS17360	1
RK1001.C0101_allcombined	3665115	3665138		tyrA	23
RK1001.C0101_allcombined	3665527	3665539		tyrA	12
RK1001.C0101_allcombined	3666337	3666349		YPO_RS17370	12
RK1001.C0101_allcombined	3666918	3666922		YPO_RS17370	4
RK1001.C0101_allcombined	3667419	3667452		yehT	33
RK1001.C0101_allcombined	3667565	3667573		yehT	8
RK1001.C0101_allcombined	3667806	3667831		yehT	25
RK1001.C0101_allcombined	3667869	3667898		yehT	29
RK1001.C0101_allcombined	3667934	3667939		yehT	5
RK1001.C0101_allcombined	3670271	3670299		YPO_RS17385	28
RK1001.C0101_allcombined	3670470	3670494		YPO_RS17385	24
RK1001.C0101_allcombined	3670903	3670911		YPO_RS17385	8
RK1001.C0101_allcombined	3672087	3672096		rplS	9
RK1001.C0101_allcombined	3672593	3672596		trmD	3
RK1001.C0101_allcombined	3673288	3673296		rimM	8
RK1001.C0101_allcombined	3673365	3673405		rimM	40
RK1001.C0101_allcombined	3673508	3673513		rimM	5
RK1001.C0101_allcombined	3673754	3673770		rpsP	16
RK1001.C0101_allcombined	3673939	3673944		rpsP	5
RK1001.C0101_allcombined	3674530	3674556		ffh	26
RK1001.C0101_allcombined	3675124	3675125		ffh	1
RK1001.C0101_allcombined	3675873	3675889		YPO_RS17420	16
RK1001.C0101_allcombined	3676283	3676290		YPO_RS17420	7
RK1001.C0101_allcombined	3676614	3676655		YPO_RS17425	41
RK1001.C0101_allcombined	3676999	3677064		YPO_RS17425	65
RK1001.C0101_allcombined	3677257	3677306		YPO_RS17425	49
RK1001.C0101_allcombined	3677477	3677480		YPO_RS17425	3
RK1001.C0101_allcombined	3677815	3677891		YPO_RS17425	76
RK1001.C0101_allcombined	3678374	3678401		YPO_RS17430	27
RK1001.C0101_allcombined	3678750	3678803		luxS	53
RK1001.C0101_allcombined	3678836	3678850		luxS	14
RK1001.C0101_allcombined	3679190	3679209		luxS	19
RK1001.C0101_allcombined	3679377	3679391		gshA	14
RK1001.C0101_allcombined	3679578	3679583		gshA	5
RK1001.C0101_allcombined	3679656	3679660		gshA	4
RK1001.C0101_allcombined	3679770	3679789		gshA	19
RK1001.C0101_allcombined	3680035	3680064		gshA	29
RK1001.C0101_allcombined	3680253	3680268		gshA	15
RK1001.C0101_allcombined	3680671	3680678		gshA	7
RK1001.C0101_allcombined	3680759	3680779		gshA	20
RK1001.C0101_allcombined	3681663	3681698		yqaB	35
RK1001.C0101_allcombined	3681734	3681738		yqaB	4
RK1001.C0101_allcombined	3681777	3681778		yqaB	1
RK1001.C0101_allcombined	3681826	3681833		yqaB	7
RK1001.C0101_allcombined	3681986	3682010		yqaB	24
RK1001.C0101_allcombined	3682301	3682318		YPO_RS17455	17
RK1001.C0101_allcombined	3682357	3682386		YPO_RS17455	29
RK1001.C0101_allcombined	3682529	3682531		YPO_RS17460	2
RK1001.C0101_allcombined	3682605	3682651		YPO_RS17465	46
RK1001.C0101_allcombined	3682739	3682742		YPO_RS17470	3
RK1001.C0101_allcombined	3682870	3682874		YPO_RS17475	4
RK1001.C0101_allcombined	3683383	3683426		csrA	43
RK1001.C0101_allcombined	3683714	3683719		alaS	5
RK1001.C0101_allcombined	3683792	3683794		alaS	2
RK1001.C0101_allcombined	3683867	3683884		alaS	17
RK1001.C0101_allcombined	3683939	3683954		alaS	15
RK1001.C0101_allcombined	3684574	3684582		alaS	8
RK1001.C0101_allcombined	3685123	3685138		alaS	15
RK1001.C0101_allcombined	3685965	3685993		alaS	28
RK1001.C0101_allcombined	3686246	3686249		alaS	3
RK1001.C0101_allcombined	3686590	3686631		recX	41
RK1001.C0101_allcombined	3686696	3686705		recX	9
RK1001.C0101_allcombined	3686875	3686912		recX	37
RK1001.C0101_allcombined	3687043	3687044		recX	1
RK1001.C0101_allcombined	3687182	3687183		recA	1
RK1001.C0101_allcombined	3687324	3687331		recA	7
RK1001.C0101_allcombined	3687419	3687448		recA	29
RK1001.C0101_allcombined	3687916	3687920		recA	4
RK1001.C0101_allcombined	3688394	3688400		pncC	6
RK1001.C0101_allcombined	3688754	3688781		pncC	27
RK1001.C0101_allcombined	3689463	3689473		YPO_RS17505	10
RK1001.C0101_allcombined	3689997	3690020		YPO_RS17505	23
RK1001.C0101_allcombined	3690482	3690509		YPO_RS17505	27
RK1001.C0101_allcombined	3690818	3690821		YPO_RS17510	3
RK1001.C0101_allcombined	3691100	3691103		YPO_RS17510	3
RK1001.C0101_allcombined	3692019	3692020		YPO_RS17515	1
RK1001.C0101_allcombined	3692394	3692397		YPO_RS17515	3
RK1001.C0101_allcombined	3692896	3692905		YPO_RS17515	9
RK1001.C0101_allcombined	3693804	3693810		YPO_RS17520	6
RK1001.C0101_allcombined	3694407	3694419		YPO_RS17520	12
RK1001.C0101_allcombined	3694987	3695000		YPO_RS17525	13
RK1001.C0101_allcombined	3695342	3695343		YPO_RS17525	1
RK1001.C0101_allcombined	3695449	3695458		YPO_RS17525	9
RK1001.C0101_allcombined	3695512	3695523		YPO_RS17525	11
RK1001.C0101_allcombined	3695573	3695588		YPO_RS17525	15
RK1001.C0101_allcombined	3696534	3696571		YPO_RS17530	37
RK1001.C0101_allcombined	3696937	3696948		YPO_RS17535	11
RK1001.C0101_allcombined	3696990	3697000		YPO_RS17535	10
RK1001.C0101_allcombined	3697567	3697575		YPO_RS17535	8
RK1001.C0101_allcombined	3698174	3698187		YPO_RS17540	13
RK1001.C0101_allcombined	3698757	3698773		YPO_RS17540	16
RK1001.C0101_allcombined	3700805	3700819		YPO_RS17550	14
RK1001.C0101_allcombined	3700998	3701001		YPO_RS17550	3
RK1001.C0101_allcombined	3701081	3701086		YPO_RS17550	5
RK1001.C0101_allcombined	3701182	3701190		YPO_RS17550	8
RK1001.C0101_allcombined	3701736	3701741		katG	5
RK1001.C0101_allcombined	3701873	3701930		katG	57
RK1001.C0101_allcombined	3701971	3702026		katG	55
RK1001.C0101_allcombined	3702314	3702320		katG	6
RK1001.C0101_allcombined	3702998	3703010		katG	12
RK1001.C0101_allcombined	3703066	3703122		katG	56
RK1001.C0101_allcombined	3703389	3703425		katG	36
RK1001.C0101_allcombined	3703886	3703949		katG	63
RK1001.C0101_allcombined	3704149	3704153		cybC	4
RK1001.C0101_allcombined	3704275	3704310		cybC	35
RK1001.C0101_allcombined	3704359	3704409		cybC	50
RK1001.C0101_allcombined	3704557	3704567		cybB	10
RK1001.C0101_allcombined	3704709	3704794		cybB	85
RK1001.C0101_allcombined	3705043	3705052		cybB	9
RK1001.C0101_allcombined	3705085	3705087		cybB	2
RK1001.C0101_allcombined	3705922	3706028		dmsD	106
RK1001.C0101_allcombined	3706368	3706376		YPO_RS17575	8
RK1001.C0101_allcombined	3706604	3706613		YPO_RS17575	9
RK1001.C0101_allcombined	3707461	3707478		dmsB	17
RK1001.C0101_allcombined	3707742	3707761		dmsA	19
RK1001.C0101_allcombined	3708600	3708602		dmsA	2
RK1001.C0101_allcombined	3709194	3709220		dmsA	26
RK1001.C0101_allcombined	3709304	3709305		dmsA	1
RK1001.C0101_allcombined	3709433	3709456		dmsA	23
RK1001.C0101_allcombined	3711285	3711290		YPO_RS17590	5
RK1001.C0101_allcombined	3712671	3712736		YPO_RS17595	65
RK1001.C0101_allcombined	3712799	3712809		YPO_RS17595	10
RK1001.C0101_allcombined	3713163	3713175		YPO_RS17600	12
RK1001.C0101_allcombined	3713277	3713278		YPO_RS17600	1
RK1001.C0101_allcombined	3713382	3713387		YPO_RS17600	5
RK1001.C0101_allcombined	3713619	3713658		YPO_RS17600	39
RK1001.C0101_allcombined	3713921	3713928		YPO_RS17600	7
RK1001.C0101_allcombined	3715184	3715186		YPO_RS17610	2
RK1001.C0101_allcombined	3715831	3715860		YPO_RS17610	29
RK1001.C0101_allcombined	3716134	3716154		YPO_RS17610	20
RK1001.C0101_allcombined	3716252	3716260		YPO_RS17610	8
RK1001.C0101_allcombined	3717893	3717911		YPO_RS17620	18
RK1001.C0101_allcombined	3718031	3718033		YPO_RS17620	2
RK1001.C0101_allcombined	3718919	3718922		YPO_RS17625	3
RK1001.C0101_allcombined	3719058	3719061		YPO_RS17625	3
RK1001.C0101_allcombined	3720034	3720043		YPO_RS17630	9
RK1001.C0101_allcombined	3720280	3720290		YPO_RS17630	10
RK1001.C0101_allcombined	3720500	3720532		YPO_RS17630	32
RK1001.C0101_allcombined	3720695	3720710		YPO_RS17630	15
RK1001.C0101_allcombined	3720819	3720821		YPO_RS17630	2
RK1001.C0101_allcombined	3721437	3721447		YPO_RS17635	10
RK1001.C0101_allcombined	3721776	3721789		YPO_RS17635	13
RK1001.C0101_allcombined	3721839	3721864		YPO_RS17635	25
RK1001.C0101_allcombined	3721940	3721950		YPO_RS17635	10
RK1001.C0101_allcombined	3722187	3722188		YPO_RS17635	1
RK1001.C0101_allcombined	3722616	3722628		YPO_RS17635	12
RK1001.C0101_allcombined	3723200	3723202		YPO_RS17640	2
RK1001.C0101_allcombined	3723344	3723361		YPO_RS17640	17
RK1001.C0101_allcombined	3723491	3723494		map	3
RK1001.C0101_allcombined	3723692	3723703		map	11
RK1001.C0101_allcombined	3724624	3724628		YPO_RS17650	4
RK1001.C0101_allcombined	3725062	3725071		YPO_RS17650	9
RK1001.C0101_allcombined	3725102	3725240		YPO_RS17650	138
RK1001.C0101_allcombined	3725592	3725649		YPO_RS17650	57
RK1001.C0101_allcombined	3725679	3725734		YPO_RS17650	55
RK1001.C0101_allcombined	3728657	3728680		YPO_RS17660	23
RK1001.C0101_allcombined	3728968	3728976		YPO_RS17665	8
RK1001.C0101_allcombined	3729052	3729061		YPO_RS17665	9
RK1001.C0101_allcombined	3729100	3729102		YPO_RS17665	2
RK1001.C0101_allcombined	3730172	3730187		YPO_RS17665	15
RK1001.C0101_allcombined	3730694	3730706		YPO_RS17670	12
RK1001.C0101_allcombined	3730949	3730968		YPO_RS17670	19
RK1001.C0101_allcombined	3731764	3731790		YPO_RS17675	26
RK1001.C0101_allcombined	3732047	3732078		YPO_RS17680	31
RK1001.C0101_allcombined	3732135	3732166		YPO_RS17680	31
RK1001.C0101_allcombined	3732233	3732238		YPO_RS17680	5
RK1001.C0101_allcombined	3732834	3732871		YPO_RS17685	37
RK1001.C0101_allcombined	3733185	3733213		arsB	28
RK1001.C0101_allcombined	3733758	3733768		arsB	10
RK1001.C0101_allcombined	3733946	3733991		arsB	45
RK1001.C0101_allcombined	3734144	3734156		arsB	12
RK1001.C0101_allcombined	3736370	3736405		dhaL	35
RK1001.C0101_allcombined	3736688	3736704		YPO_RS17705	16
RK1001.C0101_allcombined	3737182	3737184		YPO_RS17705	2
RK1001.C0101_allcombined	3737448	3737462		YPO_RS17705	14
RK1001.C0101_allcombined	3737882	3737883		YPO_RS17710	1
RK1001.C0101_allcombined	3738670	3738702		YPO_RS17715	32
RK1001.C0101_allcombined	3739414	3739420		YPO_RS17715	6
RK1001.C0101_allcombined	3740093	3740108		rpiB	15
RK1001.C0101_allcombined	3740211	3740214		rpiB	3
RK1001.C0101_allcombined	3741662	3741669		mutS	7
RK1001.C0101_allcombined	3742882	3742883		mutS	1
RK1001.C0101_allcombined	3744722	3744726		rpoS	4
RK1001.C0101_allcombined	3744839	3744873		rpoS	34
RK1001.C0101_allcombined	3746155	3746169		nlpD	14
RK1001.C0101_allcombined	3746430	3746469		YPO_RS17740	39
RK1001.C0101_allcombined	3746940	3746945		YPO_RS17740	5
RK1001.C0101_allcombined	3747227	3747237		surE	10
RK1001.C0101_allcombined	3747315	3747334		surE	19
RK1001.C0101_allcombined	3747592	3747647		surE	55
RK1001.C0101_allcombined	3747796	3747799		truD	3
RK1001.C0101_allcombined	3747895	3747899		truD	4
RK1001.C0101_allcombined	3748400	3748437		truD	37
RK1001.C0101_allcombined	3749207	3749244		ispF	37
RK1001.C0101_allcombined	3749547	3749551		ispD	4
RK1001.C0101_allcombined	3750022	3750030		ispD	8
RK1001.C0101_allcombined	3750295	3750299		ftsB	4
RK1001.C0101_allcombined	3750400	3750413		ftsB	13
RK1001.C0101_allcombined	3750860	3750871		YPO_RS17770	11
RK1001.C0101_allcombined	3750986	3750999		YPO_RS17770	13
RK1001.C0101_allcombined	3751425	3751432		cysC	7
RK1001.C0101_allcombined	3753028	3753029		cysN	1
RK1001.C0101_allcombined	3753157	3753162		cysN	5
RK1001.C0101_allcombined	3753717	3753723		cysD	6
RK1001.C0101_allcombined	3753906	3753918		cysD	12
RK1001.C0101_allcombined	3754057	3754092		cysD	35
RK1001.C0101_allcombined	3754468	3754497		cobA	29
RK1001.C0101_allcombined	3754874	3754915		cobA	41
RK1001.C0101_allcombined	3755285	3755299		cobA	14
RK1001.C0101_allcombined	3755657	3755664		cobA	7
RK1001.C0101_allcombined	3756113	3756118		YPO_RS17795	5
RK1001.C0101_allcombined	3756547	3756559		YPO_RS17800	12
RK1001.C0101_allcombined	3756863	3756865		YPO_RS17805	2
RK1001.C0101_allcombined	3756979	3756995		YPO_RS17805	16
RK1001.C0101_allcombined	3758158	3758165		cysI	7
RK1001.C0101_allcombined	3758204	3758218		cysI	14
RK1001.C0101_allcombined	3758281	3758327		cysI	46
RK1001.C0101_allcombined	3758939	3758951		cysI	12
RK1001.C0101_allcombined	3759116	3759131		cysI	15
RK1001.C0101_allcombined	3759209	3759243		cysI	34
RK1001.C0101_allcombined	3759546	3759556		cysI	10
RK1001.C0101_allcombined	3759713	3759716		cysI	3
RK1001.C0101_allcombined	3762094	3762104		queD	10
RK1001.C0101_allcombined	3763064	3763084		queE	20
RK1001.C0101_allcombined	3763729	3763736		YPO_RS17840	7
RK1001.C0101_allcombined	3763955	3763971		YPO_RS17840	16
RK1001.C0101_allcombined	3764637	3764641		eno	4
RK1001.C0101_allcombined	3764712	3764737		eno	25
RK1001.C0101_allcombined	3764806	3764811		eno	5
RK1001.C0101_allcombined	3765815	3765832		pyrG	17
RK1001.C0101_allcombined	3766514	3766532		pyrG	18
RK1001.C0101_allcombined	3767014	3767018		pyrG	4
RK1001.C0101_allcombined	3767274	3767290		pyrG	16
RK1001.C0101_allcombined	3767414	3767419		pyrG	5
RK1001.C0101_allcombined	3767960	3767971		mazG	11
RK1001.C0101_allcombined	3768402	3768419		mazG	17
RK1001.C0101_allcombined	3768491	3768506		mazG	15
RK1001.C0101_allcombined	3768912	3768917		relA	5
RK1001.C0101_allcombined	3769052	3769059		relA	7
RK1001.C0101_allcombined	3769112	3769115		relA	3
RK1001.C0101_allcombined	3769294	3769316		relA	22
RK1001.C0101_allcombined	3769596	3769602		relA	6
RK1001.C0101_allcombined	3769891	3769897		relA	6
RK1001.C0101_allcombined	3770337	3770339		relA	2
RK1001.C0101_allcombined	3770673	3770687		relA	14
RK1001.C0101_allcombined	3771220	3771239		YPO_RS17870	19
RK1001.C0101_allcombined	3771681	3771690		barA	9
RK1001.C0101_allcombined	3771756	3771761		barA	5
RK1001.C0101_allcombined	3771939	3771951		barA	12
RK1001.C0101_allcombined	3772422	3772433		barA	11
RK1001.C0101_allcombined	3772866	3772867		barA	1
RK1001.C0101_allcombined	3773154	3773181		barA	27
RK1001.C0101_allcombined	3773778	3773796		barA	18
RK1001.C0101_allcombined	3774353	3774360		degP	7
RK1001.C0101_allcombined	3775026	3775043		degP	17
RK1001.C0101_allcombined	3775160	3775181		degP	21
RK1001.C0101_allcombined	3775258	3775340		degP	82
RK1001.C0101_allcombined	3775636	3775640		degP	4
RK1001.C0101_allcombined	3775795	3775798		degP	3
RK1001.C0101_allcombined	3776161	3776207		dgt	46
RK1001.C0101_allcombined	3776281	3776308		dgt	27
RK1001.C0101_allcombined	3776498	3776517		dgt	19
RK1001.C0101_allcombined	3776652	3776691		dgt	39
RK1001.C0101_allcombined	3776859	3776898		dgt	39
RK1001.C0101_allcombined	3777424	3777452		dgt	28
RK1001.C0101_allcombined	3777810	3777814		mtnN	4
RK1001.C0101_allcombined	3778355	3778383		mtnN	28
RK1001.C0101_allcombined	3778556	3778585		btuF	29
RK1001.C0101_allcombined	3779322	3779338		btuF	16
RK1001.C0101_allcombined	3779570	3779579		YPO_RS17900	9
RK1001.C0101_allcombined	3779755	3779760		YPO_RS17900	5
RK1001.C0101_allcombined	3779829	3779853		YPO_RS17900	24
RK1001.C0101_allcombined	3779950	3779964		YPO_RS17900	14
RK1001.C0101_allcombined	3780326	3780334		erpA	8
RK1001.C0101_allcombined	3780589	3780596		erpA	7
RK1001.C0101_allcombined	3780732	3780742		clcA	10
RK1001.C0101_allcombined	3781200	3781236		clcA	36
RK1001.C0101_allcombined	3781710	3781717		clcA	7
RK1001.C0101_allcombined	3781839	3781840		clcA	1
RK1001.C0101_allcombined	3782025	3782031		clcA	6
RK1001.C0101_allcombined	3782665	3782670		hemL	5
RK1001.C0101_allcombined	3783314	3783321		hemL	7
RK1001.C0101_allcombined	3784210	3784230		fhuB	20
RK1001.C0101_allcombined	3784262	3784280		fhuB	18
RK1001.C0101_allcombined	3784814	3784823		fhuB	9
RK1001.C0101_allcombined	3785237	3785238		fhuB	1
RK1001.C0101_allcombined	3785667	3785678		fhuB	11
RK1001.C0101_allcombined	3786891	3786902		fhuD	11
RK1001.C0101_allcombined	3786977	3787021		fhuD	44
RK1001.C0101_allcombined	3787246	3787247		fhuD	1
RK1001.C0101_allcombined	3787280	3787283		fhuD	3
RK1001.C0101_allcombined	3787332	3787367		fhuC	35
RK1001.C0101_allcombined	3788401	3788418		mrcB	17
RK1001.C0101_allcombined	3788455	3788465		mrcB	10
RK1001.C0101_allcombined	3788842	3788843		mrcB	1
RK1001.C0101_allcombined	3788882	3788906		mrcB	24
RK1001.C0101_allcombined	3789155	3789176		mrcB	21
RK1001.C0101_allcombined	3789420	3789424		mrcB	4
RK1001.C0101_allcombined	3789691	3789693		mrcB	2
RK1001.C0101_allcombined	3789937	3789990		mrcB	53
RK1001.C0101_allcombined	3790728	3790741		mrcB	13
RK1001.C0101_allcombined	3790984	3790985		hrpB	1
RK1001.C0101_allcombined	3791362	3791366		hrpB	4
RK1001.C0101_allcombined	3792232	3792239		hrpB	7
RK1001.C0101_allcombined	3792947	3792951		hrpB	4
RK1001.C0101_allcombined	3794005	3794009		thpR	4
RK1001.C0101_allcombined	3794560	3794585		sfsA	25
RK1001.C0101_allcombined	3796774	3796780		gluQRS	6
RK1001.C0101_allcombined	3796943	3796947		pcnB	4
RK1001.C0101_allcombined	3797261	3797288		pcnB	27
RK1001.C0101_allcombined	3797542	3797547		pcnB	5
RK1001.C0101_allcombined	3797600	3797607		pcnB	7
RK1001.C0101_allcombined	3798433	3798442		pcnB	9
RK1001.C0101_allcombined	3799956	3799975		panB	19
RK1001.C0101_allcombined	3800086	3800087		panC	1
RK1001.C0101_allcombined	3801614	3801615		panD	1
RK1001.C0101_allcombined	3802210	3802215		YPO_RS17990	5
RK1001.C0101_allcombined	3802307	3802312		YPO_RS17990	5
RK1001.C0101_allcombined	3802392	3802416		YPO_RS17990	24
RK1001.C0101_allcombined	3802562	3802565		YPO_RS17990	3
RK1001.C0101_allcombined	3802617	3802626		YPO_RS17990	9
RK1001.C0101_allcombined	3802671	3802730		YPO_RS17990	59
RK1001.C0101_allcombined	3803499	3803518		YPO_RS17995	19
RK1001.C0101_allcombined	3804068	3804071		YPO_RS17995	3
RK1001.C0101_allcombined	3804254	3804258		YPO_RS18000	4
RK1001.C0101_allcombined	3804422	3804431		YPO_RS18000	9
RK1001.C0101_allcombined	3804550	3804555		YPO_RS18000	5
RK1001.C0101_allcombined	3804606	3804609		YPO_RS18000	3
RK1001.C0101_allcombined	3805758	3805781		can	23
RK1001.C0101_allcombined	3805982	3805991		can	9
RK1001.C0101_allcombined	3806158	3806167		hpt	9
RK1001.C0101_allcombined	3806394	3806411		hpt	17
RK1001.C0101_allcombined	3806666	3806681		hpt	15
RK1001.C0101_allcombined	3808201	3808204		cueO	3
RK1001.C0101_allcombined	3808299	3808311		cueO	12
RK1001.C0101_allcombined	3808957	3808963		YPO_RS18020	6
RK1001.C0101_allcombined	3809048	3809059		YPO_RS18020	11
RK1001.C0101_allcombined	3809146	3809154		YPO_RS18020	8
RK1001.C0101_allcombined	3809750	3809760		speE	10
RK1001.C0101_allcombined	3809833	3809840		speE	7
RK1001.C0101_allcombined	3809876	3809878		speE	2
RK1001.C0101_allcombined	3810444	3810472		speD	28
RK1001.C0101_allcombined	3810709	3810713		speD	4
RK1001.C0101_allcombined	3810746	3810757		speD	11
RK1001.C0101_allcombined	3810894	3810907		speD	13
RK1001.C0101_allcombined	3812025	3812032		YPO_RS18035	7
RK1001.C0101_allcombined	3812178	3812194		YPO_RS18035	16
RK1001.C0101_allcombined	3812502	3812511		YPO_RS18040	9
RK1001.C0101_allcombined	3813214	3813241		acnB	27
RK1001.C0101_allcombined	3813404	3813405		acnB	1
RK1001.C0101_allcombined	3813832	3813854		acnB	22
RK1001.C0101_allcombined	3813996	3814012		acnB	16
RK1001.C0101_allcombined	3814247	3814258		acnB	11
RK1001.C0101_allcombined	3814565	3814568		acnB	3
RK1001.C0101_allcombined	3814899	3814902		acnB	3
RK1001.C0101_allcombined	3815525	3815535		acnB	10
RK1001.C0101_allcombined	3815751	3815757		acnB	6
RK1001.C0101_allcombined	3816346	3816351		YPO_RS18050	5
RK1001.C0101_allcombined	3817252	3817253		lpdA	1
RK1001.C0101_allcombined	3817840	3817855		lpdA	15
RK1001.C0101_allcombined	3818071	3818079		lpdA	8
RK1001.C0101_allcombined	3818190	3818194		lpdA	4
RK1001.C0101_allcombined	3818283	3818339		lpdA	56
RK1001.C0101_allcombined	3818443	3818452		lpdA	9
RK1001.C0101_allcombined	3819376	3819402		aceF	26
RK1001.C0101_allcombined	3819665	3819672		aceF	7
RK1001.C0101_allcombined	3820685	3820697		aceE	12
RK1001.C0101_allcombined	3821067	3821086		aceE	19
RK1001.C0101_allcombined	3821646	3821648		aceE	2
RK1001.C0101_allcombined	3821974	3821979		aceE	5
RK1001.C0101_allcombined	3822197	3822203		aceE	6
RK1001.C0101_allcombined	3822233	3822239		aceE	6
RK1001.C0101_allcombined	3822921	3822937		aceE	16
RK1001.C0101_allcombined	3823594	3823602		pdhR	8
RK1001.C0101_allcombined	3825518	3825567		YPO_RS18075	49
RK1001.C0101_allcombined	3825693	3825720		YPO_RS18075	27
RK1001.C0101_allcombined	3825823	3825832		YPO_RS18075	9
RK1001.C0101_allcombined	3826087	3826105		YPO_RS18075	18
RK1001.C0101_allcombined	3826681	3826682		ampE	1
RK1001.C0101_allcombined	3826916	3826937		ampE	21
RK1001.C0101_allcombined	3827198	3827212		ampE	14
RK1001.C0101_allcombined	3827859	3827860		ampD	1
RK1001.C0101_allcombined	3828120	3828122		ampD	2
RK1001.C0101_allcombined	3828588	3828592		nadC	4
RK1001.C0101_allcombined	3829100	3829104		nadC	4
RK1001.C0101_allcombined	3829651	3829675		ppdD	24
RK1001.C0101_allcombined	3829813	3829842		ppdD	29
RK1001.C0101_allcombined	3829971	3829985		ppdD	14
RK1001.C0101_allcombined	3829978	3829995		gspE	17
RK1001.C0101_allcombined	3830229	3830253		gspE	24
RK1001.C0101_allcombined	3830439	3830441		gspE	2
RK1001.C0101_allcombined	3830599	3830613		gspE	14
RK1001.C0101_allcombined	3830756	3830762		gspE	6
RK1001.C0101_allcombined	3830904	3830913		gspE	9
RK1001.C0101_allcombined	3831220	3831241		gspE	21
RK1001.C0101_allcombined	3832094	3832120		hofC	26
RK1001.C0101_allcombined	3832169	3832207		hofC	38
RK1001.C0101_allcombined	3832350	3832356		hofC	6
RK1001.C0101_allcombined	3832433	3832466		hofC	33
RK1001.C0101_allcombined	3832689	3832712		hofC	23
RK1001.C0101_allcombined	3833292	3833294		YPO_RS18110	2
RK1001.C0101_allcombined	3833377	3833379		YPO_RS18110	2
RK1001.C0101_allcombined	3833450	3833454		YPO_RS18110	4
RK1001.C0101_allcombined	3834030	3834044		YPO_RS18110	14
RK1001.C0101_allcombined	3834515	3834529		coaE	14
RK1001.C0101_allcombined	3834608	3834617		coaE	9
RK1001.C0101_allcombined	3834733	3834744		coaE	11
RK1001.C0101_allcombined	3834853	3834878		coaE	25
RK1001.C0101_allcombined	3835093	3835098		coaE	5
RK1001.C0101_allcombined	3835095	3835113		zapD	18
RK1001.C0101_allcombined	3835203	3835265		zapD	62
RK1001.C0101_allcombined	3835563	3835581		zapD	18
RK1001.C0101_allcombined	3835838	3835844		zapD	6
RK1001.C0101_allcombined	3836229	3836239		yacG	10
RK1001.C0101_allcombined	3836833	3836835		YPO_RS18130	2
RK1001.C0101_allcombined	3838859	3838885		YPO_RS18145	26
RK1001.C0101_allcombined	3839106	3839121		YPO_RS18145	15
RK1001.C0101_allcombined	3839298	3839310		YPO_RS18145	12
RK1001.C0101_allcombined	3839473	3839494		YPO_RS18145	21
RK1001.C0101_allcombined	3839742	3839757		YPO_RS18145	15
RK1001.C0101_allcombined	3839789	3839807		YPO_RS18145	18
RK1001.C0101_allcombined	3839845	3839859		YPO_RS18145	14
RK1001.C0101_allcombined	3839890	3839910		YPO_RS18145	20
RK1001.C0101_allcombined	3840018	3840032		YPO_RS18150	14
RK1001.C0101_allcombined	3840124	3840131		YPO_RS18150	7
RK1001.C0101_allcombined	3840424	3840437		YPO_RS18150	13
RK1001.C0101_allcombined	3840600	3840609		YPO_RS18150	9
RK1001.C0101_allcombined	3841299	3841308		YPO_RS18150	9
RK1001.C0101_allcombined	3841788	3841815		YPO_RS18150	27
RK1001.C0101_allcombined	3842111	3842125		YPO_RS18155	14
RK1001.C0101_allcombined	3842291	3842309		YPO_RS18155	18
RK1001.C0101_allcombined	3842840	3842841		YPO_RS18155	1
RK1001.C0101_allcombined	3843740	3843749		lptG	9
RK1001.C0101_allcombined	3843826	3843831		lptG	5
RK1001.C0101_allcombined	3843909	3843912		lptG	3
RK1001.C0101_allcombined	3844093	3844099		lptG	6
RK1001.C0101_allcombined	3844138	3844140		lptG	2
RK1001.C0101_allcombined	3844220	3844227		lptG	7
RK1001.C0101_allcombined	3844703	3844735		lptG	32
RK1001.C0101_allcombined	3844966	3844968		lptF	2
RK1001.C0101_allcombined	3845724	3845786		lptF	62
RK1001.C0101_allcombined	3846113	3846119		pepA	6
RK1001.C0101_allcombined	3846407	3846411		pepA	4
RK1001.C0101_allcombined	3848109	3848125		YPO_RS18180	16
RK1001.C0101_allcombined	3848246	3848257		YPO_RS18185	11
RK1001.C0101_allcombined	3848338	3848346		YPO_RS18185	8
RK1001.C0101_allcombined	3848475	3848476		YPO_RS18185	1
RK1001.C0101_allcombined	3848706	3848713		YPO_RS18185	7
RK1001.C0101_allcombined	3848758	3848762		YPO_RS18185	4
RK1001.C0101_allcombined	3848814	3848831		YPO_RS18185	17
RK1001.C0101_allcombined	3849010	3849013		YPO_RS18185	3
RK1001.C0101_allcombined	3850850	3850870		YPO_RS18185	20
RK1001.C0101_allcombined	3851294	3851295		YPO_RS18190	1
RK1001.C0101_allcombined	3851396	3851410		YPO_RS18190	14
RK1001.C0101_allcombined	3851682	3851690		YPO_RS18190	8
RK1001.C0101_allcombined	3852486	3852491		rraB	5
RK1001.C0101_allcombined	3852935	3852970		argF	35
RK1001.C0101_allcombined	3853432	3853449		argF	17
RK1001.C0101_allcombined	3854388	3854389		YPO_RS18205	1
RK1001.C0101_allcombined	3854465	3854467		YPO_RS18205	2
RK1001.C0101_allcombined	3857254	3857274		YPO_RS18215	20
RK1001.C0101_allcombined	3857939	3857946		YPO_RS18215	7
RK1001.C0101_allcombined	3857999	3858011		YPO_RS18215	12
RK1001.C0101_allcombined	3858257	3858261		YPO_RS18220	4
RK1001.C0101_allcombined	3858741	3858758		YPO_RS18220	17
RK1001.C0101_allcombined	3858961	3858962		YPO_RS18225	1
RK1001.C0101_allcombined	3859080	3859088		YPO_RS18225	8
RK1001.C0101_allcombined	3861175	3861181		nrdD	6
RK1001.C0101_allcombined	3861637	3861654		nrdD	17
RK1001.C0101_allcombined	3862002	3862035		nrdD	33
RK1001.C0101_allcombined	3862275	3862294		nrdD	19
RK1001.C0101_allcombined	3862542	3862543		nrdD	1
RK1001.C0101_allcombined	3864647	3864649		phnF	2
RK1001.C0101_allcombined	3865267	3865273		phnH	6
RK1001.C0101_allcombined	3865822	3865827		phnH	5
RK1001.C0101_allcombined	3866559	3866567		YPO_RS18260	8
RK1001.C0101_allcombined	3866621	3866625		YPO_RS18260	4
RK1001.C0101_allcombined	3867366	3867375		YPO_RS18265	9
RK1001.C0101_allcombined	3867541	3867544		YPO_RS18265	3
RK1001.C0101_allcombined	3867737	3867738		YPO_RS18265	1
RK1001.C0101_allcombined	3868628	3868665		phnK	37
RK1001.C0101_allcombined	3869374	3869383		phnL	9
RK1001.C0101_allcombined	3869418	3869429		phnL	11
RK1001.C0101_allcombined	3870107	3870108		phnM	1
RK1001.C0101_allcombined	3870923	3870927		phnM	4
RK1001.C0101_allcombined	3871427	3871459		phnN	32
RK1001.C0101_allcombined	3871740	3871796		phnP	56
RK1001.C0101_allcombined	3871989	3871996		phnP	7
RK1001.C0101_allcombined	3874017	3874023		YPO_RS18305	6
RK1001.C0101_allcombined	3874564	3874586		YPO_RS18305	22
RK1001.C0101_allcombined	3874645	3874659		YPO_RS18305	14
RK1001.C0101_allcombined	3874720	3874721		YPO_RS18305	1
RK1001.C0101_allcombined	3875567	3875583		ugpC	16
RK1001.C0101_allcombined	3875867	3875872		ugpC	5
RK1001.C0101_allcombined	3877201	3877229		YPO_RS18320	28
RK1001.C0101_allcombined	3877519	3877530		YPO_RS18320	11
RK1001.C0101_allcombined	3877632	3877633		YPO_RS18320	1
RK1001.C0101_allcombined	3877641	3877649		YPO_RS18325	8
RK1001.C0101_allcombined	3878256	3878257		YPO_RS18325	1
RK1001.C0101_allcombined	3878527	3878611		YPO_RS18325	84
RK1001.C0101_allcombined	3878821	3878822		YPO_RS18325	1
RK1001.C0101_allcombined	3878880	3878954		YPO_RS18325	74
RK1001.C0101_allcombined	3879515	3879575		YPO_RS18330	60
RK1001.C0101_allcombined	3879626	3879665		YPO_RS18330	39
RK1001.C0101_allcombined	3879720	3879750		YPO_RS18330	30
RK1001.C0101_allcombined	3879782	3879795		YPO_RS18330	13
RK1001.C0101_allcombined	3880248	3880257		YPO_RS18330	9
RK1001.C0101_allcombined	3880773	3880785		YPO_RS18335	12
RK1001.C0101_allcombined	3880887	3880889		YPO_RS18335	2
RK1001.C0101_allcombined	3881145	3881176		YPO_RS18335	31
RK1001.C0101_allcombined	3881527	3881534		YPO_RS18335	7
RK1001.C0101_allcombined	3881582	3881588		YPO_RS18335	6
RK1001.C0101_allcombined	3881812	3881849		YPO_RS18335	37
RK1001.C0101_allcombined	3882308	3882318		YPO_RS18335	10
RK1001.C0101_allcombined	3883688	3883695		YPO_RS18345	7
RK1001.C0101_allcombined	3884175	3884207		YPO_RS18350	32
RK1001.C0101_allcombined	3884401	3884403		YPO_RS18350	2
RK1001.C0101_allcombined	3884969	3884987		YPO_RS18355	18
RK1001.C0101_allcombined	3885323	3885356		YPO_RS18355	33
RK1001.C0101_allcombined	3886024	3886046		YPO_RS18360	22
RK1001.C0101_allcombined	3886458	3886501		YPO_RS18360	43
RK1001.C0101_allcombined	3886847	3886908		YPO_RS18365	61
RK1001.C0101_allcombined	3886977	3886980		YPO_RS18365	3
RK1001.C0101_allcombined	3887449	3887463		YPO_RS18365	14
RK1001.C0101_allcombined	3888224	3888228		YPO_RS18365	4
RK1001.C0101_allcombined	3888404	3888422		YPO_RS18370	18
RK1001.C0101_allcombined	3888591	3888600		YPO_RS18370	9
RK1001.C0101_allcombined	3889078	3889081		YPO_RS18370	3
RK1001.C0101_allcombined	3889770	3889791		YPO_RS18370	21
RK1001.C0101_allcombined	3890014	3890016		YPO_RS18370	2
RK1001.C0101_allcombined	3890182	3890196		YPO_RS18370	14
RK1001.C0101_allcombined	3890799	3890821		YPO_RS18370	22
RK1001.C0101_allcombined	3891052	3891062		YPO_RS18370	10
RK1001.C0101_allcombined	3891139	3891157		YPO_RS18370	18
RK1001.C0101_allcombined	3891215	3891224		YPO_RS18370	9
RK1001.C0101_allcombined	3891885	3891893		YPO_RS18375	8
RK1001.C0101_allcombined	3891923	3891940		YPO_RS18375	17
RK1001.C0101_allcombined	3892286	3892315		YPO_RS18375	29
RK1001.C0101_allcombined	3892439	3892466		YPO_RS18375	27
RK1001.C0101_allcombined	3893064	3893076		YPO_RS18380	12
RK1001.C0101_allcombined	3893122	3893141		YPO_RS18380	19
RK1001.C0101_allcombined	3894351	3894365		YPO_RS18390	14
RK1001.C0101_allcombined	3894555	3894579		YPO_RS18390	24
RK1001.C0101_allcombined	3894698	3894710		YPO_RS18395	12
RK1001.C0101_allcombined	3894967	3894990		YPO_RS18395	23
RK1001.C0101_allcombined	3895897	3895919		YPO_RS18400	22
RK1001.C0101_allcombined	3896846	3896889		YPO_RS18400	43
RK1001.C0101_allcombined	3896969	3896984		YPO_RS18400	15
RK1001.C0101_allcombined	3897059	3897062		YPO_RS18400	3
RK1001.C0101_allcombined	3897164	3897196		YPO_RS18400	32
RK1001.C0101_allcombined	3897289	3897295		yrbN	6
RK1001.C0101_allcombined	3897349	3897354		yrbN	5
RK1001.C0101_allcombined	3897626	3897634		nlpI	8
RK1001.C0101_allcombined	3897792	3897811		nlpI	19
RK1001.C0101_allcombined	3898044	3898048		nlpI	4
RK1001.C0101_allcombined	3898145	3898153		nlpI	8
RK1001.C0101_allcombined	3898596	3898614		pnp	18
RK1001.C0101_allcombined	3898895	3898914		pnp	19
RK1001.C0101_allcombined	3899436	3899443		pnp	7
RK1001.C0101_allcombined	3899517	3899519		pnp	2
RK1001.C0101_allcombined	3899600	3899610		pnp	10
RK1001.C0101_allcombined	3900039	3900054		pnp	15
RK1001.C0101_allcombined	3900475	3900489		pnp	14
RK1001.C0101_allcombined	3900888	3900893		YPO_RS18420	5
RK1001.C0101_allcombined	3901240	3901273		YPO_RS18420	33
RK1001.C0101_allcombined	3902090	3902095		YPO_RS18420	5
RK1001.C0101_allcombined	3902573	3902574		rpsO	1
RK1001.C0101_allcombined	3902749	3902753		truB	4
RK1001.C0101_allcombined	3902785	3902803		truB	18
RK1001.C0101_allcombined	3903022	3903033		truB	11
RK1001.C0101_allcombined	3903116	3903128		truB	12
RK1001.C0101_allcombined	3903297	3903301		truB	4
RK1001.C0101_allcombined	3903555	3903591		truB	36
RK1001.C0101_allcombined	3903975	3903981		rbfA	6
RK1001.C0101_allcombined	3904634	3904651		infB	17
RK1001.C0101_allcombined	3904724	3904759		infB	35
RK1001.C0101_allcombined	3905570	3905575		infB	5
RK1001.C0101_allcombined	3906320	3906330		infB	10
RK1001.C0101_allcombined	3906593	3906599		infB	6
RK1001.C0101_allcombined	3907180	3907186		nusA	6
RK1001.C0101_allcombined	3907222	3907232		nusA	10
RK1001.C0101_allcombined	3908039	3908047		nusA	8
RK1001.C0101_allcombined	3908149	3908156		nusA	7
RK1001.C0101_allcombined	3908576	3908615		rimP	39
RK1001.C0101_allcombined	3909199	3909220		YPO_RS18460	21
RK1001.C0101_allcombined	3909577	3909588		secG	11
RK1001.C0101_allcombined	3909876	3909885		glmM	9
RK1001.C0101_allcombined	3910148	3910154		glmM	6
RK1001.C0101_allcombined	3910332	3910361		glmM	29
RK1001.C0101_allcombined	3910639	3910662		glmM	23
RK1001.C0101_allcombined	3911191	3911216		glmM	25
RK1001.C0101_allcombined	3911226	3911235		folP	9
RK1001.C0101_allcombined	3911362	3911374		folP	12
RK1001.C0101_allcombined	3911443	3911456		folP	13
RK1001.C0101_allcombined	3911557	3911605		folP	48
RK1001.C0101_allcombined	3911883	3911906		folP	23
RK1001.C0101_allcombined	3912020	3912024		folP	4
RK1001.C0101_allcombined	3912409	3912420		ftsH	11
RK1001.C0101_allcombined	3913378	3913389		ftsH	11
RK1001.C0101_allcombined	3913863	3913867		ftsH	4
RK1001.C0101_allcombined	3913991	3914021		ftsH	30
RK1001.C0101_allcombined	3914195	3914201		rlmE	6
RK1001.C0101_allcombined	3914334	3914371		rlmE	37
RK1001.C0101_allcombined	3914706	3914753		rlmE	47
RK1001.C0101_allcombined	3915367	3915388		greA	21
RK1001.C0101_allcombined	3915499	3915516		greA	17
RK1001.C0101_allcombined	3915825	3915843		greA	18
RK1001.C0101_allcombined	3917382	3917419		dacB	37
RK1001.C0101_allcombined	3917727	3917732		pmrA	5
RK1001.C0101_allcombined	3917984	3918008		pmrA	24
RK1001.C0101_allcombined	3918528	3918547		pmrB	19
RK1001.C0101_allcombined	3918599	3918602		pmrB	3
RK1001.C0101_allcombined	3918847	3918855		pmrB	8
RK1001.C0101_allcombined	3919726	3919750		cgtA	24
RK1001.C0101_allcombined	3920822	3920825		YPO_RS18520	3
RK1001.C0101_allcombined	3921131	3921133		YPO_RS18520	2
RK1001.C0101_allcombined	3921484	3921498		YPO_RS18520	14
RK1001.C0101_allcombined	3922628	3922655		ispB	27
RK1001.C0101_allcombined	3922690	3922714		ispB	24
RK1001.C0101_allcombined	3922905	3922938		ispB	33
RK1001.C0101_allcombined	3923186	3923201		ispB	15
RK1001.C0101_allcombined	3924070	3924120		YPO_RS18545	50
RK1001.C0101_allcombined	3925155	3925174		mdh	19
RK1001.C0101_allcombined	3926297	3926300		argR	3
RK1001.C0101_allcombined	3926532	3926541		argR	9
RK1001.C0101_allcombined	3927117	3927124		yhcN	7
RK1001.C0101_allcombined	3927160	3927173		yhcN	13
RK1001.C0101_allcombined	3928194	3928199		mpl	5
RK1001.C0101_allcombined	3928428	3928438		mpl	10
RK1001.C0101_allcombined	3928565	3928569		mpl	4
RK1001.C0101_allcombined	3928676	3928682		mpl	6
RK1001.C0101_allcombined	3928863	3928865		mpl	2
RK1001.C0101_allcombined	3929204	3929209		fbp	5
RK1001.C0101_allcombined	3929851	3929870		fbp	19
RK1001.C0101_allcombined	3930530	3930582		ppa	52
RK1001.C0101_allcombined	3931127	3931153		YPO_RS18580	26
RK1001.C0101_allcombined	3931493	3931514		YPO_RS18585	21
RK1001.C0101_allcombined	3932788	3932793		YPO_RS18585	5
RK1001.C0101_allcombined	3932830	3932833		YPO_RS18585	3
RK1001.C0101_allcombined	3933127	3933128		YPO_RS18585	1
RK1001.C0101_allcombined	3933842	3933849		YPO_RS18585	7
RK1001.C0101_allcombined	3933930	3933943		YPO_RS18585	13
RK1001.C0101_allcombined	3934521	3934523		YPO_RS18585	2
RK1001.C0101_allcombined	3934852	3934857		YPO_RS18585	5
RK1001.C0101_allcombined	3934907	3934918		YPO_RS18585	11
RK1001.C0101_allcombined	3935759	3935773		YPO_RS18590	14
RK1001.C0101_allcombined	3936017	3936024		YPO_RS18590	7
RK1001.C0101_allcombined	3936060	3936065		YPO_RS18590	5
RK1001.C0101_allcombined	3936790	3936792		YPO_RS18590	2
RK1001.C0101_allcombined	3937524	3937541		msrA	17
RK1001.C0101_allcombined	3937626	3937627		msrA	1
RK1001.C0101_allcombined	3937743	3937744		msrA	1
RK1001.C0101_allcombined	3937931	3937932		msrA	1
RK1001.C0101_allcombined	3939017	3939080		YPO_RS18600	63
RK1001.C0101_allcombined	3940206	3940207		YPO_RS18610	1
RK1001.C0101_allcombined	3940721	3940726		YPO_RS18610	5
RK1001.C0101_allcombined	3940807	3940820		cysQ	13
RK1001.C0101_allcombined	3942065	3942088		YPO_RS18620	23
RK1001.C0101_allcombined	3942175	3942205		YPO_RS18620	30
RK1001.C0101_allcombined	3942400	3942430		YPO_RS18620	30
RK1001.C0101_allcombined	3944291	3944297		ytfE	6
RK1001.C0101_allcombined	3944672	3944721		ytfE	49
RK1001.C0101_allcombined	3944947	3944950		YPO_RS18630	3
RK1001.C0101_allcombined	3945912	3945927		YPO_RS18635	15
RK1001.C0101_allcombined	3946120	3946124		YPO_RS18635	4
RK1001.C0101_allcombined	3946669	3946681		YPO_RS18640	12
RK1001.C0101_allcombined	3947015	3947021		YPO_RS18640	6
RK1001.C0101_allcombined	3947056	3947124		YPO_RS18640	68
RK1001.C0101_allcombined	3947261	3947264		YPO_RS18645	3
RK1001.C0101_allcombined	3947468	3947471		YPO_RS18645	3
RK1001.C0101_allcombined	3947521	3947526		YPO_RS18645	5
RK1001.C0101_allcombined	3948393	3948415		rpsR	22
RK1001.C0101_allcombined	3949231	3949237		rpsF	6
RK1001.C0101_allcombined	3949791	3949794		yjfP	3
RK1001.C0101_allcombined	3950172	3950180		yjfP	8
RK1001.C0101_allcombined	3950335	3950380		yjfP	45
RK1001.C0101_allcombined	3951157	3951159		YPO_RS18675	2
RK1001.C0101_allcombined	3951360	3951366		YPO_RS18675	6
RK1001.C0101_allcombined	3953856	3953877		YPO_RS18690	21
RK1001.C0101_allcombined	3954504	3954506		YPO_RS18695	2
RK1001.C0101_allcombined	3954590	3954600		YPO_RS18695	10
RK1001.C0101_allcombined	3954966	3954974		YPO_RS18695	8
RK1001.C0101_allcombined	3956066	3956068		rnpB	2
RK1001.C0101_allcombined	3956257	3956269		rsmI	12
RK1001.C0101_allcombined	3956321	3956337		rsmI	16
RK1001.C0101_allcombined	3956495	3956506		rsmI	11
RK1001.C0101_allcombined	3956984	3957004		rsmI	20
RK1001.C0101_allcombined	3957204	3957213		YPO_RS18710	9
RK1001.C0101_allcombined	3958109	3958112		YPO_RS18710	3
RK1001.C0101_allcombined	3958502	3958505		YPO_RS18710	3
RK1001.C0101_allcombined	3958893	3958915		YPO_RS18710	22
RK1001.C0101_allcombined	3960351	3960373		diaA	22
RK1001.C0101_allcombined	3960621	3960623		yraP	2
RK1001.C0101_allcombined	3961762	3961789		mtgA	27
RK1001.C0101_allcombined	3962035	3962050		elbB	15
RK1001.C0101_allcombined	3962142	3962145		elbB	3
RK1001.C0101_allcombined	3962188	3962191		elbB	3
RK1001.C0101_allcombined	3962305	3962321		elbB	16
RK1001.C0101_allcombined	3963289	3963295		arcB	6
RK1001.C0101_allcombined	3963425	3963431		arcB	6
RK1001.C0101_allcombined	3963512	3963538		arcB	26
RK1001.C0101_allcombined	3963724	3963727		arcB	3
RK1001.C0101_allcombined	3963763	3963775		arcB	12
RK1001.C0101_allcombined	3964140	3964152		arcB	12
RK1001.C0101_allcombined	3964432	3964434		arcB	2
RK1001.C0101_allcombined	3965065	3965093		arcB	28
RK1001.C0101_allcombined	3967134	3967159		gltB	25
RK1001.C0101_allcombined	3968450	3968484		gltB	34
RK1001.C0101_allcombined	3968673	3968682		gltB	9
RK1001.C0101_allcombined	3968853	3968885		gltB	32
RK1001.C0101_allcombined	3968917	3968920		gltB	3
RK1001.C0101_allcombined	3971054	3971056		gltB	2
RK1001.C0101_allcombined	3971119	3971120		gltB	1
RK1001.C0101_allcombined	3971183	3971188		gltB	5
RK1001.C0101_allcombined	3972018	3972042		YPO_RS18755	24
RK1001.C0101_allcombined	3972321	3972326		YPO_RS18755	5
RK1001.C0101_allcombined	3972619	3972632		YPO_RS18755	13
RK1001.C0101_allcombined	3973021	3973028		YPO_RS18755	7
RK1001.C0101_allcombined	3973469	3973477		YPO_RS18760	8
RK1001.C0101_allcombined	3973702	3973722		YPO_RS18760	20
RK1001.C0101_allcombined	3973799	3973819		YPO_RS18760	20
RK1001.C0101_allcombined	3974265	3974267		sspB	2
RK1001.C0101_allcombined	3974398	3974406		sspB	8
RK1001.C0101_allcombined	3974544	3974565		sspB	21
RK1001.C0101_allcombined	3974603	3974619		sspB	16
RK1001.C0101_allcombined	3974741	3974747		sspA	6
RK1001.C0101_allcombined	3975098	3975109		sspA	11
RK1001.C0101_allcombined	3975176	3975195		sspA	19
RK1001.C0101_allcombined	3975532	3975538		YPO_RS18775	6
RK1001.C0101_allcombined	3975610	3975617		YPO_RS18775	7
RK1001.C0101_allcombined	3976857	3976877		YPO_RS18790	20
RK1001.C0101_allcombined	3977668	3977692		YPO_RS18790	24
RK1001.C0101_allcombined	3978143	3978148		YPO_RS18795	5
RK1001.C0101_allcombined	3978818	3978825		degQ	7
RK1001.C0101_allcombined	3979098	3979099		degQ	1
RK1001.C0101_allcombined	3979297	3979304		degQ	7
RK1001.C0101_allcombined	3979989	3979997		degQ	8
RK1001.C0101_allcombined	3981005	3981013		degS	8
RK1001.C0101_allcombined	3981203	3981204		degS	1
RK1001.C0101_allcombined	3981264	3981280		degS	16
RK1001.C0101_allcombined	3981488	3981504		degS	16
RK1001.C0101_allcombined	3981809	3981817		degS	8
RK1001.C0101_allcombined	3981925	3982008		degS	83
RK1001.C0101_allcombined	3982302	3982326		murA	24
RK1001.C0101_allcombined	3982652	3982704		murA	52
RK1001.C0101_allcombined	3982850	3982875		murA	25
RK1001.C0101_allcombined	3983339	3983381		murA	42
RK1001.C0101_allcombined	3983694	3983706		ibaG	12
RK1001.C0101_allcombined	3984789	3984793		mlaC	4
RK1001.C0101_allcombined	3985557	3985564		mlaD	7
RK1001.C0101_allcombined	3985672	3985675		mlaE	3
RK1001.C0101_allcombined	3985715	3985718		mlaE	3
RK1001.C0101_allcombined	3985867	3985884		mlaE	17
RK1001.C0101_allcombined	3986742	3986746		mlaF	4
RK1001.C0101_allcombined	3987269	3987273		mlaF	4
RK1001.C0101_allcombined	3987347	3987360		mlaF	13
RK1001.C0101_allcombined	3987799	3987803		YPO_RS18850	4
RK1001.C0101_allcombined	3988221	3988242		YPO_RS18850	21
RK1001.C0101_allcombined	3988336	3988344		YPO_RS18850	8
RK1001.C0101_allcombined	3988639	3988658		YPO_RS18850	19
RK1001.C0101_allcombined	3989393	3989423		kdsD	30
RK1001.C0101_allcombined	3989540	3989547		kdsD	7
RK1001.C0101_allcombined	3989724	3989731		kdsD	7
RK1001.C0101_allcombined	3990295	3990314		kdsC	19
RK1001.C0101_allcombined	3990495	3990522		kdsC	27
RK1001.C0101_allcombined	3991018	3991049		lptC	31
RK1001.C0101_allcombined	3991156	3991164		lptA	8
RK1001.C0101_allcombined	3991274	3991295		lptA	21
RK1001.C0101_allcombined	3992789	3992833		rpoN	44
RK1001.C0101_allcombined	3993344	3993350		rpoN	6
RK1001.C0101_allcombined	3993683	3993702		rpoN	19
RK1001.C0101_allcombined	3993778	3993793		rpoN	15
RK1001.C0101_allcombined	3993887	3993889		rpoN	2
RK1001.C0101_allcombined	3994384	3994399		ptsN	15
RK1001.C0101_allcombined	3994515	3994520		ptsN	5
RK1001.C0101_allcombined	3994668	3994673		ptsN	5
RK1001.C0101_allcombined	3995234	3995239		rapZ	5
RK1001.C0101_allcombined	3995370	3995385		rapZ	15
RK1001.C0101_allcombined	3995682	3995692		rapZ	10
RK1001.C0101_allcombined	3995732	3995751		rapZ	19
RK1001.C0101_allcombined	3996862	3996868		pyrB	6
RK1001.C0101_allcombined	3997045	3997051		pyrB	6
RK1001.C0101_allcombined	3997348	3997356		pyrB	8
RK1001.C0101_allcombined	3997395	3997421		pyrB	26
RK1001.C0101_allcombined	3998362	3998376		ridA	14
RK1001.C0101_allcombined	3999744	3999749		YPO_RS18920	5
RK1001.C0101_allcombined	4001299	4001348		YPO_RS18935	49
RK1001.C0101_allcombined	4001587	4001589		YPO_RS18935	2
RK1001.C0101_allcombined	4001649	4001718		YPO_RS18935	69
RK1001.C0101_allcombined	4001682	4001778		tssG	96
RK1001.C0101_allcombined	4001858	4001859		tssG	1
RK1001.C0101_allcombined	4002567	4002575		tssG	8
RK1001.C0101_allcombined	4003443	4003507		tagH	64
RK1001.C0101_allcombined	4003844	4003855		tagH	11
RK1001.C0101_allcombined	4004038	4004055		tagH	17
RK1001.C0101_allcombined	4004522	4004555		tssJ	33
RK1001.C0101_allcombined	4004685	4004720		tssJ	35
RK1001.C0101_allcombined	4005563	4005577		tssK	14
RK1001.C0101_allcombined	4005950	4005956		tssK	6
RK1001.C0101_allcombined	4006226	4006228		YPO_RS18960	2
RK1001.C0101_allcombined	4006383	4006398		YPO_RS18960	15
RK1001.C0101_allcombined	4006708	4006713		YPO_RS18960	5
RK1001.C0101_allcombined	4006991	4007001		tssH	10
RK1001.C0101_allcombined	4007032	4007037		tssH	5
RK1001.C0101_allcombined	4007166	4007167		tssH	1
RK1001.C0101_allcombined	4007828	4007843		tssH	15
RK1001.C0101_allcombined	4008216	4008220		tssH	4
RK1001.C0101_allcombined	4008687	4008701		tssH	14
RK1001.C0101_allcombined	4009057	4009066		tssH	9
RK1001.C0101_allcombined	4009268	4009269		tssH	1
RK1001.C0101_allcombined	4009420	4009442		tssH	22
RK1001.C0101_allcombined	4009818	4009845		YPO_RS18970	27
RK1001.C0101_allcombined	4009969	4009971		YPO_RS18970	2
RK1001.C0101_allcombined	4010004	4010010		YPO_RS18970	6
RK1001.C0101_allcombined	4010265	4010271		YPO_RS18970	6
RK1001.C0101_allcombined	4010351	4010357		tagO	6
RK1001.C0101_allcombined	4010389	4010390		tagO	1
RK1001.C0101_allcombined	4011202	4011206		tssA	4
RK1001.C0101_allcombined	4011501	4011523		tssA	22
RK1001.C0101_allcombined	4011563	4011564		tssA	1
RK1001.C0101_allcombined	4012112	4012114		tssA	2
RK1001.C0101_allcombined	4012710	4012716		tssM	6
RK1001.C0101_allcombined	4013188	4013190		tssM	2
RK1001.C0101_allcombined	4013759	4013761		tssM	2
RK1001.C0101_allcombined	4013795	4013809		tssM	14
RK1001.C0101_allcombined	4013995	4013996		tssM	1
RK1001.C0101_allcombined	4014855	4014872		tssM	17
RK1001.C0101_allcombined	4015024	4015037		tssM	13
RK1001.C0101_allcombined	4015915	4015923		tssM	8
RK1001.C0101_allcombined	4016313	4016334		YPO_RS18990	21
RK1001.C0101_allcombined	4016436	4016439		YPO_RS18990	3
RK1001.C0101_allcombined	4016684	4016685		YPO_RS18990	1
RK1001.C0101_allcombined	4016913	4016927		YPO_RS18995	14
RK1001.C0101_allcombined	4018836	4018846		YPO_RS19000	10
RK1001.C0101_allcombined	4019680	4019707		YPO_RS19000	27
RK1001.C0101_allcombined	4019741	4019747		YPO_RS19000	6
RK1001.C0101_allcombined	4019808	4019814		YPO_RS19005	6
RK1001.C0101_allcombined	4019850	4019852		YPO_RS19005	2
RK1001.C0101_allcombined	4019958	4020002		YPO_RS19005	44
RK1001.C0101_allcombined	4020120	4020123		YPO_RS19005	3
RK1001.C0101_allcombined	4020354	4020363		YPO_RS19010	9
RK1001.C0101_allcombined	4020422	4020424		YPO_RS19010	2
RK1001.C0101_allcombined	4020507	4020510		YPO_RS19010	3
RK1001.C0101_allcombined	4020984	4020987		YPO_RS19010	3
RK1001.C0101_allcombined	4021595	4021598		YPO_RS19010	3
RK1001.C0101_allcombined	4021992	4022008		YPO_RS19010	16
RK1001.C0101_allcombined	4023776	4023777		YPO_RS19015	1
RK1001.C0101_allcombined	4024049	4024050		YPO_RS19015	1
RK1001.C0101_allcombined	4024154	4024166		YPO_RS19015	12
RK1001.C0101_allcombined	4024305	4024309		YPO_RS19015	4
RK1001.C0101_allcombined	4024512	4024520		YPO_RS19020	8
RK1001.C0101_allcombined	4024889	4024990		YPO_RS19020	101
RK1001.C0101_allcombined	4025172	4025231		YPO_RS19025	59
RK1001.C0101_allcombined	4025307	4025321		YPO_RS19030	14
RK1001.C0101_allcombined	4025467	4025487		YPO_RS19030	20
RK1001.C0101_allcombined	4025709	4025714		YPO_RS19035	5
RK1001.C0101_allcombined	4025861	4025866		YPO_RS19035	5
RK1001.C0101_allcombined	4026695	4026703		YPO_RS19045	8
RK1001.C0101_allcombined	4028204	4028207		YPO_RS19045	3
RK1001.C0101_allcombined	4028254	4028268		YPO_RS19045	14
RK1001.C0101_allcombined	4029393	4029429		YPO_RS19055	36
RK1001.C0101_allcombined	4030143	4030178		YPO_RS19055	35
RK1001.C0101_allcombined	4030538	4030550		YPO_RS19055	12
RK1001.C0101_allcombined	4030792	4030797		YPO_RS19055	5
RK1001.C0101_allcombined	4030946	4030972		YPO_RS19055	26
RK1001.C0101_allcombined	4031568	4031580		YPO_RS19055	12
RK1001.C0101_allcombined	4031658	4031665		YPO_RS19055	7
RK1001.C0101_allcombined	4031916	4031920		YPO_RS19055	4
RK1001.C0101_allcombined	4032466	4032474		YPO_RS19055	8
RK1001.C0101_allcombined	4032763	4032770		YPO_RS19055	7
RK1001.C0101_allcombined	4033114	4033122		YPO_RS19055	8
RK1001.C0101_allcombined	4033320	4033331		YPO_RS19055	11
RK1001.C0101_allcombined	4033405	4033441		YPO_RS19055	36
RK1001.C0101_allcombined	4033551	4033567		YPO_RS19055	16
RK1001.C0101_allcombined	4033650	4033711		YPO_RS19060	61
RK1001.C0101_allcombined	4033802	4033806		YPO_RS19060	4
RK1001.C0101_allcombined	4033839	4033851		YPO_RS19060	12
RK1001.C0101_allcombined	4033898	4033998		YPO_RS19060	100
RK1001.C0101_allcombined	4034035	4034141		YPO_RS19060	106
RK1001.C0101_allcombined	4034188	4034197		YPO_RS19060	9
RK1001.C0101_allcombined	4034253	4034336		YPO_RS19060	83
RK1001.C0101_allcombined	4034367	4034376		YPO_RS19060	9
RK1001.C0101_allcombined	4034651	4034678		YPO_RS19065	27
RK1001.C0101_allcombined	4034970	4035010		YPO_RS19070	40
RK1001.C0101_allcombined	4035245	4035270		YPO_RS19070	25
RK1001.C0101_allcombined	4036007	4036065		YPO_RS19075	58
RK1001.C0101_allcombined	4037868	4037869		YPO_RS19080	1
RK1001.C0101_allcombined	4038570	4038587		YPO_RS19090	17
RK1001.C0101_allcombined	4038622	4038638		YPO_RS19090	16
RK1001.C0101_allcombined	4038780	4038802		YPO_RS19090	22
RK1001.C0101_allcombined	4039103	4039105		YPO_RS19090	2
RK1001.C0101_allcombined	4040353	4040357		deoC	4
RK1001.C0101_allcombined	4040860	4040883		ssuE	23
RK1001.C0101_allcombined	4042102	4042105		YPO_RS19105	3
RK1001.C0101_allcombined	4042138	4042154		YPO_RS19105	16
RK1001.C0101_allcombined	4042607	4042612		ssuD	5
RK1001.C0101_allcombined	4043391	4043401		ssuD	10
RK1001.C0101_allcombined	4044129	4044153		ssuC	24
RK1001.C0101_allcombined	4044486	4044491		ssuC	5
RK1001.C0101_allcombined	4044857	4044863		ssuB	6
RK1001.C0101_allcombined	4046755	4046765		YPO_RS19135	10
RK1001.C0101_allcombined	4046958	4046977		YPO_RS19135	19
RK1001.C0101_allcombined	4047774	4047788		YPO_RS19135	14
RK1001.C0101_allcombined	4048339	4048361		YPO_RS19140	22
RK1001.C0101_allcombined	4048924	4048936		YPO_RS19140	12
RK1001.C0101_allcombined	4049077	4049096		YPO_RS19140	19
RK1001.C0101_allcombined	4049192	4049197		YPO_RS19140	5
RK1001.C0101_allcombined	4049669	4049686		YPO_RS19140	17
RK1001.C0101_allcombined	4049951	4049959		YPO_RS19140	8
RK1001.C0101_allcombined	4050181	4050217		YPO_RS19145	36
RK1001.C0101_allcombined	4050523	4050554		YPO_RS19145	31
RK1001.C0101_allcombined	4050628	4050654		YPO_RS19145	26
RK1001.C0101_allcombined	4050691	4050719		YPO_RS19145	28
RK1001.C0101_allcombined	4051078	4051112		YPO_RS19145	34
RK1001.C0101_allcombined	4051344	4051364		YPO_RS19145	20
RK1001.C0101_allcombined	4051516	4051519		lpxP	3
RK1001.C0101_allcombined	4051871	4051876		lpxP	5
RK1001.C0101_allcombined	4052205	4052213		lpxP	8
RK1001.C0101_allcombined	4053362	4053376		YPO_RS19155	14
RK1001.C0101_allcombined	4053962	4053964		YPO_RS19155	2
RK1001.C0101_allcombined	4055466	4055490		YPO_RS19160	24
RK1001.C0101_allcombined	4056489	4056493		YPO_RS19165	4
RK1001.C0101_allcombined	4056622	4056637		YPO_RS19165	15
RK1001.C0101_allcombined	4057078	4057096		YPO_RS19170	18
RK1001.C0101_allcombined	4057382	4057388		YPO_RS19170	6
RK1001.C0101_allcombined	4057561	4057565		YPO_RS19170	4
RK1001.C0101_allcombined	4058605	4058609		YPO_RS19175	4
RK1001.C0101_allcombined	4059405	4059472		YPO_RS19175	67
RK1001.C0101_allcombined	4059824	4059847		YPO_RS19180	23
RK1001.C0101_allcombined	4061800	4061816		YPO_RS19190	16
RK1001.C0101_allcombined	4061893	4061894		YPO_RS19190	1
RK1001.C0101_allcombined	4062531	4062533		YPO_RS19190	2
RK1001.C0101_allcombined	4063489	4063498		YPO_RS19195	9
RK1001.C0101_allcombined	4063932	4063952		YPO_RS19195	20
RK1001.C0101_allcombined	4064023	4064037		YPO_RS19195	14
RK1001.C0101_allcombined	4064879	4064888		YPO_RS19200	9
RK1001.C0101_allcombined	4065083	4065091		cspA	8
RK1001.C0101_allcombined	4065160	4065166		cspA	6
RK1001.C0101_allcombined	4066600	4066613		YPO_RS19215	13
RK1001.C0101_allcombined	4067524	4067530		YPO_RS19220	6
RK1001.C0101_allcombined	4067755	4067799		YPO_RS19220	44
RK1001.C0101_allcombined	4067829	4067833		YPO_RS19220	4
RK1001.C0101_allcombined	4067962	4067968		YPO_RS19220	6
RK1001.C0101_allcombined	4068132	4068174		YPO_RS19225	42
RK1001.C0101_allcombined	4068754	4068763		YPO_RS19225	9
RK1001.C0101_allcombined	4069188	4069196		YPO_RS19230	8
RK1001.C0101_allcombined	4069267	4069270		YPO_RS19230	3
RK1001.C0101_allcombined	4069787	4069791		YPO_RS19235	4
RK1001.C0101_allcombined	4070012	4070016		YPO_RS19235	4
RK1001.C0101_allcombined	4070107	4070121		YPO_RS19235	14
RK1001.C0101_allcombined	4070417	4070427		YPO_RS19235	10
RK1001.C0101_allcombined	4070599	4070620		YPO_RS19235	21
RK1001.C0101_allcombined	4070757	4070761		YPO_RS19235	4
RK1001.C0101_allcombined	4070812	4070815		YPO_RS19235	3
RK1001.C0101_allcombined	4071005	4071033		YPO_RS19235	28
RK1001.C0101_allcombined	4071832	4071842		YPO_RS19240	10
RK1001.C0101_allcombined	4072249	4072279		YPO_RS19245	30
RK1001.C0101_allcombined	4075466	4075482		prmA	16
RK1001.C0101_allcombined	4075603	4075624		prmA	21
RK1001.C0101_allcombined	4077100	4077118		panF	18
RK1001.C0101_allcombined	4078621	4078655		YPO_RS19285	34
RK1001.C0101_allcombined	4079230	4079249		accC	19
RK1001.C0101_allcombined	4079458	4079467		accC	9
RK1001.C0101_allcombined	4079524	4079533		accC	9
RK1001.C0101_allcombined	4081196	4081204		aroQ	8
RK1001.C0101_allcombined	4081857	4081868		msrQ	11
RK1001.C0101_allcombined	4082053	4082057		msrQ	4
RK1001.C0101_allcombined	4082097	4082098		msrQ	1
RK1001.C0101_allcombined	4082204	4082239		msrQ	35
RK1001.C0101_allcombined	4082400	4082405		msrP	5
RK1001.C0101_allcombined	4082706	4082707		msrP	1
RK1001.C0101_allcombined	4082968	4082972		msrP	4
RK1001.C0101_allcombined	4083411	4083429		msrP	18
RK1001.C0101_allcombined	4084375	4084381		YPO_RS19315	6
RK1001.C0101_allcombined	4085773	4085776		csrD	3
RK1001.C0101_allcombined	4086182	4086184		csrD	2
RK1001.C0101_allcombined	4086284	4086289		csrD	5
RK1001.C0101_allcombined	4086795	4086812		csrD	17
RK1001.C0101_allcombined	4087811	4087812		YPO_RS19325	1
RK1001.C0101_allcombined	4088829	4088853		mreC	24
RK1001.C0101_allcombined	4089331	4089361		mreC	30
RK1001.C0101_allcombined	4089670	4089674		mreD	4
RK1001.C0101_allcombined	4090724	4090727		rng	3
RK1001.C0101_allcombined	4091137	4091139		rng	2
RK1001.C0101_allcombined	4091492	4091505		rng	13
RK1001.C0101_allcombined	4091673	4091680		rng	7
RK1001.C0101_allcombined	4091735	4091749		rng	14
RK1001.C0101_allcombined	4092034	4092063		rng	29
RK1001.C0101_allcombined	4093391	4093429		YPO_RS19350	38
RK1001.C0101_allcombined	4093804	4093871		YPO_RS19350	67
RK1001.C0101_allcombined	4094383	4094386		YPO_RS19350	3
RK1001.C0101_allcombined	4095158	4095159		YPO_RS19350	1
RK1001.C0101_allcombined	4095491	4095516		YPO_RS19350	25
RK1001.C0101_allcombined	4095647	4095650		YPO_RS19350	3
RK1001.C0101_allcombined	4095784	4095789		YPO_RS19350	5
RK1001.C0101_allcombined	4096057	4096076		YPO_RS19350	19
RK1001.C0101_allcombined	4096388	4096406		YPO_RS19355	18
RK1001.C0101_allcombined	4098633	4098701		YPO_RS19365	68
RK1001.C0101_allcombined	4098770	4098878		YPO_RS19365	108
RK1001.C0101_allcombined	4098915	4099053		YPO_RS19365	138
RK1001.C0101_allcombined	4099088	4099108		YPO_RS19365	20
RK1001.C0101_allcombined	4099150	4099166		YPO_RS19365	16
RK1001.C0101_allcombined	4099339	4099547		YPO_RS19365	208
RK1001.C0101_allcombined	4101628	4101725		YPO_RS19370	97
RK1001.C0101_allcombined	4101799	4101868		YPO_RS19370	69
RK1001.C0101_allcombined	4101937	4101957		YPO_RS19370	20
RK1001.C0101_allcombined	4102119	4102128		YPO_RS19370	9
RK1001.C0101_allcombined	4102273	4102396		YPO_RS19370	123
RK1001.C0101_allcombined	4102436	4102446		YPO_RS19370	10
RK1001.C0101_allcombined	4102762	4102783		YPO_RS19370	21
RK1001.C0101_allcombined	4102876	4102894		YPO_RS19370	18
RK1001.C0101_allcombined	4103123	4103133		YPO_RS19370	10
RK1001.C0101_allcombined	4103575	4103577		YPO_RS19370	2
RK1001.C0101_allcombined	4104321	4104347		YPO_RS19370	26
RK1001.C0101_allcombined	4105102	4105117		YPO_RS19380	15
RK1001.C0101_allcombined	4105193	4105220		YPO_RS19380	27
RK1001.C0101_allcombined	4105912	4105916		YPO_RS19390	4
RK1001.C0101_allcombined	4106100	4106119		YPO_RS19390	19
RK1001.C0101_allcombined	4106362	4106403		YPO_RS19390	41
RK1001.C0101_allcombined	4106900	4106907		YPO_RS19390	7
RK1001.C0101_allcombined	4107135	4107139		YPO_RS19390	4
RK1001.C0101_allcombined	4107363	4107380		YPO_RS19390	17
RK1001.C0101_allcombined	4108106	4108115		YPO_RS19390	9
RK1001.C0101_allcombined	4108201	4108204		YPO_RS19390	3
RK1001.C0101_allcombined	4108372	4108380		YPO_RS19390	8
RK1001.C0101_allcombined	4108571	4108578		YPO_RS19390	7
RK1001.C0101_allcombined	4108780	4108788		YPO_RS19390	8
RK1001.C0101_allcombined	4109025	4109079		YPO_RS19390	54
RK1001.C0101_allcombined	4109586	4109589		YPO_RS19390	3
RK1001.C0101_allcombined	4110504	4110505		YPO_RS19395	1
RK1001.C0101_allcombined	4110584	4110588		YPO_RS19395	4
RK1001.C0101_allcombined	4110947	4110950		YPO_RS19395	3
RK1001.C0101_allcombined	4111544	4111551		YPO_RS19395	7
RK1001.C0101_allcombined	4111816	4111820		YPO_RS19395	4
RK1001.C0101_allcombined	4111963	4111996		YPO_RS19395	33
RK1001.C0101_allcombined	4112394	4112401		YPO_RS19395	7
RK1001.C0101_allcombined	4112534	4112610		YPO_RS19400	76
RK1001.C0101_allcombined	4112668	4112692		YPO_RS19400	24
RK1001.C0101_allcombined	4112726	4112778		YPO_RS19400	52
RK1001.C0101_allcombined	4112849	4112930		YPO_RS19400	81
RK1001.C0101_allcombined	4112998	4113173		YPO_RS19400	175
RK1001.C0101_allcombined	4113367	4113372		YPO_RS19400	5
RK1001.C0101_allcombined	4113468	4113529		YPO_RS19400	61
RK1001.C0101_allcombined	4113613	4113674		YPO_RS19400	61
RK1001.C0101_allcombined	4113746	4113750		YPO_RS19400	4
RK1001.C0101_allcombined	4113873	4113893		YPO_RS19400	20
RK1001.C0101_allcombined	4114024	4114061		YPO_RS19405	37
RK1001.C0101_allcombined	4114133	4114189		YPO_RS19405	56
RK1001.C0101_allcombined	4114226	4114248		YPO_RS19405	22
RK1001.C0101_allcombined	4114305	4114311		YPO_RS19405	6
RK1001.C0101_allcombined	4114395	4114435		YPO_RS19405	40
RK1001.C0101_allcombined	4114542	4114590		YPO_RS19405	48
RK1001.C0101_allcombined	4114702	4114745		YPO_RS19405	43
RK1001.C0101_allcombined	4115219	4115222		YPO_RS19405	3
RK1001.C0101_allcombined	4115281	4115286		YPO_RS19405	5
RK1001.C0101_allcombined	4115342	4115362		YPO_RS19405	20
RK1001.C0101_allcombined	4115510	4115539		YPO_RS19405	29
RK1001.C0101_allcombined	4115640	4115649		YPO_RS19405	9
RK1001.C0101_allcombined	4115904	4115928		YPO_RS19405	24
RK1001.C0101_allcombined	4116119	4116149		YPO_RS19405	30
RK1001.C0101_allcombined	4116399	4116435		YPO_RS19405	36
RK1001.C0101_allcombined	4116720	4116830		YPO_RS19410	110
RK1001.C0101_allcombined	4116962	4116970		YPO_RS19410	8
RK1001.C0101_allcombined	4117000	4117065		YPO_RS19410	65
RK1001.C0101_allcombined	4117127	4117210		YPO_RS19410	83
RK1001.C0101_allcombined	4117272	4117330		YPO_RS19410	58
RK1001.C0101_allcombined	4117412	4117454		YPO_RS19410	42
RK1001.C0101_allcombined	4117842	4117866		aaeR	24
RK1001.C0101_allcombined	4117983	4118001		aaeR	18
RK1001.C0101_allcombined	4118404	4118406		aaeR	2
RK1001.C0101_allcombined	4118437	4118444		aaeR	7
RK1001.C0101_allcombined	4118549	4118554		aaeR	5
RK1001.C0101_allcombined	4119189	4119215		YPO_RS19420	26
RK1001.C0101_allcombined	4119599	4119600		aaeA	1
RK1001.C0101_allcombined	4119693	4119705		aaeA	12
RK1001.C0101_allcombined	4119802	4119820		aaeA	18
RK1001.C0101_allcombined	4119859	4119865		aaeA	6
RK1001.C0101_allcombined	4120071	4120085		aaeA	14
RK1001.C0101_allcombined	4121013	4121029		aaeB	16
RK1001.C0101_allcombined	4121462	4121463		aaeB	1
RK1001.C0101_allcombined	4121542	4121566		aaeB	24
RK1001.C0101_allcombined	4121646	4121650		aaeB	4
RK1001.C0101_allcombined	4121863	4121867		aaeB	4
RK1001.C0101_allcombined	4124080	4124082		YPO_RS19440	2
RK1001.C0101_allcombined	4124505	4124517		YPO_RS19440	12
RK1001.C0101_allcombined	4124791	4124796		YPO_RS19445	5
RK1001.C0101_allcombined	4125060	4125084		YPO_RS19450	24
RK1001.C0101_allcombined	4125271	4125275		YPO_RS19450	4
RK1001.C0101_allcombined	4125666	4125677		pmbA	11
RK1001.C0101_allcombined	4126108	4126123		pmbA	15
RK1001.C0101_allcombined	4126559	4126571		pmbA	12
RK1001.C0101_allcombined	4127279	4127291		YPO_RS19460	12
RK1001.C0101_allcombined	4127330	4127336		YPO_RS19460	6
RK1001.C0101_allcombined	4127595	4127601		YPO_RS19460	6
RK1001.C0101_allcombined	4127731	4127761		YPO_RS19460	30
RK1001.C0101_allcombined	4128086	4128091		cybC	5
RK1001.C0101_allcombined	4128696	4128706		rnk	10
RK1001.C0101_allcombined	4128903	4128916		rnk	13
RK1001.C0101_allcombined	4129631	4129632		treC	1
RK1001.C0101_allcombined	4129804	4129813		treC	9
RK1001.C0101_allcombined	4129868	4129873		treC	5
RK1001.C0101_allcombined	4130184	4130192		treC	8
RK1001.C0101_allcombined	4130756	4130763		treC	7
RK1001.C0101_allcombined	4130807	4130824		treC	17
RK1001.C0101_allcombined	4130934	4130944		treC	10
RK1001.C0101_allcombined	4131290	4131298		treB	8
RK1001.C0101_allcombined	4131374	4131376		treB	2
RK1001.C0101_allcombined	4131674	4131679		treB	5
RK1001.C0101_allcombined	4132482	4132529		treB	47
RK1001.C0101_allcombined	4133421	4133424		treR	3
RK1001.C0101_allcombined	4134239	4134250		YPO_RS19490	11
RK1001.C0101_allcombined	4134286	4134328		YPO_RS19490	42
RK1001.C0101_allcombined	4134674	4134710		YPO_RS19490	36
RK1001.C0101_allcombined	4136521	4136523		YPO_RS19500	2
RK1001.C0101_allcombined	4139188	4139189		tssE	1
RK1001.C0101_allcombined	4139862	4139870		tssC	8
RK1001.C0101_allcombined	4140185	4140192		tssC	7
RK1001.C0101_allcombined	4140552	4140560		tssC	8
RK1001.C0101_allcombined	4140898	4140905		tssC	7
RK1001.C0101_allcombined	4141098	4141122		tssB	24
RK1001.C0101_allcombined	4141469	4141476		tssB	7
RK1001.C0101_allcombined	4142056	4142067		YPO_RS19530	11
RK1001.C0101_allcombined	4142672	4142703		YPO_RS19535	31
RK1001.C0101_allcombined	4142766	4142873		YPO_RS19535	107
RK1001.C0101_allcombined	4142912	4142915		YPO_RS19535	3
RK1001.C0101_allcombined	4143849	4143860		malM	11
RK1001.C0101_allcombined	4143913	4143918		malM	5
RK1001.C0101_allcombined	4144192	4144200		malM	8
RK1001.C0101_allcombined	4144648	4144667		YPO_RS19545	19
RK1001.C0101_allcombined	4144862	4144880		YPO_RS19545	18
RK1001.C0101_allcombined	4145044	4145045		YPO_RS19545	1
RK1001.C0101_allcombined	4145264	4145265		YPO_RS19545	1
RK1001.C0101_allcombined	4145670	4145697		YPO_RS19545	27
RK1001.C0101_allcombined	4145796	4145819		YPO_RS19545	23
RK1001.C0101_allcombined	4146577	4146585		malK	8
RK1001.C0101_allcombined	4147257	4147262		YPO_RS19555	5
RK1001.C0101_allcombined	4147955	4147965		malE	10
RK1001.C0101_allcombined	4148310	4148311		malE	1
RK1001.C0101_allcombined	4148519	4148529		malE	10
RK1001.C0101_allcombined	4149511	4149528		malF	17
RK1001.C0101_allcombined	4149671	4149674		malF	3
RK1001.C0101_allcombined	4150195	4150290		malF	95
RK1001.C0101_allcombined	4150361	4150367		malF	6
RK1001.C0101_allcombined	4150401	4150406		malF	5
RK1001.C0101_allcombined	4150636	4150646		malF	10
RK1001.C0101_allcombined	4151344	4151346		malG	2
RK1001.C0101_allcombined	4151545	4151548		malG	3
RK1001.C0101_allcombined	4151865	4151866		psiE	1
RK1001.C0101_allcombined	4152520	4152532		pgi	12
RK1001.C0101_allcombined	4153105	4153125		pgi	20
RK1001.C0101_allcombined	4153569	4153570		pgi	1
RK1001.C0101_allcombined	4154650	4154654		lysC	4
RK1001.C0101_allcombined	4155761	4155789		lysC	28
RK1001.C0101_allcombined	4156394	4156395		YPO_RS19590	1
RK1001.C0101_allcombined	4156442	4156450		YPO_RS19590	8
RK1001.C0101_allcombined	4156573	4156580		YPO_RS19590	7
RK1001.C0101_allcombined	4156626	4156667		YPO_RS19590	41
RK1001.C0101_allcombined	4156739	4156741		YPO_RS19590	2
RK1001.C0101_allcombined	4157653	4157666		YPO_RS19590	13
RK1001.C0101_allcombined	4157884	4157905		YPO_RS19590	21
RK1001.C0101_allcombined	4158256	4158261		YPO_RS19595	5
RK1001.C0101_allcombined	4158459	4158466		YPO_RS19595	7
RK1001.C0101_allcombined	4158642	4158713		YPO_RS19595	71
RK1001.C0101_allcombined	4158848	4158850		YPO_RS19595	2
RK1001.C0101_allcombined	4159073	4159074		YPO_RS19595	1
RK1001.C0101_allcombined	4159113	4159123		YPO_RS19595	10
RK1001.C0101_allcombined	4159339	4159371		YPO_RS19595	32
RK1001.C0101_allcombined	4159554	4159583		YPO_RS19595	29
RK1001.C0101_allcombined	4159683	4159728		YPO_RS19595	45
RK1001.C0101_allcombined	4159802	4159805		YPO_RS19595	3
RK1001.C0101_allcombined	4159897	4159910		YPO_RS19595	13
RK1001.C0101_allcombined	4160383	4160385		YPO_RS19595	2
RK1001.C0101_allcombined	4160569	4160578		YPO_RS19595	9
RK1001.C0101_allcombined	4160794	4160838		YPO_RS19595	44
RK1001.C0101_allcombined	4161196	4161220		YPO_RS19595	24
RK1001.C0101_allcombined	4161277	4161289		YPO_RS19595	12
RK1001.C0101_allcombined	4161501	4161516		YPO_RS19595	15
RK1001.C0101_allcombined	4162191	4162216		YPO_RS19595	25
RK1001.C0101_allcombined	4162421	4162489		YPO_RS19595	68
RK1001.C0101_allcombined	4162743	4162770		YPO_RS19595	27
RK1001.C0101_allcombined	4162813	4162878		YPO_RS19595	65
RK1001.C0101_allcombined	4162909	4162912		YPO_RS19595	3
RK1001.C0101_allcombined	4162994	4163019		YPO_RS19595	25
RK1001.C0101_allcombined	4163620	4163638		metH	18
RK1001.C0101_allcombined	4163989	4164014		metH	25
RK1001.C0101_allcombined	4164047	4164064		metH	17
RK1001.C0101_allcombined	4165036	4165065		metH	29
RK1001.C0101_allcombined	4165230	4165237		metH	7
RK1001.C0101_allcombined	4165469	4165496		metH	27
RK1001.C0101_allcombined	4166258	4166265		metH	7
RK1001.C0101_allcombined	4168454	4168483		aceK	29
RK1001.C0101_allcombined	4168739	4168776		aceK	37
RK1001.C0101_allcombined	4170024	4170069		aceA	45
RK1001.C0101_allcombined	4170306	4170313		aceA	7
RK1001.C0101_allcombined	4170943	4170971		aceA	28
RK1001.C0101_allcombined	4171628	4171632		aceB	4
RK1001.C0101_allcombined	4172040	4172060		aceB	20
RK1001.C0101_allcombined	4172533	4172551		aceB	18
RK1001.C0101_allcombined	4172736	4172745		aceB	9
RK1001.C0101_allcombined	4173355	4173364		metA	9
RK1001.C0101_allcombined	4173655	4173671		metA	16
RK1001.C0101_allcombined	4174110	4174127		metA	17
RK1001.C0101_allcombined	4175014	4175029		rrf	15
RK1001.C0101_allcombined	4175191	4175209		YPO_RS19635	18
RK1001.C0101_allcombined	4176211	4176220		YPO_RS19645	9
RK1001.C0101_allcombined	4177766	4177769		YPO_RS19645	3
RK1001.C0101_allcombined	4180529	4180532		YPO_RS19665	3
RK1001.C0101_allcombined	4181756	4181780		purH	24
RK1001.C0101_allcombined	4182788	4182803		purD	15
RK1001.C0101_allcombined	4183310	4183314		purD	4
RK1001.C0101_allcombined	4184661	4184692		YPO_RS19680	31
RK1001.C0101_allcombined	4184904	4184911		hupA	7
RK1001.C0101_allcombined	4185406	4185445		YPO_RS19690	39
RK1001.C0101_allcombined	4185529	4185530		YPO_RS19690	1
RK1001.C0101_allcombined	4185693	4185700		YPO_RS19690	7
RK1001.C0101_allcombined	4185793	4185795		YPO_RS19690	2
RK1001.C0101_allcombined	4186209	4186227		nfi	18
RK1001.C0101_allcombined	4186919	4186974		hemE	55
RK1001.C0101_allcombined	4187178	4187212		hemE	34
RK1001.C0101_allcombined	4187349	4187375		hemE	26
RK1001.C0101_allcombined	4188106	4188153		YPO_RS19705	47
RK1001.C0101_allcombined	4188302	4188321		YPO_RS19705	19
RK1001.C0101_allcombined	4188472	4188512		YPO_RS19705	40
RK1001.C0101_allcombined	4188599	4188606		YPO_RS19705	7
RK1001.C0101_allcombined	4188659	4188692		YPO_RS19705	33
RK1001.C0101_allcombined	4189802	4189805		rsd	3
RK1001.C0101_allcombined	4189927	4189933		rsd	6
RK1001.C0101_allcombined	4190657	4190659		thiC	2
RK1001.C0101_allcombined	4190705	4190738		thiC	33
RK1001.C0101_allcombined	4191393	4191405		thiC	12
RK1001.C0101_allcombined	4191933	4191948		thiC	15
RK1001.C0101_allcombined	4194373	4194384		YPO_RS19740	11
RK1001.C0101_allcombined	4196094	4196101		thiH	7
RK1001.C0101_allcombined	4196204	4196205		thiH	1
RK1001.C0101_allcombined	4196776	4196789		YPO_RS19750	13
RK1001.C0101_allcombined	4197125	4197126		YPO_RS19750	1
RK1001.C0101_allcombined	4197957	4197962		rpoC	5
RK1001.C0101_allcombined	4198090	4198105		rpoC	15
RK1001.C0101_allcombined	4199665	4199674		rpoC	9
RK1001.C0101_allcombined	4199949	4199968		rpoC	19
RK1001.C0101_allcombined	4202328	4202329		rpoB	1
RK1001.C0101_allcombined	4202406	4202416		rpoB	10
RK1001.C0101_allcombined	4202512	4202522		rpoB	10
RK1001.C0101_allcombined	4203439	4203445		rpoB	6
RK1001.C0101_allcombined	4203849	4203856		rpoB	7
RK1001.C0101_allcombined	4204595	4204601		rpoB	6
RK1001.C0101_allcombined	4205221	4205227		rpoB	6
RK1001.C0101_allcombined	4205423	4205451		rpoB	28
RK1001.C0101_allcombined	4205560	4205635		rpoB	75
RK1001.C0101_allcombined	4206230	4206234		rplL	4
RK1001.C0101_allcombined	4206340	4206341		rplL	1
RK1001.C0101_allcombined	4207440	4207478		rplA	38
RK1001.C0101_allcombined	4207555	4207556		rplA	1
RK1001.C0101_allcombined	4208106	4208111		rplK	5
RK1001.C0101_allcombined	4208237	4208255		rplK	18
RK1001.C0101_allcombined	4208866	4208876		nusG	10
RK1001.C0101_allcombined	4208918	4208927		nusG	9
RK1001.C0101_allcombined	4209177	4209204		secE	27
RK1001.C0101_allcombined	4209514	4209538		secE	24
RK1001.C0101_allcombined	4209884	4209885		tuf	1
RK1001.C0101_allcombined	4210220	4210221		tuf	1
RK1001.C0101_allcombined	4210294	4210305		tuf	11
RK1001.C0101_allcombined	4210582	4210597		tuf	15
RK1001.C0101_allcombined	4211105	4211107		YPO_RS19800	2
RK1001.C0101_allcombined	4211222	4211237		YPO_RS19805	15
RK1001.C0101_allcombined	4212492	4212493		YPO_RS19820	1
RK1001.C0101_allcombined	4213147	4213152		YPO_RS19825	5
RK1001.C0101_allcombined	4213768	4213781		YPO_RS19825	13
RK1001.C0101_allcombined	4213921	4213923		YPO_RS19830	2
RK1001.C0101_allcombined	4213957	4213965		YPO_RS19830	8
RK1001.C0101_allcombined	4214279	4214326		YPO_RS19830	47
RK1001.C0101_allcombined	4214436	4214471		YPO_RS19830	35
RK1001.C0101_allcombined	4214683	4214687		coaA	4
RK1001.C0101_allcombined	4214803	4214808		coaA	5
RK1001.C0101_allcombined	4215077	4215085		coaA	8
RK1001.C0101_allcombined	4215315	4215331		coaA	16
RK1001.C0101_allcombined	4215373	4215468		coaA	95
RK1001.C0101_allcombined	4215668	4215721		birA	53
RK1001.C0101_allcombined	4215797	4215809		birA	12
RK1001.C0101_allcombined	4215919	4215939		birA	20
RK1001.C0101_allcombined	4216009	4216013		birA	4
RK1001.C0101_allcombined	4216359	4216397		birA	38
RK1001.C0101_allcombined	4216443	4216462		birA	19
RK1001.C0101_allcombined	4216592	4216612		birA	20
RK1001.C0101_allcombined	4216652	4216657		murB	5
RK1001.C0101_allcombined	4216741	4216743		murB	2
RK1001.C0101_allcombined	4216787	4216827		murB	40
RK1001.C0101_allcombined	4217094	4217098		murB	4
RK1001.C0101_allcombined	4217218	4217287		murB	69
RK1001.C0101_allcombined	4217464	4217477		murB	13
RK1001.C0101_allcombined	4218342	4218354		YPO_RS19855	12
RK1001.C0101_allcombined	4219432	4219433		YPO_RS19855	1
RK1001.C0101_allcombined	4223131	4223151		YPO_RS19870	20
RK1001.C0101_allcombined	4223353	4223365		YPO_RS19875	12
RK1001.C0101_allcombined	4223415	4223439		YPO_RS19875	24
RK1001.C0101_allcombined	4223875	4223938		hemG	63
RK1001.C0101_allcombined	4223969	4223977		hemG	8
RK1001.C0101_allcombined	4224163	4224165		hemG	2
RK1001.C0101_allcombined	4224224	4224234		hemG	10
RK1001.C0101_allcombined	4224306	4224331		hemG	25
RK1001.C0101_allcombined	4224481	4224485		trkH	4
RK1001.C0101_allcombined	4224898	4224902		trkH	4
RK1001.C0101_allcombined	4225191	4225203		trkH	12
RK1001.C0101_allcombined	4225461	4225463		trkH	2
RK1001.C0101_allcombined	4225501	4225509		trkH	8
RK1001.C0101_allcombined	4226410	4226417		YPO_RS19895	7
RK1001.C0101_allcombined	4226956	4226970		YPO_RS19900	14
RK1001.C0101_allcombined	4227000	4227012		YPO_RS19900	12
RK1001.C0101_allcombined	4227223	4227273		pepQ	50
RK1001.C0101_allcombined	4227728	4227737		pepQ	9
RK1001.C0101_allcombined	4227884	4227889		pepQ	5
RK1001.C0101_allcombined	4228340	4228347		pepQ	7
RK1001.C0101_allcombined	4229055	4229067		fadB	12
RK1001.C0101_allcombined	4229972	4229973		fadB	1
RK1001.C0101_allcombined	4230083	4230102		fadB	19
RK1001.C0101_allcombined	4230274	4230278		fadB	4
RK1001.C0101_allcombined	4230447	4230465		fadB	18
RK1001.C0101_allcombined	4230543	4230549		fadB	6
RK1001.C0101_allcombined	4230824	4230826		fadB	2
RK1001.C0101_allcombined	4230922	4230924		fadB	2
RK1001.C0101_allcombined	4231001	4231012		fadB	11
RK1001.C0101_allcombined	4231075	4231087		fadA	12
RK1001.C0101_allcombined	4232495	4232513		fre	18
RK1001.C0101_allcombined	4232587	4232589		fre	2
RK1001.C0101_allcombined	4232690	4232691		fre	1
RK1001.C0101_allcombined	4232988	4233048		fre	60
RK1001.C0101_allcombined	4233306	4233340		ubiD	34
RK1001.C0101_allcombined	4233373	4233403		ubiD	30
RK1001.C0101_allcombined	4233723	4233735		ubiD	12
RK1001.C0101_allcombined	4233905	4233934		ubiD	29
RK1001.C0101_allcombined	4234065	4234107		ubiD	42
RK1001.C0101_allcombined	4234284	4234304		ubiD	20
RK1001.C0101_allcombined	4235160	4235186		rfaH	26
RK1001.C0101_allcombined	4235311	4235313		rfaH	2
RK1001.C0101_allcombined	4235666	4235668		hemB	2
RK1001.C0101_allcombined	4235788	4235797		hemB	9
RK1001.C0101_allcombined	4236083	4236110		hemB	27
RK1001.C0101_allcombined	4236180	4236221		hemB	41
RK1001.C0101_allcombined	4236459	4236464		hemB	5
RK1001.C0101_allcombined	4236757	4236787		YPO_RS19940	30
RK1001.C0101_allcombined	4239302	4239304		tatC	2
RK1001.C0101_allcombined	4239352	4239354		tatC	2
RK1001.C0101_allcombined	4239502	4239531		tatC	29
RK1001.C0101_allcombined	4240012	4240029		tatC	17
RK1001.C0101_allcombined	4240176	4240184		tatB	8
RK1001.C0101_allcombined	4240219	4240220		tatB	1
RK1001.C0101_allcombined	4240313	4240328		tatB	15
RK1001.C0101_allcombined	4240549	4240555		tatB	6
RK1001.C0101_allcombined	4241277	4241298		ubiB	21
RK1001.C0101_allcombined	4241419	4241421		ubiB	2
RK1001.C0101_allcombined	4241592	4241607		ubiB	15
RK1001.C0101_allcombined	4241889	4241892		ubiB	3
RK1001.C0101_allcombined	4242044	4242097		ubiB	53
RK1001.C0101_allcombined	4242281	4242294		ubiB	13
RK1001.C0101_allcombined	4242371	4242374		ubiB	3
RK1001.C0101_allcombined	4242453	4242469		ubiB	16
RK1001.C0101_allcombined	4242670	4242760		ubiB	90
RK1001.C0101_allcombined	4243032	4243038		YPO_RS19980	6
RK1001.C0101_allcombined	4243293	4243307		YPO_RS19980	14
RK1001.C0101_allcombined	4243389	4243391		YPO_RS19980	2
RK1001.C0101_allcombined	4243438	4243451		YPO_RS19980	13
RK1001.C0101_allcombined	4243804	4243815		ubiE	11
RK1001.C0101_allcombined	4244120	4244123		ubiE	3
RK1001.C0101_allcombined	4244207	4244219		ubiE	12
RK1001.C0101_allcombined	4244341	4244346		rmuC	5
RK1001.C0101_allcombined	4244914	4244927		rmuC	13
RK1001.C0101_allcombined	4246280	4246296		YPO_RS19995	16
RK1001.C0101_allcombined	4246550	4246555		YPO_RS19995	5
RK1001.C0101_allcombined	4246931	4246953		YPO_RS20000	22
RK1001.C0101_allcombined	4247164	4247208		YPO_RS20000	44
RK1001.C0101_allcombined	4247886	4247909		YPO_RS20000	23
RK1001.C0101_allcombined	4247939	4247941		YPO_RS20000	2
RK1001.C0101_allcombined	4248251	4248254		YPO_RS20000	3
RK1001.C0101_allcombined	4248571	4248593		YPO_RS20000	22
RK1001.C0101_allcombined	4249002	4249036		YPO_RS20005	34
RK1001.C0101_allcombined	4249290	4249292		YPO_RS20005	2
RK1001.C0101_allcombined	4249366	4249376		YPO_RS20005	10
RK1001.C0101_allcombined	4249620	4249624		YPO_RS20005	4
RK1001.C0101_allcombined	4249757	4249764		YPO_RS20005	7
RK1001.C0101_allcombined	4250422	4250431		udp	9
RK1001.C0101_allcombined	4250711	4250714		udp	3
RK1001.C0101_allcombined	4251241	4251271		YPO_RS20015	30
RK1001.C0101_allcombined	4251337	4251340		YPO_RS20015	3
RK1001.C0101_allcombined	4251499	4251529		YPO_RS20015	30
RK1001.C0101_allcombined	4251560	4251567		YPO_RS20015	7
RK1001.C0101_allcombined	4251967	4251983		YPO_RS20015	16
RK1001.C0101_allcombined	4252070	4252082		metE	12
RK1001.C0101_allcombined	4252260	4252274		metE	14
RK1001.C0101_allcombined	4252784	4252795		metE	11
RK1001.C0101_allcombined	4253259	4253263		metE	4
RK1001.C0101_allcombined	4254748	4254758		metR	10
RK1001.C0101_allcombined	4255680	4255686		YPO_RS20030	6
RK1001.C0101_allcombined	4256118	4256119		YPO_RS20030	1
RK1001.C0101_allcombined	4256162	4256180		YPO_RS20030	18
RK1001.C0101_allcombined	4257151	4257155		YPO_RS20035	4
RK1001.C0101_allcombined	4257915	4257921		ugpQ	6
RK1001.C0101_allcombined	4258172	4258174		ugpQ	2
RK1001.C0101_allcombined	4258325	4258338		ugpQ	13
RK1001.C0101_allcombined	4259197	4259249		YPO_RS20045	52
RK1001.C0101_allcombined	4259406	4259419		YPO_RS20045	13
RK1001.C0101_allcombined	4260209	4260216		ugpE	7
RK1001.C0101_allcombined	4260311	4260330		ugpA	19
RK1001.C0101_allcombined	4260750	4260760		ugpA	10
RK1001.C0101_allcombined	4260935	4260939		ugpA	4
RK1001.C0101_allcombined	4261093	4261099		ugpA	6
RK1001.C0101_allcombined	4261821	4261833		ugpB	12
RK1001.C0101_allcombined	4262376	4262388		ugpB	12
RK1001.C0101_allcombined	4262530	4262547		ugpB	17
RK1001.C0101_allcombined	4263341	4263369		YPO_RS20065	28
RK1001.C0101_allcombined	4263465	4263508		YPO_RS20065	43
RK1001.C0101_allcombined	4264085	4264120		YPO_RS20070	35
RK1001.C0101_allcombined	4264226	4264258		YPO_RS20070	32
RK1001.C0101_allcombined	4264342	4264345		YPO_RS20070	3
RK1001.C0101_allcombined	4264740	4264742		YPO_RS20070	2
RK1001.C0101_allcombined	4264831	4264850		YPO_RS20070	19
RK1001.C0101_allcombined	4264998	4265009		YPO_RS20070	11
RK1001.C0101_allcombined	4265170	4265198		YPO_RS20070	28
RK1001.C0101_allcombined	4265466	4265469		YPO_RS20070	3
RK1001.C0101_allcombined	4265711	4265713		YPO_RS20070	2
RK1001.C0101_allcombined	4266099	4266101		YPO_RS20070	2
RK1001.C0101_allcombined	4266200	4266229		YPO_RS20070	29
RK1001.C0101_allcombined	4266610	4266645		YPO_RS20075	35
RK1001.C0101_allcombined	4266760	4266761		YPO_RS20075	1
RK1001.C0101_allcombined	4267184	4267189		YPO_RS20080	5
RK1001.C0101_allcombined	4267548	4267551		YPO_RS20080	3
RK1001.C0101_allcombined	4267735	4267741		YPO_RS20080	6
RK1001.C0101_allcombined	4267969	4267971		YPO_RS20085	2
RK1001.C0101_allcombined	4268143	4268165		YPO_RS20085	22
RK1001.C0101_allcombined	4268197	4268201		YPO_RS20085	4
RK1001.C0101_allcombined	4268298	4268321		YPO_RS20085	23
RK1001.C0101_allcombined	4268434	4268488		YPO_RS20090	54
RK1001.C0101_allcombined	4268566	4268591		YPO_RS20090	25
RK1001.C0101_allcombined	4268709	4268713		YPO_RS20090	4
RK1001.C0101_allcombined	4268750	4268776		YPO_RS20090	26
RK1001.C0101_allcombined	4268940	4268945		YPO_RS20090	5
RK1001.C0101_allcombined	4269296	4269317		YPO_RS20090	21
RK1001.C0101_allcombined	4269400	4269414		YPO_RS20090	14
RK1001.C0101_allcombined	4269655	4269701		YPO_RS20095	46
RK1001.C0101_allcombined	4269962	4269978		YPO_RS20095	16
RK1001.C0101_allcombined	4270010	4270046		YPO_RS20095	36
RK1001.C0101_allcombined	4270906	4270910		livF	4
RK1001.C0101_allcombined	4271036	4271042		livF	6
RK1001.C0101_allcombined	4271096	4271117		YPO_RS20105	21
RK1001.C0101_allcombined	4271235	4271242		YPO_RS20105	7
RK1001.C0101_allcombined	4272073	4272081		YPO_RS20110	8
RK1001.C0101_allcombined	4272395	4272399		YPO_RS20110	4
RK1001.C0101_allcombined	4272900	4272929		YPO_RS20110	29
RK1001.C0101_allcombined	4273028	4273040		YPO_RS20110	12
RK1001.C0101_allcombined	4274249	4274276		YPO_RS20120	27
RK1001.C0101_allcombined	4275060	4275074		YPO_RS20120	14
RK1001.C0101_allcombined	4275803	4275814		panM	11
RK1001.C0101_allcombined	4275971	4275975		panM	4
RK1001.C0101_allcombined	4276437	4276447		YPO_RS20130	10
RK1001.C0101_allcombined	4277615	4277617		rpoH	2
RK1001.C0101_allcombined	4278336	4278346		ftsX	10
RK1001.C0101_allcombined	4278394	4278396		ftsX	2
RK1001.C0101_allcombined	4279045	4279051		ftsX	6
RK1001.C0101_allcombined	4279234	4279237		ftsE	3
RK1001.C0101_allcombined	4279944	4279973		ftsY	29
RK1001.C0101_allcombined	4281498	4281501		ftsY	3
RK1001.C0101_allcombined	4281794	4281799		rsmD	5
RK1001.C0101_allcombined	4282096	4282108		rsmD	12
RK1001.C0101_allcombined	4283175	4283183		YPO_RS20165	8
RK1001.C0101_allcombined	4283244	4283249		YPO_RS20165	5
RK1001.C0101_allcombined	4284303	4284309		YPO_RS20175	6
RK1001.C0101_allcombined	4284383	4284394		YPO_RS20175	11
RK1001.C0101_allcombined	4285319	4285352		YPO_RS20180	33
RK1001.C0101_allcombined	4285403	4285422		YPO_RS20180	19
RK1001.C0101_allcombined	4285689	4285694		YPO_RS20180	5
RK1001.C0101_allcombined	4285755	4285762		YPO_RS20180	7
RK1001.C0101_allcombined	4286020	4286037		YPO_RS20180	17
RK1001.C0101_allcombined	4286099	4286116		YPO_RS20180	17
RK1001.C0101_allcombined	4286341	4286358		YPO_RS20180	17
RK1001.C0101_allcombined	4286707	4286714		YPO_RS20180	7
RK1001.C0101_allcombined	4287625	4287682		tusA	57
RK1001.C0101_allcombined	4288435	4288460		YPO_RS20190	25
RK1001.C0101_allcombined	4288961	4288967		dcrB	6
RK1001.C0101_allcombined	4289877	4289884		glpC	7
RK1001.C0101_allcombined	4290024	4290034		glpC	10
RK1001.C0101_allcombined	4291209	4291237		glpB	28
RK1001.C0101_allcombined	4291278	4291282		glpB	4
RK1001.C0101_allcombined	4291713	4291718		glpB	5
RK1001.C0101_allcombined	4293005	4293018		glpA	13
RK1001.C0101_allcombined	4293200	4293209		glpA	9
RK1001.C0101_allcombined	4294702	4294732		glpQ	30
RK1001.C0101_allcombined	4294884	4294889		glpQ	5
RK1001.C0101_allcombined	4295099	4295229		glpQ	130
RK1001.C0101_allcombined	4295358	4295370		glpQ	12
RK1001.C0101_allcombined	4295521	4295534		glpQ	13
RK1001.C0101_allcombined	4297143	4297189		yigL	46
RK1001.C0101_allcombined	4297883	4297898		yigL	15
RK1001.C0101_allcombined	4298614	4298634		pldB	20
RK1001.C0101_allcombined	4299419	4299429		rhtB	10
RK1001.C0101_allcombined	4299516	4299523		rhtB	7
RK1001.C0101_allcombined	4300071	4300083		rhtC	12
RK1001.C0101_allcombined	4301982	4302001		recQ	19
RK1001.C0101_allcombined	4302086	4302097		recQ	11
RK1001.C0101_allcombined	4302393	4302401		recQ	8
RK1001.C0101_allcombined	4302567	4302595		pldA	28
RK1001.C0101_allcombined	4303054	4303063		pldA	9
RK1001.C0101_allcombined	4303170	4303206		pldA	36
RK1001.C0101_allcombined	4303604	4303610		YPO_RS20260	6
RK1001.C0101_allcombined	4303856	4303873		YPO_RS20260	17
RK1001.C0101_allcombined	4304224	4304235		rarD	11
RK1001.C0101_allcombined	4305149	4305173		corA	24
RK1001.C0101_allcombined	4305604	4305619		corA	15
RK1001.C0101_allcombined	4305849	4305862		corA	13
RK1001.C0101_allcombined	4307007	4307011		YPO_RS20275	4
RK1001.C0101_allcombined	4307577	4307578		YPO_RS20275	1
RK1001.C0101_allcombined	4307800	4307802		YPO_RS20280	2
RK1001.C0101_allcombined	4307935	4307937		YPO_RS20280	2
RK1001.C0101_allcombined	4308000	4308020		YPO_RS20280	20
RK1001.C0101_allcombined	4308693	4308739		YPO_RS20280	46
RK1001.C0101_allcombined	4309351	4309354		YPO_RS20285	3
RK1001.C0101_allcombined	4310501	4310511		uvrD	10
RK1001.C0101_allcombined	4310942	4310947		uvrD	5
RK1001.C0101_allcombined	4311076	4311078		uvrD	2
RK1001.C0101_allcombined	4311540	4311560		uvrD	20
RK1001.C0101_allcombined	4313383	4313406		xerC	23
RK1001.C0101_allcombined	4313567	4313575		xerC	8
RK1001.C0101_allcombined	4314749	4314770		dapF	21
RK1001.C0101_allcombined	4314866	4314869		dapF	3
RK1001.C0101_allcombined	4315880	4315902		YPO_RS20315	22
RK1001.C0101_allcombined	4316054	4316055		cyaY	1
RK1001.C0101_allcombined	4318777	4318792		YPO_RS20325	15
RK1001.C0101_allcombined	4319341	4319350		YPO_RS20330	9
RK1001.C0101_allcombined	4319796	4319799		hemC	3
RK1001.C0101_allcombined	4320630	4320635		hemD	5
RK1001.C0101_allcombined	4320824	4320842		hemD	18
RK1001.C0101_allcombined	4320947	4320949		hemD	2
RK1001.C0101_allcombined	4321086	4321093		hemD	7
RK1001.C0101_allcombined	4321514	4321524		hemX	10
RK1001.C0101_allcombined	4322551	4322567		hemY	16
RK1001.C0101_allcombined	4322619	4322628		hemY	9
RK1001.C0101_allcombined	4322659	4322660		hemY	1
RK1001.C0101_allcombined	4322979	4323010		hemY	31
RK1001.C0101_allcombined	4323339	4323345		hemY	6
RK1001.C0101_allcombined	4323500	4323507		hemY	7
RK1001.C0101_allcombined	4323728	4323729		hemY	1
RK1001.C0101_allcombined	4323933	4323936		YPO_RS20355	3
RK1001.C0101_allcombined	4325267	4325269		YPO_RS20360	2
RK1001.C0101_allcombined	4326004	4326018		YPO_RS20380	14
RK1001.C0101_allcombined	4326250	4326274		YPO_RS20380	24
RK1001.C0101_allcombined	4326466	4326481		YPO_RS20380	15
RK1001.C0101_allcombined	4327013	4327028		YPO_RS20380	15
RK1001.C0101_allcombined	4327968	4327975		rffM	7
RK1001.C0101_allcombined	4328309	4328313		rffM	4
RK1001.C0101_allcombined	4328881	4328888		wzyE	7
RK1001.C0101_allcombined	4329847	4329882		wzyE	35
RK1001.C0101_allcombined	4330031	4330040		YPO_RS20395	9
RK1001.C0101_allcombined	4330231	4330240		YPO_RS20395	9
RK1001.C0101_allcombined	4330682	4330687		YPO_RS20395	5
RK1001.C0101_allcombined	4330968	4330996		YPO_RS20395	28
RK1001.C0101_allcombined	4331019	4331024		wzxE	5
RK1001.C0101_allcombined	4331129	4331149		wzxE	20
RK1001.C0101_allcombined	4331671	4331677		wzxE	6
RK1001.C0101_allcombined	4331781	4331820		wzxE	39
RK1001.C0101_allcombined	4332121	4332137		wzxE	16
RK1001.C0101_allcombined	4332168	4332171		wzxE	3
RK1001.C0101_allcombined	4332344	4332384		rffA	40
RK1001.C0101_allcombined	4333430	4333443		rffC	13
RK1001.C0101_allcombined	4333688	4333692		rffC	4
RK1001.C0101_allcombined	4333861	4333908		rffC	47
RK1001.C0101_allcombined	4333990	4333995		rffC	5
RK1001.C0101_allcombined	4334450	4334458		rfbA	8
RK1001.C0101_allcombined	4334885	4334911		rfbA	26
RK1001.C0101_allcombined	4336055	4336058		rffG	3
RK1001.C0101_allcombined	4336481	4336483		wecC	2
RK1001.C0101_allcombined	4337253	4337258		wecC	5
RK1001.C0101_allcombined	4337631	4337651		wecB	20
RK1001.C0101_allcombined	4337683	4337685		wecB	2
RK1001.C0101_allcombined	4338209	4338214		wecB	5
RK1001.C0101_allcombined	4339034	4339036		wzzE	2
RK1001.C0101_allcombined	4339652	4339659		wzzE	7
RK1001.C0101_allcombined	4339869	4339881		wzzE	12
RK1001.C0101_allcombined	4340411	4340419		wecA	8
RK1001.C0101_allcombined	4340499	4340514		wecA	15
RK1001.C0101_allcombined	4340596	4340601		wecA	5
RK1001.C0101_allcombined	4340633	4340636		wecA	3
RK1001.C0101_allcombined	4340977	4340984		wecA	7
RK1001.C0101_allcombined	4341049	4341100		wecA	51
RK1001.C0101_allcombined	4341134	4341136		wecA	2
RK1001.C0101_allcombined	4341198	4341213		wecA	15
RK1001.C0101_allcombined	4341787	4341789		rho	2
RK1001.C0101_allcombined	4342176	4342185		rho	9
RK1001.C0101_allcombined	4342328	4342330		rho	2
RK1001.C0101_allcombined	4342982	4342988		rho	6
RK1001.C0101_allcombined	4343660	4343671		trxA	11
RK1001.C0101_allcombined	4344425	4344437		rhlB	12
RK1001.C0101_allcombined	4344634	4344658		rhlB	24
RK1001.C0101_allcombined	4344689	4344694		rhlB	5
RK1001.C0101_allcombined	4344768	4344770		rhlB	2
RK1001.C0101_allcombined	4344805	4344806		rhlB	1
RK1001.C0101_allcombined	4344925	4344930		rhlB	5
RK1001.C0101_allcombined	4345074	4345078		rhlB	4
RK1001.C0101_allcombined	4347157	4347174		rep	17
RK1001.C0101_allcombined	4347207	4347221		rep	14
RK1001.C0101_allcombined	4348256	4348280		rep	24
RK1001.C0101_allcombined	4348991	4349052		YPO_RS20470	61
RK1001.C0101_allcombined	4349367	4349380		YPO_RS20475	13
RK1001.C0101_allcombined	4349644	4349704		YPO_RS20480	60
RK1001.C0101_allcombined	4349739	4349744		YPO_RS20480	5
RK1001.C0101_allcombined	4349833	4349865		YPO_RS20480	32
RK1001.C0101_allcombined	4349908	4349949		YPO_RS20480	41
RK1001.C0101_allcombined	4349979	4349999		YPO_RS20480	20
RK1001.C0101_allcombined	4350043	4350052		YPO_RS20480	9
RK1001.C0101_allcombined	4350213	4350246		YPO_RS20480	33
RK1001.C0101_allcombined	4350342	4350365		YPO_RS20480	23
RK1001.C0101_allcombined	4352550	4352558		YPO_RS20490	8
RK1001.C0101_allcombined	4352626	4352632		YPO_RS20490	6
RK1001.C0101_allcombined	4352709	4352715		YPO_RS20490	6
RK1001.C0101_allcombined	4352791	4352827		YPO_RS20490	36
RK1001.C0101_allcombined	4353011	4353026		YPO_RS20490	15
RK1001.C0101_allcombined	4353060	4353080		YPO_RS20490	20
RK1001.C0101_allcombined	4353172	4353193		YPO_RS20495	21
RK1001.C0101_allcombined	4353383	4353390		YPO_RS20495	7
RK1001.C0101_allcombined	4353479	4353488		YPO_RS20495	9
RK1001.C0101_allcombined	4353602	4353609		YPO_RS20495	7
RK1001.C0101_allcombined	4353734	4353789		YPO_RS20495	55
RK1001.C0101_allcombined	4353872	4353875		YPO_RS20495	3
RK1001.C0101_allcombined	4353964	4354007		YPO_RS20500	43
RK1001.C0101_allcombined	4354047	4354182		YPO_RS20500	135
RK1001.C0101_allcombined	4354285	4354291		YPO_RS20500	6
RK1001.C0101_allcombined	4354360	4354365		YPO_RS20500	5
RK1001.C0101_allcombined	4355209	4355224		YPO_RS20500	15
RK1001.C0101_allcombined	4355426	4355442		YPO_RS20500	16
RK1001.C0101_allcombined	4355561	4355562		YPO_RS20500	1
RK1001.C0101_allcombined	4356063	4356073		YPO_RS20500	10
RK1001.C0101_allcombined	4356323	4356337		YPO_RS20500	14
RK1001.C0101_allcombined	4357174	4357198		stbD	24
RK1001.C0101_allcombined	4357340	4357354		stbD	14
RK1001.C0101_allcombined	4357540	4357541		stbD	1
RK1001.C0101_allcombined	4358208	4358216		YPO_RS20510	8
RK1001.C0101_allcombined	4358247	4358292		YPO_RS20510	45
RK1001.C0101_allcombined	4359333	4359344		YPO_RS20515	11
RK1001.C0101_allcombined	4359433	4359448		YPO_RS20515	15
RK1001.C0101_allcombined	4359487	4359509		YPO_RS20515	22
RK1001.C0101_allcombined	4359568	4359578		YPO_RS20515	10
RK1001.C0101_allcombined	4359689	4359715		YPO_RS20520	26
RK1001.C0101_allcombined	4360366	4360413		YPO_RS20530	47
RK1001.C0101_allcombined	4360600	4360701		YPO_RS20530	101
RK1001.C0101_allcombined	4360763	4360827		YPO_RS20530	64
RK1001.C0101_allcombined	4362593	4362596		ilvC	3
RK1001.C0101_allcombined	4363181	4363207		ilvC	26
RK1001.C0101_allcombined	4364316	4364325		ilvY	9
RK1001.C0101_allcombined	4364585	4364596		ilvY	11
RK1001.C0101_allcombined	4365016	4365023		ilvY	7
RK1001.C0101_allcombined	4365231	4365248		YPO_RS20550	17
RK1001.C0101_allcombined	4365281	4365287		YPO_RS20550	6
RK1001.C0101_allcombined	4366079	4366090		YPO_RS20555	11
RK1001.C0101_allcombined	4366190	4366206		YPO_RS20560	16
RK1001.C0101_allcombined	4366301	4366320		YPO_RS20560	19
RK1001.C0101_allcombined	4366393	4366418		YPO_RS20560	25
RK1001.C0101_allcombined	4366492	4366597		YPO_RS20560	105
RK1001.C0101_allcombined	4366677	4366753		YPO_RS20560	76
RK1001.C0101_allcombined	4366855	4366858		YPO_RS20565	3
RK1001.C0101_allcombined	4367019	4367104		YPO_RS20565	85
RK1001.C0101_allcombined	4367178	4367215		YPO_RS20565	37
RK1001.C0101_allcombined	4367250	4367266		YPO_RS20565	16
RK1001.C0101_allcombined	4367542	4367631		YPO_RS20570	89
RK1001.C0101_allcombined	4367746	4367791		YPO_RS20570	45
RK1001.C0101_allcombined	4367998	4368076		YPO_RS20575	78
RK1001.C0101_allcombined	4368236	4368253		YPO_RS20575	17
RK1001.C0101_allcombined	4368285	4368305		YPO_RS20575	20
RK1001.C0101_allcombined	4369966	4369981		ilvA	15
RK1001.C0101_allcombined	4370072	4370088		ilvD	16
RK1001.C0101_allcombined	4370160	4370168		ilvD	8
RK1001.C0101_allcombined	4370487	4370492		ilvD	5
RK1001.C0101_allcombined	4370649	4370651		ilvD	2
RK1001.C0101_allcombined	4370695	4370712		ilvD	17
RK1001.C0101_allcombined	4372362	4372369		YPO_RS20590	7
RK1001.C0101_allcombined	4372592	4372597		YPO_RS20590	5
RK1001.C0101_allcombined	4373178	4373216		ilvM	38
RK1001.C0101_allcombined	4374241	4374250		YPO_RS20600	9
RK1001.C0101_allcombined	4374336	4374338		YPO_RS20600	2
RK1001.C0101_allcombined	4375278	4375285		ilvL	7
RK1001.C0101_allcombined	4376092	4376098		YPO_RS20610	6
RK1001.C0101_allcombined	4377075	4377080		YPO_RS20610	5
RK1001.C0101_allcombined	4377519	4377521		YPO_RS20615	2
RK1001.C0101_allcombined	4378181	4378228		hdfR	47
RK1001.C0101_allcombined	4378442	4378447		hdfR	5
RK1001.C0101_allcombined	4378518	4378529		hdfR	11
RK1001.C0101_allcombined	4378603	4378604		hdfR	1
RK1001.C0101_allcombined	4378898	4378901		yjfF	3
RK1001.C0101_allcombined	4378951	4378958		yjfF	7
RK1001.C0101_allcombined	4379410	4379420		yjfF	10
RK1001.C0101_allcombined	4379549	4379556		yjfF	7
RK1001.C0101_allcombined	4379766	4379773		yjfF	7
RK1001.C0101_allcombined	4379933	4379966		YPO_RS20630	33
RK1001.C0101_allcombined	4380268	4380303		YPO_RS20630	35
RK1001.C0101_allcombined	4380826	4380846		YPO_RS20635	20
RK1001.C0101_allcombined	4380944	4380980		YPO_RS20635	36
RK1001.C0101_allcombined	4381042	4381046		YPO_RS20635	4
RK1001.C0101_allcombined	4381505	4381520		YPO_RS20635	15
RK1001.C0101_allcombined	4381737	4381789		YPO_RS20635	52
RK1001.C0101_allcombined	4382292	4382316		YPO_RS20635	24
RK1001.C0101_allcombined	4382417	4382429		YPO_RS20640	12
RK1001.C0101_allcombined	4382600	4382674		YPO_RS20640	74
RK1001.C0101_allcombined	4383026	4383032		YPO_RS20640	6
RK1001.C0101_allcombined	4384407	4384411		YPO_RS20645	4
RK1001.C0101_allcombined	4389159	4389162		YPO_RS20670	3
RK1001.C0101_allcombined	4389882	4389890		YPO_RS20675	8
RK1001.C0101_allcombined	4390254	4390268		murI	14
RK1001.C0101_allcombined	4390421	4390433		murI	12
RK1001.C0101_allcombined	4390464	4390476		murI	12
RK1001.C0101_allcombined	4391603	4391610		btuB	7
RK1001.C0101_allcombined	4391943	4391961		btuB	18
RK1001.C0101_allcombined	4392131	4392132		btuB	1
RK1001.C0101_allcombined	4392819	4392820		btuB	1
RK1001.C0101_allcombined	4392898	4392901		btuB	3
RK1001.C0101_allcombined	4393862	4393868		trmA	6
RK1001.C0101_allcombined	4393953	4393954		trmA	1
RK1001.C0101_allcombined	4394028	4394033		trmA	5
RK1001.C0101_allcombined	4394200	4394202		trmA	2
RK1001.C0101_allcombined	4394301	4394342		trmA	41
RK1001.C0101_allcombined	4394432	4394463		trmA	31
RK1001.C0101_allcombined	4394632	4394650		YPO_RS20695	18
RK1001.C0101_allcombined	4394887	4394931		YPO_RS20695	44
RK1001.C0101_allcombined	4394987	4394991		YPO_RS20695	4
RK1001.C0101_allcombined	4396156	4396161		sthA	5
RK1001.C0101_allcombined	4396264	4396290		sthA	26
RK1001.C0101_allcombined	4397136	4397137		sthA	1
RK1001.C0101_allcombined	4397750	4397757		oxyR	7
RK1001.C0101_allcombined	4398021	4398030		oxyR	9
RK1001.C0101_allcombined	4398338	4398375		YPO_RS20715	37
RK1001.C0101_allcombined	4398421	4398451		YPO_RS20715	30
RK1001.C0101_allcombined	4398547	4398551		YPO_RS20715	4
RK1001.C0101_allcombined	4398644	4398660		YPO_RS20715	16
RK1001.C0101_allcombined	4399058	4399069		YPO_RS20715	11
RK1001.C0101_allcombined	4399259	4399293		YPO_RS20720	34
RK1001.C0101_allcombined	4399529	4399530		YPO_RS20720	1
RK1001.C0101_allcombined	4399655	4399675		YPO_RS20720	20
RK1001.C0101_allcombined	4399908	4399914		YPO_RS20720	6
RK1001.C0101_allcombined	4400253	4400256		YPO_RS20720	3
RK1001.C0101_allcombined	4400862	4400893		YPO_RS20725	31
RK1001.C0101_allcombined	4401443	4401454		YPO_RS20725	11
RK1001.C0101_allcombined	4401518	4401533		YPO_RS20725	15
RK1001.C0101_allcombined	4401771	4401793		YPO_RS20730	22
RK1001.C0101_allcombined	4401985	4402000		YPO_RS20730	15
RK1001.C0101_allcombined	4402280	4402315		YPO_RS20730	35
RK1001.C0101_allcombined	4403079	4403080		YPO_RS20735	1
RK1001.C0101_allcombined	4403224	4403243		YPO_RS20735	19
RK1001.C0101_allcombined	4403397	4403405		YPO_RS20735	8
RK1001.C0101_allcombined	4403822	4403832		YPO_RS20735	10
RK1001.C0101_allcombined	4405063	4405065		YPO_RS20740	2
RK1001.C0101_allcombined	4405097	4405117		YPO_RS20740	20
RK1001.C0101_allcombined	4405282	4405297		YPO_RS20740	15
RK1001.C0101_allcombined	4405446	4405455		YPO_RS20740	9
RK1001.C0101_allcombined	4405579	4405606		YPO_RS20740	27
RK1001.C0101_allcombined	4405828	4405851		YPO_RS20745	23
RK1001.C0101_allcombined	4405911	4405959		YPO_RS20745	48
RK1001.C0101_allcombined	4406070	4406110		YPO_RS20745	40
RK1001.C0101_allcombined	4406312	4406377		YPO_RS20745	65
RK1001.C0101_allcombined	4406423	4406484		YPO_RS20745	61
RK1001.C0101_allcombined	4406577	4406579		YPO_RS20745	2
RK1001.C0101_allcombined	4406848	4406850		YPO_RS20745	2
RK1001.C0101_allcombined	4407246	4407249		YPO_RS20745	3
RK1001.C0101_allcombined	4407924	4407939		YPO_RS20745	15
RK1001.C0101_allcombined	4408288	4408312		YPO_RS20745	24
RK1001.C0101_allcombined	4409456	4409468		argH	12
RK1001.C0101_allcombined	4409962	4409965		argH	3
RK1001.C0101_allcombined	4410472	4410490		argB	18
RK1001.C0101_allcombined	4410779	4410786		argB	7
RK1001.C0101_allcombined	4411595	4411610		argC	15
RK1001.C0101_allcombined	4411833	4411840		argC	7
RK1001.C0101_allcombined	4412912	4412924		argE	12
RK1001.C0101_allcombined	4413369	4413396		argE	27
RK1001.C0101_allcombined	4413665	4413679		argE	14
RK1001.C0101_allcombined	4414722	4414724		ppc	2
RK1001.C0101_allcombined	4415754	4415757		ppc	3
RK1001.C0101_allcombined	4416364	4416373		ppc	9
RK1001.C0101_allcombined	4418507	4418519		YPO_RS20775	12
RK1001.C0101_allcombined	4418890	4418900		YPO_RS20775	10
RK1001.C0101_allcombined	4419472	4419482		YPO_RS20780	10
RK1001.C0101_allcombined	4419534	4419549		YPO_RS20780	15
RK1001.C0101_allcombined	4419840	4419858		YPO_RS20785	18
RK1001.C0101_allcombined	4419951	4419965		YPO_RS20785	14
RK1001.C0101_allcombined	4419998	4420038		YPO_RS20785	40
RK1001.C0101_allcombined	4421306	4421308		glpD	2
RK1001.C0101_allcombined	4421450	4421455		glpD	5
RK1001.C0101_allcombined	4421873	4421891		glpD	18
RK1001.C0101_allcombined	4421942	4421960		glpD	18
RK1001.C0101_allcombined	4422650	4422664		glpD	14
RK1001.C0101_allcombined	4422892	4422935		glgP	43
RK1001.C0101_allcombined	4423420	4423434		glgP	14
RK1001.C0101_allcombined	4424055	4424066		glgP	11
RK1001.C0101_allcombined	4424248	4424250		glgP	2
RK1001.C0101_allcombined	4424464	4424482		glgP	18
RK1001.C0101_allcombined	4424600	4424615		glgP	15
RK1001.C0101_allcombined	4425026	4425040		glgP	14
RK1001.C0101_allcombined	4425466	4425467		glgA	1
RK1001.C0101_allcombined	4425913	4425948		glgA	35
RK1001.C0101_allcombined	4426192	4426193		glgA	1
RK1001.C0101_allcombined	4426859	4426877		glgA	18
RK1001.C0101_allcombined	4428518	4428520		glgX	2
RK1001.C0101_allcombined	4429090	4429100		glgX	10
RK1001.C0101_allcombined	4429340	4429350		glgX	10
RK1001.C0101_allcombined	4429438	4429440		glgX	2
RK1001.C0101_allcombined	4429728	4429731		glgX	3
RK1001.C0101_allcombined	4429806	4429807		glgX	1
RK1001.C0101_allcombined	4430355	4430364		glgX	9
RK1001.C0101_allcombined	4430555	4430575		glgB	20
RK1001.C0101_allcombined	4431453	4431457		glgB	4
RK1001.C0101_allcombined	4431495	4431499		glgB	4
RK1001.C0101_allcombined	4432198	4432212		glgB	14
RK1001.C0101_allcombined	4432364	4432365		glgB	1
RK1001.C0101_allcombined	4433118	4433128		YPO_RS20825	10
RK1001.C0101_allcombined	4433250	4433258		YPO_RS20825	8
RK1001.C0101_allcombined	4433321	4433324		YPO_RS20825	3
RK1001.C0101_allcombined	4433517	4433546		YPO_RS20825	29
RK1001.C0101_allcombined	4433629	4433643		YPO_RS20825	14
RK1001.C0101_allcombined	4433799	4433806		YPO_RS20825	7
RK1001.C0101_allcombined	4433881	4433918		YPO_RS20825	37
RK1001.C0101_allcombined	4434261	4434264		YPO_RS20825	3
RK1001.C0101_allcombined	4434352	4434370		YPO_RS20825	18
RK1001.C0101_allcombined	4434514	4434515		YPO_RS20825	1
RK1001.C0101_allcombined	4434726	4434766		YPO_RS20825	40
RK1001.C0101_allcombined	4435135	4435137		YPO_RS20830	2
RK1001.C0101_allcombined	4435226	4435235		YPO_RS20830	9
RK1001.C0101_allcombined	4435280	4435283		YPO_RS20830	3
RK1001.C0101_allcombined	4435659	4435710		YPO_RS20830	51
RK1001.C0101_allcombined	4435791	4435861		YPO_RS20830	70
RK1001.C0101_allcombined	4435970	4436010		YPO_RS20830	40
RK1001.C0101_allcombined	4436114	4436125		YPO_RS20830	11
RK1001.C0101_allcombined	4436274	4436276		YPO_RS20830	2
RK1001.C0101_allcombined	4436348	4436363		YPO_RS20830	15
RK1001.C0101_allcombined	4436414	4436430		YPO_RS20830	16
RK1001.C0101_allcombined	4436951	4436953		YPO_RS20830	2
RK1001.C0101_allcombined	4437178	4437197		YPO_RS20830	19
RK1001.C0101_allcombined	4437295	4437305		YPO_RS20830	10
RK1001.C0101_allcombined	4437537	4437545		YPO_RS20830	8
RK1001.C0101_allcombined	4437751	4437793		YPO_RS20830	42
RK1001.C0101_allcombined	4437823	4437844		YPO_RS20830	21
RK1001.C0101_allcombined	4437952	4437965		YPO_RS20830	13
RK1001.C0101_allcombined	4438363	4438367		YPO_RS20830	4
RK1001.C0101_allcombined	4438667	4438668		YPO_RS20830	1
RK1001.C0101_allcombined	4438790	4438806		YPO_RS20830	16
RK1001.C0101_allcombined	4439332	4439341		YPO_RS20830	9
RK1001.C0101_allcombined	4440133	4440153		YPO_RS20830	20
RK1001.C0101_allcombined	4441189	4441196		YPO_RS20830	7
RK1001.C0101_allcombined	4441853	4441868		YPO_RS20830	15
RK1001.C0101_allcombined	4442026	4442034		YPO_RS20830	8
RK1001.C0101_allcombined	4442387	4442415		YPO_RS20830	28
RK1001.C0101_allcombined	4442490	4442499		YPO_RS20830	9
RK1001.C0101_allcombined	4442582	4442590		YPO_RS20830	8
RK1001.C0101_allcombined	4442673	4442723		YPO_RS20830	50
RK1001.C0101_allcombined	4442893	4442933		YPO_RS20830	40
RK1001.C0101_allcombined	4442993	4443008		YPO_RS20830	15
RK1001.C0101_allcombined	4443166	4443180		YPO_RS20830	14
RK1001.C0101_allcombined	4443345	4443346		YPO_RS20830	1
RK1001.C0101_allcombined	4443628	4443632		YPO_RS20830	4
RK1001.C0101_allcombined	4443694	4443712		YPO_RS20830	18
RK1001.C0101_allcombined	4444001	4444009		YPO_RS20830	8
RK1001.C0101_allcombined	4445797	4445841		YPO_RS20840	44
RK1001.C0101_allcombined	4445943	4445998		YPO_RS20840	55
RK1001.C0101_allcombined	4446329	4446335		YPO_RS20845	6
RK1001.C0101_allcombined	4446668	4446678		YPO_RS20855	10
RK1001.C0101_allcombined	4446730	4446732		YPO_RS20855	2
RK1001.C0101_allcombined	4446784	4446829		YPO_RS20855	45
RK1001.C0101_allcombined	4446944	4446949		YPO_RS20855	5
RK1001.C0101_allcombined	4447400	4447404		asd	4
RK1001.C0101_allcombined	4448000	4448031		asd	31
RK1001.C0101_allcombined	4449412	4449414		YPO_RS20870	2
RK1001.C0101_allcombined	4449480	4449509		YPO_RS20870	29
RK1001.C0101_allcombined	4450245	4450258		YPO_RS20875	13
RK1001.C0101_allcombined	4451378	4451379		gntT	1
RK1001.C0101_allcombined	4451712	4451720		gntT	8
RK1001.C0101_allcombined	4451938	4451980		gntT	42
RK1001.C0101_allcombined	4452491	4452499		gntT	8
RK1001.C0101_allcombined	4452730	4452736		gntR	6
RK1001.C0101_allcombined	4453568	4453569		gntR	1
RK1001.C0101_allcombined	4453699	4453714		gntR	15
RK1001.C0101_allcombined	4454372	4454394		YPO_RS20895	22
RK1001.C0101_allcombined	4454678	4454687		YPO_RS20900	9
RK1001.C0101_allcombined	4456690	4456716		YPO_RS20910	26
RK1001.C0101_allcombined	4456762	4456772		YPO_RS20910	10
RK1001.C0101_allcombined	4456828	4456829		YPO_RS20910	1
RK1001.C0101_allcombined	4458964	4458972		YPO_RS20925	8
RK1001.C0101_allcombined	4459871	4459910		YPO_RS20930	39
RK1001.C0101_allcombined	4460166	4460170		YPO_RS20930	4
RK1001.C0101_allcombined	4460411	4460421		YPO_RS20930	10
RK1001.C0101_allcombined	4460625	4460629		YPO_RS20930	4
RK1001.C0101_allcombined	4461282	4461291		YPO_RS20935	9
RK1001.C0101_allcombined	4461776	4461779		YPO_RS20935	3
RK1001.C0101_allcombined	4463380	4463388		YPO_RS20940	8
RK1001.C0101_allcombined	4463461	4463475		YPO_RS20940	14
RK1001.C0101_allcombined	4463591	4463600		YPO_RS20940	9
RK1001.C0101_allcombined	4464782	4464796		YPO_RS20940	14
RK1001.C0101_allcombined	4464998	4465003		YPO_RS20940	5
RK1001.C0101_allcombined	4465091	4465101		YPO_RS20940	10
RK1001.C0101_allcombined	4465394	4465407		YPO_RS20945	13
RK1001.C0101_allcombined	4465539	4465564		YPO_RS20945	25
RK1001.C0101_allcombined	4465857	4465884		YPO_RS20945	27
RK1001.C0101_allcombined	4466220	4466223		YPO_RS20945	3
RK1001.C0101_allcombined	4467004	4467041		pitA	37
RK1001.C0101_allcombined	4468199	4468201		pitA	2
RK1001.C0101_allcombined	4468601	4468613		YPO_RS20955	12
RK1001.C0101_allcombined	4469151	4469159		uspB	8
RK1001.C0101_allcombined	4469238	4469274		uspB	36
RK1001.C0101_allcombined	4469309	4469312		uspB	3
RK1001.C0101_allcombined	4469361	4469366		uspB	5
RK1001.C0101_allcombined	4471146	4471153		gdhA	7
RK1001.C0101_allcombined	4472069	4472071		gdhA	2
RK1001.C0101_allcombined	4472531	4472545		YPO_RS20975	14
RK1001.C0101_allcombined	4472583	4472679		YPO_RS20975	96
RK1001.C0101_allcombined	4472970	4473003		YPO_RS20975	33
RK1001.C0101_allcombined	4473081	4473097		YPO_RS20975	16
RK1001.C0101_allcombined	4473430	4473458		YPO_RS20975	28
RK1001.C0101_allcombined	4473779	4473780		YPO_RS20975	1
RK1001.C0101_allcombined	4472828	4472866		YPO_RS20975	38
RK1001.C0101_allcombined	4474084	4474099		rsmJ	15
RK1001.C0101_allcombined	4474567	4474615		rsmJ	48
RK1001.C0101_allcombined	4477814	4477832		YPO_RS20990	18
RK1001.C0101_allcombined	4478278	4478305		gorA	27
RK1001.C0101_allcombined	4479135	4479141		gorA	6
RK1001.C0101_allcombined	4480154	4480155		YPO_RS21000	1
RK1001.C0101_allcombined	4480567	4480587		YPO_RS21000	20
RK1001.C0101_allcombined	4480631	4480663		YPO_RS21000	32
RK1001.C0101_allcombined	4480652	4480663		YPO_RS21005	11
RK1001.C0101_allcombined	4481400	4481402		YPO_RS21010	2
RK1001.C0101_allcombined	4481826	4481827		YPO_RS21010	1
RK1001.C0101_allcombined	4481891	4481893		YPO_RS21010	2
RK1001.C0101_allcombined	4481967	4481970		YPO_RS21010	3
RK1001.C0101_allcombined	4482287	4482291		YPO_RS21015	4
RK1001.C0101_allcombined	4483137	4483157		YPO_RS21015	20
RK1001.C0101_allcombined	4483544	4483639		YPO_RS21020	95
RK1001.C0101_allcombined	4483697	4483766		YPO_RS21020	69
RK1001.C0101_allcombined	4483900	4483913		YPO_RS21020	13
RK1001.C0101_allcombined	4483963	4483966		YPO_RS21020	3
RK1001.C0101_allcombined	4484160	4484213		YPO_RS21025	53
RK1001.C0101_allcombined	4484308	4484316		YPO_RS21025	8
RK1001.C0101_allcombined	4484358	4484401		YPO_RS21025	43
RK1001.C0101_allcombined	4484449	4484476		YPO_RS21025	27
RK1001.C0101_allcombined	4484577	4484599		YPO_RS21025	22
RK1001.C0101_allcombined	4484601	4484604		YPO_RS21030	3
RK1001.C0101_allcombined	4484774	4484831		YPO_RS21030	57
RK1001.C0101_allcombined	4484896	4484957		YPO_RS21030	61
RK1001.C0101_allcombined	4485032	4485053		YPO_RS21030	21
RK1001.C0101_allcombined	4485098	4485135		YPO_RS21030	37
RK1001.C0101_allcombined	4485281	4485291		YPO_RS21030	10
RK1001.C0101_allcombined	4485886	4485887		yapE	1
RK1001.C0101_allcombined	4486101	4486105		yapE	4
RK1001.C0101_allcombined	4486242	4486246		yapE	4
RK1001.C0101_allcombined	4486580	4486585		yapE	5
RK1001.C0101_allcombined	4487641	4487648		yapE	7
RK1001.C0101_allcombined	4487790	4487798		yapE	8
RK1001.C0101_allcombined	4487877	4487893		yapE	16
RK1001.C0101_allcombined	4488065	4488067		yapE	2
RK1001.C0101_allcombined	4488664	4488682		yapE	18
RK1001.C0101_allcombined	4489819	4489826		yhjD	7
RK1001.C0101_allcombined	4490456	4490492		yhjD	36
RK1001.C0101_allcombined	4490535	4490538		YPO_RS21045	3
RK1001.C0101_allcombined	4490762	4490817		YPO_RS21045	55
RK1001.C0101_allcombined	4490963	4490985		YPO_RS21045	22
RK1001.C0101_allcombined	4491277	4491306		YPO_RS21045	29
RK1001.C0101_allcombined	4491392	4491397		YPO_RS21050	5
RK1001.C0101_allcombined	4491508	4491549		YPO_RS21050	41
RK1001.C0101_allcombined	4492094	4492110		YPO_RS21050	16
RK1001.C0101_allcombined	4492382	4492383		YPO_RS21050	1
RK1001.C0101_allcombined	4492453	4492467		YPO_RS21050	14
RK1001.C0101_allcombined	4492531	4492544		YPO_RS21050	13
RK1001.C0101_allcombined	4493439	4493442		YPO_RS21050	3
RK1001.C0101_allcombined	4493976	4493980		pdeH	4
RK1001.C0101_allcombined	4494184	4494191		pdeH	7
RK1001.C0101_allcombined	4494294	4494340		pdeH	46
RK1001.C0101_allcombined	4494396	4494400		pdeH	4
RK1001.C0101_allcombined	4494929	4494934		YPO_RS21060	5
RK1001.C0101_allcombined	4496024	4496038		YPO_RS21065	14
RK1001.C0101_allcombined	4496586	4496592		YPO_RS21070	6
RK1001.C0101_allcombined	4497135	4497138		YPO_RS21070	3
RK1001.C0101_allcombined	4497633	4497637		YPO_RS21070	4
RK1001.C0101_allcombined	4497680	4497698		YPO_RS21070	18
RK1001.C0101_allcombined	4497787	4497805		YPO_RS21070	18
RK1001.C0101_allcombined	4497971	4497985		YPO_RS21070	14
RK1001.C0101_allcombined	4498748	4498766		YPO_RS21075	18
RK1001.C0101_allcombined	4499070	4499072		YPO_RS21075	2
RK1001.C0101_allcombined	4499155	4499170		YPO_RS21075	15
RK1001.C0101_allcombined	4499242	4499244		YPO_RS21075	2
RK1001.C0101_allcombined	4500561	4500566		YPO_RS21080	5
RK1001.C0101_allcombined	4501160	4501161		YPO_RS21085	1
RK1001.C0101_allcombined	4501566	4501574		YPO_RS21085	8
RK1001.C0101_allcombined	4501690	4501696		YPO_RS21085	6
RK1001.C0101_allcombined	4501813	4501815		YPO_RS21085	2
RK1001.C0101_allcombined	4502035	4502046		YPO_RS21085	11
RK1001.C0101_allcombined	4502256	4502275		YPO_RS21085	19
RK1001.C0101_allcombined	4502314	4502317		YPO_RS21085	3
RK1001.C0101_allcombined	4502386	4502416		YPO_RS21085	30
RK1001.C0101_allcombined	4502753	4502783		YPO_RS21090	30
RK1001.C0101_allcombined	4502843	4502935		YPO_RS21090	92
RK1001.C0101_allcombined	4503067	4503073		YPO_RS21090	6
RK1001.C0101_allcombined	4503320	4503325		YPO_RS21090	5
RK1001.C0101_allcombined	4504156	4504181		hmsP	25
RK1001.C0101_allcombined	4504709	4504710		hmsP	1
RK1001.C0101_allcombined	4505105	4505113		hmsP	8
RK1001.C0101_allcombined	4505780	4505793		hmsP	13
RK1001.C0101_allcombined	4505947	4505954		hmsP	7
RK1001.C0101_allcombined	4506136	4506137		hmsP	1
RK1001.C0101_allcombined	4506413	4506420		bcsZ	7
RK1001.C0101_allcombined	4507300	4507312		YPO_RS21105	12
RK1001.C0101_allcombined	4507912	4507916		YPO_RS21110	4
RK1001.C0101_allcombined	4508097	4508104		YPO_RS21110	7
RK1001.C0101_allcombined	4508242	4508248		YPO_RS21110	6
RK1001.C0101_allcombined	4508341	4508349		YPO_RS21110	8
RK1001.C0101_allcombined	4508642	4508660		dppD	18
RK1001.C0101_allcombined	4511137	4511142		dppB	5
RK1001.C0101_allcombined	4511443	4511460		dppB	17
RK1001.C0101_allcombined	4511511	4511535		dppB	24
RK1001.C0101_allcombined	4512687	4512704		YPO_RS21130	17
RK1001.C0101_allcombined	4515027	4515045		YPO_RS21135	18
RK1001.C0101_allcombined	4515688	4515691		YPO_RS21135	3
RK1001.C0101_allcombined	4515982	4516133		YPO_RS21140	151
RK1001.C0101_allcombined	4516258	4516319		YPO_RS21140	61
RK1001.C0101_allcombined	4516425	4516437		YPO_RS21140	12
RK1001.C0101_allcombined	4516732	4516771		YPO_RS21140	39
RK1001.C0101_allcombined	4516853	4516864		YPO_RS21140	11
RK1001.C0101_allcombined	4516953	4516962		YPO_RS21140	9
RK1001.C0101_allcombined	4517115	4517118		YPO_RS21140	3
RK1001.C0101_allcombined	4517258	4517266		YPO_RS21140	8
RK1001.C0101_allcombined	4517326	4517352		YPO_RS21140	26
RK1001.C0101_allcombined	4518379	4518401		YPO_RS21150	22
RK1001.C0101_allcombined	4518638	4518666		YPO_RS21150	28
RK1001.C0101_allcombined	4518699	4518701		YPO_RS21150	2
RK1001.C0101_allcombined	4518907	4518909		YPO_RS21150	2
RK1001.C0101_allcombined	4519127	4519181		YPO_RS21150	54
RK1001.C0101_allcombined	4519312	4519358		YPO_RS21155	46
RK1001.C0101_allcombined	4519464	4519491		YPO_RS21155	27
RK1001.C0101_allcombined	4519561	4519571		YPO_RS21155	10
RK1001.C0101_allcombined	4519624	4519625		YPO_RS21155	1
RK1001.C0101_allcombined	4523135	4523190		uhpA	55
RK1001.C0101_allcombined	4523368	4523380		uhpA	12
RK1001.C0101_allcombined	4523811	4523814		eptB	3
RK1001.C0101_allcombined	4524018	4524030		eptB	12
RK1001.C0101_allcombined	4524362	4524375		eptB	13
RK1001.C0101_allcombined	4524419	4524428		eptB	9
RK1001.C0101_allcombined	4525038	4525066		eptB	28
RK1001.C0101_allcombined	4526370	4526384		YPO_RS21185	14
RK1001.C0101_allcombined	4526885	4526899		YPO_RS21185	14
RK1001.C0101_allcombined	4526955	4526969		YPO_RS21185	14
RK1001.C0101_allcombined	4527100	4527136		YPO_RS21185	36
RK1001.C0101_allcombined	4527802	4527812		YPO_RS21190	10
RK1001.C0101_allcombined	4528058	4528075		YPO_RS21190	17
RK1001.C0101_allcombined	4528177	4528189		YPO_RS21190	12
RK1001.C0101_allcombined	4528239	4528252		YPO_RS21190	13
RK1001.C0101_allcombined	4528693	4528707		YPO_RS21190	14
RK1001.C0101_allcombined	4530904	4530925		hutH	21
RK1001.C0101_allcombined	4532244	4532260		hutU	16
RK1001.C0101_allcombined	4532389	4532410		hutU	21
RK1001.C0101_allcombined	4533415	4533432		YPO_RS21205	17
RK1001.C0101_allcombined	4533465	4533518		YPO_RS21205	53
RK1001.C0101_allcombined	4533825	4533832		YPO_RS21205	7
RK1001.C0101_allcombined	4533916	4533920		YPO_RS21205	4
RK1001.C0101_allcombined	4534144	4534178		YPO_RS21205	34
RK1001.C0101_allcombined	4534246	4534269		YPO_RS21205	23
RK1001.C0101_allcombined	4534333	4534359		YPO_RS21205	26
RK1001.C0101_allcombined	4534356	4534366		YPO_RS21210	10
RK1001.C0101_allcombined	4534610	4534676		YPO_RS21210	66
RK1001.C0101_allcombined	4534727	4534736		YPO_RS21210	9
RK1001.C0101_allcombined	4534780	4534787		YPO_RS21210	7
RK1001.C0101_allcombined	4534840	4534920		YPO_RS21210	80
RK1001.C0101_allcombined	4535105	4535112		YPO_RS21215	7
RK1001.C0101_allcombined	4535144	4535154		YPO_RS21215	10
RK1001.C0101_allcombined	4535417	4535429		YPO_RS21215	12
RK1001.C0101_allcombined	4535574	4535661		YPO_RS21215	87
RK1001.C0101_allcombined	4536434	4536437		YPO_RS21220	3
RK1001.C0101_allcombined	4536628	4536659		YPO_RS21220	31
RK1001.C0101_allcombined	4536689	4536693		YPO_RS21220	4
RK1001.C0101_allcombined	4537158	4537167		YPO_RS21220	9
RK1001.C0101_allcombined	4539352	4539372		YPO_RS21230	20
RK1001.C0101_allcombined	4539414	4539421		YPO_RS21230	7
RK1001.C0101_allcombined	4539784	4539788		YPO_RS21235	4
RK1001.C0101_allcombined	4539900	4539945		YPO_RS21235	45
RK1001.C0101_allcombined	4540639	4540655		YPO_RS21240	16
RK1001.C0101_allcombined	4540697	4540699		YPO_RS21240	2
RK1001.C0101_allcombined	4541335	4541346		YPO_RS21240	11
RK1001.C0101_allcombined	4541754	4541772		YPO_RS21245	18
RK1001.C0101_allcombined	4541867	4541874		YPO_RS21245	7
RK1001.C0101_allcombined	4542166	4542195		YPO_RS21250	29
RK1001.C0101_allcombined	4542232	4542253		YPO_RS21250	21
RK1001.C0101_allcombined	4542300	4542308		YPO_RS21255	8
RK1001.C0101_allcombined	4542373	4542408		YPO_RS21255	35
RK1001.C0101_allcombined	4543335	4543379		YPO_RS21265	44
RK1001.C0101_allcombined	4544876	4544921		YPO_RS21275	45
RK1001.C0101_allcombined	4545305	4545318		YPO_RS21280	13
RK1001.C0101_allcombined	4545353	4545376		YPO_RS21280	23
RK1001.C0101_allcombined	4545434	4545540		YPO_RS21280	106
RK1001.C0101_allcombined	4545659	4545811		YPO_RS21280	152
RK1001.C0101_allcombined	4545875	4545914		YPO_RS21280	39
RK1001.C0101_allcombined	4546015	4546034		YPO_RS21280	19
RK1001.C0101_allcombined	4546157	4546172		YPO_RS21280	15
RK1001.C0101_allcombined	4546303	4546312		YPO_RS21280	9
RK1001.C0101_allcombined	4546389	4546414		YPO_RS21280	25
RK1001.C0101_allcombined	4546566	4546576		YPO_RS21280	10
RK1001.C0101_allcombined	4546883	4546910		YPO_RS21285	27
RK1001.C0101_allcombined	4547154	4547203		YPO_RS21285	49
RK1001.C0101_allcombined	4547418	4547427		YPO_RS21285	9
RK1001.C0101_allcombined	4547746	4547751		YPO_RS21285	5
RK1001.C0101_allcombined	4547803	4547806		YPO_RS21285	3
RK1001.C0101_allcombined	4548283	4548285		YPO_RS21295	2
RK1001.C0101_allcombined	4548452	4548454		YPO_RS21295	2
RK1001.C0101_allcombined	4548679	4548688		YPO_RS21295	9
RK1001.C0101_allcombined	4548718	4548722		YPO_RS21295	4
RK1001.C0101_allcombined	4549314	4549333		YPO_RS21295	19
RK1001.C0101_allcombined	4549377	4549385		YPO_RS21295	8
RK1001.C0101_allcombined	4549939	4549943		YPO_RS21300	4
RK1001.C0101_allcombined	4551231	4551250		YPO_RS21305	19
RK1001.C0101_allcombined	4551538	4551571		YPO_RS21305	33
RK1001.C0101_allcombined	4551769	4551770		YPO_RS21305	1
RK1001.C0101_allcombined	4551998	4552026		YPO_RS21305	28
RK1001.C0101_allcombined	4552176	4552178		YPO_RS21305	2
RK1001.C0101_allcombined	4552425	4552483		xylF	58
RK1001.C0101_allcombined	4552846	4552880		xylF	34
RK1001.C0101_allcombined	4552927	4552950		xylF	23
RK1001.C0101_allcombined	4552987	4553001		xylF	14
RK1001.C0101_allcombined	4553107	4553117		xylF	10
RK1001.C0101_allcombined	4553323	4553330		xylF	7
RK1001.C0101_allcombined	4553846	4553881		xylA	35
RK1001.C0101_allcombined	4554218	4554221		xylA	3
RK1001.C0101_allcombined	4554741	4554791		xylA	50
RK1001.C0101_allcombined	4555684	4555685		xylB	1
RK1001.C0101_allcombined	4555716	4555735		xylB	19
RK1001.C0101_allcombined	4555942	4555952		xylB	10
RK1001.C0101_allcombined	4555992	4556014		xylB	22
RK1001.C0101_allcombined	4556297	4556337		xylB	40
RK1001.C0101_allcombined	4556678	4556701		xylB	23
RK1001.C0101_allcombined	4556859	4556865		YPO_RS21325	6
RK1001.C0101_allcombined	4557183	4557189		YPO_RS21325	6
RK1001.C0101_allcombined	4557410	4557431		YPO_RS21325	21
RK1001.C0101_allcombined	4557587	4557589		YPO_RS21325	2
RK1001.C0101_allcombined	4558113	4558152		YPO_RS21330	39
RK1001.C0101_allcombined	4558313	4558350		YPO_RS21330	37
RK1001.C0101_allcombined	4558517	4558536		YPO_RS21330	19
RK1001.C0101_allcombined	4561370	4561375		YPO_RS21340	5
RK1001.C0101_allcombined	4561700	4561715		YPO_RS21340	15
RK1001.C0101_allcombined	4561824	4561867		YPO_RS21340	43
RK1001.C0101_allcombined	4562749	4562755		YPO_RS21345	6
RK1001.C0101_allcombined	4562845	4562853		YPO_RS21345	8
RK1001.C0101_allcombined	4563074	4563105		YPO_RS21345	31
RK1001.C0101_allcombined	4563351	4563381		YPO_RS21345	30
RK1001.C0101_allcombined	4563665	4563686		YPO_RS21345	21
RK1001.C0101_allcombined	4563924	4563938		YPO_RS21350	14
RK1001.C0101_allcombined	4564221	4564231		YPO_RS21355	10
RK1001.C0101_allcombined	4565415	4565416		YPO_RS21355	1
RK1001.C0101_allcombined	4565931	4565960		YPO_RS21360	29
RK1001.C0101_allcombined	4566125	4566126		YPO_RS21360	1
RK1001.C0101_allcombined	4567319	4567334		YPO_RS21365	15
RK1001.C0101_allcombined	4567507	4567512		YPO_RS21365	5
RK1001.C0101_allcombined	4567682	4567779		YPO_RS21370	97
RK1001.C0101_allcombined	4567870	4567877		YPO_RS21375	7
RK1001.C0101_allcombined	4568119	4568123		YPO_RS21375	4
RK1001.C0101_allcombined	4568153	4568169		YPO_RS21375	16
RK1001.C0101_allcombined	4568312	4568329		YPO_RS21375	17
RK1001.C0101_allcombined	4568359	4568384		YPO_RS21375	25
RK1001.C0101_allcombined	4568517	4568529		YPO_RS21380	12
RK1001.C0101_allcombined	4568599	4568606		YPO_RS21380	7
RK1001.C0101_allcombined	4568788	4568797		YPO_RS21380	9
RK1001.C0101_allcombined	4569608	4569626		selB	18
RK1001.C0101_allcombined	4569718	4569734		selB	16
RK1001.C0101_allcombined	4569840	4569848		selB	8
RK1001.C0101_allcombined	4570169	4570173		selB	4
RK1001.C0101_allcombined	4572316	4572319		YPO_RS21400	3
RK1001.C0101_allcombined	4572778	4572804		YPO_RS21400	26
RK1001.C0101_allcombined	4573088	4573105		fdhE	17
RK1001.C0101_allcombined	4573183	4573212		fdhE	29
RK1001.C0101_allcombined	4573422	4573449		fdhE	27
RK1001.C0101_allcombined	4573600	4573607		fdhE	7
RK1001.C0101_allcombined	4573978	4573999		fdhE	21
RK1001.C0101_allcombined	4574136	4574149		fdoI	13
RK1001.C0101_allcombined	4574962	4574989		fdxH	27
RK1001.C0101_allcombined	4575287	4575351		fdxH	64
RK1001.C0101_allcombined	4575768	4575837		fdnG	69
RK1001.C0101_allcombined	4576016	4576019		fdnG	3
RK1001.C0101_allcombined	4576341	4576343		fdnG	2
RK1001.C0101_allcombined	4577875	4577880		fdnG	5
RK1001.C0101_allcombined	4578372	4578382		fdnG	10
RK1001.C0101_allcombined	4579138	4579153		fdhD	15
RK1001.C0101_allcombined	4580266	4580270		sodA	4
RK1001.C0101_allcombined	4581159	4581165		YPO_RS21435	6
RK1001.C0101_allcombined	4581198	4581216		YPO_RS21435	18
RK1001.C0101_allcombined	4581251	4581268		YPO_RS21435	17
RK1001.C0101_allcombined	4582128	4582130		YPO_RS21435	2
RK1001.C0101_allcombined	4583273	4583281		YPO_RS21440	8
RK1001.C0101_allcombined	4583317	4583360		YPO_RS21440	43
RK1001.C0101_allcombined	4583408	4583421		YPO_RS21440	13
RK1001.C0101_allcombined	4583483	4583551		YPO_RS21440	68
RK1001.C0101_allcombined	4583583	4583605		YPO_RS21440	22
RK1001.C0101_allcombined	4584460	4584467		YPO_RS21445	7
RK1001.C0101_allcombined	4585068	4585077		YPO_RS21450	9
RK1001.C0101_allcombined	4585706	4585710		YPO_RS21455	4
RK1001.C0101_allcombined	4586162	4586187		YPO_RS21460	25
RK1001.C0101_allcombined	4586315	4586316		YPO_RS21460	1
RK1001.C0101_allcombined	4586376	4586386		YPO_RS21460	10
RK1001.C0101_allcombined	4586865	4586877		YPO_RS21460	12
RK1001.C0101_allcombined	4586909	4586913		YPO_RS21460	4
RK1001.C0101_allcombined	4587116	4587120		YPO_RS21460	4
RK1001.C0101_allcombined	4587170	4587184		YPO_RS21460	14
RK1001.C0101_allcombined	4588351	4588371		YPO_RS21465	20
RK1001.C0101_allcombined	4588607	4588621		YPO_RS21465	14
RK1001.C0101_allcombined	4589111	4589117		YPO_RS21465	6
RK1001.C0101_allcombined	4590161	4590171		YPO_RS21470	10
RK1001.C0101_allcombined	4590373	4590377		YPO_RS21470	4
RK1001.C0101_allcombined	4590849	4590874		YPO_RS21475	25
RK1001.C0101_allcombined	4591042	4591045		YPO_RS21475	3
RK1001.C0101_allcombined	4592106	4592108		glyS	2
RK1001.C0101_allcombined	4592734	4592742		glyS	8
RK1001.C0101_allcombined	4593631	4593636		glyQ	5
RK1001.C0101_allcombined	4593759	4593766		glyQ	7
RK1001.C0101_allcombined	4594608	4594614		YPO_RS21490	6
RK1001.C0101_allcombined	4595210	4595223		YPO_RS21495	13
RK1001.C0101_allcombined	4595266	4595268		YPO_RS21495	2
RK1001.C0101_allcombined	4595979	4595985		YPO_RS21500	6
RK1001.C0101_allcombined	4596277	4596287		YPO_RS21500	10
RK1001.C0101_allcombined	4596370	4596371		YPO_RS21500	1
RK1001.C0101_allcombined	4597160	4597187		YPO_RS21505	27
RK1001.C0101_allcombined	4597988	4598011		ghrB	23
RK1001.C0101_allcombined	4598126	4598127		ghrB	1
RK1001.C0101_allcombined	4598846	4598852		ghrB	6
RK1001.C0101_allcombined	4599791	4599811		YPO_RS21515	20
RK1001.C0101_allcombined	4600034	4600041		YPO_RS21515	7
RK1001.C0101_allcombined	4600261	4600266		YPO_RS21515	5
RK1001.C0101_allcombined	4600766	4600779		YPO_RS21515	13
RK1001.C0101_allcombined	4600996	4601011		YPO_RS21515	15
RK1001.C0101_allcombined	4601624	4601771		YPO_RS21520	147
RK1001.C0101_allcombined	4601815	4601830		YPO_RS21520	15
RK1001.C0101_allcombined	4601894	4602067		YPO_RS21520	173
RK1001.C0101_allcombined	4602522	4602527		YPO_RS21525	5
RK1001.C0101_allcombined	4602831	4602839		YPO_RS21525	8
RK1001.C0101_allcombined	4602920	4602930		YPO_RS21525	10
RK1001.C0101_allcombined	4603129	4603194		YPO_RS21525	65
RK1001.C0101_allcombined	4604610	4604611		YPO_RS21530	1
RK1001.C0101_allcombined	4605031	4605044		YPO_RS21530	13
RK1001.C0101_allcombined	4605463	4605473		YPO_RS21530	10
RK1001.C0101_allcombined	4605960	4605972		ibpB	12
RK1001.C0101_allcombined	4606377	4606379		ibpB	2
RK1001.C0101_allcombined	4606957	4606961		ibpA	4
RK1001.C0101_allcombined	4607484	4607493		YPO_RS21545	9
RK1001.C0101_allcombined	4608759	4608767		YPO_RS21555	8
RK1001.C0101_allcombined	4608873	4608878		YPO_RS21555	5
RK1001.C0101_allcombined	4609377	4609378		YPO_RS21555	1
RK1001.C0101_allcombined	4609848	4609870		YPO_RS21560	22
RK1001.C0101_allcombined	4610548	4610563		YPO_RS21560	15
RK1001.C0101_allcombined	4610896	4610898		YPO_RS21565	2
RK1001.C0101_allcombined	4611631	4611635		YPO_RS21565	4
RK1001.C0101_allcombined	4611710	4611725		YPO_RS21565	15
RK1001.C0101_allcombined	4612082	4612083		YPO_RS21565	1
RK1001.C0101_allcombined	4612641	4612652		yidA	11
RK1001.C0101_allcombined	4613322	4613328		yidA	6
RK1001.C0101_allcombined	4614345	4614372		gyrB	27
RK1001.C0101_allcombined	4614540	4614551		gyrB	11
RK1001.C0101_allcombined	4614876	4614878		gyrB	2
RK1001.C0101_allcombined	4615115	4615138		gyrB	23
RK1001.C0101_allcombined	4615265	4615312		gyrB	47
RK1001.C0101_allcombined	4615584	4615593		gyrB	9
RK1001.C0101_allcombined	4615978	4615984		recF	6
RK1001.C0101_allcombined	4617458	4617486		dnaN	28
RK1001.C0101_allcombined	4617692	4617703		dnaN	11
RK1001.C0101_allcombined	4617853	4617887		dnaN	34
RK1001.C0101_allcombined	4618353	4618365		dnaA	12
RK1001.C0101_allcombined	4618580	4618599		dnaA	19
RK1001.C0101_allcombined	4618922	4618981		dnaA	59
RK1001.C0101_allcombined	4619259	4619265		dnaA	6
RK1001.C0101_allcombined	4619495	4619552		dnaA	57
RK1001.C0101_allcombined	4619669	4619676		dnaA	7
RK1001.C0101_allcombined	4620598	4620607		rnpA	9
RK1001.C0101_allcombined	4620774	4620777		rnpA	3
RK1001.C0101_allcombined	4621113	4621116		yidD	3
RK1001.C0101_allcombined	4621177	4621178		yidD	1
RK1001.C0101_allcombined	4621434	4621448		yidC	14
RK1001.C0101_allcombined	4621905	4621923		yidC	18
RK1001.C0101_allcombined	4622590	4622591		yidC	1
RK1001.C0101_allcombined	4622725	4622727		yidC	2
RK1001.C0101_allcombined	4622995	4623005		mnmE	10
RK1001.C0101_allcombined	4623747	4623773		mnmE	26
RK1001.C0101_allcombined	4623967	4623971		mnmE	4
RK1001.C0101_allcombined	4624915	4624916		YPO_RS21620	1
RK1001.C0101_allcombined	4625571	4625574		YPO_RS21620	3
RK1001.C0101_allcombined	4625665	4625666		YPO_RS21620	1
RK1001.C0101_allcombined	4625796	4625812		YPO_RS21625	16
RK1001.C0101_allcombined	4625882	4625940		YPO_RS21625	58
RK1001.C0101_allcombined	4626015	4626023		YPO_RS21625	8
RK1001.C0101_allcombined	4626083	4626089		YPO_RS21625	6
RK1001.C0101_allcombined	4626267	4626327		YPO_RS21630	60
RK1001.C0101_allcombined	4626381	4626419		YPO_RS21630	38
RK1001.C0101_allcombined	4626524	4626538		YPO_RS21635	14
RK1001.C0101_allcombined	4626591	4626597		YPO_RS21635	6
RK1001.C0101_allcombined	4626705	4626768		YPO_RS21635	63
RK1001.C0101_allcombined	4626823	4626836		YPO_RS21635	13
RK1001.C0101_allcombined	4626919	4626948		YPO_RS21635	29
RK1001.C0101_allcombined	4626991	4627015		YPO_RS21635	24
RK1001.C0101_allcombined	4627069	4627120		YPO_RS21635	51
RK1001.C0101_allcombined	4628084	4628091		YPO_RS21640	7
RK1001.C0101_allcombined	4628238	4628242		YPO_RS21640	4
RK1001.C0101_allcombined	4629407	4629435		YPO_RS21645	28
RK1001.C0101_allcombined	4629660	4629665		yieH	5
RK1001.C0101_allcombined	4629699	4629709		yieH	10
RK1001.C0101_allcombined	4630686	4630728		YPO_RS21655	42
RK1001.C0101_allcombined	4630924	4630940		YPO_RS21655	16
RK1001.C0101_allcombined	4632071	4632076		YPO_RS21665	5
RK1001.C0101_allcombined	4632184	4632203		YPO_RS21665	19
RK1001.C0101_allcombined	4632703	4632744		YPO_RS21665	41
RK1001.C0101_allcombined	4633221	4633233		YPO_RS21670	12
RK1001.C0101_allcombined	4633388	4633405		YPO_RS21670	17
RK1001.C0101_allcombined	4633472	4633551		YPO_RS21670	79
RK1001.C0101_allcombined	4633961	4633971		phoU	10
RK1001.C0101_allcombined	4634198	4634203		phoU	5
RK1001.C0101_allcombined	4634383	4634391		phoU	8
RK1001.C0101_allcombined	4634557	4634576		phoU	19
RK1001.C0101_allcombined	4634628	4634644		phoU	16
RK1001.C0101_allcombined	4634797	4634806		pstB	9
RK1001.C0101_allcombined	4635352	4635358		pstB	6
RK1001.C0101_allcombined	4635654	4635673		pstA	19
RK1001.C0101_allcombined	4635748	4635751		pstA	3
RK1001.C0101_allcombined	4636527	4636533		pstC	6
RK1001.C0101_allcombined	4636786	4636790		pstC	4
RK1001.C0101_allcombined	4637845	4637872		pstS	27
RK1001.C0101_allcombined	4638577	4638606		pstS	29
RK1001.C0101_allcombined	4639584	4639588		glmS	4
RK1001.C0101_allcombined	4639924	4639934		glmS	10
RK1001.C0101_allcombined	4640344	4640349		glmS	5
RK1001.C0101_allcombined	4641381	4641388		glmU	7
RK1001.C0101_allcombined	4641725	4641773		glmU	48
RK1001.C0101_allcombined	4641999	4642016		glmU	17
RK1001.C0101_allcombined	4642279	4642309		glmU	30
RK1001.C0101_allcombined	4642417	4642424		glmU	7
RK1001.C0101_allcombined	4642538	4642553		glmU	15
RK1001.C0101_allcombined	4643933	4643943		atpD	10
RK1001.C0101_allcombined	4644164	4644184		atpD	20
RK1001.C0101_allcombined	4644232	4644252		atpD	20
RK1001.C0101_allcombined	4644388	4644424		atpD	36
RK1001.C0101_allcombined	4644734	4644746		atpD	12
RK1001.C0101_allcombined	4644819	4644840		atpD	21
RK1001.C0101_allcombined	4644873	4644889		atpD	16
RK1001.C0101_allcombined	4645634	4645643		atpG	9
RK1001.C0101_allcombined	4646658	4646668		atpA	10
RK1001.C0101_allcombined	4647052	4647054		atpA	2
RK1001.C0101_allcombined	4647853	4647858		atpH	5
RK1001.C0101_allcombined	4648227	4648228		atpF	1
RK1001.C0101_allcombined	4648622	4648634		atpF	12
RK1001.C0101_allcombined	4649048	4649067		atpB	19
RK1001.C0101_allcombined	4649111	4649120		atpB	9
RK1001.C0101_allcombined	4649325	4649330		atpB	5
RK1001.C0101_allcombined	4649360	4649363		atpB	3
RK1001.C0101_allcombined	4649418	4649444		atpB	26
RK1001.C0101_allcombined	4649827	4649836		atpB	9
RK1001.C0101_allcombined	4649923	4649929		atpI	6
RK1001.C0101_allcombined	4650271	4650278		atpI	7
RK1001.C0101_allcombined	4651029	4651041		rsmG	12
RK1001.C0101_allcombined	4651405	4651417		rsmG	12
RK1001.C0101_allcombined	4651483	4651490		rsmG	7
RK1001.C0101_allcombined	4651559	4651560		rsmG	1
RK1001.C0101_allcombined	4651965	4651967		mnmG	2
RK1001.C0101_allcombined	4652133	4652142		mnmG	9
RK1001.C0101_allcombined	4652321	4652347		mnmG	26
RK1001.C0101_allcombined	4652714	4652735		mnmG	21
RK1001.C0101_allcombined	4652927	4652942		mnmG	15
RK1001.C0101_allcombined	4653236	4653237		mnmG	1
RK1001.C0101_allcombined	4653516	4653520		mnmG	4
RT5_shotgun	327	332		mioC	5
RT5_shotgun	5898	5908		kup	10
RT5_shotgun	6027	6030		kup	3
RT5_shotgun	9918	9920		YPO_RS01055	2
RT5_shotgun	12865	12866		YPO_RS01070	1
RT5_shotgun	14914	14935		YPO_RS01080	21
RT5_shotgun	16490	16492		YPO_RS01080	2
RT5_shotgun	17136	17150		YPO_RS01080	14
RT5_shotgun	18218	18222		YPO_RS01090	4
RT5_shotgun	18687	18705		YPO_RS01090	18
RT5_shotgun	24019	24025		polA	6
RT5_shotgun	26519	26531		YPO_RS01125	12
RT5_shotgun	31985	32018		glnL	33
RT5_shotgun	35635	35641		typA	6
RT5_shotgun	36204	36215		typA	11
RT5_shotgun	37804	37808		yihX	4
RT5_shotgun	40413	40426		YPO_RS01185	13
RT5_shotgun	44827	44839		YPO_RS01200	12
RT5_shotgun	45161	45166		YPO_RS01200	5
RT5_shotgun	48285	48292		recG	7
RT5_shotgun	49706	49724		trmH	18
RT5_shotgun	52174	52179		spoT	5
RT5_shotgun	55503	55518		YPO_RS01245	15
RT5_shotgun	57390	57392		YPO_RS01250	2
RT5_shotgun	66018	66033		waaA	15
RT5_shotgun	69617	69633		rfaD	16
RT5_shotgun	88675	88700		pfkA	25
RT5_shotgun	89883	89889		YPO_RS01435	6
RT5_shotgun	92602	92606		YPO_RS01445	4
RT5_shotgun	95572	95578		YPO_RS01460	6
RT5_shotgun	103237	103247		zapB	10
RT5_shotgun	106581	106591		YPO_RS01520	10
RT5_shotgun	107179	107185		YPO_RS01520	6
RT5_shotgun	109230	109248		YPO_RS01530	18
RT5_shotgun	109506	109508		YPO_RS01530	2
RT5_shotgun	111444	111452		rraA	8
RT5_shotgun	117531	117543		priA	12
RT5_shotgun	120820	120831		YPO_RS01585	11
RT5_shotgun	127620	127636		YPO_RS01610	16
RT5_shotgun	128369	128375		YPO_RS01610	6
RT5_shotgun	130309	130314		glpG	5
RT5_shotgun	136156	136160		malP	4
RT5_shotgun	139600	139653		gntX	53
RT5_shotgun	142313	142317		feoB	4
RT5_shotgun	145588	145590		YPO_RS01685	2
RT5_shotgun	157074	157118		YPO_RS01725	44
RT5_shotgun	163641	163645		hofQ	4
RT5_shotgun	163866	163874		hofQ	8
RT5_shotgun	165887	165896		aroK	9
RT5_shotgun	170630	170676		YPO_RS01790	46
RT5_shotgun	170966	170973		trpS	7
RT5_shotgun	171246	171247		trpS	1
RT5_shotgun	171582	171603		trpS	21
RT5_shotgun	184327	184328		YPO_RS01840	1
RT5_shotgun	184494	184505		YPO_RS01840	11
RT5_shotgun	187230	187258		YPO_RS01850	28
RT5_shotgun	190621	190623		YPO_RS01865	2
RT5_shotgun	190832	190846		YPO_RS01865	14
RT5_shotgun	195694	195720		crp	26
RT5_shotgun	196584	196600		YPO_RS01895	16
RT5_shotgun	196789	196812		YPO_RS01895	23
RT5_shotgun	213980	213983		YPO_RS01985	3
RT5_shotgun	225638	225647		rpsC	9
RT5_shotgun	228407	228413		rpsH	6
RT5_shotgun	230386	230397		rpmD	11
RT5_shotgun	232072	232073		secY	1
RT5_shotgun	244628	244632		aroE	4
RT5_shotgun	245409	245429		YPO_RS02240	20
RT5_shotgun	246144	246147		YPO_RS02245	3
RT5_shotgun	247700	247703		YPO_RS02255	3
RT5_shotgun	249586	249594		actP	8
RT5_shotgun	252509	252519		acs	10
RT5_shotgun	255244	255246		YPO_RS02280	2
RT5_shotgun	260322	260337		sctD	15
RT5_shotgun	266077	266108		YPO_RS02340	31
RT5_shotgun	275977	276001		YPO_RS02395	24
RT5_shotgun	276838	276860		YPO_RS02400	22
RT5_shotgun	277719	277732		YPO_RS02400	13
RT5_shotgun	277900	277910		metC	10
RT5_shotgun	278203	278216		metC	13
RT5_shotgun	282027	282033		YPO_RS02425	6
RT5_shotgun	283436	283458		YPO_RS02430	22
RT5_shotgun	283604	283631		YPO_RS02430	27
RT5_shotgun	284126	284152		YPO_RS02430	26
RT5_shotgun	288940	288957		YPO_RS02455	17
RT5_shotgun	292348	292352		YPO_RS02470	4
RT5_shotgun	292348	292352		YPO_RS02475	4
RT5_shotgun	295238	295242		YPO_RS02485	4
RT5_shotgun	300734	300742		YPO_RS02520	8
RT5_shotgun	300785	300792		YPO_RS02520	7
RT5_shotgun	304326	304327		YPO_RS02530	1
RT5_shotgun	305198	305220		YPO_RS02535	22
RT5_shotgun	311267	311268		YPO_RS02555	1
RT5_shotgun	315043	315077		yapK	34
RT5_shotgun	322695	322700		zur	5
RT5_shotgun	328822	328833		alr	11
RT5_shotgun	329831	329843		YPO_RS02620	12
RT5_shotgun	333811	333813		uvrA	2
RT5_shotgun	337564	337573		rhaD	9
RT5_shotgun	340477	340501		rhaB	24
RT5_shotgun	346966	346967		YPO_RS02695	1
RT5_shotgun	347641	347644		YPO_RS02695	3
RT5_shotgun	348149	348162		YPO_RS02695	13
RT5_shotgun	353171	353201		fdhF	30
RT5_shotgun	354568	354576		fdhF	8
RT5_shotgun	357663	357664		YPO_RS02735	1
RT5_shotgun	360502	360508		fxsA	6
RT5_shotgun	365073	365077		epmB	4
RT5_shotgun	367045	367065		YPO_RS02780	20
RT5_shotgun	370297	370305		frdA	8
RT5_shotgun	374152	374160		mscM	8
RT5_shotgun	376040	376044		psd	4
RT5_shotgun	383903	383906		amiB	3
RT5_shotgun	383974	383982		amiB	8
RT5_shotgun	385094	385098		mutL	4
RT5_shotgun	391608	391610		hflC	2
RT5_shotgun	392650	392661		YPO_RS02895	11
RT5_shotgun	396673	396690		rnr	17
RT5_shotgun	400993	401000		YPO_RS02925	7
RT5_shotgun	401049	401063		YPO_RS02925	14
RT5_shotgun	403089	403092		YPO_RS02940	3
RT5_shotgun	404992	405020		YPO_RS02940	28
RT5_shotgun	407741	407743		YPO_RS02955	2
RT5_shotgun	407949	407950		YPO_RS02955	1
RT5_shotgun	408190	408215		YPO_RS02955	25
RT5_shotgun	409203	409208		YPO_RS02960	5
RT5_shotgun	409551	409578		YPO_RS02965	27
RT5_shotgun	409684	409694		YPO_RS02965	10
RT5_shotgun	409850	409950		YPO_RS02965	100
RT5_shotgun	409993	409996		YPO_RS02965	3
RT5_shotgun	410425	410455		YPO_RS02965	30
RT5_shotgun	410707	410715		YPO_RS02965	8
RT5_shotgun	410799	410827		YPO_RS02965	28
RT5_shotgun	419519	419522		YPO_RS03010	3
RT5_shotgun	426602	426616		lsrB	14
RT5_shotgun	431139	431142		lsrA	3
RT5_shotgun	431306	431321		YPO_RS03065	15
RT5_shotgun	432961	432979		lsrK	18
RT5_shotgun	435161	435181		rfaQ	20
RT5_shotgun	437958	437968		YPO_RS03090	10
RT5_shotgun	442755	442756		YPO_RS03105	1
RT5_shotgun	446861	446896		YPO_RS03125	35
RT5_shotgun	453142	453148		YPO_RS03165	6
RT5_shotgun	461183	461184		deoD	1
RT5_shotgun	470679	470691		YPO_RS03235	12
RT5_shotgun	472227	472234		YPO_RS03240	7
RT5_shotgun	480304	480316		robA	12
RT5_shotgun	489668	489672		yaaA	4
RT5_shotgun	491448	491459		mog	11
RT5_shotgun	491974	491985		mog	11
RT5_shotgun	494801	494809		YPO_RS03330	8
RT5_shotgun	495099	495105		YPO_RS03330	6
RT5_shotgun	498527	498539		dnaK	12
RT5_shotgun	502851	502860		nhaR	9
RT5_shotgun	504434	504441		ribF	7
RT5_shotgun	506334	506352		ileS	18
RT5_shotgun	510345	510358		YPO_RS03400	13
RT5_shotgun	511607	511634		dapB	27
RT5_shotgun	518634	518635		YPO_RS03430	1
RT5_shotgun	519217	519239		folA	22
RT5_shotgun	520835	520870		YPO_RS03445	35
RT5_shotgun	521316	521328		YPO_RS03450	12
RT5_shotgun	521848	521857		apaH	9
RT5_shotgun	526767	526800		lptD	33
RT5_shotgun	526996	527009		lptD	13
RT5_shotgun	527582	527585		lptD	3
RT5_shotgun	531910	531916		YPO_RS03495	6
RT5_shotgun	532052	532066		YPO_RS03495	14
RT5_shotgun	533298	533320		YPO_RS03500	22
RT5_shotgun	535186	535188		tssC	2
RT5_shotgun	535996	536022		YPO_RS03515	26
RT5_shotgun	536447	536457		YPO_RS03515	10
RT5_shotgun	537664	537669		tssF	5
RT5_shotgun	539707	539713		tssG	6
RT5_shotgun	540209	540219		tssH	10
RT5_shotgun	540783	540790		tssH	7
RT5_shotgun	541732	541738		tssH	6
RT5_shotgun	553947	553951		tssM	4
RT5_shotgun	556946	556959		rapA	13
RT5_shotgun	560902	560930		YPO_RS03600	28
RT5_shotgun	566972	566979		YPO_RS03620	7
RT5_shotgun	568472	568476		YPO_RS03625	4
RT5_shotgun	571671	571677		YPO_RS03635	6
RT5_shotgun	573140	573147		YPO_RS03645	7
RT5_shotgun	574851	574870		leuC	19
RT5_shotgun	578767	578769		YPO_RS03670	2
RT5_shotgun	579551	579586		YPO_RS03675	35
RT5_shotgun	581005	581007		leuO	2
RT5_shotgun	581186	581187		leuO	1
RT5_shotgun	586831	586858		YPO_RS03700	27
RT5_shotgun	592018	592020		YPO_RS03735	2
RT5_shotgun	604824	604839		ftsA	15
RT5_shotgun	605610	605612		ftsA	2
RT5_shotgun	610154	610158		secA	4
RT5_shotgun	613119	613120		YPO_RS03820	1
RT5_shotgun	613330	613334		YPO_RS03820	4
RT5_shotgun	613476	613511		YPO_RS03820	35
RT5_shotgun	614123	614134		YPO_RS03825	11
RT5_shotgun	628181	628182		YPO_RS03905	1
RT5_shotgun	628297	628299		YPO_RS03905	2
RT5_shotgun	628416	628437		YPO_RS03905	21
RT5_shotgun	629209	629218		sstT	9
RT5_shotgun	634216	634221		yapG	5
RT5_shotgun	634463	634523		yapG	60
RT5_shotgun	635046	635096		yapG	50
RT5_shotgun	645562	645567		YPO_RS03965	5
RT5_shotgun	650524	650554		cdiA	30
RT5_shotgun	654155	654179		cdiA	24
RT5_shotgun	657662	657666		cdiA	4
RT5_shotgun	659139	659169		cdiA	30
RT5_shotgun	659218	659238		cdiI	20
RT5_shotgun	659370	659393		cdiI	23
RT5_shotgun	663931	663940		yapF	9
RT5_shotgun	664809	664827		YPO_RS04025	18
RT5_shotgun	666283	666340		YPO_RS04030	57
RT5_shotgun	668657	668664		YPO_RS04040	7
RT5_shotgun	669186	669187		YPO_RS04040	1
RT5_shotgun	671007	671024		YPO_RS04040	17
RT5_shotgun	674154	674155		YPO_RS04055	1
RT5_shotgun	674549	674567		YPO_RS04055	18
RT5_shotgun	680742	680743		YPO_RS04080	1
RT5_shotgun	685278	685297		YPO_RS04100	19
RT5_shotgun	686993	686997		YPO_RS04110	4
RT5_shotgun	687548	687559		YPO_RS04115	11
RT5_shotgun	694060	694061		YPO_RS04160	1
RT5_shotgun	697047	697062		YPO_RS04170	15
RT5_shotgun	697981	698014		YPO_RS04180	33
RT5_shotgun	702629	702648		dnaG	19
RT5_shotgun	704725	704726		tsaD	1
RT5_shotgun	712551	712573		glnE	22
RT5_shotgun	713305	713322		glnE	17
RT5_shotgun	713505	713519		glnE	14
RT5_shotgun	714529	714535		hldE	6
RT5_shotgun	714671	714673		hldE	2
RT5_shotgun	726357	726358		yqiA	1
RT5_shotgun	726672	726696		yqiA	24
RT5_shotgun	733005	733020		parC	15
RT5_shotgun	735298	735304		ftsP	6
RT5_shotgun	739342	739343		YPO_RS04355	1
RT5_shotgun	740266	740271		yqhD	5
RT5_shotgun	742714	742719		YPO_RS04370	5
RT5_shotgun	743788	743820		metC	32
RT5_shotgun	744979	744982		exbB	3
RT5_shotgun	748387	748390		YPO_RS04395	3
RT5_shotgun	750205	750220		YPO_RS04410	15
RT5_shotgun	750527	750540		YPO_RS04415	13
RT5_shotgun	751042	751109		YPO_RS04415	67
RT5_shotgun	752953	752975		YPO_RS04425	22
RT5_shotgun	753510	753527		YPO_RS04425	17
RT5_shotgun	753767	753840		YPO_RS04430	73
RT5_shotgun	754416	754448		YPO_RS04435	32
RT5_shotgun	755998	756012		YPO_RS04445	14
RT5_shotgun	756542	756560		YPO_RS04450	18
RT5_shotgun	759974	759979		YPO_RS04465	5
RT5_shotgun	763722	763726		fepB	4
RT5_shotgun	771170	771173		fliP	3
RT5_shotgun	774679	774686		YPO_RS04530	7
RT5_shotgun	779649	779662		fliI	13
RT5_shotgun	783939	783943		flaE	4
RT5_shotgun	785297	785300		YPO_RS04600	3
RT5_shotgun	788222	788226		YPO_RS04625	4
RT5_shotgun	790593	790595		flgK	2
RT5_shotgun	791021	791042		flgK	21
RT5_shotgun	791171	791197		flgL	26
RT5_shotgun	791885	791903		flgL	18
RT5_shotgun	793477	793488		YPO_RS04650	11
RT5_shotgun	793907	793914		YPO_RS04655	7
RT5_shotgun	801156	801221		fliD	65
RT5_shotgun	801401	801408		fliS	7
RT5_shotgun	805070	805078		motA	8
RT5_shotgun	809221	809241		YPO_RS04735	20
RT5_shotgun	809950	809969		YPO_RS04740	19
RT5_shotgun	810434	810440		YPO_RS04740	6
RT5_shotgun	813965	813976		YPO_RS04755	11
RT5_shotgun	814342	814346		YPO_RS04755	4
RT5_shotgun	816382	816384		YPO_RS04765	2
RT5_shotgun	816718	816728		YPO_RS04765	10
RT5_shotgun	816993	816997		YPO_RS04770	4
RT5_shotgun	820510	820511		YPO_RS04770	1
RT5_shotgun	834345	834346		YPO_RS04800	1
RT5_shotgun	834697	834698		YPO_RS04800	1
RT5_shotgun	836106	836115		YPO_RS04805	9
RT5_shotgun	836198	836201		YPO_RS04805	3
RT5_shotgun	836450	836465		YPO_RS04805	15
RT5_shotgun	839082	839094		YPO_RS04815	12
RT5_shotgun	845180	845206		YPO_RS04835	26
RT5_shotgun	845440	845441		YPO_RS04835	1
RT5_shotgun	850257	850288		YPO_RS04840	31
RT5_shotgun	850979	850993		YPO_RS04845	14
RT5_shotgun	851757	851761		YPO_RS04845	4
RT5_shotgun	852288	852303		YPO_RS04845	15
RT5_shotgun	857275	857281		YPO_RS04850	6
RT5_shotgun	858880	858881		YPO_RS04860	1
RT5_shotgun	861653	861666		ptsP	13
RT5_shotgun	864029	864031		rppH	2
RT5_shotgun	866488	866494		YPO_RS04890	6
RT5_shotgun	867447	867457		YPO_RS04895	10
RT5_shotgun	871147	871175		aas	28
RT5_shotgun	877617	877622		YPO_RS04930	5
RT5_shotgun	878865	878876		YPO_RS04935	11
RT5_shotgun	881203	881213		YPO_RS04945	10
RT5_shotgun	882760	882772		YPO_RS04955	12
RT5_shotgun	883508	883519		YPO_RS04955	11
RT5_shotgun	883907	883915		YPO_RS04960	8
RT5_shotgun	883991	884011		YPO_RS04960	20
RT5_shotgun	884080	884108		YPO_RS04960	28
RT5_shotgun	884404	884432		YPO_RS04965	28
RT5_shotgun	884546	884554		YPO_RS04965	8
RT5_shotgun	886447	886456		YPO_RS04980	9
RT5_shotgun	886499	886508		YPO_RS04980	9
RT5_shotgun	886604	886629		YPO_RS04980	25
RT5_shotgun	886874	886877		gspL	3
RT5_shotgun	887073	887143		gspL	70
RT5_shotgun	888124	888271		YPO_RS04990	147
RT5_shotgun	888581	888586		YPO_RS04990	5
RT5_shotgun	890872	890879		gspG	7
RT5_shotgun	893685	893687		gspE	2
RT5_shotgun	893685	893825		gspD	140
RT5_shotgun	893954	893970		gspD	16
RT5_shotgun	894850	894869		gspD	19
RT5_shotgun	895235	895250		gspD	15
RT5_shotgun	895693	895723		YPO_RS05030	30
RT5_shotgun	895827	895841		YPO_RS05030	14
RT5_shotgun	896113	896159		YPO_RS05030	46
RT5_shotgun	896310	896326		YPO_RS05035	16
RT5_shotgun	896421	896432		YPO_RS05035	11
RT5_shotgun	896607	896625		YPO_RS05035	18
RT5_shotgun	899958	899961		YPO_RS05050	3
RT5_shotgun	900158	900161		YPO_RS05050	3
RT5_shotgun	906402	906412		YPO_RS05065	10
RT5_shotgun	912130	912151		YPO_RS05085	21
RT5_shotgun	914166	914215		YPO_RS05095	49
RT5_shotgun	917579	917589		nagA	10
RT5_shotgun	934479	934491		YPO_RS05180	12
RT5_shotgun	937453	937457		YPO_RS05190	4
RT5_shotgun	943964	943967		YPO_RS05215	3
RT5_shotgun	944238	944241		YPO_RS05215	3
RT5_shotgun	945347	945354		YPO_RS05220	7
RT5_shotgun	946146	946156		YPO_RS05220	10
RT5_shotgun	946401	946406		YPO_RS05220	5
RT5_shotgun	947641	947643		YPO_RS05225	2
RT5_shotgun	950009	950018		YPO_RS05235	9
RT5_shotgun	954270	954303		YPO_RS05260	33
RT5_shotgun	956142	956146		YPO_RS05270	4
RT5_shotgun	959948	959950		YPO_RS05290	2
RT5_shotgun	961520	961530		YPO_RS05295	10
RT5_shotgun	962291	962309		YPO_RS05295	18
RT5_shotgun	964022	964028		YPO_RS05315	6
RT5_shotgun	971789	971818		lysS	29
RT5_shotgun	972411	972419		lysS	8
RT5_shotgun	972715	972728		lysS	13
RT5_shotgun	974325	974327		prfB	2
RT5_shotgun	976505	976522		dsbC	17
RT5_shotgun	978175	978188		fldB	13
RT5_shotgun	978895	978902		creD	7
RT5_shotgun	981371	981377		creC	6
RT5_shotgun	985651	985654		YPO_RS05435	3
RT5_shotgun	986261	986280		YPO_RS05440	19
RT5_shotgun	993902	993908		gcvP	6
RT5_shotgun	1008751	1008765		mscS	14
RT5_shotgun	1009783	1009790		fbaA	7
RT5_shotgun	1011388	1011395		pgk	7
RT5_shotgun	1015624	1015630		YPO_RS05565	6
RT5_shotgun	1021190	1021193		speA	3
RT5_shotgun	1022150	1022154		speA	4
RT5_shotgun	1032633	1032642		YPO_RS05640	9
RT5_shotgun	1035262	1035278		YPO_RS05660	16
RT5_shotgun	1038398	1038402		YPO_RS05675	4
RT5_shotgun	1038488	1038489		YPO_RS05675	1
RT5_shotgun	1040034	1040037		YPO_RS05675	3
RT5_shotgun	1040800	1040802		YPO_RS05675	2
RT5_shotgun	1041008	1041013		YPO_RS05675	5
RT5_shotgun	1042614	1042619		YPO_RS05675	5
RT5_shotgun	1043789	1043811		YPO_RS05675	22
RT5_shotgun	1044275	1044287		YPO_RS05675	12
RT5_shotgun	1044630	1044678		YPO_RS05675	48
RT5_shotgun	1045142	1045147		YPO_RS05675	5
RT5_shotgun	1046463	1046484		YPO_RS05675	21
RT5_shotgun	1048586	1048588		glsB	2
RT5_shotgun	1058000	1058002		YPO_RS05725	2
RT5_shotgun	1062067	1062072		speF	5
RT5_shotgun	1067245	1067249		YPO_RS05765	4
RT5_shotgun	1067307	1067366		YPO_RS05765	59
RT5_shotgun	1069657	1069662		YPO_RS05770	5
RT5_shotgun	1071933	1071942		YPO_RS05790	9
RT5_shotgun	1073442	1073449		YPO_RS05795	7
RT5_shotgun	1089796	1089804		YPO_RS05850	8
RT5_shotgun	1091591	1091593		YPO_RS05855	2
RT5_shotgun	1091876	1091880		YPO_RS05855	4
RT5_shotgun	1092087	1092105		YPO_RS05860	18
RT5_shotgun	1092548	1092551		YPO_RS05860	3
RT5_shotgun	1093909	1093919		YPO_RS05865	10
RT5_shotgun	1099295	1099305		YPO_RS05890	10
RT5_shotgun	1105047	1105077		YPO_RS05905	30
RT5_shotgun	1107113	1107123		YPO_RS05910	10
RT5_shotgun	1107632	1107642		YPO_RS05915	10
RT5_shotgun	1108376	1108422		YPO_RS05915	46
RT5_shotgun	1108722	1108745		YPO_RS05915	23
RT5_shotgun	1116965	1116966		YPO_RS05940	1
RT5_shotgun	1117364	1117370		YPO_RS05940	6
RT5_shotgun	1117705	1117723		YPO_RS05940	18
RT5_shotgun	1118061	1118071		YPO_RS05940	10
RT5_shotgun	1120910	1120921		yapH	11
RT5_shotgun	1128728	1128731		yapH	3
RT5_shotgun	1129682	1129687		yapH	5
RT5_shotgun	1132338	1132341		YPO_RS05955	3
RT5_shotgun	1136274	1136276		YPO_RS05970	2
RT5_shotgun	1136379	1136392		YPO_RS05970	13
RT5_shotgun	1138088	1138090		YPO_RS05975	2
RT5_shotgun	1138583	1138606		YPO_RS05975	23
RT5_shotgun	1141193	1141197		YPO_RS05985	4
RT5_shotgun	1141494	1141508		YPO_RS05985	14
RT5_shotgun	1141920	1141931		YPO_RS05985	11
RT5_shotgun	1142280	1142308		YPO_RS05985	28
RT5_shotgun	1146282	1146286		YPO_RS05995	4
RT5_shotgun	1150332	1150348		recC	16
RT5_shotgun	1150815	1150819		recC	4
RT5_shotgun	1150902	1150906		recC	4
RT5_shotgun	1153268	1153280		ptrA	12
RT5_shotgun	1153799	1153808		ptrA	9
RT5_shotgun	1162915	1162917		argA	2
RT5_shotgun	1167086	1167087		tcdA	1
RT5_shotgun	1169357	1169359		YPO_RS06085	2
RT5_shotgun	1171899	1171910		rlmM	11
RT5_shotgun	1173792	1173798		YPO_RS06110	6
RT5_shotgun	1175636	1175640		queF	4
RT5_shotgun	1176362	1176363		syd	1
RT5_shotgun	1177834	1177850		YPO_RS06125	16
RT5_shotgun	1177882	1177890		YPO_RS06125	8
RT5_shotgun	1179368	1179381		YPO_RS06140	13
RT5_shotgun	1180040	1180055		YPO_RS06145	15
RT5_shotgun	1180837	1180851		dapD	14
RT5_shotgun	1183740	1183747		glnD	7
RT5_shotgun	1184821	1184834		map	13
RT5_shotgun	1189991	1189999		ispC	8
RT5_shotgun	1191692	1191701		cdsA	9
RT5_shotgun	1195422	1195433		bamA	11
RT5_shotgun	1196689	1196695		lpxD	6
RT5_shotgun	1198383	1198394		lpxA	11
RT5_shotgun	1201486	1201503		dnaE	17
RT5_shotgun	1202243	1202249		dnaE	6
RT5_shotgun	1202558	1202559		dnaE	1
RT5_shotgun	1205676	1205678		YPO_RS06250	2
RT5_shotgun	1206020	1206022		tilS	2
RT5_shotgun	1214638	1214727		metI	89
RT5_shotgun	1215065	1215067		metI	2
RT5_shotgun	1218461	1218462		YPO_RS06330	1
RT5_shotgun	1220119	1220126		YPO_RS06340	7
RT5_shotgun	1221219	1221220		YPO_RS06340	1
RT5_shotgun	1221601	1221610		YPO_RS06340	9
RT5_shotgun	1223700	1223711		dkgB	11
RT5_shotgun	1228474	1228481		YPO_RS06380	7
RT5_shotgun	1228942	1228962		rnhA	20
RT5_shotgun	1232228	1232230		YPO_RS06405	2
RT5_shotgun	1232805	1232808		YPO_RS06410	3
RT5_shotgun	1235305	1235322		YPO_RS06430	17
RT5_shotgun	1237674	1237678		YPO_RS06440	4
RT5_shotgun	1239264	1239287		YPO_RS06455	23
RT5_shotgun	1240741	1240745		YPO_RS06465	4
RT5_shotgun	1241391	1241400		YPO_RS06465	9
RT5_shotgun	1241878	1241959		YPO_RS06465	81
RT5_shotgun	1242001	1242018		YPO_RS06465	17
RT5_shotgun	1242349	1242419		YPO_RS06470	70
RT5_shotgun	1242962	1242968		YPO_RS06470	6
RT5_shotgun	1243404	1243405		YPO_RS06470	1
RT5_shotgun	1243508	1243520		YPO_RS06475	12
RT5_shotgun	1244011	1244043		YPO_RS06475	32
RT5_shotgun	1247740	1247744		bamE	4
RT5_shotgun	1254026	1254037		sdhD	11
RT5_shotgun	1254285	1254286		sdhA	1
RT5_shotgun	1259601	1259613		sucA	12
RT5_shotgun	1260636	1260641		odhB	5
RT5_shotgun	1262710	1262726		sucD	16
RT5_shotgun	1270273	1270278		tolB	5
RT5_shotgun	1271105	1271108		tolB	3
RT5_shotgun	1272644	1272647		cpoB	3
RT5_shotgun	1275905	1275906		zitB	1
RT5_shotgun	1278058	1278077		aroG	19
RT5_shotgun	1278604	1278610		YPO_RS06660	6
RT5_shotgun	1280005	1280016		YPO_RS06670	11
RT5_shotgun	1286673	1286680		YPO_RS06710	7
RT5_shotgun	1293902	1293914		YPO_RS06745	12
RT5_shotgun	1303453	1303461		uvrB	8
RT5_shotgun	1316611	1316622		YPO_RS06845	11
RT5_shotgun	1316689	1316695		YPO_RS06845	6
RT5_shotgun	1317021	1317023		YPO_RS06845	2
RT5_shotgun	1322148	1322160		YPO_RS06875	12
RT5_shotgun	1322813	1322833		YPO_RS06875	20
RT5_shotgun	1324435	1324440		YPO_RS06885	5
RT5_shotgun	1331492	1331495		phnC	3
RT5_shotgun	1334405	1334410		phnE	5
RT5_shotgun	1335648	1335657		urtA	9
RT5_shotgun	1336360	1336366		urtA	6
RT5_shotgun	1337691	1337693		urtB	2
RT5_shotgun	1337769	1337771		urtB	2
RT5_shotgun	1338820	1338823		urtC	3
RT5_shotgun	1340801	1340811		urtE	10
RT5_shotgun	1341674	1341701		YPO_RS06970	27
RT5_shotgun	1350091	1350129		adiC	38
RT5_shotgun	1351571	1351573		YPO_RS07015	2
RT5_shotgun	1352106	1352114		YPO_RS07015	8
RT5_shotgun	1357546	1357553		dinG	7
RT5_shotgun	1359550	1359555		YPO_RS07040	5
RT5_shotgun	1359777	1359795		YPO_RS07040	18
RT5_shotgun	1364618	1364636		YPO_RS07055	18
RT5_shotgun	1366268	1366295		nrdB	27
RT5_shotgun	1372320	1372347		gyrA	27
RT5_shotgun	1373356	1373367		gyrA	11
RT5_shotgun	1374207	1374219		rcsC	12
RT5_shotgun	1374429	1374444		rcsC	15
RT5_shotgun	1374793	1374794		rcsC	1
RT5_shotgun	1375897	1375909		rcsC	12
RT5_shotgun	1376966	1376989		rcsB	23
RT5_shotgun	1377236	1377245		YPO_RS07100	9
RT5_shotgun	1379005	1379016		rcsD	11
RT5_shotgun	1380307	1380312		YPO_RS07110	5
RT5_shotgun	1380527	1380530		YPO_RS07110	3
RT5_shotgun	1383658	1383666		YPO_RS07120	8
RT5_shotgun	1383711	1383713		YPO_RS07120	2
RT5_shotgun	1401606	1401608		YPO_RS07215	2
RT5_shotgun	1402548	1402554		YPO_RS07225	6
RT5_shotgun	1403544	1403570		YPO_RS07225	26
RT5_shotgun	1407545	1407556		YPO_RS07245	11
RT5_shotgun	1413171	1413174		YPO_RS07280	3
RT5_shotgun	1417088	1417090		YPO_RS07305	2
RT5_shotgun	1419329	1419361		yejK	32
RT5_shotgun	1423732	1423734		rsuA	2
RT5_shotgun	1426615	1426623		YPO_RS07345	8
RT5_shotgun	1427362	1427365		yejF	3
RT5_shotgun	1430315	1430326		YPO_RS07360	11
RT5_shotgun	1433439	1433442		YPO_RS07370	3
RT5_shotgun	1436060	1436069		YPO_RS07380	9
RT5_shotgun	1439353	1439365		YPO_RS07395	12
RT5_shotgun	1439575	1439586		YPO_RS07395	11
RT5_shotgun	1440139	1440146		YPO_RS07395	7
RT5_shotgun	1440396	1440400		YPO_RS07395	4
RT5_shotgun	1441295	1441299		uxuA	4
RT5_shotgun	1444309	1444323		mtr	14
RT5_shotgun	1448911	1448924		YPO_RS07435	13
RT5_shotgun	1452435	1452437		YPO_RS07450	2
RT5_shotgun	1461102	1461114		YPO_RS07485	12
RT5_shotgun	1461596	1461605		YPO_RS07485	9
RT5_shotgun	1461898	1461901		YPO_RS07490	3
RT5_shotgun	1461994	1462010		YPO_RS07490	16
RT5_shotgun	1463147	1463167		psaA	20
RT5_shotgun	1463239	1463252		psaA	13
RT5_shotgun	1465617	1465638		psaC	21
RT5_shotgun	1465966	1465977		psaC	11
RT5_shotgun	1468719	1468723		YPO_RS07515	4
RT5_shotgun	1470045	1470048		YPO_RS07520	3
RT5_shotgun	1471700	1471716		YPO_RS07525	16
RT5_shotgun	1480385	1480393		YPO_RS07560	8
RT5_shotgun	1481733	1481758		YPO_RS07565	25
RT5_shotgun	1482335	1482336		YPO_RS07570	1
RT5_shotgun	1486399	1486405		YPO_RS07585	6
RT5_shotgun	1486831	1486878		YPO_RS07585	47
RT5_shotgun	1495762	1495770		YPO_RS07625	8
RT5_shotgun	1500866	1500875		YPO_RS07650	9
RT5_shotgun	1503543	1503546		YPO_RS07665	3
RT5_shotgun	1504449	1504458		YPO_RS07670	9
RT5_shotgun	1505617	1505634		YPO_RS07680	17
RT5_shotgun	1526058	1526060		hcp	2
RT5_shotgun	1529035	1529064		YPO_RS07800	29
RT5_shotgun	1529642	1529648		YPO_RS07800	6
RT5_shotgun	1530727	1530746		YPO_RS07805	19
RT5_shotgun	1532758	1532760		macB	2
RT5_shotgun	1537099	1537104		clpA	5
RT5_shotgun	1541947	1541954		cydD	7
RT5_shotgun	1550799	1550802		lolA	3
RT5_shotgun	1554687	1554692		YPO_RS07890	5
RT5_shotgun	1555700	1555707		pflA	7
RT5_shotgun	1557802	1557850		YPO_RS07900	48
RT5_shotgun	1558514	1558526		pflB	12
RT5_shotgun	1562714	1562716		YPO_RS07915	2
RT5_shotgun	1562806	1562811		YPO_RS07915	5
RT5_shotgun	1563862	1563864		ansB	2
RT5_shotgun	1564419	1564430		ansB	11
RT5_shotgun	1566084	1566093		YPO_RS07925	9
RT5_shotgun	1566687	1566697		YPO_RS07930	10
RT5_shotgun	1567630	1567642		YPO_RS07930	12
RT5_shotgun	1567707	1567766		YPO_RS07930	59
RT5_shotgun	1568861	1568869		serC	8
RT5_shotgun	1570888	1570894		aroA	6
RT5_shotgun	1571615	1571619		cmk	4
RT5_shotgun	1576146	1576147		YPO_RS07960	1
RT5_shotgun	1578921	1578935		lpxK	14
RT5_shotgun	1583142	1583148		kdsB	6
RT5_shotgun	1584083	1584089		YPO_RS07995	6
RT5_shotgun	1587303	1587322		mukF	19
RT5_shotgun	1591139	1591140		mukB	1
RT5_shotgun	1593555	1593567		YPO_RS08020	12
RT5_shotgun	1598038	1598041		YPO_RS08045	3
RT5_shotgun	1599272	1599279		ompF	7
RT5_shotgun	1603422	1603426		pncB	4
RT5_shotgun	1604673	1604695		pepN	22
RT5_shotgun	1605333	1605337		pepN	4
RT5_shotgun	1608111	1608133		pyrD	22
RT5_shotgun	1609112	1609120		YPO_RS08075	8
RT5_shotgun	1609282	1609316		YPO_RS08075	34
RT5_shotgun	1610447	1610453		YPO_RS08080	6
RT5_shotgun	1615748	1615759		pqiA	11
RT5_shotgun	1619255	1619270		YPO_RS08115	15
RT5_shotgun	1620916	1620947		YPO_RS08125	31
RT5_shotgun	1624641	1624648		YPO_RS08150	7
RT5_shotgun	1626672	1626674		YPO_RS08160	2
RT5_shotgun	1628029	1628030		ompA	1
RT5_shotgun	1633009	1633025		helD	16
RT5_shotgun	1635955	1635966		YPO_RS08200	11
RT5_shotgun	1636042	1636045		YPO_RS08200	3
RT5_shotgun	1636252	1636260		YPO_RS08200	8
RT5_shotgun	1644614	1644623		YPO_RS08245	9
RT5_shotgun	1646229	1646242		YPO_RS08250	13
RT5_shotgun	1647675	1647684		YPO_RS08260	9
RT5_shotgun	1648079	1648122		YPO_RS08260	43
RT5_shotgun	1648112	1648142		YPO_RS08265	30
RT5_shotgun	1648260	1648268		YPO_RS08265	8
RT5_shotgun	1649089	1649097		YPO_RS08265	8
RT5_shotgun	1651094	1651097		YPO_RS08275	3
RT5_shotgun	1651495	1651523		YPO_RS08280	28
RT5_shotgun	1651762	1651767		YPO_RS08280	5
RT5_shotgun	1653295	1653299		YPO_RS08290	4
RT5_shotgun	1653867	1653886		YPO_RS08295	19
RT5_shotgun	1654339	1654458		YPO_RS08300	119
RT5_shotgun	1655358	1655405		YPO_RS08305	47
RT5_shotgun	1662176	1662187		YPO_RS08330	11
RT5_shotgun	1666838	1666844		YPO_RS08345	6
RT5_shotgun	1667102	1667107		YPO_RS08345	5
RT5_shotgun	1668003	1668005		YPO_RS08345	2
RT5_shotgun	1668332	1668345		YPO_RS08350	13
RT5_shotgun	1669398	1669412		YPO_RS08350	14
RT5_shotgun	1669934	1669938		YPO_RS08350	4
RT5_shotgun	1670006	1670008		YPO_RS08350	2
RT5_shotgun	1670480	1670498		YPO_RS08355	18
RT5_shotgun	1670573	1670578		YPO_RS08355	5
RT5_shotgun	1670719	1670723		YPO_RS08355	4
RT5_shotgun	1670795	1670814		YPO_RS08355	19
RT5_shotgun	1670987	1671071		YPO_RS08355	84
RT5_shotgun	1671499	1671504		YPO_RS08360	5
RT5_shotgun	1671925	1671926		YPO_RS08365	1
RT5_shotgun	1673359	1673420		YPO_RS08365	61
RT5_shotgun	1674416	1674422		YPO_RS08370	6
RT5_shotgun	1679746	1679751		YPO_RS08385	5
RT5_shotgun	1683708	1683732		YPO_RS08395	24
RT5_shotgun	1683841	1683847		YPO_RS08395	6
RT5_shotgun	1684040	1684051		YPO_RS08400	11
RT5_shotgun	1684127	1684142		YPO_RS08400	15
RT5_shotgun	1685768	1685770		tssF	2
RT5_shotgun	1690279	1690280		YPO_RS08430	1
RT5_shotgun	1690404	1690410		YPO_RS08430	6
RT5_shotgun	1690724	1690755		YPO_RS08430	31
RT5_shotgun	1693454	1693455		YPO_RS08440	1
RT5_shotgun	1697336	1697342		moeA	6
RT5_shotgun	1698263	1698288		darE	25
RT5_shotgun	1698364	1698374		darE	10
RT5_shotgun	1698659	1698671		darE	12
RT5_shotgun	1698921	1698945		darE	24
RT5_shotgun	1699094	1699104		darE	10
RT5_shotgun	1699138	1699141		darE	3
RT5_shotgun	1699740	1699744		darD	4
RT5_shotgun	1699910	1699916		darC	6
RT5_shotgun	1700927	1700931		darC	4
RT5_shotgun	1701235	1701236		darB	1
RT5_shotgun	1701369	1701396		darB	27
RT5_shotgun	1701615	1701624		darB	9
RT5_shotgun	1702058	1702079		darB	21
RT5_shotgun	1703411	1703431		darB	20
RT5_shotgun	1706545	1706554		YPO_RS08495	9
RT5_shotgun	1712811	1712813		mglA	2
RT5_shotgun	1714183	1714187		mglC	4
RT5_shotgun	1714986	1714989		mglC	3
RT5_shotgun	1716046	1716062		sanA	16
RT5_shotgun	1717842	1717846		YPO_RS08535	4
RT5_shotgun	1720650	1720654		YPO_RS08550	4
RT5_shotgun	1721627	1721630		YPO_RS08555	3
RT5_shotgun	1723096	1723107		YPO_RS08560	11
RT5_shotgun	1725909	1725934		YPO_RS08570	25
RT5_shotgun	1726005	1726007		YPO_RS08570	2
RT5_shotgun	1727742	1727764		YPO_RS08580	22
RT5_shotgun	1731752	1731781		apbC	29
RT5_shotgun	1733337	1733338		udk	1
RT5_shotgun	1734369	1734371		asmA	2
RT5_shotgun	1735308	1735328		asmA	20
RT5_shotgun	1736897	1736911		YPO_RS08615	14
RT5_shotgun	1738545	1738557		fhuF	12
RT5_shotgun	1738723	1738744		fhuF	21
RT5_shotgun	1739303	1739309		YPO_RS08625	6
RT5_shotgun	1739477	1739501		YPO_RS08625	24
RT5_shotgun	1741719	1741729		YPO_RS08630	10
RT5_shotgun	1746885	1746909		YPO_RS08655	24
RT5_shotgun	1748851	1748853		YPO_RS08665	2
RT5_shotgun	1757169	1757183		gndA	14
RT5_shotgun	1760737	1760745		hisB	8
RT5_shotgun	1775690	1775702		YPO_RS08785	12
RT5_shotgun	1776288	1776291		YPO_RS08785	3
RT5_shotgun	1778140	1778153		YPO_RS08795	13
RT5_shotgun	1783284	1783291		YPO_RS08805	7
RT5_shotgun	1783886	1783899		YPO_RS08805	13
RT5_shotgun	1786632	1786634		YPO_RS08820	2
RT5_shotgun	1787762	1787789		YPO_RS08825	27
RT5_shotgun	1792208	1792213		YPO_RS08840	5
RT5_shotgun	1796104	1796130		YPO_RS08855	26
RT5_shotgun	1796287	1796304		YPO_RS08855	17
RT5_shotgun	1799320	1799355		YPO_RS08875	35
RT5_shotgun	1800119	1800124		YPO_RS08875	5
RT5_shotgun	1803123	1803126		YPO_RS08890	3
RT5_shotgun	1808179	1808185		YPO_RS08910	6
RT5_shotgun	1810561	1810568		pyrC	7
RT5_shotgun	1815393	1815396		rne	3
RT5_shotgun	1820893	1820927		plsX	34
RT5_shotgun	1825005	1825022		fabF	17
RT5_shotgun	1828375	1828383		mltG	8
RT5_shotgun	1828665	1828674		mltG	9
RT5_shotgun	1833080	1833093		ptsG	13
RT5_shotgun	1838338	1838344		nagZ	6
RT5_shotgun	1839083	1839095		YPO_RS09075	12
RT5_shotgun	1840238	1840252		YPO_RS09080	14
RT5_shotgun	1843283	1843285		YPO_RS09095	2
RT5_shotgun	1844258	1844264		YPO_RS09100	6
RT5_shotgun	1844440	1844448		YPO_RS09100	8
RT5_shotgun	1844527	1844566		YPO_RS09100	39
RT5_shotgun	1845167	1845179		YPO_RS09105	12
RT5_shotgun	1853144	1853145		lolE	1
RT5_shotgun	1856712	1856737		pepT	25
RT5_shotgun	1864180	1864181		mnmA	1
RT5_shotgun	1864834	1864840		mnmA	6
RT5_shotgun	1873084	1873100		YPO_RS09220	16
RT5_shotgun	1874640	1874651		YPO_RS09230	11
RT5_shotgun	1878155	1878175		YPO_RS09250	20
RT5_shotgun	1882902	1882925		YPO_RS09260	23
RT5_shotgun	1889393	1889437		mgtA	44
RT5_shotgun	1889708	1889723		mgtA	15
RT5_shotgun	1891102	1891104		mgtA	2
RT5_shotgun	1898946	1898954		YPO_RS09320	8
RT5_shotgun	1899934	1899957		YPO_RS09320	23
RT5_shotgun	1900211	1900263		YPO_RS09325	52
RT5_shotgun	1900845	1900850		YPO_RS09330	5
RT5_shotgun	1900968	1900976		YPO_RS09330	8
RT5_shotgun	1901685	1901714		YPO_RS09335	29
RT5_shotgun	1903626	1903628		yapJ	2
RT5_shotgun	1903785	1903789		yapJ	4
RT5_shotgun	1904208	1904250		yapJ	42
RT5_shotgun	1904870	1904877		yapJ	7
RT5_shotgun	1906599	1906606		yapJ	7
RT5_shotgun	1910101	1910105		YPO_RS09350	4
RT5_shotgun	1916581	1916582		YPO_RS09370	1
RT5_shotgun	1918432	1918439		YPO_RS09385	7
RT5_shotgun	1918993	1919001		YPO_RS09385	8
RT5_shotgun	1922252	1922262		YPO_RS09400	10
RT5_shotgun	1922914	1922921		YPO_RS09400	7
RT5_shotgun	1923868	1923889		YPO_RS09405	21
RT5_shotgun	1924699	1924706		YPO_RS09405	7
RT5_shotgun	1924850	1924852		YPO_RS09405	2
RT5_shotgun	1926218	1926222		YPO_RS09415	4
RT5_shotgun	1930024	1930035		YPO_RS09435	11
RT5_shotgun	1933745	1933749		YPO_RS09455	4
RT5_shotgun	1933801	1933857		YPO_RS09455	56
RT5_shotgun	1936620	1936639		YPO_RS09460	19
RT5_shotgun	1947684	1947689		htpX	5
RT5_shotgun	1948627	1948649		YPO_RS09510	22
RT5_shotgun	1949193	1949211		YPO_RS09515	18
RT5_shotgun	1951084	1951113		YPO_RS09520	29
RT5_shotgun	1953093	1953099		YPO_RS09525	6
RT5_shotgun	1954206	1954217		YPO_RS09530	11
RT5_shotgun	1957199	1957228		YPO_RS09540	29
RT5_shotgun	1958773	1958780		YPO_RS09550	7
RT5_shotgun	1959181	1959196		YPO_RS09550	15
RT5_shotgun	1959296	1959310		YPO_RS09550	14
RT5_shotgun	1960067	1960082		YPO_RS09555	15
RT5_shotgun	1961052	1961062		YPO_RS09555	10
RT5_shotgun	1962457	1962474		YPO_RS09565	17
RT5_shotgun	1962927	1962948		YPO_RS09565	21
RT5_shotgun	1963048	1963049		YPO_RS09565	1
RT5_shotgun	1963566	1963575		YPO_RS09570	9
RT5_shotgun	1964051	1964066		YPO_RS09570	15
RT5_shotgun	1964136	1964162		YPO_RS09570	26
RT5_shotgun	1965011	1965018		YPO_RS09575	7
RT5_shotgun	1967579	1967588		YPO_RS09585	9
RT5_shotgun	1968000	1968006		YPO_RS09590	6
RT5_shotgun	1968969	1968992		YPO_RS09590	23
RT5_shotgun	1969761	1969771		kduD	10
RT5_shotgun	1970914	1970922		kduI	8
RT5_shotgun	1976831	1976842		YPO_RS09630	11
RT5_shotgun	1977503	1977507		mtfA	4
RT5_shotgun	1983477	1983506		YPO_RS09670	29
RT5_shotgun	1985253	1985264		YPO_RS09690	11
RT5_shotgun	1988016	1988021		YPO_RS09705	5
RT5_shotgun	1992241	1992278		YPO_RS09730	37
RT5_shotgun	1993986	1993994		YPO_RS09740	8
RT5_shotgun	1996457	1996466		YPO_RS09745	9
RT5_shotgun	2000492	2000494		YPO_RS09760	2
RT5_shotgun	2001235	2001246		YPO_RS09765	11
RT5_shotgun	2001507	2001509		YPO_RS09765	2
RT5_shotgun	2004532	2004556		YPO_RS09780	24
RT5_shotgun	2011298	2011307		hpaH	9
RT5_shotgun	2013507	2013517		hpaX	10
RT5_shotgun	2014331	2014373		hpaB	42
RT5_shotgun	2014589	2014604		hpaB	15
RT5_shotgun	2015590	2015596		hpaB	6
RT5_shotgun	2016084	2016106		hpaC	22
RT5_shotgun	2016712	2016719		YPO_RS09840	7
RT5_shotgun	2024274	2024275		YPO_RS09870	1
RT5_shotgun	2031116	2031118		yobA	2
RT5_shotgun	2033296	2033301		YPO_RS09920	5
RT5_shotgun	2048688	2048691		flgG	3
RT5_shotgun	2055186	2055238		flgL	52
RT5_shotgun	2057851	2057854		YPO_RS10035	3
RT5_shotgun	2063375	2063382		YPO_RS10055	7
RT5_shotgun	2064987	2065005		YPO_RS10065	18
RT5_shotgun	2065408	2065414		YPO_RS10070	6
RT5_shotgun	2067943	2067969		fliO	26
RT5_shotgun	2075610	2075624		fliF	14
RT5_shotgun	2079958	2079973		YPO_RS10165	15
RT5_shotgun	2081708	2081725		YPO_RS10170	17
RT5_shotgun	2083493	2083504		YPO_RS10175	11
RT5_shotgun	2086358	2086364		fliD	6
RT5_shotgun	2087341	2087350		YPO_RS10195	9
RT5_shotgun	2091301	2091309		tcyJ	8
RT5_shotgun	2094013	2094028		YPO_RS10235	15
RT5_shotgun	2097118	2097119		putA	1
RT5_shotgun	2099207	2099221		putP	14
RT5_shotgun	2103135	2103140		efeB	5
RT5_shotgun	2104271	2104276		efeB	5
RT5_shotgun	2105007	2105017		wrbA	10
RT5_shotgun	2106823	2106852		cycA	29
RT5_shotgun	2109431	2109445		YPO_RS10290	14
RT5_shotgun	2110638	2110641		YPO_RS10300	3
RT5_shotgun	2110751	2110783		YPO_RS10300	32
RT5_shotgun	2112382	2112387		uvrY	5
RT5_shotgun	2113713	2113728		uvrC	15
RT5_shotgun	2113842	2113853		uvrC	11
RT5_shotgun	2114020	2114038		uvrC	18
RT5_shotgun	2118119	2118133		hcp	14
RT5_shotgun	2118248	2118251		hcp	3
RT5_shotgun	2118749	2118764		YPO_RS10365	15
RT5_shotgun	2122251	2122254		YPO_RS10390	3
RT5_shotgun	2123448	2123478		YPO_RS10405	30
RT5_shotgun	2126276	2126302		YPO_RS10415	26
RT5_shotgun	2126496	2126532		YPO_RS10415	36
RT5_shotgun	2126780	2126784		YPO_RS10420	4
RT5_shotgun	2126877	2126908		YPO_RS10420	31
RT5_shotgun	2130013	2130017		YPO_RS10435	4
RT5_shotgun	2133067	2133086		YPO_RS10450	19
RT5_shotgun	2133248	2133250		YPO_RS10450	2
RT5_shotgun	2142100	2142108		fyuA	8
RT5_shotgun	2144512	2144517		ybtE	5
RT5_shotgun	2169207	2169212		ybtS	5
RT5_shotgun	2171754	2171761		YPO_RS10580	7
RT5_shotgun	2173632	2173641		YPO_RS10585	9
RT5_shotgun	2174155	2174161		YPO_RS10590	6
RT5_shotgun	2174782	2174783		YPO_RS10590	1
RT5_shotgun	2178361	2178369		YPO_RS10605	8
RT5_shotgun	2179247	2179260		YPO_RS10605	13
RT5_shotgun	2179964	2179981		YPO_RS10605	17
RT5_shotgun	2180684	2180692		YPO_RS10610	8
RT5_shotgun	2180936	2180949		YPO_RS10610	13
RT5_shotgun	2189881	2189883		YPO_RS10655	2
RT5_shotgun	2190204	2190205		YPO_RS10655	1
RT5_shotgun	2192366	2192388		nqrE	22
RT5_shotgun	2194848	2194858		ansP	10
RT5_shotgun	2195850	2195856		ansP	6
RT5_shotgun	2205065	2205066		YPO_RS10710	1
RT5_shotgun	2205837	2205840		YPO_RS10710	3
RT5_shotgun	2212491	2212495		YPO_RS10745	4
RT5_shotgun	2214699	2214707		pgaA	8
RT5_shotgun	2216695	2216723		pgaB	28
RT5_shotgun	2216958	2216961		pgaB	3
RT5_shotgun	2217107	2217145		pgaB	38
RT5_shotgun	2218007	2218020		YPO_RS10760	13
RT5_shotgun	2220790	2220807		YPO_RS10770	17
RT5_shotgun	2224266	2224270		narX	4
RT5_shotgun	2234091	2234127		astE	36
RT5_shotgun	2237352	2237385		YPO_RS10835	33
RT5_shotgun	2237549	2237555		YPO_RS10840	6
RT5_shotgun	2237667	2237689		YPO_RS10840	22
RT5_shotgun	2240335	2240348		YPO_RS10855	13
RT5_shotgun	2240560	2240566		YPO_RS10855	6
RT5_shotgun	2243110	2243120		YPO_RS10865	10
RT5_shotgun	2249094	2249130		YPO_RS10890	36
RT5_shotgun	2252789	2252819		YPO_RS10905	30
RT5_shotgun	2259018	2259064		YPO_RS10935	46
RT5_shotgun	2260097	2260101		YPO_RS10935	4
RT5_shotgun	2260492	2260498		YPO_RS10935	6
RT5_shotgun	2263193	2263208		YPO_RS10940	15
RT5_shotgun	2265038	2265043		YPO_RS10950	5
RT5_shotgun	2265099	2265121		YPO_RS10950	22
RT5_shotgun	2265381	2265382		YPO_RS10955	1
RT5_shotgun	2266239	2266246		YPO_RS10960	7
RT5_shotgun	2266330	2266380		YPO_RS10965	50
RT5_shotgun	2266817	2266822		YPO_RS10965	5
RT5_shotgun	2266901	2266918		YPO_RS10965	17
RT5_shotgun	2269921	2269940		YPO_RS10980	19
RT5_shotgun	2270404	2270431		YPO_RS10980	27
RT5_shotgun	2270741	2270753		YPO_RS10980	12
RT5_shotgun	2272650	2272659		YPO_RS10995	9
RT5_shotgun	2277808	2277815		YPO_RS11020	7
RT5_shotgun	2280785	2280803		YPO_RS11035	18
RT5_shotgun	2283226	2283232		ychF	6
RT5_shotgun	2287128	2287130		lolB	2
RT5_shotgun	2291599	2291610		YPO_RS11090	11
RT5_shotgun	2291609	2291610		YPO_RS11095	1
RT5_shotgun	2294836	2294854		YPO_RS11110	18
RT5_shotgun	2295099	2295103		YPO_RS11115	4
RT5_shotgun	2295369	2295398		YPO_RS11115	29
RT5_shotgun	2295989	2296033		YPO_RS11120	44
RT5_shotgun	2299541	2299543		YPO_RS11135	2
RT5_shotgun	2300005	2300030		YPO_RS11135	25
RT5_shotgun	2304216	2304220		YPO_RS11160	4
RT5_shotgun	2304479	2304484		YPO_RS11160	5
RT5_shotgun	2305969	2305971		YPO_RS11175	2
RT5_shotgun	2307069	2307073		YPO_RS11175	4
RT5_shotgun	2307740	2307742		YPO_RS11185	2
RT5_shotgun	2310984	2310997		mdtH	13
RT5_shotgun	2312626	2312633		YPO_RS11210	7
RT5_shotgun	2313797	2313799		YPO_RS11210	2
RT5_shotgun	2316441	2316469		YPO_RS11220	28
RT5_shotgun	2317368	2317400		YPO_RS11220	32
RT5_shotgun	2318052	2318068		YPO_RS11220	16
RT5_shotgun	2319545	2319573		YPO_RS11225	28
RT5_shotgun	2320645	2320652		YPO_RS11225	7
RT5_shotgun	2322145	2322159		YPO_RS11225	14
RT5_shotgun	2324146	2324150		argS	4
RT5_shotgun	2324260	2324264		argS	4
RT5_shotgun	2324395	2324396		argS	1
RT5_shotgun	2330551	2330556		YPO_RS11260	5
RT5_shotgun	2339328	2339331		znuA	3
RT5_shotgun	2339540	2339541		znuA	1
RT5_shotgun	2342228	2342233		lpxM	5
RT5_shotgun	2346738	2346743		zwf	5
RT5_shotgun	2347405	2347419		zwf	14
RT5_shotgun	2348056	2348061		YPO_RS11335	5
RT5_shotgun	2348229	2348233		YPO_RS11335	4
RT5_shotgun	2352001	2352006		YPO_RS11355	5
RT5_shotgun	2353761	2353762		YPO_RS11365	1
RT5_shotgun	2355599	2355627		fadD	28
RT5_shotgun	2362676	2362677		YPO_RS11415	1
RT5_shotgun	2370367	2370373		YPO_RS11470	6
RT5_shotgun	2378279	2378293		YPO_RS11525	14
RT5_shotgun	2387277	2387290		YPO_RS11590	13
RT5_shotgun	2387606	2387642		YPO_RS11590	36
RT5_shotgun	2388293	2388296		YPO_RS11590	3
RT5_shotgun	2388716	2388730		YPO_RS11590	14
RT5_shotgun	2389150	2389155		YPO_RS11590	5
RT5_shotgun	2392948	2392953		YPO_RS11615	5
RT5_shotgun	2393012	2393017		YPO_RS11615	5
RT5_shotgun	2393685	2393689		YPO_RS11620	4
RT5_shotgun	2395067	2395072		YPO_RS11630	5
RT5_shotgun	2400415	2400435		YPO_RS11660	20
RT5_shotgun	2400626	2400632		YPO_RS11660	6
RT5_shotgun	2400725	2400737		YPO_RS11665	12
RT5_shotgun	2401620	2401648		YPO_RS11665	28
RT5_shotgun	2401721	2401723		YPO_RS11670	2
RT5_shotgun	2402404	2402415		YPO_RS11670	11
RT5_shotgun	2403406	2403407		YPO_RS11680	1
RT5_shotgun	2403696	2403703		YPO_RS11680	7
RT5_shotgun	2406153	2406162		YPO_RS11690	9
RT5_shotgun	2411209	2411228		nhaB	19
RT5_shotgun	2411634	2411645		nhaB	11
RT5_shotgun	2413516	2413518		YPO_RS11720	2
RT5_shotgun	2414710	2414717		YPO_RS11720	7
RT5_shotgun	2425299	2425303		YPO_RS11760	4
RT5_shotgun	2425791	2425797		YPO_RS11760	6
RT5_shotgun	2425838	2425844		YPO_RS11760	6
RT5_shotgun	2427163	2427173		gapA	10
RT5_shotgun	2430788	2430793		ansA	5
RT5_shotgun	2431701	2431703		sppA	2
RT5_shotgun	2437437	2437446		YPO_RS11820	9
RT5_shotgun	2439585	2439587		YPO_RS11830	2
RT5_shotgun	2439656	2439658		YPO_RS11830	2
RT5_shotgun	2439903	2439926		YPO_RS11830	23
RT5_shotgun	2440033	2440041		YPO_RS11830	8
RT5_shotgun	2440199	2440203		YPO_RS11830	4
RT5_shotgun	2441900	2441906		YPO_RS11850	6
RT5_shotgun	2442373	2442391		purU	18
RT5_shotgun	2443168	2443169		purU	1
RT5_shotgun	2445426	2445429		rssB	3
RT5_shotgun	2445953	2445958		rssB	5
RT5_shotgun	2447101	2447115		YPO_RS11870	14
RT5_shotgun	2452742	2452744		adhE	2
RT5_shotgun	2453099	2453107		adhE	8
RT5_shotgun	2454907	2454910		adhE	3
RT5_shotgun	2461215	2461221		YPO_RS11920	6
RT5_shotgun	2463023	2463028		YPO_RS11925	5
RT5_shotgun	2463790	2463791		YPO_RS11930	1
RT5_shotgun	2466765	2466770		YPO_RS11945	5
RT5_shotgun	2468117	2468129		YPO_RS11955	12
RT5_shotgun	2470622	2470624		YPO_RS11975	2
RT5_shotgun	2471259	2471274		YPO_RS11975	15
RT5_shotgun	2472400	2472445		YPO_RS11985	45
RT5_shotgun	2472938	2472942		YPO_RS11990	4
RT5_shotgun	2474597	2474601		YPO_RS11995	4
RT5_shotgun	2475845	2475869		YPO_RS12005	24
RT5_shotgun	2477925	2477926		trpA	1
RT5_shotgun	2478607	2478613		trpB	6
RT5_shotgun	2487850	2487853		cobO	3
RT5_shotgun	2490585	2490588		YPO_RS12085	3
RT5_shotgun	2494591	2494592		cysB	1
RT5_shotgun	2494630	2494639		cysB	9
RT5_shotgun	2494747	2494757		cysB	10
RT5_shotgun	2495539	2495546		YPO_RS12105	7
RT5_shotgun	2495984	2496011		YPO_RS12105	27
RT5_shotgun	2496190	2496203		YPO_RS12105	13
RT5_shotgun	2498628	2498637		acnA	9
RT5_shotgun	2499063	2499065		acnA	2
RT5_shotgun	2500509	2500529		pgpB	20
RT5_shotgun	2503178	2503187		YPO_RS12135	9
RT5_shotgun	2506182	2506191		araD	9
RT5_shotgun	2508561	2508563		YPO_RS12175	2
RT5_shotgun	2508631	2508648		YPO_RS12175	17
RT5_shotgun	2509516	2509523		YPO_RS12175	7
RT5_shotgun	2520956	2520972		rsxC	16
RT5_shotgun	2521101	2521122		rsxC	21
RT5_shotgun	2522296	2522300		rsxB	4
RT5_shotgun	2526946	2526968		YPO_RS12245	22
RT5_shotgun	2529843	2529847		YPO_RS12255	4
RT5_shotgun	2531660	2531662		araA	2
RT5_shotgun	2531973	2531974		YPO_RS12265	1
RT5_shotgun	2532738	2532740		YPO_RS12265	2
RT5_shotgun	2535672	2535690		YPO_RS12275	18
RT5_shotgun	2538001	2538005		araC	4
RT5_shotgun	2539886	2539887		YPO_RS12290	1
RT5_shotgun	2540100	2540150		YPO_RS12295	50
RT5_shotgun	2541711	2541731		YPO_RS12300	20
RT5_shotgun	2544073	2544078		manA	5
RT5_shotgun	2546876	2546902		YPO_RS12320	26
RT5_shotgun	2549040	2549140		YPO_RS12325	100
RT5_shotgun	2549374	2549562		YPO_RS12330	188
RT5_shotgun	2549640	2549771		YPO_RS12335	131
RT5_shotgun	2554373	2554633		YPO_RS12355	260
RT5_shotgun	2554658	2555065		YPO_RS12360	407
RT5_shotgun	2555162	2555608		YPO_RS12365	446
RT5_shotgun	2555780	2556832		YPO_RS12370	1052
RT5_shotgun	2556844	2557161		YPO_RS12375	317
RT5_shotgun	2557164	2557415		YPO_RS12380	251
RT5_shotgun	2557451	2557684		YPO_RS12385	233
RT5_shotgun	2557749	2559461		YPO_RS12390	1712
RT5_shotgun	2559474	2559761		YPO_RS12395	287
RT5_shotgun	2559765	2560790		YPO_RS12400	1025
RT5_shotgun	2560790	2562034		YPO_RS12405	1244
RT5_shotgun	2562123	2562371		YPO_RS12410	248
RT5_shotgun	2562568	2562765		YPO_RS12415	197
RT5_shotgun	2563701	2563708		YPO_RS12420	7
RT5_shotgun	2564281	2564285		YPO_RS12420	4
RT5_shotgun	2564453	2564455		YPO_RS12425	2
RT5_shotgun	2564849	2564868		YPO_RS12425	19
RT5_shotgun	2565808	2565832		YPO_RS12435	24
RT5_shotgun	2572034	2572041		YPO_RS12455	7
RT5_shotgun	2575214	2575239		YPO_RS12460	25
RT5_shotgun	2575502	2575510		YPO_RS12460	8
RT5_shotgun	2577181	2577188		YPO_RS12465	7
RT5_shotgun	2580555	2580565		yjjG	10
RT5_shotgun	2582937	2582938		YPO_RS12495	1
RT5_shotgun	2583562	2583570		YPO_RS12495	8
RT5_shotgun	2589940	2589947		pntB	7
RT5_shotgun	2596398	2596402		rstB	4
RT5_shotgun	2599306	2599308		YPO_RS12560	2
RT5_shotgun	2605320	2605322		YPO_RS12580	2
RT5_shotgun	2607167	2607183		YPO_RS12590	16
RT5_shotgun	2611210	2611212		hrpA	2
RT5_shotgun	2614917	2614921		YPO_RS12620	4
RT5_shotgun	2622492	2622495		YPO_RS12655	3
RT5_shotgun	2627865	2627866		ttcA	1
RT5_shotgun	2630107	2630114		YPO_RS12680	7
RT5_shotgun	2630805	2630817		YPO_RS12680	12
RT5_shotgun	2632546	2632564		YPO_RS12690	18
RT5_shotgun	2633869	2633882		YPO_RS12690	13
RT5_shotgun	2638435	2638441		tyrR	6
RT5_shotgun	2638973	2638974		tyrR	1
RT5_shotgun	2646113	2646118		pspF	5
RT5_shotgun	2646420	2646428		YPO_RS12765	8
RT5_shotgun	2647693	2647699		sapA	6
RT5_shotgun	2650342	2650349		sapC	7
RT5_shotgun	2658541	2658576		YPO_RS12815	35
RT5_shotgun	2659155	2659157		YPO_RS12820	2
RT5_shotgun	2663280	2663281		pdxH	1
RT5_shotgun	2664990	2664995		anmK	5
RT5_shotgun	2670801	2670803		eptA	2
RT5_shotgun	2674010	2674013		YPO_RS12890	3
RT5_shotgun	2674917	2674935		YPO_RS12890	18
RT5_shotgun	2675780	2675784		YPO_RS12890	4
RT5_shotgun	2683899	2683900		YPO_RS12940	1
RT5_shotgun	2687471	2687496		YPO_RS12960	25
RT5_shotgun	2688201	2688215		YPO_RS12960	14
RT5_shotgun	2690158	2690164		pykF	6
RT5_shotgun	2690963	2690964		pykF	1
RT5_shotgun	2691724	2691728		YPO_RS12985	4
RT5_shotgun	2696775	2696777		sufS	2
RT5_shotgun	2699603	2699604		sufC	1
RT5_shotgun	2704487	2704488		YPO_RS13040	1
RT5_shotgun	2716239	2716241		YPO_RS13080	2
RT5_shotgun	2717295	2717296		arnE	1
RT5_shotgun	2717540	2717542		arnT	2
RT5_shotgun	2718570	2718572		arnT	2
RT5_shotgun	2720749	2720759		arnA	10
RT5_shotgun	2721430	2721460		arnA	30
RT5_shotgun	2724888	2724891		btuD	3
RT5_shotgun	2725770	2725784		btuC	14
RT5_shotgun	2726007	2726011		btuC	4
RT5_shotgun	2732383	2732387		rpmI	4
RT5_shotgun	2738791	2738804		yfeA	13
RT5_shotgun	2739865	2739885		yfeB	20
RT5_shotgun	2743307	2743341		YPO_RS13230	34
RT5_shotgun	2743816	2743822		YPO_RS13235	6
RT5_shotgun	2743898	2743935		YPO_RS13235	37
RT5_shotgun	2747269	2747270		solA	1
RT5_shotgun	2748690	2748694		YPO_RS13255	4
RT5_shotgun	2755171	2755175		YPO_RS13290	4
RT5_shotgun	2756670	2756681		YPO_RS13295	11
RT5_shotgun	2757536	2757543		YPO_RS13305	7
RT5_shotgun	2759774	2759776		YPO_RS13315	2
RT5_shotgun	2760927	2760936		cas6f	9
RT5_shotgun	2763983	2764002		csy1	19
RT5_shotgun	2772883	2772893		YPO_RS13355	10
RT5_shotgun	2773230	2773233		YPO_RS13355	3
RT5_shotgun	2773298	2773305		YPO_RS13360	7
RT5_shotgun	2773904	2773905		YPO_RS13360	1
RT5_shotgun	2774785	2774791		YPO_RS13365	6
RT5_shotgun	2776497	2776502		YPO_RS13370	5
RT5_shotgun	2776685	2776707		YPO_RS13375	22
RT5_shotgun	2777391	2777392		YPO_RS13375	1
RT5_shotgun	2785406	2785432		YPO_RS13415	26
RT5_shotgun	2786319	2786369		YPO_RS13425	50
RT5_shotgun	2786703	2786704		YPO_RS13430	1
RT5_shotgun	2786825	2786841		YPO_RS13430	16
RT5_shotgun	2788833	2788848		YPO_RS13435	15
RT5_shotgun	2788911	2788920		YPO_RS13435	9
RT5_shotgun	2789812	2789820		YPO_RS13445	8
RT5_shotgun	2790211	2790218		cdiA	7
RT5_shotgun	2794466	2794476		cdiA	10
RT5_shotgun	2795568	2795569		cdiA	1
RT5_shotgun	2801773	2801796		YPO_RS13465	23
RT5_shotgun	2803305	2803312		YPO_RS13470	7
RT5_shotgun	2803596	2803610		YPO_RS13470	14
RT5_shotgun	2808734	2808741		YPO_RS13490	7
RT5_shotgun	2814115	2814127		YPO_RS13510	12
RT5_shotgun	2814184	2814229		YPO_RS13510	45
RT5_shotgun	2814610	2814645		YPO_RS13515	35
RT5_shotgun	2822865	2822870		glnH	5
RT5_shotgun	2825885	2825889		YPO_RS13570	4
RT5_shotgun	2826739	2826754		YPO_RS13575	15
RT5_shotgun	2827584	2827610		YPO_RS13580	26
RT5_shotgun	2827890	2827893		YPO_RS13580	3
RT5_shotgun	2829720	2829728		rlmF	8
RT5_shotgun	2831731	2831733		ybiB	2
RT5_shotgun	2853921	2853938		YPO_RS13690	17
RT5_shotgun	2854178	2854246		YPO_RS13690	68
RT5_shotgun	2871040	2871061		lrhA	21
RT5_shotgun	2875569	2875571		YPO_RS13775	2
RT5_shotgun	2876059	2876064		YPO_RS13775	5
RT5_shotgun	2877629	2877642		YPO_RS13780	13
RT5_shotgun	2878342	2878344		YPO_RS13785	2
RT5_shotgun	2884924	2884926		YPO_RS13810	2
RT5_shotgun	2885757	2885781		YPO_RS13815	24
RT5_shotgun	2888184	2888189		YPO_RS13830	5
RT5_shotgun	2888547	2888555		YPO_RS13830	8
RT5_shotgun	2891215	2891217		YPO_RS13830	2
RT5_shotgun	2894688	2894705		YPO_RS13835	17
RT5_shotgun	2903983	2903992		YPO_RS13865	9
RT5_shotgun	2910283	2910290		iolB	7
RT5_shotgun	2912823	2912847		YPO_RS13905	24
RT5_shotgun	2912893	2912894		YPO_RS13905	1
RT5_shotgun	2913556	2913563		YPO_RS13910	7
RT5_shotgun	2915766	2915768		YPO_RS13925	2
RT5_shotgun	2921355	2921356		YPO_RS13960	1
RT5_shotgun	2924330	2924336		mrdB	6
RT5_shotgun	2927616	2927622		rlmH	6
RT5_shotgun	2930712	2930750		lptE	38
RT5_shotgun	2934921	2934924		YPO_RS14020	3
RT5_shotgun	2935276	2935280		gltK	4
RT5_shotgun	2935563	2935585		gltK	22
RT5_shotgun	2938482	2938483		lnt	1
RT5_shotgun	2940318	2940327		corC	9
RT5_shotgun	2943224	2943227		miaB	3
RT5_shotgun	2943709	2943719		miaB	10
RT5_shotgun	2950134	2950146		YPO_RS14105	12
RT5_shotgun	2954490	2954500		YPO_RS14120	10
RT5_shotgun	2956929	2956930		glnS	1
RT5_shotgun	2969210	2969219		YPO_RS14185	9
RT5_shotgun	2972496	2972524		proX	28
RT5_shotgun	2976483	2976485		nrdF	2
RT5_shotgun	2976813	2976814		nrdF	1
RT5_shotgun	2977264	2977265		nrdE	1
RT5_shotgun	2977371	2977376		nrdE	5
RT5_shotgun	2978228	2978230		nrdE	2
RT5_shotgun	2979163	2979165		nrdI	2
RT5_shotgun	2979448	2979455		nrdI	7
RT5_shotgun	2986326	2986334		YPO_RS14265	8
RT5_shotgun	2989733	2989736		YPO_RS14285	3
RT5_shotgun	2992622	2992645		YPO_RS14300	23
RT5_shotgun	2994955	2994960		ureE	5
RT5_shotgun	3000157	3000232		hdeB	75
RT5_shotgun	3002444	3002473		crcB	29
RT5_shotgun	3008521	3008522		YPO_RS14385	1
RT5_shotgun	3010520	3010553		pgm	33
RT5_shotgun	3011160	3011169		pgm	9
RT5_shotgun	3013212	3013217		kdpE	5
RT5_shotgun	3017530	3017534		kdpB	4
RT5_shotgun	3028498	3028501		pxpA	3
RT5_shotgun	3036262	3036266		srmB	4
RT5_shotgun	3037255	3037264		YPO_RS14530	9
RT5_shotgun	3042139	3042140		YPO_RS14560	1
RT5_shotgun	3042575	3042596		YPO_RS14560	21
RT5_shotgun	3043472	3043477		lepA	5
RT5_shotgun	3045783	3045800		lepB	17
RT5_shotgun	3051355	3051380		tssL	25
RT5_shotgun	3055159	3055177		tssM	18
RT5_shotgun	3056435	3056443		YPO_RS14610	8
RT5_shotgun	3060593	3060602		YPO_RS14625	9
RT5_shotgun	3065555	3065560		YPO_RS14660	5
RT5_shotgun	3065752	3065758		YPO_RS14660	6
RT5_shotgun	3066458	3066463		ccmA	5
RT5_shotgun	3067351	3067362		ccmB	11
RT5_shotgun	3071223	3071240		YPO_RS14690	17
RT5_shotgun	3071832	3071843		YPO_RS14695	11
RT5_shotgun	3071840	3071851		YPO_RS14700	11
RT5_shotgun	3074029	3074053		mlaA	24
RT5_shotgun	3080000	3080015		fadJ	15
RT5_shotgun	3082260	3082267		smrB	7
RT5_shotgun	3083823	3083825		aroC	2
RT5_shotgun	3092975	3092999		YPO_RS14790	24
RT5_shotgun	3098217	3098221		pdxB	4
RT5_shotgun	3101722	3101748		YPO_RS14830	26
RT5_shotgun	3107575	3107581		purF	6
RT5_shotgun	3109190	3109202		hisJ	12
RT5_shotgun	3110129	3110134		YPO_RS14870	5
RT5_shotgun	3111397	3111407		hisP	10
RT5_shotgun	3114117	3114122		YPO_RS14890	5
RT5_shotgun	3114226	3114230		YPO_RS14890	4
RT5_shotgun	3114989	3115003		yfcE	14
RT5_shotgun	3121354	3121381		YPO_RS14925	27
RT5_shotgun	3121678	3121696		YPO_RS14925	18
RT5_shotgun	3122236	3122243		YPO_RS14930	7
RT5_shotgun	3122342	3122384		YPO_RS14930	42
RT5_shotgun	3122479	3122482		YPO_RS14930	3
RT5_shotgun	3126334	3126352		yapC	18
RT5_shotgun	3131563	3131568		YPO_RS14980	5
RT5_shotgun	3132742	3132761		YPO_RS14985	19
RT5_shotgun	3133929	3133939		YPO_RS14990	10
RT5_shotgun	3150360	3150388		YPO_RS15075	28
RT5_shotgun	3150560	3150566		YPO_RS15075	6
RT5_shotgun	3153232	3153242		YPO_RS15105	10
RT5_shotgun	3155374	3155380		purM	6
RT5_shotgun	3159123	3159128		pstB	5
RT5_shotgun	3161501	3161502		YPO_RS15145	1
RT5_shotgun	3165025	3165032		ppk1	7
RT5_shotgun	3174667	3174671		YPO_RS15190	4
RT5_shotgun	3175374	3175376		YPO_RS15190	2
RT5_shotgun	3177034	3177056		YPO_RS15195	22
RT5_shotgun	3177992	3177999		YPO_RS15200	7
RT5_shotgun	3180207	3180217		YPO_RS15205	10
RT5_shotgun	3191272	3191285		YPO_RS15240	13
RT5_shotgun	3197812	3197874		YPO_RS15265	62
RT5_shotgun	3199870	3199875		YPO_RS15280	5
RT5_shotgun	3200336	3200435		YPO_RS15285	99
RT5_shotgun	3200485	3200491		YPO_RS15285	6
RT5_shotgun	3200899	3200909		YPO_RS15290	10
RT5_shotgun	3201127	3201168		YPO_RS15295	41
RT5_shotgun	3201727	3201737		YPO_RS15300	10
RT5_shotgun	3201848	3201901		YPO_RS15300	53
RT5_shotgun	3201931	3201960		YPO_RS15300	29
RT5_shotgun	3202209	3202285		YPO_RS15305	76
RT5_shotgun	3203834	3203841		guaA	7
RT5_shotgun	3205218	3205221		guaB	3
RT5_shotgun	3210132	3210133		der	1
RT5_shotgun	3211245	3211248		der	3
RT5_shotgun	3212523	3212526		bamB	3
RT5_shotgun	3216023	3216026		ispG	3
RT5_shotgun	3217526	3217531		pilW	5
RT5_shotgun	3217797	3217809		pilW	12
RT5_shotgun	3218634	3218650		trmG/rlmN	16
RT5_shotgun	3222627	3222651		YPO_RS15385	24
RT5_shotgun	3223346	3223392		yapA	46
RT5_shotgun	3223545	3223549		yapA	4
RT5_shotgun	3225160	3225172		yapA	12
RT5_shotgun	3227107	3227108		yapA	1
RT5_shotgun	3230916	3230919		YPO_RS15395	3
RT5_shotgun	3232672	3232679		sseB	7
RT5_shotgun	3240612	3240616		iscR	4
RT5_shotgun	3245349	3245352		csiE	3
RT5_shotgun	3262730	3262741		YPO_RS15560	11
RT5_shotgun	3262840	3262853		YPO_RS15560	13
RT5_shotgun	3270405	3270409		yfhb	4
RT5_shotgun	3273301	3273306		YPO_RS15605	5
RT5_shotgun	3278694	3278711		tssK	17
RT5_shotgun	3278792	3278800		tssK	8
RT5_shotgun	3279034	3279045		tssJ	11
RT5_shotgun	3281870	3281878		tssC	8
RT5_shotgun	3284078	3284093		YPO_RS15665	15
RT5_shotgun	3284488	3284491		YPO_RS15665	3
RT5_shotgun	3285362	3285380		YPO_RS15670	18
RT5_shotgun	3285971	3285980		YPO_RS15675	9
RT5_shotgun	3286069	3286074		YPO_RS15675	5
RT5_shotgun	3287092	3287095		YPO_RS15675	3
RT5_shotgun	3287643	3287645		YPO_RS15680	2
RT5_shotgun	3289354	3289358		tssH	4
RT5_shotgun	3289701	3289706		tssH	5
RT5_shotgun	3294134	3294137		tssF	3
RT5_shotgun	3296116	3296125		YPO_RS15705	9
RT5_shotgun	3298610	3298620		YPO_RS15715	10
RT5_shotgun	3301610	3301627		YPO_RS15730	17
RT5_shotgun	3302753	3302820		YPO_RS15735	67
RT5_shotgun	3309554	3309566		YPO_RS15760	12
RT5_shotgun	3313208	3313219		YPO_RS15775	11
RT5_shotgun	3313844	3313848		YPO_RS15775	4
RT5_shotgun	3314268	3314289		YPO_RS15775	21
RT5_shotgun	3335469	3335491		YPO_RS15905	22
RT5_shotgun	3339962	3339964		zipA	2
RT5_shotgun	3341510	3341532		cysZ	22
RT5_shotgun	3351041	3351044		macB	3
RT5_shotgun	3351415	3351423		macB	8
RT5_shotgun	3352936	3352944		YPO_RS15995	8
RT5_shotgun	3354974	3355080		YPO_RS16000	106
RT5_shotgun	3355890	3355893		YPO_RS16005	3
RT5_shotgun	3356711	3356712		YPO_RS16010	1
RT5_shotgun	3357243	3357265		YPO_RS16015	22
RT5_shotgun	3358314	3358318		YPO_RS16020	4
RT5_shotgun	3359409	3359410		YPO_RS16025	1
RT5_shotgun	3361015	3361025		YPO_RS16030	10
RT5_shotgun	3361422	3361423		YPO_RS16030	1
RT5_shotgun	3363837	3363843		YPO_RS16040	6
RT5_shotgun	3364159	3364160		YPO_RS16040	1
RT5_shotgun	3364528	3364560		YPO_RS16040	32
RT5_shotgun	3368750	3368753		cysT	3
RT5_shotgun	3376637	3376642		YPO_RS16095	5
RT5_shotgun	3377577	3377584		YPO_RS16100	7
RT5_shotgun	3377626	3377628		YPO_RS16100	2
RT5_shotgun	3382233	3382238		yapL	5
RT5_shotgun	3382294	3382296		yapL	2
RT5_shotgun	3383727	3383767		YPO_RS16125	40
RT5_shotgun	3391869	3391874		napA	5
RT5_shotgun	3395753	3395759		YPO_RS16180	6
RT5_shotgun	3397182	3397183		acrD	1
RT5_shotgun	3399839	3399848		YPO_RS16195	9
RT5_shotgun	3403013	3403026		YPO_RS16205	13
RT5_shotgun	3408079	3408082		YPO_RS16225	3
RT5_shotgun	3408783	3408793		YPO_RS16230	10
RT5_shotgun	3410104	3410111		YPO_RS16235	7
RT5_shotgun	3412318	3412326		YPO_RS16250	8
RT5_shotgun	3426947	3426959		hda	12
RT5_shotgun	3429930	3429935		cysS	5
RT5_shotgun	3435453	3435457		YPO_RS16360	4
RT5_shotgun	3436134	3436139		YPO_RS16365	5
RT5_shotgun	3437073	3437078		tesA	5
RT5_shotgun	3440245	3440272		YPO_RS16385	27
RT5_shotgun	3446793	3446842		YPO_RS16415	49
RT5_shotgun	3450020	3450028		YPO_RS16425	8
RT5_shotgun	3454440	3454462		fepE	22
RT5_shotgun	3454777	3454824		fepE	47
RT5_shotgun	3454955	3454961		fepE	6
RT5_shotgun	3455907	3455913		cpsG	6
RT5_shotgun	3456169	3456174		cpsG	5
RT5_shotgun	3456526	3456563		YPO_RS16450	37
RT5_shotgun	3456678	3456689		YPO_RS16450	11
RT5_shotgun	3456773	3456841		YPO_RS16450	68
RT5_shotgun	3457109	3457122		YPO_RS16450	13
RT5_shotgun	3457211	3457220		YPO_RS16455	9
RT5_shotgun	3457648	3457649		YPO_RS16455	1
RT5_shotgun	3461813	3461826		YPO_RS16470	13
RT5_shotgun	3463760	3463800		YPO_RS16480	40
RT5_shotgun	3463966	3463983		YPO_RS16480	17
RT5_shotgun	3464312	3464314		YPO_RS16480	2
RT5_shotgun	3464992	3464994		YPO_RS16485	2
RT5_shotgun	3465051	3465150		YPO_RS16485	99
RT5_shotgun	3465319	3465330		YPO_RS16485	11
RT5_shotgun	3465412	3465439		YPO_RS16485	27
RT5_shotgun	3465501	3465556		YPO_RS16485	55
RT5_shotgun	3465567	3465584		YPO_RS16490	17
RT5_shotgun	3465864	3465870		YPO_RS16490	6
RT5_shotgun	3466586	3466626		YPO_RS16490	40
RT5_shotgun	3467231	3467234		YPO_RS16495	3
RT5_shotgun	3467535	3467552		YPO_RS16495	17
RT5_shotgun	3470493	3470547		rfbG	54
RT5_shotgun	3471732	3471746		rfbF	14
RT5_shotgun	3472128	3472137		rfbF	9
RT5_shotgun	3473057	3473134		YPO_RS16520	77
RT5_shotgun	3476396	3476398		htpG	2
RT5_shotgun	3486237	3486245		mscK	8
RT5_shotgun	3487398	3487448		mscK	50
RT5_shotgun	3491552	3491571		YPO_RS16600	19
RT5_shotgun	3500935	3500955		tesB	20
RT5_shotgun	3507437	3507449		YPO_RS16675	12
RT5_shotgun	3508528	3508543		YPO_RS16680	15
RT5_shotgun	3509082	3509092		cof	10
RT5_shotgun	3512910	3512913		YPO_RS16700	3
RT5_shotgun	3514644	3514653		ppiD	9
RT5_shotgun	3517640	3517658		lon	18
RT5_shotgun	3524075	3524077		YPO_RS16745	2
RT5_shotgun	3524935	3524949		ampG	14
RT5_shotgun	3525639	3525653		ampG	14
RT5_shotgun	3528017	3528018		cyoA	1
RT5_shotgun	3529141	3529151		cyoB	10
RT5_shotgun	3531896	3531904		cyoE	8
RT5_shotgun	3534622	3534628		YPO_RS16790	6
RT5_shotgun	3542747	3542780		pgpA	33
RT5_shotgun	3548139	3548159		YPO_RS16865	20
RT5_shotgun	3548266	3548292		YPO_RS16865	26
RT5_shotgun	3549313	3549320		secF	7
RT5_shotgun	3552401	3552424		yajC	23
RT5_shotgun	3557183	3557185		YPO_RS16910	2
RT5_shotgun	3559829	3559842		YPO_RS16920	13
RT5_shotgun	3563745	3563775		proY	30
RT5_shotgun	3565270	3565273		brnQ	3
RT5_shotgun	3572036	3572039		YPO_RS16965	3
RT5_shotgun	3572180	3572183		YPO_RS16965	3
RT5_shotgun	3574190	3574206		YPO_RS16965	16
RT5_shotgun	3574366	3574381		YPO_RS16965	15
RT5_shotgun	3574416	3574422		YPO_RS16965	6
RT5_shotgun	3582249	3582256		YPO_RS17005	7
RT5_shotgun	3582292	3582298		YPO_RS17005	6
RT5_shotgun	3583930	3583934		YPO_RS17015	4
RT5_shotgun	3584063	3584078		YPO_RS17015	15
RT5_shotgun	3585549	3585556		proA	7
RT5_shotgun	3590787	3590793		YPO_RS17050	6
RT5_shotgun	3592483	3592519		YPO_RS17055	36
RT5_shotgun	3595441	3595443		pepD	2
RT5_shotgun	3595822	3595824		pepD	2
RT5_shotgun	3595924	3595934		pepD	10
RT5_shotgun	3597327	3597333		dinB	6
RT5_shotgun	3598507	3598531		YPO_RS17070	24
RT5_shotgun	3599610	3599617		YPO_RS17080	7
RT5_shotgun	3599900	3599904		YPO_RS17080	4
RT5_shotgun	3600452	3600456		YPO_RS17080	4
RT5_shotgun	3601130	3601141		nqrF	11
RT5_shotgun	3604631	3604642		YPO_RS17105	11
RT5_shotgun	3605202	3605211		YPO_RS17110	9
RT5_shotgun	3611537	3611541		YPO_RS17130	4
RT5_shotgun	3614920	3614954		YPO_RS17145	34
RT5_shotgun	3619086	3619098		YPO_RS17145	12
RT5_shotgun	3621400	3621416		YPO_RS17150	16
RT5_shotgun	3621868	3621869		YPO_RS17150	1
RT5_shotgun	3629875	3629883		YPO_RS17195	8
RT5_shotgun	3640476	3640480		emrB	4
RT5_shotgun	3646460	3646464		YPO_RS17270	4
RT5_shotgun	3646945	3646946		pssA	1
RT5_shotgun	3647752	3647766		pssA	14
RT5_shotgun	3649886	3649887		YPO_RS17290	1
RT5_shotgun	3649925	3649936		YPO_RS17290	11
RT5_shotgun	3655113	3655119		clpB	6
RT5_shotgun	3658365	3658386		rluD	21
RT5_shotgun	3658805	3658827		rluD	22
RT5_shotgun	3661290	3661304		YPO_RS17340	14
RT5_shotgun	3662695	3662697		pheA	2
RT5_shotgun	3665530	3665536		tyrA	6
RT5_shotgun	3667889	3667890		yehT	1
RT5_shotgun	3671360	3671420		YPO_RS17390	60
RT5_shotgun	3671535	3671568		YPO_RS17390	33
RT5_shotgun	3676303	3676344		YPO_RS17420	41
RT5_shotgun	3685777	3685792		alaS	15
RT5_shotgun	3686692	3686702		recX	10
RT5_shotgun	3687021	3687030		recX	9
RT5_shotgun	3690503	3690512		YPO_RS17505	9
RT5_shotgun	3690945	3690954		YPO_RS17510	9
RT5_shotgun	3695387	3695390		YPO_RS17525	3
RT5_shotgun	3696937	3696939		YPO_RS17535	2
RT5_shotgun	3703329	3703334		katG	5
RT5_shotgun	3703716	3703725		katG	9
RT5_shotgun	3704130	3704154		cybC	24
RT5_shotgun	3705344	3705364		dmsD	20
RT5_shotgun	3709453	3709455		dmsA	2
RT5_shotgun	3714406	3714416		YPO_RS17605	10
RT5_shotgun	3714551	3714570		YPO_RS17605	19
RT5_shotgun	3716700	3716710		YPO_RS17615	10
RT5_shotgun	3724659	3724665		YPO_RS17650	6
RT5_shotgun	3724749	3724755		YPO_RS17650	6
RT5_shotgun	3725194	3725202		YPO_RS17650	8
RT5_shotgun	3725634	3725638		YPO_RS17650	4
RT5_shotgun	3729018	3729025		YPO_RS17665	7
RT5_shotgun	3730442	3730454		YPO_RS17670	12
RT5_shotgun	3730943	3730944		YPO_RS17670	1
RT5_shotgun	3733050	3733065		arsB	15
RT5_shotgun	3746164	3746187		nlpD	23
RT5_shotgun	3759548	3759555		cysI	7
RT5_shotgun	3771236	3771240		YPO_RS17870	4
RT5_shotgun	3773096	3773097		barA	1
RT5_shotgun	3774353	3774390		degP	37
RT5_shotgun	3776893	3776899		dgt	6
RT5_shotgun	3781288	3781297		clcA	9
RT5_shotgun	3782708	3782710		hemL	2
RT5_shotgun	3785114	3785122		fhuB	8
RT5_shotgun	3786083	3786094		fhuB	11
RT5_shotgun	3788924	3788932		mrcB	8
RT5_shotgun	3789945	3789960		mrcB	15
RT5_shotgun	3803862	3803865		YPO_RS17995	3
RT5_shotgun	3804797	3804809		YPO_RS18000	12
RT5_shotgun	3805555	3805588		can	33
RT5_shotgun	3806400	3806406		hpt	6
RT5_shotgun	3806671	3806674		hpt	3
RT5_shotgun	3809070	3809071		YPO_RS18020	1
RT5_shotgun	3810437	3810445		speD	8
RT5_shotgun	3817419	3817429		lpdA	10
RT5_shotgun	3819391	3819395		aceF	4
RT5_shotgun	3822273	3822282		aceE	9
RT5_shotgun	3822931	3822935		aceE	4
RT5_shotgun	3827865	3827867		ampD	2
RT5_shotgun	3831228	3831244		gspE	16
RT5_shotgun	3834033	3834037		YPO_RS18110	4
RT5_shotgun	3835087	3835098		coaE	11
RT5_shotgun	3835095	3835101		zapD	6
RT5_shotgun	3836513	3836515		YPO_RS18130	2
RT5_shotgun	3837966	3837970		YPO_RS18135	4
RT5_shotgun	3838316	3838322		YPO_RS18140	6
RT5_shotgun	3838505	3838507		YPO_RS18140	2
RT5_shotgun	3839096	3839109		YPO_RS18145	13
RT5_shotgun	3839490	3839495		YPO_RS18145	5
RT5_shotgun	3840806	3840809		YPO_RS18150	3
RT5_shotgun	3845734	3845737		lptF	3
RT5_shotgun	3852377	3852380		rraB	3
RT5_shotgun	3862610	3862633		nrdD	23
RT5_shotgun	3867541	3867542		YPO_RS18265	1
RT5_shotgun	3869792	3869797		phnL	5
RT5_shotgun	3871749	3871753		phnP	4
RT5_shotgun	3880567	3880570		YPO_RS18330	3
RT5_shotgun	3881169	3881173		YPO_RS18335	4
RT5_shotgun	3895819	3895825		YPO_RS18400	6
RT5_shotgun	3896867	3896873		YPO_RS18400	6
RT5_shotgun	3901266	3901295		YPO_RS18420	29
RT5_shotgun	3901354	3901363		YPO_RS18420	9
RT5_shotgun	3902099	3902105		YPO_RS18420	6
RT5_shotgun	3908594	3908614		rimP	20
RT5_shotgun	3911177	3911184		glmM	7
RT5_shotgun	3911357	3911368		folP	11
RT5_shotgun	3912385	3912387		ftsH	2
RT5_shotgun	3913892	3913893		ftsH	1
RT5_shotgun	3928415	3928442		mpl	27
RT5_shotgun	3928955	3928964		mpl	9
RT5_shotgun	3934910	3934918		YPO_RS18585	8
RT5_shotgun	3934975	3934991		YPO_RS18585	16
RT5_shotgun	3939041	3939070		YPO_RS18600	29
RT5_shotgun	3942423	3942430		YPO_RS18620	7
RT5_shotgun	3945911	3945924		YPO_RS18635	13
RT5_shotgun	3947052	3947061		YPO_RS18640	9
RT5_shotgun	3947697	3947704		YPO_RS18645	7
RT5_shotgun	3950383	3950391		yjfP	8
RT5_shotgun	3951182	3951189		YPO_RS18675	7
RT5_shotgun	3952092	3952097		YPO_RS18680	5
RT5_shotgun	3968932	3968953		gltB	21
RT5_shotgun	3970934	3970940		gltB	6
RT5_shotgun	3971219	3971227		gltB	8
RT5_shotgun	3975543	3975553		YPO_RS18775	10
RT5_shotgun	3975841	3975844		rpsI	3
RT5_shotgun	3980370	3980375		YPO_RS18805	5
RT5_shotgun	3981988	3981993		degS	5
RT5_shotgun	3986766	3986776		mlaF	10
RT5_shotgun	3991287	3991291		lptA	4
RT5_shotgun	3992839	3992840		rpoN	1
RT5_shotgun	4000171	4000177		YPO_RS18925	6
RT5_shotgun	4007599	4007602		tssH	3
RT5_shotgun	4008629	4008635		tssH	6
RT5_shotgun	4013990	4013995		tssM	5
RT5_shotgun	4020411	4020426		YPO_RS19010	15
RT5_shotgun	4024770	4024772		YPO_RS19020	2
RT5_shotgun	4033596	4033603		YPO_RS19060	7
RT5_shotgun	4033974	4033986		YPO_RS19060	12
RT5_shotgun	4036023	4036062		YPO_RS19075	39
RT5_shotgun	4039367	4039382		YPO_RS19090	15
RT5_shotgun	4046607	4046612		YPO_RS19135	5
RT5_shotgun	4048612	4048625		YPO_RS19140	13
RT5_shotgun	4050540	4050548		YPO_RS19145	8
RT5_shotgun	4051098	4051107		YPO_RS19145	9
RT5_shotgun	4053745	4053756		YPO_RS19155	11
RT5_shotgun	4054213	4054219		YPO_RS19155	6
RT5_shotgun	4055305	4055311		YPO_RS19160	6
RT5_shotgun	4057564	4057586		YPO_RS19170	22
RT5_shotgun	4059434	4059452		YPO_RS19175	18
RT5_shotgun	4067960	4067965		YPO_RS19220	5
RT5_shotgun	4071008	4071038		YPO_RS19235	30
RT5_shotgun	4072049	4072053		YPO_RS19245	4
RT5_shotgun	4087358	4087377		YPO_RS19325	19
RT5_shotgun	4089366	4089369		mreC	3
RT5_shotgun	4090125	4090128		YPO_RS19340	3
RT5_shotgun	4091531	4091535		rng	4
RT5_shotgun	4098633	4098680		YPO_RS19365	47
RT5_shotgun	4098804	4098857		YPO_RS19365	53
RT5_shotgun	4098976	4098992		YPO_RS19365	16
RT5_shotgun	4099407	4099443		YPO_RS19365	36
RT5_shotgun	4102374	4102388		YPO_RS19370	14
RT5_shotgun	4106341	4106347		YPO_RS19390	6
RT5_shotgun	4107010	4107022		YPO_RS19390	12
RT5_shotgun	4110509	4110511		YPO_RS19395	2
RT5_shotgun	4110664	4110672		YPO_RS19395	8
RT5_shotgun	4112230	4112232		YPO_RS19395	2
RT5_shotgun	4113658	4113696		YPO_RS19400	38
RT5_shotgun	4115104	4115105		YPO_RS19405	1
RT5_shotgun	4116773	4116799		YPO_RS19410	26
RT5_shotgun	4117132	4117177		YPO_RS19410	45
RT5_shotgun	4117257	4117261		YPO_RS19410	4
RT5_shotgun	4124085	4124087		YPO_RS19440	2
RT5_shotgun	4130829	4130831		treC	2
RT5_shotgun	4131091	4131114		treC	23
RT5_shotgun	4131944	4131947		treB	3
RT5_shotgun	4144279	4144284		malM	5
RT5_shotgun	4153261	4153266		pgi	5
RT5_shotgun	4160249	4160251		YPO_RS19595	2
RT5_shotgun	4162743	4162762		YPO_RS19595	19
RT5_shotgun	4162804	4162816		YPO_RS19595	12
RT5_shotgun	4170945	4170957		aceA	12
RT5_shotgun	4173479	4173484		metA	5
RT5_shotgun	4176209	4176224		YPO_RS19645	15
RT5_shotgun	4185423	4185426		YPO_RS19690	3
RT5_shotgun	4186951	4186960		hemE	9
RT5_shotgun	4188315	4188324		YPO_RS19705	9
RT5_shotgun	4194772	4194780		YPO_RS19740	8
RT5_shotgun	4200688	4200691		rpoC	3
RT5_shotgun	4205426	4205435		rpoB	9
RT5_shotgun	4208862	4208880		nusG	18
RT5_shotgun	4216466	4216470		birA	4
RT5_shotgun	4217227	4217263		murB	36
RT5_shotgun	4223118	4223151		YPO_RS19870	33
RT5_shotgun	4225461	4225469		trkH	8
RT5_shotgun	4226988	4226992		YPO_RS19900	4
RT5_shotgun	4227995	4227999		pepQ	4
RT5_shotgun	4231078	4231081		fadA	3
RT5_shotgun	4233242	4233255		ubiD	13
RT5_shotgun	4233506	4233508		ubiD	2
RT5_shotgun	4235787	4235794		hemB	7
RT5_shotgun	4239533	4239542		tatC	9
RT5_shotgun	4241575	4241589		ubiB	14
RT5_shotgun	4242059	4242063		ubiB	4
RT5_shotgun	4245654	4245660		rmuC	6
RT5_shotgun	4246519	4246533		YPO_RS19995	14
RT5_shotgun	4248267	4248269		YPO_RS20000	2
RT5_shotgun	4248584	4248588		YPO_RS20000	4
RT5_shotgun	4250708	4250710		udp	2
RT5_shotgun	4253541	4253543		metE	2
RT5_shotgun	4256180	4256191		YPO_RS20030	11
RT5_shotgun	4260209	4260219		ugpE	10
RT5_shotgun	4263490	4263518		YPO_RS20065	28
RT5_shotgun	4264249	4264250		YPO_RS20070	1
RT5_shotgun	4265156	4265161		YPO_RS20070	5
RT5_shotgun	4266843	4266844		YPO_RS20075	1
RT5_shotgun	4269669	4269690		YPO_RS20095	21
RT5_shotgun	4277155	4277167		rpoH	12
RT5_shotgun	4282218	4282219		rsmD	1
RT5_shotgun	4284390	4284401		YPO_RS20175	11
RT5_shotgun	4285215	4285220		YPO_RS20180	5
RT5_shotgun	4288228	4288233		YPO_RS20190	5
RT5_shotgun	4293030	4293037		glpA	7
RT5_shotgun	4302575	4302587		pldA	12
RT5_shotgun	4303085	4303086		pldA	1
RT5_shotgun	4330972	4330996		YPO_RS20395	24
RT5_shotgun	4342979	4342983		rho	4
RT5_shotgun	4343954	4343959		rhlB	5
RT5_shotgun	4350336	4350338		YPO_RS20480	2
RT5_shotgun	4351318	4351319		YPO_RS20485	1
RT5_shotgun	4354353	4354357		YPO_RS20500	4
RT5_shotgun	4356062	4356063		YPO_RS20500	1
RT5_shotgun	4357454	4357459		stbD	5
RT5_shotgun	4359759	4359770		YPO_RS20520	11
RT5_shotgun	4360257	4360292		YPO_RS20525	35
RT5_shotgun	4360801	4360805		YPO_RS20530	4
RT5_shotgun	4365266	4365287		YPO_RS20550	21
RT5_shotgun	4381738	4381743		YPO_RS20635	5
RT5_shotgun	4382635	4382660		YPO_RS20640	25
RT5_shotgun	4389733	4389736		YPO_RS20670	3
RT5_shotgun	4394871	4394876		YPO_RS20695	5
RT5_shotgun	4399283	4399288		YPO_RS20720	5
RT5_shotgun	4405599	4405601		YPO_RS20740	2
RT5_shotgun	4407557	4407563		YPO_RS20745	6
RT5_shotgun	4417675	4417693		YPO_RS20775	18
RT5_shotgun	4421272	4421281		glpD	9
RT5_shotgun	4421963	4421987		glpD	24
RT5_shotgun	4422896	4422901		glgP	5
RT5_shotgun	4426089	4426093		glgA	4
RT5_shotgun	4436872	4436894		YPO_RS20830	22
RT5_shotgun	4437146	4437172		YPO_RS20830	26
RT5_shotgun	4437950	4437956		YPO_RS20830	6
RT5_shotgun	4441248	4441257		YPO_RS20830	9
RT5_shotgun	4444022	4444023		YPO_RS20830	1
RT5_shotgun	4450284	4450290		YPO_RS20875	6
RT5_shotgun	4459411	4459417		YPO_RS20925	6
RT5_shotgun	4463327	4463328		YPO_RS20940	1
RT5_shotgun	4472533	4472538		YPO_RS20975	5
RT5_shotgun	4472612	4472626		YPO_RS20975	14
RT5_shotgun	4473111	4473118		YPO_RS20975	7
RT5_shotgun	4473473	4473479		YPO_RS20975	6
RT5_shotgun	4477815	4477832		YPO_RS20990	17
RT5_shotgun	4478399	4478419		gorA	20
RT5_shotgun	4480653	4480661		YPO_RS21000	8
RT5_shotgun	4480653	4480661		YPO_RS21005	8
RT5_shotgun	4483157	4483162		YPO_RS21015	5
RT5_shotgun	4483675	4483678		YPO_RS21020	3
RT5_shotgun	4484821	4484835		YPO_RS21030	14
RT5_shotgun	4485283	4485288		YPO_RS21030	5
RT5_shotgun	4486102	4486109		yapE	7
RT5_shotgun	4490569	4490585		YPO_RS21045	16
RT5_shotgun	4490788	4490809		YPO_RS21045	21
RT5_shotgun	4497655	4497657		YPO_RS21070	2
RT5_shotgun	4498772	4498783		YPO_RS21075	11
RT5_shotgun	4502931	4502939		YPO_RS21090	8
RT5_shotgun	4514642	4514650		YPO_RS21135	8
RT5_shotgun	4516732	4516771		YPO_RS21140	39
RT5_shotgun	4517343	4517363		YPO_RS21140	20
RT5_shotgun	4524160	4524177		eptB	17
RT5_shotgun	4524593	4524597		eptB	4
RT5_shotgun	4527757	4527762		YPO_RS21190	5
RT5_shotgun	4528690	4528691		YPO_RS21190	1
RT5_shotgun	4534059	4534069		YPO_RS21205	10
RT5_shotgun	4534290	4534306		YPO_RS21205	16
RT5_shotgun	4534687	4534710		YPO_RS21210	23
RT5_shotgun	4535141	4535160		YPO_RS21215	19
RT5_shotgun	4545318	4545331		YPO_RS21280	13
RT5_shotgun	4545366	4545394		YPO_RS21280	28
RT5_shotgun	4545676	4545695		YPO_RS21280	19
RT5_shotgun	4545875	4545897		YPO_RS21280	22
RT5_shotgun	4546116	4546130		YPO_RS21280	14
RT5_shotgun	4552010	4552015		YPO_RS21305	5
RT5_shotgun	4557596	4557608		YPO_RS21325	12
RT5_shotgun	4558343	4558349		YPO_RS21330	6
RT5_shotgun	4563863	4563865		YPO_RS21350	2
RT5_shotgun	4564212	4564228		YPO_RS21355	16
RT5_shotgun	4568590	4568605		YPO_RS21380	15
RT5_shotgun	4575273	4575278		fdxH	5
RT5_shotgun	4577590	4577595		fdnG	5
RT5_shotgun	4580256	4580271		sodA	15
RT5_shotgun	4581368	4581376		YPO_RS21435	8
RT5_shotgun	4581886	4581889		YPO_RS21435	3
RT5_shotgun	4584350	4584352		YPO_RS21445	2
RT5_shotgun	4586996	4587001		YPO_RS21460	5
RT5_shotgun	4596329	4596333		YPO_RS21500	4
RT5_shotgun	4601003	4601008		YPO_RS21515	5
RT5_shotgun	4601643	4601709		YPO_RS21520	66
RT5_shotgun	4604907	4604909		YPO_RS21530	2
RT5_shotgun	4610881	4610897		YPO_RS21565	16
RT5_shotgun	4611634	4611646		YPO_RS21565	12
RT5_shotgun	4612891	4612909		yidA	18
RT5_shotgun	4615071	4615076		gyrB	5
RT5_shotgun	4620970	4620988		yidD	18
RT5_shotgun	4623746	4623754		mnmE	8
RT5_shotgun	4626527	4626528		YPO_RS21635	1
RT5_shotgun	4626786	4626814		YPO_RS21635	28
RT5_shotgun	4633305	4633335		YPO_RS21670	30
RT5_shotgun	4636227	4636230		pstA	3
RT5_shotgun	4636671	4636685		pstC	14
RT5_shotgun	4644288	4644299		atpD	11
RT5_shotgun	4652729	4652743		mnmG	14
RV2039_libmerged	839	840		asnC	1
RV2039_libmerged	879	912		asnC	33
RV2039_libmerged	1139	1154		asnC	15
RV2039_libmerged	1258	1265		asnC	7
RV2039_libmerged	1718	1720		YPO_RS01015	2
RV2039_libmerged	1757	1764		YPO_RS01015	7
RV2039_libmerged	2599	2600		viaA	1
RV2039_libmerged	2771	2774		viaA	3
RV2039_libmerged	2847	2851		viaA	4
RV2039_libmerged	2883	2884		viaA	1
RV2039_libmerged	3921	3930		viaA	9
RV2039_libmerged	4563	4565		ravA	2
RV2039_libmerged	5314	5330		ravA	16
RV2039_libmerged	6482	6486		kup	4
RV2039_libmerged	6587	6594		kup	7
RV2039_libmerged	7184	7239		kup	55
RV2039_libmerged	7662	7667		kup	5
RV2039_libmerged	9370	9382		YPO_RS01045	12
RV2039_libmerged	9370	9383		YPO_RS01050	13
RV2039_libmerged	9626	9637		YPO_RS01055	11
RV2039_libmerged	9845	9852		YPO_RS01055	7
RV2039_libmerged	9911	9950		YPO_RS01055	39
RV2039_libmerged	10304	10329		YPO_RS01055	25
RV2039_libmerged	10436	10446		YPO_RS01055	10
RV2039_libmerged	11097	11145		YPO_RS01060	48
RV2039_libmerged	12177	12193		YPO_RS01065	16
RV2039_libmerged	14915	14921		YPO_RS01080	6
RV2039_libmerged	18596	18648		YPO_RS01090	52
RV2039_libmerged	19175	19220		mobB	45
RV2039_libmerged	19716	19728		mobA	12
RV2039_libmerged	19827	19841		mobA	14
RV2039_libmerged	20171	20182		mobA	11
RV2039_libmerged	21806	21811		dsbA	5
RV2039_libmerged	21960	21978		dsbA	18
RV2039_libmerged	22326	22363		dsbA	37
RV2039_libmerged	23068	23091		polA	23
RV2039_libmerged	23376	23388		polA	12
RV2039_libmerged	23649	23677		polA	28
RV2039_libmerged	24439	24470		polA	31
RV2039_libmerged	25659	25669		polA	10
RV2039_libmerged	26128	26154		YPO_RS01125	26
RV2039_libmerged	26206	26209		YPO_RS01125	3
RV2039_libmerged	26569	26586		YPO_RS01125	17
RV2039_libmerged	29044	29046		hemN	2
RV2039_libmerged	29315	29320		hemN	5
RV2039_libmerged	29822	29826		hemN	4
RV2039_libmerged	30724	30728		glnG	4
RV2039_libmerged	31654	31655		glnG	1
RV2039_libmerged	32152	32165		glnL	13
RV2039_libmerged	32808	32826		glnL	18
RV2039_libmerged	33216	33221		glnA	5
RV2039_libmerged	33715	33718		glnA	3
RV2039_libmerged	34096	34113		glnA	17
RV2039_libmerged	35156	35163		typA	7
RV2039_libmerged	35282	35288		typA	6
RV2039_libmerged	36676	36680		typA	4
RV2039_libmerged	37247	37251		yihX	4
RV2039_libmerged	37806	37821		yihX	15
RV2039_libmerged	38653	38681		YPO_RS01170	28
RV2039_libmerged	39259	39262		dtd	3
RV2039_libmerged	39350	39459		YPO_RS01180	109
RV2039_libmerged	39610	39654		YPO_RS01180	44
RV2039_libmerged	39755	39793		YPO_RS01180	38
RV2039_libmerged	40143	40183		YPO_RS01185	40
RV2039_libmerged	40232	40248		YPO_RS01185	16
RV2039_libmerged	40437	40493		YPO_RS01185	56
RV2039_libmerged	40990	41023		YPO_RS01185	33
RV2039_libmerged	41098	41120		YPO_RS01185	22
RV2039_libmerged	43260	43261		YPO_RS01195	1
RV2039_libmerged	44455	44461		YPO_RS01200	6
RV2039_libmerged	44583	44590		YPO_RS01200	7
RV2039_libmerged	45157	45166		YPO_RS01200	9
RV2039_libmerged	46266	46273		gltS	7
RV2039_libmerged	49280	49285		recG	5
RV2039_libmerged	49445	49448		recG	3
RV2039_libmerged	50654	50663		spoT	9
RV2039_libmerged	51467	51504		spoT	37
RV2039_libmerged	53117	53120		gmk	3
RV2039_libmerged	54025	54034		ligB	9
RV2039_libmerged	55177	55182		ligB	5
RV2039_libmerged	55879	55901		YPO_RS01245	22
RV2039_libmerged	56093	56102		YPO_RS01245	9
RV2039_libmerged	56895	56898		YPO_RS01250	3
RV2039_libmerged	57853	57854		rph	1
RV2039_libmerged	57884	57886		rph	2
RV2039_libmerged	59928	59949		dut	21
RV2039_libmerged	60423	60479		coaBC	56
RV2039_libmerged	60764	60779		coaBC	15
RV2039_libmerged	60813	60814		coaBC	1
RV2039_libmerged	61956	61959		YPO_RS01280	3
RV2039_libmerged	62967	62989		rpmG	22
RV2039_libmerged	63076	63080		rpmG	4
RV2039_libmerged	63390	63402		mutM	12
RV2039_libmerged	64575	64588		YPO_RS01310	13
RV2039_libmerged	69517	69532		rfaD	15
RV2039_libmerged	69843	69890		rfaD	47
RV2039_libmerged	70520	70522		YPO_RS01335	2
RV2039_libmerged	71255	71259		YPO_RS01335	4
RV2039_libmerged	71536	71550		tdh	14
RV2039_libmerged	71976	71982		tdh	6
RV2039_libmerged	76098	76117		gpmM	19
RV2039_libmerged	76239	76243		gpmM	4
RV2039_libmerged	77420	77425		grxC	5
RV2039_libmerged	78155	78160		secB	5
RV2039_libmerged	78194	78200		secB	6
RV2039_libmerged	78335	78338		gpsA	3
RV2039_libmerged	79056	79071		gpsA	15
RV2039_libmerged	79597	79603		cysE	6
RV2039_libmerged	80290	80313		cysE	23
RV2039_libmerged	81611	81626		ada	15
RV2039_libmerged	82501	82503		cpxA	2
RV2039_libmerged	83179	83196		cpxA	17
RV2039_libmerged	84078	84082		cpxR	4
RV2039_libmerged	87550	87552		fieF	2
RV2039_libmerged	88037	88041		fieF	4
RV2039_libmerged	88573	88597		pfkA	24
RV2039_libmerged	89565	89568		YPO_RS01435	3
RV2039_libmerged	89610	89670		YPO_RS01435	60
RV2039_libmerged	90335	90341		YPO_RS01435	6
RV2039_libmerged	91064	91077		YPO_RS01440	13
RV2039_libmerged	91626	91640		YPO_RS01445	14
RV2039_libmerged	92648	92656		YPO_RS01445	8
RV2039_libmerged	93253	93305		ligK	52
RV2039_libmerged	96886	96913		tpiA	27
RV2039_libmerged	97627	97652		YPO_RS01470	25
RV2039_libmerged	101532	101562		YPO_RS01495	30
RV2039_libmerged	101957	101978		YPO_RS01495	21
RV2039_libmerged	103568	103586		YPO_RS01505	18
RV2039_libmerged	103669	103825		YPO_RS01505	156
RV2039_libmerged	103860	103878		YPO_RS01505	18
RV2039_libmerged	105645	105649		YPO_RS01515	4
RV2039_libmerged	105733	105770		YPO_RS01515	37
RV2039_libmerged	105967	106114		YPO_RS01515	147
RV2039_libmerged	106156	106239		YPO_RS01515	83
RV2039_libmerged	106277	106335		YPO_RS01515	58
RV2039_libmerged	106410	106424		YPO_RS01515	14
RV2039_libmerged	106424	106461		YPO_RS01520	37
RV2039_libmerged	106513	106537		YPO_RS01520	24
RV2039_libmerged	106582	106605		YPO_RS01520	23
RV2039_libmerged	106705	106895		YPO_RS01520	190
RV2039_libmerged	107135	107193		YPO_RS01520	58
RV2039_libmerged	107265	107278		YPO_RS01520	13
RV2039_libmerged	107346	107373		YPO_RS01520	27
RV2039_libmerged	108699	108708		YPO_RS01530	9
RV2039_libmerged	109039	109047		YPO_RS01530	8
RV2039_libmerged	109111	109113		YPO_RS01530	2
RV2039_libmerged	111485	111496		rraA	11
RV2039_libmerged	112183	112214		YPO_RS01550	31
RV2039_libmerged	112532	112536		YPO_RS01550	4
RV2039_libmerged	113341	113343		hslU	2
RV2039_libmerged	114615	114625		hslV	10
RV2039_libmerged	115239	115248		ftsN	9
RV2039_libmerged	115781	115788		ftsN	7
RV2039_libmerged	115964	115989		ftsN	25
RV2039_libmerged	119228	119257		priA	29
RV2039_libmerged	123497	123505		YPO_RS01600	8
RV2039_libmerged	123957	123962		YPO_RS01600	5
RV2039_libmerged	124615	124618		YPO_RS01600	3
RV2039_libmerged	126243	126256		metF	13
RV2039_libmerged	127210	127252		YPO_RS01610	42
RV2039_libmerged	127534	127552		YPO_RS01610	18
RV2039_libmerged	127905	127913		YPO_RS01610	8
RV2039_libmerged	128178	128197		YPO_RS01610	19
RV2039_libmerged	128784	128803		YPO_RS01615	19
RV2039_libmerged	129868	129870		glpG	2
RV2039_libmerged	130308	130314		glpG	6
RV2039_libmerged	131441	131442		malT	1
RV2039_libmerged	131814	131816		malT	2
RV2039_libmerged	132158	132160		malT	2
RV2039_libmerged	132806	132819		malT	13
RV2039_libmerged	134463	134473		malP	10
RV2039_libmerged	134843	134850		malP	7
RV2039_libmerged	135792	135825		malP	33
RV2039_libmerged	135901	135914		malP	13
RV2039_libmerged	136229	136236		malP	7
RV2039_libmerged	136483	136487		malQ	4
RV2039_libmerged	138449	138462		malQ	13
RV2039_libmerged	138909	138917		nfuA	8
RV2039_libmerged	138950	138952		nfuA	2
RV2039_libmerged	141285	141298		YPO_RS01665	13
RV2039_libmerged	143431	143441		feoB	10
RV2039_libmerged	146649	146657		YPO_RS01685	8
RV2039_libmerged	149495	149500		envZ	5
RV2039_libmerged	153490	153521		hslO	31
RV2039_libmerged	154194	154220		yrfG	26
RV2039_libmerged	155106	155121		YPO_RS01725	15
RV2039_libmerged	155841	155842		YPO_RS01725	1
RV2039_libmerged	156633	156668		YPO_RS01725	35
RV2039_libmerged	156909	156912		YPO_RS01725	3
RV2039_libmerged	157775	157785		nudE	10
RV2039_libmerged	158204	158224		nudE	20
RV2039_libmerged	158291	158297		nudE	6
RV2039_libmerged	158844	158847		mrcA	3
RV2039_libmerged	159231	159241		mrcA	10
RV2039_libmerged	161108	161122		YPO_RS01740	14
RV2039_libmerged	161358	161367		YPO_RS01740	9
RV2039_libmerged	163163	163170		YPO_RS01750	7
RV2039_libmerged	166080	166081		aroB	1
RV2039_libmerged	167037	167062		aroB	25
RV2039_libmerged	167520	167556		YPO_RS01775	36
RV2039_libmerged	168624	168659		dam	35
RV2039_libmerged	170610	170633		YPO_RS01790	23
RV2039_libmerged	171058	171063		trpS	5
RV2039_libmerged	173109	173112		cobA	3
RV2039_libmerged	173218	173222		cobA	4
RV2039_libmerged	175087	175089		YPO_RS01815	2
RV2039_libmerged	175620	175626		YPO_RS01815	6
RV2039_libmerged	180906	180916		YPO_RS01830	10
RV2039_libmerged	181132	181134		YPO_RS01830	2
RV2039_libmerged	181554	181566		YPO_RS01830	12
RV2039_libmerged	181868	181879		YPO_RS01830	11
RV2039_libmerged	182535	182542		YPO_RS01830	7
RV2039_libmerged	183909	183913		YPO_RS01835	4
RV2039_libmerged	186316	186324		ppiA	8
RV2039_libmerged	187241	187243		YPO_RS01850	2
RV2039_libmerged	188866	188913		YPO_RS01855	47
RV2039_libmerged	188965	188968		YPO_RS01855	3
RV2039_libmerged	190282	190317		YPO_RS01865	35
RV2039_libmerged	190354	190366		YPO_RS01865	12
RV2039_libmerged	190428	190463		YPO_RS01865	35
RV2039_libmerged	190604	190616		YPO_RS01865	12
RV2039_libmerged	190795	190802		YPO_RS01865	7
RV2039_libmerged	190861	190879		YPO_RS01865	18
RV2039_libmerged	191000	191029		YPO_RS01865	29
RV2039_libmerged	191110	191113		YPO_RS01865	3
RV2039_libmerged	191299	191419		YPO_RS01870	120
RV2039_libmerged	191478	191629		YPO_RS01870	151
RV2039_libmerged	191669	191704		YPO_RS01870	35
RV2039_libmerged	191827	191912		YPO_RS01870	85
RV2039_libmerged	195312	195313		crp	1
RV2039_libmerged	199573	199579		YPO_RS01915	6
RV2039_libmerged	199657	199660		YPO_RS01915	3
RV2039_libmerged	201250	201253		tauA	3
RV2039_libmerged	201501	201529		tauB	28
RV2039_libmerged	202293	202299		tauC	6
RV2039_libmerged	205376	205382		YPO_RS01945	6
RV2039_libmerged	208787	208804		kefB	17
RV2039_libmerged	210723	210728		YPO_RS01965	5
RV2039_libmerged	211397	211402		slyD	5
RV2039_libmerged	212412	212426		fkpA	14
RV2039_libmerged	212729	212745		fkpA	16
RV2039_libmerged	213728	213735		YPO_RS01985	7
RV2039_libmerged	213904	213931		YPO_RS01985	27
RV2039_libmerged	214475	214479		tusC	4
RV2039_libmerged	215717	215722		rpsG	5
RV2039_libmerged	216864	216898		fusA	34
RV2039_libmerged	218314	218334		fusA	20
RV2039_libmerged	218838	218867		tuf	29
RV2039_libmerged	219141	219144		tuf	3
RV2039_libmerged	219361	219370		tuf	9
RV2039_libmerged	219896	219904		YPO_RS02025	8
RV2039_libmerged	220019	220108		YPO_RS02025	89
RV2039_libmerged	220305	220307		YPO_RS02025	2
RV2039_libmerged	220892	220903		bfr	11
RV2039_libmerged	220980	220986		bfr	6
RV2039_libmerged	221138	221149		bfr	11
RV2039_libmerged	222510	222511		rplC	1
RV2039_libmerged	224835	224847		rplV	12
RV2039_libmerged	227484	227491		rplX	7
RV2039_libmerged	228044	228045		rplE	1
RV2039_libmerged	228059	228066		rpsN	7
RV2039_libmerged	228596	228601		rpsH	5
RV2039_libmerged	229012	229016		rplF	4
RV2039_libmerged	229348	229349		rplR	1
RV2039_libmerged	230222	230223		rpmD	1
RV2039_libmerged	230348	230400		rpmD	52
RV2039_libmerged	231243	231255		secY	12
RV2039_libmerged	232849	232860		rpsK	11
RV2039_libmerged	233526	233535		rpsD	9
RV2039_libmerged	236009	236055		zntR	46
RV2039_libmerged	236465	236484		YPO_RS02185	19
RV2039_libmerged	237212	237242		trkA	30
RV2039_libmerged	237416	237418		trkA	2
RV2039_libmerged	238104	238149		trkA	45
RV2039_libmerged	238593	238611		rsmB	18
RV2039_libmerged	239450	239452		rsmB	2
RV2039_libmerged	239522	239530		rsmB	8
RV2039_libmerged	240597	240605		fmt	8
RV2039_libmerged	240731	240750		fmt	19
RV2039_libmerged	242089	242092		dprA	3
RV2039_libmerged	243066	243087		YPO_RS02220	21
RV2039_libmerged	243728	243735		YPO_RS02225	7
RV2039_libmerged	244107	244112		tsaC	5
RV2039_libmerged	245339	245342		YPO_RS02240	3
RV2039_libmerged	245465	245471		YPO_RS02240	6
RV2039_libmerged	245527	245560		YPO_RS02240	33
RV2039_libmerged	245816	245822		YPO_RS02245	6
RV2039_libmerged	245855	245888		YPO_RS02245	33
RV2039_libmerged	245983	246009		YPO_RS02245	26
RV2039_libmerged	246057	246063		YPO_RS02245	6
RV2039_libmerged	246116	246134		YPO_RS02245	18
RV2039_libmerged	246178	246183		YPO_RS02245	5
RV2039_libmerged	246268	246277		YPO_RS02245	9
RV2039_libmerged	246426	246467		YPO_RS02245	41
RV2039_libmerged	246560	246571		YPO_RS02245	11
RV2039_libmerged	246571	246585		YPO_RS02250	14
RV2039_libmerged	246631	246666		YPO_RS02250	35
RV2039_libmerged	246864	246898		YPO_RS02250	34
RV2039_libmerged	246955	246967		YPO_RS02250	12
RV2039_libmerged	247037	247040		YPO_RS02250	3
RV2039_libmerged	247076	247142		YPO_RS02250	66
RV2039_libmerged	247263	247269		YPO_RS02250	6
RV2039_libmerged	247398	247424		YPO_RS02250	26
RV2039_libmerged	247558	247593		YPO_RS02250	35
RV2039_libmerged	248054	248089		YPO_RS02255	35
RV2039_libmerged	248496	248514		YPO_RS02255	18
RV2039_libmerged	250583	250585		YPO_RS02265	2
RV2039_libmerged	251305	251348		acs	43
RV2039_libmerged	252602	252645		acs	43
RV2039_libmerged	254060	254065		gltP	5
RV2039_libmerged	254229	254230		gltP	1
RV2039_libmerged	254748	254750		gltP	2
RV2039_libmerged	255267	255271		YPO_RS02280	4
RV2039_libmerged	257268	257276		YPO_RS02285	8
RV2039_libmerged	258434	258439		YPO_RS02285	5
RV2039_libmerged	258973	258974		YPO_RS02290	1
RV2039_libmerged	259022	259061		YPO_RS02290	39
RV2039_libmerged	259842	259854		YPO_RS02290	12
RV2039_libmerged	260007	260009		YPO_RS02290	2
RV2039_libmerged	260388	260400		sctD	12
RV2039_libmerged	260750	260768		sctD	18
RV2039_libmerged	260840	260860		sctD	20
RV2039_libmerged	260921	260925		sctD	4
RV2039_libmerged	262506	262507		sctF	1
RV2039_libmerged	263064	263072		sctI	8
RV2039_libmerged	265577	265583		YPO_RS02340	6
RV2039_libmerged	265814	265825		YPO_RS02340	11
RV2039_libmerged	266042	266043		YPO_RS02340	1
RV2039_libmerged	269240	269245		YPO_RS02355	5
RV2039_libmerged	269340	269372		YPO_RS02355	32
RV2039_libmerged	271211	271229		sctR	18
RV2039_libmerged	271327	271372		YPO_RS02370	45
RV2039_libmerged	271940	271946		sctT	6
RV2039_libmerged	272317	272350		sctT	33
RV2039_libmerged	272559	272564		YPO_RS02380	5
RV2039_libmerged	272811	272855		YPO_RS02380	44
RV2039_libmerged	273029	273065		YPO_RS02380	36
RV2039_libmerged	275265	275267		yedF	2
RV2039_libmerged	275581	275609		YPO_RS02395	28
RV2039_libmerged	275853	275858		YPO_RS02395	5
RV2039_libmerged	275955	275977		YPO_RS02395	22
RV2039_libmerged	276617	276634		YPO_RS02400	17
RV2039_libmerged	276735	276740		YPO_RS02400	5
RV2039_libmerged	276805	276812		YPO_RS02400	7
RV2039_libmerged	276970	276971		YPO_RS02400	1
RV2039_libmerged	277500	277533		YPO_RS02400	33
RV2039_libmerged	278862	278891		metC	29
RV2039_libmerged	280632	280633		YPO_RS02415	1
RV2039_libmerged	281944	281946		YPO_RS02425	2
RV2039_libmerged	282809	282812		YPO_RS02425	3
RV2039_libmerged	283448	283451		YPO_RS02430	3
RV2039_libmerged	283628	283641		YPO_RS02430	13
RV2039_libmerged	284305	284317		YPO_RS02430	12
RV2039_libmerged	286702	286709		YPO_RS02450	7
RV2039_libmerged	288363	288432		YPO_RS02455	69
RV2039_libmerged	288562	288569		YPO_RS02455	7
RV2039_libmerged	288892	288943		YPO_RS02455	51
RV2039_libmerged	289104	289113		YPO_RS02455	9
RV2039_libmerged	292325	292328		YPO_RS02470	3
RV2039_libmerged	292738	292745		YPO_RS02475	7
RV2039_libmerged	294470	294471		YPO_RS02485	1
RV2039_libmerged	299228	299253		YPO_RS02510	25
RV2039_libmerged	300167	300176		YPO_RS02515	9
RV2039_libmerged	300554	300562		YPO_RS02520	8
RV2039_libmerged	300592	300668		YPO_RS02520	76
RV2039_libmerged	300873	300943		YPO_RS02520	70
RV2039_libmerged	301887	301913		YPO_RS02525	26
RV2039_libmerged	302240	302243		YPO_RS02525	3
RV2039_libmerged	303361	303366		YPO_RS02530	5
RV2039_libmerged	303444	303452		YPO_RS02530	8
RV2039_libmerged	303521	303531		YPO_RS02530	10
RV2039_libmerged	304269	304274		YPO_RS02530	5
RV2039_libmerged	305235	305246		YPO_RS02535	11
RV2039_libmerged	305723	305740		YPO_RS02535	17
RV2039_libmerged	305903	305913		YPO_RS02540	10
RV2039_libmerged	308561	308565		YPO_RS02550	4
RV2039_libmerged	310300	310337		YPO_RS02555	37
RV2039_libmerged	310443	310464		YPO_RS02555	21
RV2039_libmerged	314234	314240		yapK	6
RV2039_libmerged	314724	314746		yapK	22
RV2039_libmerged	315014	315029		yapK	15
RV2039_libmerged	315187	315240		yapK	53
RV2039_libmerged	317773	317788		ubiA	15
RV2039_libmerged	323913	323924		dusA	11
RV2039_libmerged	324731	324733		pspG	2
RV2039_libmerged	331025	331028		YPO_RS02625	3
RV2039_libmerged	331182	331227		YPO_RS02625	45
RV2039_libmerged	332672	332697		uvrA	25
RV2039_libmerged	333989	333993		uvrA	4
RV2039_libmerged	334122	334144		uvrA	22
RV2039_libmerged	335875	335903		fucO	28
RV2039_libmerged	336480	336495		fucO	15
RV2039_libmerged	337377	337394		rhaD	17
RV2039_libmerged	337866	337868		rhaD	2
RV2039_libmerged	339183	339199		rhaB	16
RV2039_libmerged	340100	340101		rhaB	1
RV2039_libmerged	340138	340156		rhaB	18
RV2039_libmerged	340687	340713		YPO_RS02665	26
RV2039_libmerged	343755	343758		rhaT	3
RV2039_libmerged	344040	344051		rhaT	11
RV2039_libmerged	345086	345130		YPO_RS02690	44
RV2039_libmerged	345767	345770		YPO_RS02695	3
RV2039_libmerged	345971	345975		YPO_RS02695	4
RV2039_libmerged	346225	346226		YPO_RS02695	1
RV2039_libmerged	346256	346271		YPO_RS02695	15
RV2039_libmerged	346692	346700		YPO_RS02695	8
RV2039_libmerged	347011	347023		YPO_RS02695	12
RV2039_libmerged	347393	347488		YPO_RS02695	95
RV2039_libmerged	347670	347679		YPO_RS02695	9
RV2039_libmerged	348033	348048		YPO_RS02695	15
RV2039_libmerged	348149	348154		YPO_RS02695	5
RV2039_libmerged	348225	348227		YPO_RS02695	2
RV2039_libmerged	349349	349355		YPO_RS02705	6
RV2039_libmerged	350061	350066		aegA	5
RV2039_libmerged	350748	350773		aegA	25
RV2039_libmerged	353170	353174		fdhF	4
RV2039_libmerged	353265	353274		fdhF	9
RV2039_libmerged	354190	354205		fdhF	15
RV2039_libmerged	356021	356028		YPO_RS02725	7
RV2039_libmerged	356637	356645		cutA	8
RV2039_libmerged	356711	356741		cutA	30
RV2039_libmerged	357462	357504		YPO_RS02735	42
RV2039_libmerged	357660	357699		YPO_RS02735	39
RV2039_libmerged	357855	357888		YPO_RS02735	33
RV2039_libmerged	358343	358347		YPO_RS02735	4
RV2039_libmerged	358400	358406		YPO_RS02735	6
RV2039_libmerged	360490	360498		fxsA	8
RV2039_libmerged	360949	360950		fxsA	1
RV2039_libmerged	361256	361261		YPO_RS02750	5
RV2039_libmerged	364787	364804		epmB	17
RV2039_libmerged	364896	364910		epmB	14
RV2039_libmerged	366430	366449		sugE	19
RV2039_libmerged	367043	367091		YPO_RS02780	48
RV2039_libmerged	367132	367144		YPO_RS02780	12
RV2039_libmerged	367214	367229		YPO_RS02780	15
RV2039_libmerged	367312	367335		YPO_RS02780	23
RV2039_libmerged	367375	367384		YPO_RS02780	9
RV2039_libmerged	367658	367682		frdD	24
RV2039_libmerged	368270	368277		frdC	7
RV2039_libmerged	371745	371765		epmA	20
RV2039_libmerged	373428	373448		mscM	20
RV2039_libmerged	376744	376754		psd	10
RV2039_libmerged	377762	377767		rsgA	5
RV2039_libmerged	378723	378736		orn	13
RV2039_libmerged	379943	379944		queG	1
RV2039_libmerged	380038	380045		queG	7
RV2039_libmerged	381419	381428		nnr	9
RV2039_libmerged	382273	382278		nnr	5
RV2039_libmerged	382333	382344		nnr	11
RV2039_libmerged	387823	387828		miaA	5
RV2039_libmerged	388074	388081		hfq	7
RV2039_libmerged	389252	389269		hflX	17
RV2039_libmerged	390500	390511		hflK	11
RV2039_libmerged	390891	390894		hflK	3
RV2039_libmerged	391461	391463		hflC	2
RV2039_libmerged	392332	392335		YPO_RS02890	3
RV2039_libmerged	392484	392488		YPO_RS02890	4
RV2039_libmerged	393129	393140		YPO_RS02895	11
RV2039_libmerged	393851	393861		YPO_RS02895	10
RV2039_libmerged	394319	394347		nsrR	28
RV2039_libmerged	394572	394581		nsrR	9
RV2039_libmerged	394700	394704		nsrR	4
RV2039_libmerged	396281	396289		rnr	8
RV2039_libmerged	396699	396726		rnr	27
RV2039_libmerged	397635	397641		rlmB	6
RV2039_libmerged	399190	399193		YPO_RS02915	3
RV2039_libmerged	399226	399239		YPO_RS02915	13
RV2039_libmerged	401046	401063		YPO_RS02925	17
RV2039_libmerged	401114	401118		YPO_RS02930	4
RV2039_libmerged	401385	401453		YPO_RS02930	68
RV2039_libmerged	401492	401523		YPO_RS02930	31
RV2039_libmerged	401597	401614		YPO_RS02930	17
RV2039_libmerged	401663	401738		YPO_RS02930	75
RV2039_libmerged	401881	401893		YPO_RS02930	12
RV2039_libmerged	401893	401908		YPO_RS02935	15
RV2039_libmerged	402086	402089		YPO_RS02935	3
RV2039_libmerged	402123	402133		YPO_RS02935	10
RV2039_libmerged	402326	402355		YPO_RS02935	29
RV2039_libmerged	402509	402517		YPO_RS02935	8
RV2039_libmerged	402635	402645		YPO_RS02935	10
RV2039_libmerged	402746	402753		YPO_RS02935	7
RV2039_libmerged	402898	402915		YPO_RS02935	17
RV2039_libmerged	403371	403395		YPO_RS02940	24
RV2039_libmerged	403992	403995		YPO_RS02940	3
RV2039_libmerged	404222	404243		YPO_RS02940	21
RV2039_libmerged	404298	404303		YPO_RS02940	5
RV2039_libmerged	404721	404762		YPO_RS02940	41
RV2039_libmerged	404849	404870		YPO_RS02940	21
RV2039_libmerged	404997	405018		YPO_RS02940	21
RV2039_libmerged	405142	405165		YPO_RS02945	23
RV2039_libmerged	405645	405647		YPO_RS02945	2
RV2039_libmerged	406250	406271		YPO_RS02945	21
RV2039_libmerged	407601	407608		YPO_RS02955	7
RV2039_libmerged	407762	407773		YPO_RS02955	11
RV2039_libmerged	407908	407916		YPO_RS02955	8
RV2039_libmerged	407974	407982		YPO_RS02955	8
RV2039_libmerged	408085	408107		YPO_RS02955	22
RV2039_libmerged	408180	408183		YPO_RS02955	3
RV2039_libmerged	408254	408339		YPO_RS02955	85
RV2039_libmerged	408588	408591		YPO_RS02955	3
RV2039_libmerged	408659	408669		YPO_RS02955	10
RV2039_libmerged	408936	408960		YPO_RS02960	24
RV2039_libmerged	409027	409039		YPO_RS02960	12
RV2039_libmerged	409187	409230		YPO_RS02960	43
RV2039_libmerged	409264	409316		YPO_RS02960	52
RV2039_libmerged	409390	409397		YPO_RS02960	7
RV2039_libmerged	409565	409591		YPO_RS02965	26
RV2039_libmerged	409632	409652		YPO_RS02965	20
RV2039_libmerged	409919	409921		YPO_RS02965	2
RV2039_libmerged	410088	410102		YPO_RS02965	14
RV2039_libmerged	410153	410162		YPO_RS02965	9
RV2039_libmerged	410199	410206		YPO_RS02965	7
RV2039_libmerged	410372	410406		YPO_RS02965	34
RV2039_libmerged	410846	410864		YPO_RS02965	18
RV2039_libmerged	411235	411243		YPO_RS02970	8
RV2039_libmerged	412607	412610		YPO_RS02980	3
RV2039_libmerged	414271	414278		YPO_RS02985	7
RV2039_libmerged	414619	414648		YPO_RS02985	29
RV2039_libmerged	415149	415151		YPO_RS02990	2
RV2039_libmerged	416015	416028		YPO_RS02995	13
RV2039_libmerged	416114	416116		YPO_RS02995	2
RV2039_libmerged	416157	416160		YPO_RS02995	3
RV2039_libmerged	416433	416460		YPO_RS02995	27
RV2039_libmerged	416834	416852		YPO_RS02995	18
RV2039_libmerged	418335	418343		YPO_RS03000	8
RV2039_libmerged	418345	418389		YPO_RS03005	44
RV2039_libmerged	418549	418566		YPO_RS03005	17
RV2039_libmerged	418604	418626		YPO_RS03005	22
RV2039_libmerged	419198	419209		YPO_RS03005	11
RV2039_libmerged	420791	420798		YPO_RS03020	7
RV2039_libmerged	420863	420891		YPO_RS03020	28
RV2039_libmerged	422974	422979		ptsP	5
RV2039_libmerged	423706	423709		ptsP	3
RV2039_libmerged	424155	424161		ptsP	6
RV2039_libmerged	424414	424421		YPO_RS03030	7
RV2039_libmerged	424608	424625		YPO_RS03030	17
RV2039_libmerged	424856	424863		YPO_RS03030	7
RV2039_libmerged	425242	425247		lsrG	5
RV2039_libmerged	425956	425977		lsrF	21
RV2039_libmerged	426540	426558		lsrB	18
RV2039_libmerged	428003	428031		lsrD	28
RV2039_libmerged	429207	429221		lsrC	14
RV2039_libmerged	429879	429897		lsrA	18
RV2039_libmerged	431098	431102		lsrA	4
RV2039_libmerged	431163	431164		lsrA	1
RV2039_libmerged	433748	433749		lsrK	1
RV2039_libmerged	434619	434633		rfaQ	14
RV2039_libmerged	436003	436023		YPO_RS03085	20
RV2039_libmerged	436090	436100		YPO_RS03085	10
RV2039_libmerged	436250	436255		YPO_RS03085	5
RV2039_libmerged	436355	436374		YPO_RS03085	19
RV2039_libmerged	439414	439429		YPO_RS03100	15
RV2039_libmerged	439486	439508		YPO_RS03100	22
RV2039_libmerged	439606	439609		YPO_RS03100	3
RV2039_libmerged	440191	440205		YPO_RS03100	14
RV2039_libmerged	441081	441101		YPO_RS03100	20
RV2039_libmerged	441640	441642		YPO_RS03100	2
RV2039_libmerged	441995	442021		YPO_RS03100	26
RV2039_libmerged	442311	442317		YPO_RS03100	6
RV2039_libmerged	442824	442844		YPO_RS03105	20
RV2039_libmerged	443885	443892		YPO_RS03115	7
RV2039_libmerged	444696	444698		YPO_RS03115	2
RV2039_libmerged	445696	445707		YPO_RS03120	11
RV2039_libmerged	446008	446031		YPO_RS03120	23
RV2039_libmerged	446084	446099		YPO_RS03120	15
RV2039_libmerged	446183	446252		YPO_RS03120	69
RV2039_libmerged	446456	446457		YPO_RS03120	1
RV2039_libmerged	446592	446611		YPO_RS03120	19
RV2039_libmerged	448712	448714		rsmC	2
RV2039_libmerged	449172	449176		YPO_RS03140	4
RV2039_libmerged	452283	452285		osmY	2
RV2039_libmerged	453130	453147		YPO_RS03165	17
RV2039_libmerged	453505	453514		YPO_RS03165	9
RV2039_libmerged	453977	453978		YPO_RS03165	1
RV2039_libmerged	455748	455751		YPO_RS03175	3
RV2039_libmerged	456525	456553		YPO_RS03175	28
RV2039_libmerged	457345	457353		deoC	8
RV2039_libmerged	458035	458041		deoC	6
RV2039_libmerged	459661	459667		deoB	6
RV2039_libmerged	461214	461221		deoD	7
RV2039_libmerged	462164	462173		YPO_RS03200	9
RV2039_libmerged	462306	462328		YPO_RS03200	22
RV2039_libmerged	466269	466273		nadR	4
RV2039_libmerged	467139	467145		YPO_RS03220	6
RV2039_libmerged	467484	467504		YPO_RS03220	20
RV2039_libmerged	467659	467666		YPO_RS03220	7
RV2039_libmerged	470101	470137		YPO_RS03230	36
RV2039_libmerged	470331	470355		YPO_RS03230	24
RV2039_libmerged	470686	470702		YPO_RS03235	16
RV2039_libmerged	472137	472144		YPO_RS03240	7
RV2039_libmerged	472214	472232		YPO_RS03240	18
RV2039_libmerged	472873	472884		YPO_RS03245	11
RV2039_libmerged	473666	473684		YPO_RS03245	18
RV2039_libmerged	475165	475172		YPO_RS03245	7
RV2039_libmerged	475222	475229		YPO_RS03245	7
RV2039_libmerged	476300	476302		sltY	2
RV2039_libmerged	476802	476808		sltY	6
RV2039_libmerged	477592	477605		sltY	13
RV2039_libmerged	478829	478838		yjjX	9
RV2039_libmerged	480556	480571		robA	15
RV2039_libmerged	481952	481954		arcA	2
RV2039_libmerged	482156	482164		arcA	8
RV2039_libmerged	483920	483950		thrA	30
RV2039_libmerged	484248	484258		thrA	10
RV2039_libmerged	484336	484342		thrA	6
RV2039_libmerged	484454	484458		thrA	4
RV2039_libmerged	486225	486227		thrB	2
RV2039_libmerged	486680	486681		thrB	1
RV2039_libmerged	486979	486982		thrC	3
RV2039_libmerged	487303	487315		thrC	12
RV2039_libmerged	487800	487809		thrC	9
RV2039_libmerged	493235	493241		YPO_RS03325	6
RV2039_libmerged	494227	494228		YPO_RS03330	1
RV2039_libmerged	494524	494526		YPO_RS03330	2
RV2039_libmerged	494609	494628		YPO_RS03330	19
RV2039_libmerged	495057	495090		YPO_RS03330	33
RV2039_libmerged	495210	495218		YPO_RS03330	8
RV2039_libmerged	495317	495320		YPO_RS03330	3
RV2039_libmerged	495484	495492		YPO_RS03330	8
RV2039_libmerged	495640	495670		YPO_RS03330	30
RV2039_libmerged	497373	497374		dnaK	1
RV2039_libmerged	497516	497531		dnaK	15
RV2039_libmerged	497738	497746		dnaK	8
RV2039_libmerged	498712	498721		dnaK	9
RV2039_libmerged	500417	500420		dnaJ	3
RV2039_libmerged	502383	502384		nhaR	1
RV2039_libmerged	502495	502506		nhaR	11
RV2039_libmerged	502593	502594		nhaR	1
RV2039_libmerged	502916	502925		nhaR	9
RV2039_libmerged	506605	506624		ileS	19
RV2039_libmerged	506910	506922		ileS	12
RV2039_libmerged	508011	508014		lspA	3
RV2039_libmerged	507892	507905		lspA	13
RV2039_libmerged	508672	508689		ispH	17
RV2039_libmerged	509902	509929		YPO_RS03400	27
RV2039_libmerged	509968	509978		YPO_RS03400	10
RV2039_libmerged	510071	510127		YPO_RS03400	56
RV2039_libmerged	510199	510225		YPO_RS03400	26
RV2039_libmerged	510307	510334		YPO_RS03400	27
RV2039_libmerged	511610	511612		dapB	2
RV2039_libmerged	513085	513096		carA	11
RV2039_libmerged	513252	513262		carA	10
RV2039_libmerged	515132	515137		carB	5
RV2039_libmerged	515204	515206		carB	2
RV2039_libmerged	517752	517767		YPO_RS03425	15
RV2039_libmerged	518522	518563		YPO_RS03430	41
RV2039_libmerged	518701	518708		YPO_RS03430	7
RV2039_libmerged	518814	518837		YPO_RS03430	23
RV2039_libmerged	519853	519863		YPO_RS03440	10
RV2039_libmerged	519969	520031		YPO_RS03440	62
RV2039_libmerged	520096	520149		YPO_RS03440	53
RV2039_libmerged	520183	520206		YPO_RS03440	23
RV2039_libmerged	520809	520842		YPO_RS03445	33
RV2039_libmerged	521520	521521		YPO_RS03450	1
RV2039_libmerged	521570	521589		YPO_RS03450	19
RV2039_libmerged	522918	522928		apaG	10
RV2039_libmerged	523941	523957		pdxA	16
RV2039_libmerged	524772	524780		surA	8
RV2039_libmerged	524970	524995		surA	25
RV2039_libmerged	525562	525571		surA	9
RV2039_libmerged	526334	526338		lptD	4
RV2039_libmerged	526494	526507		lptD	13
RV2039_libmerged	527003	527009		lptD	6
RV2039_libmerged	527323	527341		lptD	18
RV2039_libmerged	527833	527836		lptD	3
RV2039_libmerged	528198	528204		lptD	6
RV2039_libmerged	528349	528372		lptD	23
RV2039_libmerged	528654	528664		djlA	10
RV2039_libmerged	530403	530405		rluA	2
RV2039_libmerged	532254	532262		YPO_RS03495	8
RV2039_libmerged	532937	532952		YPO_RS03500	15
RV2039_libmerged	533412	533414		YPO_RS03500	2
RV2039_libmerged	533582	533616		YPO_RS03500	34
RV2039_libmerged	533776	533779		tssB	3
RV2039_libmerged	533976	533978		tssB	2
RV2039_libmerged	537666	537676		tssF	10
RV2039_libmerged	537730	537733		tssF	3
RV2039_libmerged	538292	538302		tssF	10
RV2039_libmerged	539135	539147		tssG	12
RV2039_libmerged	539841	539845		tssG	4
RV2039_libmerged	542150	542163		tssH	13
RV2039_libmerged	542657	542662		vgrG	5
RV2039_libmerged	542883	542911		vgrG	28
RV2039_libmerged	542982	542983		vgrG	1
RV2039_libmerged	543087	543094		vgrG	7
RV2039_libmerged	543612	543614		vgrG	2
RV2039_libmerged	544146	544165		vgrG	19
RV2039_libmerged	544302	544327		vgrG	25
RV2039_libmerged	545595	545596		YPO_RS03550	1
RV2039_libmerged	545875	545876		YPO_RS03550	1
RV2039_libmerged	546698	546707		YPO_RS03550	9
RV2039_libmerged	546770	546822		YPO_RS03550	52
RV2039_libmerged	546914	546918		YPO_RS03550	4
RV2039_libmerged	546949	546982		YPO_RS03550	33
RV2039_libmerged	547693	547704		YPO_RS03555	11
RV2039_libmerged	547739	547754		YPO_RS03555	15
RV2039_libmerged	549427	549438		tssJ	11
RV2039_libmerged	549851	549870		tssK	19
RV2039_libmerged	550164	550184		tssK	20
RV2039_libmerged	551035	551043		tssK	8
RV2039_libmerged	551097	551111		tssK	14
RV2039_libmerged	551509	551535		YPO_RS03580	26
RV2039_libmerged	551582	551590		YPO_RS03580	8
RV2039_libmerged	552334	552337		YPO_RS03580	3
RV2039_libmerged	552875	552933		tssM	58
RV2039_libmerged	553684	553691		tssM	7
RV2039_libmerged	554272	554302		tssM	30
RV2039_libmerged	554411	554412		tssM	1
RV2039_libmerged	554535	554536		tssM	1
RV2039_libmerged	555049	555080		tssM	31
RV2039_libmerged	555843	555845		tssM	2
RV2039_libmerged	556337	556339		YPO_RS03590	2
RV2039_libmerged	556946	556955		rapA	9
RV2039_libmerged	560313	560351		YPO_RS03600	38
RV2039_libmerged	560656	560664		YPO_RS03600	8
RV2039_libmerged	561095	561098		YPO_RS03600	3
RV2039_libmerged	563198	563205		YPO_RS03605	7
RV2039_libmerged	563424	563445		YPO_RS03605	21
RV2039_libmerged	563589	563614		YPO_RS03605	25
RV2039_libmerged	564981	565016		thiP	35
RV2039_libmerged	566126	566136		YPO_RS03620	10
RV2039_libmerged	566472	566488		YPO_RS03620	16
RV2039_libmerged	568895	568899		YPO_RS03625	4
RV2039_libmerged	571251	571298		YPO_RS03635	47
RV2039_libmerged	571329	571363		YPO_RS03635	34
RV2039_libmerged	571501	571507		YPO_RS03635	6
RV2039_libmerged	571554	571564		YPO_RS03635	10
RV2039_libmerged	571622	571645		YPO_RS03635	23
RV2039_libmerged	571892	571930		YPO_RS03635	38
RV2039_libmerged	572041	572068		YPO_RS03640	27
RV2039_libmerged	572110	572126		YPO_RS03640	16
RV2039_libmerged	572216	572222		YPO_RS03640	6
RV2039_libmerged	572280	572437		YPO_RS03640	157
RV2039_libmerged	572579	572618		YPO_RS03640	39
RV2039_libmerged	572662	572676		YPO_RS03640	14
RV2039_libmerged	572882	572904		YPO_RS03640	22
RV2039_libmerged	573140	573161		YPO_RS03645	21
RV2039_libmerged	575459	575488		leuC	29
RV2039_libmerged	576604	576610		leuB	6
RV2039_libmerged	577166	577170		leuA	4
RV2039_libmerged	577568	577572		leuA	4
RV2039_libmerged	577763	577783		leuA	20
RV2039_libmerged	578607	578736		YPO_RS03670	129
RV2039_libmerged	578822	578851		YPO_RS03670	29
RV2039_libmerged	578937	578942		YPO_RS03670	5
RV2039_libmerged	579549	579551		YPO_RS03675	2
RV2039_libmerged	579581	579586		YPO_RS03675	5
RV2039_libmerged	580853	580856		leuO	3
RV2039_libmerged	580984	581008		leuO	24
RV2039_libmerged	582859	582863		YPO_RS03685	4
RV2039_libmerged	583355	583372		YPO_RS03685	17
RV2039_libmerged	585386	585392		ilvI	6
RV2039_libmerged	585923	585943		ilvN	20
RV2039_libmerged	586486	586502		YPO_RS03700	16
RV2039_libmerged	586569	586613		YPO_RS03700	44
RV2039_libmerged	586764	586839		YPO_RS03700	75
RV2039_libmerged	587517	587523		cra	6
RV2039_libmerged	588610	588623		YPO_RS03710	13
RV2039_libmerged	591518	591524		ftsL	6
RV2039_libmerged	593571	593593		YPO_RS03735	22
RV2039_libmerged	596071	596108		murF	37
RV2039_libmerged	596206	596209		murF	3
RV2039_libmerged	596758	596780		mraY	22
RV2039_libmerged	597028	597033		mraY	5
RV2039_libmerged	598925	598929		ftsW	4
RV2039_libmerged	599164	599176		ftsW	12
RV2039_libmerged	602625	602627		murC	2
RV2039_libmerged	604442	604451		ftsQ	9
RV2039_libmerged	604617	604619		ftsA	2
RV2039_libmerged	605029	605042		ftsA	13
RV2039_libmerged	605264	605267		ftsA	3
RV2039_libmerged	605354	605355		ftsA	1
RV2039_libmerged	605683	605686		ftsA	3
RV2039_libmerged	605777	605784		ftsA	7
RV2039_libmerged	606385	606392		ftsZ	7
RV2039_libmerged	606802	606812		ftsZ	10
RV2039_libmerged	607404	607415		lpxC	11
RV2039_libmerged	608032	608045		lpxC	13
RV2039_libmerged	611307	611329		secA	22
RV2039_libmerged	613033	613059		YPO_RS03820	26
RV2039_libmerged	613117	613167		YPO_RS03820	50
RV2039_libmerged	613353	613372		YPO_RS03820	19
RV2039_libmerged	613416	613572		YPO_RS03820	156
RV2039_libmerged	613707	613729		YPO_RS03820	22
RV2039_libmerged	613833	613840		YPO_RS03825	7
RV2039_libmerged	613930	613942		YPO_RS03825	12
RV2039_libmerged	614158	614181		YPO_RS03825	23
RV2039_libmerged	614272	614283		YPO_RS03825	11
RV2039_libmerged	614624	614642		YPO_RS03825	18
RV2039_libmerged	614826	614834		YPO_RS03825	8
RV2039_libmerged	615412	615414		YPO_RS03835	2
RV2039_libmerged	616327	616343		YPO_RS03845	16
RV2039_libmerged	617310	617323		YPO_RS03855	13
RV2039_libmerged	618149	618150		YPO_RS03865	1
RV2039_libmerged	618599	618639		YPO_RS03865	40
RV2039_libmerged	619792	619794		exuR	2
RV2039_libmerged	621125	621145		YPO_RS03880	20
RV2039_libmerged	622962	622969		uxaC	7
RV2039_libmerged	623468	623470		uxaC	2
RV2039_libmerged	627245	627254		YPO_RS03895	9
RV2039_libmerged	627361	627364		YPO_RS03895	3
RV2039_libmerged	628049	628050		YPO_RS03900	1
RV2039_libmerged	628211	628305		YPO_RS03905	94
RV2039_libmerged	628421	628435		YPO_RS03905	14
RV2039_libmerged	628475	628587		YPO_RS03905	112
RV2039_libmerged	628618	628623		YPO_RS03905	5
RV2039_libmerged	629224	629247		sstT	23
RV2039_libmerged	630066	630077		sstT	11
RV2039_libmerged	631816	631818		YPO_RS03920	2
RV2039_libmerged	632597	632620		yapG	23
RV2039_libmerged	632829	632835		yapG	6
RV2039_libmerged	633199	633208		yapG	9
RV2039_libmerged	633661	633662		yapG	1
RV2039_libmerged	633940	633947		yapG	7
RV2039_libmerged	634762	634790		yapG	28
RV2039_libmerged	634943	634946		yapG	3
RV2039_libmerged	638414	638423		YPO_RS03935	9
RV2039_libmerged	640107	640123		YPO_RS03940	16
RV2039_libmerged	640633	640662		YPO_RS03945	29
RV2039_libmerged	641278	641282		YPO_RS03945	4
RV2039_libmerged	642159	642160		YPO_RS03950	1
RV2039_libmerged	643494	643503		YPO_RS03950	9
RV2039_libmerged	645384	645385		YPO_RS03960	1
RV2039_libmerged	645559	645564		YPO_RS03965	5
RV2039_libmerged	646046	646051		YPO_RS03965	5
RV2039_libmerged	646253	646291		YPO_RS03970	38
RV2039_libmerged	649165	649182		YPO_RS03975	17
RV2039_libmerged	649945	649967		cdiA	22
RV2039_libmerged	650515	650531		cdiA	16
RV2039_libmerged	650969	650971		cdiA	2
RV2039_libmerged	651957	651976		cdiA	19
RV2039_libmerged	652656	652668		cdiA	12
RV2039_libmerged	652839	652840		cdiA	1
RV2039_libmerged	653457	653462		cdiA	5
RV2039_libmerged	654422	654427		cdiA	5
RV2039_libmerged	659257	659299		cdiI	42
RV2039_libmerged	659376	659389		cdiI	13
RV2039_libmerged	660592	660593		YPO_RS04010	1
RV2039_libmerged	662180	662187		yapF	7
RV2039_libmerged	662260	662302		yapF	42
RV2039_libmerged	662362	662368		yapF	6
RV2039_libmerged	663180	663196		yapF	16
RV2039_libmerged	664227	664231		YPO_RS04025	4
RV2039_libmerged	664296	664297		YPO_RS04025	1
RV2039_libmerged	664526	664542		YPO_RS04025	16
RV2039_libmerged	664731	664745		YPO_RS04025	14
RV2039_libmerged	664826	664843		YPO_RS04025	17
RV2039_libmerged	666322	666329		YPO_RS04030	7
RV2039_libmerged	666933	666957		YPO_RS04035	24
RV2039_libmerged	668396	668402		YPO_RS04040	6
RV2039_libmerged	668567	668573		YPO_RS04040	6
RV2039_libmerged	669066	669085		YPO_RS04040	19
RV2039_libmerged	669669	669678		YPO_RS04040	9
RV2039_libmerged	670718	670732		YPO_RS04040	14
RV2039_libmerged	671538	671556		YPO_RS04045	18
RV2039_libmerged	671989	671993		YPO_RS04045	4
RV2039_libmerged	672287	672289		YPO_RS04045	2
RV2039_libmerged	672598	672608		YPO_RS04050	10
RV2039_libmerged	674810	674835		YPO_RS04060	25
RV2039_libmerged	674957	674958		YPO_RS04060	1
RV2039_libmerged	675147	675160		YPO_RS04060	13
RV2039_libmerged	675496	675524		YPO_RS04060	28
RV2039_libmerged	677117	677123		YPO_RS04070	6
RV2039_libmerged	679834	679848		YPO_RS04075	14
RV2039_libmerged	679966	679990		YPO_RS04080	24
RV2039_libmerged	680425	680437		YPO_RS04080	12
RV2039_libmerged	681185	681196		YPO_RS04080	11
RV2039_libmerged	681449	681458		YPO_RS04080	9
RV2039_libmerged	682397	682415		mdtN	18
RV2039_libmerged	682548	682557		mdtN	9
RV2039_libmerged	684948	684952		YPO_RS04100	4
RV2039_libmerged	685271	685277		YPO_RS04100	6
RV2039_libmerged	685307	685309		YPO_RS04100	2
RV2039_libmerged	685877	685913		YPO_RS04105	36
RV2039_libmerged	686247	686262		YPO_RS04105	15
RV2039_libmerged	686313	686326		YPO_RS04105	13
RV2039_libmerged	686656	686661		YPO_RS04105	5
RV2039_libmerged	686706	686710		YPO_RS04105	4
RV2039_libmerged	686798	686799		YPO_RS04105	1
RV2039_libmerged	687196	687208		YPO_RS04110	12
RV2039_libmerged	687729	687732		YPO_RS04115	3
RV2039_libmerged	687832	687847		YPO_RS04115	15
RV2039_libmerged	687894	687897		YPO_RS04115	3
RV2039_libmerged	688077	688097		YPO_RS04120	20
RV2039_libmerged	688180	688201		YPO_RS04120	21
RV2039_libmerged	688238	688327		YPO_RS04120	89
RV2039_libmerged	689609	689625		YPO_RS04130	16
RV2039_libmerged	693608	693630		YPO_RS04155	22
RV2039_libmerged	693801	693810		YPO_RS04160	9
RV2039_libmerged	693848	693900		YPO_RS04160	52
RV2039_libmerged	693977	693982		YPO_RS04160	5
RV2039_libmerged	694057	694121		YPO_RS04160	64
RV2039_libmerged	694342	694345		YPO_RS04160	3
RV2039_libmerged	694709	694792		YPO_RS04160	83
RV2039_libmerged	694903	694973		YPO_RS04165	70
RV2039_libmerged	695048	695186		YPO_RS04165	138
RV2039_libmerged	695386	695394		YPO_RS04165	8
RV2039_libmerged	695506	695534		YPO_RS04165	28
RV2039_libmerged	697092	697107		YPO_RS04170	15
RV2039_libmerged	697574	697582		YPO_RS04175	8
RV2039_libmerged	697817	697824		YPO_RS04180	7
RV2039_libmerged	699686	699692		rpoD	6
RV2039_libmerged	699773	699790		rpoD	17
RV2039_libmerged	700612	700613		rpoD	1
RV2039_libmerged	702093	702108		dnaG	15
RV2039_libmerged	702212	702214		dnaG	2
RV2039_libmerged	702684	702688		dnaG	4
RV2039_libmerged	703174	703175		rpsU	1
RV2039_libmerged	705086	705087		plsY	1
RV2039_libmerged	705191	705211		plsY	20
RV2039_libmerged	705414	705423		plsY	9
RV2039_libmerged	705752	705759		folB	7
RV2039_libmerged	706363	706367		bacA	4
RV2039_libmerged	708817	708818		YPO_RS04235	1
RV2039_libmerged	712847	712873		glnE	26
RV2039_libmerged	713164	713180		glnE	16
RV2039_libmerged	714267	714275		hldE	8
RV2039_libmerged	715406	715407		hldE	1
RV2039_libmerged	720483	720489		YPO_RS04275	6
RV2039_libmerged	721102	721109		YPO_RS04275	7
RV2039_libmerged	723739	723750		tolC	11
RV2039_libmerged	724353	724358		nudF	5
RV2039_libmerged	725614	725629		cpdA	15
RV2039_libmerged	726235	726239		cpdA	4
RV2039_libmerged	726354	726368		yqiA	14
RV2039_libmerged	727272	727297		parE	25
RV2039_libmerged	728812	728820		parE	8
RV2039_libmerged	729325	729353		YPO_RS04315	28
RV2039_libmerged	729822	729836		YPO_RS04315	14
RV2039_libmerged	730683	730703		YPO_RS04325	20
RV2039_libmerged	730865	730870		parC	5
RV2039_libmerged	731083	731096		parC	13
RV2039_libmerged	731669	731674		parC	5
RV2039_libmerged	731980	731983		parC	3
RV2039_libmerged	734339	734341		ftsP	2
RV2039_libmerged	738782	738786		dkgA	4
RV2039_libmerged	739194	739195		dkgA	1
RV2039_libmerged	739342	739349		YPO_RS04355	7
RV2039_libmerged	739495	739501		YPO_RS04355	6
RV2039_libmerged	739619	739623		yqhD	4
RV2039_libmerged	740196	740205		yqhD	9
RV2039_libmerged	740750	740751		yqhD	1
RV2039_libmerged	741250	741280		YPO_RS04365	30
RV2039_libmerged	743562	743596		metC	34
RV2039_libmerged	743755	743818		metC	63
RV2039_libmerged	745042	745059		exbB	17
RV2039_libmerged	746545	746555		YPO_RS04390	10
RV2039_libmerged	746670	746671		YPO_RS04390	1
RV2039_libmerged	746898	746939		YPO_RS04390	41
RV2039_libmerged	747116	747166		YPO_RS04390	50
RV2039_libmerged	747198	747210		YPO_RS04390	12
RV2039_libmerged	747416	747454		YPO_RS04390	38
RV2039_libmerged	748082	748090		YPO_RS04395	8
RV2039_libmerged	749098	749118		YPO_RS04405	20
RV2039_libmerged	749326	749378		YPO_RS04405	52
RV2039_libmerged	749484	749490		YPO_RS04405	6
RV2039_libmerged	749623	749645		YPO_RS04405	22
RV2039_libmerged	749629	749723		YPO_RS04410	94
RV2039_libmerged	749837	749843		YPO_RS04410	6
RV2039_libmerged	749978	750062		YPO_RS04410	84
RV2039_libmerged	750192	750194		YPO_RS04410	2
RV2039_libmerged	750249	750280		YPO_RS04410	31
RV2039_libmerged	750413	750431		YPO_RS04410	18
RV2039_libmerged	751066	751143		YPO_RS04415	77
RV2039_libmerged	751470	751492		YPO_RS04420	22
RV2039_libmerged	751603	751607		YPO_RS04420	4
RV2039_libmerged	752053	752067		YPO_RS04420	14
RV2039_libmerged	752421	752469		YPO_RS04420	48
RV2039_libmerged	752629	752642		YPO_RS04425	13
RV2039_libmerged	752674	752682		YPO_RS04425	8
RV2039_libmerged	752929	752935		YPO_RS04425	6
RV2039_libmerged	753477	753498		YPO_RS04425	21
RV2039_libmerged	753534	753569		YPO_RS04425	35
RV2039_libmerged	753827	753864		YPO_RS04430	37
RV2039_libmerged	753939	753974		YPO_RS04430	35
RV2039_libmerged	754036	754039		YPO_RS04430	3
RV2039_libmerged	754411	754431		YPO_RS04435	20
RV2039_libmerged	754546	754556		YPO_RS04440	10
RV2039_libmerged	754854	754858		YPO_RS04440	4
RV2039_libmerged	754990	755067		YPO_RS04440	77
RV2039_libmerged	755156	755168		YPO_RS04440	12
RV2039_libmerged	755343	755372		YPO_RS04440	29
RV2039_libmerged	755369	755375		YPO_RS04445	6
RV2039_libmerged	755533	755537		YPO_RS04445	4
RV2039_libmerged	755579	755585		YPO_RS04445	6
RV2039_libmerged	755772	755794		YPO_RS04445	22
RV2039_libmerged	755910	755919		YPO_RS04445	9
RV2039_libmerged	755960	755964		YPO_RS04445	4
RV2039_libmerged	756014	756041		YPO_RS04445	27
RV2039_libmerged	756419	756421		YPO_RS04450	2
RV2039_libmerged	756516	756572		YPO_RS04450	56
RV2039_libmerged	756626	756650		YPO_RS04450	24
RV2039_libmerged	756909	756940		YPO_RS04455	31
RV2039_libmerged	757066	757125		YPO_RS04455	59
RV2039_libmerged	757231	757339		YPO_RS04455	108
RV2039_libmerged	757676	757734		YPO_RS04460	58
RV2039_libmerged	757806	757865		YPO_RS04460	59
RV2039_libmerged	757919	758067		YPO_RS04460	148
RV2039_libmerged	758463	758483		YPO_RS04465	20
RV2039_libmerged	758860	758864		YPO_RS04465	4
RV2039_libmerged	759925	759928		YPO_RS04465	3
RV2039_libmerged	761708	761709		YPO_RS04475	1
RV2039_libmerged	762085	762087		YPO_RS04475	2
RV2039_libmerged	762251	762285		YPO_RS04475	34
RV2039_libmerged	762479	762518		YPO_RS04475	39
RV2039_libmerged	762718	762728		YPO_RS04475	10
RV2039_libmerged	762990	762991		fepB	1
RV2039_libmerged	763096	763102		fepB	6
RV2039_libmerged	763775	763817		fepB	42
RV2039_libmerged	765598	765604		YPO_RS04485	6
RV2039_libmerged	765687	765701		YPO_RS04485	14
RV2039_libmerged	765775	765790		YPO_RS04485	15
RV2039_libmerged	765847	765861		YPO_RS04485	14
RV2039_libmerged	765909	765920		YPO_RS04485	11
RV2039_libmerged	769137	769150		flhB	13
RV2039_libmerged	770216	770217		YPO_RS04505	1
RV2039_libmerged	770618	770620		YPO_RS04505	2
RV2039_libmerged	770042	770050		YPO_RS04505	8
RV2039_libmerged	772017	772029		fliN	12
RV2039_libmerged	772532	772568		YPO_RS04525	36
RV2039_libmerged	772599	772605		YPO_RS04525	6
RV2039_libmerged	774472	774488		YPO_RS04530	16
RV2039_libmerged	774704	774710		fliE	6
RV2039_libmerged	775319	775337		fliF	18
RV2039_libmerged	776421	776427		fliF	6
RV2039_libmerged	779666	779668		fliI	2
RV2039_libmerged	779857	779864		fliJ	7
RV2039_libmerged	782292	782293		flgA	1
RV2039_libmerged	782351	782359		flgB	8
RV2039_libmerged	783327	783337		flgD	10
RV2039_libmerged	783625	783631		flgD	6
RV2039_libmerged	784792	784793		flaE	1
RV2039_libmerged	785290	785360		YPO_RS04600	70
RV2039_libmerged	785515	785518		YPO_RS04605	3
RV2039_libmerged	785583	785621		YPO_RS04605	38
RV2039_libmerged	785677	785705		YPO_RS04605	28
RV2039_libmerged	785778	785800		YPO_RS04605	22
RV2039_libmerged	785858	785862		YPO_RS04605	4
RV2039_libmerged	787729	787736		flgH	7
RV2039_libmerged	787903	787907		flgH	4
RV2039_libmerged	788008	788016		flgH	8
RV2039_libmerged	789374	789382		flgJ	8
RV2039_libmerged	789632	789652		flgJ	20
RV2039_libmerged	789946	789957		flgK	11
RV2039_libmerged	791356	791370		flgL	14
RV2039_libmerged	791436	791453		flgL	17
RV2039_libmerged	791590	791610		flgL	20
RV2039_libmerged	792412	792428		YPO_RS04645	16
RV2039_libmerged	793541	793565		YPO_RS04650	24
RV2039_libmerged	794746	794755		YPO_RS04655	9
RV2039_libmerged	795387	795397		YPO_RS04660	10
RV2039_libmerged	796074	796100		YPO_RS04660	26
RV2039_libmerged	797878	797884		YPO_RS04665	6
RV2039_libmerged	797991	797995		YPO_RS04665	4
RV2039_libmerged	800865	800890		fliD	25
RV2039_libmerged	801138	801146		fliD	8
RV2039_libmerged	801468	801493		fliS	25
RV2039_libmerged	801564	801575		fliS	11
RV2039_libmerged	801645	801672		fliS	27
RV2039_libmerged	802597	802686		YPO_RS04690	89
RV2039_libmerged	803679	803685		YPO_RS04695	6
RV2039_libmerged	804262	804264		YPO_RS04700	2
RV2039_libmerged	804451	804464		motA	13
RV2039_libmerged	804771	804791		motA	20
RV2039_libmerged	804961	804965		motA	4
RV2039_libmerged	808991	808998		YPO_RS04735	7
RV2039_libmerged	809069	809080		YPO_RS04735	11
RV2039_libmerged	809222	809233		YPO_RS04735	11
RV2039_libmerged	809842	809851		YPO_RS04740	9
RV2039_libmerged	810115	810119		YPO_RS04740	4
RV2039_libmerged	810421	810437		YPO_RS04740	16
RV2039_libmerged	810712	810726		YPO_RS04740	14
RV2039_libmerged	810795	810811		YPO_RS04740	16
RV2039_libmerged	811081	811109		YPO_RS04740	28
RV2039_libmerged	811086	811109		YPO_RS04745	23
RV2039_libmerged	811923	811942		YPO_RS04745	19
RV2039_libmerged	812775	812780		YPO_RS04750	5
RV2039_libmerged	813926	813935		YPO_RS04755	9
RV2039_libmerged	815018	815038		YPO_RS04755	20
RV2039_libmerged	815488	815496		YPO_RS04760	8
RV2039_libmerged	816719	816727		YPO_RS04765	8
RV2039_libmerged	816880	816884		YPO_RS04770	4
RV2039_libmerged	818738	818748		YPO_RS04770	10
RV2039_libmerged	819648	819649		YPO_RS04770	1
RV2039_libmerged	820516	820517		YPO_RS04770	1
RV2039_libmerged	822481	822499		YPO_RS04775	18
RV2039_libmerged	823048	823081		vgrG	33
RV2039_libmerged	824472	824483		vgrG	11
RV2039_libmerged	830442	830451		gntP	9
RV2039_libmerged	830658	830669		gntP	11
RV2039_libmerged	830714	830721		gntP	7
RV2039_libmerged	830927	830940		gntP	13
RV2039_libmerged	831416	831438		gntP	22
RV2039_libmerged	833019	833049		YPO_RS04795	30
RV2039_libmerged	835099	835121		YPO_RS04805	22
RV2039_libmerged	837247	837248		YPO_RS04810	1
RV2039_libmerged	837342	837357		YPO_RS04810	15
RV2039_libmerged	837540	837548		YPO_RS04810	8
RV2039_libmerged	837662	837696		YPO_RS04810	34
RV2039_libmerged	837752	837770		YPO_RS04810	18
RV2039_libmerged	837922	837927		YPO_RS04810	5
RV2039_libmerged	838513	838517		YPO_RS04810	4
RV2039_libmerged	839033	839079		YPO_RS04815	46
RV2039_libmerged	839272	839296		YPO_RS04815	24
RV2039_libmerged	839816	839826		YPO_RS04815	10
RV2039_libmerged	841012	841023		YPO_RS04825	11
RV2039_libmerged	842071	842073		YPO_RS04830	2
RV2039_libmerged	842947	842969		YPO_RS04835	22
RV2039_libmerged	843123	843144		YPO_RS04835	21
RV2039_libmerged	843867	843870		YPO_RS04835	3
RV2039_libmerged	844121	844141		YPO_RS04835	20
RV2039_libmerged	844231	844288		YPO_RS04835	57
RV2039_libmerged	844428	844433		YPO_RS04835	5
RV2039_libmerged	844886	844914		YPO_RS04835	28
RV2039_libmerged	845170	845212		YPO_RS04835	42
RV2039_libmerged	845991	845998		YPO_RS04835	7
RV2039_libmerged	847055	847110		YPO_RS04835	55
RV2039_libmerged	847524	847558		YPO_RS04835	34
RV2039_libmerged	849765	849773		YPO_RS04840	8
RV2039_libmerged	850129	850142		YPO_RS04840	13
RV2039_libmerged	852272	852279		YPO_RS04845	7
RV2039_libmerged	852378	852392		YPO_RS04845	14
RV2039_libmerged	852506	852510		YPO_RS04845	4
RV2039_libmerged	852703	852707		YPO_RS04845	4
RV2039_libmerged	852905	852939		YPO_RS04845	34
RV2039_libmerged	853910	853932		YPO_RS04845	22
RV2039_libmerged	854032	854042		YPO_RS04845	10
RV2039_libmerged	855904	855923		YPO_RS04845	19
RV2039_libmerged	856541	856554		YPO_RS04845	13
RV2039_libmerged	856997	857012		YPO_RS04850	15
RV2039_libmerged	857088	857126		YPO_RS04850	38
RV2039_libmerged	857158	857175		YPO_RS04850	17
RV2039_libmerged	857394	857494		YPO_RS04850	100
RV2039_libmerged	857575	857682		YPO_RS04850	107
RV2039_libmerged	857908	857911		YPO_RS04855	3
RV2039_libmerged	857974	858009		YPO_RS04855	35
RV2039_libmerged	858055	858137		YPO_RS04855	82
RV2039_libmerged	858210	858219		YPO_RS04855	9
RV2039_libmerged	858434	858517		YPO_RS04855	83
RV2039_libmerged	858579	858613		YPO_RS04855	34
RV2039_libmerged	858763	858782		YPO_RS04855	19
RV2039_libmerged	858880	858894		YPO_RS04860	14
RV2039_libmerged	858966	858982		YPO_RS04860	16
RV2039_libmerged	860383	860384		lgt	1
RV2039_libmerged	860718	860721		lgt	3
RV2039_libmerged	862651	862655		ptsP	4
RV2039_libmerged	864006	864011		rppH	5
RV2039_libmerged	866321	866336		YPO_RS04890	15
RV2039_libmerged	866552	866559		YPO_RS04890	7
RV2039_libmerged	867828	867848		YPO_RS04900	20
RV2039_libmerged	868243	868261		lplT	18
RV2039_libmerged	869340	869362		aas	22
RV2039_libmerged	869541	869543		aas	2
RV2039_libmerged	869962	869969		aas	7
RV2039_libmerged	871127	871142		aas	15
RV2039_libmerged	871928	871964		YPO_RS04915	36
RV2039_libmerged	872289	872295		YPO_RS04915	6
RV2039_libmerged	876070	876090		lysA	20
RV2039_libmerged	876432	876439		lysA	7
RV2039_libmerged	876513	876519		lysA	6
RV2039_libmerged	877031	877037		YPO_RS04930	6
RV2039_libmerged	877255	877256		YPO_RS04930	1
RV2039_libmerged	877335	877342		YPO_RS04930	7
RV2039_libmerged	879523	879538		YPO_RS04940	15
RV2039_libmerged	879765	879784		YPO_RS04940	19
RV2039_libmerged	880409	880434		YPO_RS04945	25
RV2039_libmerged	880689	880698		YPO_RS04945	9
RV2039_libmerged	882538	882552		YPO_RS04955	14
RV2039_libmerged	882784	882799		YPO_RS04955	15
RV2039_libmerged	883465	883495		YPO_RS04955	30
RV2039_libmerged	883624	883628		YPO_RS04955	4
RV2039_libmerged	884009	884016		YPO_RS04960	7
RV2039_libmerged	884375	884422		YPO_RS04965	47
RV2039_libmerged	884493	884494		YPO_RS04965	1
RV2039_libmerged	884647	884660		YPO_RS04965	13
RV2039_libmerged	884738	884764		YPO_RS04965	26
RV2039_libmerged	884825	884844		YPO_RS04965	19
RV2039_libmerged	884883	884907		YPO_RS04965	24
RV2039_libmerged	885582	885605		YPO_RS04975	23
RV2039_libmerged	885677	885685		YPO_RS04975	8
RV2039_libmerged	886460	886471		YPO_RS04980	11
RV2039_libmerged	886591	886656		YPO_RS04980	65
RV2039_libmerged	886719	886795		YPO_RS04980	76
RV2039_libmerged	886838	886865		YPO_RS04980	27
RV2039_libmerged	886983	886992		gspL	9
RV2039_libmerged	887043	887076		gspL	33
RV2039_libmerged	887344	887366		gspL	22
RV2039_libmerged	887419	887425		gspL	6
RV2039_libmerged	887744	887789		gspL	45
RV2039_libmerged	887983	887984		gspL	1
RV2039_libmerged	888147	888172		YPO_RS04990	25
RV2039_libmerged	888217	888237		YPO_RS04990	20
RV2039_libmerged	888510	888539		YPO_RS04990	29
RV2039_libmerged	888634	888640		YPO_RS04990	6
RV2039_libmerged	888707	888802		YPO_RS04990	95
RV2039_libmerged	888928	888951		YPO_RS04990	23
RV2039_libmerged	889268	889370		gspJ	102
RV2039_libmerged	889417	889539		gspJ	122
RV2039_libmerged	889640	889658		gspI	18
RV2039_libmerged	889758	889770		gspI	12
RV2039_libmerged	890021	890042		YPO_RS05005	21
RV2039_libmerged	890167	890168		YPO_RS05005	1
RV2039_libmerged	890451	890462		YPO_RS05005	11
RV2039_libmerged	890862	890877		gspG	15
RV2039_libmerged	890915	890923		gspG	8
RV2039_libmerged	892176	892200		gspE	24
RV2039_libmerged	892368	892369		gspE	1
RV2039_libmerged	892479	892481		gspE	2
RV2039_libmerged	892827	892836		gspE	9
RV2039_libmerged	892949	892966		gspE	17
RV2039_libmerged	893197	893209		gspE	12
RV2039_libmerged	893341	893355		gspE	14
RV2039_libmerged	893617	893655		gspE	38
RV2039_libmerged	893738	893803		gspD	65
RV2039_libmerged	893863	893895		gspD	32
RV2039_libmerged	894076	894098		gspD	22
RV2039_libmerged	894373	894376		gspD	3
RV2039_libmerged	894623	894633		gspD	10
RV2039_libmerged	894939	894968		gspD	29
RV2039_libmerged	895155	895222		gspD	67
RV2039_libmerged	895437	895464		gspD	27
RV2039_libmerged	895720	895756		YPO_RS05030	36
RV2039_libmerged	895978	896016		YPO_RS05030	38
RV2039_libmerged	896084	896096		YPO_RS05030	12
RV2039_libmerged	896258	896275		YPO_RS05035	17
RV2039_libmerged	896360	896371		YPO_RS05035	11
RV2039_libmerged	896469	896526		YPO_RS05035	57
RV2039_libmerged	896631	896647		YPO_RS05035	16
RV2039_libmerged	897417	897464		YPO_RS05040	47
RV2039_libmerged	897584	897606		YPO_RS05040	22
RV2039_libmerged	898668	898669		YPO_RS05045	1
RV2039_libmerged	899811	899833		YPO_RS05050	22
RV2039_libmerged	900035	900086		YPO_RS05050	51
RV2039_libmerged	900332	900345		YPO_RS05050	13
RV2039_libmerged	900384	900408		YPO_RS05050	24
RV2039_libmerged	900594	900598		yapM	4
RV2039_libmerged	900831	900840		yapM	9
RV2039_libmerged	901004	901059		yapM	55
RV2039_libmerged	901197	901220		yapM	23
RV2039_libmerged	901295	901320		yapM	25
RV2039_libmerged	902135	902147		yapM	12
RV2039_libmerged	902392	902400		yapM	8
RV2039_libmerged	902640	902676		yapM	36
RV2039_libmerged	903044	903059		YPO_RS05060	15
RV2039_libmerged	903452	903461		YPO_RS05060	9
RV2039_libmerged	903731	903758		YPO_RS05060	27
RV2039_libmerged	903834	903837		YPO_RS05060	3
RV2039_libmerged	904246	904249		YPO_RS05060	3
RV2039_libmerged	904760	904787		YPO_RS05060	27
RV2039_libmerged	904996	905004		YPO_RS05060	8
RV2039_libmerged	905128	905138		YPO_RS05060	10
RV2039_libmerged	905291	905292		YPO_RS05060	1
RV2039_libmerged	906238	906343		YPO_RS05065	105
RV2039_libmerged	906502	906522		YPO_RS05065	20
RV2039_libmerged	906582	906677		YPO_RS05065	95
RV2039_libmerged	906746	906760		YPO_RS05065	14
RV2039_libmerged	906884	906917		YPO_RS05065	33
RV2039_libmerged	907049	907073		YPO_RS05070	24
RV2039_libmerged	907226	907229		YPO_RS05070	3
RV2039_libmerged	907294	907318		YPO_RS05070	24
RV2039_libmerged	907545	907563		YPO_RS05070	18
RV2039_libmerged	907614	907643		YPO_RS05070	29
RV2039_libmerged	907844	907878		YPO_RS05070	34
RV2039_libmerged	907942	908005		YPO_RS05070	63
RV2039_libmerged	908119	908210		tnpA	91
RV2039_libmerged	908243	908296		tnpA	53
RV2039_libmerged	908339	908356		tnpA	17
RV2039_libmerged	908466	908530		tnpA	64
RV2039_libmerged	909532	909535		YPO_RS05080	3
RV2039_libmerged	909816	909819		YPO_RS05080	3
RV2039_libmerged	910206	910216		YPO_RS05080	10
RV2039_libmerged	910261	910264		YPO_RS05080	3
RV2039_libmerged	911893	911939		YPO_RS05085	46
RV2039_libmerged	912886	912891		kbaZ	5
RV2039_libmerged	914634	914641		YPO_RS05095	7
RV2039_libmerged	915563	915577		YPO_RS05105	14
RV2039_libmerged	916119	916125		YPO_RS05110	6
RV2039_libmerged	918804	918814		kduD	10
RV2039_libmerged	919562	919573		YPO_RS05130	11
RV2039_libmerged	921351	921370		YPO_RS05135	19
RV2039_libmerged	922496	922497		YPO_RS05140	1
RV2039_libmerged	923135	923140		YPO_RS05140	5
RV2039_libmerged	924026	924043		YPO_RS05145	17
RV2039_libmerged	924469	924481		YPO_RS05145	12
RV2039_libmerged	925177	925189		YPO_RS05145	12
RV2039_libmerged	925511	925522		YPO_RS05150	11
RV2039_libmerged	925622	925624		YPO_RS05150	2
RV2039_libmerged	926393	926397		YPO_RS05155	4
RV2039_libmerged	926724	926727		YPO_RS05155	3
RV2039_libmerged	927940	927943		YPO_RS05160	3
RV2039_libmerged	928772	928797		YPO_RS05165	25
RV2039_libmerged	929277	929299		YPO_RS05165	22
RV2039_libmerged	929831	929838		YPO_RS05165	7
RV2039_libmerged	930160	930175		YPO_RS05170	15
RV2039_libmerged	930875	930916		YPO_RS05170	41
RV2039_libmerged	931304	931337		YPO_RS05170	33
RV2039_libmerged	931794	931816		YPO_RS05170	22
RV2039_libmerged	934944	934978		YPO_RS05180	34
RV2039_libmerged	935193	935199		YPO_RS05180	6
RV2039_libmerged	937313	937332		YPO_RS05190	19
RV2039_libmerged	937508	937510		YPO_RS05190	2
RV2039_libmerged	937877	937881		YPO_RS05190	4
RV2039_libmerged	938012	938013		YPO_RS05190	1
RV2039_libmerged	938466	938468		YPO_RS05195	2
RV2039_libmerged	938961	938977		YPO_RS05195	16
RV2039_libmerged	939494	939580		YPO_RS05200	86
RV2039_libmerged	939638	939653		YPO_RS05200	15
RV2039_libmerged	939845	939852		YPO_RS05200	7
RV2039_libmerged	940236	940240		YPO_RS05200	4
RV2039_libmerged	940332	940333		YPO_RS05200	1
RV2039_libmerged	940345	940352		YPO_RS05205	7
RV2039_libmerged	940431	940433		YPO_RS05205	2
RV2039_libmerged	942703	942706		YPO_RS05210	3
RV2039_libmerged	943756	943769		YPO_RS05215	13
RV2039_libmerged	944217	944229		YPO_RS05215	12
RV2039_libmerged	944409	944411		YPO_RS05215	2
RV2039_libmerged	945352	945355		YPO_RS05220	3
RV2039_libmerged	946319	946351		YPO_RS05220	32
RV2039_libmerged	947192	947193		YPO_RS05225	1
RV2039_libmerged	948312	948315		YPO_RS05230	3
RV2039_libmerged	950063	950120		YPO_RS05235	57
RV2039_libmerged	950322	950331		YPO_RS05235	9
RV2039_libmerged	953224	953252		YPO_RS05255	28
RV2039_libmerged	954119	954162		YPO_RS05260	43
RV2039_libmerged	954252	954267		YPO_RS05260	15
RV2039_libmerged	955831	955838		YPO_RS05270	7
RV2039_libmerged	956467	956476		YPO_RS05270	9
RV2039_libmerged	957080	957082		YPO_RS05270	2
RV2039_libmerged	957156	957167		YPO_RS05270	11
RV2039_libmerged	957803	957816		YPO_RS05270	13
RV2039_libmerged	957904	957912		YPO_RS05270	8
RV2039_libmerged	958352	958411		YPO_RS05275	59
RV2039_libmerged	958464	958499		YPO_RS05275	35
RV2039_libmerged	958585	958612		YPO_RS05275	27
RV2039_libmerged	959349	959411		YPO_RS05285	62
RV2039_libmerged	959594	959596		YPO_RS05290	2
RV2039_libmerged	959654	959667		YPO_RS05290	13
RV2039_libmerged	960223	960233		YPO_RS05290	10
RV2039_libmerged	960963	960964		YPO_RS05290	1
RV2039_libmerged	961468	961470		YPO_RS05295	2
RV2039_libmerged	963407	963409		YPO_RS05305	2
RV2039_libmerged	963452	963493		YPO_RS05305	41
RV2039_libmerged	964298	964307		YPO_RS05320	9
RV2039_libmerged	964448	964459		YPO_RS05325	11
RV2039_libmerged	967714	967717		YPO_RS05335	3
RV2039_libmerged	968200	968202		YPO_RS05340	2
RV2039_libmerged	968342	968358		YPO_RS05340	16
RV2039_libmerged	969017	969033		YPO_RS05350	16
RV2039_libmerged	969089	969094		YPO_RS05350	5
RV2039_libmerged	970097	970124		YPO_RS05360	27
RV2039_libmerged	970458	970469		YPO_RS05360	11
RV2039_libmerged	970502	970514		YPO_RS05360	12
RV2039_libmerged	972402	972417		lysS	15
RV2039_libmerged	974890	974892		recJ	2
RV2039_libmerged	975008	975015		recJ	7
RV2039_libmerged	976137	976140		recJ	3
RV2039_libmerged	976784	976787		dsbC	3
RV2039_libmerged	977367	977376		xerD	9
RV2039_libmerged	978157	978186		fldB	29
RV2039_libmerged	979052	979057		creD	5
RV2039_libmerged	979999	980011		creD	12
RV2039_libmerged	981853	981878		creB	25
RV2039_libmerged	983527	983537		ygfZ	10
RV2039_libmerged	984422	984428		YPO_RS05430	6
RV2039_libmerged	985177	985186		YPO_RS05435	9
RV2039_libmerged	986120	986135		YPO_RS05440	15
RV2039_libmerged	986305	986323		YPO_RS05440	18
RV2039_libmerged	986887	986904		YPO_RS05440	17
RV2039_libmerged	990615	990616		YPO_RS05455	1
RV2039_libmerged	990830	990838		YPO_RS05455	8
RV2039_libmerged	990905	990910		YPO_RS05455	5
RV2039_libmerged	992208	992209		gcvP	1
RV2039_libmerged	993010	993012		gcvP	2
RV2039_libmerged	993111	993122		gcvP	11
RV2039_libmerged	994764	994765		gcvH	1
RV2039_libmerged	995373	995375		gcvT	2
RV2039_libmerged	995850	995857		gcvT	7
RV2039_libmerged	997870	997872		ubiI	2
RV2039_libmerged	998898	998900		ubiH	2
RV2039_libmerged	999216	999219		ubiH	3
RV2039_libmerged	1001186	1001191		YPO_RS05490	5
RV2039_libmerged	1003542	1003547		serA	5
RV2039_libmerged	1004743	1004754		rpiA	11
RV2039_libmerged	1006827	1006840		YPO_RS05525	13
RV2039_libmerged	1007704	1007708		argO	4
RV2039_libmerged	1010171	1010172		fbaA	1
RV2039_libmerged	1010331	1010333		fbaA	2
RV2039_libmerged	1013665	1013684		YPO_RS05555	19
RV2039_libmerged	1013757	1013778		YPO_RS05555	21
RV2039_libmerged	1013880	1013945		YPO_RS05555	65
RV2039_libmerged	1014008	1014048		YPO_RS05555	40
RV2039_libmerged	1014110	1014137		YPO_RS05555	27
RV2039_libmerged	1014223	1014276		YPO_RS05555	53
RV2039_libmerged	1014318	1014327		YPO_RS05555	9
RV2039_libmerged	1014378	1014399		YPO_RS05560	21
RV2039_libmerged	1014599	1014618		YPO_RS05560	19
RV2039_libmerged	1014699	1014837		YPO_RS05560	138
RV2039_libmerged	1014874	1014890		YPO_RS05560	16
RV2039_libmerged	1014928	1014990		YPO_RS05560	62
RV2039_libmerged	1015101	1015107		YPO_RS05560	6
RV2039_libmerged	1015183	1015185		YPO_RS05560	2
RV2039_libmerged	1015288	1015296		YPO_RS05560	8
RV2039_libmerged	1015371	1015380		YPO_RS05560	9
RV2039_libmerged	1015580	1015604		YPO_RS05565	24
RV2039_libmerged	1015665	1015701		YPO_RS05565	36
RV2039_libmerged	1015783	1015794		YPO_RS05565	11
RV2039_libmerged	1015843	1015848		YPO_RS05565	5
RV2039_libmerged	1015968	1016020		YPO_RS05565	52
RV2039_libmerged	1016855	1016859		tkt	4
RV2039_libmerged	1016923	1016945		tkt	22
RV2039_libmerged	1017667	1017669		tkt	2
RV2039_libmerged	1018102	1018103		tkt	1
RV2039_libmerged	1019108	1019115		YPO_RS05575	7
RV2039_libmerged	1019176	1019183		YPO_RS05575	7
RV2039_libmerged	1020684	1020686		speA	2
RV2039_libmerged	1020809	1020818		speA	9
RV2039_libmerged	1022161	1022186		speA	25
RV2039_libmerged	1023532	1023557		metK	25
RV2039_libmerged	1024876	1024878		YPO_RS05600	2
RV2039_libmerged	1025985	1025998		endA	13
RV2039_libmerged	1026737	1026762		rsmE	25
RV2039_libmerged	1026970	1026985		rsmE	15
RV2039_libmerged	1027219	1027224		gshB	5
RV2039_libmerged	1027329	1027331		gshB	2
RV2039_libmerged	1028001	1028014		gshB	13
RV2039_libmerged	1028585	1028591		YPO_RS05620	6
RV2039_libmerged	1028821	1028834		YPO_RS05620	13
RV2039_libmerged	1028834	1028880		ruvX	46
RV2039_libmerged	1031868	1031871		YPO_RS05640	3
RV2039_libmerged	1032485	1032491		YPO_RS05640	6
RV2039_libmerged	1034895	1034900		YPO_RS05655	5
RV2039_libmerged	1035030	1035033		YPO_RS05655	3
RV2039_libmerged	1035113	1035122		YPO_RS05655	9
RV2039_libmerged	1035355	1035356		YPO_RS05660	1
RV2039_libmerged	1035573	1035593		YPO_RS05665	20
RV2039_libmerged	1037174	1037223		hemW	49
RV2039_libmerged	1037259	1037273		hemW	14
RV2039_libmerged	1037486	1037488		YPO_RS05675	2
RV2039_libmerged	1037607	1037640		YPO_RS05675	33
RV2039_libmerged	1037808	1037827		YPO_RS05675	19
RV2039_libmerged	1037860	1037912		YPO_RS05675	52
RV2039_libmerged	1038557	1038587		YPO_RS05675	30
RV2039_libmerged	1038994	1039000		YPO_RS05675	6
RV2039_libmerged	1039058	1039196		YPO_RS05675	138
RV2039_libmerged	1039353	1039361		YPO_RS05675	8
RV2039_libmerged	1039393	1039408		YPO_RS05675	15
RV2039_libmerged	1039459	1039508		YPO_RS05675	49
RV2039_libmerged	1039617	1039630		YPO_RS05675	13
RV2039_libmerged	1039686	1039690		YPO_RS05675	4
RV2039_libmerged	1039831	1039834		YPO_RS05675	3
RV2039_libmerged	1039888	1039890		YPO_RS05675	2
RV2039_libmerged	1040033	1040049		YPO_RS05675	16
RV2039_libmerged	1040303	1040356		YPO_RS05675	53
RV2039_libmerged	1040728	1040743		YPO_RS05675	15
RV2039_libmerged	1040794	1040806		YPO_RS05675	12
RV2039_libmerged	1040946	1041039		YPO_RS05675	93
RV2039_libmerged	1041651	1041730		YPO_RS05675	79
RV2039_libmerged	1042608	1042630		YPO_RS05675	22
RV2039_libmerged	1042764	1042771		YPO_RS05675	7
RV2039_libmerged	1042880	1042888		YPO_RS05675	8
RV2039_libmerged	1043038	1043046		YPO_RS05675	8
RV2039_libmerged	1043783	1043798		YPO_RS05675	15
RV2039_libmerged	1043962	1043978		YPO_RS05675	16
RV2039_libmerged	1044266	1044273		YPO_RS05675	7
RV2039_libmerged	1044395	1044404		YPO_RS05675	9
RV2039_libmerged	1044503	1044539		YPO_RS05675	36
RV2039_libmerged	1044617	1044660		YPO_RS05675	43
RV2039_libmerged	1044766	1044832		YPO_RS05675	66
RV2039_libmerged	1045038	1045040		YPO_RS05675	2
RV2039_libmerged	1045271	1045300		YPO_RS05675	29
RV2039_libmerged	1045425	1045426		YPO_RS05675	1
RV2039_libmerged	1045541	1045562		YPO_RS05675	21
RV2039_libmerged	1045628	1045657		YPO_RS05675	29
RV2039_libmerged	1045813	1045877		YPO_RS05675	64
RV2039_libmerged	1045974	1045979		YPO_RS05675	5
RV2039_libmerged	1046208	1046221		YPO_RS05675	13
RV2039_libmerged	1046431	1046438		YPO_RS05675	7
RV2039_libmerged	1048643	1048645		glsB	2
RV2039_libmerged	1048814	1048817		glsB	3
RV2039_libmerged	1049075	1049080		glsB	5
RV2039_libmerged	1049387	1049416		YPO_RS05690	29
RV2039_libmerged	1049989	1050004		trmB	15
RV2039_libmerged	1050655	1050660		mutY	5
RV2039_libmerged	1052560	1052563		mltC	3
RV2039_libmerged	1053147	1053151		mltC	4
RV2039_libmerged	1056890	1056892		YPO_RS05720	2
RV2039_libmerged	1057129	1057153		YPO_RS05725	24
RV2039_libmerged	1057626	1057653		YPO_RS05725	27
RV2039_libmerged	1057996	1058002		YPO_RS05725	6
RV2039_libmerged	1058329	1058331		YPO_RS05730	2
RV2039_libmerged	1058537	1058558		YPO_RS05730	21
RV2039_libmerged	1058822	1058871		YPO_RS05730	49
RV2039_libmerged	1059607	1059643		YPO_RS05735	36
RV2039_libmerged	1059973	1059981		YPO_RS05735	8
RV2039_libmerged	1061110	1061114		speF	4
RV2039_libmerged	1061156	1061157		speF	1
RV2039_libmerged	1061521	1061554		speF	33
RV2039_libmerged	1062097	1062126		speF	29
RV2039_libmerged	1062216	1062219		speF	3
RV2039_libmerged	1062369	1062380		speF	11
RV2039_libmerged	1062786	1062794		speF	8
RV2039_libmerged	1062915	1062924		speF	9
RV2039_libmerged	1066038	1066039		YPO_RS05760	1
RV2039_libmerged	1067046	1067048		YPO_RS05765	2
RV2039_libmerged	1067087	1067104		YPO_RS05765	17
RV2039_libmerged	1067283	1067284		YPO_RS05765	1
RV2039_libmerged	1067362	1067382		YPO_RS05765	20
RV2039_libmerged	1067376	1067382		YPO_RS05770	6
RV2039_libmerged	1067531	1067574		YPO_RS05770	43
RV2039_libmerged	1068428	1068430		YPO_RS05770	2
RV2039_libmerged	1068944	1068954		YPO_RS05770	10
RV2039_libmerged	1069297	1069318		YPO_RS05770	21
RV2039_libmerged	1069883	1069887		YPO_RS05775	4
RV2039_libmerged	1071911	1071916		YPO_RS05790	5
RV2039_libmerged	1072221	1072223		YPO_RS05790	2
RV2039_libmerged	1072398	1072402		YPO_RS05795	4
RV2039_libmerged	1072476	1072487		YPO_RS05795	11
RV2039_libmerged	1072844	1072854		YPO_RS05795	10
RV2039_libmerged	1072952	1072959		YPO_RS05795	7
RV2039_libmerged	1073108	1073171		YPO_RS05795	63
RV2039_libmerged	1073209	1073210		YPO_RS05795	1
RV2039_libmerged	1074849	1074857		YPO_RS05800	8
RV2039_libmerged	1076260	1076274		YPO_RS05800	14
RV2039_libmerged	1076715	1076719		YPO_RS05800	4
RV2039_libmerged	1079410	1079423		tssH	13
RV2039_libmerged	1080612	1080617		YPO_RS05815	5
RV2039_libmerged	1082867	1082868		YPO_RS05820	1
RV2039_libmerged	1086136	1086143		tssB	7
RV2039_libmerged	1088737	1088760		YPO_RS05845	23
RV2039_libmerged	1091363	1091365		YPO_RS05855	2
RV2039_libmerged	1091440	1091443		YPO_RS05855	3
RV2039_libmerged	1091704	1091709		YPO_RS05855	5
RV2039_libmerged	1092097	1092102		YPO_RS05860	5
RV2039_libmerged	1092423	1092470		YPO_RS05860	47
RV2039_libmerged	1092558	1092572		YPO_RS05860	14
RV2039_libmerged	1093917	1093921		YPO_RS05865	4
RV2039_libmerged	1095860	1095885		YPO_RS05870	25
RV2039_libmerged	1096320	1096328		YPO_RS05880	8
RV2039_libmerged	1096768	1096780		YPO_RS05880	12
RV2039_libmerged	1097142	1097143		YPO_RS05880	1
RV2039_libmerged	1101382	1101387		iucC	5
RV2039_libmerged	1102800	1102805		YPO_RS05900	5
RV2039_libmerged	1104337	1104338		YPO_RS05905	1
RV2039_libmerged	1104893	1104902		YPO_RS05905	9
RV2039_libmerged	1105270	1105275		YPO_RS05905	5
RV2039_libmerged	1105841	1105853		YPO_RS05910	12
RV2039_libmerged	1105991	1106009		YPO_RS05910	18
RV2039_libmerged	1106393	1106401		YPO_RS05910	8
RV2039_libmerged	1107011	1107014		YPO_RS05910	3
RV2039_libmerged	1107049	1107057		YPO_RS05910	8
RV2039_libmerged	1107648	1107657		YPO_RS05915	9
RV2039_libmerged	1108455	1108468		YPO_RS05915	13
RV2039_libmerged	1108521	1108526		YPO_RS05915	5
RV2039_libmerged	1108578	1108582		YPO_RS05915	4
RV2039_libmerged	1108794	1108811		YPO_RS05915	17
RV2039_libmerged	1109373	1109383		YPO_RS05920	10
RV2039_libmerged	1109434	1109439		YPO_RS05920	5
RV2039_libmerged	1110187	1110200		YPO_RS05920	13
RV2039_libmerged	1111246	1111247		YPO_RS05920	1
RV2039_libmerged	1111318	1111332		YPO_RS05920	14
RV2039_libmerged	1111368	1111373		YPO_RS05920	5
RV2039_libmerged	1113210	1113221		YPO_RS05930	11
RV2039_libmerged	1113613	1113617		YPO_RS05935	4
RV2039_libmerged	1114390	1114403		YPO_RS05935	13
RV2039_libmerged	1116372	1116384		YPO_RS05935	12
RV2039_libmerged	1116710	1116715		YPO_RS05940	5
RV2039_libmerged	1116848	1116856		YPO_RS05940	8
RV2039_libmerged	1116972	1116980		YPO_RS05940	8
RV2039_libmerged	1117112	1117120		YPO_RS05940	8
RV2039_libmerged	1117271	1117274		YPO_RS05940	3
RV2039_libmerged	1117348	1117362		YPO_RS05940	14
RV2039_libmerged	1117447	1117486		YPO_RS05940	39
RV2039_libmerged	1117724	1117731		YPO_RS05940	7
RV2039_libmerged	1118028	1118030		YPO_RS05940	2
RV2039_libmerged	1118875	1118882		YPO_RS05945	7
RV2039_libmerged	1121540	1121547		yapH	7
RV2039_libmerged	1121675	1121688		yapH	13
RV2039_libmerged	1121831	1121836		yapH	5
RV2039_libmerged	1121886	1121889		yapH	3
RV2039_libmerged	1125043	1125066		yapH	23
RV2039_libmerged	1127081	1127110		yapH	29
RV2039_libmerged	1128076	1128087		yapH	11
RV2039_libmerged	1128721	1128723		yapH	2
RV2039_libmerged	1129740	1129741		yapH	1
RV2039_libmerged	1131056	1131114		YPO_RS05955	58
RV2039_libmerged	1131146	1131147		YPO_RS05955	1
RV2039_libmerged	1131518	1131520		YPO_RS05955	2
RV2039_libmerged	1133681	1133700		YPO_RS05965	19
RV2039_libmerged	1134046	1134097		YPO_RS05965	51
RV2039_libmerged	1135705	1135713		YPO_RS05970	8
RV2039_libmerged	1138332	1138342		YPO_RS05975	10
RV2039_libmerged	1138570	1138599		YPO_RS05975	29
RV2039_libmerged	1140384	1140385		YPO_RS05985	1
RV2039_libmerged	1140436	1140472		YPO_RS05985	36
RV2039_libmerged	1140502	1140526		YPO_RS05985	24
RV2039_libmerged	1140583	1140593		YPO_RS05985	10
RV2039_libmerged	1140705	1140712		YPO_RS05985	7
RV2039_libmerged	1140902	1140916		YPO_RS05985	14
RV2039_libmerged	1141064	1141065		YPO_RS05985	1
RV2039_libmerged	1141170	1141171		YPO_RS05985	1
RV2039_libmerged	1141256	1141277		YPO_RS05985	21
RV2039_libmerged	1141398	1141424		YPO_RS05985	26
RV2039_libmerged	1141627	1141651		YPO_RS05985	24
RV2039_libmerged	1141910	1141915		YPO_RS05985	5
RV2039_libmerged	1142162	1142221		YPO_RS05985	59
RV2039_libmerged	1142261	1142266		YPO_RS05985	5
RV2039_libmerged	1142436	1142437		YPO_RS05985	1
RV2039_libmerged	1146015	1146020		YPO_RS05995	5
RV2039_libmerged	1146055	1146125		YPO_RS05995	70
RV2039_libmerged	1146165	1146224		YPO_RS05995	59
RV2039_libmerged	1146440	1146514		YPO_RS05995	74
RV2039_libmerged	1146564	1146619		YPO_RS05995	55
RV2039_libmerged	1146715	1146736		YPO_RS05995	21
RV2039_libmerged	1147030	1147037		YPO_RS05995	7
RV2039_libmerged	1146872	1146985		YPO_RS05995	113
RV2039_libmerged	1147037	1147080		YPO_RS06000	43
RV2039_libmerged	1147123	1147173		YPO_RS06000	50
RV2039_libmerged	1147337	1147377		YPO_RS06000	40
RV2039_libmerged	1147453	1147459		YPO_RS06000	6
RV2039_libmerged	1147522	1147548		YPO_RS06000	26
RV2039_libmerged	1147599	1147618		YPO_RS06000	19
RV2039_libmerged	1147674	1147691		YPO_RS06000	17
RV2039_libmerged	1148634	1148641		YPO_RS06010	7
RV2039_libmerged	1149659	1149666		recC	7
RV2039_libmerged	1150170	1150180		recC	10
RV2039_libmerged	1150400	1150405		recC	5
RV2039_libmerged	1150803	1150804		recC	1
RV2039_libmerged	1151406	1151427		recC	21
RV2039_libmerged	1152278	1152286		recC	8
RV2039_libmerged	1153264	1153278		ptrA	14
RV2039_libmerged	1154265	1154269		ptrA	4
RV2039_libmerged	1154712	1154725		ptrA	13
RV2039_libmerged	1155161	1155177		ptrA	16
RV2039_libmerged	1155298	1155305		ptrA	7
RV2039_libmerged	1155402	1155420		ptrA	18
RV2039_libmerged	1155458	1155468		ptrA	10
RV2039_libmerged	1155569	1155594		ptrA	25
RV2039_libmerged	1157234	1157236		recB	2
RV2039_libmerged	1157268	1157269		recB	1
RV2039_libmerged	1158996	1159034		recB	38
RV2039_libmerged	1159927	1159951		recD	24
RV2039_libmerged	1161265	1161268		recD	3
RV2039_libmerged	1161298	1161327		recD	29
RV2039_libmerged	1161834	1161835		argA	1
RV2039_libmerged	1162452	1162460		argA	8
RV2039_libmerged	1162725	1162736		argA	11
RV2039_libmerged	1163489	1163501		YPO_RS06050	12
RV2039_libmerged	1163672	1163678		YPO_RS06050	6
RV2039_libmerged	1165624	1165629		mltA	5
RV2039_libmerged	1165663	1165667		mltA	4
RV2039_libmerged	1165863	1165866		mltA	3
RV2039_libmerged	1166085	1166086		mltA	1
RV2039_libmerged	1166814	1166826		tcdA	12
RV2039_libmerged	1166922	1166927		tcdA	5
RV2039_libmerged	1168692	1168697		csdA	5
RV2039_libmerged	1169352	1169359		YPO_RS06085	7
RV2039_libmerged	1172906	1172911		xni	5
RV2039_libmerged	1175929	1175953		queF	24
RV2039_libmerged	1177501	1177512		YPO_RS06125	11
RV2039_libmerged	1177568	1177573		YPO_RS06125	5
RV2039_libmerged	1177612	1177619		YPO_RS06125	7
RV2039_libmerged	1177703	1177829		YPO_RS06125	126
RV2039_libmerged	1177868	1177939		YPO_RS06125	71
RV2039_libmerged	1178654	1178678		truC	24
RV2039_libmerged	1179955	1179970		YPO_RS06145	15
RV2039_libmerged	1180053	1180061		YPO_RS06145	8
RV2039_libmerged	1180137	1180168		YPO_RS06145	31
RV2039_libmerged	1180216	1180247		YPO_RS06145	31
RV2039_libmerged	1180418	1180420		dapD	2
RV2039_libmerged	1181024	1181032		dapD	8
RV2039_libmerged	1181397	1181398		glnD	1
RV2039_libmerged	1182137	1182142		glnD	5
RV2039_libmerged	1183432	1183447		glnD	15
RV2039_libmerged	1184600	1184606		map	6
RV2039_libmerged	1184823	1184827		map	4
RV2039_libmerged	1185901	1185934		rpsB	33
RV2039_libmerged	1187707	1187714		pyrH	7
RV2039_libmerged	1189268	1189304		ispC	36
RV2039_libmerged	1190007	1190044		ispC	37
RV2039_libmerged	1190401	1190438		ispU	37
RV2039_libmerged	1192533	1192536		rseP	3
RV2039_libmerged	1193310	1193335		rseP	25
RV2039_libmerged	1194376	1194438		bamA	62
RV2039_libmerged	1194734	1194748		bamA	14
RV2039_libmerged	1196322	1196355		skp	33
RV2039_libmerged	1196587	1196596		lpxD	9
RV2039_libmerged	1196794	1196795		lpxD	1
RV2039_libmerged	1197276	1197317		lpxD	41
RV2039_libmerged	1197601	1197603		fabZ	2
RV2039_libmerged	1197897	1197906		fabZ	9
RV2039_libmerged	1198983	1198991		lpxB	8
RV2039_libmerged	1199920	1199927		lpxB	7
RV2039_libmerged	1200432	1200444		rnhB	12
RV2039_libmerged	1201432	1201435		dnaE	3
RV2039_libmerged	1201892	1201894		dnaE	2
RV2039_libmerged	1204374	1204377		accA	3
RV2039_libmerged	1204449	1204461		accA	12
RV2039_libmerged	1206002	1206007		tilS	5
RV2039_libmerged	1206138	1206144		tilS	6
RV2039_libmerged	1207136	1207144		tilS	8
RV2039_libmerged	1210018	1210069		nlpE	51
RV2039_libmerged	1210119	1210149		nlpE	30
RV2039_libmerged	1210524	1210538		nlpE	14
RV2039_libmerged	1211888	1211906		proS	18
RV2039_libmerged	1212609	1212627		tsaA	18
RV2039_libmerged	1213902	1213908		YPO_RS06305	6
RV2039_libmerged	1214266	1214272		YPO_RS06305	6
RV2039_libmerged	1215032	1215042		metI	10
RV2039_libmerged	1215335	1215337		metN	2
RV2039_libmerged	1215400	1215402		metN	2
RV2039_libmerged	1215567	1215607		metN	40
RV2039_libmerged	1215925	1216003		metN	78
RV2039_libmerged	1216266	1216283		metN	17
RV2039_libmerged	1216692	1216698		gmhB	6
RV2039_libmerged	1220119	1220134		YPO_RS06340	15
RV2039_libmerged	1221078	1221085		YPO_RS06340	7
RV2039_libmerged	1221219	1221241		YPO_RS06340	22
RV2039_libmerged	1221599	1221602		YPO_RS06340	3
RV2039_libmerged	1223552	1223572		dkgB	20
RV2039_libmerged	1223689	1223720		dkgB	31
RV2039_libmerged	1223963	1223978		dkgB	15
RV2039_libmerged	1228698	1228708		rnhA	10
RV2039_libmerged	1228812	1228822		rnhA	10
RV2039_libmerged	1228947	1228963		rnhA	16
RV2039_libmerged	1229305	1229321		dnaQ	16
RV2039_libmerged	1229536	1229551		dnaQ	15
RV2039_libmerged	1230376	1230381		YPO_RS06400	5
RV2039_libmerged	1230575	1230588		YPO_RS06400	13
RV2039_libmerged	1231049	1231055		YPO_RS06400	6
RV2039_libmerged	1232281	1232282		YPO_RS06405	1
RV2039_libmerged	1232288	1232298		YPO_RS06405	10
RV2039_libmerged	1232349	1232362		YPO_RS06410	13
RV2039_libmerged	1232473	1232499		YPO_RS06410	26
RV2039_libmerged	1232606	1232618		YPO_RS06410	12
RV2039_libmerged	1232798	1232806		YPO_RS06410	8
RV2039_libmerged	1232976	1233011		YPO_RS06410	35
RV2039_libmerged	1233253	1233255		YPO_RS06415	2
RV2039_libmerged	1233400	1233471		YPO_RS06415	71
RV2039_libmerged	1233578	1233593		YPO_RS06415	15
RV2039_libmerged	1233643	1233706		YPO_RS06415	63
RV2039_libmerged	1233762	1233770		YPO_RS06415	8
RV2039_libmerged	1233974	1233982		YPO_RS06415	8
RV2039_libmerged	1234039	1234142		YPO_RS06415	103
RV2039_libmerged	1235317	1235349		YPO_RS06430	32
RV2039_libmerged	1235772	1235788		YPO_RS06435	16
RV2039_libmerged	1236280	1236286		YPO_RS06435	6
RV2039_libmerged	1237279	1237281		YPO_RS06440	2
RV2039_libmerged	1237442	1237445		YPO_RS06440	3
RV2039_libmerged	1237708	1237735		YPO_RS06440	27
RV2039_libmerged	1237972	1238002		YPO_RS06445	30
RV2039_libmerged	1238484	1238491		YPO_RS06450	7
RV2039_libmerged	1239238	1239242		YPO_RS06455	4
RV2039_libmerged	1240712	1240746		YPO_RS06465	34
RV2039_libmerged	1241116	1241121		YPO_RS06465	5
RV2039_libmerged	1241207	1241235		YPO_RS06465	28
RV2039_libmerged	1241357	1241399		YPO_RS06465	42
RV2039_libmerged	1241485	1241501		YPO_RS06465	16
RV2039_libmerged	1241730	1241763		YPO_RS06465	33
RV2039_libmerged	1241877	1241884		YPO_RS06465	7
RV2039_libmerged	1242031	1242046		YPO_RS06465	15
RV2039_libmerged	1242150	1242165		YPO_RS06465	15
RV2039_libmerged	1242550	1242603		YPO_RS06470	53
RV2039_libmerged	1242679	1242687		YPO_RS06470	8
RV2039_libmerged	1242789	1242800		YPO_RS06470	11
RV2039_libmerged	1243301	1243312		YPO_RS06470	11
RV2039_libmerged	1243484	1243504		YPO_RS06475	20
RV2039_libmerged	1243544	1243574		YPO_RS06475	30
RV2039_libmerged	1244601	1244603		YPO_RS06475	2
RV2039_libmerged	1244675	1244683		YPO_RS06475	8
RV2039_libmerged	1244988	1245026		YPO_RS06480	38
RV2039_libmerged	1245241	1245252		YPO_RS06480	11
RV2039_libmerged	1245182	1245195		YPO_RS06480	13
RV2039_libmerged	1246623	1246631		YPO_RS06495	8
RV2039_libmerged	1246662	1246691		YPO_RS06495	29
RV2039_libmerged	1246738	1246747		YPO_RS06495	9
RV2039_libmerged	1246858	1246929		YPO_RS06495	71
RV2039_libmerged	1247152	1247154		YPO_RS06500	2
RV2039_libmerged	1248064	1248091		recN	27
RV2039_libmerged	1248564	1248575		recN	11
RV2039_libmerged	1250268	1250275		nadK	7
RV2039_libmerged	1250526	1250531		nadK	5
RV2039_libmerged	1251741	1251748		YPO_RS06525	7
RV2039_libmerged	1253992	1254028		sdhD	36
RV2039_libmerged	1254900	1254923		sdhA	23
RV2039_libmerged	1255796	1255800		sdhA	4
RV2039_libmerged	1256265	1256275		YPO_RS06545	10
RV2039_libmerged	1256576	1256593		YPO_RS06545	17
RV2039_libmerged	1257151	1257164		sucA	13
RV2039_libmerged	1257312	1257317		sucA	5
RV2039_libmerged	1257868	1257897		sucA	29
RV2039_libmerged	1258161	1258163		sucA	2
RV2039_libmerged	1258418	1258423		sucA	5
RV2039_libmerged	1258543	1258551		sucA	8
RV2039_libmerged	1258612	1258616		sucA	4
RV2039_libmerged	1258926	1258929		sucA	3
RV2039_libmerged	1259351	1259355		sucA	4
RV2039_libmerged	1259811	1259814		sucA	3
RV2039_libmerged	1259844	1259880		odhB	36
RV2039_libmerged	1260633	1260645		odhB	12
RV2039_libmerged	1260715	1260727		odhB	12
RV2039_libmerged	1260915	1260946		odhB	31
RV2039_libmerged	1261797	1261798		sucC	1
RV2039_libmerged	1263033	1263038		sucD	5
RV2039_libmerged	1265656	1265673		cydB	17
RV2039_libmerged	1266020	1266029		cydB	9
RV2039_libmerged	1266466	1266472		cydB	6
RV2039_libmerged	1266720	1266722		cydX	2
RV2039_libmerged	1267312	1267319		ybgC	7
RV2039_libmerged	1267460	1267461		ybgC	1
RV2039_libmerged	1267641	1267647		ybgC	6
RV2039_libmerged	1268363	1268364		tolR	1
RV2039_libmerged	1269804	1269806		tolA	2
RV2039_libmerged	1270246	1270271		tolB	25
RV2039_libmerged	1270462	1270463		tolB	1
RV2039_libmerged	1271224	1271234		tolB	10
RV2039_libmerged	1271346	1271350		tolB	4
RV2039_libmerged	1271918	1271936		pal	18
RV2039_libmerged	1272494	1272497		cpoB	3
RV2039_libmerged	1272547	1272557		cpoB	10
RV2039_libmerged	1272643	1272677		cpoB	34
RV2039_libmerged	1275134	1275151		YPO_RS06645	17
RV2039_libmerged	1275471	1275473		YPO_RS06645	2
RV2039_libmerged	1275716	1275743		zitB	27
RV2039_libmerged	1277801	1277833		aroG	32
RV2039_libmerged	1278051	1278063		aroG	12
RV2039_libmerged	1278185	1278238		YPO_RS06660	53
RV2039_libmerged	1278277	1278280		YPO_RS06660	3
RV2039_libmerged	1278378	1278421		YPO_RS06660	43
RV2039_libmerged	1278459	1278478		YPO_RS06660	19
RV2039_libmerged	1278570	1278587		YPO_RS06660	17
RV2039_libmerged	1278637	1278649		YPO_RS06660	12
RV2039_libmerged	1278748	1278807		YPO_RS06660	59
RV2039_libmerged	1278929	1278952		YPO_RS06665	23
RV2039_libmerged	1279088	1279089		YPO_RS06665	1
RV2039_libmerged	1279182	1279186		YPO_RS06665	4
RV2039_libmerged	1279451	1279455		YPO_RS06665	4
RV2039_libmerged	1279532	1279552		YPO_RS06665	20
RV2039_libmerged	1279610	1279627		YPO_RS06665	17
RV2039_libmerged	1279722	1279773		YPO_RS06665	51
RV2039_libmerged	1279922	1279930		YPO_RS06665	8
RV2039_libmerged	1280006	1280020		YPO_RS06670	14
RV2039_libmerged	1281034	1281047		gpmA	13
RV2039_libmerged	1282874	1282886		galM	12
RV2039_libmerged	1282942	1282952		YPO_RS06690	10
RV2039_libmerged	1286290	1286312		galE	22
RV2039_libmerged	1286672	1286694		YPO_RS06710	22
RV2039_libmerged	1287719	1287725		modF	6
RV2039_libmerged	1289439	1289441		modE	2
RV2039_libmerged	1289659	1289685		modE	26
RV2039_libmerged	1289995	1289998		modE	3
RV2039_libmerged	1291571	1291578		modA	7
RV2039_libmerged	1292254	1292255		modB	1
RV2039_libmerged	1294053	1294056		YPO_RS06745	3
RV2039_libmerged	1295004	1295007		pgl	3
RV2039_libmerged	1296937	1296944		bioA	7
RV2039_libmerged	1297192	1297202		bioB	10
RV2039_libmerged	1298053	1298060		bioB	7
RV2039_libmerged	1301379	1301381		YPO_RS06780	2
RV2039_libmerged	1301510	1301544		YPO_RS06780	34
RV2039_libmerged	1302854	1302861		uvrB	7
RV2039_libmerged	1302969	1302993		uvrB	24
RV2039_libmerged	1308137	1308157		moaC	20
RV2039_libmerged	1308900	1308901		moaE	1
RV2039_libmerged	1309253	1309255		YPO_RS06820	2
RV2039_libmerged	1310198	1310285		YPO_RS06825	87
RV2039_libmerged	1310572	1310581		YPO_RS06825	9
RV2039_libmerged	1310901	1310904		betA	3
RV2039_libmerged	1311491	1311507		betA	16
RV2039_libmerged	1311639	1311644		betA	5
RV2039_libmerged	1312634	1312638		betB	4
RV2039_libmerged	1313237	1313243		betB	6
RV2039_libmerged	1315477	1315478		YPO_RS06845	1
RV2039_libmerged	1315554	1315563		YPO_RS06845	9
RV2039_libmerged	1316279	1316306		YPO_RS06845	27
RV2039_libmerged	1316687	1316693		YPO_RS06845	6
RV2039_libmerged	1318405	1318409		YPO_RS06855	4
RV2039_libmerged	1318572	1318595		YPO_RS06855	23
RV2039_libmerged	1319480	1319487		xapA	7
RV2039_libmerged	1319640	1319645		xapA	5
RV2039_libmerged	1321461	1321508		YPO_RS06870	47
RV2039_libmerged	1321595	1321637		YPO_RS06870	42
RV2039_libmerged	1321717	1321730		YPO_RS06870	13
RV2039_libmerged	1322157	1322186		YPO_RS06875	29
RV2039_libmerged	1322290	1322309		YPO_RS06875	19
RV2039_libmerged	1322383	1322397		YPO_RS06875	14
RV2039_libmerged	1322524	1322526		YPO_RS06875	2
RV2039_libmerged	1322831	1322849		YPO_RS06875	18
RV2039_libmerged	1322931	1322951		YPO_RS06875	20
RV2039_libmerged	1326669	1326682		dld	13
RV2039_libmerged	1327347	1327397		dld	50
RV2039_libmerged	1327477	1327479		dld	2
RV2039_libmerged	1328400	1328414		cyaB	14
RV2039_libmerged	1329632	1329653		YPO_RS06910	21
RV2039_libmerged	1329945	1329951		YPO_RS06910	6
RV2039_libmerged	1330201	1330204		YPO_RS06910	3
RV2039_libmerged	1330889	1330908		phnC	19
RV2039_libmerged	1331074	1331076		phnC	2
RV2039_libmerged	1331437	1331444		phnC	7
RV2039_libmerged	1331474	1331477		phnC	3
RV2039_libmerged	1331548	1331566		phnC	18
RV2039_libmerged	1331718	1331748		phnD	30
RV2039_libmerged	1331946	1331963		phnD	17
RV2039_libmerged	1332750	1332764		phnE	14
RV2039_libmerged	1333533	1333540		phnE	7
RV2039_libmerged	1333616	1333617		phnE	1
RV2039_libmerged	1334384	1334402		phnE	18
RV2039_libmerged	1336350	1336355		urtA	5
RV2039_libmerged	1336388	1336407		urtA	19
RV2039_libmerged	1337743	1337744		urtB	1
RV2039_libmerged	1337949	1337952		urtB	3
RV2039_libmerged	1338220	1338224		urtB	4
RV2039_libmerged	1339200	1339218		urtC	18
RV2039_libmerged	1339451	1339465		urtC	14
RV2039_libmerged	1341539	1341542		YPO_RS06970	3
RV2039_libmerged	1342052	1342058		YPO_RS06970	6
RV2039_libmerged	1343095	1343100		YPO_RS06975	5
RV2039_libmerged	1343416	1343421		YPO_RS06975	5
RV2039_libmerged	1344540	1344555		sseA	15
RV2039_libmerged	1344718	1344738		sseA	20
RV2039_libmerged	1345654	1345674		YPO_RS06985	20
RV2039_libmerged	1345910	1345914		YPO_RS06985	4
RV2039_libmerged	1346171	1346191		YPO_RS06990	20
RV2039_libmerged	1346821	1346822		YPO_RS06995	1
RV2039_libmerged	1346940	1346947		YPO_RS06995	7
RV2039_libmerged	1347119	1347132		YPO_RS06995	13
RV2039_libmerged	1347794	1347797		YPO_RS06995	3
RV2039_libmerged	1347844	1347845		YPO_RS06995	1
RV2039_libmerged	1347844	1347849		YPO_RS07000	5
RV2039_libmerged	1347883	1347916		YPO_RS07000	33
RV2039_libmerged	1348590	1348595		YPO_RS07000	5
RV2039_libmerged	1350091	1350120		adiC	29
RV2039_libmerged	1350376	1350379		adiC	3
RV2039_libmerged	1350468	1350483		adiC	15
RV2039_libmerged	1350657	1350660		adiC	3
RV2039_libmerged	1351576	1351581		YPO_RS07015	5
RV2039_libmerged	1351719	1351749		YPO_RS07015	30
RV2039_libmerged	1351811	1351813		YPO_RS07015	2
RV2039_libmerged	1352125	1352139		YPO_RS07015	14
RV2039_libmerged	1352292	1352336		YPO_RS07015	44
RV2039_libmerged	1352489	1352496		YPO_RS07015	7
RV2039_libmerged	1353408	1353419		YPO_RS07015	11
RV2039_libmerged	1355586	1355590		ompF2	4
RV2039_libmerged	1355884	1355890		ompF2	6
RV2039_libmerged	1356474	1356485		ompF2	11
RV2039_libmerged	1356621	1356635		ompF2	14
RV2039_libmerged	1358966	1358993		dinG	27
RV2039_libmerged	1359559	1359563		YPO_RS07040	4
RV2039_libmerged	1359794	1359814		YPO_RS07040	20
RV2039_libmerged	1361443	1361448		YPO_RS07045	5
RV2039_libmerged	1361781	1361811		tyrP	30
RV2039_libmerged	1362729	1362770		tyrP	41
RV2039_libmerged	1365633	1365643		YPO_RS07065	10
RV2039_libmerged	1365811	1365824		nrdB	13
RV2039_libmerged	1366267	1366295		nrdB	28
RV2039_libmerged	1367794	1367795		nrdA	1
RV2039_libmerged	1368159	1368172		nrdA	13
RV2039_libmerged	1370082	1370093		YPO_RS07080	11
RV2039_libmerged	1373361	1373368		gyrA	7
RV2039_libmerged	1373399	1373404		gyrA	5
RV2039_libmerged	1373982	1374014		rcsC	32
RV2039_libmerged	1374497	1374514		rcsC	17
RV2039_libmerged	1374747	1374753		rcsC	6
RV2039_libmerged	1374890	1374892		rcsC	2
RV2039_libmerged	1375182	1375195		rcsC	13
RV2039_libmerged	1375350	1375364		rcsC	14
RV2039_libmerged	1375672	1375674		rcsC	2
RV2039_libmerged	1376217	1376236		rcsC	19
RV2039_libmerged	1376627	1376640		rcsB	13
RV2039_libmerged	1377174	1377186		rcsB	12
RV2039_libmerged	1377189	1377203		YPO_RS07100	14
RV2039_libmerged	1377397	1377426		YPO_RS07100	29
RV2039_libmerged	1378017	1378037		rcsD	20
RV2039_libmerged	1378157	1378214		rcsD	57
RV2039_libmerged	1379680	1379691		rcsD	11
RV2039_libmerged	1380221	1380225		YPO_RS07110	4
RV2039_libmerged	1381056	1381057		YPO_RS07110	1
RV2039_libmerged	1382431	1382451		YPO_RS07115	20
RV2039_libmerged	1383260	1383261		YPO_RS07115	1
RV2039_libmerged	1383547	1383595		YPO_RS07120	48
RV2039_libmerged	1383913	1383923		YPO_RS07120	10
RV2039_libmerged	1384902	1384910		ampH	8
RV2039_libmerged	1386427	1386432		YPO_RS07140	5
RV2039_libmerged	1387152	1387153		YPO_RS07140	1
RV2039_libmerged	1387353	1387362		YPO_RS07140	9
RV2039_libmerged	1389355	1389364		YPO_RS07150	9
RV2039_libmerged	1390114	1390142		YPO_RS07150	28
RV2039_libmerged	1391419	1391430		ycoA	11
RV2039_libmerged	1391635	1391653		ycoA	18
RV2039_libmerged	1394190	1394192		YPO_RS07170	2
RV2039_libmerged	1395536	1395549		YPO_RS07175	13
RV2039_libmerged	1399383	1399421		YPO_RS07200	38
RV2039_libmerged	1400348	1400357		YPO_RS07210	9
RV2039_libmerged	1401630	1401631		YPO_RS07215	1
RV2039_libmerged	1402525	1402548		YPO_RS07225	23
RV2039_libmerged	1402822	1402830		YPO_RS07225	8
RV2039_libmerged	1403050	1403064		YPO_RS07225	14
RV2039_libmerged	1403220	1403223		YPO_RS07225	3
RV2039_libmerged	1406517	1406519		YPO_RS07240	2
RV2039_libmerged	1406649	1406652		YPO_RS07240	3
RV2039_libmerged	1407543	1407565		YPO_RS07245	22
RV2039_libmerged	1408184	1408187		YPO_RS07250	3
RV2039_libmerged	1410546	1410553		YPO_RS07270	7
RV2039_libmerged	1410938	1410951		YPO_RS07270	13
RV2039_libmerged	1411715	1411718		YPO_RS07275	3
RV2039_libmerged	1412102	1412111		YPO_RS07275	9
RV2039_libmerged	1412781	1412822		YPO_RS07275	41
RV2039_libmerged	1413073	1413099		YPO_RS07280	26
RV2039_libmerged	1413353	1413382		YPO_RS07280	29
RV2039_libmerged	1414246	1414279		YPO_RS07285	33
RV2039_libmerged	1414490	1414556		YPO_RS07285	66
RV2039_libmerged	1417056	1417060		YPO_RS07305	4
RV2039_libmerged	1417143	1417166		YPO_RS07305	23
RV2039_libmerged	1418991	1419050		yejK	59
RV2039_libmerged	1419332	1419347		yejK	15
RV2039_libmerged	1420189	1420226		YPO_RS07320	37
RV2039_libmerged	1420386	1420434		YPO_RS07320	48
RV2039_libmerged	1420549	1420619		YPO_RS07320	70
RV2039_libmerged	1421055	1421056		rplY	1
RV2039_libmerged	1421477	1421487		YPO_RS07330	10
RV2039_libmerged	1421833	1421835		YPO_RS07330	2
RV2039_libmerged	1424395	1424397		YPO_RS07340	2
RV2039_libmerged	1426632	1426636		YPO_RS07345	4
RV2039_libmerged	1428298	1428300		yejF	2
RV2039_libmerged	1428480	1428492		yejF	12
RV2039_libmerged	1428494	1428508		YPO_RS07355	14
RV2039_libmerged	1429333	1429351		YPO_RS07355	18
RV2039_libmerged	1429975	1429977		YPO_RS07360	2
RV2039_libmerged	1430068	1430110		YPO_RS07360	42
RV2039_libmerged	1430567	1430579		YPO_RS07360	12
RV2039_libmerged	1430903	1430908		YPO_RS07365	5
RV2039_libmerged	1431987	1432000		YPO_RS07365	13
RV2039_libmerged	1432951	1432963		YPO_RS07370	12
RV2039_libmerged	1433113	1433115		YPO_RS07370	2
RV2039_libmerged	1433377	1433383		YPO_RS07370	6
RV2039_libmerged	1433895	1433903		YPO_RS07370	8
RV2039_libmerged	1435002	1435009		mepS	7
RV2039_libmerged	1435146	1435161		mepS	15
RV2039_libmerged	1436519	1436548		YPO_RS07385	29
RV2039_libmerged	1439361	1439364		YPO_RS07395	3
RV2039_libmerged	1439686	1439708		YPO_RS07395	22
RV2039_libmerged	1445633	1445634		YPO_RS07420	1
RV2039_libmerged	1447169	1447172		YPO_RS07430	3
RV2039_libmerged	1447209	1447217		YPO_RS07430	8
RV2039_libmerged	1450171	1450186		xylB	15
RV2039_libmerged	1451756	1451768		rpiA	12
RV2039_libmerged	1452200	1452212		rpiA	12
RV2039_libmerged	1453578	1453611		YPO_RS07455	33
RV2039_libmerged	1456277	1456281		YPO_RS07465	4
RV2039_libmerged	1456671	1456673		YPO_RS07465	2
RV2039_libmerged	1457837	1457838		YPO_RS07470	1
RV2039_libmerged	1459003	1459013		fruK	10
RV2039_libmerged	1460272	1460289		fruA	17
RV2039_libmerged	1461139	1461156		YPO_RS07485	17
RV2039_libmerged	1461370	1461398		YPO_RS07485	28
RV2039_libmerged	1461513	1461582		YPO_RS07485	69
RV2039_libmerged	1461748	1461807		YPO_RS07490	59
RV2039_libmerged	1461871	1461896		YPO_RS07490	25
RV2039_libmerged	1462001	1462021		YPO_RS07490	20
RV2039_libmerged	1462983	1462990		psaA	7
RV2039_libmerged	1463133	1463217		psaA	84
RV2039_libmerged	1463383	1463405		YPO_RS07500	22
RV2039_libmerged	1463495	1463514		YPO_RS07500	19
RV2039_libmerged	1463558	1463584		YPO_RS07500	26
RV2039_libmerged	1463766	1463779		YPO_RS07500	13
RV2039_libmerged	1464407	1464412		psaC	5
RV2039_libmerged	1465959	1465978		psaC	19
RV2039_libmerged	1468366	1468383		YPO_RS07515	17
RV2039_libmerged	1468537	1468545		YPO_RS07515	8
RV2039_libmerged	1468867	1468877		YPO_RS07515	10
RV2039_libmerged	1470235	1470239		YPO_RS07520	4
RV2039_libmerged	1470399	1470412		YPO_RS07520	13
RV2039_libmerged	1472663	1472664		YPO_RS07530	1
RV2039_libmerged	1472940	1472955		YPO_RS07530	15
RV2039_libmerged	1473207	1473216		YPO_RS07530	9
RV2039_libmerged	1475538	1475547		YPO_RS07540	9
RV2039_libmerged	1476003	1476004		YPO_RS07545	1
RV2039_libmerged	1476058	1476062		YPO_RS07545	4
RV2039_libmerged	1476677	1476683		YPO_RS07545	6
RV2039_libmerged	1476765	1476766		YPO_RS07545	1
RV2039_libmerged	1477039	1477054		YPO_RS07545	15
RV2039_libmerged	1477185	1477188		YPO_RS07545	3
RV2039_libmerged	1477962	1477980		YPO_RS07545	18
RV2039_libmerged	1479641	1479653		YPO_RS07555	12
RV2039_libmerged	1479692	1479694		YPO_RS07555	2
RV2039_libmerged	1480181	1480184		YPO_RS07560	3
RV2039_libmerged	1481898	1481900		YPO_RS07565	2
RV2039_libmerged	1482168	1482174		YPO_RS07565	6
RV2039_libmerged	1483344	1483361		YPO_RS07575	17
RV2039_libmerged	1483439	1483442		YPO_RS07575	3
RV2039_libmerged	1483745	1483766		YPO_RS07575	21
RV2039_libmerged	1484761	1484765		YPO_RS07580	4
RV2039_libmerged	1485488	1485491		YPO_RS07580	3
RV2039_libmerged	1485993	1486008		YPO_RS07585	15
RV2039_libmerged	1486423	1486457		YPO_RS07585	34
RV2039_libmerged	1486879	1486881		YPO_RS07585	2
RV2039_libmerged	1487108	1487115		YPO_RS07585	7
RV2039_libmerged	1487160	1487194		YPO_RS07585	34
RV2039_libmerged	1488332	1488335		deoR	3
RV2039_libmerged	1488516	1488517		deoR	1
RV2039_libmerged	1488641	1488643		deoR	2
RV2039_libmerged	1488757	1488762		deoR	5
RV2039_libmerged	1489877	1489890		YPO_RS07595	13
RV2039_libmerged	1489982	1489985		YPO_RS07595	3
RV2039_libmerged	1490710	1490728		ybjG	18
RV2039_libmerged	1491488	1491495		YPO_RS07605	7
RV2039_libmerged	1493551	1493578		YPO_RS07610	27
RV2039_libmerged	1493654	1493657		YPO_RS07610	3
RV2039_libmerged	1494114	1494116		YPO_RS07615	2
RV2039_libmerged	1499509	1499524		potH	15
RV2039_libmerged	1501896	1501899		rlmC	3
RV2039_libmerged	1502179	1502185		rlmC	6
RV2039_libmerged	1502827	1502847		YPO_RS07665	20
RV2039_libmerged	1502886	1502918		YPO_RS07665	32
RV2039_libmerged	1502981	1503042		YPO_RS07665	61
RV2039_libmerged	1503109	1503135		YPO_RS07665	26
RV2039_libmerged	1503306	1503313		YPO_RS07665	7
RV2039_libmerged	1503438	1503439		YPO_RS07665	1
RV2039_libmerged	1503726	1503799		YPO_RS07665	73
RV2039_libmerged	1503829	1503838		YPO_RS07665	9
RV2039_libmerged	1504016	1504043		YPO_RS07670	27
RV2039_libmerged	1504160	1504187		YPO_RS07670	27
RV2039_libmerged	1504255	1504288		YPO_RS07670	33
RV2039_libmerged	1504336	1504347		YPO_RS07670	11
RV2039_libmerged	1504411	1504413		YPO_RS07670	2
RV2039_libmerged	1504545	1504546		YPO_RS07670	1
RV2039_libmerged	1504620	1504628		YPO_RS07670	8
RV2039_libmerged	1505601	1505602		YPO_RS07680	1
RV2039_libmerged	1505975	1505996		YPO_RS07685	21
RV2039_libmerged	1506526	1506546		YPO_RS07685	20
RV2039_libmerged	1508815	1508821		YPO_RS07700	6
RV2039_libmerged	1510839	1510849		YPO_RS07715	10
RV2039_libmerged	1510989	1511012		YPO_RS07715	23
RV2039_libmerged	1512465	1512473		YPO_RS07725	8
RV2039_libmerged	1513339	1513340		YPO_RS07730	1
RV2039_libmerged	1514804	1514806		artQ	2
RV2039_libmerged	1517118	1517134		YPO_RS07755	16
RV2039_libmerged	1517785	1517792		YPO_RS07760	7
RV2039_libmerged	1520566	1520575		YPO_RS07770	9
RV2039_libmerged	1521388	1521389		ltaE	1
RV2039_libmerged	1522061	1522075		poxB	14
RV2039_libmerged	1523063	1523088		poxB	25
RV2039_libmerged	1523876	1523878		hcr	2
RV2039_libmerged	1525300	1525302		hcp	2
RV2039_libmerged	1526435	1526503		hcp	68
RV2039_libmerged	1527400	1527435		YPO_RS07795	35
RV2039_libmerged	1529646	1529653		YPO_RS07800	7
RV2039_libmerged	1531718	1531731		macA	13
RV2039_libmerged	1532052	1532062		macA	10
RV2039_libmerged	1532743	1532777		macB	34
RV2039_libmerged	1533160	1533162		macB	2
RV2039_libmerged	1536992	1536998		clpA	6
RV2039_libmerged	1537342	1537348		clpA	6
RV2039_libmerged	1537537	1537556		clpA	19
RV2039_libmerged	1537930	1538003		YPO_RS07835	73
RV2039_libmerged	1538051	1538139		YPO_RS07835	88
RV2039_libmerged	1538234	1538261		YPO_RS07835	27
RV2039_libmerged	1539508	1539513		aat	5
RV2039_libmerged	1540581	1540590		cydC	9
RV2039_libmerged	1540648	1540660		cydC	12
RV2039_libmerged	1541288	1541297		cydC	9
RV2039_libmerged	1541913	1541932		cydD	19
RV2039_libmerged	1542460	1542461		cydD	1
RV2039_libmerged	1544352	1544376		trxB	24
RV2039_libmerged	1547257	1547258		YPO_RS07870	1
RV2039_libmerged	1548628	1548632		YPO_RS07870	4
RV2039_libmerged	1549605	1549606		YPO_RS07870	1
RV2039_libmerged	1549849	1549861		YPO_RS07870	12
RV2039_libmerged	1550149	1550154		YPO_RS07870	5
RV2039_libmerged	1550688	1550699		lolA	11
RV2039_libmerged	1551852	1551860		YPO_RS07880	8
RV2039_libmerged	1553355	1553373		serS	18
RV2039_libmerged	1553940	1553947		serS	7
RV2039_libmerged	1554869	1554901		YPO_RS07890	32
RV2039_libmerged	1556226	1556237		pflA	11
RV2039_libmerged	1557288	1557305		YPO_RS07900	17
RV2039_libmerged	1557589	1557609		YPO_RS07900	20
RV2039_libmerged	1557696	1557699		YPO_RS07900	3
RV2039_libmerged	1557822	1557837		YPO_RS07900	15
RV2039_libmerged	1557923	1557937		YPO_RS07900	14
RV2039_libmerged	1558070	1558107		pflB	37
RV2039_libmerged	1559891	1559930		pflB	39
RV2039_libmerged	1560487	1560495		focA	8
RV2039_libmerged	1560589	1560593		focA	4
RV2039_libmerged	1562583	1562587		YPO_RS07915	4
RV2039_libmerged	1562715	1562720		YPO_RS07915	5
RV2039_libmerged	1563248	1563253		YPO_RS07915	5
RV2039_libmerged	1564145	1564170		ansB	25
RV2039_libmerged	1565872	1565961		YPO_RS07925	89
RV2039_libmerged	1566494	1566528		YPO_RS07930	34
RV2039_libmerged	1566862	1566867		YPO_RS07930	5
RV2039_libmerged	1567026	1567039		YPO_RS07930	13
RV2039_libmerged	1567522	1567553		YPO_RS07930	31
RV2039_libmerged	1567696	1567784		YPO_RS07930	88
RV2039_libmerged	1568575	1568587		serC	12
RV2039_libmerged	1568859	1568878		serC	19
RV2039_libmerged	1569406	1569412		serC	6
RV2039_libmerged	1569773	1569782		aroA	9
RV2039_libmerged	1570874	1570875		aroA	1
RV2039_libmerged	1573552	1573563		rpsA	11
RV2039_libmerged	1575365	1575377		YPO_RS07960	12
RV2039_libmerged	1576130	1576138		YPO_RS07960	8
RV2039_libmerged	1576680	1576685		YPO_RS07960	5
RV2039_libmerged	1578345	1578348		msbA	3
RV2039_libmerged	1579802	1579820		lpxK	18
RV2039_libmerged	1580102	1580106		YPO_RS07975	4
RV2039_libmerged	1580161	1580162		YPO_RS07975	1
RV2039_libmerged	1580930	1580932		YPO_RS07975	2
RV2039_libmerged	1583155	1583211		kdsB	56
RV2039_libmerged	1583365	1583377		kdsB	12
RV2039_libmerged	1584136	1584162		YPO_RS07995	26
RV2039_libmerged	1584426	1584430		YPO_RS07995	4
RV2039_libmerged	1584772	1584779		YPO_RS07995	7
RV2039_libmerged	1584874	1584885		YPO_RS07995	11
RV2039_libmerged	1586305	1586313		cmoM	8
RV2039_libmerged	1586444	1586455		cmoM	11
RV2039_libmerged	1587813	1587814		mukF	1
RV2039_libmerged	1587813	1587814		mukE	1
RV2039_libmerged	1588069	1588083		mukE	14
RV2039_libmerged	1589415	1589417		mukB	2
RV2039_libmerged	1592495	1592497		mukB	2
RV2039_libmerged	1593210	1593235		YPO_RS08020	25
RV2039_libmerged	1593318	1593320		YPO_RS08020	2
RV2039_libmerged	1593370	1593377		YPO_RS08020	7
RV2039_libmerged	1593514	1593533		YPO_RS08020	19
RV2039_libmerged	1593574	1593654		YPO_RS08020	80
RV2039_libmerged	1594347	1594355		ldtD	8
RV2039_libmerged	1596398	1596401		YPO_RS08030	3
RV2039_libmerged	1597206	1597211		YPO_RS08035	5
RV2039_libmerged	1598871	1598878		YPO_RS08045	7
RV2039_libmerged	1599270	1599286		ompF	16
RV2039_libmerged	1599591	1599593		ompF	2
RV2039_libmerged	1600661	1600668		asnS	7
RV2039_libmerged	1600845	1600850		asnS	5
RV2039_libmerged	1600882	1600892		asnS	10
RV2039_libmerged	1601738	1601773		asnS	35
RV2039_libmerged	1603425	1603446		pncB	21
RV2039_libmerged	1605126	1605142		pepN	16
RV2039_libmerged	1605469	1605487		pepN	18
RV2039_libmerged	1605721	1605723		pepN	2
RV2039_libmerged	1606345	1606359		pepN	14
RV2039_libmerged	1607984	1607989		pyrD	5
RV2039_libmerged	1608052	1608068		pyrD	16
RV2039_libmerged	1608105	1608161		pyrD	56
RV2039_libmerged	1608310	1608312		pyrD	2
RV2039_libmerged	1608575	1608584		pyrD	9
RV2039_libmerged	1609293	1609316		YPO_RS08075	23
RV2039_libmerged	1610775	1610776		rlmKL	1
RV2039_libmerged	1611210	1611214		rlmKL	4
RV2039_libmerged	1612079	1612121		rlmKL	42
RV2039_libmerged	1613104	1613119		YPO_RS08090	15
RV2039_libmerged	1613327	1613332		YPO_RS08090	5
RV2039_libmerged	1614117	1614145		YPO_RS08090	28
RV2039_libmerged	1614463	1614470		YPO_RS08090	7
RV2039_libmerged	1614735	1614748		pqiA	13
RV2039_libmerged	1615401	1615413		pqiA	12
RV2039_libmerged	1615685	1615686		pqiA	1
RV2039_libmerged	1616080	1616082		pqiB	2
RV2039_libmerged	1616419	1616444		pqiB	25
RV2039_libmerged	1616826	1616839		pqiB	13
RV2039_libmerged	1617119	1617141		pqiB	22
RV2039_libmerged	1617279	1617292		pqiB	13
RV2039_libmerged	1618863	1618885		YPO_RS08115	22
RV2039_libmerged	1618942	1619049		YPO_RS08115	107
RV2039_libmerged	1619108	1619119		YPO_RS08115	11
RV2039_libmerged	1619179	1619188		YPO_RS08115	9
RV2039_libmerged	1620482	1620508		YPO_RS08125	26
RV2039_libmerged	1620697	1620752		YPO_RS08125	55
RV2039_libmerged	1620889	1621064		YPO_RS08125	175
RV2039_libmerged	1621124	1621171		YPO_RS08125	47
RV2039_libmerged	1621291	1621295		YPO_RS08130	4
RV2039_libmerged	1621450	1621473		YPO_RS08130	23
RV2039_libmerged	1621565	1621581		YPO_RS08130	16
RV2039_libmerged	1621678	1621691		YPO_RS08130	13
RV2039_libmerged	1621765	1621774		YPO_RS08130	9
RV2039_libmerged	1622131	1622185		YPO_RS08130	54
RV2039_libmerged	1622274	1622283		YPO_RS08130	9
RV2039_libmerged	1622999	1623008		YPO_RS08140	9
RV2039_libmerged	1624396	1624407		YPO_RS08150	11
RV2039_libmerged	1625681	1625687		YPO_RS08150	6
RV2039_libmerged	1626603	1626670		YPO_RS08160	67
RV2039_libmerged	1626705	1626706		YPO_RS08160	1
RV2039_libmerged	1626738	1626748		YPO_RS08160	10
RV2039_libmerged	1626820	1626828		YPO_RS08160	8
RV2039_libmerged	1626894	1626900		YPO_RS08160	6
RV2039_libmerged	1626942	1626977		YPO_RS08160	35
RV2039_libmerged	1628000	1628006		ompA	6
RV2039_libmerged	1629068	1629099		sulA	31
RV2039_libmerged	1630513	1630514		yccS	1
RV2039_libmerged	1631342	1631358		yccS	16
RV2039_libmerged	1631765	1631811		yccS	46
RV2039_libmerged	1632086	1632094		yccS	8
RV2039_libmerged	1632178	1632197		yccS	19
RV2039_libmerged	1632415	1632417		YPO_RS08185	2
RV2039_libmerged	1632671	1632684		YPO_RS08185	13
RV2039_libmerged	1633711	1633748		helD	37
RV2039_libmerged	1635072	1635077		YPO_RS08195	5
RV2039_libmerged	1636693	1636701		YPO_RS08205	8
RV2039_libmerged	1637249	1637323		hspQ	74
RV2039_libmerged	1638184	1638214		rlmI	30
RV2039_libmerged	1638763	1638767		yccX	4
RV2039_libmerged	1643963	1643981		YPO_RS08245	18
RV2039_libmerged	1644099	1644104		YPO_RS08245	5
RV2039_libmerged	1644997	1645005		YPO_RS08245	8
RV2039_libmerged	1646384	1646385		YPO_RS08250	1
RV2039_libmerged	1647681	1647719		YPO_RS08260	38
RV2039_libmerged	1647829	1647830		YPO_RS08260	1
RV2039_libmerged	1648240	1648255		YPO_RS08265	15
RV2039_libmerged	1648599	1648608		YPO_RS08265	9
RV2039_libmerged	1649166	1649176		YPO_RS08265	10
RV2039_libmerged	1649242	1649244		YPO_RS08265	2
RV2039_libmerged	1649584	1649588		YPO_RS08270	4
RV2039_libmerged	1649741	1649755		YPO_RS08270	14
RV2039_libmerged	1649877	1649890		YPO_RS08270	13
RV2039_libmerged	1649945	1649955		YPO_RS08270	10
RV2039_libmerged	1650120	1650124		YPO_RS08270	4
RV2039_libmerged	1650574	1650580		YPO_RS08275	6
RV2039_libmerged	1650634	1650672		YPO_RS08275	38
RV2039_libmerged	1650892	1650930		YPO_RS08275	38
RV2039_libmerged	1651088	1651089		YPO_RS08275	1
RV2039_libmerged	1651172	1651179		YPO_RS08275	7
RV2039_libmerged	1651298	1651325		YPO_RS08275	27
RV2039_libmerged	1651520	1651533		YPO_RS08280	13
RV2039_libmerged	1651929	1651933		YPO_RS08280	4
RV2039_libmerged	1652016	1652078		YPO_RS08280	62
RV2039_libmerged	1652174	1652212		YPO_RS08285	38
RV2039_libmerged	1652318	1652327		YPO_RS08285	9
RV2039_libmerged	1652784	1652829		YPO_RS08285	45
RV2039_libmerged	1652902	1652904		YPO_RS08290	2
RV2039_libmerged	1653165	1653178		YPO_RS08290	13
RV2039_libmerged	1653286	1653313		YPO_RS08290	27
RV2039_libmerged	1653732	1653743		YPO_RS08295	11
RV2039_libmerged	1653811	1653866		YPO_RS08295	55
RV2039_libmerged	1654112	1654121		YPO_RS08295	9
RV2039_libmerged	1654324	1654332		YPO_RS08300	8
RV2039_libmerged	1655070	1655097		YPO_RS08305	27
RV2039_libmerged	1655379	1655405		YPO_RS08305	26
RV2039_libmerged	1657963	1657972		tssC	9
RV2039_libmerged	1663153	1663163		tssH	10
RV2039_libmerged	1667800	1667801		YPO_RS08345	1
RV2039_libmerged	1668220	1668247		YPO_RS08350	27
RV2039_libmerged	1668865	1668870		YPO_RS08350	5
RV2039_libmerged	1669404	1669417		YPO_RS08350	13
RV2039_libmerged	1669454	1669459		YPO_RS08350	5
RV2039_libmerged	1669639	1669666		YPO_RS08350	27
RV2039_libmerged	1669696	1669704		YPO_RS08350	8
RV2039_libmerged	1669998	1670011		YPO_RS08350	13
RV2039_libmerged	1670106	1670132		YPO_RS08350	26
RV2039_libmerged	1670464	1670498		YPO_RS08355	34
RV2039_libmerged	1670723	1670732		YPO_RS08355	9
RV2039_libmerged	1670865	1670887		YPO_RS08355	22
RV2039_libmerged	1671201	1671229		YPO_RS08355	28
RV2039_libmerged	1671587	1671603		YPO_RS08360	16
RV2039_libmerged	1673014	1673032		YPO_RS08365	18
RV2039_libmerged	1673079	1673086		YPO_RS08365	7
RV2039_libmerged	1673207	1673237		YPO_RS08365	30
RV2039_libmerged	1674225	1674260		YPO_RS08370	35
RV2039_libmerged	1674387	1674418		YPO_RS08370	31
RV2039_libmerged	1679245	1679248		YPO_RS08385	3
RV2039_libmerged	1680838	1680843		YPO_RS08385	5
RV2039_libmerged	1681671	1681676		tssA	5
RV2039_libmerged	1683050	1683052		YPO_RS08395	2
RV2039_libmerged	1683414	1683460		YPO_RS08395	46
RV2039_libmerged	1683591	1683616		YPO_RS08395	25
RV2039_libmerged	1683839	1683857		YPO_RS08395	18
RV2039_libmerged	1683956	1683978		YPO_RS08395	22
RV2039_libmerged	1684125	1684148		YPO_RS08400	23
RV2039_libmerged	1684425	1684456		YPO_RS08400	31
RV2039_libmerged	1684995	1685005		tssF	10
RV2039_libmerged	1686331	1686335		tssF	4
RV2039_libmerged	1686410	1686419		tssF	9
RV2039_libmerged	1687509	1687511		tssG	2
RV2039_libmerged	1687509	1687511		tssJ	2
RV2039_libmerged	1687679	1687690		tssJ	11
RV2039_libmerged	1690140	1690147		YPO_RS08430	7
RV2039_libmerged	1690256	1690271		YPO_RS08430	15
RV2039_libmerged	1690307	1690331		YPO_RS08430	24
RV2039_libmerged	1690383	1690410		YPO_RS08430	27
RV2039_libmerged	1690691	1690699		YPO_RS08430	8
RV2039_libmerged	1690733	1690763		YPO_RS08430	30
RV2039_libmerged	1692022	1692055		YPO_RS08435	33
RV2039_libmerged	1692725	1692732		YPO_RS08435	7
RV2039_libmerged	1693583	1693589		YPO_RS08440	6
RV2039_libmerged	1693716	1693741		YPO_RS08440	25
RV2039_libmerged	1693797	1693808		YPO_RS08440	11
RV2039_libmerged	1693966	1693974		YPO_RS08445	8
RV2039_libmerged	1694057	1694081		YPO_RS08445	24
RV2039_libmerged	1694179	1694184		YPO_RS08445	5
RV2039_libmerged	1694278	1694303		YPO_RS08445	25
RV2039_libmerged	1694380	1694381		YPO_RS08445	1
RV2039_libmerged	1694480	1694487		YPO_RS08445	7
RV2039_libmerged	1694539	1694543		YPO_RS08445	4
RV2039_libmerged	1694596	1694599		YPO_RS08445	3
RV2039_libmerged	1694629	1694640		YPO_RS08445	11
RV2039_libmerged	1694997	1695007		YPO_RS08445	10
RV2039_libmerged	1695055	1695063		YPO_RS08445	8
RV2039_libmerged	1696094	1696116		moeA	22
RV2039_libmerged	1696622	1696652		moeA	30
RV2039_libmerged	1696781	1696783		moeA	2
RV2039_libmerged	1697271	1697279		moeA	8
RV2039_libmerged	1698307	1698318		darE	11
RV2039_libmerged	1698366	1698395		darE	29
RV2039_libmerged	1698501	1698502		darE	1
RV2039_libmerged	1698664	1698669		darE	5
RV2039_libmerged	1698926	1698933		darE	7
RV2039_libmerged	1699100	1699109		darE	9
RV2039_libmerged	1699161	1699201		darE	40
RV2039_libmerged	1699211	1699220		darD	9
RV2039_libmerged	1699597	1699625		darD	28
RV2039_libmerged	1699759	1699771		darD	12
RV2039_libmerged	1699928	1699954		darC	26
RV2039_libmerged	1700020	1700034		darC	14
RV2039_libmerged	1700119	1700124		darC	5
RV2039_libmerged	1700225	1700243		darC	18
RV2039_libmerged	1700313	1700347		darC	34
RV2039_libmerged	1700564	1700581		darC	17
RV2039_libmerged	1700808	1700814		darC	6
RV2039_libmerged	1700899	1700900		darC	1
RV2039_libmerged	1700991	1700993		darC	2
RV2039_libmerged	1701046	1701109		darC	63
RV2039_libmerged	1701288	1701397		darB	109
RV2039_libmerged	1701543	1701545		darB	2
RV2039_libmerged	1701616	1701638		darB	22
RV2039_libmerged	1701691	1701707		darB	16
RV2039_libmerged	1701841	1701856		darB	15
RV2039_libmerged	1702052	1702086		darB	34
RV2039_libmerged	1702224	1702241		darB	17
RV2039_libmerged	1702597	1702600		darB	3
RV2039_libmerged	1702631	1702636		darB	5
RV2039_libmerged	1702692	1702709		darB	17
RV2039_libmerged	1703101	1703104		darB	3
RV2039_libmerged	1703415	1703428		darB	13
RV2039_libmerged	1703635	1703650		darA-c	15
RV2039_libmerged	1703776	1703797		darA-c	21
RV2039_libmerged	1704120	1704128		fghA	8
RV2039_libmerged	1704957	1704974		YPO_RS08490	17
RV2039_libmerged	1705637	1705646		YPO_RS08490	9
RV2039_libmerged	1706831	1706853		YPO_RS08495	22
RV2039_libmerged	1708962	1708985		folE	23
RV2039_libmerged	1709567	1709594		YPO_RS08510	27
RV2039_libmerged	1709667	1709676		YPO_RS08510	9
RV2039_libmerged	1711342	1711352		mglB	10
RV2039_libmerged	1711677	1711683		mglB	6
RV2039_libmerged	1711768	1711794		mglB	26
RV2039_libmerged	1712259	1712260		mglB	1
RV2039_libmerged	1713342	1713344		mglA	2
RV2039_libmerged	1714008	1714012		mglA	4
RV2039_libmerged	1714083	1714095		mglC	12
RV2039_libmerged	1714131	1714158		mglC	27
RV2039_libmerged	1714791	1714799		mglC	8
RV2039_libmerged	1715073	1715081		mglC	8
RV2039_libmerged	1715697	1715699		sanA	2
RV2039_libmerged	1716877	1716880		YPO_RS08535	3
RV2039_libmerged	1717433	1717436		YPO_RS08535	3
RV2039_libmerged	1717945	1717956		YPO_RS08535	11
RV2039_libmerged	1719291	1719300		cdd	9
RV2039_libmerged	1720595	1720609		YPO_RS08550	14
RV2039_libmerged	1720739	1720744		YPO_RS08550	5
RV2039_libmerged	1721467	1721472		YPO_RS08555	5
RV2039_libmerged	1721547	1721548		YPO_RS08555	1
RV2039_libmerged	1722252	1722268		YPO_RS08555	16
RV2039_libmerged	1722674	1722724		YPO_RS08560	50
RV2039_libmerged	1723493	1723495		YPO_RS08560	2
RV2039_libmerged	1725726	1725735		YPO_RS08570	9
RV2039_libmerged	1725903	1725946		YPO_RS08570	43
RV2039_libmerged	1726285	1726319		YPO_RS08570	34
RV2039_libmerged	1726646	1726668		YPO_RS08575	22
RV2039_libmerged	1726735	1726760		YPO_RS08575	25
RV2039_libmerged	1726856	1726910		YPO_RS08575	54
RV2039_libmerged	1726986	1727103		YPO_RS08575	117
RV2039_libmerged	1727133	1727137		YPO_RS08575	4
RV2039_libmerged	1727294	1727313		YPO_RS08575	19
RV2039_libmerged	1727441	1727444		YPO_RS08580	3
RV2039_libmerged	1727483	1727540		YPO_RS08580	57
RV2039_libmerged	1727818	1727819		YPO_RS08580	1
RV2039_libmerged	1727857	1727876		YPO_RS08580	19
RV2039_libmerged	1727945	1727996		YPO_RS08580	51
RV2039_libmerged	1728157	1728185		YPO_RS08580	28
RV2039_libmerged	1728658	1728673		YPO_RS08585	15
RV2039_libmerged	1728712	1728802		YPO_RS08585	90
RV2039_libmerged	1728865	1728951		YPO_RS08585	86
RV2039_libmerged	1729897	1729905		metG	8
RV2039_libmerged	1730848	1730858		metG	10
RV2039_libmerged	1731546	1731555		apbC	9
RV2039_libmerged	1731709	1731717		apbC	8
RV2039_libmerged	1731774	1731781		apbC	7
RV2039_libmerged	1732079	1732082		apbC	3
RV2039_libmerged	1732206	1732217		apbC	11
RV2039_libmerged	1733189	1733190		udk	1
RV2039_libmerged	1733240	1733249		udk	9
RV2039_libmerged	1733310	1733335		udk	25
RV2039_libmerged	1733365	1733378		udk	13
RV2039_libmerged	1733659	1733688		dcd	29
RV2039_libmerged	1734370	1734373		asmA	3
RV2039_libmerged	1734996	1734999		asmA	3
RV2039_libmerged	1735138	1735141		asmA	3
RV2039_libmerged	1735326	1735333		asmA	7
RV2039_libmerged	1736426	1736435		YPO_RS08615	9
RV2039_libmerged	1737449	1737450		YPO_RS08615	1
RV2039_libmerged	1738382	1738394		fhuF	12
RV2039_libmerged	1738678	1738683		fhuF	5
RV2039_libmerged	1738820	1738887		fhuF	67
RV2039_libmerged	1739303	1739311		YPO_RS08625	8
RV2039_libmerged	1739348	1739355		YPO_RS08625	7
RV2039_libmerged	1739427	1739451		YPO_RS08625	24
RV2039_libmerged	1739531	1739536		YPO_RS08625	5
RV2039_libmerged	1739936	1739978		YPO_RS08625	42
RV2039_libmerged	1740252	1740315		YPO_RS08625	63
RV2039_libmerged	1740581	1740588		YPO_RS08625	7
RV2039_libmerged	1740691	1740725		YPO_RS08625	34
RV2039_libmerged	1740811	1740827		YPO_RS08625	16
RV2039_libmerged	1740907	1740963		YPO_RS08630	56
RV2039_libmerged	1741191	1741220		YPO_RS08630	29
RV2039_libmerged	1741266	1741270		YPO_RS08630	4
RV2039_libmerged	1741671	1741680		YPO_RS08630	9
RV2039_libmerged	1741786	1741792		YPO_RS08630	6
RV2039_libmerged	1741920	1741945		YPO_RS08630	25
RV2039_libmerged	1742023	1742037		YPO_RS08630	14
RV2039_libmerged	1742328	1742329		YPO_RS08635	1
RV2039_libmerged	1742468	1742482		YPO_RS08635	14
RV2039_libmerged	1742739	1742761		YPO_RS08635	22
RV2039_libmerged	1742758	1742762		YPO_RS08640	4
RV2039_libmerged	1742901	1742903		YPO_RS08640	2
RV2039_libmerged	1743080	1743096		YPO_RS08640	16
RV2039_libmerged	1743730	1743733		YPO_RS08640	3
RV2039_libmerged	1745099	1745105		YPO_RS08645	6
RV2039_libmerged	1745655	1745676		YPO_RS08650	21
RV2039_libmerged	1747469	1747480		YPO_RS08655	11
RV2039_libmerged	1749159	1749183		YPO_RS08665	24
RV2039_libmerged	1749732	1749736		YPO_RS08665	4
RV2039_libmerged	1750244	1750245		YPO_RS08665	1
RV2039_libmerged	1750532	1750555		YPO_RS08665	23
RV2039_libmerged	1751039	1751047		YPO_RS08665	8
RV2039_libmerged	1751766	1751783		YPO_RS08670	17
RV2039_libmerged	1752197	1752210		YPO_RS08670	13
RV2039_libmerged	1752421	1752437		YPO_RS08670	16
RV2039_libmerged	1752874	1752904		YPO_RS08670	30
RV2039_libmerged	1754349	1754351		galU	2
RV2039_libmerged	1754422	1754424		galU	2
RV2039_libmerged	1754849	1754889		galU	40
RV2039_libmerged	1755165	1755194		galU	29
RV2039_libmerged	1758096	1758111		YPO_RS08690	15
RV2039_libmerged	1758262	1758266		YPO_RS08690	4
RV2039_libmerged	1759133	1759142		hisF	9
RV2039_libmerged	1760146	1760150		hisH	4
RV2039_libmerged	1760584	1760591		hisB	7
RV2039_libmerged	1763374	1763382		hisD	8
RV2039_libmerged	1765832	1765840		YPO_RS08735	8
RV2039_libmerged	1767441	1767456		YPO_RS08745	15
RV2039_libmerged	1768883	1768890		YPO_RS08750	7
RV2039_libmerged	1769575	1769582		YPO_RS08755	7
RV2039_libmerged	1770913	1770920		YPO_RS08760	7
RV2039_libmerged	1772299	1772307		YPO_RS08770	8
RV2039_libmerged	1773019	1773036		YPO_RS08770	17
RV2039_libmerged	1775116	1775121		sbcB	5
RV2039_libmerged	1775800	1775812		YPO_RS08785	12
RV2039_libmerged	1776274	1776302		YPO_RS08785	28
RV2039_libmerged	1776436	1776444		YPO_RS08785	8
RV2039_libmerged	1777299	1777308		YPO_RS08790	9
RV2039_libmerged	1777851	1777892		YPO_RS08795	41
RV2039_libmerged	1777931	1777961		YPO_RS08795	30
RV2039_libmerged	1778229	1778239		YPO_RS08795	10
RV2039_libmerged	1778330	1778342		YPO_RS08795	12
RV2039_libmerged	1778574	1778626		YPO_RS08795	52
RV2039_libmerged	1778836	1778862		YPO_RS08795	26
RV2039_libmerged	1779085	1779095		YPO_RS08800	10
RV2039_libmerged	1779452	1779474		YPO_RS08800	22
RV2039_libmerged	1779628	1779629		YPO_RS08800	1
RV2039_libmerged	1779734	1779748		YPO_RS08800	14
RV2039_libmerged	1779791	1779808		YPO_RS08800	17
RV2039_libmerged	1780854	1780861		YPO_RS08800	7
RV2039_libmerged	1781077	1781079		YPO_RS08800	2
RV2039_libmerged	1781605	1781614		YPO_RS08800	9
RV2039_libmerged	1782157	1782174		YPO_RS08800	17
RV2039_libmerged	1783410	1783419		YPO_RS08805	9
RV2039_libmerged	1783518	1783532		YPO_RS08805	14
RV2039_libmerged	1783979	1783989		YPO_RS08805	10
RV2039_libmerged	1784068	1784074		YPO_RS08805	6
RV2039_libmerged	1784574	1784589		YPO_RS08810	15
RV2039_libmerged	1785746	1785748		YPO_RS08815	2
RV2039_libmerged	1786784	1786788		YPO_RS08820	4
RV2039_libmerged	1787746	1787749		YPO_RS08825	3
RV2039_libmerged	1788166	1788189		YPO_RS08825	23
RV2039_libmerged	1789090	1789095		lldD	5
RV2039_libmerged	1790184	1790185		argG	1
RV2039_libmerged	1790930	1790933		argG	3
RV2039_libmerged	1791963	1791968		YPO_RS08840	5
RV2039_libmerged	1793222	1793230		YPO_RS08845	8
RV2039_libmerged	1795935	1795954		YPO_RS08855	19
RV2039_libmerged	1796124	1796186		YPO_RS08855	62
RV2039_libmerged	1796221	1796313		YPO_RS08855	92
RV2039_libmerged	1796509	1796530		YPO_RS08855	21
RV2039_libmerged	1796968	1796984		YPO_RS08860	16
RV2039_libmerged	1799312	1799322		YPO_RS08875	10
RV2039_libmerged	1799557	1799589		YPO_RS08875	32
RV2039_libmerged	1800101	1800105		YPO_RS08875	4
RV2039_libmerged	1800476	1800490		YPO_RS08880	14
RV2039_libmerged	1800692	1800693		YPO_RS08880	1
RV2039_libmerged	1801060	1801061		YPO_RS08885	1
RV2039_libmerged	1801417	1801436		YPO_RS08885	19
RV2039_libmerged	1802819	1802829		YPO_RS08890	10
RV2039_libmerged	1803158	1803160		YPO_RS08890	2
RV2039_libmerged	1804308	1804320		YPO_RS08900	12
RV2039_libmerged	1805676	1805678		YPO_RS08900	2
RV2039_libmerged	1805904	1805924		YPO_RS08905	20
RV2039_libmerged	1806331	1806335		YPO_RS08905	4
RV2039_libmerged	1806981	1807004		YPO_RS08905	23
RV2039_libmerged	1807100	1807127		YPO_RS08910	27
RV2039_libmerged	1807181	1807183		YPO_RS08910	2
RV2039_libmerged	1807236	1807251		YPO_RS08910	15
RV2039_libmerged	1807341	1807413		YPO_RS08910	72
RV2039_libmerged	1807548	1807553		YPO_RS08910	5
RV2039_libmerged	1807600	1807608		YPO_RS08910	8
RV2039_libmerged	1807706	1807725		YPO_RS08910	19
RV2039_libmerged	1807869	1807886		YPO_RS08910	17
RV2039_libmerged	1808052	1808061		YPO_RS08910	9
RV2039_libmerged	1808272	1808277		YPO_RS08910	5
RV2039_libmerged	1808272	1808325		bssS	53
RV2039_libmerged	1808518	1808536		bssS	18
RV2039_libmerged	1811856	1811875		YPO_RS08940	19
RV2039_libmerged	1812052	1812063		YPO_RS08940	11
RV2039_libmerged	1812343	1812388		YPO_RS08940	45
RV2039_libmerged	1812546	1812551		YPO_RS08940	5
RV2039_libmerged	1817560	1817568		rluC	8
RV2039_libmerged	1818217	1818221		YPO_RS08955	4
RV2039_libmerged	1818255	1818306		YPO_RS08955	51
RV2039_libmerged	1818403	1818599		YPO_RS08955	196
RV2039_libmerged	1820318	1820325		plsX	7
RV2039_libmerged	1820460	1820464		plsX	4
RV2039_libmerged	1820902	1820909		plsX	7
RV2039_libmerged	1822574	1822580		fabD	6
RV2039_libmerged	1823521	1823545		fabG	24
RV2039_libmerged	1823772	1823785		fabG	13
RV2039_libmerged	1825426	1825433		fabF	7
RV2039_libmerged	1825982	1825995		YPO_RS09005	13
RV2039_libmerged	1826237	1826276		YPO_RS09005	39
RV2039_libmerged	1826830	1826847		pabC	17
RV2039_libmerged	1827490	1827500		pabC	10
RV2039_libmerged	1827917	1827934		mltG	17
RV2039_libmerged	1828056	1828073		mltG	17
RV2039_libmerged	1828601	1828625		mltG	24
RV2039_libmerged	1829598	1829599		holB	1
RV2039_libmerged	1830531	1830536		holB	5
RV2039_libmerged	1830595	1830608		YPO_RS09030	13
RV2039_libmerged	1831225	1831230		YPO_RS09030	5
RV2039_libmerged	1831971	1831973		ptsG	2
RV2039_libmerged	1832297	1832299		ptsG	2
RV2039_libmerged	1833358	1833392		YPO_RS09040	34
RV2039_libmerged	1833445	1833529		YPO_RS09040	84
RV2039_libmerged	1833563	1833606		YPO_RS09040	43
RV2039_libmerged	1833651	1833673		YPO_RS09040	22
RV2039_libmerged	1835880	1835883		YPO_RS09055	3
RV2039_libmerged	1836460	1836474		lpoB	14
RV2039_libmerged	1838324	1838326		nagZ	2
RV2039_libmerged	1839883	1839911		YPO_RS09080	28
RV2039_libmerged	1840767	1840770		YPO_RS09080	3
RV2039_libmerged	1841471	1841481		YPO_RS09085	10
RV2039_libmerged	1842001	1842008		YPO_RS09090	7
RV2039_libmerged	1842089	1842116		YPO_RS09090	27
RV2039_libmerged	1842183	1842204		YPO_RS09090	21
RV2039_libmerged	1842263	1842271		YPO_RS09090	8
RV2039_libmerged	1842398	1842401		YPO_RS09090	3
RV2039_libmerged	1842497	1842564		YPO_RS09095	67
RV2039_libmerged	1842633	1842655		YPO_RS09095	22
RV2039_libmerged	1842786	1842849		YPO_RS09095	63
RV2039_libmerged	1842940	1843057		YPO_RS09095	117
RV2039_libmerged	1843137	1843155		YPO_RS09095	18
RV2039_libmerged	1843242	1843259		YPO_RS09095	17
RV2039_libmerged	1843447	1843489		YPO_RS09095	42
RV2039_libmerged	1843688	1843705		YPO_RS09095	17
RV2039_libmerged	1844089	1844118		YPO_RS09100	29
RV2039_libmerged	1844170	1844182		YPO_RS09100	12
RV2039_libmerged	1844436	1844569		YPO_RS09100	133
RV2039_libmerged	1844679	1844687		YPO_RS09100	8
RV2039_libmerged	1844734	1844777		YPO_RS09100	43
RV2039_libmerged	1844854	1844863		YPO_RS09100	9
RV2039_libmerged	1845111	1845158		YPO_RS09105	47
RV2039_libmerged	1845190	1845211		YPO_RS09105	21
RV2039_libmerged	1845712	1845735		YPO_RS09105	23
RV2039_libmerged	1845769	1845796		YPO_RS09105	27
RV2039_libmerged	1845833	1845885		YPO_RS09105	52
RV2039_libmerged	1846311	1846330		YPO_RS09110	19
RV2039_libmerged	1848644	1848707		mfd	63
RV2039_libmerged	1850211	1850219		mfd	8
RV2039_libmerged	1850704	1850713		lolC	9
RV2039_libmerged	1850852	1850853		lolC	1
RV2039_libmerged	1852842	1852868		lolE	26
RV2039_libmerged	1853175	1853178		lolE	3
RV2039_libmerged	1853380	1853389		lolE	9
RV2039_libmerged	1855290	1855303		cobB	13
RV2039_libmerged	1856079	1856108		pepT	29
RV2039_libmerged	1856214	1856238		pepT	24
RV2039_libmerged	1857252	1857262		YPO_RS09150	10
RV2039_libmerged	1857382	1857391		YPO_RS09150	9
RV2039_libmerged	1858199	1858206		YPO_RS09150	7
RV2039_libmerged	1858531	1858561		phoQ	30
RV2039_libmerged	1860455	1860460		phoP	5
RV2039_libmerged	1863538	1863545		hflD	7
RV2039_libmerged	1865418	1865453		YPO_RS09185	35
RV2039_libmerged	1866449	1866457		icd	8
RV2039_libmerged	1867067	1867068		icd	1
RV2039_libmerged	1867790	1867805		YPO_RS09200	15
RV2039_libmerged	1868662	1868665		YPO_RS09200	3
RV2039_libmerged	1869138	1869150		YPO_RS09205	12
RV2039_libmerged	1870644	1870646		YPO_RS09210	2
RV2039_libmerged	1871897	1871900		YPO_RS09215	3
RV2039_libmerged	1872258	1872267		YPO_RS09215	9
RV2039_libmerged	1872561	1872566		YPO_RS09215	5
RV2039_libmerged	1873435	1873444		YPO_RS09225	9
RV2039_libmerged	1873753	1873762		YPO_RS09230	9
RV2039_libmerged	1877945	1877948		YPO_RS09250	3
RV2039_libmerged	1878145	1878155		YPO_RS09250	10
RV2039_libmerged	1878215	1878257		YPO_RS09250	42
RV2039_libmerged	1878654	1878671		YPO_RS09255	17
RV2039_libmerged	1880366	1880367		YPO_RS09260	1
RV2039_libmerged	1880905	1880929		YPO_RS09260	24
RV2039_libmerged	1881258	1881262		YPO_RS09260	4
RV2039_libmerged	1883782	1883790		cspE	8
RV2039_libmerged	1889416	1889430		mgtA	14
RV2039_libmerged	1891080	1891099		mgtA	19
RV2039_libmerged	1892843	1892863		flhC	20
RV2039_libmerged	1893772	1893810		motA	38
RV2039_libmerged	1893900	1893901		motA	1
RV2039_libmerged	1894098	1894100		motA	2
RV2039_libmerged	1894213	1894216		motA	3
RV2039_libmerged	1895212	1895213		motB	1
RV2039_libmerged	1895252	1895255		motB	3
RV2039_libmerged	1897908	1897910		cheA	2
RV2039_libmerged	1898301	1898317		cheW	16
RV2039_libmerged	1898386	1898392		cheW	6
RV2039_libmerged	1898868	1898886		YPO_RS09320	18
RV2039_libmerged	1898961	1898985		YPO_RS09320	24
RV2039_libmerged	1899476	1899481		YPO_RS09320	5
RV2039_libmerged	1900001	1900013		YPO_RS09320	12
RV2039_libmerged	1900560	1900561		YPO_RS09330	1
RV2039_libmerged	1900831	1900874		YPO_RS09330	43
RV2039_libmerged	1900996	1901001		YPO_RS09330	5
RV2039_libmerged	1901443	1901470		YPO_RS09330	27
RV2039_libmerged	1901660	1901674		YPO_RS09335	14
RV2039_libmerged	1902034	1902036		YPO_RS09335	2
RV2039_libmerged	1902067	1902072		YPO_RS09335	5
RV2039_libmerged	1903759	1903786		yapJ	27
RV2039_libmerged	1904296	1904302		yapJ	6
RV2039_libmerged	1904574	1904576		yapJ	2
RV2039_libmerged	1904842	1904872		yapJ	30
RV2039_libmerged	1907372	1907375		YPO_RS09345	3
RV2039_libmerged	1908718	1908723		YPO_RS09345	5
RV2039_libmerged	1909075	1909081		YPO_RS09345	6
RV2039_libmerged	1909537	1909549		YPO_RS09345	12
RV2039_libmerged	1910080	1910104		YPO_RS09350	24
RV2039_libmerged	1910188	1910220		YPO_RS09350	32
RV2039_libmerged	1910388	1910415		YPO_RS09350	27
RV2039_libmerged	1910718	1910721		YPO_RS09350	3
RV2039_libmerged	1911246	1911268		YPO_RS09355	22
RV2039_libmerged	1915637	1915647		YPO_RS09370	10
RV2039_libmerged	1916580	1916582		YPO_RS09370	2
RV2039_libmerged	1916821	1916822		cheY	1
RV2039_libmerged	1918291	1918299		YPO_RS09385	8
RV2039_libmerged	1918490	1918493		YPO_RS09385	3
RV2039_libmerged	1918603	1918621		YPO_RS09385	18
RV2039_libmerged	1919006	1919013		YPO_RS09385	7
RV2039_libmerged	1919675	1919677		YPO_RS09390	2
RV2039_libmerged	1920923	1920925		YPO_RS09390	2
RV2039_libmerged	1921507	1921508		YPO_RS09390	1
RV2039_libmerged	1922158	1922161		YPO_RS09400	3
RV2039_libmerged	1922207	1922255		YPO_RS09400	48
RV2039_libmerged	1922441	1922443		YPO_RS09400	2
RV2039_libmerged	1922762	1922799		YPO_RS09400	37
RV2039_libmerged	1924058	1924075		YPO_RS09405	17
RV2039_libmerged	1924147	1924156		YPO_RS09405	9
RV2039_libmerged	1924498	1924507		YPO_RS09405	9
RV2039_libmerged	1924678	1924707		YPO_RS09405	29
RV2039_libmerged	1928171	1928174		YPO_RS09425	3
RV2039_libmerged	1928269	1928278		YPO_RS09425	9
RV2039_libmerged	1928320	1928331		YPO_RS09425	11
RV2039_libmerged	1928939	1928967		YPO_RS09430	28
RV2039_libmerged	1929025	1929029		YPO_RS09430	4
RV2039_libmerged	1929223	1929266		YPO_RS09430	43
RV2039_libmerged	1929365	1929419		YPO_RS09430	54
RV2039_libmerged	1929622	1929628		YPO_RS09430	6
RV2039_libmerged	1929731	1929809		YPO_RS09435	78
RV2039_libmerged	1930014	1930046		YPO_RS09435	32
RV2039_libmerged	1930153	1930195		YPO_RS09435	42
RV2039_libmerged	1930396	1930401		YPO_RS09435	5
RV2039_libmerged	1930523	1930537		YPO_RS09435	14
RV2039_libmerged	1930643	1930662		YPO_RS09435	19
RV2039_libmerged	1930720	1930740		YPO_RS09435	20
RV2039_libmerged	1931150	1931162		YPO_RS09440	12
RV2039_libmerged	1931500	1931531		YPO_RS09440	31
RV2039_libmerged	1931695	1931739		YPO_RS09445	44
RV2039_libmerged	1932261	1932268		YPO_RS09450	7
RV2039_libmerged	1932389	1932391		YPO_RS09450	2
RV2039_libmerged	1932974	1933006		YPO_RS09450	32
RV2039_libmerged	1933850	1933852		YPO_RS09455	2
RV2039_libmerged	1934164	1934173		YPO_RS09455	9
RV2039_libmerged	1934228	1934243		YPO_RS09455	15
RV2039_libmerged	1934335	1934375		YPO_RS09455	40
RV2039_libmerged	1935263	1935279		YPO_RS09455	16
RV2039_libmerged	1935596	1935599		YPO_RS09455	3
RV2039_libmerged	1935666	1935698		YPO_RS09455	32
RV2039_libmerged	1935925	1935937		YPO_RS09460	12
RV2039_libmerged	1936031	1936033		YPO_RS09460	2
RV2039_libmerged	1936488	1936507		YPO_RS09460	19
RV2039_libmerged	1936545	1936551		YPO_RS09460	6
RV2039_libmerged	1936672	1936675		YPO_RS09460	3
RV2039_libmerged	1936706	1936726		YPO_RS09465	20
RV2039_libmerged	1937811	1937814		YPO_RS09470	3
RV2039_libmerged	1937820	1937871		YPO_RS09475	51
RV2039_libmerged	1938092	1938100		YPO_RS09475	8
RV2039_libmerged	1940411	1940430		YPO_RS09480	19
RV2039_libmerged	1940603	1940644		YPO_RS09480	41
RV2039_libmerged	1941492	1941504		YPO_RS09480	12
RV2039_libmerged	1941492	1941513		yebS	21
RV2039_libmerged	1944972	1944977		prc	5
RV2039_libmerged	1945133	1945143		prc	10
RV2039_libmerged	1945182	1945247		prc	65
RV2039_libmerged	1945458	1945459		prc	1
RV2039_libmerged	1945937	1945947		prc	10
RV2039_libmerged	1946824	1946829		htpX	5
RV2039_libmerged	1947193	1947205		htpX	12
RV2039_libmerged	1947421	1947444		htpX	23
RV2039_libmerged	1947681	1947698		htpX	17
RV2039_libmerged	1948646	1948663		YPO_RS09510	17
RV2039_libmerged	1948897	1948900		YPO_RS09510	3
RV2039_libmerged	1949325	1949340		YPO_RS09515	15
RV2039_libmerged	1949919	1949936		YPO_RS09520	17
RV2039_libmerged	1951265	1951270		YPO_RS09520	5
RV2039_libmerged	1952556	1952567		YPO_RS09525	11
RV2039_libmerged	1952709	1952714		YPO_RS09525	5
RV2039_libmerged	1953050	1953067		YPO_RS09525	17
RV2039_libmerged	1953644	1953645		YPO_RS09525	1
RV2039_libmerged	1953757	1953778		YPO_RS09530	21
RV2039_libmerged	1954545	1954560		YPO_RS09535	15
RV2039_libmerged	1955493	1955521		YPO_RS09535	28
RV2039_libmerged	1956936	1956940		YPO_RS09540	4
RV2039_libmerged	1957201	1957205		YPO_RS09540	4
RV2039_libmerged	1958117	1958118		kdgR	1
RV2039_libmerged	1958997	1959005		YPO_RS09550	8
RV2039_libmerged	1960078	1960086		YPO_RS09555	8
RV2039_libmerged	1960900	1960901		YPO_RS09555	1
RV2039_libmerged	1961498	1961516		YPO_RS09560	18
RV2039_libmerged	1962692	1962706		YPO_RS09565	14
RV2039_libmerged	1962756	1962767		YPO_RS09565	11
RV2039_libmerged	1962802	1962822		YPO_RS09565	20
RV2039_libmerged	1963483	1963490		YPO_RS09570	7
RV2039_libmerged	1963809	1963810		YPO_RS09570	1
RV2039_libmerged	1963906	1963928		YPO_RS09570	22
RV2039_libmerged	1963992	1964097		YPO_RS09570	105
RV2039_libmerged	1964219	1964223		YPO_RS09570	4
RV2039_libmerged	1964291	1964356		YPO_RS09570	65
RV2039_libmerged	1964946	1964969		YPO_RS09575	23
RV2039_libmerged	1965213	1965234		YPO_RS09575	21
RV2039_libmerged	1966084	1966093		YPO_RS09580	9
RV2039_libmerged	1966984	1967028		YPO_RS09585	44
RV2039_libmerged	1967366	1967368		YPO_RS09585	2
RV2039_libmerged	1967618	1967621		YPO_RS09585	3
RV2039_libmerged	1967704	1967717		YPO_RS09585	13
RV2039_libmerged	1967758	1967763		YPO_RS09590	5
RV2039_libmerged	1967836	1967847		YPO_RS09590	11
RV2039_libmerged	1968232	1968251		YPO_RS09590	19
RV2039_libmerged	1968311	1968319		YPO_RS09590	8
RV2039_libmerged	1968841	1968842		YPO_RS09590	1
RV2039_libmerged	1969077	1969080		YPO_RS09590	3
RV2039_libmerged	1969299	1969306		YPO_RS09590	7
RV2039_libmerged	1969776	1969784		kduD	8
RV2039_libmerged	1970045	1970060		kduD	15
RV2039_libmerged	1972110	1972125		YPO_RS09605	15
RV2039_libmerged	1972343	1972364		YPO_RS09610	21
RV2039_libmerged	1972551	1972556		YPO_RS09610	5
RV2039_libmerged	1972668	1972712		YPO_RS09610	44
RV2039_libmerged	1972743	1972756		YPO_RS09610	13
RV2039_libmerged	1974910	1974991		YPO_RS09620	81
RV2039_libmerged	1975025	1975070		YPO_RS09620	45
RV2039_libmerged	1975315	1975337		YPO_RS09620	22
RV2039_libmerged	1975414	1975437		YPO_RS09620	23
RV2039_libmerged	1975472	1975477		YPO_RS09620	5
RV2039_libmerged	1975617	1975632		YPO_RS09620	15
RV2039_libmerged	1975753	1975761		YPO_RS09620	8
RV2039_libmerged	1975989	1976004		YPO_RS09625	15
RV2039_libmerged	1976136	1976183		YPO_RS09625	47
RV2039_libmerged	1976244	1976283		YPO_RS09625	39
RV2039_libmerged	1976510	1976511		YPO_RS09625	1
RV2039_libmerged	1976545	1976566		YPO_RS09625	21
RV2039_libmerged	1976618	1976659		YPO_RS09630	41
RV2039_libmerged	1976701	1976709		YPO_RS09630	8
RV2039_libmerged	1977455	1977457		mtfA	2
RV2039_libmerged	1977551	1977616		mtfA	65
RV2039_libmerged	1979331	1979385		YPO_RS09650	54
RV2039_libmerged	1980753	1980773		YPO_RS09655	20
RV2039_libmerged	1980899	1980905		YPO_RS09655	6
RV2039_libmerged	1981154	1981188		YPO_RS09655	34
RV2039_libmerged	1981428	1981430		YPO_RS09655	2
RV2039_libmerged	1981600	1981605		YPO_RS09655	5
RV2039_libmerged	1982331	1982348		YPO_RS09660	17
RV2039_libmerged	1982535	1982560		YPO_RS09665	25
RV2039_libmerged	1982798	1982801		YPO_RS09665	3
RV2039_libmerged	1985368	1985369		YPO_RS09690	1
RV2039_libmerged	1985799	1985814		YPO_RS09695	15
RV2039_libmerged	1986202	1986206		YPO_RS09700	4
RV2039_libmerged	1987752	1987758		YPO_RS09705	6
RV2039_libmerged	1987798	1987812		YPO_RS09705	14
RV2039_libmerged	1987905	1987909		YPO_RS09705	4
RV2039_libmerged	1988030	1988047		YPO_RS09705	17
RV2039_libmerged	1989941	1989946		pgeF	5
RV2039_libmerged	1990995	1990997		rlmA	2
RV2039_libmerged	1991504	1991515		rlmA	11
RV2039_libmerged	1992274	1992278		YPO_RS09730	4
RV2039_libmerged	1992692	1992704		YPO_RS09735	12
RV2039_libmerged	1992799	1992862		YPO_RS09735	63
RV2039_libmerged	1992945	1992967		YPO_RS09735	22
RV2039_libmerged	1993013	1993029		YPO_RS09735	16
RV2039_libmerged	1993195	1993203		YPO_RS09735	8
RV2039_libmerged	1993322	1993365		YPO_RS09735	43
RV2039_libmerged	1993561	1993584		YPO_RS09735	23
RV2039_libmerged	1993623	1993657		YPO_RS09735	34
RV2039_libmerged	1993818	1993837		YPO_RS09740	19
RV2039_libmerged	1993954	1994056		YPO_RS09740	102
RV2039_libmerged	1994087	1994124		YPO_RS09740	37
RV2039_libmerged	1994293	1994375		YPO_RS09740	82
RV2039_libmerged	1994421	1994441		YPO_RS09740	20
RV2039_libmerged	1994502	1994509		YPO_RS09745	7
RV2039_libmerged	1996065	1996080		YPO_RS09745	15
RV2039_libmerged	1996363	1996365		YPO_RS09745	2
RV2039_libmerged	1996468	1996472		YPO_RS09745	4
RV2039_libmerged	1996899	1996927		YPO_RS09750	28
RV2039_libmerged	1997513	1997529		YPO_RS09750	16
RV2039_libmerged	1997787	1997828		YPO_RS09750	41
RV2039_libmerged	1998102	1998125		YPO_RS09750	23
RV2039_libmerged	1998183	1998234		YPO_RS09750	51
RV2039_libmerged	1998413	1998416		YPO_RS09750	3
RV2039_libmerged	2000598	2000626		YPO_RS09760	28
RV2039_libmerged	2000714	2000725		YPO_RS09760	11
RV2039_libmerged	2000791	2000795		YPO_RS09760	4
RV2039_libmerged	2001845	2001857		YPO_RS09765	12
RV2039_libmerged	2001901	2001937		YPO_RS09770	36
RV2039_libmerged	2002073	2002088		YPO_RS09770	15
RV2039_libmerged	2002898	2002927		manX	29
RV2039_libmerged	2003543	2003565		manX	22
RV2039_libmerged	2004523	2004534		YPO_RS09780	11
RV2039_libmerged	2004863	2004870		YPO_RS09780	7
RV2039_libmerged	2006884	2006942		YPO_RS09790	58
RV2039_libmerged	2007066	2007070		YPO_RS09790	4
RV2039_libmerged	2007913	2007929		YPO_RS09795	16
RV2039_libmerged	2008186	2008225		YPO_RS09795	39
RV2039_libmerged	2008257	2008263		YPO_RS09795	6
RV2039_libmerged	2008260	2008274		YPO_RS09800	14
RV2039_libmerged	2008855	2008900		YPO_RS09800	45
RV2039_libmerged	2009267	2009269		YPO_RS09800	2
RV2039_libmerged	2009629	2009643		YPO_RS09800	14
RV2039_libmerged	2009794	2009808		hpaD	14
RV2039_libmerged	2010802	2010824		YPO_RS09810	22
RV2039_libmerged	2011038	2011040		YPO_RS09810	2
RV2039_libmerged	2011176	2011192		hpaH	16
RV2039_libmerged	2011825	2011853		hpaH	28
RV2039_libmerged	2011864	2011894		hpaI	30
RV2039_libmerged	2012567	2012593		hpaI	26
RV2039_libmerged	2012759	2012773		hpaX	14
RV2039_libmerged	2015837	2015842		hpaC	5
RV2039_libmerged	2019836	2019842		pabB	6
RV2039_libmerged	2020329	2020337		pabB	8
RV2039_libmerged	2020700	2020707		YPO_RS09855	7
RV2039_libmerged	2022255	2022264		purT	9
RV2039_libmerged	2026154	2026163		YPO_RS09885	9
RV2039_libmerged	2026634	2026645		YPO_RS09885	11
RV2039_libmerged	2027305	2027379		YPO_RS09885	74
RV2039_libmerged	2029247	2029253		pip	6
RV2039_libmerged	2030290	2030331		ftnA	41
RV2039_libmerged	2031170	2031181		yobA	11
RV2039_libmerged	2031684	2031688		copD	4
RV2039_libmerged	2032048	2032054		copD	6
RV2039_libmerged	2032120	2032123		copD	3
RV2039_libmerged	2033313	2033324		YPO_RS09920	11
RV2039_libmerged	2033693	2033707		YPO_RS09925	14
RV2039_libmerged	2033872	2033877		YPO_RS09925	5
RV2039_libmerged	2034746	2034751		flhB	5
RV2039_libmerged	2037161	2037168		flhA	7
RV2039_libmerged	2038043	2038054		YPO_RS09940	11
RV2039_libmerged	2039790	2039816		YPO_RS09950	26
RV2039_libmerged	2039872	2039876		YPO_RS09950	4
RV2039_libmerged	2040094	2040187		YPO_RS09950	93
RV2039_libmerged	2044783	2044787		flgB	4
RV2039_libmerged	2045264	2045278		flgD	14
RV2039_libmerged	2045639	2045647		flgD	8
RV2039_libmerged	2045740	2045750		flgD	10
RV2039_libmerged	2046894	2046899		YPO_RS09990	5
RV2039_libmerged	2047076	2047106		YPO_RS09990	30
RV2039_libmerged	2048212	2048214		flgG	2
RV2039_libmerged	2049072	2049089		flgH	17
RV2039_libmerged	2053669	2053673		flgK	4
RV2039_libmerged	2055139	2055141		flgL	2
RV2039_libmerged	2058273	2058288		YPO_RS10035	15
RV2039_libmerged	2058790	2058835		YPO_RS10040	45
RV2039_libmerged	2059266	2059284		YPO_RS10040	18
RV2039_libmerged	2059521	2059540		YPO_RS10040	19
RV2039_libmerged	2060139	2060152		YPO_RS10045	13
RV2039_libmerged	2060333	2060366		YPO_RS10045	33
RV2039_libmerged	2061208	2061236		YPO_RS10050	28
RV2039_libmerged	2062312	2062320		YPO_RS10050	8
RV2039_libmerged	2063047	2063081		YPO_RS10055	34
RV2039_libmerged	2064944	2064947		YPO_RS10065	3
RV2039_libmerged	2064982	2065005		YPO_RS10065	23
RV2039_libmerged	2065721	2065725		fliR	4
RV2039_libmerged	2066518	2066522		fliQ	4
RV2039_libmerged	2067163	2067191		fliP	28
RV2039_libmerged	2067416	2067417		fliP	1
RV2039_libmerged	2067709	2067731		fliO	22
RV2039_libmerged	2068272	2068277		fliN	5
RV2039_libmerged	2068593	2068649		fliM	56
RV2039_libmerged	2069660	2069668		fliL	8
RV2039_libmerged	2069931	2069958		fliL	27
RV2039_libmerged	2071065	2071104		YPO_RS10110	39
RV2039_libmerged	2071899	2071902		fliJ	3
RV2039_libmerged	2072292	2072313		fliI	21
RV2039_libmerged	2072430	2072438		fliI	8
RV2039_libmerged	2077755	2077756		YPO_RS10145	1
RV2039_libmerged	2078133	2078146		YPO_RS10150	13
RV2039_libmerged	2078278	2078280		YPO_RS10155	2
RV2039_libmerged	2078410	2078414		YPO_RS10155	4
RV2039_libmerged	2079752	2079755		YPO_RS10165	3
RV2039_libmerged	2080388	2080396		YPO_RS10165	8
RV2039_libmerged	2080492	2080510		YPO_RS10165	18
RV2039_libmerged	2080753	2080754		YPO_RS10170	1
RV2039_libmerged	2081197	2081206		YPO_RS10170	9
RV2039_libmerged	2081554	2081577		YPO_RS10170	23
RV2039_libmerged	2082534	2082535		YPO_RS10170	1
RV2039_libmerged	2082639	2082646		YPO_RS10170	7
RV2039_libmerged	2083022	2083025		YPO_RS10175	3
RV2039_libmerged	2083766	2083772		YPO_RS10175	6
RV2039_libmerged	2084378	2084387		fliT	9
RV2039_libmerged	2084794	2084796		fliS	2
RV2039_libmerged	2084980	2085006		fliD	26
RV2039_libmerged	2085442	2085475		fliD	33
RV2039_libmerged	2085625	2085638		fliD	13
RV2039_libmerged	2085852	2085875		fliD	23
RV2039_libmerged	2086362	2086364		fliD	2
RV2039_libmerged	2089323	2089328		fliZ	5
RV2039_libmerged	2090217	2090230		YPO_RS10210	13
RV2039_libmerged	2090848	2090851		YPO_RS10210	3
RV2039_libmerged	2091292	2091294		tcyJ	2
RV2039_libmerged	2091344	2091358		tcyJ	14
RV2039_libmerged	2091416	2091437		tcyJ	21
RV2039_libmerged	2092451	2092455		yecC	4
RV2039_libmerged	2093966	2093979		YPO_RS10235	13
RV2039_libmerged	2095407	2095414		putA	7
RV2039_libmerged	2097382	2097383		putA	1
RV2039_libmerged	2098625	2098630		putA	5
RV2039_libmerged	2099004	2099038		YPO_RS10245	34
RV2039_libmerged	2099557	2099612		putP	55
RV2039_libmerged	2100002	2100007		putP	5
RV2039_libmerged	2100217	2100228		putP	11
RV2039_libmerged	2101279	2101283		YPO_RS10255	4
RV2039_libmerged	2103526	2103536		efeB	10
RV2039_libmerged	2103582	2103595		efeB	13
RV2039_libmerged	2103745	2103753		efeB	8
RV2039_libmerged	2104288	2104290		efeB	2
RV2039_libmerged	2106219	2106222		YPO_RS10275	3
RV2039_libmerged	2106737	2106739		cycA	2
RV2039_libmerged	2106885	2106888		cycA	3
RV2039_libmerged	2106936	2106942		cycA	6
RV2039_libmerged	2107522	2107544		cycA	22
RV2039_libmerged	2109269	2109273		YPO_RS10290	4
RV2039_libmerged	2109434	2109442		YPO_RS10290	8
RV2039_libmerged	2109477	2109481		YPO_RS10290	4
RV2039_libmerged	2109528	2109538		YPO_RS10290	10
RV2039_libmerged	2109696	2109766		YPO_RS10290	70
RV2039_libmerged	2110442	2110462		YPO_RS10300	20
RV2039_libmerged	2110659	2110662		YPO_RS10300	3
RV2039_libmerged	2112376	2112382		uvrY	6
RV2039_libmerged	2113276	2113282		uvrC	6
RV2039_libmerged	2115523	2115537		YPO_RS10340	14
RV2039_libmerged	2115594	2115608		YPO_RS10340	14
RV2039_libmerged	2117368	2117412		YPO_RS10350	44
RV2039_libmerged	2118003	2118046		hcp	43
RV2039_libmerged	2118319	2118347		hcp	28
RV2039_libmerged	2118855	2118859		YPO_RS10365	4
RV2039_libmerged	2119142	2119154		YPO_RS10365	12
RV2039_libmerged	2122159	2122172		YPO_RS10385	13
RV2039_libmerged	2122811	2122824		YPO_RS10395	13
RV2039_libmerged	2123084	2123096		YPO_RS10400	12
RV2039_libmerged	2123466	2123517		YPO_RS10405	51
RV2039_libmerged	2123579	2123597		YPO_RS10405	18
RV2039_libmerged	2123663	2123670		YPO_RS10405	7
RV2039_libmerged	2123725	2123729		YPO_RS10405	4
RV2039_libmerged	2124168	2124203		YPO_RS10405	35
RV2039_libmerged	2126017	2126054		YPO_RS10415	37
RV2039_libmerged	2126167	2126175		YPO_RS10415	8
RV2039_libmerged	2126309	2126316		YPO_RS10415	7
RV2039_libmerged	2126633	2126642		YPO_RS10420	9
RV2039_libmerged	2129964	2129989		YPO_RS10435	25
RV2039_libmerged	2130492	2130525		YPO_RS10440	33
RV2039_libmerged	2130877	2130898		YPO_RS10440	21
RV2039_libmerged	2132546	2132550		YPO_RS10445	4
RV2039_libmerged	2133402	2133403		YPO_RS10450	1
RV2039_libmerged	2134498	2134532		YPO_RS10460	34
RV2039_libmerged	2134642	2134643		YPO_RS10465	1
RV2039_libmerged	2135599	2135700		YPO_RS10475	101
RV2039_libmerged	2135833	2135836		YPO_RS10475	3
RV2039_libmerged	2135909	2135969		YPO_RS10475	60
RV2039_libmerged	2136020	2136057		YPO_RS10475	37
RV2039_libmerged	2136118	2136148		YPO_RS10475	30
RV2039_libmerged	2136450	2136479		YPO_RS10475	29
RV2039_libmerged	2136555	2136567		YPO_RS10475	12
RV2039_libmerged	2136567	2136572		YPO_RS10480	5
RV2039_libmerged	2136674	2136750		YPO_RS10480	76
RV2039_libmerged	2136840	2136862		YPO_RS10480	22
RV2039_libmerged	2136924	2136931		YPO_RS10480	7
RV2039_libmerged	2136967	2136977		YPO_RS10480	10
RV2039_libmerged	2137065	2137132		YPO_RS10480	67
RV2039_libmerged	2137187	2137197		YPO_RS10480	10
RV2039_libmerged	2137228	2137232		YPO_RS10480	4
RV2039_libmerged	2137282	2137305		YPO_RS10480	23
RV2039_libmerged	2139265	2139272		YPO_RS10505	7
RV2039_libmerged	2139384	2139387		YPO_RS10505	3
RV2039_libmerged	2141160	2141162		fyuA	2
RV2039_libmerged	2141983	2142002		fyuA	19
RV2039_libmerged	2148831	2148837		irp1	6
RV2039_libmerged	2150609	2150610		irp1	1
RV2039_libmerged	2151005	2151008		irp1	3
RV2039_libmerged	2156157	2156183		irp2	26
RV2039_libmerged	2158278	2158282		irp2	4
RV2039_libmerged	2160296	2160301		irp2	5
RV2039_libmerged	2161808	2161820		irp2	12
RV2039_libmerged	2163726	2163731		ybtP	5
RV2039_libmerged	2166939	2166941		ybtQ	2
RV2039_libmerged	2167049	2167053		ybtQ	4
RV2039_libmerged	2169086	2169096		ybtS	10
RV2039_libmerged	2169662	2169669		ybtS	7
RV2039_libmerged	2171753	2171759		YPO_RS10580	6
RV2039_libmerged	2172030	2172040		YPO_RS10580	10
RV2039_libmerged	2172456	2172461		YPO_RS10585	5
RV2039_libmerged	2173588	2173609		YPO_RS10585	21
RV2039_libmerged	2173653	2173664		YPO_RS10585	11
RV2039_libmerged	2174778	2174794		YPO_RS10590	16
RV2039_libmerged	2175390	2175391		YPO_RS10590	1
RV2039_libmerged	2175796	2175818		YPO_RS10590	22
RV2039_libmerged	2176764	2176766		YPO_RS10595	2
RV2039_libmerged	2176871	2176895		YPO_RS10595	24
RV2039_libmerged	2177560	2177572		YPO_RS10600	12
RV2039_libmerged	2178416	2178424		YPO_RS10605	8
RV2039_libmerged	2179028	2179054		YPO_RS10605	26
RV2039_libmerged	2179964	2179969		YPO_RS10605	5
RV2039_libmerged	2180462	2180471		YPO_RS10605	9
RV2039_libmerged	2180750	2180768		YPO_RS10610	18
RV2039_libmerged	2180948	2180970		YPO_RS10610	22
RV2039_libmerged	2181288	2181301		YPO_RS10610	13
RV2039_libmerged	2181344	2181354		YPO_RS10610	10
RV2039_libmerged	2182025	2182026		YPO_RS10615	1
RV2039_libmerged	2182595	2182599		YPO_RS10615	4
RV2039_libmerged	2183822	2183823		YPO_RS10620	1
RV2039_libmerged	2185172	2185187		YPO_RS10625	15
RV2039_libmerged	2185645	2185646		YPO_RS10630	1
RV2039_libmerged	2186686	2186694		YPO_RS10635	8
RV2039_libmerged	2187507	2187517		YPO_RS10640	10
RV2039_libmerged	2187681	2187687		YPO_RS10640	6
RV2039_libmerged	2187800	2187816		YPO_RS10645	16
RV2039_libmerged	2187908	2187942		YPO_RS10645	34
RV2039_libmerged	2187986	2187991		YPO_RS10645	5
RV2039_libmerged	2189008	2189013		YPO_RS10650	5
RV2039_libmerged	2189245	2189251		YPO_RS10650	6
RV2039_libmerged	2189520	2189542		YPO_RS10650	22
RV2039_libmerged	2190092	2190109		YPO_RS10655	17
RV2039_libmerged	2190642	2190647		YPO_RS10655	5
RV2039_libmerged	2192371	2192374		nqrE	3
RV2039_libmerged	2192531	2192545		nqrE	14
RV2039_libmerged	2193863	2193904		YPO_RS10670	41
RV2039_libmerged	2194778	2194795		ansP	17
RV2039_libmerged	2197244	2197261		YPO_RS10680	17
RV2039_libmerged	2198102	2198121		YPO_RS10685	19
RV2039_libmerged	2198977	2198980		glsA	3
RV2039_libmerged	2199563	2199569		glsA	6
RV2039_libmerged	2200067	2200068		YPO_RS10695	1
RV2039_libmerged	2202058	2202069		YPO_RS10700	11
RV2039_libmerged	2202102	2202105		YPO_RS10700	3
RV2039_libmerged	2203400	2203407		YPO_RS10700	7
RV2039_libmerged	2204119	2204126		YPO_RS10705	7
RV2039_libmerged	2204377	2204382		YPO_RS10705	5
RV2039_libmerged	2205150	2205166		YPO_RS10710	16
RV2039_libmerged	2205557	2205561		YPO_RS10710	4
RV2039_libmerged	2205806	2205815		YPO_RS10710	9
RV2039_libmerged	2206359	2206365		YPO_RS10715	6
RV2039_libmerged	2206722	2206740		YPO_RS10715	18
RV2039_libmerged	2207633	2207651		YPO_RS10715	18
RV2039_libmerged	2207641	2207659		YPO_RS10720	18
RV2039_libmerged	2208042	2208050		YPO_RS10720	8
RV2039_libmerged	2208994	2208995		YPO_RS10725	1
RV2039_libmerged	2209131	2209141		YPO_RS10725	10
RV2039_libmerged	2209241	2209259		YPO_RS10725	18
RV2039_libmerged	2209751	2209772		YPO_RS10730	21
RV2039_libmerged	2209852	2209866		YPO_RS10730	14
RV2039_libmerged	2211131	2211169		tehB	38
RV2039_libmerged	2213690	2213698		pgaA	8
RV2039_libmerged	2214228	2214230		pgaA	2
RV2039_libmerged	2214471	2214493		pgaA	22
RV2039_libmerged	2215008	2215023		pgaA	15
RV2039_libmerged	2215356	2215379		pgaA	23
RV2039_libmerged	2216622	2216625		pgaB	3
RV2039_libmerged	2216701	2216731		pgaB	30
RV2039_libmerged	2217426	2217433		pgaB	7
RV2039_libmerged	2217922	2217940		YPO_RS10760	18
RV2039_libmerged	2219607	2219614		pgaD	7
RV2039_libmerged	2220463	2220466		YPO_RS10770	3
RV2039_libmerged	2220631	2220634		YPO_RS10770	3
RV2039_libmerged	2221442	2221481		YPO_RS10775	39
RV2039_libmerged	2221523	2221533		YPO_RS10775	10
RV2039_libmerged	2222102	2222103		phoH	1
RV2039_libmerged	2223503	2223508		chaA	5
RV2039_libmerged	2224263	2224266		narX	3
RV2039_libmerged	2224532	2224547		narX	15
RV2039_libmerged	2224587	2224593		narX	6
RV2039_libmerged	2224713	2224734		narX	21
RV2039_libmerged	2225219	2225229		narX	10
RV2039_libmerged	2225844	2225873		narX	29
RV2039_libmerged	2225990	2225991		narX	1
RV2039_libmerged	2226588	2226611		YPO_RS10800	23
RV2039_libmerged	2231248	2231263		astD	15
RV2039_libmerged	2232312	2232350		astB	38
RV2039_libmerged	2233009	2233051		astB	42
RV2039_libmerged	2233240	2233271		astB	31
RV2039_libmerged	2234528	2234553		astE	25
RV2039_libmerged	2236361	2236434		YPO_RS10835	73
RV2039_libmerged	2236488	2236502		YPO_RS10835	14
RV2039_libmerged	2236629	2236644		YPO_RS10835	15
RV2039_libmerged	2236689	2236695		YPO_RS10835	6
RV2039_libmerged	2236788	2236821		YPO_RS10835	33
RV2039_libmerged	2236904	2236963		YPO_RS10835	59
RV2039_libmerged	2237093	2237104		YPO_RS10835	11
RV2039_libmerged	2237317	2237397		YPO_RS10835	80
RV2039_libmerged	2237397	2237398		YPO_RS10840	1
RV2039_libmerged	2237486	2237499		YPO_RS10840	13
RV2039_libmerged	2237720	2237760		YPO_RS10840	40
RV2039_libmerged	2237790	2237814		YPO_RS10840	24
RV2039_libmerged	2238049	2238066		YPO_RS10840	17
RV2039_libmerged	2238726	2238735		hutG	9
RV2039_libmerged	2240172	2240186		YPO_RS10855	14
RV2039_libmerged	2241286	2241288		hutC	2
RV2039_libmerged	2241991	2242009		YPO_RS10865	18
RV2039_libmerged	2242532	2242561		YPO_RS10865	29
RV2039_libmerged	2242778	2242783		YPO_RS10865	5
RV2039_libmerged	2242821	2242834		YPO_RS10865	13
RV2039_libmerged	2243405	2243413		YPO_RS10870	8
RV2039_libmerged	2243460	2243469		YPO_RS10870	9
RV2039_libmerged	2244074	2244084		YPO_RS10875	10
RV2039_libmerged	2244443	2244456		YPO_RS10875	13
RV2039_libmerged	2244771	2244780		YPO_RS10875	9
RV2039_libmerged	2244908	2244922		YPO_RS10875	14
RV2039_libmerged	2245367	2245371		YPO_RS10875	4
RV2039_libmerged	2251648	2251680		YPO_RS10900	32
RV2039_libmerged	2252380	2252389		YPO_RS10905	9
RV2039_libmerged	2254533	2254540		YPO_RS10915	7
RV2039_libmerged	2255145	2255168		YPO_RS10920	23
RV2039_libmerged	2255261	2255270		YPO_RS10920	9
RV2039_libmerged	2255600	2255616		YPO_RS10925	16
RV2039_libmerged	2255686	2255713		YPO_RS10925	27
RV2039_libmerged	2256048	2256059		YPO_RS10925	11
RV2039_libmerged	2256127	2256160		YPO_RS10925	33
RV2039_libmerged	2256272	2256292		YPO_RS10925	20
RV2039_libmerged	2256351	2256374		YPO_RS10925	23
RV2039_libmerged	2256579	2256603		YPO_RS10925	24
RV2039_libmerged	2257057	2257105		YPO_RS10925	48
RV2039_libmerged	2257308	2257313		YPO_RS10930	5
RV2039_libmerged	2257399	2257418		YPO_RS10930	19
RV2039_libmerged	2257450	2257468		YPO_RS10930	18
RV2039_libmerged	2257621	2257624		YPO_RS10930	3
RV2039_libmerged	2257717	2257748		YPO_RS10930	31
RV2039_libmerged	2257805	2257876		YPO_RS10930	71
RV2039_libmerged	2257937	2257961		YPO_RS10930	24
RV2039_libmerged	2258066	2258113		YPO_RS10930	47
RV2039_libmerged	2258482	2258487		YPO_RS10930	5
RV2039_libmerged	2258859	2258868		YPO_RS10935	9
RV2039_libmerged	2259062	2259086		YPO_RS10935	24
RV2039_libmerged	2259313	2259326		YPO_RS10935	13
RV2039_libmerged	2259406	2259415		YPO_RS10935	9
RV2039_libmerged	2259676	2259724		YPO_RS10935	48
RV2039_libmerged	2259804	2259817		YPO_RS10935	13
RV2039_libmerged	2260019	2260034		YPO_RS10935	15
RV2039_libmerged	2260488	2260511		YPO_RS10935	23
RV2039_libmerged	2260691	2260752		YPO_RS10935	61
RV2039_libmerged	2262124	2262168		YPO_RS10940	44
RV2039_libmerged	2262633	2262641		YPO_RS10940	8
RV2039_libmerged	2263409	2263415		YPO_RS10940	6
RV2039_libmerged	2263982	2264002		YPO_RS10945	20
RV2039_libmerged	2264595	2264609		YPO_RS10950	14
RV2039_libmerged	2265151	2265166		YPO_RS10950	15
RV2039_libmerged	2265644	2265647		YPO_RS10955	3
RV2039_libmerged	2265814	2265824		YPO_RS10955	10
RV2039_libmerged	2265876	2265885		YPO_RS10955	9
RV2039_libmerged	2265925	2265945		YPO_RS10955	20
RV2039_libmerged	2266230	2266246		YPO_RS10960	16
RV2039_libmerged	2266623	2266625		YPO_RS10965	2
RV2039_libmerged	2266764	2266838		YPO_RS10965	74
RV2039_libmerged	2266984	2267001		YPO_RS10965	17
RV2039_libmerged	2267171	2267242		YPO_RS10965	71
RV2039_libmerged	2267229	2267244		YPO_RS10970	15
RV2039_libmerged	2267521	2267532		YPO_RS10970	11
RV2039_libmerged	2268011	2268016		YPO_RS10970	5
RV2039_libmerged	2268460	2268473		YPO_RS10975	13
RV2039_libmerged	2268732	2268735		YPO_RS10975	3
RV2039_libmerged	2268791	2268857		YPO_RS10975	66
RV2039_libmerged	2271504	2271514		YPO_RS10985	10
RV2039_libmerged	2273653	2273680		YPO_RS10995	27
RV2039_libmerged	2273953	2273954		YPO_RS11000	1
RV2039_libmerged	2275412	2275429		YPO_RS11005	17
RV2039_libmerged	2275511	2275516		YPO_RS11005	5
RV2039_libmerged	2276205	2276217		YPO_RS11010	12
RV2039_libmerged	2276721	2276727		YPO_RS11015	6
RV2039_libmerged	2277033	2277034		YPO_RS11015	1
RV2039_libmerged	2277192	2277203		YPO_RS11015	11
RV2039_libmerged	2277805	2277812		YPO_RS11020	7
RV2039_libmerged	2278386	2278390		YPO_RS11020	4
RV2039_libmerged	2282172	2282179		ychF	7
RV2039_libmerged	2283597	2283614		pth	17
RV2039_libmerged	2286453	2286454		ispE	1
RV2039_libmerged	2287336	2287354		lolB	18
RV2039_libmerged	2289939	2289951		prfA	12
RV2039_libmerged	2290230	2290245		prfA	15
RV2039_libmerged	2291379	2291386		YPO_RS11090	7
RV2039_libmerged	2291928	2291937		YPO_RS11095	9
RV2039_libmerged	2292514	2292519		kdsA	5
RV2039_libmerged	2292996	2293013		kdsA	17
RV2039_libmerged	2293850	2293881		YPO_RS11105	31
RV2039_libmerged	2294095	2294105		YPO_RS11105	10
RV2039_libmerged	2294229	2294246		YPO_RS11105	17
RV2039_libmerged	2294294	2294308		YPO_RS11105	14
RV2039_libmerged	2294837	2294854		YPO_RS11110	17
RV2039_libmerged	2294931	2294973		YPO_RS11115	42
RV2039_libmerged	2295167	2295228		YPO_RS11115	61
RV2039_libmerged	2295281	2295288		YPO_RS11115	7
RV2039_libmerged	2295357	2295415		YPO_RS11115	58
RV2039_libmerged	2295450	2295479		YPO_RS11115	29
RV2039_libmerged	2295510	2295552		YPO_RS11115	42
RV2039_libmerged	2295753	2295855		YPO_RS11120	102
RV2039_libmerged	2295928	2296015		YPO_RS11120	87
RV2039_libmerged	2296091	2296101		YPO_RS11120	10
RV2039_libmerged	2296207	2296281		YPO_RS11120	74
RV2039_libmerged	2296530	2296562		YPO_RS11120	32
RV2039_libmerged	2296632	2296650		YPO_RS11120	18
RV2039_libmerged	2296711	2296729		YPO_RS11120	18
RV2039_libmerged	2299507	2299536		YPO_RS11135	29
RV2039_libmerged	2300423	2300430		YPO_RS11140	7
RV2039_libmerged	2301184	2301187		YPO_RS11140	3
RV2039_libmerged	2301222	2301232		YPO_RS11140	10
RV2039_libmerged	2301379	2301387		YPO_RS11140	8
RV2039_libmerged	2303636	2303642		YPO_RS11155	6
RV2039_libmerged	2303892	2303926		YPO_RS11155	34
RV2039_libmerged	2304034	2304087		YPO_RS11160	53
RV2039_libmerged	2304123	2304154		YPO_RS11160	31
RV2039_libmerged	2304231	2304256		YPO_RS11160	25
RV2039_libmerged	2304357	2304401		YPO_RS11160	44
RV2039_libmerged	2307737	2307748		YPO_RS11185	11
RV2039_libmerged	2307908	2307919		YPO_RS11185	11
RV2039_libmerged	2308504	2308520		YPO_RS11190	16
RV2039_libmerged	2309741	2309744		YPO_RS11195	3
RV2039_libmerged	2310758	2310780		mdtH	22
RV2039_libmerged	2311015	2311028		mdtH	13
RV2039_libmerged	2311185	2311189		mdtH	4
RV2039_libmerged	2312683	2312690		YPO_RS11210	7
RV2039_libmerged	2312735	2312747		YPO_RS11210	12
RV2039_libmerged	2313247	2313287		YPO_RS11210	40
RV2039_libmerged	2315088	2315092		murJ	4
RV2039_libmerged	2315526	2315534		murJ	8
RV2039_libmerged	2316451	2316458		YPO_RS11220	7
RV2039_libmerged	2316501	2316569		YPO_RS11220	68
RV2039_libmerged	2316626	2316655		YPO_RS11220	29
RV2039_libmerged	2316769	2316775		YPO_RS11220	6
RV2039_libmerged	2316887	2316894		YPO_RS11220	7
RV2039_libmerged	2316986	2317000		YPO_RS11220	14
RV2039_libmerged	2317114	2317119		YPO_RS11220	5
RV2039_libmerged	2317366	2317380		YPO_RS11220	14
RV2039_libmerged	2317499	2317513		YPO_RS11220	14
RV2039_libmerged	2317595	2317597		YPO_RS11220	2
RV2039_libmerged	2317684	2317698		YPO_RS11220	14
RV2039_libmerged	2317732	2317747		YPO_RS11220	15
RV2039_libmerged	2317795	2317797		YPO_RS11220	2
RV2039_libmerged	2317902	2317921		YPO_RS11220	19
RV2039_libmerged	2318079	2318102		YPO_RS11220	23
RV2039_libmerged	2318273	2318278		YPO_RS11225	5
RV2039_libmerged	2318383	2318393		YPO_RS11225	10
RV2039_libmerged	2318853	2318914		YPO_RS11225	61
RV2039_libmerged	2319260	2319267		YPO_RS11225	7
RV2039_libmerged	2319300	2319314		YPO_RS11225	14
RV2039_libmerged	2319492	2319535		YPO_RS11225	43
RV2039_libmerged	2320422	2320423		YPO_RS11225	1
RV2039_libmerged	2320531	2320532		YPO_RS11225	1
RV2039_libmerged	2320569	2320577		YPO_RS11225	8
RV2039_libmerged	2322109	2322172		YPO_RS11225	63
RV2039_libmerged	2322816	2322838		YPO_RS11225	22
RV2039_libmerged	2323258	2323272		argS	14
RV2039_libmerged	2323946	2323954		argS	8
RV2039_libmerged	2324042	2324057		argS	15
RV2039_libmerged	2325732	2325751		YPO_RS11235	19
RV2039_libmerged	2326438	2326471		cutC	33
RV2039_libmerged	2326680	2326683		cutC	3
RV2039_libmerged	2327333	2327356		cmoB	23
RV2039_libmerged	2328544	2328566		cmoA	22
RV2039_libmerged	2330337	2330342		YPO_RS11260	5
RV2039_libmerged	2334153	2334170		YPO_RS11275	17
RV2039_libmerged	2338022	2338032		znuB	10
RV2039_libmerged	2339554	2339565		znuA	11
RV2039_libmerged	2339780	2339795		znuA	15
RV2039_libmerged	2341153	2341166		mepM	13
RV2039_libmerged	2342455	2342456		lpxM	1
RV2039_libmerged	2344778	2344779		YPO_RS11325	1
RV2039_libmerged	2344908	2344923		YPO_RS11325	15
RV2039_libmerged	2344979	2345002		YPO_RS11325	23
RV2039_libmerged	2345102	2345129		YPO_RS11325	27
RV2039_libmerged	2345362	2345396		YPO_RS11325	34
RV2039_libmerged	2346006	2346007		zwf	1
RV2039_libmerged	2347176	2347196		zwf	20
RV2039_libmerged	2349476	2349494		mdtJ	18
RV2039_libmerged	2351338	2351349		YPO_RS11355	11
RV2039_libmerged	2352664	2352688		tsaB	24
RV2039_libmerged	2352956	2352961		tsaB	5
RV2039_libmerged	2353318	2353324		YPO_RS11365	6
RV2039_libmerged	2353728	2353763		YPO_RS11365	35
RV2039_libmerged	2355019	2355030		fadD	11
RV2039_libmerged	2355585	2355601		fadD	16
RV2039_libmerged	2355899	2355900		fadD	1
RV2039_libmerged	2356014	2356059		fadD	45
RV2039_libmerged	2356475	2356496		rnd	21
RV2039_libmerged	2357063	2357078		rnd	15
RV2039_libmerged	2357314	2357315		rnd	1
RV2039_libmerged	2358117	2358118		minD	1
RV2039_libmerged	2358816	2358836		minC	20
RV2039_libmerged	2358886	2358887		minC	1
RV2039_libmerged	2360483	2360487		YPO_RS11400	4
RV2039_libmerged	2360960	2360970		YPO_RS11405	10
RV2039_libmerged	2361351	2361353		YPO_RS11405	2
RV2039_libmerged	2362273	2362322		YPO_RS11410	49
RV2039_libmerged	2363667	2363671		YPO_RS11420	4
RV2039_libmerged	2363748	2363754		YPO_RS11420	6
RV2039_libmerged	2363936	2363943		YPO_RS11420	7
RV2039_libmerged	2364359	2364424		YPO_RS11425	65
RV2039_libmerged	2364607	2364620		YPO_RS11425	13
RV2039_libmerged	2364800	2364835		YPO_RS11425	35
RV2039_libmerged	2364876	2364953		YPO_RS11425	77
RV2039_libmerged	2364985	2365080		YPO_RS11425	95
RV2039_libmerged	2365111	2365126		YPO_RS11425	15
RV2039_libmerged	2365287	2365293		YPO_RS11425	6
RV2039_libmerged	2365427	2365459		YPO_RS11430	32
RV2039_libmerged	2365508	2365558		YPO_RS11430	50
RV2039_libmerged	2365624	2365769		YPO_RS11430	145
RV2039_libmerged	2365844	2365947		YPO_RS11430	103
RV2039_libmerged	2366551	2366553		YPO_RS11435	2
RV2039_libmerged	2368172	2368189		YPO_RS11450	17
RV2039_libmerged	2369033	2369041		YPO_RS11455	8
RV2039_libmerged	2369364	2369381		YPO_RS11465	17
RV2039_libmerged	2369692	2369717		YPO_RS11465	25
RV2039_libmerged	2370546	2370560		YPO_RS11470	14
RV2039_libmerged	2370557	2370567		YPO_RS11475	10
RV2039_libmerged	2370691	2370702		YPO_RS11475	11
RV2039_libmerged	2370800	2370832		YPO_RS11475	32
RV2039_libmerged	2371162	2371191		YPO_RS11480	29
RV2039_libmerged	2373985	2373988		YPO_RS11500	3
RV2039_libmerged	2374074	2374082		YPO_RS11500	8
RV2039_libmerged	2374795	2374798		YPO_RS11505	3
RV2039_libmerged	2375090	2375092		YPO_RS11505	2
RV2039_libmerged	2375096	2375097		YPO_RS11510	1
RV2039_libmerged	2375485	2375488		YPO_RS11510	3
RV2039_libmerged	2375652	2375672		YPO_RS11510	20
RV2039_libmerged	2376219	2376235		YPO_RS11515	16
RV2039_libmerged	2376453	2376495		YPO_RS11515	42
RV2039_libmerged	2376948	2376989		YPO_RS11520	41
RV2039_libmerged	2377323	2377333		YPO_RS11520	10
RV2039_libmerged	2377512	2377525		YPO_RS11520	13
RV2039_libmerged	2377904	2377910		YPO_RS11520	6
RV2039_libmerged	2378022	2378026		YPO_RS11525	4
RV2039_libmerged	2378194	2378203		YPO_RS11525	9
RV2039_libmerged	2378310	2378325		YPO_RS11525	15
RV2039_libmerged	2378458	2378470		YPO_RS11525	12
RV2039_libmerged	2379072	2379079		YPO_RS11530	7
RV2039_libmerged	2379586	2379594		YPO_RS11535	8
RV2039_libmerged	2380157	2380162		YPO_RS11535	5
RV2039_libmerged	2381337	2381362		YPO_RS11545	25
RV2039_libmerged	2382098	2382112		YPO_RS11545	14
RV2039_libmerged	2382748	2382764		YPO_RS11550	16
RV2039_libmerged	2382925	2382947		YPO_RS11550	22
RV2039_libmerged	2383674	2383707		YPO_RS11565	33
RV2039_libmerged	2383836	2383838		YPO_RS11565	2
RV2039_libmerged	2383936	2383944		YPO_RS11565	8
RV2039_libmerged	2384545	2384548		YPO_RS11570	3
RV2039_libmerged	2385362	2385375		YPO_RS11575	13
RV2039_libmerged	2387626	2387643		YPO_RS11590	17
RV2039_libmerged	2390424	2390561		YPO_RS11600	137
RV2039_libmerged	2390746	2390761		YPO_RS11600	15
RV2039_libmerged	2390824	2390882		YPO_RS11600	58
RV2039_libmerged	2391003	2391015		YPO_RS11605	12
RV2039_libmerged	2391449	2391460		YPO_RS11605	11
RV2039_libmerged	2392229	2392247		YPO_RS11610	18
RV2039_libmerged	2393440	2393456		YPO_RS11620	16
RV2039_libmerged	2393594	2393608		YPO_RS11620	14
RV2039_libmerged	2394494	2394509		YPO_RS11630	15
RV2039_libmerged	2394725	2394758		YPO_RS11630	33
RV2039_libmerged	2394897	2394906		YPO_RS11630	9
RV2039_libmerged	2395482	2395496		YPO_RS11635	14
RV2039_libmerged	2395787	2395789		YPO_RS11635	2
RV2039_libmerged	2396172	2396173		YPO_RS11640	1
RV2039_libmerged	2396770	2396782		YPO_RS11645	12
RV2039_libmerged	2397187	2397188		YPO_RS11655	1
RV2039_libmerged	2397288	2397295		YPO_RS11655	7
RV2039_libmerged	2397499	2397507		YPO_RS11660	8
RV2039_libmerged	2397818	2397819		YPO_RS11660	1
RV2039_libmerged	2398340	2398353		YPO_RS11660	13
RV2039_libmerged	2398612	2398639		YPO_RS11660	27
RV2039_libmerged	2399128	2399134		YPO_RS11660	6
RV2039_libmerged	2399390	2399394		YPO_RS11660	4
RV2039_libmerged	2399846	2399850		YPO_RS11660	4
RV2039_libmerged	2400170	2400195		YPO_RS11660	25
RV2039_libmerged	2400316	2400323		YPO_RS11660	7
RV2039_libmerged	2400588	2400589		YPO_RS11660	1
RV2039_libmerged	2401639	2401650		YPO_RS11665	11
RV2039_libmerged	2402284	2402296		YPO_RS11670	12
RV2039_libmerged	2402696	2402746		YPO_RS11675	50
RV2039_libmerged	2403046	2403058		YPO_RS11675	12
RV2039_libmerged	2403372	2403383		YPO_RS11680	11
RV2039_libmerged	2403486	2403505		YPO_RS11680	19
RV2039_libmerged	2403691	2403792		YPO_RS11680	101
RV2039_libmerged	2403837	2403862		YPO_RS11680	25
RV2039_libmerged	2403925	2403958		YPO_RS11680	33
RV2039_libmerged	2403988	2404019		YPO_RS11680	31
RV2039_libmerged	2404112	2404119		YPO_RS11680	7
RV2039_libmerged	2405043	2405045		YPO_RS11685	2
RV2039_libmerged	2406139	2406154		YPO_RS11690	15
RV2039_libmerged	2407487	2407498		YPO_RS11695	11
RV2039_libmerged	2411012	2411019		nhaB	7
RV2039_libmerged	2411222	2411229		nhaB	7
RV2039_libmerged	2411625	2411656		nhaB	31
RV2039_libmerged	2412032	2412034		nhaB	2
RV2039_libmerged	2413972	2413976		YPO_RS11720	4
RV2039_libmerged	2414467	2414476		YPO_RS11720	9
RV2039_libmerged	2414776	2414779		YPO_RS11720	3
RV2039_libmerged	2416585	2416616		YPO_RS11725	31
RV2039_libmerged	2416731	2416735		YPO_RS11730	4
RV2039_libmerged	2417807	2417814		YPO_RS11730	7
RV2039_libmerged	2418850	2418857		YPO_RS11735	7
RV2039_libmerged	2419847	2419858		YPO_RS11740	11
RV2039_libmerged	2420909	2420910		YPO_RS11745	1
RV2039_libmerged	2421336	2421337		YPO_RS11750	1
RV2039_libmerged	2422438	2422450		YPO_RS11750	12
RV2039_libmerged	2422781	2422790		yeaG	9
RV2039_libmerged	2423503	2423517		yeaG	14
RV2039_libmerged	2426671	2426672		YPO_RS11765	1
RV2039_libmerged	2427929	2427942		gapA	13
RV2039_libmerged	2428722	2428731		msrB	9
RV2039_libmerged	2429007	2429010		YPO_RS11780	3
RV2039_libmerged	2429570	2429596		pncA	26
RV2039_libmerged	2430890	2430896		ansA	6
RV2039_libmerged	2431248	2431250		sppA	2
RV2039_libmerged	2431836	2431838		sppA	2
RV2039_libmerged	2432401	2432402		sppA	1
RV2039_libmerged	2432500	2432509		sppA	9
RV2039_libmerged	2432829	2432833		sppA	4
RV2039_libmerged	2434441	2434448		selD	7
RV2039_libmerged	2435310	2435321		YPO_RS11810	11
RV2039_libmerged	2436855	2436867		YPO_RS11810	12
RV2039_libmerged	2437092	2437114		YPO_RS11815	22
RV2039_libmerged	2437833	2437864		xthA	31
RV2039_libmerged	2438135	2438153		xthA	18
RV2039_libmerged	2438453	2438455		xthA	2
RV2039_libmerged	2439687	2439697		YPO_RS11830	10
RV2039_libmerged	2439918	2439946		YPO_RS11830	28
RV2039_libmerged	2440120	2440149		YPO_RS11830	29
RV2039_libmerged	2441131	2441135		YPO_RS11850	4
RV2039_libmerged	2441221	2441228		YPO_RS11850	7
RV2039_libmerged	2441437	2441500		YPO_RS11850	63
RV2039_libmerged	2441600	2441683		YPO_RS11850	83
RV2039_libmerged	2441767	2441775		YPO_RS11850	8
RV2039_libmerged	2441899	2441905		YPO_RS11850	6
RV2039_libmerged	2442087	2442111		YPO_RS11850	24
RV2039_libmerged	2442207	2442209		YPO_RS11850	2
RV2039_libmerged	2442360	2442386		purU	26
RV2039_libmerged	2442675	2442702		purU	27
RV2039_libmerged	2443328	2443349		YPO_RS11860	21
RV2039_libmerged	2445476	2445486		rssB	10
RV2039_libmerged	2445580	2445615		rssB	35
RV2039_libmerged	2445774	2445776		rssB	2
RV2039_libmerged	2445827	2445858		rssB	31
RV2039_libmerged	2446045	2446057		rssB	12
RV2039_libmerged	2446717	2446741		YPO_RS11870	24
RV2039_libmerged	2446895	2446912		YPO_RS11870	17
RV2039_libmerged	2446972	2446983		YPO_RS11870	11
RV2039_libmerged	2447537	2447560		YPO_RS11870	23
RV2039_libmerged	2447643	2447660		YPO_RS11870	17
RV2039_libmerged	2448276	2448307		hns	31
RV2039_libmerged	2450264	2450293		YPO_RS11885	29
RV2039_libmerged	2450345	2450369		YPO_RS11885	24
RV2039_libmerged	2450421	2450442		YPO_RS11885	21
RV2039_libmerged	2450550	2450613		YPO_RS11885	63
RV2039_libmerged	2450714	2450798		YPO_RS11885	84
RV2039_libmerged	2450879	2450942		YPO_RS11885	63
RV2039_libmerged	2451065	2451096		YPO_RS11890	31
RV2039_libmerged	2451458	2451540		YPO_RS11890	82
RV2039_libmerged	2451841	2451867		YPO_RS11890	26
RV2039_libmerged	2452707	2452745		adhE	38
RV2039_libmerged	2453492	2453501		adhE	9
RV2039_libmerged	2454157	2454164		adhE	7
RV2039_libmerged	2454714	2454748		adhE	34
RV2039_libmerged	2455095	2455105		adhE	10
RV2039_libmerged	2456697	2456708		YPO_RS11900	11
RV2039_libmerged	2457579	2457582		oppA	3
RV2039_libmerged	2458238	2458244		oppA	6
RV2039_libmerged	2458379	2458385		oppA	6
RV2039_libmerged	2458461	2458513		oppA	52
RV2039_libmerged	2458747	2458766		oppA	19
RV2039_libmerged	2458962	2458984		oppA	22
RV2039_libmerged	2460763	2460788		oppC	25
RV2039_libmerged	2461179	2461181		YPO_RS11920	2
RV2039_libmerged	2461393	2461401		YPO_RS11920	8
RV2039_libmerged	2461742	2461800		YPO_RS11920	58
RV2039_libmerged	2462606	2462632		YPO_RS11925	26
RV2039_libmerged	2462731	2462735		YPO_RS11925	4
RV2039_libmerged	2462921	2462924		YPO_RS11925	3
RV2039_libmerged	2463060	2463066		YPO_RS11925	6
RV2039_libmerged	2463709	2463710		YPO_RS11930	1
RV2039_libmerged	2463770	2463791		YPO_RS11930	21
RV2039_libmerged	2464839	2464843		cls	4
RV2039_libmerged	2465125	2465129		cls	4
RV2039_libmerged	2465172	2465173		cls	1
RV2039_libmerged	2465474	2465478		cls	4
RV2039_libmerged	2465542	2465575		cls	33
RV2039_libmerged	2465787	2465806		cls	19
RV2039_libmerged	2467219	2467225		YPO_RS11950	6
RV2039_libmerged	2467971	2467976		YPO_RS11955	5
RV2039_libmerged	2468350	2468353		YPO_RS11960	3
RV2039_libmerged	2468856	2468868		YPO_RS11965	12
RV2039_libmerged	2469979	2470021		tonB	42
RV2039_libmerged	2470387	2470404		YPO_RS11975	17
RV2039_libmerged	2470646	2470649		YPO_RS11975	3
RV2039_libmerged	2470918	2470982		YPO_RS11975	64
RV2039_libmerged	2471257	2471304		YPO_RS11975	47
RV2039_libmerged	2471392	2471417		YPO_RS11975	25
RV2039_libmerged	2472151	2472164		YPO_RS11985	13
RV2039_libmerged	2473709	2473721		YPO_RS11990	12
RV2039_libmerged	2474186	2474188		YPO_RS11995	2
RV2039_libmerged	2474309	2474328		YPO_RS11995	19
RV2039_libmerged	2474814	2474826		YPO_RS12000	12
RV2039_libmerged	2474863	2474901		YPO_RS12000	38
RV2039_libmerged	2474987	2475004		YPO_RS12000	17
RV2039_libmerged	2475056	2475080		YPO_RS12000	24
RV2039_libmerged	2475459	2475470		YPO_RS12000	11
RV2039_libmerged	2475770	2475789		YPO_RS12005	19
RV2039_libmerged	2475852	2475869		YPO_RS12005	17
RV2039_libmerged	2476464	2476466		ompW	2
RV2039_libmerged	2476760	2476769		YPO_RS12015	9
RV2039_libmerged	2478883	2478891		trpB	8
RV2039_libmerged	2479777	2479791		trpCF	14
RV2039_libmerged	2480935	2480950		trpCF	15
RV2039_libmerged	2483744	2483749		YPO_RS12045	5
RV2039_libmerged	2483798	2483817		YPO_RS12045	19
RV2039_libmerged	2484135	2484154		YPO_RS12045	19
RV2039_libmerged	2485758	2485762		YPO_RS12060	4
RV2039_libmerged	2486726	2486733		rluB	7
RV2039_libmerged	2487284	2487288		rluB	4
RV2039_libmerged	2487865	2487866		cobO	1
RV2039_libmerged	2487943	2487952		cobO	9
RV2039_libmerged	2488975	2489001		YPO_RS12075	26
RV2039_libmerged	2489328	2489337		sohB	9
RV2039_libmerged	2490575	2490605		YPO_RS12085	30
RV2039_libmerged	2492077	2492089		topA	12
RV2039_libmerged	2492540	2492552		topA	12
RV2039_libmerged	2494320	2494348		cysB	28
RV2039_libmerged	2494963	2495008		cysB	45
RV2039_libmerged	2495346	2495376		YPO_RS12105	30
RV2039_libmerged	2495534	2495544		YPO_RS12105	10
RV2039_libmerged	2495625	2495630		YPO_RS12105	5
RV2039_libmerged	2495866	2495932		YPO_RS12105	66
RV2039_libmerged	2496025	2496043		YPO_RS12105	18
RV2039_libmerged	2498690	2498695		acnA	5
RV2039_libmerged	2498792	2498800		acnA	8
RV2039_libmerged	2500506	2500538		pgpB	32
RV2039_libmerged	2501064	2501132		pgpB	68
RV2039_libmerged	2502120	2502125		lapB	5
RV2039_libmerged	2502536	2502540		lapB	4
RV2039_libmerged	2502776	2502785		lapB	9
RV2039_libmerged	2504683	2504692		yciH	9
RV2039_libmerged	2506427	2506435		araD	8
RV2039_libmerged	2507536	2507559		fsa	23
RV2039_libmerged	2507995	2507997		YPO_RS12170	2
RV2039_libmerged	2508401	2508414		YPO_RS12175	13
RV2039_libmerged	2508853	2508885		YPO_RS12175	32
RV2039_libmerged	2509642	2509650		YPO_RS12175	8
RV2039_libmerged	2510874	2510879		YPO_RS12180	5
RV2039_libmerged	2513512	2513523		YPO_RS12185	11
RV2039_libmerged	2514032	2514033		YPO_RS12185	1
RV2039_libmerged	2514609	2514624		YPO_RS12190	15
RV2039_libmerged	2514880	2514890		YPO_RS12190	10
RV2039_libmerged	2516153	2516161		nth	8
RV2039_libmerged	2517225	2517278		rsxG	53
RV2039_libmerged	2517475	2517491		rsxG	16
RV2039_libmerged	2517681	2517682		rsxG	1
RV2039_libmerged	2517692	2517736		rsxD	44
RV2039_libmerged	2518480	2518502		rsxD	22
RV2039_libmerged	2519275	2519302		YPO_RS12215	27
RV2039_libmerged	2520863	2520864		rsxC	1
RV2039_libmerged	2521555	2521575		rsxC	20
RV2039_libmerged	2521881	2521890		rsxC	9
RV2039_libmerged	2522201	2522205		rsxB	4
RV2039_libmerged	2522260	2522261		rsxB	1
RV2039_libmerged	2522309	2522312		rsxB	3
RV2039_libmerged	2522432	2522444		rsxB	12
RV2039_libmerged	2522728	2522729		rsxB	1
RV2039_libmerged	2522986	2523020		rsxA	34
RV2039_libmerged	2523103	2523113		rsxA	10
RV2039_libmerged	2523632	2523636		YPO_RS12235	4
RV2039_libmerged	2527122	2527123		YPO_RS12245	1
RV2039_libmerged	2529098	2529115		YPO_RS12255	17
RV2039_libmerged	2530264	2530276		araA	12
RV2039_libmerged	2531218	2531226		araA	8
RV2039_libmerged	2531569	2531605		araA	36
RV2039_libmerged	2531651	2531662		araA	11
RV2039_libmerged	2532032	2532048		YPO_RS12265	16
RV2039_libmerged	2532733	2532734		YPO_RS12265	1
RV2039_libmerged	2532869	2532879		YPO_RS12265	10
RV2039_libmerged	2533896	2533898		YPO_RS12270	2
RV2039_libmerged	2534115	2534120		YPO_RS12270	5
RV2039_libmerged	2534728	2534729		YPO_RS12270	1
RV2039_libmerged	2535145	2535159		YPO_RS12275	14
RV2039_libmerged	2535693	2535699		YPO_RS12275	6
RV2039_libmerged	2535883	2535888		YPO_RS12275	5
RV2039_libmerged	2536298	2536324		YPO_RS12275	26
RV2039_libmerged	2536426	2536442		YPO_RS12275	16
RV2039_libmerged	2536889	2536891		YPO_RS12280	2
RV2039_libmerged	2537484	2537497		YPO_RS12280	13
RV2039_libmerged	2538150	2538153		araC	3
RV2039_libmerged	2538196	2538199		araC	3
RV2039_libmerged	2538466	2538507		araC	41
RV2039_libmerged	2538857	2538864		YPO_RS12290	7
RV2039_libmerged	2539863	2539864		YPO_RS12290	1
RV2039_libmerged	2540114	2540170		YPO_RS12295	56
RV2039_libmerged	2540343	2540355		YPO_RS12295	12
RV2039_libmerged	2541334	2541375		YPO_RS12300	41
RV2039_libmerged	2541852	2541858		YPO_RS12300	6
RV2039_libmerged	2542439	2542464		YPO_RS12305	25
RV2039_libmerged	2542578	2542597		YPO_RS12305	19
RV2039_libmerged	2542782	2542792		YPO_RS12305	10
RV2039_libmerged	2543039	2543052		YPO_RS12305	13
RV2039_libmerged	2543998	2544000		manA	2
RV2039_libmerged	2545267	2545282		fumC	15
RV2039_libmerged	2546232	2546247		fumC	15
RV2039_libmerged	2548266	2548280		YPO_RS12325	14
RV2039_libmerged	2548349	2548367		YPO_RS12325	18
RV2039_libmerged	2548582	2548629		YPO_RS12325	47
RV2039_libmerged	2548853	2548862		YPO_RS12325	9
RV2039_libmerged	2549134	2549140		YPO_RS12325	6
RV2039_libmerged	2549513	2549515		YPO_RS12330	2
RV2039_libmerged	2549742	2549756		YPO_RS12335	14
RV2039_libmerged	2549842	2549863		YPO_RS12335	21
RV2039_libmerged	2550198	2550199		YPO_RS12335	1
RV2039_libmerged	2550467	2550468		YPO_RS12340	1
RV2039_libmerged	2550507	2550510		YPO_RS12340	3
RV2039_libmerged	2550929	2550931		YPO_RS12340	2
RV2039_libmerged	2551320	2551330		YPO_RS12340	10
RV2039_libmerged	2552301	2552306		bioD	5
RV2039_libmerged	2552354	2552361		bioD	7
RV2039_libmerged	2553976	2553983		clcB	7
RV2039_libmerged	2554373	2554633		YPO_RS12355	260
RV2039_libmerged	2554658	2555065		YPO_RS12360	407
RV2039_libmerged	2555162	2555608		YPO_RS12365	446
RV2039_libmerged	2555780	2556832		YPO_RS12370	1052
RV2039_libmerged	2556844	2557161		YPO_RS12375	317
RV2039_libmerged	2557164	2557415		YPO_RS12380	251
RV2039_libmerged	2557451	2557684		YPO_RS12385	233
RV2039_libmerged	2557749	2559461		YPO_RS12390	1712
RV2039_libmerged	2559474	2559761		YPO_RS12395	287
RV2039_libmerged	2559765	2560790		YPO_RS12400	1025
RV2039_libmerged	2560790	2562034		YPO_RS12405	1244
RV2039_libmerged	2562123	2562371		YPO_RS12410	248
RV2039_libmerged	2562568	2562765		YPO_RS12415	197
RV2039_libmerged	2563494	2563496		YPO_RS12420	2
RV2039_libmerged	2565877	2565904		YPO_RS12435	27
RV2039_libmerged	2566006	2566012		YPO_RS12435	6
RV2039_libmerged	2566197	2566205		YPO_RS12435	8
RV2039_libmerged	2566342	2566350		YPO_RS12435	8
RV2039_libmerged	2566817	2566830		YPO_RS12435	13
RV2039_libmerged	2568433	2568455		YPO_RS12445	22
RV2039_libmerged	2569202	2569206		YPO_RS12445	4
RV2039_libmerged	2571203	2571234		YPO_RS12450	31
RV2039_libmerged	2571239	2571274		YPO_RS12455	35
RV2039_libmerged	2571354	2571360		YPO_RS12455	6
RV2039_libmerged	2571408	2571413		YPO_RS12455	5
RV2039_libmerged	2572480	2572481		YPO_RS12455	1
RV2039_libmerged	2572793	2572800		YPO_RS12455	7
RV2039_libmerged	2573725	2573727		YPO_RS12455	2
RV2039_libmerged	2574199	2574214		YPO_RS12455	15
RV2039_libmerged	2574669	2574719		YPO_RS12460	50
RV2039_libmerged	2575519	2575530		YPO_RS12460	11
RV2039_libmerged	2575951	2575956		YPO_RS12460	5
RV2039_libmerged	2576183	2576208		YPO_RS12460	25
RV2039_libmerged	2576624	2576630		YPO_RS12460	6
RV2039_libmerged	2576690	2576725		YPO_RS12460	35
RV2039_libmerged	2577182	2577248		YPO_RS12465	66
RV2039_libmerged	2577347	2577351		YPO_RS12465	4
RV2039_libmerged	2577415	2577456		YPO_RS12465	41
RV2039_libmerged	2577763	2577810		YPO_RS12465	47
RV2039_libmerged	2578435	2578441		ilvB	6
RV2039_libmerged	2580520	2580521		yjjG	1
RV2039_libmerged	2580592	2580593		yjjG	1
RV2039_libmerged	2580920	2580945		yjjG	25
RV2039_libmerged	2580987	2580991		yjjG	4
RV2039_libmerged	2581089	2581110		yjjG	21
RV2039_libmerged	2581610	2581612		YPO_RS12490	2
RV2039_libmerged	2583195	2583204		YPO_RS12495	9
RV2039_libmerged	2583319	2583338		YPO_RS12495	19
RV2039_libmerged	2585582	2585583		phoA	1
RV2039_libmerged	2585981	2586014		ogt	33
RV2039_libmerged	2586677	2586684		YPO_RS12510	7
RV2039_libmerged	2587166	2587172		YPO_RS12510	6
RV2039_libmerged	2587595	2587606		uspE	11
RV2039_libmerged	2587941	2587943		uspE	2
RV2039_libmerged	2588185	2588201		uspE	16
RV2039_libmerged	2588274	2588275		uspE	1
RV2039_libmerged	2588849	2588857		pntB	8
RV2039_libmerged	2589778	2589803		pntB	25
RV2039_libmerged	2590255	2590279		pntA	24
RV2039_libmerged	2591389	2591395		pntA	6
RV2039_libmerged	2593925	2593934		YPO_RS12535	9
RV2039_libmerged	2594254	2594266		YPO_RS12535	12
RV2039_libmerged	2595716	2595720		rstA	4
RV2039_libmerged	2596225	2596236		rstB	11
RV2039_libmerged	2597403	2597408		rstB	5
RV2039_libmerged	2597624	2597625		YPO_RS12555	1
RV2039_libmerged	2598103	2598109		YPO_RS12555	6
RV2039_libmerged	2598158	2598171		YPO_RS12555	13
RV2039_libmerged	2598253	2598255		YPO_RS12555	2
RV2039_libmerged	2598973	2598990		YPO_RS12555	17
RV2039_libmerged	2599031	2599048		YPO_RS12555	17
RV2039_libmerged	2599248	2599257		YPO_RS12560	9
RV2039_libmerged	2599300	2599352		YPO_RS12560	52
RV2039_libmerged	2599399	2599464		YPO_RS12560	65
RV2039_libmerged	2599541	2599571		YPO_RS12560	30
RV2039_libmerged	2599663	2599675		YPO_RS12560	12
RV2039_libmerged	2604643	2604669		YPO_RS12575	26
RV2039_libmerged	2604826	2604834		YPO_RS12575	8
RV2039_libmerged	2606263	2606266		asr	3
RV2039_libmerged	2607166	2607170		YPO_RS12590	4
RV2039_libmerged	2607431	2607444		YPO_RS12590	13
RV2039_libmerged	2607511	2607515		YPO_RS12590	4
RV2039_libmerged	2607611	2607617		YPO_RS12590	6
RV2039_libmerged	2607727	2607731		YPO_RS12595	4
RV2039_libmerged	2607809	2607811		YPO_RS12595	2
RV2039_libmerged	2609948	2609961		hrpA	13
RV2039_libmerged	2610049	2610053		hrpA	4
RV2039_libmerged	2611212	2611221		hrpA	9
RV2039_libmerged	2614052	2614062		YPO_RS12615	10
RV2039_libmerged	2616121	2616122		YPO_RS12620	1
RV2039_libmerged	2616969	2617009		YPO_RS12630	40
RV2039_libmerged	2617273	2617287		YPO_RS12635	14
RV2039_libmerged	2618024	2618027		YPO_RS12635	3
RV2039_libmerged	2618923	2618945		YPO_RS12635	22
RV2039_libmerged	2619123	2619134		YPO_RS12635	11
RV2039_libmerged	2619538	2619557		YPO_RS12635	19
RV2039_libmerged	2620595	2620606		YPO_RS12640	11
RV2039_libmerged	2621536	2621540		hslJ	4
RV2039_libmerged	2621876	2621877		YPO_RS12650	1
RV2039_libmerged	2622335	2622343		YPO_RS12655	8
RV2039_libmerged	2622488	2622490		YPO_RS12655	2
RV2039_libmerged	2624461	2624463		nifJ	2
RV2039_libmerged	2624776	2624778		nifJ	2
RV2039_libmerged	2625250	2625256		nifJ	6
RV2039_libmerged	2625292	2625313		nifJ	21
RV2039_libmerged	2626338	2626358		nifJ	20
RV2039_libmerged	2626765	2626780		nifJ	15
RV2039_libmerged	2627894	2627913		ttcA	19
RV2039_libmerged	2629571	2629577		YPO_RS12675	6
RV2039_libmerged	2630519	2630524		YPO_RS12680	5
RV2039_libmerged	2630872	2630875		YPO_RS12680	3
RV2039_libmerged	2631497	2631516		zntB	19
RV2039_libmerged	2631838	2631851		zntB	13
RV2039_libmerged	2632546	2632548		YPO_RS12690	2
RV2039_libmerged	2632977	2633035		YPO_RS12690	58
RV2039_libmerged	2633330	2633380		YPO_RS12690	50
RV2039_libmerged	2635040	2635044		mpaA	4
RV2039_libmerged	2635658	2635690		ycjG	32
RV2039_libmerged	2637319	2637348		YPO_RS12710	29
RV2039_libmerged	2637568	2637685		YPO_RS12710	117
RV2039_libmerged	2639232	2639235		tyrR	3
RV2039_libmerged	2639902	2639934		YPO_RS12720	32
RV2039_libmerged	2640270	2640279		YPO_RS12725	9
RV2039_libmerged	2640397	2640405		YPO_RS12725	8
RV2039_libmerged	2640743	2640745		YPO_RS12730	2
RV2039_libmerged	2642151	2642158		YPO_RS12735	7
RV2039_libmerged	2642930	2642980		YPO_RS12735	50
RV2039_libmerged	2644837	2644859		pspA	22
RV2039_libmerged	2645498	2645502		pspF	4
RV2039_libmerged	2646374	2646380		YPO_RS12765	6
RV2039_libmerged	2646420	2646518		YPO_RS12765	98
RV2039_libmerged	2646567	2646582		YPO_RS12765	15
RV2039_libmerged	2646622	2646643		YPO_RS12765	21
RV2039_libmerged	2646720	2646724		YPO_RS12765	4
RV2039_libmerged	2646787	2646809		YPO_RS12765	22
RV2039_libmerged	2649180	2649194		sapB	14
RV2039_libmerged	2649230	2649243		sapB	13
RV2039_libmerged	2655307	2655315		dtpA	8
RV2039_libmerged	2655471	2655472		dtpA	1
RV2039_libmerged	2655537	2655545		dtpA	8
RV2039_libmerged	2655755	2655762		dtpA	7
RV2039_libmerged	2657297	2657299		YPO_RS12805	2
RV2039_libmerged	2658241	2658282		YPO_RS12815	41
RV2039_libmerged	2658330	2658393		YPO_RS12815	63
RV2039_libmerged	2658526	2658588		YPO_RS12815	62
RV2039_libmerged	2658853	2658871		YPO_RS12815	18
RV2039_libmerged	2658871	2658885		YPO_RS12820	14
RV2039_libmerged	2658985	2659040		YPO_RS12820	55
RV2039_libmerged	2659150	2659157		YPO_RS12820	7
RV2039_libmerged	2659291	2659296		YPO_RS12820	5
RV2039_libmerged	2659493	2659511		YPO_RS12820	18
RV2039_libmerged	2659584	2659617		YPO_RS12820	33
RV2039_libmerged	2659663	2659781		YPO_RS12820	118
RV2039_libmerged	2661947	2661949		tyrS	2
RV2039_libmerged	2664697	2664710		anmK	13
RV2039_libmerged	2664883	2664889		anmK	6
RV2039_libmerged	2665077	2665084		anmK	7
RV2039_libmerged	2666063	2666064		YPO_RS12855	1
RV2039_libmerged	2666685	2666693		rovA	8
RV2039_libmerged	2666778	2666784		rovA	6
RV2039_libmerged	2666899	2666911		rovA	12
RV2039_libmerged	2670031	2670038		eptA	7
RV2039_libmerged	2670899	2670902		eptA	3
RV2039_libmerged	2671443	2671461		YPO_RS12880	18
RV2039_libmerged	2671786	2671793		YPO_RS12880	7
RV2039_libmerged	2672813	2672815		YPO_RS12885	2
RV2039_libmerged	2673455	2673484		YPO_RS12890	29
RV2039_libmerged	2673649	2673655		YPO_RS12890	6
RV2039_libmerged	2673695	2673700		YPO_RS12890	5
RV2039_libmerged	2673947	2673977		YPO_RS12890	30
RV2039_libmerged	2674569	2674573		YPO_RS12890	4
RV2039_libmerged	2674936	2674942		YPO_RS12890	6
RV2039_libmerged	2675281	2675282		YPO_RS12890	1
RV2039_libmerged	2676638	2676644		gloA	6
RV2039_libmerged	2677709	2677711		YPO_RS12905	2
RV2039_libmerged	2678729	2678731		YPO_RS12915	2
RV2039_libmerged	2678849	2678883		YPO_RS12915	34
RV2039_libmerged	2679272	2679305		YPO_RS12915	33
RV2039_libmerged	2681988	2682001		purR	13
RV2039_libmerged	2682366	2682379		YPO_RS12935	13
RV2039_libmerged	2683648	2683664		YPO_RS12940	16
RV2039_libmerged	2686177	2686204		cfa	27
RV2039_libmerged	2686367	2686382		YPO_RS12950	15
RV2039_libmerged	2687022	2687039		YPO_RS12955	17
RV2039_libmerged	2687142	2687147		YPO_RS12955	5
RV2039_libmerged	2687490	2687502		YPO_RS12960	12
RV2039_libmerged	2688204	2688210		YPO_RS12960	6
RV2039_libmerged	2690270	2690285		pykF	15
RV2039_libmerged	2690389	2690390		pykF	1
RV2039_libmerged	2691956	2691967		YPO_RS12985	11
RV2039_libmerged	2692029	2692072		YPO_RS12985	43
RV2039_libmerged	2692156	2692182		YPO_RS12985	26
RV2039_libmerged	2692781	2692801		YPO_RS12990	20
RV2039_libmerged	2692876	2692879		YPO_RS12990	3
RV2039_libmerged	2693033	2693084		YPO_RS12990	51
RV2039_libmerged	2693216	2693263		YPO_RS12990	47
RV2039_libmerged	2693411	2693421		YPO_RS12990	10
RV2039_libmerged	2693478	2693504		YPO_RS12990	26
RV2039_libmerged	2693655	2693674		YPO_RS12990	19
RV2039_libmerged	2693729	2693761		YPO_RS12990	32
RV2039_libmerged	2693808	2693837		YPO_RS12995	29
RV2039_libmerged	2693930	2693956		YPO_RS12995	26
RV2039_libmerged	2694064	2694196		YPO_RS12995	132
RV2039_libmerged	2694306	2694319		YPO_RS12995	13
RV2039_libmerged	2694410	2694430		YPO_RS12995	20
RV2039_libmerged	2694473	2694488		YPO_RS12995	15
RV2039_libmerged	2694543	2694565		YPO_RS12995	22
RV2039_libmerged	2694628	2694639		YPO_RS13000	11
RV2039_libmerged	2694890	2694903		YPO_RS13000	13
RV2039_libmerged	2696861	2696868		sufS	7
RV2039_libmerged	2697282	2697291		sufS	9
RV2039_libmerged	2698457	2698466		sufD	9
RV2039_libmerged	2699067	2699069		sufC	2
RV2039_libmerged	2699623	2699637		sufC	14
RV2039_libmerged	2701134	2701137		sufB	3
RV2039_libmerged	2703797	2703811		YPO_RS13040	14
RV2039_libmerged	2704471	2704475		YPO_RS13040	4
RV2039_libmerged	2704568	2704582		YPO_RS13040	14
RV2039_libmerged	2706601	2706610		ydiK	9
RV2039_libmerged	2707366	2707380		ydiK	14
RV2039_libmerged	2709597	2709598		ppsA	1
RV2039_libmerged	2710198	2710206		ppsA	8
RV2039_libmerged	2710317	2710324		ppsA	7
RV2039_libmerged	2711007	2711014		YPO_RS13060	7
RV2039_libmerged	2712336	2712341		YPO_RS13065	5
RV2039_libmerged	2715123	2715133		YPO_RS13075	10
RV2039_libmerged	2715318	2715330		YPO_RS13075	12
RV2039_libmerged	2715481	2715491		YPO_RS13075	10
RV2039_libmerged	2715949	2715954		YPO_RS13080	5
RV2039_libmerged	2716966	2716968		arnF	2
RV2039_libmerged	2716966	2717001		arnE	35
RV2039_libmerged	2717696	2717713		arnT	17
RV2039_libmerged	2718175	2718188		arnT	13
RV2039_libmerged	2719448	2719505		YPO_RS13105	57
RV2039_libmerged	2719636	2719637		YPO_RS13105	1
RV2039_libmerged	2720170	2720173		arnA	3
RV2039_libmerged	2720480	2720482		arnA	2
RV2039_libmerged	2721973	2721994		arnC	21
RV2039_libmerged	2722172	2722187		arnC	15
RV2039_libmerged	2722494	2722495		arnC	1
RV2039_libmerged	2722805	2722827		arnC	22
RV2039_libmerged	2722872	2722889		arnB	17
RV2039_libmerged	2724343	2724372		btuD	29
RV2039_libmerged	2724877	2724886		btuD	9
RV2039_libmerged	2725095	2725100		btuD	5
RV2039_libmerged	2725642	2725680		YPO_RS13130	38
RV2039_libmerged	2725757	2725758		btuC	1
RV2039_libmerged	2726433	2726439		btuC	6
RV2039_libmerged	2726655	2726665		btuC	10
RV2039_libmerged	2727065	2727072		YPO_RS13140	7
RV2039_libmerged	2727381	2727390		YPO_RS13140	9
RV2039_libmerged	2728005	2728018		ihfA	13
RV2039_libmerged	2728215	2728219		pheT	4
RV2039_libmerged	2728474	2728479		pheT	5
RV2039_libmerged	2729405	2729414		pheT	9
RV2039_libmerged	2729788	2729789		pheT	1
RV2039_libmerged	2729880	2729918		pheT	38
RV2039_libmerged	2730041	2730081		pheT	40
RV2039_libmerged	2730569	2730576		pheS	7
RV2039_libmerged	2730610	2730628		pheS	18
RV2039_libmerged	2731107	2731124		pheS	17
RV2039_libmerged	2732904	2732918		infC	14
RV2039_libmerged	2733849	2733851		thrS	2
RV2039_libmerged	2735068	2735089		thrS	21
RV2039_libmerged	2736710	2736718		YPO_RS13190	8
RV2039_libmerged	2737234	2737264		YPO_RS13195	30
RV2039_libmerged	2737427	2737428		YPO_RS13195	1
RV2039_libmerged	2738060	2738074		YPO_RS13200	14
RV2039_libmerged	2738377	2738378		YPO_RS13200	1
RV2039_libmerged	2738465	2738475		YPO_RS13200	10
RV2039_libmerged	2738783	2738787		yfeA	4
RV2039_libmerged	2739145	2739151		yfeA	6
RV2039_libmerged	2739425	2739448		yfeA	23
RV2039_libmerged	2739669	2739698		yfeA	29
RV2039_libmerged	2739818	2739837		yfeB	19
RV2039_libmerged	2739885	2739897		yfeB	12
RV2039_libmerged	2740026	2740031		yfeB	5
RV2039_libmerged	2740444	2740448		yfeB	4
RV2039_libmerged	2740982	2740985		yfeC	3
RV2039_libmerged	2741097	2741100		yfeC	3
RV2039_libmerged	2741599	2741612		yfeD	13
RV2039_libmerged	2742213	2742220		yfeD	7
RV2039_libmerged	2742360	2742364		yfeD	4
RV2039_libmerged	2742535	2742538		YPO_RS13225	3
RV2039_libmerged	2742895	2742901		YPO_RS13230	6
RV2039_libmerged	2745664	2745669		YPO_RS13245	5
RV2039_libmerged	2745777	2745778		YPO_RS13245	1
RV2039_libmerged	2745988	2746000		YPO_RS13245	12
RV2039_libmerged	2746432	2746455		YPO_RS13245	23
RV2039_libmerged	2746655	2746657		YPO_RS13245	2
RV2039_libmerged	2748562	2748587		YPO_RS13255	25
RV2039_libmerged	2748671	2748729		YPO_RS13255	58
RV2039_libmerged	2748763	2748764		YPO_RS13255	1
RV2039_libmerged	2748816	2748833		YPO_RS13255	17
RV2039_libmerged	2748969	2748981		YPO_RS13255	12
RV2039_libmerged	2749485	2749489		YPO_RS13260	4
RV2039_libmerged	2749840	2749853		YPO_RS13265	13
RV2039_libmerged	2749915	2749927		YPO_RS13265	12
RV2039_libmerged	2750018	2750023		YPO_RS13265	5
RV2039_libmerged	2750538	2750553		YPO_RS13265	15
RV2039_libmerged	2750726	2750745		YPO_RS13265	19
RV2039_libmerged	2751776	2751796		YPO_RS13270	20
RV2039_libmerged	2753044	2753067		YPO_RS13280	23
RV2039_libmerged	2754131	2754133		YPO_RS13285	2
RV2039_libmerged	2754595	2754608		YPO_RS13285	13
RV2039_libmerged	2754820	2754881		YPO_RS13290	61
RV2039_libmerged	2755019	2755025		YPO_RS13290	6
RV2039_libmerged	2755138	2755141		YPO_RS13290	3
RV2039_libmerged	2755171	2755182		YPO_RS13290	11
RV2039_libmerged	2755330	2755346		YPO_RS13290	16
RV2039_libmerged	2756671	2756677		YPO_RS13295	6
RV2039_libmerged	2757226	2757242		YPO_RS13300	16
RV2039_libmerged	2757524	2757542		YPO_RS13305	18
RV2039_libmerged	2759091	2759096		fae	5
RV2039_libmerged	2759552	2759590		YPO_RS13315	38
RV2039_libmerged	2759768	2759775		YPO_RS13315	7
RV2039_libmerged	2761988	2761994		csy2	6
RV2039_libmerged	2762755	2762762		csy2	7
RV2039_libmerged	2762991	2762994		csy1	3
RV2039_libmerged	2763108	2763111		csy1	3
RV2039_libmerged	2763676	2763682		csy1	6
RV2039_libmerged	2763981	2763985		csy1	4
RV2039_libmerged	2765929	2765932		cas3f	3
RV2039_libmerged	2766207	2766208		cas3f	1
RV2039_libmerged	2766241	2766275		cas3f	34
RV2039_libmerged	2766383	2766391		cas3f	8
RV2039_libmerged	2767009	2767013		cas3f	4
RV2039_libmerged	2767523	2767541		cas3f	18
RV2039_libmerged	2770251	2770256		YPO_RS13350	5
RV2039_libmerged	2770780	2770781		YPO_RS13350	1
RV2039_libmerged	2771015	2771043		YPO_RS13350	28
RV2039_libmerged	2772354	2772382		YPO_RS13355	28
RV2039_libmerged	2773755	2773771		YPO_RS13360	16
RV2039_libmerged	2774386	2774395		YPO_RS13360	9
RV2039_libmerged	2774683	2774688		YPO_RS13365	5
RV2039_libmerged	2774747	2774764		YPO_RS13365	17
RV2039_libmerged	2774960	2774965		YPO_RS13365	5
RV2039_libmerged	2775816	2775824		YPO_RS13370	8
RV2039_libmerged	2776499	2776528		YPO_RS13370	29
RV2039_libmerged	2776970	2776982		YPO_RS13375	12
RV2039_libmerged	2777083	2777106		YPO_RS13375	23
RV2039_libmerged	2777249	2777252		YPO_RS13375	3
RV2039_libmerged	2777413	2777419		YPO_RS13375	6
RV2039_libmerged	2777653	2777655		YPO_RS13380	2
RV2039_libmerged	2777978	2777986		YPO_RS13380	8
RV2039_libmerged	2778164	2778171		YPO_RS13380	7
RV2039_libmerged	2778880	2778883		YPO_RS13385	3
RV2039_libmerged	2779000	2779011		YPO_RS13385	11
RV2039_libmerged	2779754	2779767		YPO_RS13385	13
RV2039_libmerged	2780329	2780362		YPO_RS13390	33
RV2039_libmerged	2782302	2782317		YPO_RS13395	15
RV2039_libmerged	2782726	2782741		ugpC	15
RV2039_libmerged	2783947	2783948		YPO_RS13405	1
RV2039_libmerged	2784068	2784069		YPO_RS13405	1
RV2039_libmerged	2784762	2784775		YPO_RS13410	13
RV2039_libmerged	2784853	2784872		YPO_RS13410	19
RV2039_libmerged	2785315	2785320		YPO_RS13415	5
RV2039_libmerged	2785492	2785510		YPO_RS13415	18
RV2039_libmerged	2785602	2785634		YPO_RS13415	32
RV2039_libmerged	2786338	2786339		YPO_RS13425	1
RV2039_libmerged	2786460	2786480		YPO_RS13430	20
RV2039_libmerged	2786680	2786692		YPO_RS13430	12
RV2039_libmerged	2786952	2786954		YPO_RS13430	2
RV2039_libmerged	2787361	2787367		YPO_RS13430	6
RV2039_libmerged	2788077	2788092		YPO_RS13430	15
RV2039_libmerged	2788674	2788677		YPO_RS13435	3
RV2039_libmerged	2789247	2789261		YPO_RS13440	14
RV2039_libmerged	2789708	2789709		YPO_RS13445	1
RV2039_libmerged	2789793	2789805		YPO_RS13445	12
RV2039_libmerged	2790247	2790268		cdiA	21
RV2039_libmerged	2790340	2790356		cdiA	16
RV2039_libmerged	2790587	2790618		cdiA	31
RV2039_libmerged	2790695	2790703		cdiA	8
RV2039_libmerged	2793726	2793747		cdiA	21
RV2039_libmerged	2799389	2799397		YPO_RS13455	8
RV2039_libmerged	2800386	2800392		YPO_RS13460	6
RV2039_libmerged	2800747	2800748		YPO_RS13460	1
RV2039_libmerged	2801129	2801135		YPO_RS13460	6
RV2039_libmerged	2802096	2802124		YPO_RS13465	28
RV2039_libmerged	2802735	2802757		YPO_RS13470	22
RV2039_libmerged	2803814	2803851		YPO_RS13470	37
RV2039_libmerged	2804133	2804145		YPO_RS13470	12
RV2039_libmerged	2807344	2807379		YPO_RS13485	35
RV2039_libmerged	2807442	2807444		YPO_RS13485	2
RV2039_libmerged	2809434	2809456		YPO_RS13495	22
RV2039_libmerged	2810439	2810504		YPO_RS13495	65
RV2039_libmerged	2810929	2810931		YPO_RS13500	2
RV2039_libmerged	2811573	2811576		YPO_RS13500	3
RV2039_libmerged	2811621	2811643		YPO_RS13500	22
RV2039_libmerged	2811903	2811915		YPO_RS13505	12
RV2039_libmerged	2812777	2812783		YPO_RS13505	6
RV2039_libmerged	2814005	2814035		YPO_RS13510	30
RV2039_libmerged	2814183	2814190		YPO_RS13510	7
RV2039_libmerged	2814576	2814656		YPO_RS13515	80
RV2039_libmerged	2814727	2814737		YPO_RS13515	10
RV2039_libmerged	2814986	2815032		YPO_RS13515	46
RV2039_libmerged	2815481	2815482		YPO_RS13520	1
RV2039_libmerged	2815702	2815710		YPO_RS13520	8
RV2039_libmerged	2816126	2816198		YPO_RS13520	72
RV2039_libmerged	2816958	2816968		ompX	10
RV2039_libmerged	2817615	2817627		rhtA	12
RV2039_libmerged	2820332	2820334		dps	2
RV2039_libmerged	2821038	2821051		YPO_RS13550	13
RV2039_libmerged	2821872	2821873		YPO_RS13550	1
RV2039_libmerged	2823031	2823047		glnH	16
RV2039_libmerged	2823528	2823530		glnP	2
RV2039_libmerged	2825673	2825689		YPO_RS13570	16
RV2039_libmerged	2826093	2826103		YPO_RS13570	10
RV2039_libmerged	2826180	2826206		YPO_RS13570	26
RV2039_libmerged	2826265	2826348		YPO_RS13575	83
RV2039_libmerged	2826424	2826432		YPO_RS13575	8
RV2039_libmerged	2826602	2826647		YPO_RS13575	45
RV2039_libmerged	2826688	2826694		YPO_RS13575	6
RV2039_libmerged	2826976	2826977		YPO_RS13575	1
RV2039_libmerged	2827128	2827134		YPO_RS13575	6
RV2039_libmerged	2827165	2827173		YPO_RS13575	8
RV2039_libmerged	2827381	2827384		YPO_RS13580	3
RV2039_libmerged	2827454	2827475		YPO_RS13580	21
RV2039_libmerged	2827538	2827556		YPO_RS13580	18
RV2039_libmerged	2827648	2827664		YPO_RS13580	16
RV2039_libmerged	2827699	2827714		YPO_RS13580	15
RV2039_libmerged	2828013	2828066		YPO_RS13580	53
RV2039_libmerged	2829057	2829085		rlmF	28
RV2039_libmerged	2829175	2829198		rlmF	23
RV2039_libmerged	2833458	2833459		menC	1
RV2039_libmerged	2838518	2838533		menF	15
RV2039_libmerged	2839784	2839799		YPO_RS13635	15
RV2039_libmerged	2840122	2840139		YPO_RS13635	17
RV2039_libmerged	2841081	2841082		YPO_RS13640	1
RV2039_libmerged	2841266	2841286		YPO_RS13640	20
RV2039_libmerged	2842233	2842243		YPO_RS13645	10
RV2039_libmerged	2843183	2843219		YPO_RS13645	36
RV2039_libmerged	2843402	2843403		YPO_RS13645	1
RV2039_libmerged	2845739	2845766		YPO_RS13655	27
RV2039_libmerged	2845947	2845954		YPO_RS13655	7
RV2039_libmerged	2846878	2846892		YPO_RS13660	14
RV2039_libmerged	2849630	2849631		YPO_RS13670	1
RV2039_libmerged	2850253	2850259		YPO_RS13670	6
RV2039_libmerged	2850337	2850352		YPO_RS13670	15
RV2039_libmerged	2852243	2852259		YPO_RS13680	16
RV2039_libmerged	2852424	2852436		YPO_RS13680	12
RV2039_libmerged	2853807	2853814		YPO_RS13690	7
RV2039_libmerged	2853932	2853985		YPO_RS13690	53
RV2039_libmerged	2854061	2854081		YPO_RS13690	20
RV2039_libmerged	2854342	2854356		YPO_RS13690	14
RV2039_libmerged	2856766	2856770		nuoM	4
RV2039_libmerged	2857212	2857217		nuoM	5
RV2039_libmerged	2857713	2857716		nuoM	3
RV2039_libmerged	2859102	2859109		nuoL	7
RV2039_libmerged	2860171	2860177		nuoK	6
RV2039_libmerged	2860526	2860530		nuoJ	4
RV2039_libmerged	2864142	2864149		nuoG	7
RV2039_libmerged	2864315	2864329		nuoG	14
RV2039_libmerged	2864567	2864575		nuoG	8
RV2039_libmerged	2864807	2864822		nuoG	15
RV2039_libmerged	2865084	2865092		nuoG	8
RV2039_libmerged	2867119	2867124		nuoE	5
RV2039_libmerged	2867127	2867134		nuoC	7
RV2039_libmerged	2867446	2867449		nuoC	3
RV2039_libmerged	2868664	2868670		nuoC	6
RV2039_libmerged	2869278	2869320		YPO_RS13750	42
RV2039_libmerged	2869740	2869741		YPO_RS13750	1
RV2039_libmerged	2874314	2874334		yfbR	20
RV2039_libmerged	2874561	2874596		yfbR	35
RV2039_libmerged	2875116	2875170		YPO_RS13775	54
RV2039_libmerged	2876024	2876034		YPO_RS13775	10
RV2039_libmerged	2878127	2878169		YPO_RS13785	42
RV2039_libmerged	2882644	2882648		pta	4
RV2039_libmerged	2884106	2884110		YPO_RS13805	4
RV2039_libmerged	2885174	2885177		YPO_RS13810	3
RV2039_libmerged	2885320	2885367		YPO_RS13810	47
RV2039_libmerged	2885751	2885790		YPO_RS13815	39
RV2039_libmerged	2885812	2885821		YPO_RS13820	9
RV2039_libmerged	2886224	2886305		YPO_RS13820	81
RV2039_libmerged	2886518	2886523		YPO_RS13820	5
RV2039_libmerged	2886904	2886936		YPO_RS13820	32
RV2039_libmerged	2887074	2887090		YPO_RS13825	16
RV2039_libmerged	2887419	2887457		YPO_RS13825	38
RV2039_libmerged	2888850	2888869		YPO_RS13830	19
RV2039_libmerged	2889067	2889082		YPO_RS13830	15
RV2039_libmerged	2889563	2889566		YPO_RS13830	3
RV2039_libmerged	2889665	2889688		YPO_RS13830	23
RV2039_libmerged	2890073	2890074		YPO_RS13830	1
RV2039_libmerged	2891596	2891620		YPO_RS13830	24
RV2039_libmerged	2891894	2891910		YPO_RS13830	16
RV2039_libmerged	2892099	2892107		YPO_RS13830	8
RV2039_libmerged	2892971	2892979		YPO_RS13830	8
RV2039_libmerged	2898723	2898753		iolD	30
RV2039_libmerged	2902893	2902924		YPO_RS13865	31
RV2039_libmerged	2903524	2903531		YPO_RS13865	7
RV2039_libmerged	2903771	2903773		YPO_RS13865	2
RV2039_libmerged	2903828	2903832		YPO_RS13865	4
RV2039_libmerged	2904012	2904019		YPO_RS13865	7
RV2039_libmerged	2905641	2905647		YPO_RS13875	6
RV2039_libmerged	2906052	2906075		YPO_RS13875	23
RV2039_libmerged	2910198	2910201		iolB	3
RV2039_libmerged	2910283	2910290		iolB	7
RV2039_libmerged	2911068	2911092		YPO_RS13900	24
RV2039_libmerged	2912125	2912146		YPO_RS13900	21
RV2039_libmerged	2912892	2912895		YPO_RS13905	3
RV2039_libmerged	2914489	2914495		YPO_RS13920	6
RV2039_libmerged	2914672	2914676		YPO_RS13920	4
RV2039_libmerged	2918698	2918702		tatA	4
RV2039_libmerged	2919074	2919075		lipA	1
RV2039_libmerged	2919405	2919409		lipA	4
RV2039_libmerged	2919618	2919629		lipA	11
RV2039_libmerged	2920511	2920513		lipB	2
RV2039_libmerged	2922782	2922808		dacA	26
RV2039_libmerged	2923312	2923330		rlpA	18
RV2039_libmerged	2924044	2924048		rlpA	4
RV2039_libmerged	2924131	2924137		rlpA	6
RV2039_libmerged	2924453	2924454		mrdB	1
RV2039_libmerged	2925165	2925179		mrdB	14
RV2039_libmerged	2925814	2925822		mrdA	8
RV2039_libmerged	2926242	2926252		mrdA	10
RV2039_libmerged	2926837	2926852		mrdA	15
RV2039_libmerged	2926953	2926975		mrdA	22
RV2039_libmerged	2927626	2927637		rlmH	11
RV2039_libmerged	2928272	2928276		rsfS	4
RV2039_libmerged	2928981	2928983		nadD	2
RV2039_libmerged	2929204	2929233		nadD	29
RV2039_libmerged	2930284	2930290		lptE	6
RV2039_libmerged	2930966	2930980		leuS	14
RV2039_libmerged	2933762	2933769		YPO_RS14015	7
RV2039_libmerged	2934898	2934927		YPO_RS14020	29
RV2039_libmerged	2935275	2935285		gltK	10
RV2039_libmerged	2936225	2936233		YPO_RS14030	8
RV2039_libmerged	2936402	2936405		YPO_RS14030	3
RV2039_libmerged	2936464	2936465		YPO_RS14030	1
RV2039_libmerged	2937064	2937072		YPO_RS14035	8
RV2039_libmerged	2937312	2937336		YPO_RS14035	24
RV2039_libmerged	2938492	2938499		lnt	7
RV2039_libmerged	2939867	2939903		lnt	36
RV2039_libmerged	2940013	2940024		corC	11
RV2039_libmerged	2940305	2940307		corC	2
RV2039_libmerged	2941034	2941043		ybeY	9
RV2039_libmerged	2941259	2941270		ybeY	11
RV2039_libmerged	2942233	2942247		YPO_RS14055	14
RV2039_libmerged	2943491	2943499		miaB	8
RV2039_libmerged	2944024	2944032		miaB	8
RV2039_libmerged	2944207	2944212		miaB	5
RV2039_libmerged	2944929	2944930		ubiF	1
RV2039_libmerged	2945120	2945128		ubiF	8
RV2039_libmerged	2949658	2949666		YPO_RS14100	8
RV2039_libmerged	2950029	2950043		YPO_RS14105	14
RV2039_libmerged	2950330	2950350		YPO_RS14105	20
RV2039_libmerged	2950691	2950692		YPO_RS14105	1
RV2039_libmerged	2951647	2951668		nagA	21
RV2039_libmerged	2952157	2952180		nagA	23
RV2039_libmerged	2953609	2953615		YPO_RS14120	6
RV2039_libmerged	2953917	2953934		YPO_RS14120	17
RV2039_libmerged	2954517	2954520		YPO_RS14120	3
RV2039_libmerged	2954589	2954602		YPO_RS14120	13
RV2039_libmerged	2955001	2955006		YPO_RS14120	5
RV2039_libmerged	2955702	2955729		YPO_RS14125	27
RV2039_libmerged	2955783	2955788		YPO_RS14125	5
RV2039_libmerged	2955884	2955888		YPO_RS14125	4
RV2039_libmerged	2955936	2955960		YPO_RS14125	24
RV2039_libmerged	2956035	2956149		YPO_RS14125	114
RV2039_libmerged	2959896	2959905		YPO_RS14135	9
RV2039_libmerged	2963653	2963665		fur	12
RV2039_libmerged	2964589	2964595		fldA	6
RV2039_libmerged	2964724	2964756		fldA	32
RV2039_libmerged	2964916	2964925		fldA	9
RV2039_libmerged	2966116	2966128		ybfF	12
RV2039_libmerged	2966478	2966483		ybfF	5
RV2039_libmerged	2966532	2966534		ybfF	2
RV2039_libmerged	2968931	2968936		YPO_RS14185	5
RV2039_libmerged	2968998	2969051		YPO_RS14185	53
RV2039_libmerged	2969256	2969417		YPO_RS14185	161
RV2039_libmerged	2969580	2969615		YPO_RS14185	35
RV2039_libmerged	2969683	2969710		YPO_RS14185	27
RV2039_libmerged	2969710	2969780		YPO_RS14190	70
RV2039_libmerged	2969895	2969942		YPO_RS14190	47
RV2039_libmerged	2970015	2970063		YPO_RS14190	48
RV2039_libmerged	2970160	2970182		YPO_RS14190	22
RV2039_libmerged	2970227	2970307		YPO_RS14190	80
RV2039_libmerged	2970339	2970358		YPO_RS14190	19
RV2039_libmerged	2970457	2970472		YPO_RS14190	15
RV2039_libmerged	2970556	2970582		YPO_RS14190	26
RV2039_libmerged	2971931	2971932		proX	1
RV2039_libmerged	2972405	2972419		proX	14
RV2039_libmerged	2972525	2972530		proX	5
RV2039_libmerged	2974752	2974759		proV	7
RV2039_libmerged	2976086	2976100		nrdF	14
RV2039_libmerged	2976212	2976216		nrdF	4
RV2039_libmerged	2976521	2976526		nrdF	5
RV2039_libmerged	2976575	2976587		nrdF	12
RV2039_libmerged	2977004	2977018		nrdE	14
RV2039_libmerged	2977179	2977240		nrdE	61
RV2039_libmerged	2977287	2977301		nrdE	14
RV2039_libmerged	2977995	2978007		nrdE	12
RV2039_libmerged	2979159	2979188		nrdI	29
RV2039_libmerged	2979619	2979636		YPO_RS14230	17
RV2039_libmerged	2981174	2981178		YPO_RS14240	4
RV2039_libmerged	2981229	2981230		YPO_RS14240	1
RV2039_libmerged	2981689	2981699		YPO_RS14245	10
RV2039_libmerged	2981907	2981929		YPO_RS14245	22
RV2039_libmerged	2982348	2982377		YPO_RS14250	29
RV2039_libmerged	2982607	2982642		YPO_RS14250	35
RV2039_libmerged	2982903	2982920		YPO_RS14250	17
RV2039_libmerged	2982995	2983000		YPO_RS14250	5
RV2039_libmerged	2983109	2983135		YPO_RS14250	26
RV2039_libmerged	2986634	2986645		YPO_RS14265	11
RV2039_libmerged	2987073	2987089		YPO_RS14270	16
RV2039_libmerged	2987259	2987278		YPO_RS14270	19
RV2039_libmerged	2988616	2988617		YPO_RS14275	1
RV2039_libmerged	2990151	2990217		YPO_RS14285	66
RV2039_libmerged	2992499	2992503		YPO_RS14300	4
RV2039_libmerged	2992800	2992808		YPO_RS14300	8
RV2039_libmerged	2994484	2994485		ureE	1
RV2039_libmerged	2995654	2995682		YPO_RS14310	28
RV2039_libmerged	2995901	2995928		ureG	27
RV2039_libmerged	2996210	2996216		ureG	6
RV2039_libmerged	2998926	2998927		YPO_RS14330	1
RV2039_libmerged	2999017	2999029		YPO_RS14330	12
RV2039_libmerged	2999275	2999292		YPO_RS14330	17
RV2039_libmerged	2999335	2999342		YPO_RS14330	7
RV2039_libmerged	2999807	2999817		YPO_RS14330	10
RV2039_libmerged	3000172	3000194		hdeB	22
RV2039_libmerged	3000328	3000351		hdeB	23
RV2039_libmerged	3001399	3001469		kch	70
RV2039_libmerged	3001526	3001528		kch	2
RV2039_libmerged	3002442	3002467		crcB	25
RV2039_libmerged	3005113	3005134		chbC	21
RV2039_libmerged	3006643	3006644		chbR	1
RV2039_libmerged	3007219	3007221		chbG	2
RV2039_libmerged	3007496	3007501		chbG	5
RV2039_libmerged	3007610	3007613		chbG	3
RV2039_libmerged	3007682	3007719		chbG	37
RV2039_libmerged	3009566	3009571		seqA	5
RV2039_libmerged	3009825	3009827		pgm	2
RV2039_libmerged	3010069	3010070		pgm	1
RV2039_libmerged	3010753	3010757		pgm	4
RV2039_libmerged	3011755	3011766		YPO_RS14400	11
RV2039_libmerged	3013604	3013606		kdbD	2
RV2039_libmerged	3013812	3013814		kdbD	2
RV2039_libmerged	3016338	3016352		kdpC	14
RV2039_libmerged	3017815	3017836		kdpB	21
RV2039_libmerged	3020429	3020434		kdpA	5
RV2039_libmerged	3021092	3021096		YPO_RS14440	4
RV2039_libmerged	3023866	3023899		phrB	33
RV2039_libmerged	3024498	3024510		YPO_RS14460	12
RV2039_libmerged	3025262	3025285		YPO_RS14465	23
RV2039_libmerged	3025515	3025528		YPO_RS14465	13
RV2039_libmerged	3025827	3025830		YPO_RS14465	3
RV2039_libmerged	3025968	3025979		YPO_RS14465	11
RV2039_libmerged	3026208	3026220		YPO_RS14470	12
RV2039_libmerged	3027933	3027942		YPO_RS14480	9
RV2039_libmerged	3028499	3028512		pxpA	13
RV2039_libmerged	3028649	3028659		pxpA	10
RV2039_libmerged	3029352	3029354		YPO_RS14490	2
RV2039_libmerged	3029668	3029674		YPO_RS14490	6
RV2039_libmerged	3030101	3030112		YPO_RS14495	11
RV2039_libmerged	3030151	3030160		YPO_RS14495	9
RV2039_libmerged	3031599	3031602		ung	3
RV2039_libmerged	3031948	3031957		ung	9
RV2039_libmerged	3032083	3032095		ung	12
RV2039_libmerged	3034408	3034424		YPO_RS14520	16
RV2039_libmerged	3034729	3034736		YPO_RS14520	7
RV2039_libmerged	3037564	3037580		nadB	16
RV2039_libmerged	3037813	3037814		nadB	1
RV2039_libmerged	3038026	3038056		nadB	30
RV2039_libmerged	3038345	3038352		nadB	7
RV2039_libmerged	3039740	3039770		rpoE	30
RV2039_libmerged	3040771	3040786		rseB	15
RV2039_libmerged	3042169	3042171		YPO_RS14560	2
RV2039_libmerged	3045731	3045757		lepB	26
RV2039_libmerged	3049201	3049206		YPO_RS14590	5
RV2039_libmerged	3049397	3049431		YPO_RS14590	34
RV2039_libmerged	3049585	3049609		YPO_RS14590	24
RV2039_libmerged	3049665	3049701		YPO_RS14590	36
RV2039_libmerged	3049756	3049759		YPO_RS14590	3
RV2039_libmerged	3049976	3050028		YPO_RS14590	52
RV2039_libmerged	3050108	3050168		YPO_RS14595	60
RV2039_libmerged	3050220	3050276		YPO_RS14595	56
RV2039_libmerged	3050363	3050439		YPO_RS14595	76
RV2039_libmerged	3050518	3050565		YPO_RS14595	47
RV2039_libmerged	3050635	3050668		YPO_RS14595	33
RV2039_libmerged	3050719	3050782		YPO_RS14595	63
RV2039_libmerged	3050816	3050822		YPO_RS14595	6
RV2039_libmerged	3050838	3050889		tssL	51
RV2039_libmerged	3051309	3051350		tssL	41
RV2039_libmerged	3052016	3052040		tssM	24
RV2039_libmerged	3052661	3052689		tssM	28
RV2039_libmerged	3053135	3053155		tssM	20
RV2039_libmerged	3054180	3054193		tssM	13
RV2039_libmerged	3054541	3054542		tssM	1
RV2039_libmerged	3055099	3055144		tssM	45
RV2039_libmerged	3055923	3055925		YPO_RS14610	2
RV2039_libmerged	3056155	3056165		YPO_RS14610	10
RV2039_libmerged	3056237	3056300		YPO_RS14610	63
RV2039_libmerged	3056398	3056402		YPO_RS14610	4
RV2039_libmerged	3056931	3056934		YPO_RS14610	3
RV2039_libmerged	3057130	3057133		YPO_RS14610	3
RV2039_libmerged	3057918	3057922		YPO_RS14610	4
RV2039_libmerged	3058940	3058946		YPO_RS14620	6
RV2039_libmerged	3059161	3059169		YPO_RS14620	8
RV2039_libmerged	3059348	3059359		YPO_RS14620	11
RV2039_libmerged	3059629	3059638		YPO_RS14620	9
RV2039_libmerged	3060141	3060154		YPO_RS14625	13
RV2039_libmerged	3060415	3060416		YPO_RS14625	1
RV2039_libmerged	3061343	3061372		YPO_RS14635	29
RV2039_libmerged	3061488	3061506		YPO_RS14635	18
RV2039_libmerged	3062937	3062953		YPO_RS14645	16
RV2039_libmerged	3064721	3064724		YPO_RS14650	3
RV2039_libmerged	3065220	3065231		YPO_RS14655	11
RV2039_libmerged	3065577	3065601		YPO_RS14660	24
RV2039_libmerged	3065724	3065743		YPO_RS14660	19
RV2039_libmerged	3065848	3065853		YPO_RS14660	5
RV2039_libmerged	3066548	3066553		ccmA	5
RV2039_libmerged	3067321	3067324		ccmB	3
RV2039_libmerged	3068989	3068991		ccmE	2
RV2039_libmerged	3070455	3070475		YPO_RS14690	20
RV2039_libmerged	3070992	3071026		YPO_RS14690	34
RV2039_libmerged	3071353	3071358		YPO_RS14695	5
RV2039_libmerged	3072098	3072100		YPO_RS14700	2
RV2039_libmerged	3072935	3072941		ccmI	6
RV2039_libmerged	3073097	3073118		ccmI	21
RV2039_libmerged	3073204	3073205		ccmI	1
RV2039_libmerged	3074029	3074055		mlaA	26
RV2039_libmerged	3074627	3074628		fadL	1
RV2039_libmerged	3074739	3074749		fadL	10
RV2039_libmerged	3075095	3075114		fadL	19
RV2039_libmerged	3076749	3076772		fadI	23
RV2039_libmerged	3076947	3076948		fadI	1
RV2039_libmerged	3078231	3078247		fadJ	16
RV2039_libmerged	3078300	3078304		fadJ	4
RV2039_libmerged	3078652	3078656		fadJ	4
RV2039_libmerged	3079292	3079297		fadJ	5
RV2039_libmerged	3080244	3080253		fadJ	9
RV2039_libmerged	3082796	3082804		prmB	8
RV2039_libmerged	3084391	3084398		aroC	7
RV2039_libmerged	3085778	3085785		YPO_RS14760	7
RV2039_libmerged	3086984	3087011		YPO_RS14765	27
RV2039_libmerged	3087422	3087425		YPO_RS14770	3
RV2039_libmerged	3088577	3088580		mnmC	3
RV2039_libmerged	3090504	3090511		fabB	7
RV2039_libmerged	3090814	3090817		fabB	3
RV2039_libmerged	3091613	3091618		YPO_RS14785	5
RV2039_libmerged	3095484	3095486		YPO_RS14800	2
RV2039_libmerged	3096331	3096340		YPO_RS14805	9
RV2039_libmerged	3097900	3097920		pdxB	20
RV2039_libmerged	3098253	3098271		pdxB	18
RV2039_libmerged	3098457	3098575		YPO_RS14815	118
RV2039_libmerged	3098655	3098692		YPO_RS14815	37
RV2039_libmerged	3098846	3098873		YPO_RS14815	27
RV2039_libmerged	3100755	3100758		truA	3
RV2039_libmerged	3100881	3100896		truA	15
RV2039_libmerged	3101679	3101703		YPO_RS14830	24
RV2039_libmerged	3102690	3102723		accD	33
RV2039_libmerged	3104751	3104764		dedD	13
RV2039_libmerged	3105398	3105402		dedD	4
RV2039_libmerged	3105714	3105719		cvpA	5
RV2039_libmerged	3106437	3106448		purF	11
RV2039_libmerged	3106610	3106622		purF	12
RV2039_libmerged	3107136	3107145		purF	9
RV2039_libmerged	3109726	3109728		hisJ	2
RV2039_libmerged	3110112	3110119		YPO_RS14870	7
RV2039_libmerged	3110761	3110770		YPO_RS14875	9
RV2039_libmerged	3111299	3111304		YPO_RS14875	5
RV2039_libmerged	3112653	3112659		YPO_RS14885	6
RV2039_libmerged	3113216	3113221		YPO_RS14885	5
RV2039_libmerged	3113940	3113951		YPO_RS14890	11
RV2039_libmerged	3114060	3114075		YPO_RS14890	15
RV2039_libmerged	3114209	3114222		YPO_RS14890	13
RV2039_libmerged	3114523	3114524		yfcE	1
RV2039_libmerged	3114637	3114651		yfcE	14
RV2039_libmerged	3115630	3115634		yfcD	4
RV2039_libmerged	3115664	3115688		yfcD	24
RV2039_libmerged	3116493	3116498		YPO_RS14905	5
RV2039_libmerged	3116860	3116863		YPO_RS14905	3
RV2039_libmerged	3117329	3117358		YPO_RS14910	29
RV2039_libmerged	3117413	3117426		YPO_RS14910	13
RV2039_libmerged	3117671	3117678		YPO_RS14910	7
RV2039_libmerged	3117838	3117862		YPO_RS14910	24
RV2039_libmerged	3117970	3118001		YPO_RS14910	31
RV2039_libmerged	3118043	3118060		YPO_RS14910	17
RV2039_libmerged	3121382	3121437		YPO_RS14925	55
RV2039_libmerged	3121572	3121574		YPO_RS14925	2
RV2039_libmerged	3121673	3121675		YPO_RS14925	2
RV2039_libmerged	3122345	3122401		YPO_RS14930	56
RV2039_libmerged	3122456	3122458		YPO_RS14930	2
RV2039_libmerged	3122896	3122900		YPO_RS14935	4
RV2039_libmerged	3122972	3122986		YPO_RS14935	14
RV2039_libmerged	3123346	3123352		YPO_RS14940	6
RV2039_libmerged	3124016	3124034		YPO_RS14950	18
RV2039_libmerged	3125089	3125097		yapC	8
RV2039_libmerged	3125232	3125244		yapC	12
RV2039_libmerged	3125280	3125325		yapC	45
RV2039_libmerged	3125694	3125715		yapC	21
RV2039_libmerged	3126100	3126107		yapC	7
RV2039_libmerged	3126778	3126801		yapC	23
RV2039_libmerged	3128725	3128729		YPO_RS14975	4
RV2039_libmerged	3129243	3129268		YPO_RS14975	25
RV2039_libmerged	3129395	3129416		YPO_RS14975	21
RV2039_libmerged	3129527	3129528		YPO_RS14975	1
RV2039_libmerged	3129659	3129682		YPO_RS14975	23
RV2039_libmerged	3130645	3130656		YPO_RS14980	11
RV2039_libmerged	3130767	3130770		YPO_RS14980	3
RV2039_libmerged	3131558	3131573		YPO_RS14980	15
RV2039_libmerged	3132394	3132459		YPO_RS14985	65
RV2039_libmerged	3132759	3132781		YPO_RS14985	22
RV2039_libmerged	3134728	3134732		YPO_RS14990	4
RV2039_libmerged	3136103	3136104		YPO_RS14995	1
RV2039_libmerged	3136567	3136568		YPO_RS14995	1
RV2039_libmerged	3139601	3139610		YPO_RS15010	9
RV2039_libmerged	3139849	3139852		YPO_RS15010	3
RV2039_libmerged	3140406	3140422		YPO_RS15010	16
RV2039_libmerged	3140549	3140580		YPO_RS15015	31
RV2039_libmerged	3140917	3140973		YPO_RS15015	56
RV2039_libmerged	3141066	3141153		YPO_RS15015	87
RV2039_libmerged	3141210	3141257		YPO_RS15015	47
RV2039_libmerged	3141528	3141532		YPO_RS15015	4
RV2039_libmerged	3141619	3141625		YPO_RS15020	6
RV2039_libmerged	3141719	3141739		YPO_RS15020	20
RV2039_libmerged	3141858	3141887		YPO_RS15020	29
RV2039_libmerged	3141925	3141990		YPO_RS15020	65
RV2039_libmerged	3142063	3142100		YPO_RS15020	37
RV2039_libmerged	3142207	3142241		YPO_RS15020	34
RV2039_libmerged	3142273	3142317		YPO_RS15020	44
RV2039_libmerged	3144360	3144361		YPO_RS15035	1
RV2039_libmerged	3144568	3144578		YPO_RS15035	10
RV2039_libmerged	3144964	3144965		YPO_RS15040	1
RV2039_libmerged	3145461	3145498		YPO_RS15040	37
RV2039_libmerged	3145679	3145688		YPO_RS15040	9
RV2039_libmerged	3145756	3145760		YPO_RS15040	4
RV2039_libmerged	3146554	3146555		YPO_RS15045	1
RV2039_libmerged	3147974	3147979		YPO_RS15050	5
RV2039_libmerged	3152873	3152896		ybcJ	23
RV2039_libmerged	3153252	3153263		YPO_RS15105	11
RV2039_libmerged	3153309	3153342		YPO_RS15105	33
RV2039_libmerged	3153413	3153417		YPO_RS15105	4
RV2039_libmerged	3153451	3153494		YPO_RS15105	43
RV2039_libmerged	3153549	3153623		YPO_RS15105	74
RV2039_libmerged	3157373	3157384		speG	11
RV2039_libmerged	3159100	3159101		pstB	1
RV2039_libmerged	3160263	3160307		pstA	44
RV2039_libmerged	3160366	3160373		pstA	7
RV2039_libmerged	3160720	3160723		pstA	3
RV2039_libmerged	3161123	3161126		pstA	3
RV2039_libmerged	3165485	3165537		ppk1	52
RV2039_libmerged	3165691	3165692		ppk1	1
RV2039_libmerged	3166013	3166042		ppk1	29
RV2039_libmerged	3166832	3166834		ppx	2
RV2039_libmerged	3167094	3167095		ppx	1
RV2039_libmerged	3170251	3170278		yegD	27
RV2039_libmerged	3172272	3172279		YPO_RS15180	7
RV2039_libmerged	3172598	3172631		YPO_RS15180	33
RV2039_libmerged	3172963	3172966		YPO_RS15180	3
RV2039_libmerged	3173728	3173747		YPO_RS15185	19
RV2039_libmerged	3174120	3174126		YPO_RS15185	6
RV2039_libmerged	3174563	3174575		YPO_RS15190	12
RV2039_libmerged	3178136	3178142		YPO_RS15200	6
RV2039_libmerged	3178542	3178548		YPO_RS15200	6
RV2039_libmerged	3180392	3180399		YPO_RS15205	7
RV2039_libmerged	3180493	3180501		YPO_RS15205	8
RV2039_libmerged	3181493	3181494		YPO_RS15210	1
RV2039_libmerged	3182966	3182967		YPO_RS15210	1
RV2039_libmerged	3184283	3184290		mdtC	7
RV2039_libmerged	3184975	3185019		mdtC	44
RV2039_libmerged	3185155	3185157		mdtC	2
RV2039_libmerged	3185272	3185279		mdtC	7
RV2039_libmerged	3190077	3190079		baeR	2
RV2039_libmerged	3190197	3190198		baeR	1
RV2039_libmerged	3190813	3190818		YPO_RS15235	5
RV2039_libmerged	3191255	3191260		YPO_RS15240	5
RV2039_libmerged	3196123	3196132		thiD	9
RV2039_libmerged	3197685	3197701		YPO_RS15265	16
RV2039_libmerged	3197853	3197877		YPO_RS15265	24
RV2039_libmerged	3197971	3197976		YPO_RS15270	5
RV2039_libmerged	3198075	3198079		YPO_RS15270	4
RV2039_libmerged	3198157	3198166		YPO_RS15270	9
RV2039_libmerged	3198218	3198249		YPO_RS15270	31
RV2039_libmerged	3198313	3198351		YPO_RS15275	38
RV2039_libmerged	3198465	3198532		YPO_RS15275	67
RV2039_libmerged	3198695	3198706		YPO_RS15275	11
RV2039_libmerged	3198994	3199019		YPO_RS15275	25
RV2039_libmerged	3199095	3199101		YPO_RS15275	6
RV2039_libmerged	3199307	3199312		YPO_RS15275	5
RV2039_libmerged	3200101	3200108		YPO_RS15280	7
RV2039_libmerged	3200412	3200426		YPO_RS15285	14
RV2039_libmerged	3200465	3200466		YPO_RS15285	1
RV2039_libmerged	3200470	3200489		YPO_RS15285	19
RV2039_libmerged	3200548	3200557		YPO_RS15285	9
RV2039_libmerged	3200679	3200733		YPO_RS15290	54
RV2039_libmerged	3200820	3200831		YPO_RS15290	11
RV2039_libmerged	3200902	3200917		YPO_RS15290	15
RV2039_libmerged	3201115	3201145		YPO_RS15295	30
RV2039_libmerged	3201455	3201473		YPO_RS15295	18
RV2039_libmerged	3201606	3201707		YPO_RS15300	101
RV2039_libmerged	3201768	3201786		YPO_RS15300	18
RV2039_libmerged	3201943	3201965		YPO_RS15300	22
RV2039_libmerged	3202241	3202248		YPO_RS15305	7
RV2039_libmerged	3202305	3202308		YPO_RS15305	3
RV2039_libmerged	3202364	3202374		YPO_RS15305	10
RV2039_libmerged	3202628	3202811		YPO_RS15310	183
RV2039_libmerged	3204241	3204248		guaA	7
RV2039_libmerged	3205218	3205221		guaB	3
RV2039_libmerged	3208645	3208649		YPO_RS15335	4
RV2039_libmerged	3209417	3209419		YPO_RS15335	2
RV2039_libmerged	3210112	3210121		der	9
RV2039_libmerged	3210265	3210272		der	7
RV2039_libmerged	3210436	3210441		der	5
RV2039_libmerged	3212264	3212275		bamB	11
RV2039_libmerged	3212550	3212559		bamB	9
RV2039_libmerged	3213401	3213402		YPO_RS15350	1
RV2039_libmerged	3213860	3213864		hisS	4
RV2039_libmerged	3214899	3214901		ispG	2
RV2039_libmerged	3215140	3215141		ispG	1
RV2039_libmerged	3215251	3215259		ispG	8
RV2039_libmerged	3215694	3215702		ispG	8
RV2039_libmerged	3215857	3215880		ispG	23
RV2039_libmerged	3216754	3216756		rodZ	2
RV2039_libmerged	3217282	3217284		pilW	2
RV2039_libmerged	3219902	3219904		ndk	2
RV2039_libmerged	3220231	3220259		YPO_RS15385	28
RV2039_libmerged	3221034	3221051		YPO_RS15385	17
RV2039_libmerged	3221378	3221379		YPO_RS15385	1
RV2039_libmerged	3221472	3221479		YPO_RS15385	7
RV2039_libmerged	3221704	3221764		YPO_RS15385	60
RV2039_libmerged	3221819	3221844		YPO_RS15385	25
RV2039_libmerged	3221969	3221970		YPO_RS15385	1
RV2039_libmerged	3222057	3222075		YPO_RS15385	18
RV2039_libmerged	3222627	3222651		YPO_RS15385	24
RV2039_libmerged	3223669	3223676		yapA	7
RV2039_libmerged	3224036	3224039		yapA	3
RV2039_libmerged	3224521	3224530		yapA	9
RV2039_libmerged	3226765	3226771		yapA	6
RV2039_libmerged	3226832	3226834		yapA	2
RV2039_libmerged	3227717	3227721		yapA	4
RV2039_libmerged	3229105	3229119		YPO_RS15395	14
RV2039_libmerged	3229224	3229275		YPO_RS15395	51
RV2039_libmerged	3229512	3229541		YPO_RS15395	29
RV2039_libmerged	3232905	3232910		sseB	5
RV2039_libmerged	3234321	3234329		pepB	8
RV2039_libmerged	3238825	3238840		iscU	15
RV2039_libmerged	3239486	3239489		YPO_RS15450	3
RV2039_libmerged	3239849	3239863		YPO_RS15450	14
RV2039_libmerged	3240312	3240340		iscR	28
RV2039_libmerged	3240880	3240900		trmJ	20
RV2039_libmerged	3241559	3241570		trmJ	11
RV2039_libmerged	3241632	3241638		trmJ	6
RV2039_libmerged	3242881	3242902		YPO_RS15470	21
RV2039_libmerged	3243013	3243023		YPO_RS15470	10
RV2039_libmerged	3243143	3243172		YPO_RS15470	29
RV2039_libmerged	3243202	3243237		YPO_RS15470	35
RV2039_libmerged	3243936	3243959		YPO_RS15475	23
RV2039_libmerged	3244582	3244592		YPO_RS15480	10
RV2039_libmerged	3244879	3244883		YPO_RS15480	4
RV2039_libmerged	3244928	3244929		YPO_RS15480	1
RV2039_libmerged	3246302	3246310		csiE	8
RV2039_libmerged	3246651	3246673		YPO_RS15490	22
RV2039_libmerged	3247259	3247268		YPO_RS15490	9
RV2039_libmerged	3247572	3247574		YPO_RS15490	2
RV2039_libmerged	3247619	3247627		YPO_RS15490	8
RV2039_libmerged	3248325	3248328		ail	3
RV2039_libmerged	3248571	3248619		ail	48
RV2039_libmerged	3249227	3249256		YPO_RS15505	29
RV2039_libmerged	3249370	3249392		YPO_RS15505	22
RV2039_libmerged	3249551	3249565		YPO_RS15505	14
RV2039_libmerged	3249886	3249897		YPO_RS15505	11
RV2039_libmerged	3251123	3251146		hmpA	23
RV2039_libmerged	3254582	3254587		YPO_RS15525	5
RV2039_libmerged	3255321	3255322		YPO_RS15525	1
RV2039_libmerged	3255806	3255820		glrR	14
RV2039_libmerged	3256172	3256176		glrR	4
RV2039_libmerged	3256435	3256441		glrR	6
RV2039_libmerged	3256654	3256663		glrR	9
RV2039_libmerged	3259779	3259781		YPO_RS15545	2
RV2039_libmerged	3259824	3259838		YPO_RS15545	14
RV2039_libmerged	3259895	3259940		YPO_RS15545	45
RV2039_libmerged	3259995	3259999		YPO_RS15545	4
RV2039_libmerged	3260034	3260065		YPO_RS15545	31
RV2039_libmerged	3260111	3260208		YPO_RS15545	97
RV2039_libmerged	3260200	3260208		YPO_RS15550	8
RV2039_libmerged	3260350	3260351		YPO_RS15550	1
RV2039_libmerged	3261495	3261528		YPO_RS15555	33
RV2039_libmerged	3261865	3261871		YPO_RS15555	6
RV2039_libmerged	3262722	3262724		YPO_RS15560	2
RV2039_libmerged	3262844	3262845		YPO_RS15560	1
RV2039_libmerged	3265411	3265425		purL	14
RV2039_libmerged	3265853	3265857		purL	4
RV2039_libmerged	3267657	3267692		mltF	35
RV2039_libmerged	3270254	3270263		yfhb	9
RV2039_libmerged	3271460	3271479		murQ	19
RV2039_libmerged	3272545	3272550		YPO_RS15595	5
RV2039_libmerged	3272588	3272614		YPO_RS15595	26
RV2039_libmerged	3272883	3272889		YPO_RS15600	6
RV2039_libmerged	3273281	3273335		YPO_RS15605	54
RV2039_libmerged	3273391	3273490		YPO_RS15605	99
RV2039_libmerged	3273570	3273642		YPO_RS15605	72
RV2039_libmerged	3275153	3275264		YPO_RS15620	111
RV2039_libmerged	3275492	3275530		YPO_RS15620	38
RV2039_libmerged	3275561	3275653		YPO_RS15620	92
RV2039_libmerged	3275733	3275835		YPO_RS15620	102
RV2039_libmerged	3275975	3275994		YPO_RS15625	19
RV2039_libmerged	3276049	3276053		YPO_RS15625	4
RV2039_libmerged	3276356	3276386		YPO_RS15625	30
RV2039_libmerged	3276559	3276572		YPO_RS15625	13
RV2039_libmerged	3276635	3276700		YPO_RS15625	65
RV2039_libmerged	3276916	3276953		YPO_RS15625	37
RV2039_libmerged	3276741	3276874		YPO_RS15625	133
RV2039_libmerged	3278409	3278425		tssK	16
RV2039_libmerged	3278768	3278831		tssK	63
RV2039_libmerged	3279072	3279078		tssJ	6
RV2039_libmerged	3279866	3279883		YPO_RS15645	17
RV2039_libmerged	3280071	3280089		YPO_RS15645	18
RV2039_libmerged	3280278	3280284		YPO_RS15645	6
RV2039_libmerged	3280820	3280828		tssC	8
RV2039_libmerged	3281874	3281917		tssC	43
RV2039_libmerged	3282033	3282044		tssC	11
RV2039_libmerged	3282866	3282893		YPO_RS15660	27
RV2039_libmerged	3282935	3282961		YPO_RS15660	26
RV2039_libmerged	3283067	3283110		YPO_RS15660	43
RV2039_libmerged	3283204	3283215		YPO_RS15660	11
RV2039_libmerged	3284367	3284371		YPO_RS15665	4
RV2039_libmerged	3284464	3284527		YPO_RS15665	63
RV2039_libmerged	3284660	3284663		YPO_RS15670	3
RV2039_libmerged	3284716	3284717		YPO_RS15670	1
RV2039_libmerged	3284913	3284933		YPO_RS15670	20
RV2039_libmerged	3285347	3285356		YPO_RS15670	9
RV2039_libmerged	3285810	3285817		YPO_RS15675	7
RV2039_libmerged	3285852	3285893		YPO_RS15675	41
RV2039_libmerged	3286064	3286079		YPO_RS15675	15
RV2039_libmerged	3286861	3286877		YPO_RS15675	16
RV2039_libmerged	3287271	3287273		YPO_RS15675	2
RV2039_libmerged	3287490	3287554		YPO_RS15680	64
RV2039_libmerged	3288231	3288242		YPO_RS15680	11
RV2039_libmerged	3288498	3288540		YPO_RS15685	42
RV2039_libmerged	3288652	3288673		YPO_RS15685	21
RV2039_libmerged	3288767	3288771		YPO_RS15685	4
RV2039_libmerged	3288893	3288898		YPO_RS15685	5
RV2039_libmerged	3291067	3291080		tssH	13
RV2039_libmerged	3292837	3292863		tssF	26
RV2039_libmerged	3293630	3293632		tssF	2
RV2039_libmerged	3295311	3295333		tssG	22
RV2039_libmerged	3295638	3295685		YPO_RS15705	47
RV2039_libmerged	3296850	3296868		YPO_RS15710	18
RV2039_libmerged	3298758	3298805		YPO_RS15715	47
RV2039_libmerged	3299258	3299263		YPO_RS15720	5
RV2039_libmerged	3299979	3299980		YPO_RS15725	1
RV2039_libmerged	3300629	3300633		YPO_RS15725	4
RV2039_libmerged	3301209	3301213		YPO_RS15725	4
RV2039_libmerged	3301276	3301277		YPO_RS15725	1
RV2039_libmerged	3301715	3301728		YPO_RS15730	13
RV2039_libmerged	3302790	3302832		YPO_RS15735	42
RV2039_libmerged	3302895	3302928		YPO_RS15735	33
RV2039_libmerged	3304696	3304714		mltB	18
RV2039_libmerged	3306352	3306364		YPO_RS15745	12
RV2039_libmerged	3306643	3306644		YPO_RS15745	1
RV2039_libmerged	3307109	3307110		YPO_RS15750	1
RV2039_libmerged	3307637	3307639		YPO_RS15750	2
RV2039_libmerged	3307896	3307908		YPO_RS15750	12
RV2039_libmerged	3308321	3308329		YPO_RS15750	8
RV2039_libmerged	3309580	3309587		YPO_RS15760	7
RV2039_libmerged	3309681	3309688		YPO_RS15760	7
RV2039_libmerged	3310573	3310576		YPO_RS15765	3
RV2039_libmerged	3310629	3310650		YPO_RS15765	21
RV2039_libmerged	3310852	3310898		YPO_RS15765	46
RV2039_libmerged	3311197	3311199		YPO_RS15770	2
RV2039_libmerged	3311342	3311354		YPO_RS15770	12
RV2039_libmerged	3311470	3311540		YPO_RS15770	70
RV2039_libmerged	3311823	3311872		YPO_RS15770	49
RV2039_libmerged	3311978	3311989		YPO_RS15770	11
RV2039_libmerged	3313121	3313133		YPO_RS15775	12
RV2039_libmerged	3313199	3313241		YPO_RS15775	42
RV2039_libmerged	3313335	3313342		YPO_RS15775	7
RV2039_libmerged	3314282	3314306		YPO_RS15775	24
RV2039_libmerged	3314541	3314542		YPO_RS15775	1
RV2039_libmerged	3314658	3314690		YPO_RS15775	32
RV2039_libmerged	3315267	3315268		YPO_RS15775	1
RV2039_libmerged	3315280	3315314		dmsB	34
RV2039_libmerged	3315446	3315455		dmsB	9
RV2039_libmerged	3316114	3316116		YPO_RS15785	2
RV2039_libmerged	3317427	3317428		YPO_RS15790	1
RV2039_libmerged	3318304	3318319		YPO_RS15795	15
RV2039_libmerged	3319194	3319198		YPO_RS15800	4
RV2039_libmerged	3319799	3319821		YPO_RS15810	22
RV2039_libmerged	3319932	3319933		YPO_RS15810	1
RV2039_libmerged	3321799	3321811		YPO_RS15820	12
RV2039_libmerged	3321859	3321878		YPO_RS15820	19
RV2039_libmerged	3324442	3324445		YPO_RS15830	3
RV2039_libmerged	3324653	3324661		YPO_RS15830	8
RV2039_libmerged	3324870	3324899		YPO_RS15830	29
RV2039_libmerged	3328034	3328039		YPO_RS15850	5
RV2039_libmerged	3329463	3329481		YPO_RS15860	18
RV2039_libmerged	3330214	3330217		YPO_RS15860	3
RV2039_libmerged	3330552	3330557		YPO_RS15860	5
RV2039_libmerged	3331087	3331112		YPO_RS15865	25
RV2039_libmerged	3331362	3331363		YPO_RS15865	1
RV2039_libmerged	3335084	3335094		YPO_RS15905	10
RV2039_libmerged	3335152	3335164		YPO_RS15905	12
RV2039_libmerged	3335270	3335284		YPO_RS15905	14
RV2039_libmerged	3335451	3335480		YPO_RS15905	29
RV2039_libmerged	3335519	3335523		YPO_RS15905	4
RV2039_libmerged	3336298	3336303		YPO_RS15920	5
RV2039_libmerged	3339247	3339254		ligA	7
RV2039_libmerged	3339424	3339438		ligA	14
RV2039_libmerged	3340139	3340141		zipA	2
RV2039_libmerged	3341014	3341018		cysZ	4
RV2039_libmerged	3341199	3341213		cysZ	14
RV2039_libmerged	3342315	3342320		cysK	5
RV2039_libmerged	3342422	3342433		cysK	11
RV2039_libmerged	3343678	3343683		ptsI	5
RV2039_libmerged	3343717	3343721		ptsI	4
RV2039_libmerged	3344294	3344309		ptsI	15
RV2039_libmerged	3345011	3345034		ptsI	23
RV2039_libmerged	3345862	3345865		crr	3
RV2039_libmerged	3346120	3346170		YPO_RS15970	50
RV2039_libmerged	3346207	3346239		YPO_RS15970	32
RV2039_libmerged	3346309	3346310		YPO_RS15970	1
RV2039_libmerged	3346435	3346496		YPO_RS15970	61
RV2039_libmerged	3346875	3346876		YPO_RS15975	1
RV2039_libmerged	3347250	3347256		YPO_RS15975	6
RV2039_libmerged	3347708	3347715		YPO_RS15975	7
RV2039_libmerged	3350119	3350121		YPO_RS15985	2
RV2039_libmerged	3350258	3350283		YPO_RS15985	25
RV2039_libmerged	3350865	3350890		macB	25
RV2039_libmerged	3351051	3351068		macB	17
RV2039_libmerged	3351208	3351210		macB	2
RV2039_libmerged	3352580	3352593		YPO_RS15995	13
RV2039_libmerged	3352731	3352761		YPO_RS15995	30
RV2039_libmerged	3353393	3353405		YPO_RS15995	12
RV2039_libmerged	3354308	3354324		YPO_RS16000	16
RV2039_libmerged	3354430	3354439		YPO_RS16000	9
RV2039_libmerged	3355299	3355308		YPO_RS16000	9
RV2039_libmerged	3355454	3355498		YPO_RS16000	44
RV2039_libmerged	3355702	3355714		YPO_RS16000	12
RV2039_libmerged	3355900	3355910		YPO_RS16005	10
RV2039_libmerged	3356083	3356098		YPO_RS16010	15
RV2039_libmerged	3356172	3356216		YPO_RS16010	44
RV2039_libmerged	3357138	3357145		YPO_RS16015	7
RV2039_libmerged	3357268	3357269		YPO_RS16015	1
RV2039_libmerged	3358143	3358162		YPO_RS16020	19
RV2039_libmerged	3358313	3358317		YPO_RS16020	4
RV2039_libmerged	3358475	3358488		YPO_RS16020	13
RV2039_libmerged	3359357	3359363		YPO_RS16025	6
RV2039_libmerged	3360068	3360089		YPO_RS16025	21
RV2039_libmerged	3360272	3360283		YPO_RS16025	11
RV2039_libmerged	3361011	3361035		YPO_RS16030	24
RV2039_libmerged	3362019	3362026		YPO_RS16030	7
RV2039_libmerged	3362921	3362924		YPO_RS16035	3
RV2039_libmerged	3363112	3363115		YPO_RS16035	3
RV2039_libmerged	3363764	3363787		YPO_RS16040	23
RV2039_libmerged	3363952	3363970		YPO_RS16040	18
RV2039_libmerged	3364113	3364129		YPO_RS16040	16
RV2039_libmerged	3364214	3364239		YPO_RS16040	25
RV2039_libmerged	3366857	3366858		cysA	1
RV2039_libmerged	3367077	3367094		cysA	17
RV2039_libmerged	3369783	3369787		YPO_RS16065	4
RV2039_libmerged	3371101	3371103		YPO_RS16070	2
RV2039_libmerged	3371137	3371163		YPO_RS16070	26
RV2039_libmerged	3372632	3372637		YPO_RS16075	5
RV2039_libmerged	3373551	3373558		YPO_RS16080	7
RV2039_libmerged	3379527	3379550		YPO_RS16110	23
RV2039_libmerged	3380589	3380612		YPO_RS16115	23
RV2039_libmerged	3381105	3381133		yapL	28
RV2039_libmerged	3381421	3381429		yapL	8
RV2039_libmerged	3381792	3381806		yapL	14
RV2039_libmerged	3382038	3382044		yapL	6
RV2039_libmerged	3382485	3382502		yapL	17
RV2039_libmerged	3382849	3382854		yapL	5
RV2039_libmerged	3383553	3383587		YPO_RS16125	34
RV2039_libmerged	3383671	3383748		YPO_RS16125	77
RV2039_libmerged	3383807	3383824		YPO_RS16125	17
RV2039_libmerged	3385602	3385617		hemF	15
RV2039_libmerged	3389639	3389688		nudK	49
RV2039_libmerged	3390260	3390272		napC	12
RV2039_libmerged	3390907	3390910		napB	3
RV2039_libmerged	3395545	3395546		YPO_RS16180	1
RV2039_libmerged	3395608	3395612		YPO_RS16180	4
RV2039_libmerged	3399497	3399505		acrD	8
RV2039_libmerged	3399578	3399596		acrD	18
RV2039_libmerged	3399963	3399964		YPO_RS16195	1
RV2039_libmerged	3400220	3400224		YPO_RS16195	4
RV2039_libmerged	3400284	3400292		YPO_RS16195	8
RV2039_libmerged	3400342	3400360		YPO_RS16195	18
RV2039_libmerged	3402003	3402020		YPO_RS16205	17
RV2039_libmerged	3402600	3402693		YPO_RS16205	93
RV2039_libmerged	3402886	3402932		YPO_RS16205	46
RV2039_libmerged	3403145	3403173		YPO_RS16205	28
RV2039_libmerged	3403350	3403351		YPO_RS16210	1
RV2039_libmerged	3403886	3403893		YPO_RS16210	7
RV2039_libmerged	3404053	3404054		YPO_RS16210	1
RV2039_libmerged	3405239	3405249		YPO_RS16215	10
RV2039_libmerged	3405342	3405348		YPO_RS16215	6
RV2039_libmerged	3406183	3406185		YPO_RS16220	2
RV2039_libmerged	3406604	3406613		YPO_RS16225	9
RV2039_libmerged	3406887	3406889		YPO_RS16225	2
RV2039_libmerged	3407179	3407210		YPO_RS16225	31
RV2039_libmerged	3408077	3408082		YPO_RS16225	5
RV2039_libmerged	3409260	3409264		YPO_RS16230	4
RV2039_libmerged	3409363	3409401		YPO_RS16230	38
RV2039_libmerged	3414089	3414105		YPO_RS16260	16
RV2039_libmerged	3416863	3416866		purC	3
RV2039_libmerged	3417606	3417608		YPO_RS16280	2
RV2039_libmerged	3417677	3417707		YPO_RS16280	30
RV2039_libmerged	3417819	3417846		YPO_RS16280	27
RV2039_libmerged	3417899	3417904		YPO_RS16280	5
RV2039_libmerged	3417983	3418004		YPO_RS16280	21
RV2039_libmerged	3418728	3418729		bamC	1
RV2039_libmerged	3418747	3418795		bamC	48
RV2039_libmerged	3419592	3419624		dapA	32
RV2039_libmerged	3419855	3419877		dapA	22
RV2039_libmerged	3421059	3421061		bcp	2
RV2039_libmerged	3422070	3422075		YPO_RS16305	5
RV2039_libmerged	3422119	3422144		YPO_RS16305	25
RV2039_libmerged	3422337	3422353		YPO_RS16305	16
RV2039_libmerged	3422405	3422410		YPO_RS16305	5
RV2039_libmerged	3422757	3422765		YPO_RS16305	8
RV2039_libmerged	3423758	3423781		YPO_RS16310	23
RV2039_libmerged	3423903	3423904		YPO_RS16310	1
RV2039_libmerged	3424182	3424197		YPO_RS16310	15
RV2039_libmerged	3425053	3425070		YPO_RS16315	17
RV2039_libmerged	3425264	3425266		YPO_RS16315	2
RV2039_libmerged	3425738	3425756		YPO_RS16315	18
RV2039_libmerged	3426991	3427001		hda	10
RV2039_libmerged	3427832	3427891		YPO_RS16330	59
RV2039_libmerged	3428022	3428036		YPO_RS16330	14
RV2039_libmerged	3428067	3428091		YPO_RS16330	24
RV2039_libmerged	3428181	3428182		YPO_RS16330	1
RV2039_libmerged	3429929	3429950		cysS	21
RV2039_libmerged	3430215	3430260		ppiB	45
RV2039_libmerged	3430316	3430334		ppiB	18
RV2039_libmerged	3430585	3430590		ppiB	5
RV2039_libmerged	3430794	3430814		YPO_RS16345	20
RV2039_libmerged	3431283	3431284		YPO_RS16345	1
RV2039_libmerged	3431391	3431398		YPO_RS16345	7
RV2039_libmerged	3433682	3433689		YPO_RS16360	7
RV2039_libmerged	3434364	3434388		YPO_RS16360	24
RV2039_libmerged	3436132	3436143		YPO_RS16365	11
RV2039_libmerged	3436389	3436391		YPO_RS16365	2
RV2039_libmerged	3440517	3440542		YPO_RS16390	25
RV2039_libmerged	3441579	3441610		copA	31
RV2039_libmerged	3445035	3445036		YPO_RS16405	1
RV2039_libmerged	3445413	3445425		YPO_RS16405	12
RV2039_libmerged	3445561	3445567		YPO_RS16405	6
RV2039_libmerged	3446786	3446792		YPO_RS16415	6
RV2039_libmerged	3446824	3446837		YPO_RS16415	13
RV2039_libmerged	3447023	3447024		YPO_RS16415	1
RV2039_libmerged	3449319	3449328		YPO_RS16425	9
RV2039_libmerged	3449393	3449400		YPO_RS16425	7
RV2039_libmerged	3449441	3449457		YPO_RS16425	16
RV2039_libmerged	3449755	3449775		YPO_RS16425	20
RV2039_libmerged	3449914	3449933		YPO_RS16425	19
RV2039_libmerged	3451706	3451717		YPO_RS16430	11
RV2039_libmerged	3452385	3452386		YPO_RS16435	1
RV2039_libmerged	3453218	3453238		YPO_RS16435	20
RV2039_libmerged	3453963	3453979		fepE	16
RV2039_libmerged	3454036	3454064		fepE	28
RV2039_libmerged	3454367	3454389		fepE	22
RV2039_libmerged	3454657	3454682		fepE	25
RV2039_libmerged	3454839	3454847		fepE	8
RV2039_libmerged	3454942	3454961		fepE	19
RV2039_libmerged	3455055	3455056		cpsG	1
RV2039_libmerged	3455333	3455334		cpsG	1
RV2039_libmerged	3455592	3455612		cpsG	20
RV2039_libmerged	3456104	3456116		cpsG	12
RV2039_libmerged	3456181	3456188		cpsG	7
RV2039_libmerged	3456550	3456554		YPO_RS16450	4
RV2039_libmerged	3456647	3456657		YPO_RS16450	10
RV2039_libmerged	3456801	3456802		YPO_RS16450	1
RV2039_libmerged	3456992	3457008		YPO_RS16450	16
RV2039_libmerged	3457061	3457130		YPO_RS16450	69
RV2039_libmerged	3457228	3457232		YPO_RS16455	4
RV2039_libmerged	3458196	3458200		YPO_RS16455	4
RV2039_libmerged	3461065	3461096		YPO_RS16470	31
RV2039_libmerged	3461210	3461219		YPO_RS16470	9
RV2039_libmerged	3461361	3461434		YPO_RS16470	73
RV2039_libmerged	3461574	3461582		YPO_RS16470	8
RV2039_libmerged	3461627	3461677		YPO_RS16470	50
RV2039_libmerged	3461722	3461726		YPO_RS16470	4
RV2039_libmerged	3463388	3463402		YPO_RS16480	14
RV2039_libmerged	3463695	3463711		YPO_RS16480	16
RV2039_libmerged	3463769	3463793		YPO_RS16480	24
RV2039_libmerged	3464015	3464065		YPO_RS16480	50
RV2039_libmerged	3464165	3464203		YPO_RS16480	38
RV2039_libmerged	3464263	3464266		YPO_RS16480	3
RV2039_libmerged	3464405	3464409		YPO_RS16480	4
RV2039_libmerged	3464882	3464893		YPO_RS16485	11
RV2039_libmerged	3465297	3465336		YPO_RS16485	39
RV2039_libmerged	3465454	3465463		YPO_RS16485	9
RV2039_libmerged	3465848	3465860		YPO_RS16490	12
RV2039_libmerged	3466022	3466051		YPO_RS16490	29
RV2039_libmerged	3466225	3466242		YPO_RS16490	17
RV2039_libmerged	3466275	3466338		YPO_RS16490	63
RV2039_libmerged	3466447	3466466		YPO_RS16490	19
RV2039_libmerged	3466639	3466677		YPO_RS16490	38
RV2039_libmerged	3466784	3466831		YPO_RS16490	47
RV2039_libmerged	3466984	3467071		YPO_RS16495	87
RV2039_libmerged	3467121	3467139		YPO_RS16495	18
RV2039_libmerged	3467228	3467231		YPO_RS16495	3
RV2039_libmerged	3467463	3467506		YPO_RS16495	43
RV2039_libmerged	3468076	3468096		YPO_RS16495	20
RV2039_libmerged	3468287	3468325		YPO_RS16500	38
RV2039_libmerged	3468384	3468390		YPO_RS16500	6
RV2039_libmerged	3468603	3468606		YPO_RS16500	3
RV2039_libmerged	3468883	3468885		YPO_RS16500	2
RV2039_libmerged	3468933	3468939		YPO_RS16500	6
RV2039_libmerged	3468988	3469019		YPO_RS16500	31
RV2039_libmerged	3469220	3469233		rfbH	13
RV2039_libmerged	3470037	3470062		rfbH	25
RV2039_libmerged	3470235	3470239		rfbH	4
RV2039_libmerged	3470364	3470374		rfbH	10
RV2039_libmerged	3470493	3470566		rfbG	73
RV2039_libmerged	3470886	3470907		rfbG	21
RV2039_libmerged	3471605	3471621		rfbF	16
RV2039_libmerged	3471953	3471958		rfbF	5
RV2039_libmerged	3472047	3472072		rfbF	25
RV2039_libmerged	3472198	3472201		rfbF	3
RV2039_libmerged	3472263	3472269		rfbF	6
RV2039_libmerged	3472384	3472410		YPO_RS16520	26
RV2039_libmerged	3472548	3472555		YPO_RS16520	7
RV2039_libmerged	3472603	3472609		YPO_RS16520	6
RV2039_libmerged	3472864	3472927		YPO_RS16520	63
RV2039_libmerged	3473089	3473101		YPO_RS16520	12
RV2039_libmerged	3473264	3473279		YPO_RS16520	15
RV2039_libmerged	3474651	3474653		hemH	2
RV2039_libmerged	3475111	3475113		adk	2
RV2039_libmerged	3475474	3475509		adk	35
RV2039_libmerged	3476387	3476389		htpG	2
RV2039_libmerged	3476526	3476539		htpG	13
RV2039_libmerged	3476866	3476871		htpG	5
RV2039_libmerged	3477492	3477537		htpG	45
RV2039_libmerged	3482803	3482863		YPO_RS16560	60
RV2039_libmerged	3482937	3483034		YPO_RS16560	97
RV2039_libmerged	3483074	3483092		YPO_RS16560	18
RV2039_libmerged	3483158	3483180		YPO_RS16560	22
RV2039_libmerged	3483323	3483339		YPO_RS16560	16
RV2039_libmerged	3485781	3485784		rsmS	3
RV2039_libmerged	3487060	3487084		mscK	24
RV2039_libmerged	3487529	3487542		mscK	13
RV2039_libmerged	3487845	3487849		mscK	4
RV2039_libmerged	3488664	3488686		mscK	22
RV2039_libmerged	3489250	3489273		mscK	23
RV2039_libmerged	3490090	3490106		YPO_RS16590	16
RV2039_libmerged	3491353	3491373		YPO_RS16600	20
RV2039_libmerged	3491593	3491607		YPO_RS16600	14
RV2039_libmerged	3492637	3492674		YPO_RS16605	37
RV2039_libmerged	3493132	3493143		YPO_RS16605	11
RV2039_libmerged	3493179	3493208		YPO_RS16605	29
RV2039_libmerged	3494516	3494519		YPO_RS16605	3
RV2039_libmerged	3495091	3495096		YPO_RS16605	5
RV2039_libmerged	3495178	3495181		YPO_RS16605	3
RV2039_libmerged	3495909	3495914		rpmJ	5
RV2039_libmerged	3496788	3496803		YPO_RS16620	15
RV2039_libmerged	3497477	3497481		tomB	4
RV2039_libmerged	3497650	3497668		tomB	18
RV2039_libmerged	3500327	3500329		tesB	2
RV2039_libmerged	3500526	3500527		tesB	1
RV2039_libmerged	3500623	3500638		tesB	15
RV2039_libmerged	3504352	3504358		YPO_RS16665	6
RV2039_libmerged	3504779	3504791		YPO_RS16665	12
RV2039_libmerged	3504987	3504995		YPO_RS16665	8
RV2039_libmerged	3505183	3505197		YPO_RS16670	14
RV2039_libmerged	3505241	3505245		YPO_RS16670	4
RV2039_libmerged	3505862	3505876		YPO_RS16670	14
RV2039_libmerged	3506081	3506091		YPO_RS16670	10
RV2039_libmerged	3506390	3506396		YPO_RS16670	6
RV2039_libmerged	3507247	3507249		YPO_RS16675	2
RV2039_libmerged	3507415	3507416		YPO_RS16675	1
RV2039_libmerged	3507579	3507593		YPO_RS16680	14
RV2039_libmerged	3508011	3508021		YPO_RS16680	10
RV2039_libmerged	3509086	3509097		cof	11
RV2039_libmerged	3510083	3510085		YPO_RS16690	2
RV2039_libmerged	3510660	3510664		YPO_RS16690	4
RV2039_libmerged	3510837	3510863		YPO_RS16690	26
RV2039_libmerged	3511373	3511391		YPO_RS16690	18
RV2039_libmerged	3512409	3512423		queC	14
RV2039_libmerged	3512854	3512867		YPO_RS16700	13
RV2039_libmerged	3512908	3512911		YPO_RS16700	3
RV2039_libmerged	3513677	3513716		YPO_RS16705	39
RV2039_libmerged	3513936	3513940		ppiD	4
RV2039_libmerged	3514563	3514572		ppiD	9
RV2039_libmerged	3515407	3515408		ppiD	1
RV2039_libmerged	3516537	3516544		lon	7
RV2039_libmerged	3516665	3516690		lon	25
RV2039_libmerged	3517292	3517298		lon	6
RV2039_libmerged	3517588	3517594		lon	6
RV2039_libmerged	3519180	3519185		clpX	5
RV2039_libmerged	3519804	3519806		clpX	2
RV2039_libmerged	3520019	3520053		clpX	34
RV2039_libmerged	3521002	3521007		clpP	5
RV2039_libmerged	3522730	3522732		tig	2
RV2039_libmerged	3525490	3525491		ampG	1
RV2039_libmerged	3525643	3525660		ampG	17
RV2039_libmerged	3526967	3526974		YPO_RS16755	7
RV2039_libmerged	3527254	3527267		YPO_RS16755	13
RV2039_libmerged	3527966	3527968		cyoA	2
RV2039_libmerged	3528000	3528012		cyoA	12
RV2039_libmerged	3528267	3528276		cyoA	9
RV2039_libmerged	3528418	3528425		cyoA	7
RV2039_libmerged	3529591	3529605		cyoB	14
RV2039_libmerged	3529933	3529947		cyoB	14
RV2039_libmerged	3530006	3530019		cyoB	13
RV2039_libmerged	3531072	3531073		YPO_RS16770	1
RV2039_libmerged	3531539	3531552		cyoE	13
RV2039_libmerged	3531878	3531879		cyoE	1
RV2039_libmerged	3532305	3532308		cyoE	3
RV2039_libmerged	3532963	3532991		YPO_RS16785	28
RV2039_libmerged	3533161	3533163		YPO_RS16785	2
RV2039_libmerged	3533449	3533454		YPO_RS16785	5
RV2039_libmerged	3534887	3534889		YPO_RS16790	2
RV2039_libmerged	3535540	3535548		panE	8
RV2039_libmerged	3535681	3535686		panE	5
RV2039_libmerged	3536379	3536389		yajL	10
RV2039_libmerged	3537429	3537449		thiI	20
RV2039_libmerged	3539455	3539464		ispA	9
RV2039_libmerged	3540336	3540347		dxs	11
RV2039_libmerged	3541837	3541838		YPO_RS16825	1
RV2039_libmerged	3541956	3541961		YPO_RS16825	5
RV2039_libmerged	3542013	3542050		YPO_RS16825	37
RV2039_libmerged	3542108	3542115		YPO_RS16825	7
RV2039_libmerged	3542158	3542223		YPO_RS16825	65
RV2039_libmerged	3542687	3542714		pgpA	27
RV2039_libmerged	3543825	3543830		thiL	5
RV2039_libmerged	3544363	3544368		nusB	5
RV2039_libmerged	3545694	3545697		ribD	3
RV2039_libmerged	3545856	3545859		ribD	3
RV2039_libmerged	3546811	3546833		nrdR	22
RV2039_libmerged	3547464	3547480		YPO_RS16860	16
RV2039_libmerged	3547717	3547719		YPO_RS16865	2
RV2039_libmerged	3548035	3548086		YPO_RS16865	51
RV2039_libmerged	3548125	3548148		YPO_RS16865	23
RV2039_libmerged	3548297	3548298		YPO_RS16865	1
RV2039_libmerged	3548757	3548798		YPO_RS16870	41
RV2039_libmerged	3548878	3548935		YPO_RS16870	57
RV2039_libmerged	3549076	3549106		YPO_RS16870	30
RV2039_libmerged	3549501	3549506		secF	5
RV2039_libmerged	3550227	3550245		secF	18
RV2039_libmerged	3550375	3550385		secD	10
RV2039_libmerged	3550492	3550493		secD	1
RV2039_libmerged	3550699	3550702		secD	3
RV2039_libmerged	3550744	3550774		secD	30
RV2039_libmerged	3551109	3551116		secD	7
RV2039_libmerged	3551412	3551426		secD	14
RV2039_libmerged	3551636	3551637		secD	1
RV2039_libmerged	3552307	3552337		yajC	30
RV2039_libmerged	3552644	3552685		tgt	41
RV2039_libmerged	3552842	3552879		tgt	37
RV2039_libmerged	3554215	3554217		queA	2
RV2039_libmerged	3554439	3554447		queA	8
RV2039_libmerged	3555489	3555493		YPO_RS16900	4
RV2039_libmerged	3555621	3555636		YPO_RS16900	15
RV2039_libmerged	3556801	3556812		YPO_RS16910	11
RV2039_libmerged	3556863	3556898		YPO_RS16910	35
RV2039_libmerged	3556983	3557010		YPO_RS16910	27
RV2039_libmerged	3557100	3557164		YPO_RS16910	64
RV2039_libmerged	3559969	3559973		YPO_RS16920	4
RV2039_libmerged	3562938	3562953		proY	15
RV2039_libmerged	3563524	3563536		proY	12
RV2039_libmerged	3563738	3563757		proY	19
RV2039_libmerged	3565648	3565657		brnQ	9
RV2039_libmerged	3566559	3566566		YPO_RS16945	7
RV2039_libmerged	3568193	3568203		phoR	10
RV2039_libmerged	3568733	3568738		phoB	5
RV2039_libmerged	3569047	3569060		phoB	13
RV2039_libmerged	3569237	3569238		phoB	1
RV2039_libmerged	3569667	3569685		sbcD	18
RV2039_libmerged	3569791	3569800		sbcD	9
RV2039_libmerged	3571260	3571264		YPO_RS16965	4
RV2039_libmerged	3573073	3573087		YPO_RS16965	14
RV2039_libmerged	3573649	3573654		YPO_RS16965	5
RV2039_libmerged	3573934	3573946		YPO_RS16965	12
RV2039_libmerged	3574097	3574109		YPO_RS16965	12
RV2039_libmerged	3574407	3574441		YPO_RS16965	34
RV2039_libmerged	3574487	3574576		YPO_RS16970	89
RV2039_libmerged	3574654	3574663		YPO_RS16970	9
RV2039_libmerged	3574741	3574769		YPO_RS16970	28
RV2039_libmerged	3574822	3574825		YPO_RS16970	3
RV2039_libmerged	3574895	3574965		YPO_RS16970	70
RV2039_libmerged	3574995	3575017		YPO_RS16970	22
RV2039_libmerged	3575089	3575126		YPO_RS16970	37
RV2039_libmerged	3575181	3575182		YPO_RS16970	1
RV2039_libmerged	3575276	3575390		YPO_RS16975	114
RV2039_libmerged	3575598	3575610		YPO_RS16975	12
RV2039_libmerged	3575689	3575713		YPO_RS16975	24
RV2039_libmerged	3575877	3575888		YPO_RS16975	11
RV2039_libmerged	3576001	3576012		YPO_RS16975	11
RV2039_libmerged	3577139	3577142		mak	3
RV2039_libmerged	3577500	3577506		mak	6
RV2039_libmerged	3580191	3580192		aroL	1
RV2039_libmerged	3580480	3580521		aroL	41
RV2039_libmerged	3581156	3581183		YPO_RS17000	27
RV2039_libmerged	3581316	3581320		YPO_RS17000	4
RV2039_libmerged	3582251	3582260		YPO_RS17005	9
RV2039_libmerged	3582299	3582308		YPO_RS17005	9
RV2039_libmerged	3583265	3583270		YPO_RS17010	5
RV2039_libmerged	3584127	3584137		YPO_RS17015	10
RV2039_libmerged	3584839	3584876		proA	37
RV2039_libmerged	3585138	3585150		proA	12
RV2039_libmerged	3587842	3587857		frsA	15
RV2039_libmerged	3590082	3590100		YPO_RS17045	18
RV2039_libmerged	3590374	3590387		YPO_RS17050	13
RV2039_libmerged	3590805	3590815		YPO_RS17050	10
RV2039_libmerged	3590847	3590892		YPO_RS17050	45
RV2039_libmerged	3591818	3591820		YPO_RS17050	2
RV2039_libmerged	3592456	3592472		YPO_RS17055	16
RV2039_libmerged	3592662	3592698		YPO_RS17055	36
RV2039_libmerged	3592748	3592750		YPO_RS17055	2
RV2039_libmerged	3595941	3595957		pepD	16
RV2039_libmerged	3596180	3596199		pepD	19
RV2039_libmerged	3597509	3597510		dinB	1
RV2039_libmerged	3598294	3598295		YPO_RS17070	1
RV2039_libmerged	3598803	3598852		YPO_RS17070	49
RV2039_libmerged	3599603	3599636		YPO_RS17080	33
RV2039_libmerged	3599769	3599781		YPO_RS17080	12
RV2039_libmerged	3600441	3600446		YPO_RS17080	5
RV2039_libmerged	3600688	3600690		nqrF	2
RV2039_libmerged	3600826	3600835		nqrF	9
RV2039_libmerged	3601131	3601137		nqrF	6
RV2039_libmerged	3601966	3601968		nqrE	2
RV2039_libmerged	3602719	3602774		YPO_RS17095	55
RV2039_libmerged	3603219	3603224		YPO_RS17100	5
RV2039_libmerged	3604433	3604437		YPO_RS17105	4
RV2039_libmerged	3604587	3604592		YPO_RS17105	5
RV2039_libmerged	3604667	3604670		YPO_RS17105	3
RV2039_libmerged	3604889	3604892		YPO_RS17105	3
RV2039_libmerged	3606376	3606378		YPO_RS17110	2
RV2039_libmerged	3607101	3607114		YPO_RS17115	13
RV2039_libmerged	3607349	3607351		YPO_RS17115	2
RV2039_libmerged	3607436	3607439		YPO_RS17115	3
RV2039_libmerged	3607510	3607514		YPO_RS17115	4
RV2039_libmerged	3607820	3607827		YPO_RS17120	7
RV2039_libmerged	3609497	3609522		YPO_RS17130	25
RV2039_libmerged	3610905	3610926		YPO_RS17130	21
RV2039_libmerged	3612678	3612698		YPO_RS17135	20
RV2039_libmerged	3614097	3614102		YPO_RS17140	5
RV2039_libmerged	3614252	3614261		YPO_RS17140	9
RV2039_libmerged	3614363	3614371		YPO_RS17140	8
RV2039_libmerged	3614702	3614717		YPO_RS17140	15
RV2039_libmerged	3615052	3615059		YPO_RS17145	7
RV2039_libmerged	3616054	3616060		YPO_RS17145	6
RV2039_libmerged	3616659	3616665		YPO_RS17145	6
RV2039_libmerged	3616718	3616722		YPO_RS17145	4
RV2039_libmerged	3616928	3616932		YPO_RS17145	4
RV2039_libmerged	3617414	3617430		YPO_RS17145	16
RV2039_libmerged	3617838	3617855		YPO_RS17145	17
RV2039_libmerged	3618160	3618167		YPO_RS17145	7
RV2039_libmerged	3618210	3618220		YPO_RS17145	10
RV2039_libmerged	3618256	3618262		YPO_RS17145	6
RV2039_libmerged	3619184	3619190		YPO_RS17145	6
RV2039_libmerged	3619509	3619511		YPO_RS17145	2
RV2039_libmerged	3621139	3621174		YPO_RS17150	35
RV2039_libmerged	3621402	3621441		YPO_RS17150	39
RV2039_libmerged	3622407	3622435		YPO_RS17150	28
RV2039_libmerged	3624873	3624904		YPO_RS17165	31
RV2039_libmerged	3625259	3625274		YPO_RS17165	15
RV2039_libmerged	3625359	3625375		YPO_RS17170	16
RV2039_libmerged	3625499	3625551		YPO_RS17170	52
RV2039_libmerged	3625720	3625738		YPO_RS17170	18
RV2039_libmerged	3625772	3625800		YPO_RS17170	28
RV2039_libmerged	3625907	3625940		YPO_RS17170	33
RV2039_libmerged	3626009	3626051		YPO_RS17170	42
RV2039_libmerged	3626227	3626244		YPO_RS17170	17
RV2039_libmerged	3626307	3626333		YPO_RS17170	26
RV2039_libmerged	3626386	3626392		YPO_RS17175	6
RV2039_libmerged	3626549	3626567		YPO_RS17175	18
RV2039_libmerged	3626680	3626689		YPO_RS17175	9
RV2039_libmerged	3626754	3626771		YPO_RS17175	17
RV2039_libmerged	3627140	3627145		YPO_RS17175	5
RV2039_libmerged	3627196	3627215		YPO_RS17180	19
RV2039_libmerged	3627418	3627421		YPO_RS17180	3
RV2039_libmerged	3628722	3628723		YPO_RS17185	1
RV2039_libmerged	3628873	3628886		YPO_RS17185	13
RV2039_libmerged	3628878	3628886		YPO_RS17190	8
RV2039_libmerged	3630456	3630478		YPO_RS17200	22
RV2039_libmerged	3630924	3630953		YPO_RS17200	29
RV2039_libmerged	3632676	3632678		YPO_RS17215	2
RV2039_libmerged	3634182	3634184		hpxZ	2
RV2039_libmerged	3637513	3637518		mprA	5
RV2039_libmerged	3637915	3637924		mprA	9
RV2039_libmerged	3638492	3638506		emrA	14
RV2039_libmerged	3639467	3639477		emrA	10
RV2039_libmerged	3640774	3640794		emrB	20
RV2039_libmerged	3641446	3641454		YPO_RS17255	8
RV2039_libmerged	3642255	3642258		YPO_RS17255	3
RV2039_libmerged	3642620	3642621		trxC	1
RV2039_libmerged	3642966	3642974		trxC	8
RV2039_libmerged	3643010	3643042		trxC	32
RV2039_libmerged	3643736	3643737		YPO_RS17265	1
RV2039_libmerged	3644277	3644291		YPO_RS17270	14
RV2039_libmerged	3645334	3645347		YPO_RS17270	13
RV2039_libmerged	3646255	3646299		YPO_RS17270	44
RV2039_libmerged	3646566	3646579		YPO_RS17270	13
RV2039_libmerged	3647283	3647345		pssA	62
RV2039_libmerged	3647894	3647911		pssA	17
RV2039_libmerged	3648067	3648115		pssA	48
RV2039_libmerged	3649935	3649936		YPO_RS17290	1
RV2039_libmerged	3654695	3654718		clpB	23
RV2039_libmerged	3655189	3655197		clpB	8
RV2039_libmerged	3658197	3658200		rluD	3
RV2039_libmerged	3661042	3661147		YPO_RS17340	105
RV2039_libmerged	3661285	3661320		YPO_RS17340	35
RV2039_libmerged	3661404	3661458		YPO_RS17340	54
RV2039_libmerged	3662130	3662132		pheA	2
RV2039_libmerged	3662373	3662386		pheA	13
RV2039_libmerged	3662689	3662693		pheA	4
RV2039_libmerged	3662814	3662820		YPO_RS17350	6
RV2039_libmerged	3662874	3663002		YPO_RS17350	128
RV2039_libmerged	3663205	3663283		YPO_RS17350	78
RV2039_libmerged	3663469	3663499		YPO_RS17350	30
RV2039_libmerged	3663547	3663582		YPO_RS17350	35
RV2039_libmerged	3663715	3663789		YPO_RS17350	74
RV2039_libmerged	3663907	3663933		YPO_RS17355	26
RV2039_libmerged	3664026	3664104		YPO_RS17355	78
RV2039_libmerged	3664136	3664224		YPO_RS17355	88
RV2039_libmerged	3664283	3664289		YPO_RS17355	6
RV2039_libmerged	3664432	3664456		YPO_RS17355	24
RV2039_libmerged	3664554	3664582		YPO_RS17355	28
RV2039_libmerged	3666456	3666484		YPO_RS17370	28
RV2039_libmerged	3667925	3667933		yehT	8
RV2039_libmerged	3671728	3671755		YPO_RS17390	27
RV2039_libmerged	3672310	3672318		rplS	8
RV2039_libmerged	3672562	3672575		trmD	13
RV2039_libmerged	3676097	3676098		YPO_RS17420	1
RV2039_libmerged	3676232	3676241		YPO_RS17420	9
RV2039_libmerged	3676622	3676631		YPO_RS17425	9
RV2039_libmerged	3677200	3677249		YPO_RS17425	49
RV2039_libmerged	3677530	3677531		YPO_RS17425	1
RV2039_libmerged	3678161	3678184		YPO_RS17430	23
RV2039_libmerged	3678233	3678238		YPO_RS17430	5
RV2039_libmerged	3678298	3678319		YPO_RS17430	21
RV2039_libmerged	3678485	3678487		YPO_RS17430	2
RV2039_libmerged	3679035	3679039		luxS	4
RV2039_libmerged	3679163	3679199		luxS	36
RV2039_libmerged	3679771	3679777		gshA	6
RV2039_libmerged	3680043	3680065		gshA	22
RV2039_libmerged	3680491	3680495		gshA	4
RV2039_libmerged	3680735	3680739		gshA	4
RV2039_libmerged	3681019	3681022		YPO_RS17445	3
RV2039_libmerged	3681724	3681728		yqaB	4
RV2039_libmerged	3681987	3682010		yqaB	23
RV2039_libmerged	3682382	3682386		YPO_RS17455	4
RV2039_libmerged	3683911	3683937		alaS	26
RV2039_libmerged	3684584	3684591		alaS	7
RV2039_libmerged	3684742	3684761		alaS	19
RV2039_libmerged	3685137	3685140		alaS	3
RV2039_libmerged	3685276	3685282		alaS	6
RV2039_libmerged	3685948	3685952		alaS	4
RV2039_libmerged	3685985	3685990		alaS	5
RV2039_libmerged	3686518	3686533		recX	15
RV2039_libmerged	3686842	3686844		recX	2
RV2039_libmerged	3687411	3687416		recA	5
RV2039_libmerged	3687933	3687936		recA	3
RV2039_libmerged	3689241	3689273		YPO_RS17505	32
RV2039_libmerged	3690498	3690508		YPO_RS17505	10
RV2039_libmerged	3690918	3690961		YPO_RS17510	43
RV2039_libmerged	3691113	3691138		YPO_RS17510	25
RV2039_libmerged	3691942	3691959		YPO_RS17515	17
RV2039_libmerged	3692156	3692157		YPO_RS17515	1
RV2039_libmerged	3695346	3695378		YPO_RS17525	32
RV2039_libmerged	3696061	3696072		YPO_RS17530	11
RV2039_libmerged	3698738	3698742		YPO_RS17540	4
RV2039_libmerged	3699789	3699790		YPO_RS17545	1
RV2039_libmerged	3700032	3700037		YPO_RS17545	5
RV2039_libmerged	3700479	3700491		YPO_RS17550	12
RV2039_libmerged	3701913	3701952		katG	39
RV2039_libmerged	3702339	3702343		katG	4
RV2039_libmerged	3702637	3702707		katG	70
RV2039_libmerged	3702803	3702848		katG	45
RV2039_libmerged	3703001	3703012		katG	11
RV2039_libmerged	3704386	3704404		cybC	18
RV2039_libmerged	3704585	3704589		cybB	4
RV2039_libmerged	3704965	3704977		cybB	12
RV2039_libmerged	3705389	3705392		dmsD	3
RV2039_libmerged	3706605	3706612		YPO_RS17575	7
RV2039_libmerged	3707993	3707994		dmsA	1
RV2039_libmerged	3708059	3708066		dmsA	7
RV2039_libmerged	3708820	3708845		dmsA	25
RV2039_libmerged	3708890	3708895		dmsA	5
RV2039_libmerged	3709218	3709225		dmsA	7
RV2039_libmerged	3709835	3709842		dmsA	7
RV2039_libmerged	3711089	3711133		YPO_RS17590	44
RV2039_libmerged	3713096	3713114		YPO_RS17600	18
RV2039_libmerged	3713611	3713612		YPO_RS17600	1
RV2039_libmerged	3713695	3713696		YPO_RS17600	1
RV2039_libmerged	3714227	3714342		YPO_RS17605	115
RV2039_libmerged	3714435	3714483		YPO_RS17605	48
RV2039_libmerged	3714542	3714593		YPO_RS17605	51
RV2039_libmerged	3714658	3714685		YPO_RS17605	27
RV2039_libmerged	3715017	3715030		YPO_RS17610	13
RV2039_libmerged	3715447	3715462		YPO_RS17610	15
RV2039_libmerged	3716259	3716268		YPO_RS17610	9
RV2039_libmerged	3716709	3716734		YPO_RS17615	25
RV2039_libmerged	3717756	3717760		YPO_RS17620	4
RV2039_libmerged	3721876	3721880		YPO_RS17635	4
RV2039_libmerged	3721966	3721970		YPO_RS17635	4
RV2039_libmerged	3722317	3722321		YPO_RS17635	4
RV2039_libmerged	3722889	3722904		YPO_RS17635	15
RV2039_libmerged	3722955	3722958		YPO_RS17635	3
RV2039_libmerged	3723200	3723209		YPO_RS17640	9
RV2039_libmerged	3723677	3723678		map	1
RV2039_libmerged	3723983	3724014		map	31
RV2039_libmerged	3724739	3724758		YPO_RS17650	19
RV2039_libmerged	3724947	3724952		YPO_RS17650	5
RV2039_libmerged	3725195	3725220		YPO_RS17650	25
RV2039_libmerged	3725277	3725304		YPO_RS17650	27
RV2039_libmerged	3725459	3725462		YPO_RS17650	3
RV2039_libmerged	3725494	3725518		YPO_RS17650	24
RV2039_libmerged	3725606	3725646		YPO_RS17650	40
RV2039_libmerged	3728601	3728637		YPO_RS17660	36
RV2039_libmerged	3729016	3729027		YPO_RS17665	11
RV2039_libmerged	3729233	3729237		YPO_RS17665	4
RV2039_libmerged	3730147	3730151		YPO_RS17665	4
RV2039_libmerged	3730189	3730195		YPO_RS17665	6
RV2039_libmerged	3730695	3730701		YPO_RS17670	6
RV2039_libmerged	3730800	3730877		YPO_RS17670	77
RV2039_libmerged	3730930	3730969		YPO_RS17670	39
RV2039_libmerged	3731673	3731709		YPO_RS17675	36
RV2039_libmerged	3733762	3733767		arsB	5
RV2039_libmerged	3733854	3733862		arsB	8
RV2039_libmerged	3735253	3735256		YPO_RS17695	3
RV2039_libmerged	3735935	3735941		dhaL	6
RV2039_libmerged	3736163	3736174		dhaL	11
RV2039_libmerged	3736607	3736618		YPO_RS17705	11
RV2039_libmerged	3736701	3736716		YPO_RS17705	15
RV2039_libmerged	3742748	3742762		mutS	14
RV2039_libmerged	3743131	3743154		mutS	23
RV2039_libmerged	3743526	3743545		mutS	19
RV2039_libmerged	3743630	3743638		mutS	8
RV2039_libmerged	3744566	3744571		rpoS	5
RV2039_libmerged	3744714	3744715		rpoS	1
RV2039_libmerged	3745178	3745207		rpoS	29
RV2039_libmerged	3745701	3745707		nlpD	6
RV2039_libmerged	3746042	3746046		nlpD	4
RV2039_libmerged	3746931	3746939		YPO_RS17740	8
RV2039_libmerged	3746975	3746980		YPO_RS17740	5
RV2039_libmerged	3747056	3747069		surE	13
RV2039_libmerged	3747994	3747995		truD	1
RV2039_libmerged	3748787	3748794		truD	7
RV2039_libmerged	3751309	3751377		cysC	68
RV2039_libmerged	3751521	3751525		cysC	4
RV2039_libmerged	3752786	3752787		cysN	1
RV2039_libmerged	3753892	3753894		cysD	2
RV2039_libmerged	3754056	3754070		cysD	14
RV2039_libmerged	3756528	3756558		YPO_RS17800	30
RV2039_libmerged	3759554	3759576		cysI	22
RV2039_libmerged	3759861	3759864		cysI	3
RV2039_libmerged	3760167	3760176		cysJ	9
RV2039_libmerged	3760874	3760876		cysJ	2
RV2039_libmerged	3761574	3761575		cysJ	1
RV2039_libmerged	3763894	3763931		YPO_RS17840	37
RV2039_libmerged	3764639	3764641		eno	2
RV2039_libmerged	3765329	3765331		eno	2
RV2039_libmerged	3769290	3769292		relA	2
RV2039_libmerged	3769555	3769583		relA	28
RV2039_libmerged	3771448	3771453		barA	5
RV2039_libmerged	3771653	3771657		barA	4
RV2039_libmerged	3771767	3771785		barA	18
RV2039_libmerged	3773093	3773104		barA	11
RV2039_libmerged	3773181	3773185		barA	4
RV2039_libmerged	3773308	3773313		barA	5
RV2039_libmerged	3775774	3775798		degP	24
RV2039_libmerged	3776285	3776317		dgt	32
RV2039_libmerged	3780732	3780752		clcA	20
RV2039_libmerged	3781335	3781382		clcA	47
RV2039_libmerged	3781415	3781423		clcA	8
RV2039_libmerged	3781455	3781469		clcA	14
RV2039_libmerged	3782051	3782052		clcA	1
RV2039_libmerged	3782740	3782748		hemL	8
RV2039_libmerged	3785688	3785689		fhuB	1
RV2039_libmerged	3789864	3789872		mrcB	8
RV2039_libmerged	3789983	3789992		mrcB	9
RV2039_libmerged	3796103	3796110		gluQRS	7
RV2039_libmerged	3796782	3796788		gluQRS	6
RV2039_libmerged	3797938	3797944		pcnB	6
RV2039_libmerged	3798138	3798144		pcnB	6
RV2039_libmerged	3800170	3800177		panC	7
RV2039_libmerged	3801976	3802003		YPO_RS17990	27
RV2039_libmerged	3802098	3802101		YPO_RS17990	3
RV2039_libmerged	3802188	3802199		YPO_RS17990	11
RV2039_libmerged	3802257	3802299		YPO_RS17990	42
RV2039_libmerged	3802421	3802425		YPO_RS17990	4
RV2039_libmerged	3802549	3802551		YPO_RS17990	2
RV2039_libmerged	3802948	3802966		YPO_RS17990	18
RV2039_libmerged	3803085	3803136		YPO_RS17990	51
RV2039_libmerged	3803427	3803438		YPO_RS17995	11
RV2039_libmerged	3803503	3803511		YPO_RS17995	8
RV2039_libmerged	3803704	3803716		YPO_RS17995	12
RV2039_libmerged	3804148	3804151		YPO_RS17995	3
RV2039_libmerged	3804790	3804793		YPO_RS18000	3
RV2039_libmerged	3804878	3804889		YPO_RS18000	11
RV2039_libmerged	3806371	3806391		hpt	20
RV2039_libmerged	3806553	3806565		hpt	12
RV2039_libmerged	3808290	3808298		cueO	8
RV2039_libmerged	3809054	3809055		YPO_RS18020	1
RV2039_libmerged	3809899	3809927		speE	28
RV2039_libmerged	3810832	3810853		speD	21
RV2039_libmerged	3811629	3811647		YPO_RS18035	18
RV2039_libmerged	3812144	3812189		YPO_RS18035	45
RV2039_libmerged	3812327	3812332		YPO_RS18035	5
RV2039_libmerged	3813500	3813503		acnB	3
RV2039_libmerged	3816327	3816354		YPO_RS18050	27
RV2039_libmerged	3816429	3816465		YPO_RS18050	36
RV2039_libmerged	3816543	3816584		YPO_RS18050	41
RV2039_libmerged	3816702	3816732		YPO_RS18050	30
RV2039_libmerged	3816779	3816785		YPO_RS18050	6
RV2039_libmerged	3817060	3817064		lpdA	4
RV2039_libmerged	3817877	3817885		lpdA	8
RV2039_libmerged	3819128	3819135		aceF	7
RV2039_libmerged	3820562	3820592		aceE	30
RV2039_libmerged	3821722	3821737		aceE	15
RV2039_libmerged	3821790	3821792		aceE	2
RV2039_libmerged	3822441	3822450		aceE	9
RV2039_libmerged	3826085	3826087		YPO_RS18075	2
RV2039_libmerged	3827014	3827029		ampE	15
RV2039_libmerged	3827300	3827317		ampE	17
RV2039_libmerged	3827436	3827441		ampE	5
RV2039_libmerged	3828900	3828917		nadC	17
RV2039_libmerged	3829102	3829103		nadC	1
RV2039_libmerged	3829912	3829923		ppdD	11
RV2039_libmerged	3830596	3830614		gspE	18
RV2039_libmerged	3830665	3830667		gspE	2
RV2039_libmerged	3830754	3830757		gspE	3
RV2039_libmerged	3830881	3830908		gspE	27
RV2039_libmerged	3831098	3831101		gspE	3
RV2039_libmerged	3831234	3831239		gspE	5
RV2039_libmerged	3832049	3832062		hofC	13
RV2039_libmerged	3832271	3832278		hofC	7
RV2039_libmerged	3834478	3834489		coaE	11
RV2039_libmerged	3834722	3834744		coaE	22
RV2039_libmerged	3835043	3835049		coaE	6
RV2039_libmerged	3835096	3835098		coaE	2
RV2039_libmerged	3835096	3835129		zapD	33
RV2039_libmerged	3835479	3835496		zapD	17
RV2039_libmerged	3836209	3836222		yacG	13
RV2039_libmerged	3836545	3836547		YPO_RS18130	2
RV2039_libmerged	3836771	3836779		YPO_RS18130	8
RV2039_libmerged	3836813	3836829		YPO_RS18130	16
RV2039_libmerged	3836998	3837020		YPO_RS18135	22
RV2039_libmerged	3837164	3837182		YPO_RS18135	18
RV2039_libmerged	3837328	3837336		YPO_RS18135	8
RV2039_libmerged	3837405	3837407		YPO_RS18135	2
RV2039_libmerged	3837463	3837503		YPO_RS18135	40
RV2039_libmerged	3837565	3837599		YPO_RS18135	34
RV2039_libmerged	3837691	3837707		YPO_RS18135	16
RV2039_libmerged	3837892	3837947		YPO_RS18135	55
RV2039_libmerged	3837986	3838020		YPO_RS18135	34
RV2039_libmerged	3838020	3838031		YPO_RS18140	11
RV2039_libmerged	3838092	3838125		YPO_RS18140	33
RV2039_libmerged	3838322	3838446		YPO_RS18140	124
RV2039_libmerged	3838705	3838715		YPO_RS18140	10
RV2039_libmerged	3838772	3838792		YPO_RS18140	20
RV2039_libmerged	3838859	3838869		YPO_RS18145	10
RV2039_libmerged	3840208	3840218		YPO_RS18150	10
RV2039_libmerged	3840779	3840787		YPO_RS18150	8
RV2039_libmerged	3841402	3841416		YPO_RS18150	14
RV2039_libmerged	3841804	3841815		YPO_RS18150	11
RV2039_libmerged	3841846	3841861		YPO_RS18150	15
RV2039_libmerged	3843919	3843920		lptG	1
RV2039_libmerged	3843964	3843967		lptG	3
RV2039_libmerged	3846877	3846901		pepA	24
RV2039_libmerged	3849516	3849524		YPO_RS18185	8
RV2039_libmerged	3850903	3850905		YPO_RS18185	2
RV2039_libmerged	3851547	3851576		YPO_RS18190	29
RV2039_libmerged	3852490	3852496		rraB	6
RV2039_libmerged	3853000	3853035		argF	35
RV2039_libmerged	3854442	3854443		YPO_RS18205	1
RV2039_libmerged	3857021	3857035		YPO_RS18215	14
RV2039_libmerged	3857626	3857635		YPO_RS18215	9
RV2039_libmerged	3859143	3859155		YPO_RS18225	12
RV2039_libmerged	3859661	3859667		YPO_RS18225	6
RV2039_libmerged	3859713	3859715		YPO_RS18225	2
RV2039_libmerged	3860948	3860952		nrdD	4
RV2039_libmerged	3867952	3868003		phnK	51
RV2039_libmerged	3869422	3869430		phnL	8
RV2039_libmerged	3870215	3870219		phnM	4
RV2039_libmerged	3873405	3873417		YPO_RS18300	12
RV2039_libmerged	3873807	3873809		YPO_RS18305	2
RV2039_libmerged	3873849	3873874		YPO_RS18305	25
RV2039_libmerged	3873909	3873911		YPO_RS18305	2
RV2039_libmerged	3875203	3875213		ugpC	10
RV2039_libmerged	3875999	3876013		YPO_RS18315	14
RV2039_libmerged	3876781	3876788		YPO_RS18320	7
RV2039_libmerged	3877386	3877391		YPO_RS18320	5
RV2039_libmerged	3877853	3877860		YPO_RS18325	7
RV2039_libmerged	3878776	3878779		YPO_RS18325	3
RV2039_libmerged	3878871	3878909		YPO_RS18325	38
RV2039_libmerged	3879515	3879533		YPO_RS18330	18
RV2039_libmerged	3879624	3879667		YPO_RS18330	43
RV2039_libmerged	3879819	3879826		YPO_RS18330	7
RV2039_libmerged	3880166	3880182		YPO_RS18330	16
RV2039_libmerged	3880592	3880600		YPO_RS18330	8
RV2039_libmerged	3880680	3880713		YPO_RS18330	33
RV2039_libmerged	3883011	3883020		YPO_RS18340	9
RV2039_libmerged	3883548	3883550		YPO_RS18345	2
RV2039_libmerged	3883647	3883652		YPO_RS18345	5
RV2039_libmerged	3884282	3884291		YPO_RS18350	9
RV2039_libmerged	3885014	3885023		YPO_RS18355	9
RV2039_libmerged	3885426	3885432		YPO_RS18355	6
RV2039_libmerged	3885515	3885522		YPO_RS18355	7
RV2039_libmerged	3887728	3887739		YPO_RS18365	11
RV2039_libmerged	3887849	3887854		YPO_RS18365	5
RV2039_libmerged	3888219	3888241		YPO_RS18365	22
RV2039_libmerged	3888412	3888413		YPO_RS18370	1
RV2039_libmerged	3889107	3889122		YPO_RS18370	15
RV2039_libmerged	3889191	3889192		YPO_RS18370	1
RV2039_libmerged	3890182	3890183		YPO_RS18370	1
RV2039_libmerged	3890870	3890879		YPO_RS18370	9
RV2039_libmerged	3892261	3892263		YPO_RS18375	2
RV2039_libmerged	3893575	3893579		YPO_RS18380	4
RV2039_libmerged	3894583	3894588		YPO_RS18390	5
RV2039_libmerged	3894798	3894804		YPO_RS18395	6
RV2039_libmerged	3897785	3897796		nlpI	11
RV2039_libmerged	3898875	3898920		pnp	45
RV2039_libmerged	3899458	3899467		pnp	9
RV2039_libmerged	3899609	3899610		pnp	1
RV2039_libmerged	3900945	3901045		YPO_RS18420	100
RV2039_libmerged	3902791	3902793		truB	2
RV2039_libmerged	3905025	3905053		infB	28
RV2039_libmerged	3905782	3905786		infB	4
RV2039_libmerged	3907205	3907229		nusA	24
RV2039_libmerged	3908425	3908430		rimP	5
RV2039_libmerged	3910567	3910584		glmM	17
RV2039_libmerged	3910888	3910909		glmM	21
RV2039_libmerged	3911054	3911096		glmM	42
RV2039_libmerged	3913096	3913100		ftsH	4
RV2039_libmerged	3913931	3913935		ftsH	4
RV2039_libmerged	3913970	3913976		ftsH	6
RV2039_libmerged	3914646	3914667		rlmE	21
RV2039_libmerged	3916502	3916504		dacB	2
RV2039_libmerged	3918748	3918756		pmrB	8
RV2039_libmerged	3919049	3919054		pmrB	5
RV2039_libmerged	3919166	3919169		pmrB	3
RV2039_libmerged	3920835	3920840		YPO_RS18520	5
RV2039_libmerged	3922522	3922528		ispB	6
RV2039_libmerged	3923662	3923679		YPO_RS18540	17
RV2039_libmerged	3925323	3925338		mdh	15
RV2039_libmerged	3925580	3925586		mdh	6
RV2039_libmerged	3929679	3929687		fbp	8
RV2039_libmerged	3930543	3930560		ppa	17
RV2039_libmerged	3931160	3931173		YPO_RS18580	13
RV2039_libmerged	3931468	3931487		YPO_RS18585	19
RV2039_libmerged	3931542	3931546		YPO_RS18585	4
RV2039_libmerged	3932821	3932835		YPO_RS18585	14
RV2039_libmerged	3934895	3934912		YPO_RS18585	17
RV2039_libmerged	3934999	3935030		YPO_RS18585	31
RV2039_libmerged	3936437	3936443		YPO_RS18590	6
RV2039_libmerged	3937402	3937404		msrA	2
RV2039_libmerged	3938630	3938640		YPO_RS18600	10
RV2039_libmerged	3939155	3939161		YPO_RS18600	6
RV2039_libmerged	3940211	3940231		YPO_RS18610	20
RV2039_libmerged	3941141	3941154		cysQ	13
RV2039_libmerged	3942054	3942067		YPO_RS18620	13
RV2039_libmerged	3942257	3942264		YPO_RS18620	7
RV2039_libmerged	3943686	3943694		YPO_RS18620	8
RV2039_libmerged	3944298	3944310		ytfE	12
RV2039_libmerged	3946231	3946234		YPO_RS18635	3
RV2039_libmerged	3946970	3946991		YPO_RS18640	21
RV2039_libmerged	3947246	3947278		YPO_RS18645	32
RV2039_libmerged	3947328	3947342		YPO_RS18645	14
RV2039_libmerged	3947384	3947407		YPO_RS18645	23
RV2039_libmerged	3947487	3947515		YPO_RS18645	28
RV2039_libmerged	3947663	3947704		YPO_RS18645	41
RV2039_libmerged	3949312	3949317		rpsF	5
RV2039_libmerged	3950382	3950410		yjfP	28
RV2039_libmerged	3950467	3950483		YPO_RS18675	16
RV2039_libmerged	3950515	3950522		YPO_RS18675	7
RV2039_libmerged	3950561	3950577		YPO_RS18675	16
RV2039_libmerged	3950637	3950674		YPO_RS18675	37
RV2039_libmerged	3950755	3950806		YPO_RS18675	51
RV2039_libmerged	3950845	3950856		YPO_RS18675	11
RV2039_libmerged	3950971	3950981		YPO_RS18675	10
RV2039_libmerged	3951374	3951378		YPO_RS18675	4
RV2039_libmerged	3951433	3951458		YPO_RS18675	25
RV2039_libmerged	3951587	3951631		YPO_RS18680	44
RV2039_libmerged	3951741	3951810		YPO_RS18680	69
RV2039_libmerged	3951869	3951996		YPO_RS18680	127
RV2039_libmerged	3952129	3952268		YPO_RS18680	139
RV2039_libmerged	3955840	3955854		rnpB	14
RV2039_libmerged	3956463	3956504		rsmI	41
RV2039_libmerged	3957617	3957636		YPO_RS18710	19
RV2039_libmerged	3957666	3957679		YPO_RS18710	13
RV2039_libmerged	3958454	3958466		YPO_RS18710	12
RV2039_libmerged	3958519	3958527		YPO_RS18710	8
RV2039_libmerged	3960401	3960431		yraP	30
RV2039_libmerged	3961839	3961843		mtgA	4
RV2039_libmerged	3963125	3963128		arcB	3
RV2039_libmerged	3963170	3963197		arcB	27
RV2039_libmerged	3963393	3963427		arcB	34
RV2039_libmerged	3969371	3969378		gltB	7
RV2039_libmerged	3970562	3970567		gltB	5
RV2039_libmerged	3971276	3971279		gltB	3
RV2039_libmerged	3973469	3973486		YPO_RS18760	17
RV2039_libmerged	3973783	3973816		YPO_RS18760	33
RV2039_libmerged	3975579	3975582		YPO_RS18775	3
RV2039_libmerged	3976462	3976478		rplM	16
RV2039_libmerged	3976823	3976837		YPO_RS18790	14
RV2039_libmerged	3977237	3977257		YPO_RS18790	20
RV2039_libmerged	3978425	3978438		YPO_RS18795	13
RV2039_libmerged	3980510	3980515		YPO_RS18805	5
RV2039_libmerged	3980555	3980653		YPO_RS18805	98
RV2039_libmerged	3980698	3980733		YPO_RS18805	35
RV2039_libmerged	3980764	3980766		YPO_RS18805	2
RV2039_libmerged	3981262	3981270		degS	8
RV2039_libmerged	3982843	3982856		murA	13
RV2039_libmerged	3983337	3983346		murA	9
RV2039_libmerged	3983860	3983873		ibaG	13
RV2039_libmerged	3983911	3983921		ibaG	10
RV2039_libmerged	3984254	3984261		mlaB	7
RV2039_libmerged	3984789	3984808		mlaC	19
RV2039_libmerged	3985670	3985673		mlaE	3
RV2039_libmerged	3987726	3987745		YPO_RS18850	19
RV2039_libmerged	3990685	3990688		lptC	3
RV2039_libmerged	3991279	3991284		lptA	5
RV2039_libmerged	3992224	3992227		lptB	3
RV2039_libmerged	3993089	3993092		rpoN	3
RV2039_libmerged	3993398	3993402		rpoN	4
RV2039_libmerged	3993489	3993516		rpoN	27
RV2039_libmerged	3995290	3995323		rapZ	33
RV2039_libmerged	3995625	3995635		rapZ	10
RV2039_libmerged	3997765	3997778		YPO_RS18910	13
RV2039_libmerged	3997982	3997985		YPO_RS18910	3
RV2039_libmerged	3998850	3998865		YPO_RS18920	15
RV2039_libmerged	3999036	3999063		YPO_RS18920	27
RV2039_libmerged	3999102	3999127		YPO_RS18920	25
RV2039_libmerged	3999288	3999300		YPO_RS18920	12
RV2039_libmerged	3999391	3999433		YPO_RS18920	42
RV2039_libmerged	3999494	3999562		YPO_RS18920	68
RV2039_libmerged	3999799	3999830		YPO_RS18920	31
RV2039_libmerged	3999972	4000021		YPO_RS18925	49
RV2039_libmerged	4000059	4000060		YPO_RS18925	1
RV2039_libmerged	4000236	4000277		YPO_RS18925	41
RV2039_libmerged	4000322	4000376		YPO_RS18925	54
RV2039_libmerged	4000526	4000633		YPO_RS18925	107
RV2039_libmerged	4001348	4001357		YPO_RS18935	9
RV2039_libmerged	4003204	4003208		tagH	4
RV2039_libmerged	4005656	4005696		tssK	40
RV2039_libmerged	4006312	4006333		YPO_RS18960	21
RV2039_libmerged	4007594	4007600		tssH	6
RV2039_libmerged	4008011	4008022		tssH	11
RV2039_libmerged	4009493	4009505		YPO_RS18970	12
RV2039_libmerged	4010606	4010624		tagO	18
RV2039_libmerged	4011010	4011032		tssA	22
RV2039_libmerged	4011272	4011277		tssA	5
RV2039_libmerged	4013808	4013812		tssM	4
RV2039_libmerged	4013857	4013858		tssM	1
RV2039_libmerged	4014000	4014051		tssM	51
RV2039_libmerged	4015255	4015271		tssM	16
RV2039_libmerged	4021238	4021243		YPO_RS19010	5
RV2039_libmerged	4021524	4021532		YPO_RS19010	8
RV2039_libmerged	4022120	4022147		YPO_RS19010	27
RV2039_libmerged	4023269	4023272		YPO_RS19015	3
RV2039_libmerged	4023958	4023962		YPO_RS19015	4
RV2039_libmerged	4024686	4024688		YPO_RS19020	2
RV2039_libmerged	4024753	4024787		YPO_RS19020	34
RV2039_libmerged	4024892	4024903		YPO_RS19020	11
RV2039_libmerged	4025525	4025529		YPO_RS19030	4
RV2039_libmerged	4025790	4025792		YPO_RS19035	2
RV2039_libmerged	4025875	4025883		YPO_RS19035	8
RV2039_libmerged	4026019	4026020		YPO_RS19035	1
RV2039_libmerged	4028196	4028206		YPO_RS19045	10
RV2039_libmerged	4028516	4028518		YPO_RS19045	2
RV2039_libmerged	4033288	4033325		YPO_RS19055	37
RV2039_libmerged	4033506	4033509		YPO_RS19055	3
RV2039_libmerged	4033585	4033587		YPO_RS19055	2
RV2039_libmerged	4033596	4033604		YPO_RS19060	8
RV2039_libmerged	4033655	4033720		YPO_RS19060	65
RV2039_libmerged	4033835	4033859		YPO_RS19060	24
RV2039_libmerged	4033962	4033969		YPO_RS19060	7
RV2039_libmerged	4034036	4034041		YPO_RS19060	5
RV2039_libmerged	4034332	4034336		YPO_RS19060	4
RV2039_libmerged	4034664	4034683		YPO_RS19065	19
RV2039_libmerged	4034817	4034835		YPO_RS19070	18
RV2039_libmerged	4035051	4035074		YPO_RS19070	23
RV2039_libmerged	4035262	4035305		YPO_RS19070	43
RV2039_libmerged	4035711	4035759		YPO_RS19075	48
RV2039_libmerged	4036241	4036255		YPO_RS19075	14
RV2039_libmerged	4036674	4036676		YPO_RS19075	2
RV2039_libmerged	4037592	4037626		YPO_RS19080	34
RV2039_libmerged	4038141	4038156		rbsD	15
RV2039_libmerged	4038575	4038577		YPO_RS19090	2
RV2039_libmerged	4039908	4039917		deoC	9
RV2039_libmerged	4041506	4041514		YPO_RS19105	8
RV2039_libmerged	4047794	4047809		YPO_RS19135	15
RV2039_libmerged	4048602	4048610		YPO_RS19140	8
RV2039_libmerged	4049528	4049533		YPO_RS19140	5
RV2039_libmerged	4050200	4050202		YPO_RS19145	2
RV2039_libmerged	4050562	4050601		YPO_RS19145	39
RV2039_libmerged	4050707	4050718		YPO_RS19145	11
RV2039_libmerged	4051055	4051069		YPO_RS19145	14
RV2039_libmerged	4051166	4051173		YPO_RS19145	7
RV2039_libmerged	4051324	4051333		YPO_RS19145	9
RV2039_libmerged	4053945	4053946		YPO_RS19155	1
RV2039_libmerged	4055569	4055570		YPO_RS19160	1
RV2039_libmerged	4055872	4055883		YPO_RS19160	11
RV2039_libmerged	4056851	4056855		YPO_RS19165	4
RV2039_libmerged	4057116	4057117		YPO_RS19170	1
RV2039_libmerged	4057796	4057812		YPO_RS19170	16
RV2039_libmerged	4059604	4059620		YPO_RS19180	16
RV2039_libmerged	4060819	4060827		yghU	8
RV2039_libmerged	4062620	4062645		YPO_RS19190	25
RV2039_libmerged	4062752	4062755		YPO_RS19190	3
RV2039_libmerged	4064034	4064037		YPO_RS19195	3
RV2039_libmerged	4064559	4064856		YPO_RS19200	297
RV2039_libmerged	4064896	4064900		YPO_RS19200	4
RV2039_libmerged	4066676	4066681		YPO_RS19215	5
RV2039_libmerged	4068831	4068836		YPO_RS19225	5
RV2039_libmerged	4070615	4070619		YPO_RS19235	4
RV2039_libmerged	4071630	4071641		YPO_RS19240	11
RV2039_libmerged	4072106	4072119		YPO_RS19245	13
RV2039_libmerged	4072377	4072383		YPO_RS19245	6
RV2039_libmerged	4076299	4076303		panF	4
RV2039_libmerged	4077386	4077399		panF	13
RV2039_libmerged	4081226	4081227		aroQ	1
RV2039_libmerged	4081784	4081798		msrQ	14
RV2039_libmerged	4085819	4085821		csrD	2
RV2039_libmerged	4089541	4089545		mreD	4
RV2039_libmerged	4090544	4090545		YPO_RS19340	1
RV2039_libmerged	4090624	4090631		YPO_RS19340	7
RV2039_libmerged	4090624	4090635		rng	11
RV2039_libmerged	4093868	4093880		YPO_RS19350	12
RV2039_libmerged	4094000	4094007		YPO_RS19350	7
RV2039_libmerged	4094380	4094384		YPO_RS19350	4
RV2039_libmerged	4095019	4095022		YPO_RS19350	3
RV2039_libmerged	4095596	4095622		YPO_RS19350	26
RV2039_libmerged	4095710	4095712		YPO_RS19350	2
RV2039_libmerged	4095784	4095789		YPO_RS19350	5
RV2039_libmerged	4096463	4096514		YPO_RS19355	51
RV2039_libmerged	4097019	4097054		tldD	35
RV2039_libmerged	4097169	4097181		tldD	12
RV2039_libmerged	4097335	4097343		tldD	8
RV2039_libmerged	4098682	4098696		YPO_RS19365	14
RV2039_libmerged	4098801	4098878		YPO_RS19365	77
RV2039_libmerged	4099101	4099110		YPO_RS19365	9
RV2039_libmerged	4099142	4099151		YPO_RS19365	9
RV2039_libmerged	4100260	4100269		YPO_RS19365	9
RV2039_libmerged	4100406	4100408		YPO_RS19365	2
RV2039_libmerged	4101423	4101425		YPO_RS19365	2
RV2039_libmerged	4101854	4101883		YPO_RS19370	29
RV2039_libmerged	4101983	4102003		YPO_RS19370	20
RV2039_libmerged	4102403	4102405		YPO_RS19370	2
RV2039_libmerged	4105237	4105253		YPO_RS19380	16
RV2039_libmerged	4106345	4106395		YPO_RS19390	50
RV2039_libmerged	4106685	4106705		YPO_RS19390	20
RV2039_libmerged	4107665	4107691		YPO_RS19390	26
RV2039_libmerged	4108104	4108121		YPO_RS19390	17
RV2039_libmerged	4108246	4108250		YPO_RS19390	4
RV2039_libmerged	4108607	4108621		YPO_RS19390	14
RV2039_libmerged	4109936	4109951		YPO_RS19390	15
RV2039_libmerged	4110568	4110576		YPO_RS19395	8
RV2039_libmerged	4111894	4111895		YPO_RS19395	1
RV2039_libmerged	4112183	4112196		YPO_RS19395	13
RV2039_libmerged	4112286	4112294		YPO_RS19395	8
RV2039_libmerged	4112399	4112413		YPO_RS19395	14
RV2039_libmerged	4112882	4112888		YPO_RS19400	6
RV2039_libmerged	4113086	4113118		YPO_RS19400	32
RV2039_libmerged	4113168	4113180		YPO_RS19400	12
RV2039_libmerged	4113638	4113666		YPO_RS19400	28
RV2039_libmerged	4113984	4114007		YPO_RS19405	23
RV2039_libmerged	4114050	4114055		YPO_RS19405	5
RV2039_libmerged	4114492	4114504		YPO_RS19405	12
RV2039_libmerged	4114697	4114718		YPO_RS19405	21
RV2039_libmerged	4114811	4114813		YPO_RS19405	2
RV2039_libmerged	4115652	4115660		YPO_RS19405	8
RV2039_libmerged	4115973	4116043		YPO_RS19405	70
RV2039_libmerged	4116123	4116130		YPO_RS19405	7
RV2039_libmerged	4116919	4116920		YPO_RS19410	1
RV2039_libmerged	4117036	4117050		YPO_RS19410	14
RV2039_libmerged	4117215	4117225		YPO_RS19410	10
RV2039_libmerged	4117474	4117476		YPO_RS19410	2
RV2039_libmerged	4120939	4120941		aaeB	2
RV2039_libmerged	4121454	4121455		aaeB	1
RV2039_libmerged	4124072	4124087		YPO_RS19440	15
RV2039_libmerged	4124434	4124436		YPO_RS19440	2
RV2039_libmerged	4124468	4124493		YPO_RS19440	25
RV2039_libmerged	4126886	4126888		pmbA	2
RV2039_libmerged	4127609	4127622		YPO_RS19460	13
RV2039_libmerged	4129654	4129659		treC	5
RV2039_libmerged	4129879	4129882		treC	3
RV2039_libmerged	4130283	4130287		treC	4
RV2039_libmerged	4131108	4131113		treC	5
RV2039_libmerged	4132564	4132571		treB	7
RV2039_libmerged	4133731	4133737		treR	6
RV2039_libmerged	4134293	4134297		YPO_RS19490	4
RV2039_libmerged	4134839	4134854		YPO_RS19495	15
RV2039_libmerged	4134890	4134987		YPO_RS19495	97
RV2039_libmerged	4135148	4135295		YPO_RS19495	147
RV2039_libmerged	4135330	4135352		YPO_RS19495	22
RV2039_libmerged	4135405	4135495		YPO_RS19495	90
RV2039_libmerged	4135717	4135737		YPO_RS19500	20
RV2039_libmerged	4135888	4135936		YPO_RS19500	48
RV2039_libmerged	4135979	4135989		YPO_RS19500	10
RV2039_libmerged	4136070	4136106		YPO_RS19500	36
RV2039_libmerged	4136304	4136313		YPO_RS19500	9
RV2039_libmerged	4136371	4136473		YPO_RS19500	102
RV2039_libmerged	4136609	4136627		YPO_RS19500	18
RV2039_libmerged	4140059	4140071		tssC	12
RV2039_libmerged	4140464	4140476		tssC	12
RV2039_libmerged	4140899	4140911		tssC	12
RV2039_libmerged	4141294	4141299		tssB	5
RV2039_libmerged	4141442	4141470		tssB	28
RV2039_libmerged	4142083	4142089		YPO_RS19530	6
RV2039_libmerged	4142456	4142463		YPO_RS19530	7
RV2039_libmerged	4142782	4142810		YPO_RS19535	28
RV2039_libmerged	4143423	4143442		malM	19
RV2039_libmerged	4143755	4143764		malM	9
RV2039_libmerged	4143934	4143935		malM	1
RV2039_libmerged	4144749	4144750		YPO_RS19545	1
RV2039_libmerged	4144840	4144860		YPO_RS19545	20
RV2039_libmerged	4145283	4145296		YPO_RS19545	13
RV2039_libmerged	4145415	4145421		YPO_RS19545	6
RV2039_libmerged	4146366	4146378		malK	12
RV2039_libmerged	4146759	4146774		malK	15
RV2039_libmerged	4146913	4146928		malK	15
RV2039_libmerged	4148365	4148380		malE	15
RV2039_libmerged	4148954	4148971		malE	17
RV2039_libmerged	4149634	4149641		malF	7
RV2039_libmerged	4150205	4150213		malF	8
RV2039_libmerged	4150629	4150643		malF	14
RV2039_libmerged	4151005	4151030		malG	25
RV2039_libmerged	4151123	4151124		malG	1
RV2039_libmerged	4151282	4151284		malG	2
RV2039_libmerged	4151687	4151696		malG	9
RV2039_libmerged	4153279	4153297		pgi	18
RV2039_libmerged	4154654	4154675		lysC	21
RV2039_libmerged	4155506	4155536		lysC	30
RV2039_libmerged	4156566	4156567		YPO_RS19590	1
RV2039_libmerged	4156624	4156638		YPO_RS19590	14
RV2039_libmerged	4157158	4157198		YPO_RS19590	40
RV2039_libmerged	4158288	4158295		YPO_RS19595	7
RV2039_libmerged	4158725	4158731		YPO_RS19595	6
RV2039_libmerged	4160262	4160270		YPO_RS19595	8
RV2039_libmerged	4160513	4160517		YPO_RS19595	4
RV2039_libmerged	4160772	4160775		YPO_RS19595	3
RV2039_libmerged	4161292	4161302		YPO_RS19595	10
RV2039_libmerged	4162074	4162096		YPO_RS19595	22
RV2039_libmerged	4162509	4162521		YPO_RS19595	12
RV2039_libmerged	4162865	4162866		YPO_RS19595	1
RV2039_libmerged	4164474	4164492		metH	18
RV2039_libmerged	4164966	4164975		metH	9
RV2039_libmerged	4165046	4165057		metH	11
RV2039_libmerged	4166738	4166744		metH	6
RV2039_libmerged	4168131	4168136		aceK	5
RV2039_libmerged	4168663	4168689		aceK	26
RV2039_libmerged	4169013	4169049		aceK	36
RV2039_libmerged	4170234	4170248		aceA	14
RV2039_libmerged	4172351	4172374		aceB	23
RV2039_libmerged	4173770	4173772		metA	2
RV2039_libmerged	4178238	4178242		YPO_RS19645	4
RV2039_libmerged	4180529	4180546		YPO_RS19665	17
RV2039_libmerged	4181565	4181568		purH	3
RV2039_libmerged	4183467	4183468		purD	1
RV2039_libmerged	4184842	4184854		YPO_RS19680	12
RV2039_libmerged	4187275	4187280		hemE	5
RV2039_libmerged	4187984	4187992		YPO_RS19705	8
RV2039_libmerged	4188224	4188240		YPO_RS19705	16
RV2039_libmerged	4189546	4189553		nudC	7
RV2039_libmerged	4190002	4190034		rsd	32
RV2039_libmerged	4192141	4192149		thiC	8
RV2039_libmerged	4192180	4192186		thiC	6
RV2039_libmerged	4193431	4193434		YPO_RS19730	3
RV2039_libmerged	4193814	4193831		YPO_RS19730	17
RV2039_libmerged	4194106	4194120		thiS	14
RV2039_libmerged	4196679	4196716		YPO_RS19750	37
RV2039_libmerged	4196911	4196918		YPO_RS19750	7
RV2039_libmerged	4197013	4197137		YPO_RS19750	124
RV2039_libmerged	4197948	4197949		rpoC	1
RV2039_libmerged	4198199	4198219		rpoC	20
RV2039_libmerged	4198258	4198261		rpoC	3
RV2039_libmerged	4198981	4199030		rpoC	49
RV2039_libmerged	4199830	4199834		rpoC	4
RV2039_libmerged	4201048	4201073		rpoC	25
RV2039_libmerged	4202037	4202069		rpoB	32
RV2039_libmerged	4202861	4202873		rpoB	12
RV2039_libmerged	4203022	4203023		rpoB	1
RV2039_libmerged	4203119	4203121		rpoB	2
RV2039_libmerged	4203442	4203466		rpoB	24
RV2039_libmerged	4203841	4203859		rpoB	18
RV2039_libmerged	4204986	4204997		rpoB	11
RV2039_libmerged	4205112	4205125		rpoB	13
RV2039_libmerged	4205203	4205225		rpoB	22
RV2039_libmerged	4205568	4205582		rpoB	14
RV2039_libmerged	4205632	4205641		rpoB	9
RV2039_libmerged	4207334	4207379		rplA	45
RV2039_libmerged	4207459	4207461		rplA	2
RV2039_libmerged	4207515	4207539		rplA	24
RV2039_libmerged	4209191	4209207		secE	16
RV2039_libmerged	4210300	4210317		tuf	17
RV2039_libmerged	4210357	4210359		tuf	2
RV2039_libmerged	4210752	4210762		tuf	10
RV2039_libmerged	4212117	4212131		YPO_RS19820	14
RV2039_libmerged	4212193	4212255		YPO_RS19820	62
RV2039_libmerged	4212313	4212419		YPO_RS19820	106
RV2039_libmerged	4212476	4212556		YPO_RS19820	80
RV2039_libmerged	4212634	4212681		YPO_RS19820	47
RV2039_libmerged	4212830	4212923		YPO_RS19825	93
RV2039_libmerged	4213091	4213125		YPO_RS19825	34
RV2039_libmerged	4213184	4213281		YPO_RS19825	97
RV2039_libmerged	4213446	4213456		YPO_RS19825	10
RV2039_libmerged	4213541	4213610		YPO_RS19825	69
RV2039_libmerged	4213647	4213681		YPO_RS19825	34
RV2039_libmerged	4213744	4213828		YPO_RS19825	84
RV2039_libmerged	4213921	4213935		YPO_RS19830	14
RV2039_libmerged	4213977	4213985		YPO_RS19830	8
RV2039_libmerged	4214108	4214132		YPO_RS19830	24
RV2039_libmerged	4214359	4214391		YPO_RS19830	32
RV2039_libmerged	4214847	4214854		coaA	7
RV2039_libmerged	4215188	4215195		coaA	7
RV2039_libmerged	4215242	4215245		coaA	3
RV2039_libmerged	4215348	4215380		coaA	32
RV2039_libmerged	4215681	4215701		birA	20
RV2039_libmerged	4215943	4215947		birA	4
RV2039_libmerged	4217199	4217257		murB	58
RV2039_libmerged	4217432	4217442		murB	10
RV2039_libmerged	4217521	4217534		murB	13
RV2039_libmerged	4223148	4223173		YPO_RS19870	25
RV2039_libmerged	4224230	4224250		hemG	20
RV2039_libmerged	4224720	4224723		trkH	3
RV2039_libmerged	4225780	4225787		trkH	7
RV2039_libmerged	4226393	4226401		YPO_RS19895	8
RV2039_libmerged	4226443	4226467		YPO_RS19895	24
RV2039_libmerged	4226545	4226549		YPO_RS19895	4
RV2039_libmerged	4226595	4226689		YPO_RS19895	94
RV2039_libmerged	4226759	4226814		YPO_RS19895	55
RV2039_libmerged	4226845	4226851		YPO_RS19895	6
RV2039_libmerged	4226982	4226995		YPO_RS19900	13
RV2039_libmerged	4227129	4227142		YPO_RS19900	13
RV2039_libmerged	4227587	4227610		pepQ	23
RV2039_libmerged	4229041	4229049		fadB	8
RV2039_libmerged	4230827	4230831		fadB	4
RV2039_libmerged	4231693	4231695		fadA	2
RV2039_libmerged	4232809	4232816		fre	7
RV2039_libmerged	4233674	4233688		ubiD	14
RV2039_libmerged	4233719	4233727		ubiD	8
RV2039_libmerged	4234543	4234564		ubiD	21
RV2039_libmerged	4235160	4235165		rfaH	5
RV2039_libmerged	4235745	4235755		hemB	10
RV2039_libmerged	4236031	4236057		hemB	26
RV2039_libmerged	4236161	4236168		hemB	7
RV2039_libmerged	4236780	4236817		YPO_RS19940	37
RV2039_libmerged	4236932	4236952		YPO_RS19945	20
RV2039_libmerged	4237102	4237124		YPO_RS19945	22
RV2039_libmerged	4237380	4237397		YPO_RS19945	17
RV2039_libmerged	4237447	4237450		YPO_RS19945	3
RV2039_libmerged	4237514	4237540		YPO_RS19945	26
RV2039_libmerged	4237613	4237635		YPO_RS19945	22
RV2039_libmerged	4237635	4237692		YPO_RS19950	57
RV2039_libmerged	4237911	4237976		YPO_RS19950	65
RV2039_libmerged	4238008	4238065		YPO_RS19950	57
RV2039_libmerged	4238170	4238260		YPO_RS19950	90
RV2039_libmerged	4238359	4238365		YPO_RS19950	6
RV2039_libmerged	4238651	4238657		YPO_RS19950	6
RV2039_libmerged	4239503	4239512		tatC	9
RV2039_libmerged	4239712	4239734		tatC	22
RV2039_libmerged	4241343	4241364		ubiB	21
RV2039_libmerged	4241580	4241591		ubiB	11
RV2039_libmerged	4241870	4241884		ubiB	14
RV2039_libmerged	4242018	4242022		ubiB	4
RV2039_libmerged	4242096	4242099		ubiB	3
RV2039_libmerged	4242273	4242282		ubiB	9
RV2039_libmerged	4242628	4242670		ubiB	42
RV2039_libmerged	4243265	4243307		YPO_RS19980	42
RV2039_libmerged	4243436	4243437		YPO_RS19980	1
RV2039_libmerged	4243644	4243661		ubiE	17
RV2039_libmerged	4243873	4243882		ubiE	9
RV2039_libmerged	4244209	4244218		ubiE	9
RV2039_libmerged	4244645	4244654		rmuC	9
RV2039_libmerged	4245403	4245411		rmuC	8
RV2039_libmerged	4245791	4245817		rmuC	26
RV2039_libmerged	4246540	4246555		YPO_RS19995	15
RV2039_libmerged	4247052	4247053		YPO_RS20000	1
RV2039_libmerged	4247188	4247207		YPO_RS20000	19
RV2039_libmerged	4247451	4247457		YPO_RS20000	6
RV2039_libmerged	4247720	4247730		YPO_RS20000	10
RV2039_libmerged	4248059	4248064		YPO_RS20000	5
RV2039_libmerged	4248520	4248616		YPO_RS20000	96
RV2039_libmerged	4249002	4249014		YPO_RS20005	12
RV2039_libmerged	4249362	4249374		YPO_RS20005	12
RV2039_libmerged	4249647	4249652		YPO_RS20005	5
RV2039_libmerged	4250411	4250418		udp	7
RV2039_libmerged	4250519	4250524		udp	5
RV2039_libmerged	4251264	4251266		YPO_RS20015	2
RV2039_libmerged	4251776	4251812		YPO_RS20015	36
RV2039_libmerged	4252248	4252271		metE	23
RV2039_libmerged	4253523	4253525		metE	2
RV2039_libmerged	4254866	4254877		metR	11
RV2039_libmerged	4257129	4257145		YPO_RS20035	16
RV2039_libmerged	4257257	4257258		YPO_RS20035	1
RV2039_libmerged	4259146	4259153		YPO_RS20045	7
RV2039_libmerged	4259410	4259413		YPO_RS20045	3
RV2039_libmerged	4259626	4259685		ugpE	59
RV2039_libmerged	4259963	4259970		ugpE	7
RV2039_libmerged	4260209	4260215		ugpE	6
RV2039_libmerged	4262752	4262772		ugpB	20
RV2039_libmerged	4263327	4263368		YPO_RS20065	41
RV2039_libmerged	4263471	4263516		YPO_RS20065	45
RV2039_libmerged	4264085	4264086		YPO_RS20070	1
RV2039_libmerged	4264245	4264259		YPO_RS20070	14
RV2039_libmerged	4265892	4265922		YPO_RS20070	30
RV2039_libmerged	4266534	4266542		YPO_RS20075	8
RV2039_libmerged	4267183	4267186		YPO_RS20080	3
RV2039_libmerged	4267857	4267868		YPO_RS20085	11
RV2039_libmerged	4268448	4268470		YPO_RS20090	22
RV2039_libmerged	4268924	4268951		YPO_RS20090	27
RV2039_libmerged	4269041	4269086		YPO_RS20090	45
RV2039_libmerged	4269251	4269254		YPO_RS20090	3
RV2039_libmerged	4269334	4269339		YPO_RS20090	5
RV2039_libmerged	4269655	4269668		YPO_RS20095	13
RV2039_libmerged	4270014	4270033		YPO_RS20095	19
RV2039_libmerged	4270632	4270646		livF	14
RV2039_libmerged	4270983	4270991		livF	8
RV2039_libmerged	4272321	4272335		YPO_RS20110	14
RV2039_libmerged	4273172	4273201		livH	29
RV2039_libmerged	4273381	4273390		livH	9
RV2039_libmerged	4273851	4273870		livH	19
RV2039_libmerged	4274244	4274252		YPO_RS20120	8
RV2039_libmerged	4274999	4275010		YPO_RS20120	11
RV2039_libmerged	4276419	4276459		YPO_RS20130	40
RV2039_libmerged	4276519	4276569		YPO_RS20130	50
RV2039_libmerged	4276614	4276637		YPO_RS20130	23
RV2039_libmerged	4276811	4276812		YPO_RS20130	1
RV2039_libmerged	4277562	4277566		rpoH	4
RV2039_libmerged	4277902	4277911		rpoH	9
RV2039_libmerged	4280305	4280307		ftsY	2
RV2039_libmerged	4282121	4282125		rsmD	4
RV2039_libmerged	4283708	4283717		YPO_RS20170	9
RV2039_libmerged	4283784	4283837		YPO_RS20170	53
RV2039_libmerged	4284516	4284517		YPO_RS20175	1
RV2039_libmerged	4286730	4286731		YPO_RS20180	1
RV2039_libmerged	4287666	4287672		tusA	6
RV2039_libmerged	4288211	4288229		YPO_RS20190	18
RV2039_libmerged	4288551	4288556		YPO_RS20190	5
RV2039_libmerged	4289223	4289224		dcrB	1
RV2039_libmerged	4289972	4289985		glpC	13
RV2039_libmerged	4290114	4290121		glpC	7
RV2039_libmerged	4290391	4290396		glpC	5
RV2039_libmerged	4290584	4290590		glpC	6
RV2039_libmerged	4291711	4291716		glpB	5
RV2039_libmerged	4293644	4293651		glpA	7
RV2039_libmerged	4294724	4294759		glpQ	35
RV2039_libmerged	4295123	4295149		glpQ	26
RV2039_libmerged	4299710	4299712		rhtB	2
RV2039_libmerged	4300058	4300060		rhtC	2
RV2039_libmerged	4300594	4300621		recQ	27
RV2039_libmerged	4303055	4303076		pldA	21
RV2039_libmerged	4303176	4303200		pldA	24
RV2039_libmerged	4304969	4305004		rarD	35
RV2039_libmerged	4307349	4307373		YPO_RS20275	24
RV2039_libmerged	4310975	4310986		uvrD	11
RV2039_libmerged	4312638	4312643		yigB	5
RV2039_libmerged	4314001	4314014		YPO_RS20305	13
RV2039_libmerged	4314152	4314153		YPO_RS20305	1
RV2039_libmerged	4314579	4314581		YPO_RS20305	2
RV2039_libmerged	4315209	4315212		dapF	3
RV2039_libmerged	4316054	4316076		cyaY	22
RV2039_libmerged	4316119	4316161		cyaY	42
RV2039_libmerged	4317750	4317770		YPO_RS20325	20
RV2039_libmerged	4319332	4319334		YPO_RS20330	2
RV2039_libmerged	4321168	4321181		hemD	13
RV2039_libmerged	4322039	4322056		hemX	17
RV2039_libmerged	4322598	4322601		hemY	3
RV2039_libmerged	4322640	4322650		hemY	10
RV2039_libmerged	4322969	4322985		hemY	16
RV2039_libmerged	4323966	4324042		YPO_RS20355	76
RV2039_libmerged	4324171	4324206		YPO_RS20355	35
RV2039_libmerged	4324328	4324341		YPO_RS20355	13
RV2039_libmerged	4326075	4326085		YPO_RS20380	10
RV2039_libmerged	4326553	4326563		YPO_RS20380	10
RV2039_libmerged	4328658	4328660		wzyE	2
RV2039_libmerged	4328880	4328886		wzyE	6
RV2039_libmerged	4329875	4329885		wzyE	10
RV2039_libmerged	4330406	4330408		YPO_RS20395	2
RV2039_libmerged	4331232	4331253		wzxE	21
RV2039_libmerged	4332310	4332313		rffA	3
RV2039_libmerged	4332447	4332452		rffA	5
RV2039_libmerged	4333885	4333892		rffC	7
RV2039_libmerged	4336399	4336411		wecC	12
RV2039_libmerged	4337021	4337025		wecC	4
RV2039_libmerged	4337145	4337146		wecC	1
RV2039_libmerged	4338332	4338334		wecB	2
RV2039_libmerged	4338739	4338753		wecB	14
RV2039_libmerged	4339380	4339382		wzzE	2
RV2039_libmerged	4339875	4339884		wzzE	9
RV2039_libmerged	4340230	4340231		wecA	1
RV2039_libmerged	4340646	4340649		wecA	3
RV2039_libmerged	4342184	4342186		rho	2
RV2039_libmerged	4347962	4347994		rep	32
RV2039_libmerged	4348514	4348530		rep	16
RV2039_libmerged	4348818	4348833		rep	15
RV2039_libmerged	4349716	4349736		YPO_RS20480	20
RV2039_libmerged	4349942	4349951		YPO_RS20480	9
RV2039_libmerged	4350031	4350049		YPO_RS20480	18
RV2039_libmerged	4350341	4350347		YPO_RS20480	6
RV2039_libmerged	4350532	4350540		YPO_RS20485	8
RV2039_libmerged	4350615	4350640		YPO_RS20485	25
RV2039_libmerged	4350692	4350693		YPO_RS20485	1
RV2039_libmerged	4350794	4350804		YPO_RS20485	10
RV2039_libmerged	4350841	4350858		YPO_RS20485	17
RV2039_libmerged	4351243	4351244		YPO_RS20485	1
RV2039_libmerged	4351290	4351316		YPO_RS20485	26
RV2039_libmerged	4351574	4351580		YPO_RS20485	6
RV2039_libmerged	4352840	4352844		YPO_RS20490	4
RV2039_libmerged	4352961	4352966		YPO_RS20490	5
RV2039_libmerged	4353630	4353635		YPO_RS20495	5
RV2039_libmerged	4354046	4354074		YPO_RS20500	28
RV2039_libmerged	4354367	4354375		YPO_RS20500	8
RV2039_libmerged	4354649	4354651		YPO_RS20500	2
RV2039_libmerged	4355479	4355482		YPO_RS20500	3
RV2039_libmerged	4356099	4356107		YPO_RS20500	8
RV2039_libmerged	4357190	4357230		stbD	40
RV2039_libmerged	4357704	4357768		stbD	64
RV2039_libmerged	4358283	4358291		YPO_RS20510	8
RV2039_libmerged	4358471	4358508		YPO_RS20510	37
RV2039_libmerged	4359493	4359520		YPO_RS20515	27
RV2039_libmerged	4360252	4360300		YPO_RS20525	48
RV2039_libmerged	4361997	4362011		YPO_RS20535	14
RV2039_libmerged	4362397	4362401		ilvC	4
RV2039_libmerged	4362594	4362609		ilvC	15
RV2039_libmerged	4365146	4365155		YPO_RS20550	9
RV2039_libmerged	4366301	4366307		YPO_RS20560	6
RV2039_libmerged	4366490	4366494		YPO_RS20560	4
RV2039_libmerged	4367066	4367072		YPO_RS20565	6
RV2039_libmerged	4367563	4367572		YPO_RS20570	9
RV2039_libmerged	4367610	4367620		YPO_RS20570	10
RV2039_libmerged	4368126	4368129		YPO_RS20575	3
RV2039_libmerged	4368284	4368295		YPO_RS20575	11
RV2039_libmerged	4368882	4368894		ilvA	12
RV2039_libmerged	4368948	4368965		ilvA	17
RV2039_libmerged	4372497	4372498		YPO_RS20590	1
RV2039_libmerged	4373322	4373339		ilvM	17
RV2039_libmerged	4377535	4377548		YPO_RS20615	13
RV2039_libmerged	4377940	4377958		hdfR	18
RV2039_libmerged	4378007	4378018		hdfR	11
RV2039_libmerged	4378214	4378215		hdfR	1
RV2039_libmerged	4379520	4379534		yjfF	14
RV2039_libmerged	4379768	4379788		yjfF	20
RV2039_libmerged	4381772	4381804		YPO_RS20635	32
RV2039_libmerged	4381920	4381925		YPO_RS20635	5
RV2039_libmerged	4383092	4383095		YPO_RS20640	3
RV2039_libmerged	4389733	4389743		YPO_RS20670	10
RV2039_libmerged	4389820	4389842		YPO_RS20675	22
RV2039_libmerged	4390456	4390478		murI	22
RV2039_libmerged	4391054	4391063		murI	9
RV2039_libmerged	4391054	4391063		btuB	9
RV2039_libmerged	4391224	4391253		btuB	29
RV2039_libmerged	4391736	4391738		btuB	2
RV2039_libmerged	4392048	4392058		btuB	10
RV2039_libmerged	4392381	4392386		btuB	5
RV2039_libmerged	4394884	4394904		YPO_RS20695	20
RV2039_libmerged	4395085	4395095		fabR	10
RV2039_libmerged	4395163	4395174		fabR	11
RV2039_libmerged	4396125	4396156		sthA	31
RV2039_libmerged	4396505	4396510		sthA	5
RV2039_libmerged	4396666	4396686		sthA	20
RV2039_libmerged	4396873	4396878		sthA	5
RV2039_libmerged	4397890	4397896		oxyR	6
RV2039_libmerged	4399388	4399397		YPO_RS20720	9
RV2039_libmerged	4399661	4399671		YPO_RS20720	10
RV2039_libmerged	4399901	4399927		YPO_RS20720	26
RV2039_libmerged	4401545	4401546		YPO_RS20725	1
RV2039_libmerged	4402303	4402314		YPO_RS20730	11
RV2039_libmerged	4403036	4403044		YPO_RS20735	8
RV2039_libmerged	4404238	4404244		YPO_RS20735	6
RV2039_libmerged	4405597	4405606		YPO_RS20740	9
RV2039_libmerged	4405828	4405851		YPO_RS20745	23
RV2039_libmerged	4406089	4406092		YPO_RS20745	3
RV2039_libmerged	4406297	4406351		YPO_RS20745	54
RV2039_libmerged	4406856	4406860		YPO_RS20745	4
RV2039_libmerged	4407060	4407069		YPO_RS20745	9
RV2039_libmerged	4407242	4407245		YPO_RS20745	3
RV2039_libmerged	4407284	4407285		YPO_RS20745	1
RV2039_libmerged	4407331	4407343		YPO_RS20745	12
RV2039_libmerged	4411893	4411900		argC	7
RV2039_libmerged	4413565	4413593		argE	28
RV2039_libmerged	4415878	4415880		ppc	2
RV2039_libmerged	4417571	4417576		YPO_RS20775	5
RV2039_libmerged	4418506	4418519		YPO_RS20775	13
RV2039_libmerged	4419459	4419468		YPO_RS20780	9
RV2039_libmerged	4419785	4419799		YPO_RS20785	14
RV2039_libmerged	4420224	4420252		YPO_RS20790	28
RV2039_libmerged	4421260	4421268		glpD	8
RV2039_libmerged	4421951	4421976		glpD	25
RV2039_libmerged	4422062	4422063		glpD	1
RV2039_libmerged	4422862	4422869		glgP	7
RV2039_libmerged	4425062	4425065		glgP	3
RV2039_libmerged	4425141	4425148		glgP	7
RV2039_libmerged	4425206	4425222		glgP	16
RV2039_libmerged	4425282	4425284		glgP	2
RV2039_libmerged	4426849	4426852		glgA	3
RV2039_libmerged	4430571	4430598		glgB	27
RV2039_libmerged	4431093	4431109		glgB	16
RV2039_libmerged	4432220	4432223		glgB	3
RV2039_libmerged	4434068	4434075		YPO_RS20825	7
RV2039_libmerged	4434249	4434255		YPO_RS20825	6
RV2039_libmerged	4434710	4434729		YPO_RS20825	19
RV2039_libmerged	4436216	4436247		YPO_RS20830	31
RV2039_libmerged	4436919	4436922		YPO_RS20830	3
RV2039_libmerged	4437764	4437782		YPO_RS20830	18
RV2039_libmerged	4437841	4437878		YPO_RS20830	37
RV2039_libmerged	4438185	4438194		YPO_RS20830	9
RV2039_libmerged	4438294	4438302		YPO_RS20830	8
RV2039_libmerged	4438946	4438949		YPO_RS20830	3
RV2039_libmerged	4439080	4439091		YPO_RS20830	11
RV2039_libmerged	4441275	4441277		YPO_RS20830	2
RV2039_libmerged	4441933	4441953		YPO_RS20830	20
RV2039_libmerged	4443190	4443241		YPO_RS20830	51
RV2039_libmerged	4443304	4443327		YPO_RS20830	23
RV2039_libmerged	4443928	4443944		YPO_RS20830	16
RV2039_libmerged	4444022	4444023		YPO_RS20830	1
RV2039_libmerged	4445990	4446007		YPO_RS20840	17
RV2039_libmerged	4446326	4446352		YPO_RS20845	26
RV2039_libmerged	4446372	4446390		YPO_RS20850	18
RV2039_libmerged	4446857	4446887		YPO_RS20855	30
RV2039_libmerged	4449690	4449698		YPO_RS20870	8
RV2039_libmerged	4451374	4451377		gntT	3
RV2039_libmerged	4451935	4451951		gntT	16
RV2039_libmerged	4452436	4452437		gntT	1
RV2039_libmerged	4452730	4452738		gntR	8
RV2039_libmerged	4452936	4452971		gntR	35
RV2039_libmerged	4454206	4454235		YPO_RS20895	29
RV2039_libmerged	4454509	4454514		YPO_RS20895	5
RV2039_libmerged	4456472	4456474		YPO_RS20910	2
RV2039_libmerged	4457495	4457496		YPO_RS20915	1
RV2039_libmerged	4457886	4457890		YPO_RS20915	4
RV2039_libmerged	4459878	4459887		YPO_RS20930	9
RV2039_libmerged	4460261	4460276		YPO_RS20930	15
RV2039_libmerged	4461220	4461222		YPO_RS20935	2
RV2039_libmerged	4463307	4463329		YPO_RS20940	22
RV2039_libmerged	4463516	4463523		YPO_RS20940	7
RV2039_libmerged	4463826	4463828		YPO_RS20940	2
RV2039_libmerged	4463861	4463863		YPO_RS20940	2
RV2039_libmerged	4465534	4465548		YPO_RS20945	14
RV2039_libmerged	4466845	4466868		pitA	23
RV2039_libmerged	4467122	4467123		pitA	1
RV2039_libmerged	4468528	4468537		YPO_RS20955	9
RV2039_libmerged	4468635	4468640		YPO_RS20955	5
RV2039_libmerged	4468700	4468781		YPO_RS20955	81
RV2039_libmerged	4468861	4468874		YPO_RS20955	13
RV2039_libmerged	4470859	4470867		gdhA	8
RV2039_libmerged	4472030	4472031		gdhA	1
RV2039_libmerged	4472074	4472086		gdhA	12
RV2039_libmerged	4472137	4472140		gdhA	3
RV2039_libmerged	4472451	4472464		YPO_RS20975	13
RV2039_libmerged	4472515	4472551		YPO_RS20975	36
RV2039_libmerged	4472745	4472747		YPO_RS20975	2
RV2039_libmerged	4473274	4473276		YPO_RS20975	2
RV2039_libmerged	4477815	4477832		YPO_RS20990	17
RV2039_libmerged	4478267	4478268		gorA	1
RV2039_libmerged	4478862	4478893		gorA	31
RV2039_libmerged	4480572	4480578		YPO_RS21000	6
RV2039_libmerged	4480609	4480650		YPO_RS21000	41
RV2039_libmerged	4481500	4481516		YPO_RS21010	16
RV2039_libmerged	4483576	4483592		YPO_RS21020	16
RV2039_libmerged	4483672	4483705		YPO_RS21020	33
RV2039_libmerged	4483861	4483935		YPO_RS21020	74
RV2039_libmerged	4484354	4484355		YPO_RS21025	1
RV2039_libmerged	4484476	4484484		YPO_RS21025	8
RV2039_libmerged	4484821	4484857		YPO_RS21030	36
RV2039_libmerged	4484927	4484962		YPO_RS21030	35
RV2039_libmerged	4485111	4485112		YPO_RS21030	1
RV2039_libmerged	4485411	4485420		YPO_RS21030	9
RV2039_libmerged	4486570	4486602		yapE	32
RV2039_libmerged	4486865	4486877		yapE	12
RV2039_libmerged	4487865	4487866		yapE	1
RV2039_libmerged	4488013	4488042		yapE	29
RV2039_libmerged	4489706	4489709		yhjD	3
RV2039_libmerged	4491523	4491526		YPO_RS21050	3
RV2039_libmerged	4492368	4492370		YPO_RS21050	2
RV2039_libmerged	4493980	4493986		pdeH	6
RV2039_libmerged	4494057	4494064		pdeH	7
RV2039_libmerged	4494410	4494422		pdeH	12
RV2039_libmerged	4496645	4496646		YPO_RS21070	1
RV2039_libmerged	4498838	4498884		YPO_RS21075	46
RV2039_libmerged	4499113	4499137		YPO_RS21075	24
RV2039_libmerged	4501176	4501178		YPO_RS21085	2
RV2039_libmerged	4501418	4501421		YPO_RS21085	3
RV2039_libmerged	4502747	4502749		YPO_RS21090	2
RV2039_libmerged	4502849	4502883		YPO_RS21090	34
RV2039_libmerged	4502961	4502967		YPO_RS21090	6
RV2039_libmerged	4503266	4503268		YPO_RS21090	2
RV2039_libmerged	4504165	4504176		hmsP	11
RV2039_libmerged	4504252	4504296		hmsP	44
RV2039_libmerged	4505950	4505971		hmsP	21
RV2039_libmerged	4506187	4506188		hmsP	1
RV2039_libmerged	4507011	4507013		bcsZ	2
RV2039_libmerged	4510252	4510256		dppC	4
RV2039_libmerged	4512206	4512207		YPO_RS21130	1
RV2039_libmerged	4513244	4513245		YPO_RS21130	1
RV2039_libmerged	4515012	4515044		YPO_RS21135	32
RV2039_libmerged	4516222	4516228		YPO_RS21140	6
RV2039_libmerged	4516297	4516374		YPO_RS21140	77
RV2039_libmerged	4516565	4516577		YPO_RS21140	12
RV2039_libmerged	4516684	4516691		YPO_RS21140	7
RV2039_libmerged	4517327	4517340		YPO_RS21140	13
RV2039_libmerged	4518185	4518189		YPO_RS21150	4
RV2039_libmerged	4518806	4518809		YPO_RS21150	3
RV2039_libmerged	4518851	4518852		YPO_RS21150	1
RV2039_libmerged	4519130	4519159		YPO_RS21150	29
RV2039_libmerged	4519746	4519756		YPO_RS21155	10
RV2039_libmerged	4520110	4520133		YPO_RS21160	23
RV2039_libmerged	4520306	4520307		YPO_RS21160	1
RV2039_libmerged	4520366	4520402		YPO_RS21160	36
RV2039_libmerged	4520483	4520489		YPO_RS21160	6
RV2039_libmerged	4520566	4520570		YPO_RS21160	4
RV2039_libmerged	4520604	4520620		YPO_RS21160	16
RV2039_libmerged	4520682	4520707		YPO_RS21160	25
RV2039_libmerged	4520859	4520889		YPO_RS21160	30
RV2039_libmerged	4520889	4520941		YPO_RS21165	52
RV2039_libmerged	4521172	4521222		YPO_RS21165	50
RV2039_libmerged	4521295	4521314		YPO_RS21165	19
RV2039_libmerged	4521434	4521493		YPO_RS21165	59
RV2039_libmerged	4521596	4521611		YPO_RS21165	15
RV2039_libmerged	4521737	4521740		YPO_RS21165	3
RV2039_libmerged	4521803	4521825		YPO_RS21165	22
RV2039_libmerged	4523029	4523034		uhpA	5
RV2039_libmerged	4523148	4523182		uhpA	34
RV2039_libmerged	4523496	4523535		eptB	39
RV2039_libmerged	4523827	4523832		eptB	5
RV2039_libmerged	4523964	4523967		eptB	3
RV2039_libmerged	4524019	4524021		eptB	2
RV2039_libmerged	4524926	4524984		eptB	58
RV2039_libmerged	4525056	4525064		eptB	8
RV2039_libmerged	4525757	4525763		YPO_RS21185	6
RV2039_libmerged	4527100	4527126		YPO_RS21185	26
RV2039_libmerged	4528054	4528058		YPO_RS21190	4
RV2039_libmerged	4528317	4528320		YPO_RS21190	3
RV2039_libmerged	4533829	4533845		YPO_RS21205	16
RV2039_libmerged	4533891	4533895		YPO_RS21205	4
RV2039_libmerged	4534048	4534111		YPO_RS21205	63
RV2039_libmerged	4534276	4534296		YPO_RS21205	20
RV2039_libmerged	4534664	4534676		YPO_RS21210	12
RV2039_libmerged	4534722	4534736		YPO_RS21210	14
RV2039_libmerged	4535022	4535035		YPO_RS21215	13
RV2039_libmerged	4535134	4535163		YPO_RS21215	29
RV2039_libmerged	4535209	4535212		YPO_RS21215	3
RV2039_libmerged	4535562	4535565		YPO_RS21215	3
RV2039_libmerged	4535595	4535652		YPO_RS21215	57
RV2039_libmerged	4536207	4536215		YPO_RS21220	8
RV2039_libmerged	4537001	4537045		YPO_RS21220	44
RV2039_libmerged	4537802	4537813		YPO_RS21225	11
RV2039_libmerged	4538666	4538688		YPO_RS21230	22
RV2039_libmerged	4539182	4539199		YPO_RS21230	17
RV2039_libmerged	4540042	4540044		YPO_RS21235	2
RV2039_libmerged	4540485	4540490		YPO_RS21235	5
RV2039_libmerged	4541316	4541326		YPO_RS21240	10
RV2039_libmerged	4543326	4543336		YPO_RS21265	10
RV2039_libmerged	4545346	4545455		YPO_RS21280	109
RV2039_libmerged	4545640	4545681		YPO_RS21280	41
RV2039_libmerged	4545769	4545832		YPO_RS21280	63
RV2039_libmerged	4545891	4545933		YPO_RS21280	42
RV2039_libmerged	4546030	4546045		YPO_RS21280	15
RV2039_libmerged	4546437	4546444		YPO_RS21280	7
RV2039_libmerged	4548245	4548284		YPO_RS21295	39
RV2039_libmerged	4549859	4549885		YPO_RS21300	26
RV2039_libmerged	4549939	4549940		YPO_RS21300	1
RV2039_libmerged	4550090	4550093		YPO_RS21300	3
RV2039_libmerged	4550752	4550773		YPO_RS21305	21
RV2039_libmerged	4550905	4550924		YPO_RS21305	19
RV2039_libmerged	4552017	4552031		YPO_RS21305	14
RV2039_libmerged	4555128	4555138		xylA	10
RV2039_libmerged	4556991	4557028		YPO_RS21325	37
RV2039_libmerged	4557393	4557438		YPO_RS21325	45
RV2039_libmerged	4557953	4557958		YPO_RS21330	5
RV2039_libmerged	4558511	4558517		YPO_RS21330	6
RV2039_libmerged	4561310	4561338		YPO_RS21340	28
RV2039_libmerged	4561700	4561709		YPO_RS21340	9
RV2039_libmerged	4561856	4561867		YPO_RS21340	11
RV2039_libmerged	4563089	4563090		YPO_RS21345	1
RV2039_libmerged	4563179	4563188		YPO_RS21345	9
RV2039_libmerged	4563655	4563669		YPO_RS21345	14
RV2039_libmerged	4563858	4563859		YPO_RS21350	1
RV2039_libmerged	4564104	4564113		YPO_RS21355	9
RV2039_libmerged	4564416	4564434		YPO_RS21355	18
RV2039_libmerged	4565018	4565076		YPO_RS21355	58
RV2039_libmerged	4567001	4567011		YPO_RS21360	10
RV2039_libmerged	4567697	4567721		YPO_RS21370	24
RV2039_libmerged	4567890	4567939		YPO_RS21375	49
RV2039_libmerged	4568363	4568437		YPO_RS21375	74
RV2039_libmerged	4568469	4568481		YPO_RS21380	12
RV2039_libmerged	4569894	4569897		selB	3
RV2039_libmerged	4570568	4570588		selB	20
RV2039_libmerged	4572205	4572237		YPO_RS21400	32
RV2039_libmerged	4572720	4572725		YPO_RS21400	5
RV2039_libmerged	4573079	4573112		fdhE	33
RV2039_libmerged	4574976	4574982		fdxH	6
RV2039_libmerged	4581384	4581395		YPO_RS21435	11
RV2039_libmerged	4581618	4581624		YPO_RS21435	6
RV2039_libmerged	4581822	4581840		YPO_RS21435	18
RV2039_libmerged	4583504	4583536		YPO_RS21440	32
RV2039_libmerged	4584384	4584393		YPO_RS21445	9
RV2039_libmerged	4586819	4586828		YPO_RS21460	9
RV2039_libmerged	4587567	4587569		YPO_RS21465	2
RV2039_libmerged	4590710	4590711		YPO_RS21470	1
RV2039_libmerged	4592332	4592333		glyS	1
RV2039_libmerged	4593679	4593694		glyQ	15
RV2039_libmerged	4595202	4595204		YPO_RS21495	2
RV2039_libmerged	4596149	4596177		YPO_RS21500	28
RV2039_libmerged	4598521	4598522		ghrB	1
RV2039_libmerged	4599891	4599894		YPO_RS21515	3
RV2039_libmerged	4600226	4600228		YPO_RS21515	2
RV2039_libmerged	4601674	4601679		YPO_RS21520	5
RV2039_libmerged	4601734	4601737		YPO_RS21520	3
RV2039_libmerged	4601774	4601776		YPO_RS21520	2
RV2039_libmerged	4601960	4601973		YPO_RS21520	13
RV2039_libmerged	4602810	4602821		YPO_RS21525	11
RV2039_libmerged	4602996	4603021		YPO_RS21525	25
RV2039_libmerged	4604075	4604108		YPO_RS21530	33
RV2039_libmerged	4605541	4605547		YPO_RS21530	6
RV2039_libmerged	4607670	4607673		YPO_RS21545	3
RV2039_libmerged	4610532	4610557		YPO_RS21560	25
RV2039_libmerged	4610978	4611000		YPO_RS21565	22
RV2039_libmerged	4611113	4611118		YPO_RS21565	5
RV2039_libmerged	4611198	4611204		YPO_RS21565	6
RV2039_libmerged	4611256	4611277		YPO_RS21565	21
RV2039_libmerged	4611592	4611614		YPO_RS21565	22
RV2039_libmerged	4611754	4611755		YPO_RS21565	1
RV2039_libmerged	4612519	4612525		yidA	6
RV2039_libmerged	4612920	4612923		yidA	3
RV2039_libmerged	4614292	4614310		gyrB	18
RV2039_libmerged	4615063	4615086		gyrB	23
RV2039_libmerged	4619490	4619501		dnaA	11
RV2039_libmerged	4619564	4619588		dnaA	24
RV2039_libmerged	4621451	4621467		yidC	16
RV2039_libmerged	4622478	4622488		yidC	10
RV2039_libmerged	4622590	4622599		yidC	9
RV2039_libmerged	4623547	4623576		mnmE	29
RV2039_libmerged	4623734	4623749		mnmE	15
RV2039_libmerged	4624071	4624085		mnmE	14
RV2039_libmerged	4624872	4624880		YPO_RS21620	8
RV2039_libmerged	4625543	4625550		YPO_RS21620	7
RV2039_libmerged	4625906	4625934		YPO_RS21625	28
RV2039_libmerged	4626330	4626342		YPO_RS21630	12
RV2039_libmerged	4626611	4626641		YPO_RS21635	30
RV2039_libmerged	4627809	4627812		YPO_RS21640	3
RV2039_libmerged	4629680	4629686		yieH	6
RV2039_libmerged	4630842	4630864		YPO_RS21655	22
RV2039_libmerged	4633107	4633112		YPO_RS21670	5
RV2039_libmerged	4633187	4633217		YPO_RS21670	30
RV2039_libmerged	4634076	4634078		phoU	2
RV2039_libmerged	4634125	4634130		phoU	5
RV2039_libmerged	4634542	4634582		phoU	40
RV2039_libmerged	4636061	4636083		pstA	22
RV2039_libmerged	4636811	4636819		pstC	8
RV2039_libmerged	4637831	4637898		pstS	67
RV2039_libmerged	4639276	4639280		glmS	4
RV2039_libmerged	4639469	4639475		glmS	6
RV2039_libmerged	4639617	4639623		glmS	6
RV2039_libmerged	4640114	4640120		glmS	6
RV2039_libmerged	4640693	4640699		glmS	6
RV2039_libmerged	4640778	4640779		glmS	1
RV2039_libmerged	4641733	4641765		glmU	32
RV2039_libmerged	4642374	4642378		glmU	4
RV2039_libmerged	4643216	4643220		atpC	4
RV2039_libmerged	4643629	4643638		atpC	9
RV2039_libmerged	4644165	4644180		atpD	15
RV2039_libmerged	4644753	4644777		atpD	24
RV2039_libmerged	4645035	4645042		atpD	7
RV2039_libmerged	4645548	4645552		atpG	4
RV2039_libmerged	4646616	4646622		atpA	6
RV2039_libmerged	4646730	4646738		atpA	8
RV2039_libmerged	4646960	4646986		atpA	26
RV2039_libmerged	4647238	4647242		atpA	4
RV2039_libmerged	4648618	4648622		atpF	4
RV2039_libmerged	4649543	4649550		atpB	7
RV2039_libmerged	4649801	4649808		atpB	7
RV2039_libmerged	4650142	4650147		atpI	5
RV2039_libmerged	4651241	4651245		rsmG	4
RV2039_libmerged	4651435	4651444		rsmG	9
RV2039_libmerged	4651493	4651502		rsmG	9
RV2039_libmerged	4651544	4651546		rsmG	2
RV2039_libmerged	4652828	4652829		mnmG	1
RV2039_libmerged	4652881	4652886		mnmG	5
VEL003.B0101_rmdup	959	983		asnC	24
VEL003.B0101_rmdup	1546	1548		YPO_RS01015	2
VEL003.B0101_rmdup	4013	4093		ravA	80
VEL003.B0101_rmdup	5186	5194		ravA	8
VEL003.B0101_rmdup	5434	5447		ravA	13
VEL003.B0101_rmdup	7968	7986		rbsD	18
VEL003.B0101_rmdup	9216	9218		rbsK	2
VEL003.B0101_rmdup	10222	10235		YPO_RS01055	13
VEL003.B0101_rmdup	10655	10658		YPO_RS01055	3
VEL003.B0101_rmdup	11590	11592		YPO_RS01060	2
VEL003.B0101_rmdup	14919	14920		YPO_RS01080	1
VEL003.B0101_rmdup	16015	16016		YPO_RS01080	1
VEL003.B0101_rmdup	18766	18798		YPO_RS01090	32
VEL003.B0101_rmdup	19088	19095		YPO_RS01090	7
VEL003.B0101_rmdup	19623	19627		mobB	4
VEL003.B0101_rmdup	19945	19948		mobA	3
VEL003.B0101_rmdup	20840	20851		YPO_RS01110	11
VEL003.B0101_rmdup	21268	21271		YPO_RS01110	3
VEL003.B0101_rmdup	23032	23069		polA	37
VEL003.B0101_rmdup	24250	24254		polA	4
VEL003.B0101_rmdup	29917	29920		hemN	3
VEL003.B0101_rmdup	33131	33134		glnA	3
VEL003.B0101_rmdup	33168	33178		glnA	10
VEL003.B0101_rmdup	38251	38252		YPO_RS01170	1
VEL003.B0101_rmdup	40040	40067		YPO_RS01180	27
VEL003.B0101_rmdup	41077	41080		YPO_RS01185	3
VEL003.B0101_rmdup	41537	41595		fabY	58
VEL003.B0101_rmdup	49701	49705		trmH	4
VEL003.B0101_rmdup	51113	51116		spoT	3
VEL003.B0101_rmdup	51904	51943		spoT	39
VEL003.B0101_rmdup	53789	53816		ligB	27
VEL003.B0101_rmdup	54144	54155		ligB	11
VEL003.B0101_rmdup	55299	55310		ligB	11
VEL003.B0101_rmdup	55511	55512		YPO_RS01245	1
VEL003.B0101_rmdup	56053	56084		YPO_RS01245	31
VEL003.B0101_rmdup	58827	58853		pyrE	26
VEL003.B0101_rmdup	62985	62987		rpmG	2
VEL003.B0101_rmdup	64817	64837		YPO_RS01310	20
VEL003.B0101_rmdup	67729	67749		rfaC	20
VEL003.B0101_rmdup	68844	68854		rfaF	10
VEL003.B0101_rmdup	69693	69700		rfaD	7
VEL003.B0101_rmdup	71936	71943		tdh	7
VEL003.B0101_rmdup	73613	73615		envC	2
VEL003.B0101_rmdup	73910	73916		envC	6
VEL003.B0101_rmdup	74637	74645		envC	8
VEL003.B0101_rmdup	77644	77645		grxC	1
VEL003.B0101_rmdup	78269	78286		gpsA	17
VEL003.B0101_rmdup	78880	78910		gpsA	30
VEL003.B0101_rmdup	81869	81878		ada	9
VEL003.B0101_rmdup	82516	82534		cpxA	18
VEL003.B0101_rmdup	82565	82600		cpxA	35
VEL003.B0101_rmdup	84573	84575		YPO_RS01405	2
VEL003.B0101_rmdup	85974	85987		YPO_RS01420	13
VEL003.B0101_rmdup	86476	86480		YPO_RS01420	4
VEL003.B0101_rmdup	87917	87925		fieF	8
VEL003.B0101_rmdup	91865	91888		YPO_RS01445	23
VEL003.B0101_rmdup	92489	92494		YPO_RS01445	5
VEL003.B0101_rmdup	98036	98039		YPO_RS01475	3
VEL003.B0101_rmdup	99108	99119		fpr	11
VEL003.B0101_rmdup	106546	106581		YPO_RS01520	35
VEL003.B0101_rmdup	107389	107393		YPO_RS01520	4
VEL003.B0101_rmdup	108541	108565		YPO_RS01530	24
VEL003.B0101_rmdup	111066	111067		YPO_RS01540	1
VEL003.B0101_rmdup	111859	111866		rraA	7
VEL003.B0101_rmdup	113712	113738		hslU	26
VEL003.B0101_rmdup	114412	114447		hslU	35
VEL003.B0101_rmdup	115463	115466		ftsN	3
VEL003.B0101_rmdup	116438	116452		cytR	14
VEL003.B0101_rmdup	125789	125798		YPO_RS01600	9
VEL003.B0101_rmdup	126299	126309		metF	10
VEL003.B0101_rmdup	127212	127225		YPO_RS01610	13
VEL003.B0101_rmdup	128018	128033		YPO_RS01610	15
VEL003.B0101_rmdup	130286	130305		glpG	19
VEL003.B0101_rmdup	131718	131728		malT	10
VEL003.B0101_rmdup	132681	132699		malT	18
VEL003.B0101_rmdup	134742	134753		malP	11
VEL003.B0101_rmdup	137737	137760		malQ	23
VEL003.B0101_rmdup	139744	139749		gntX	5
VEL003.B0101_rmdup	140071	140075		gntX	4
VEL003.B0101_rmdup	141850	141895		YPO_RS01670	45
VEL003.B0101_rmdup	142145	142149		feoB	4
VEL003.B0101_rmdup	142451	142459		feoB	8
VEL003.B0101_rmdup	142587	142600		feoB	13
VEL003.B0101_rmdup	145169	145194		YPO_RS01685	25
VEL003.B0101_rmdup	146251	146264		YPO_RS01685	13
VEL003.B0101_rmdup	147211	147232		YPO_RS01685	21
VEL003.B0101_rmdup	150596	150607		envZ	11
VEL003.B0101_rmdup	151666	151672		pckA	6
VEL003.B0101_rmdup	153080	153104		hslO	24
VEL003.B0101_rmdup	153940	153941		hslR	1
VEL003.B0101_rmdup	159701	159705		mrcA	4
VEL003.B0101_rmdup	159840	159848		mrcA	8
VEL003.B0101_rmdup	159928	159934		mrcA	6
VEL003.B0101_rmdup	160330	160334		mrcA	4
VEL003.B0101_rmdup	163626	163639		hofQ	13
VEL003.B0101_rmdup	168097	168103		YPO_RS01775	6
VEL003.B0101_rmdup	169007	169029		dam	22
VEL003.B0101_rmdup	170910	170927		YPO_RS01790	17
VEL003.B0101_rmdup	171938	171940		trpS	2
VEL003.B0101_rmdup	174346	174361		nirC	15
VEL003.B0101_rmdup	177529	177531		YPO_RS01815	2
VEL003.B0101_rmdup	179373	179374		tsgA	1
VEL003.B0101_rmdup	182189	182191		YPO_RS01830	2
VEL003.B0101_rmdup	183893	183894		YPO_RS01835	1
VEL003.B0101_rmdup	187504	187510		YPO_RS01850	6
VEL003.B0101_rmdup	187595	187603		YPO_RS01850	8
VEL003.B0101_rmdup	188555	188567		YPO_RS01850	12
VEL003.B0101_rmdup	190192	190201		YPO_RS01865	9
VEL003.B0101_rmdup	192975	192980		YPO_RS01880	5
VEL003.B0101_rmdup	196642	196666		YPO_RS01895	24
VEL003.B0101_rmdup	196908	196910		YPO_RS01895	2
VEL003.B0101_rmdup	197468	197488		YPO_RS01900	20
VEL003.B0101_rmdup	200858	200861		tauA	3
VEL003.B0101_rmdup	205677	205700		YPO_RS01945	23
VEL003.B0101_rmdup	208524	208532		kefG	8
VEL003.B0101_rmdup	214071	214079		tusD	8
VEL003.B0101_rmdup	215307	215311		rpsL	4
VEL003.B0101_rmdup	224755	224756		rplV	1
VEL003.B0101_rmdup	225173	225181		rpsC	8
VEL003.B0101_rmdup	228836	228842		rplF	6
VEL003.B0101_rmdup	229056	229070		rplF	14
VEL003.B0101_rmdup	229425	229433		rplR	8
VEL003.B0101_rmdup	236481	236491		YPO_RS02185	10
VEL003.B0101_rmdup	236810	236812		mscL	2
VEL003.B0101_rmdup	237393	237396		trkA	3
VEL003.B0101_rmdup	241435	241455		def	20
VEL003.B0101_rmdup	248712	248718		actP	6
VEL003.B0101_rmdup	249588	249594		actP	6
VEL003.B0101_rmdup	252316	252335		acs	19
VEL003.B0101_rmdup	253596	253597		gltP	1
VEL003.B0101_rmdup	255186	255187		YPO_RS02280	1
VEL003.B0101_rmdup	255750	255756		YPO_RS02285	6
VEL003.B0101_rmdup	256237	256241		YPO_RS02285	4
VEL003.B0101_rmdup	258198	258203		YPO_RS02285	5
VEL003.B0101_rmdup	258747	258778		YPO_RS02290	31
VEL003.B0101_rmdup	258856	258862		YPO_RS02290	6
VEL003.B0101_rmdup	261009	261010		sctD	1
VEL003.B0101_rmdup	263123	263134		sctI	11
VEL003.B0101_rmdup	264879	264883		sctL	4
VEL003.B0101_rmdup	265282	265286		sctL	4
VEL003.B0101_rmdup	265462	265490		YPO_RS02340	28
VEL003.B0101_rmdup	265927	265936		YPO_RS02340	9
VEL003.B0101_rmdup	267782	267787		YPO_RS02345	5
VEL003.B0101_rmdup	267834	267857		YPO_RS02345	23
VEL003.B0101_rmdup	268041	268049		YPO_RS02345	8
VEL003.B0101_rmdup	268546	268569		YPO_RS02345	23
VEL003.B0101_rmdup	270264	270284		YPO_RS02360	20
VEL003.B0101_rmdup	270954	270969		sctR	15
VEL003.B0101_rmdup	271666	271683		sctT	17
VEL003.B0101_rmdup	272283	272284		sctT	1
VEL003.B0101_rmdup	275532	275549		YPO_RS02395	17
VEL003.B0101_rmdup	277900	277913		metC	13
VEL003.B0101_rmdup	278608	278609		metC	1
VEL003.B0101_rmdup	279218	279231		YPO_RS02410	13
VEL003.B0101_rmdup	280134	280146		YPO_RS02415	12
VEL003.B0101_rmdup	281544	281555		YPO_RS02420	11
VEL003.B0101_rmdup	281656	281657		YPO_RS02420	1
VEL003.B0101_rmdup	282532	282535		YPO_RS02425	3
VEL003.B0101_rmdup	283954	283957		YPO_RS02430	3
VEL003.B0101_rmdup	286047	286051		YPO_RS02440	4
VEL003.B0101_rmdup	286607	286610		hutX	3
VEL003.B0101_rmdup	287875	287876		YPO_RS02450	1
VEL003.B0101_rmdup	288872	288896		YPO_RS02455	24
VEL003.B0101_rmdup	289431	289458		YPO_RS02460	27
VEL003.B0101_rmdup	291163	291171		YPO_RS02465	8
VEL003.B0101_rmdup	294342	294362		YPO_RS02485	20
VEL003.B0101_rmdup	294464	294481		YPO_RS02485	17
VEL003.B0101_rmdup	295048	295051		YPO_RS02485	3
VEL003.B0101_rmdup	296594	296595		YPO_RS02495	1
VEL003.B0101_rmdup	304074	304092		YPO_RS02530	18
VEL003.B0101_rmdup	305413	305429		YPO_RS02535	16
VEL003.B0101_rmdup	311690	311711		YPO_RS02555	21
VEL003.B0101_rmdup	312366	312378		yapK	12
VEL003.B0101_rmdup	312857	312861		yapK	4
VEL003.B0101_rmdup	312963	312979		yapK	16
VEL003.B0101_rmdup	313955	313958		yapK	3
VEL003.B0101_rmdup	315088	315093		yapK	5
VEL003.B0101_rmdup	320201	320228		plsB	27
VEL003.B0101_rmdup	321774	321797		lexA	23
VEL003.B0101_rmdup	325782	325796		YPO_RS02605	14
VEL003.B0101_rmdup	326939	326955		dnaB	16
VEL003.B0101_rmdup	327473	327502		dnaB	29
VEL003.B0101_rmdup	333342	333349		uvrA	7
VEL003.B0101_rmdup	334897	334914		ssb1	17
VEL003.B0101_rmdup	335078	335100		ssb1	22
VEL003.B0101_rmdup	340025	340026		rhaB	1
VEL003.B0101_rmdup	345070	345108		YPO_RS02690	38
VEL003.B0101_rmdup	345926	345963		YPO_RS02695	37
VEL003.B0101_rmdup	346039	346110		YPO_RS02695	71
VEL003.B0101_rmdup	346646	346663		YPO_RS02695	17
VEL003.B0101_rmdup	347183	347194		YPO_RS02695	11
VEL003.B0101_rmdup	347615	347619		YPO_RS02695	4
VEL003.B0101_rmdup	348020	348042		YPO_RS02695	22
VEL003.B0101_rmdup	348148	348172		YPO_RS02695	24
VEL003.B0101_rmdup	351823	351850		aegA	27
VEL003.B0101_rmdup	353954	353963		fdhF	9
VEL003.B0101_rmdup	354361	354369		fdhF	8
VEL003.B0101_rmdup	356515	356535		YPO_RS02725	20
VEL003.B0101_rmdup	359117	359128		aspA	11
VEL003.B0101_rmdup	360467	360496		fxsA	29
VEL003.B0101_rmdup	363098	363102		groL	4
VEL003.B0101_rmdup	363141	363143		groL	2
VEL003.B0101_rmdup	365396	365401		epmB	5
VEL003.B0101_rmdup	371052	371067		YPO_RS02805	15
VEL003.B0101_rmdup	371105	371112		YPO_RS02805	7
VEL003.B0101_rmdup	373585	373633		mscM	48
VEL003.B0101_rmdup	380518	380525		queG	7
VEL003.B0101_rmdup	381880	381881		nnr	1
VEL003.B0101_rmdup	383768	383791		amiB	23
VEL003.B0101_rmdup	386121	386128		mutL	7
VEL003.B0101_rmdup	387186	387199		miaA	13
VEL003.B0101_rmdup	391614	391616		hflC	2
VEL003.B0101_rmdup	394696	394706		nsrR	10
VEL003.B0101_rmdup	396152	396178		rnr	26
VEL003.B0101_rmdup	396413	396415		rnr	2
VEL003.B0101_rmdup	397246	397250		rnr	4
VEL003.B0101_rmdup	397728	397758		rlmB	30
VEL003.B0101_rmdup	397950	397957		rlmB	7
VEL003.B0101_rmdup	401048	401049		YPO_RS02925	1
VEL003.B0101_rmdup	402852	402856		YPO_RS02935	4
VEL003.B0101_rmdup	405899	405910		YPO_RS02945	11
VEL003.B0101_rmdup	407822	407878		YPO_RS02955	56
VEL003.B0101_rmdup	408057	408059		YPO_RS02955	2
VEL003.B0101_rmdup	408273	408318		YPO_RS02955	45
VEL003.B0101_rmdup	408398	408417		YPO_RS02955	19
VEL003.B0101_rmdup	408991	409033		YPO_RS02960	42
VEL003.B0101_rmdup	409205	409222		YPO_RS02960	17
VEL003.B0101_rmdup	409482	409505		YPO_RS02960	23
VEL003.B0101_rmdup	409714	409795		YPO_RS02965	81
VEL003.B0101_rmdup	409846	409869		YPO_RS02965	23
VEL003.B0101_rmdup	410384	410398		YPO_RS02965	14
VEL003.B0101_rmdup	410844	410891		YPO_RS02965	47
VEL003.B0101_rmdup	409587	409662		YPO_RS02965	75
VEL003.B0101_rmdup	413270	413275		YPO_RS02980	5
VEL003.B0101_rmdup	415615	415625		YPO_RS02990	10
VEL003.B0101_rmdup	415841	415848		YPO_RS02990	7
VEL003.B0101_rmdup	416432	416455		YPO_RS02995	23
VEL003.B0101_rmdup	417003	417018		YPO_RS02995	15
VEL003.B0101_rmdup	417084	417101		YPO_RS02995	17
VEL003.B0101_rmdup	418329	418343		YPO_RS03000	14
VEL003.B0101_rmdup	418345	418382		YPO_RS03005	37
VEL003.B0101_rmdup	418530	418553		YPO_RS03005	23
VEL003.B0101_rmdup	418726	418730		YPO_RS03005	4
VEL003.B0101_rmdup	422030	422059		ptsP	29
VEL003.B0101_rmdup	422223	422232		ptsP	9
VEL003.B0101_rmdup	422432	422442		ptsP	10
VEL003.B0101_rmdup	423111	423112		ptsP	1
VEL003.B0101_rmdup	423293	423297		ptsP	4
VEL003.B0101_rmdup	423826	423840		ptsP	14
VEL003.B0101_rmdup	426087	426094		lsrF	7
VEL003.B0101_rmdup	428851	428856		lsrC	5
VEL003.B0101_rmdup	429199	429212		lsrC	13
VEL003.B0101_rmdup	430165	430178		lsrA	13
VEL003.B0101_rmdup	431280	431395		YPO_RS03065	115
VEL003.B0101_rmdup	433196	433228		lsrK	32
VEL003.B0101_rmdup	434001	434021		lsrK	20
VEL003.B0101_rmdup	434117	434136		lsrK	19
VEL003.B0101_rmdup	445543	445560		YPO_RS03120	17
VEL003.B0101_rmdup	446228	446239		YPO_RS03120	11
VEL003.B0101_rmdup	449140	449179		YPO_RS03140	39
VEL003.B0101_rmdup	453377	453448		YPO_RS03165	71
VEL003.B0101_rmdup	455550	455552		YPO_RS03175	2
VEL003.B0101_rmdup	456142	456166		YPO_RS03175	24
VEL003.B0101_rmdup	461555	461558		deoD	3
VEL003.B0101_rmdup	466420	466428		nadR	8
VEL003.B0101_rmdup	478388	478394		trpR	6
VEL003.B0101_rmdup	478631	478633		yjjX	2
VEL003.B0101_rmdup	484992	484993		thrA	1
VEL003.B0101_rmdup	493618	493644		YPO_RS03330	26
VEL003.B0101_rmdup	494654	494711		YPO_RS03330	57
VEL003.B0101_rmdup	494973	495056		YPO_RS03330	83
VEL003.B0101_rmdup	495303	495310		YPO_RS03330	7
VEL003.B0101_rmdup	495364	495404		YPO_RS03330	40
VEL003.B0101_rmdup	495716	495791		YPO_RS03330	75
VEL003.B0101_rmdup	495902	495925		YPO_RS03330	23
VEL003.B0101_rmdup	499576	499597		dnaJ	21
VEL003.B0101_rmdup	499869	499871		dnaJ	2
VEL003.B0101_rmdup	500493	500500		dnaJ	7
VEL003.B0101_rmdup	501050	501053		nhaA	3
VEL003.B0101_rmdup	501105	501120		nhaA	15
VEL003.B0101_rmdup	507516	507517		ileS	1
VEL003.B0101_rmdup	513816	513839		carB	23
VEL003.B0101_rmdup	516159	516164		carB	5
VEL003.B0101_rmdup	516353	516359		carB	6
VEL003.B0101_rmdup	517077	517093		YPO_RS03420	16
VEL003.B0101_rmdup	518191	518209		YPO_RS03425	18
VEL003.B0101_rmdup	519099	519125		folA	26
VEL003.B0101_rmdup	520994	521002		YPO_RS03445	8
VEL003.B0101_rmdup	521134	521152		YPO_RS03450	18
VEL003.B0101_rmdup	521437	521438		YPO_RS03450	1
VEL003.B0101_rmdup	521742	521743		apaH	1
VEL003.B0101_rmdup	524635	524644		pdxA	9
VEL003.B0101_rmdup	524683	524698		pdxA	15
VEL003.B0101_rmdup	524778	524781		surA	3
VEL003.B0101_rmdup	526780	526781		lptD	1
VEL003.B0101_rmdup	527546	527547		lptD	1
VEL003.B0101_rmdup	527557	527575		lptD	18
VEL003.B0101_rmdup	532257	532266		YPO_RS03495	9
VEL003.B0101_rmdup	534609	534625		tssC	16
VEL003.B0101_rmdup	540249	540254		tssH	5
VEL003.B0101_rmdup	540882	540891		tssH	9
VEL003.B0101_rmdup	541075	541083		tssH	8
VEL003.B0101_rmdup	541640	541644		tssH	4
VEL003.B0101_rmdup	542250	542253		tssH	3
VEL003.B0101_rmdup	544357	544359		vgrG	2
VEL003.B0101_rmdup	550815	550824		tssK	9
VEL003.B0101_rmdup	552372	552398		YPO_RS03580	26
VEL003.B0101_rmdup	552875	552883		tssM	8
VEL003.B0101_rmdup	554835	554850		tssM	15
VEL003.B0101_rmdup	555556	555559		tssM	3
VEL003.B0101_rmdup	558771	558779		rapA	8
VEL003.B0101_rmdup	559410	559415		rapA	5
VEL003.B0101_rmdup	562644	562682		YPO_RS03600	38
VEL003.B0101_rmdup	562972	562998		YPO_RS03605	26
VEL003.B0101_rmdup	563465	563476		YPO_RS03605	11
VEL003.B0101_rmdup	563755	563769		thiQ	14
VEL003.B0101_rmdup	564016	564030		thiQ	14
VEL003.B0101_rmdup	564326	564356		thiQ	30
VEL003.B0101_rmdup	565230	565233		thiP	3
VEL003.B0101_rmdup	566769	566780		YPO_RS03620	11
VEL003.B0101_rmdup	568432	568442		YPO_RS03625	10
VEL003.B0101_rmdup	571497	571510		YPO_RS03635	13
VEL003.B0101_rmdup	572714	572716		YPO_RS03640	2
VEL003.B0101_rmdup	573140	573153		YPO_RS03645	13
VEL003.B0101_rmdup	576127	576130		leuB	3
VEL003.B0101_rmdup	576713	576714		leuB	1
VEL003.B0101_rmdup	579371	579372		YPO_RS03675	1
VEL003.B0101_rmdup	579546	579586		YPO_RS03675	40
VEL003.B0101_rmdup	583164	583169		YPO_RS03685	5
VEL003.B0101_rmdup	588396	588399		cra	3
VEL003.B0101_rmdup	592032	592054		YPO_RS03735	22
VEL003.B0101_rmdup	592188	592202		YPO_RS03735	14
VEL003.B0101_rmdup	592921	592930		YPO_RS03735	9
VEL003.B0101_rmdup	593559	593581		YPO_RS03735	22
VEL003.B0101_rmdup	594033	594045		murE	12
VEL003.B0101_rmdup	594244	594255		murE	11
VEL003.B0101_rmdup	595316	595351		murF	35
VEL003.B0101_rmdup	595758	595811		murF	53
VEL003.B0101_rmdup	596046	596067		murF	21
VEL003.B0101_rmdup	596613	596623		mraY	10
VEL003.B0101_rmdup	597564	597570		mraY	6
VEL003.B0101_rmdup	598403	598416		murD	13
VEL003.B0101_rmdup	598800	598808		murD	8
VEL003.B0101_rmdup	598941	598951		ftsW	10
VEL003.B0101_rmdup	600143	600147		murG	4
VEL003.B0101_rmdup	600890	600908		murG	18
VEL003.B0101_rmdup	602345	602354		murC	9
VEL003.B0101_rmdup	602532	602548		murC	16
VEL003.B0101_rmdup	608243	608246		YPO_RS03800	3
VEL003.B0101_rmdup	613354	613355		YPO_RS03820	1
VEL003.B0101_rmdup	613442	613448		YPO_RS03820	6
VEL003.B0101_rmdup	617190	617201		YPO_RS03855	11
VEL003.B0101_rmdup	617247	617267		YPO_RS03855	20
VEL003.B0101_rmdup	618454	618464		YPO_RS03865	10
VEL003.B0101_rmdup	621736	621741		YPO_RS03880	5
VEL003.B0101_rmdup	621773	621776		YPO_RS03880	3
VEL003.B0101_rmdup	621870	621876		YPO_RS03880	6
VEL003.B0101_rmdup	623219	623221		uxaC	2
VEL003.B0101_rmdup	624126	624133		uxaC	7
VEL003.B0101_rmdup	629200	629207		sstT	7
VEL003.B0101_rmdup	632822	632823		yapG	1
VEL003.B0101_rmdup	633064	633077		yapG	13
VEL003.B0101_rmdup	633806	633824		yapG	18
VEL003.B0101_rmdup	635286	635308		yapG	22
VEL003.B0101_rmdup	635503	635517		yapG	14
VEL003.B0101_rmdup	637702	637711		YPO_RS03935	9
VEL003.B0101_rmdup	639712	639723		YPO_RS03940	11
VEL003.B0101_rmdup	641718	641719		YPO_RS03945	1
VEL003.B0101_rmdup	642904	642906		YPO_RS03950	2
VEL003.B0101_rmdup	647586	647601		YPO_RS03975	15
VEL003.B0101_rmdup	647859	647865		YPO_RS03975	6
VEL003.B0101_rmdup	648216	648227		YPO_RS03975	11
VEL003.B0101_rmdup	649159	649180		YPO_RS03975	21
VEL003.B0101_rmdup	649377	649379		cdiA	2
VEL003.B0101_rmdup	649387	649390		cdiA	3
VEL003.B0101_rmdup	650577	650586		cdiA	9
VEL003.B0101_rmdup	653259	653292		cdiA	33
VEL003.B0101_rmdup	653729	653734		cdiA	5
VEL003.B0101_rmdup	654156	654159		cdiA	3
VEL003.B0101_rmdup	654784	654787		cdiA	3
VEL003.B0101_rmdup	656702	656705		cdiA	3
VEL003.B0101_rmdup	657343	657370		cdiA	27
VEL003.B0101_rmdup	658172	658179		cdiA	7
VEL003.B0101_rmdup	658648	658651		cdiA	3
VEL003.B0101_rmdup	659221	659240		cdiI	19
VEL003.B0101_rmdup	659350	659387		cdiI	37
VEL003.B0101_rmdup	660474	660485		YPO_RS04010	11
VEL003.B0101_rmdup	660830	660831		YPO_RS04010	1
VEL003.B0101_rmdup	662293	662300		yapF	7
VEL003.B0101_rmdup	663124	663148		yapF	24
VEL003.B0101_rmdup	663501	663514		yapF	13
VEL003.B0101_rmdup	664340	664363		YPO_RS04025	23
VEL003.B0101_rmdup	664982	664998		YPO_RS04025	16
VEL003.B0101_rmdup	666531	666546		YPO_RS04030	15
VEL003.B0101_rmdup	667391	667401		YPO_RS04035	10
VEL003.B0101_rmdup	667977	667987		YPO_RS04035	10
VEL003.B0101_rmdup	668135	668141		YPO_RS04040	6
VEL003.B0101_rmdup	668370	668391		YPO_RS04040	21
VEL003.B0101_rmdup	669257	669270		YPO_RS04040	13
VEL003.B0101_rmdup	669604	669621		YPO_RS04040	17
VEL003.B0101_rmdup	670176	670185		YPO_RS04040	9
VEL003.B0101_rmdup	670943	670945		YPO_RS04040	2
VEL003.B0101_rmdup	671269	671272		YPO_RS04040	3
VEL003.B0101_rmdup	671773	671823		YPO_RS04045	50
VEL003.B0101_rmdup	672631	672680		YPO_RS04050	49
VEL003.B0101_rmdup	673946	673971		YPO_RS04055	25
VEL003.B0101_rmdup	674606	674637		YPO_RS04055	31
VEL003.B0101_rmdup	675969	675981		YPO_RS04065	12
VEL003.B0101_rmdup	676660	676669		YPO_RS04070	9
VEL003.B0101_rmdup	677371	677410		YPO_RS04070	39
VEL003.B0101_rmdup	677570	677582		YPO_RS04070	12
VEL003.B0101_rmdup	679058	679064		YPO_RS04075	6
VEL003.B0101_rmdup	679760	679762		YPO_RS04075	2
VEL003.B0101_rmdup	680323	680327		YPO_RS04080	4
VEL003.B0101_rmdup	681714	681724		YPO_RS04080	10
VEL003.B0101_rmdup	682054	682059		mdtN	5
VEL003.B0101_rmdup	682269	682312		mdtN	43
VEL003.B0101_rmdup	682754	682780		mdtN	26
VEL003.B0101_rmdup	684668	684673		YPO_RS04100	5
VEL003.B0101_rmdup	685724	685727		YPO_RS04105	3
VEL003.B0101_rmdup	687954	687970		YPO_RS04115	16
VEL003.B0101_rmdup	688318	688337		YPO_RS04120	19
VEL003.B0101_rmdup	689068	689072		YPO_RS04125	4
VEL003.B0101_rmdup	695169	695186		YPO_RS04165	17
VEL003.B0101_rmdup	696401	696408		YPO_RS04170	7
VEL003.B0101_rmdup	696892	697019		YPO_RS04170	127
VEL003.B0101_rmdup	703275	703278		rpsU	3
VEL003.B0101_rmdup	704022	704032		tsaD	10
VEL003.B0101_rmdup	704525	704535		tsaD	10
VEL003.B0101_rmdup	704976	705023		plsY	47
VEL003.B0101_rmdup	707558	707574		YPO_RS04230	16
VEL003.B0101_rmdup	708444	708452		YPO_RS04230	8
VEL003.B0101_rmdup	708563	708576		YPO_RS04230	13
VEL003.B0101_rmdup	712668	712671		glnE	3
VEL003.B0101_rmdup	715310	715313		hldE	3
VEL003.B0101_rmdup	718270	718282		ribB	12
VEL003.B0101_rmdup	719473	719515		ygiD	42
VEL003.B0101_rmdup	721434	721462		YPO_RS04275	28
VEL003.B0101_rmdup	726475	726478		yqiA	3
VEL003.B0101_rmdup	729417	729429		YPO_RS04315	12
VEL003.B0101_rmdup	729839	729846		YPO_RS04315	7
VEL003.B0101_rmdup	731245	731263		parC	18
VEL003.B0101_rmdup	731926	731941		parC	15
VEL003.B0101_rmdup	742562	742588		YPO_RS04370	26
VEL003.B0101_rmdup	743634	743637		metC	3
VEL003.B0101_rmdup	743691	743692		metC	1
VEL003.B0101_rmdup	744035	744048		metC	13
VEL003.B0101_rmdup	744811	744861		exbB	50
VEL003.B0101_rmdup	745912	745913		exbD	1
VEL003.B0101_rmdup	746923	746946		YPO_RS04390	23
VEL003.B0101_rmdup	747771	747797		YPO_RS04390	26
VEL003.B0101_rmdup	749195	749202		YPO_RS04405	7
VEL003.B0101_rmdup	749295	749371		YPO_RS04405	76
VEL003.B0101_rmdup	749604	749645		YPO_RS04405	41
VEL003.B0101_rmdup	749629	749662		YPO_RS04410	33
VEL003.B0101_rmdup	750075	750102		YPO_RS04410	27
VEL003.B0101_rmdup	750201	750270		YPO_RS04410	69
VEL003.B0101_rmdup	750373	750382		YPO_RS04410	9
VEL003.B0101_rmdup	750439	750462		YPO_RS04410	23
VEL003.B0101_rmdup	750459	750548		YPO_RS04415	89
VEL003.B0101_rmdup	750755	750756		YPO_RS04415	1
VEL003.B0101_rmdup	751188	751214		YPO_RS04415	26
VEL003.B0101_rmdup	752464	752465		YPO_RS04420	1
VEL003.B0101_rmdup	752664	752690		YPO_RS04425	26
VEL003.B0101_rmdup	753724	753756		YPO_RS04425	32
VEL003.B0101_rmdup	753767	753786		YPO_RS04430	19
VEL003.B0101_rmdup	753934	753953		YPO_RS04430	19
VEL003.B0101_rmdup	754730	754733		YPO_RS04440	3
VEL003.B0101_rmdup	754862	754893		YPO_RS04440	31
VEL003.B0101_rmdup	754979	755032		YPO_RS04440	53
VEL003.B0101_rmdup	755332	755358		YPO_RS04440	26
VEL003.B0101_rmdup	755526	755565		YPO_RS04445	39
VEL003.B0101_rmdup	756534	756623		YPO_RS04450	89
VEL003.B0101_rmdup	761076	761080		YPO_RS04470	4
VEL003.B0101_rmdup	763891	763892		fepB	1
VEL003.B0101_rmdup	766202	766224		YPO_RS04490	22
VEL003.B0101_rmdup	769882	769901		flhB	19
VEL003.B0101_rmdup	770298	770307		YPO_RS04505	9
VEL003.B0101_rmdup	771310	771331		fliP	21
VEL003.B0101_rmdup	771724	771763		fliP	39
VEL003.B0101_rmdup	772027	772028		fliN	1
VEL003.B0101_rmdup	772606	772615		YPO_RS04525	9
VEL003.B0101_rmdup	772970	773003		YPO_RS04525	33
VEL003.B0101_rmdup	774516	774540		YPO_RS04530	24
VEL003.B0101_rmdup	777796	777839		YPO_RS04550	43
VEL003.B0101_rmdup	779363	779364		fliI	1
VEL003.B0101_rmdup	780169	780190		fliJ	21
VEL003.B0101_rmdup	782889	782913		flgC	24
VEL003.B0101_rmdup	784107	784125		flaE	18
VEL003.B0101_rmdup	785303	785368		YPO_RS04600	65
VEL003.B0101_rmdup	787682	787685		flgH	3
VEL003.B0101_rmdup	788912	788916		YPO_RS04625	4
VEL003.B0101_rmdup	790086	790089		flgK	3
VEL003.B0101_rmdup	791134	791141		flgK	7
VEL003.B0101_rmdup	791741	791742		flgL	1
VEL003.B0101_rmdup	791807	791811		flgL	4
VEL003.B0101_rmdup	793090	793101		YPO_RS04645	11
VEL003.B0101_rmdup	793483	793487		YPO_RS04650	4
VEL003.B0101_rmdup	796055	796076		YPO_RS04660	21
VEL003.B0101_rmdup	796152	796176		YPO_RS04660	24
VEL003.B0101_rmdup	799310	799318		YPO_RS04670	8
VEL003.B0101_rmdup	801211	801221		fliD	10
VEL003.B0101_rmdup	801476	801508		fliS	32
VEL003.B0101_rmdup	803189	803195		YPO_RS04690	6
VEL003.B0101_rmdup	803326	803348		YPO_RS04695	22
VEL003.B0101_rmdup	803586	803587		YPO_RS04695	1
VEL003.B0101_rmdup	804904	804920		motA	16
VEL003.B0101_rmdup	806658	806677		YPO_RS04715	19
VEL003.B0101_rmdup	807643	807706		YPO_RS04720	63
VEL003.B0101_rmdup	807690	807706		YPO_RS04725	16
VEL003.B0101_rmdup	807956	807961		YPO_RS04725	5
VEL003.B0101_rmdup	809186	809241		YPO_RS04735	55
VEL003.B0101_rmdup	812723	812729		YPO_RS04750	6
VEL003.B0101_rmdup	816397	816455		YPO_RS04765	58
VEL003.B0101_rmdup	816678	816679		YPO_RS04765	1
VEL003.B0101_rmdup	817916	817917		YPO_RS04770	1
VEL003.B0101_rmdup	818918	818924		YPO_RS04770	6
VEL003.B0101_rmdup	820905	820920		YPO_RS04770	15
VEL003.B0101_rmdup	821515	821517		YPO_RS04775	2
VEL003.B0101_rmdup	822640	822659		vgrG	19
VEL003.B0101_rmdup	822822	822828		vgrG	6
VEL003.B0101_rmdup	834340	834341		YPO_RS04800	1
VEL003.B0101_rmdup	835345	835358		YPO_RS04805	13
VEL003.B0101_rmdup	837237	837272		YPO_RS04810	35
VEL003.B0101_rmdup	837606	837617		YPO_RS04810	11
VEL003.B0101_rmdup	838390	838409		YPO_RS04810	19
VEL003.B0101_rmdup	838845	838908		YPO_RS04815	63
VEL003.B0101_rmdup	840820	840823		YPO_RS04825	3
VEL003.B0101_rmdup	841133	841217		YPO_RS04825	84
VEL003.B0101_rmdup	841502	841508		YPO_RS04825	6
VEL003.B0101_rmdup	842058	842077		YPO_RS04830	19
VEL003.B0101_rmdup	843425	843444		YPO_RS04835	19
VEL003.B0101_rmdup	843749	843764		YPO_RS04835	15
VEL003.B0101_rmdup	843820	843828		YPO_RS04835	8
VEL003.B0101_rmdup	845412	845613		YPO_RS04835	201
VEL003.B0101_rmdup	845921	845930		YPO_RS04835	9
VEL003.B0101_rmdup	846127	846175		YPO_RS04835	48
VEL003.B0101_rmdup	846662	846676		YPO_RS04835	14
VEL003.B0101_rmdup	847028	847033		YPO_RS04835	5
VEL003.B0101_rmdup	849547	849585		YPO_RS04840	38
VEL003.B0101_rmdup	850044	850045		YPO_RS04840	1
VEL003.B0101_rmdup	853772	853787		YPO_RS04845	15
VEL003.B0101_rmdup	854083	854107		YPO_RS04845	24
VEL003.B0101_rmdup	856072	856080		YPO_RS04845	8
VEL003.B0101_rmdup	856771	856783		YPO_RS04845	12
VEL003.B0101_rmdup	858885	858891		YPO_RS04860	6
VEL003.B0101_rmdup	863125	863153		ptsP	28
VEL003.B0101_rmdup	865352	865356		mutH	4
VEL003.B0101_rmdup	866957	866961		YPO_RS04890	4
VEL003.B0101_rmdup	867779	867802		YPO_RS04900	23
VEL003.B0101_rmdup	867907	867920		YPO_RS04900	13
VEL003.B0101_rmdup	868567	868584		lplT	17
VEL003.B0101_rmdup	871153	871158		aas	5
VEL003.B0101_rmdup	875565	875573		lysA	8
VEL003.B0101_rmdup	877874	877927		YPO_RS04935	53
VEL003.B0101_rmdup	878397	878401		YPO_RS04935	4
VEL003.B0101_rmdup	881366	881373		YPO_RS04950	7
VEL003.B0101_rmdup	883492	883522		YPO_RS04955	30
VEL003.B0101_rmdup	884302	884328		YPO_RS04965	26
VEL003.B0101_rmdup	884428	884443		YPO_RS04965	15
VEL003.B0101_rmdup	885658	885705		YPO_RS04975	47
VEL003.B0101_rmdup	886156	886190		YPO_RS04975	34
VEL003.B0101_rmdup	886242	886243		YPO_RS04975	1
VEL003.B0101_rmdup	886602	886680		YPO_RS04980	78
VEL003.B0101_rmdup	887039	887050		gspL	11
VEL003.B0101_rmdup	887110	887111		gspL	1
VEL003.B0101_rmdup	887260	887269		gspL	9
VEL003.B0101_rmdup	887371	887379		gspL	8
VEL003.B0101_rmdup	887759	887835		gspL	76
VEL003.B0101_rmdup	888164	888234		YPO_RS04990	70
VEL003.B0101_rmdup	888824	888825		YPO_RS04990	1
VEL003.B0101_rmdup	889305	889378		gspJ	73
VEL003.B0101_rmdup	889516	889529		gspJ	13
VEL003.B0101_rmdup	889955	889970		gspI	15
VEL003.B0101_rmdup	889984	890040		YPO_RS05005	56
VEL003.B0101_rmdup	893722	893827		gspD	105
VEL003.B0101_rmdup	894703	894731		gspD	28
VEL003.B0101_rmdup	894848	894873		gspD	25
VEL003.B0101_rmdup	894937	894953		gspD	16
VEL003.B0101_rmdup	895427	895522		gspD	95
VEL003.B0101_rmdup	895597	895606		gspD	9
VEL003.B0101_rmdup	895760	895762		YPO_RS05030	2
VEL003.B0101_rmdup	895892	895942		YPO_RS05030	50
VEL003.B0101_rmdup	896116	896190		YPO_RS05030	74
VEL003.B0101_rmdup	900606	900615		yapM	9
VEL003.B0101_rmdup	903881	903887		YPO_RS05060	6
VEL003.B0101_rmdup	903985	903993		YPO_RS05060	8
VEL003.B0101_rmdup	906648	906655		YPO_RS05065	7
VEL003.B0101_rmdup	907345	907358		YPO_RS05070	13
VEL003.B0101_rmdup	907995	908001		YPO_RS05070	6
VEL003.B0101_rmdup	908114	908131		tnpA	17
VEL003.B0101_rmdup	909208	909222		YPO_RS05080	14
VEL003.B0101_rmdup	910426	910459		YPO_RS05080	33
VEL003.B0101_rmdup	913970	913975		YPO_RS05095	5
VEL003.B0101_rmdup	914842	914854		YPO_RS05100	12
VEL003.B0101_rmdup	915421	915443		YPO_RS05105	22
VEL003.B0101_rmdup	917702	917735		nagA	33
VEL003.B0101_rmdup	918126	918141		nagA	15
VEL003.B0101_rmdup	918456	918462		nagA	6
VEL003.B0101_rmdup	920360	920374		YPO_RS05130	14
VEL003.B0101_rmdup	921688	921692		YPO_RS05135	4
VEL003.B0101_rmdup	922141	922170		YPO_RS05140	29
VEL003.B0101_rmdup	923133	923150		YPO_RS05140	17
VEL003.B0101_rmdup	924410	924415		YPO_RS05145	5
VEL003.B0101_rmdup	924595	924603		YPO_RS05145	8
VEL003.B0101_rmdup	924800	924807		YPO_RS05145	7
VEL003.B0101_rmdup	924912	924914		YPO_RS05145	2
VEL003.B0101_rmdup	926040	926068		YPO_RS05150	28
VEL003.B0101_rmdup	926871	926877		YPO_RS05155	6
VEL003.B0101_rmdup	928963	928977		YPO_RS05165	14
VEL003.B0101_rmdup	929459	929461		YPO_RS05165	2
VEL003.B0101_rmdup	930401	930418		YPO_RS05170	17
VEL003.B0101_rmdup	933621	933623		YPO_RS05175	2
VEL003.B0101_rmdup	934314	934326		YPO_RS05180	12
VEL003.B0101_rmdup	936260	936264		YPO_RS05190	4
VEL003.B0101_rmdup	936428	936439		YPO_RS05190	11
VEL003.B0101_rmdup	937855	937859		YPO_RS05190	4
VEL003.B0101_rmdup	940535	940580		YPO_RS05205	45
VEL003.B0101_rmdup	942216	942219		YPO_RS05210	3
VEL003.B0101_rmdup	944182	944189		YPO_RS05215	7
VEL003.B0101_rmdup	946188	946196		YPO_RS05220	8
VEL003.B0101_rmdup	946955	946965		YPO_RS05225	10
VEL003.B0101_rmdup	949950	949957		YPO_RS05235	7
VEL003.B0101_rmdup	950148	950187		YPO_RS05235	39
VEL003.B0101_rmdup	953671	953685		YPO_RS05260	14
VEL003.B0101_rmdup	953756	953807		YPO_RS05260	51
VEL003.B0101_rmdup	957891	957899		YPO_RS05270	8
VEL003.B0101_rmdup	958359	958365		YPO_RS05275	6
VEL003.B0101_rmdup	960208	960209		YPO_RS05290	1
VEL003.B0101_rmdup	960374	960375		YPO_RS05290	1
VEL003.B0101_rmdup	960668	960670		YPO_RS05290	2
VEL003.B0101_rmdup	963335	963343		YPO_RS05305	8
VEL003.B0101_rmdup	963551	963569		YPO_RS05310	18
VEL003.B0101_rmdup	963627	963648		YPO_RS05310	21
VEL003.B0101_rmdup	963703	963706		YPO_RS05310	3
VEL003.B0101_rmdup	964103	964110		YPO_RS05315	7
VEL003.B0101_rmdup	965255	965257		YPO_RS05330	2
VEL003.B0101_rmdup	966448	966449		YPO_RS05330	1
VEL003.B0101_rmdup	966483	966584		YPO_RS05330	101
VEL003.B0101_rmdup	971292	971311		YPO_RS05360	19
VEL003.B0101_rmdup	971808	971815		lysS	7
VEL003.B0101_rmdup	976927	976934		dsbC	7
VEL003.B0101_rmdup	976992	977004		dsbC	12
VEL003.B0101_rmdup	977731	977739		xerD	8
VEL003.B0101_rmdup	979646	979673		creD	27
VEL003.B0101_rmdup	982413	982415		YPO_RS05415	2
VEL003.B0101_rmdup	984102	984140		ygfZ	38
VEL003.B0101_rmdup	992000	992007		gcvP	7
VEL003.B0101_rmdup	993951	993996		gcvP	45
VEL003.B0101_rmdup	997021	997032		ubiI	11
VEL003.B0101_rmdup	997628	997636		ubiI	8
VEL003.B0101_rmdup	997722	997739		ubiI	17
VEL003.B0101_rmdup	999940	999953		pepP	13
VEL003.B0101_rmdup	1001230	1001238		YPO_RS05490	8
VEL003.B0101_rmdup	1002021	1002025		ssrS	4
VEL003.B0101_rmdup	1002121	1002153		ssrS	32
VEL003.B0101_rmdup	1006651	1006656		YPO_RS05525	5
VEL003.B0101_rmdup	1007994	1007995		argO	1
VEL003.B0101_rmdup	1011373	1011382		pgk	9
VEL003.B0101_rmdup	1014013	1014028		YPO_RS05555	15
VEL003.B0101_rmdup	1014710	1014714		YPO_RS05560	4
VEL003.B0101_rmdup	1016602	1016611		tkt	9
VEL003.B0101_rmdup	1023726	1023729		metK	3
VEL003.B0101_rmdup	1025336	1025338		YPO_RS05600	2
VEL003.B0101_rmdup	1029938	1029941		aguB	3
VEL003.B0101_rmdup	1031212	1031223		aguA	11
VEL003.B0101_rmdup	1033134	1033161		YPO_RS05645	27
VEL003.B0101_rmdup	1033309	1033314		YPO_RS05645	5
VEL003.B0101_rmdup	1033679	1033687		YPO_RS05650	8
VEL003.B0101_rmdup	1037104	1037108		hemW	4
VEL003.B0101_rmdup	1039397	1039400		YPO_RS05675	3
VEL003.B0101_rmdup	1040217	1040234		YPO_RS05675	17
VEL003.B0101_rmdup	1041383	1041387		YPO_RS05675	4
VEL003.B0101_rmdup	1041903	1041911		YPO_RS05675	8
VEL003.B0101_rmdup	1043114	1043116		YPO_RS05675	2
VEL003.B0101_rmdup	1043407	1043415		YPO_RS05675	8
VEL003.B0101_rmdup	1043933	1043968		YPO_RS05675	35
VEL003.B0101_rmdup	1044044	1044048		YPO_RS05675	4
VEL003.B0101_rmdup	1044241	1044272		YPO_RS05675	31
VEL003.B0101_rmdup	1044423	1044541		YPO_RS05675	118
VEL003.B0101_rmdup	1044736	1044744		YPO_RS05675	8
VEL003.B0101_rmdup	1044989	1045100		YPO_RS05675	111
VEL003.B0101_rmdup	1045288	1045307		YPO_RS05675	19
VEL003.B0101_rmdup	1045394	1045419		YPO_RS05675	25
VEL003.B0101_rmdup	1045525	1045594		YPO_RS05675	69
VEL003.B0101_rmdup	1045696	1045701		YPO_RS05675	5
VEL003.B0101_rmdup	1045815	1045857		YPO_RS05675	42
VEL003.B0101_rmdup	1046393	1046396		YPO_RS05675	3
VEL003.B0101_rmdup	1046472	1046606		YPO_RS05675	134
VEL003.B0101_rmdup	1046699	1046722		YPO_RS05675	23
VEL003.B0101_rmdup	1052375	1052377		mltC	2
VEL003.B0101_rmdup	1053168	1053201		mltC	33
VEL003.B0101_rmdup	1054495	1054502		YPO_RS05715	7
VEL003.B0101_rmdup	1055107	1055108		YPO_RS05720	1
VEL003.B0101_rmdup	1055391	1055393		YPO_RS05720	2
VEL003.B0101_rmdup	1055826	1055844		YPO_RS05720	18
VEL003.B0101_rmdup	1058243	1058249		YPO_RS05730	6
VEL003.B0101_rmdup	1059127	1059146		YPO_RS05730	19
VEL003.B0101_rmdup	1060485	1060487		YPO_RS05735	2
VEL003.B0101_rmdup	1066918	1066924		YPO_RS05765	6
VEL003.B0101_rmdup	1067101	1067107		YPO_RS05765	6
VEL003.B0101_rmdup	1067301	1067389		YPO_RS05765	88
VEL003.B0101_rmdup	1067376	1067436		YPO_RS05770	60
VEL003.B0101_rmdup	1067866	1067869		YPO_RS05770	3
VEL003.B0101_rmdup	1068100	1068183		YPO_RS05770	83
VEL003.B0101_rmdup	1069514	1069545		YPO_RS05770	31
VEL003.B0101_rmdup	1071648	1071669		YPO_RS05785	21
VEL003.B0101_rmdup	1071907	1071911		YPO_RS05790	4
VEL003.B0101_rmdup	1073115	1073183		YPO_RS05795	68
VEL003.B0101_rmdup	1075651	1075701		YPO_RS05800	50
VEL003.B0101_rmdup	1076029	1076036		YPO_RS05800	7
VEL003.B0101_rmdup	1077014	1077027		tssH	13
VEL003.B0101_rmdup	1077764	1077775		tssH	11
VEL003.B0101_rmdup	1078397	1078404		tssH	7
VEL003.B0101_rmdup	1079558	1079562		tssH	4
VEL003.B0101_rmdup	1080620	1080621		YPO_RS05815	1
VEL003.B0101_rmdup	1080951	1080956		YPO_RS05815	5
VEL003.B0101_rmdup	1081031	1081050		YPO_RS05815	19
VEL003.B0101_rmdup	1081390	1081399		YPO_RS05815	9
VEL003.B0101_rmdup	1081430	1081448		YPO_RS05815	18
VEL003.B0101_rmdup	1081695	1081703		YPO_RS05815	8
VEL003.B0101_rmdup	1081905	1081909		YPO_RS05815	4
VEL003.B0101_rmdup	1081954	1081975		YPO_RS05815	21
VEL003.B0101_rmdup	1082813	1082820		YPO_RS05820	7
VEL003.B0101_rmdup	1083271	1083273		tssK	2
VEL003.B0101_rmdup	1083478	1083480		tssK	2
VEL003.B0101_rmdup	1084029	1084047		tssK	18
VEL003.B0101_rmdup	1084680	1084684		tssC	4
VEL003.B0101_rmdup	1085022	1085036		tssC	14
VEL003.B0101_rmdup	1088702	1088718		YPO_RS05845	16
VEL003.B0101_rmdup	1089041	1089082		YPO_RS05845	41
VEL003.B0101_rmdup	1091623	1091626		YPO_RS05855	3
VEL003.B0101_rmdup	1093926	1093935		YPO_RS05865	9
VEL003.B0101_rmdup	1094217	1094223		YPO_RS05865	6
VEL003.B0101_rmdup	1095868	1095885		YPO_RS05870	17
VEL003.B0101_rmdup	1096334	1096349		YPO_RS05880	15
VEL003.B0101_rmdup	1096822	1096824		YPO_RS05880	2
VEL003.B0101_rmdup	1099386	1099388		YPO_RS05890	2
VEL003.B0101_rmdup	1099966	1099988		YPO_RS05890	22
VEL003.B0101_rmdup	1102128	1102134		YPO_RS05900	6
VEL003.B0101_rmdup	1102852	1102867		YPO_RS05900	15
VEL003.B0101_rmdup	1103132	1103135		YPO_RS05900	3
VEL003.B0101_rmdup	1104914	1104915		YPO_RS05905	1
VEL003.B0101_rmdup	1106440	1106445		YPO_RS05910	5
VEL003.B0101_rmdup	1107553	1107574		YPO_RS05915	21
VEL003.B0101_rmdup	1108195	1108198		YPO_RS05915	3
VEL003.B0101_rmdup	1108493	1108496		YPO_RS05915	3
VEL003.B0101_rmdup	1109259	1109261		YPO_RS05920	2
VEL003.B0101_rmdup	1110744	1110772		YPO_RS05920	28
VEL003.B0101_rmdup	1112245	1112250		YPO_RS05930	5
VEL003.B0101_rmdup	1112491	1112493		YPO_RS05930	2
VEL003.B0101_rmdup	1114301	1114326		YPO_RS05935	25
VEL003.B0101_rmdup	1114909	1114926		YPO_RS05935	17
VEL003.B0101_rmdup	1115254	1115262		YPO_RS05935	8
VEL003.B0101_rmdup	1116076	1116077		YPO_RS05935	1
VEL003.B0101_rmdup	1116826	1116841		YPO_RS05940	15
VEL003.B0101_rmdup	1116940	1116973		YPO_RS05940	33
VEL003.B0101_rmdup	1117056	1117122		YPO_RS05940	66
VEL003.B0101_rmdup	1117270	1117277		YPO_RS05940	7
VEL003.B0101_rmdup	1117358	1117360		YPO_RS05940	2
VEL003.B0101_rmdup	1118015	1118110		YPO_RS05940	95
VEL003.B0101_rmdup	1118452	1118454		YPO_RS05945	2
VEL003.B0101_rmdup	1118907	1118922		YPO_RS05945	15
VEL003.B0101_rmdup	1121491	1121495		yapH	4
VEL003.B0101_rmdup	1121587	1121601		yapH	14
VEL003.B0101_rmdup	1122619	1122642		yapH	23
VEL003.B0101_rmdup	1123629	1123660		yapH	31
VEL003.B0101_rmdup	1123957	1123990		yapH	33
VEL003.B0101_rmdup	1124071	1124187		yapH	116
VEL003.B0101_rmdup	1124218	1124228		yapH	10
VEL003.B0101_rmdup	1124279	1124281		yapH	2
VEL003.B0101_rmdup	1124387	1124498		yapH	111
VEL003.B0101_rmdup	1124537	1124544		yapH	7
VEL003.B0101_rmdup	1124597	1124622		yapH	25
VEL003.B0101_rmdup	1124684	1124883		yapH	199
VEL003.B0101_rmdup	1124921	1124946		yapH	25
VEL003.B0101_rmdup	1125121	1125255		yapH	134
VEL003.B0101_rmdup	1125305	1125399		yapH	94
VEL003.B0101_rmdup	1125440	1125471		yapH	31
VEL003.B0101_rmdup	1125522	1125607		yapH	85
VEL003.B0101_rmdup	1125646	1125702		yapH	56
VEL003.B0101_rmdup	1125789	1125838		yapH	49
VEL003.B0101_rmdup	1126276	1126302		yapH	26
VEL003.B0101_rmdup	1127138	1127144		yapH	6
VEL003.B0101_rmdup	1127788	1127803		yapH	15
VEL003.B0101_rmdup	1128866	1128870		yapH	4
VEL003.B0101_rmdup	1129978	1130017		yapH	39
VEL003.B0101_rmdup	1130672	1130695		yapH	23
VEL003.B0101_rmdup	1133669	1133676		YPO_RS05965	7
VEL003.B0101_rmdup	1134088	1134098		YPO_RS05965	10
VEL003.B0101_rmdup	1135694	1135696		YPO_RS05970	2
VEL003.B0101_rmdup	1137730	1137739		YPO_RS05975	9
VEL003.B0101_rmdup	1140365	1140415		YPO_RS05985	50
VEL003.B0101_rmdup	1140476	1140479		YPO_RS05985	3
VEL003.B0101_rmdup	1140766	1140768		YPO_RS05985	2
VEL003.B0101_rmdup	1141432	1141444		YPO_RS05985	12
VEL003.B0101_rmdup	1141728	1141738		YPO_RS05985	10
VEL003.B0101_rmdup	1142069	1142087		YPO_RS05985	18
VEL003.B0101_rmdup	1142166	1142242		YPO_RS05985	76
VEL003.B0101_rmdup	1142411	1142437		YPO_RS05985	26
VEL003.B0101_rmdup	1146058	1146060		YPO_RS05995	2
VEL003.B0101_rmdup	1147131	1147134		YPO_RS06000	3
VEL003.B0101_rmdup	1147336	1147342		YPO_RS06000	6
VEL003.B0101_rmdup	1147504	1147517		YPO_RS06000	13
VEL003.B0101_rmdup	1150298	1150305		recC	7
VEL003.B0101_rmdup	1151720	1151729		recC	9
VEL003.B0101_rmdup	1152183	1152225		recC	42
VEL003.B0101_rmdup	1153270	1153285		ptrA	15
VEL003.B0101_rmdup	1154158	1154177		ptrA	19
VEL003.B0101_rmdup	1154847	1154858		ptrA	11
VEL003.B0101_rmdup	1155581	1155585		ptrA	4
VEL003.B0101_rmdup	1156027	1156074		recB	47
VEL003.B0101_rmdup	1156509	1156526		recB	17
VEL003.B0101_rmdup	1157282	1157308		recB	26
VEL003.B0101_rmdup	1159616	1159620		recB	4
VEL003.B0101_rmdup	1161301	1161313		recD	12
VEL003.B0101_rmdup	1164151	1164186		YPO_RS06050	35
VEL003.B0101_rmdup	1166413	1166442		mltA	29
VEL003.B0101_rmdup	1167645	1167672		csdE	27
VEL003.B0101_rmdup	1170798	1170800		YPO_RS06090	2
VEL003.B0101_rmdup	1171285	1171298		YPO_RS06095	13
VEL003.B0101_rmdup	1172190	1172194		rlmM	4
VEL003.B0101_rmdup	1173438	1173443		xni	5
VEL003.B0101_rmdup	1174674	1174679		YPO_RS06110	5
VEL003.B0101_rmdup	1191444	1191456		cdsA	12
VEL003.B0101_rmdup	1198031	1198033		fabZ	2
VEL003.B0101_rmdup	1199782	1199783		lpxB	1
VEL003.B0101_rmdup	1200266	1200270		rnhB	4
VEL003.B0101_rmdup	1204492	1204497		accA	5
VEL003.B0101_rmdup	1204573	1204577		accA	4
VEL003.B0101_rmdup	1204796	1204807		accA	11
VEL003.B0101_rmdup	1206393	1206415		tilS	22
VEL003.B0101_rmdup	1206791	1206804		tilS	13
VEL003.B0101_rmdup	1207761	1207764		YPO_RS06260	3
VEL003.B0101_rmdup	1208262	1208263		rof	1
VEL003.B0101_rmdup	1208421	1208443		YPO_RS06270	22
VEL003.B0101_rmdup	1212532	1212535		tsaA	3
VEL003.B0101_rmdup	1213727	1213730		YPO_RS06305	3
VEL003.B0101_rmdup	1214750	1214766		metI	16
VEL003.B0101_rmdup	1214949	1214962		metI	13
VEL003.B0101_rmdup	1215150	1215154		metI	4
VEL003.B0101_rmdup	1221198	1221221		YPO_RS06340	23
VEL003.B0101_rmdup	1221604	1221614		YPO_RS06340	10
VEL003.B0101_rmdup	1223723	1223730		dkgB	7
VEL003.B0101_rmdup	1226812	1226823		mltD	11
VEL003.B0101_rmdup	1227697	1227703		gloB	6
VEL003.B0101_rmdup	1228496	1228505		YPO_RS06380	9
VEL003.B0101_rmdup	1228954	1228961		rnhA	7
VEL003.B0101_rmdup	1230403	1230415		YPO_RS06400	12
VEL003.B0101_rmdup	1230907	1230915		YPO_RS06400	8
VEL003.B0101_rmdup	1231566	1231569		YPO_RS06400	3
VEL003.B0101_rmdup	1232124	1232126		YPO_RS06405	2
VEL003.B0101_rmdup	1236364	1236370		YPO_RS06435	6
VEL003.B0101_rmdup	1236934	1236936		YPO_RS06440	2
VEL003.B0101_rmdup	1237289	1237295		YPO_RS06440	6
VEL003.B0101_rmdup	1238075	1238088		YPO_RS06445	13
VEL003.B0101_rmdup	1238142	1238143		YPO_RS06445	1
VEL003.B0101_rmdup	1238326	1238334		YPO_RS06450	8
VEL003.B0101_rmdup	1240922	1240948		YPO_RS06465	26
VEL003.B0101_rmdup	1241047	1241150		YPO_RS06465	103
VEL003.B0101_rmdup	1241691	1241693		YPO_RS06465	2
VEL003.B0101_rmdup	1242467	1242468		YPO_RS06470	1
VEL003.B0101_rmdup	1242526	1242532		YPO_RS06470	6
VEL003.B0101_rmdup	1242589	1242627		YPO_RS06470	38
VEL003.B0101_rmdup	1243055	1243065		YPO_RS06470	10
VEL003.B0101_rmdup	1243212	1243216		YPO_RS06470	4
VEL003.B0101_rmdup	1245806	1245810		ssrA	4
VEL003.B0101_rmdup	1246754	1246802		YPO_RS06495	48
VEL003.B0101_rmdup	1250501	1250507		nadK	6
VEL003.B0101_rmdup	1251896	1251901		YPO_RS06525	5
VEL003.B0101_rmdup	1252569	1252583		YPO_RS06525	14
VEL003.B0101_rmdup	1252628	1252635		YPO_RS06525	7
VEL003.B0101_rmdup	1254863	1254864		sdhA	1
VEL003.B0101_rmdup	1255997	1256022		YPO_RS06545	25
VEL003.B0101_rmdup	1257700	1257718		sucA	18
VEL003.B0101_rmdup	1258049	1258063		sucA	14
VEL003.B0101_rmdup	1258789	1258792		sucA	3
VEL003.B0101_rmdup	1260325	1260356		odhB	31
VEL003.B0101_rmdup	1261265	1261268		sucC	3
VEL003.B0101_rmdup	1266792	1266794		cydX	2
VEL003.B0101_rmdup	1268368	1268374		tolR	6
VEL003.B0101_rmdup	1269570	1269652		tolA	82
VEL003.B0101_rmdup	1269743	1269747		tolA	4
VEL003.B0101_rmdup	1271116	1271151		tolB	35
VEL003.B0101_rmdup	1272357	1272359		cpoB	2
VEL003.B0101_rmdup	1273775	1273810		nadA	35
VEL003.B0101_rmdup	1276407	1276421		zitB	14
VEL003.B0101_rmdup	1277566	1277575		aroG	9
VEL003.B0101_rmdup	1278044	1278062		aroG	18
VEL003.B0101_rmdup	1280014	1280015		YPO_RS06670	1
VEL003.B0101_rmdup	1280092	1280114		YPO_RS06670	22
VEL003.B0101_rmdup	1282293	1282294		galM	1
VEL003.B0101_rmdup	1284073	1284083		galK	10
VEL003.B0101_rmdup	1285470	1285475		galE	5
VEL003.B0101_rmdup	1285941	1285962		galE	21
VEL003.B0101_rmdup	1286092	1286163		galE	71
VEL003.B0101_rmdup	1287184	1287187		YPO_RS06710	3
VEL003.B0101_rmdup	1287976	1287982		modF	6
VEL003.B0101_rmdup	1288148	1288160		modF	12
VEL003.B0101_rmdup	1289022	1289027		modF	5
VEL003.B0101_rmdup	1290843	1290845		modA	2
VEL003.B0101_rmdup	1291951	1291966		modB	15
VEL003.B0101_rmdup	1292910	1292926		modC	16
VEL003.B0101_rmdup	1294998	1295002		pgl	4
VEL003.B0101_rmdup	1295726	1295741		bioA	15
VEL003.B0101_rmdup	1296538	1296563		bioA	25
VEL003.B0101_rmdup	1298668	1298714		bioF	46
VEL003.B0101_rmdup	1298940	1298951		bioF	11
VEL003.B0101_rmdup	1299151	1299160		bioF	9
VEL003.B0101_rmdup	1304057	1304066		uvrB	9
VEL003.B0101_rmdup	1308595	1308617		moaD	22
VEL003.B0101_rmdup	1312970	1312974		betB	4
VEL003.B0101_rmdup	1313683	1313690		betB	7
VEL003.B0101_rmdup	1315213	1315220		YPO_RS06845	7
VEL003.B0101_rmdup	1315657	1315666		YPO_RS06845	9
VEL003.B0101_rmdup	1317744	1317771		YPO_RS06850	27
VEL003.B0101_rmdup	1322247	1322302		YPO_RS06875	55
VEL003.B0101_rmdup	1322381	1322406		YPO_RS06875	25
VEL003.B0101_rmdup	1322732	1322737		YPO_RS06875	5
VEL003.B0101_rmdup	1322824	1322872		YPO_RS06875	48
VEL003.B0101_rmdup	1322964	1322966		YPO_RS06875	2
VEL003.B0101_rmdup	1323416	1323431		dusC	15
VEL003.B0101_rmdup	1326413	1326430		dld	17
VEL003.B0101_rmdup	1328461	1328468		YPO_RS06905	7
VEL003.B0101_rmdup	1329173	1329179		YPO_RS06910	6
VEL003.B0101_rmdup	1329513	1329517		YPO_RS06910	4
VEL003.B0101_rmdup	1329997	1330010		YPO_RS06910	13
VEL003.B0101_rmdup	1331068	1331083		phnC	15
VEL003.B0101_rmdup	1337582	1337588		urtB	6
VEL003.B0101_rmdup	1337834	1337836		urtB	2
VEL003.B0101_rmdup	1338610	1338626		urtB	16
VEL003.B0101_rmdup	1341696	1341700		YPO_RS06970	4
VEL003.B0101_rmdup	1343046	1343049		YPO_RS06975	3
VEL003.B0101_rmdup	1343908	1343922		sseA	14
VEL003.B0101_rmdup	1344442	1344448		sseA	6
VEL003.B0101_rmdup	1346096	1346108		YPO_RS06990	12
VEL003.B0101_rmdup	1347700	1347746		YPO_RS06995	46
VEL003.B0101_rmdup	1347965	1347966		YPO_RS07000	1
VEL003.B0101_rmdup	1350120	1350146		adiC	26
VEL003.B0101_rmdup	1350954	1350981		adiC	27
VEL003.B0101_rmdup	1354896	1354923		yedA	27
VEL003.B0101_rmdup	1360328	1360347		YPO_RS07040	19
VEL003.B0101_rmdup	1361120	1361135		YPO_RS07045	15
VEL003.B0101_rmdup	1365474	1365480		YPO_RS07065	6
VEL003.B0101_rmdup	1371339	1371342		gyrA	3
VEL003.B0101_rmdup	1371391	1371401		gyrA	10
VEL003.B0101_rmdup	1373869	1373876		rcsC	7
VEL003.B0101_rmdup	1376837	1376843		rcsB	6
VEL003.B0101_rmdup	1378019	1378032		rcsD	13
VEL003.B0101_rmdup	1379085	1379091		rcsD	6
VEL003.B0101_rmdup	1380313	1380325		YPO_RS07110	12
VEL003.B0101_rmdup	1383158	1383169		YPO_RS07115	11
VEL003.B0101_rmdup	1383275	1383277		YPO_RS07115	2
VEL003.B0101_rmdup	1387092	1387093		YPO_RS07140	1
VEL003.B0101_rmdup	1388221	1388241		YPO_RS07145	20
VEL003.B0101_rmdup	1389219	1389225		YPO_RS07150	6
VEL003.B0101_rmdup	1390243	1390272		YPO_RS07150	29
VEL003.B0101_rmdup	1392306	1392317		ycoA	11
VEL003.B0101_rmdup	1397397	1397403		YPO_RS07185	6
VEL003.B0101_rmdup	1397659	1397681		YPO_RS07190	22
VEL003.B0101_rmdup	1397902	1397914		YPO_RS07190	12
VEL003.B0101_rmdup	1399577	1399586		YPO_RS07200	9
VEL003.B0101_rmdup	1400193	1400203		YPO_RS07210	10
VEL003.B0101_rmdup	1400356	1400376		YPO_RS07210	20
VEL003.B0101_rmdup	1401526	1401543		YPO_RS07215	17
VEL003.B0101_rmdup	1402052	1402071		YPO_RS07220	19
VEL003.B0101_rmdup	1402971	1402974		YPO_RS07225	3
VEL003.B0101_rmdup	1404184	1404206		YPO_RS07230	22
VEL003.B0101_rmdup	1404664	1404670		YPO_RS07230	6
VEL003.B0101_rmdup	1404865	1404875		YPO_RS07230	10
VEL003.B0101_rmdup	1404943	1404951		YPO_RS07230	8
VEL003.B0101_rmdup	1405574	1405601		YPO_RS07235	27
VEL003.B0101_rmdup	1405861	1405862		YPO_RS07235	1
VEL003.B0101_rmdup	1406110	1406151		YPO_RS07235	41
VEL003.B0101_rmdup	1406988	1406999		YPO_RS07240	11
VEL003.B0101_rmdup	1409645	1409654		YPO_RS07265	9
VEL003.B0101_rmdup	1409751	1409752		YPO_RS07265	1
VEL003.B0101_rmdup	1410539	1410606		YPO_RS07270	67
VEL003.B0101_rmdup	1410736	1410746		YPO_RS07270	10
VEL003.B0101_rmdup	1410881	1410932		YPO_RS07270	51
VEL003.B0101_rmdup	1410969	1410972		YPO_RS07270	3
VEL003.B0101_rmdup	1412926	1412927		YPO_RS07275	1
VEL003.B0101_rmdup	1414922	1414923		YPO_RS07290	1
VEL003.B0101_rmdup	1415077	1415087		YPO_RS07290	10
VEL003.B0101_rmdup	1415140	1415152		YPO_RS07290	12
VEL003.B0101_rmdup	1415263	1415266		YPO_RS07290	3
VEL003.B0101_rmdup	1416340	1416355		YPO_RS07295	15
VEL003.B0101_rmdup	1416454	1416456		YPO_RS07295	2
VEL003.B0101_rmdup	1421402	1421407		YPO_RS07330	5
VEL003.B0101_rmdup	1422633	1422637		YPO_RS07330	4
VEL003.B0101_rmdup	1423621	1423622		rsuA	1
VEL003.B0101_rmdup	1424509	1424537		YPO_RS07340	28
VEL003.B0101_rmdup	1428301	1428304		yejF	3
VEL003.B0101_rmdup	1430510	1430519		YPO_RS07360	9
VEL003.B0101_rmdup	1431472	1431473		YPO_RS07365	1
VEL003.B0101_rmdup	1431823	1431827		YPO_RS07365	4
VEL003.B0101_rmdup	1432286	1432292		YPO_RS07365	6
VEL003.B0101_rmdup	1433396	1433412		YPO_RS07370	16
VEL003.B0101_rmdup	1433769	1433771		YPO_RS07370	2
VEL003.B0101_rmdup	1436033	1436058		YPO_RS07380	25
VEL003.B0101_rmdup	1436362	1436363		YPO_RS07380	1
VEL003.B0101_rmdup	1438628	1438670		YPO_RS07390	42
VEL003.B0101_rmdup	1445557	1445564		YPO_RS07420	7
VEL003.B0101_rmdup	1447113	1447119		YPO_RS07430	6
VEL003.B0101_rmdup	1447819	1447844		YPO_RS07430	25
VEL003.B0101_rmdup	1449277	1449300		YPO_RS07435	23
VEL003.B0101_rmdup	1449517	1449522		YPO_RS07435	5
VEL003.B0101_rmdup	1449833	1449860		YPO_RS07435	27
VEL003.B0101_rmdup	1450102	1450130		xylB	28
VEL003.B0101_rmdup	1450976	1450980		xylB	4
VEL003.B0101_rmdup	1451093	1451123		xylB	30
VEL003.B0101_rmdup	1451310	1451374		xylB	64
VEL003.B0101_rmdup	1452024	1452037		rpiA	13
VEL003.B0101_rmdup	1454051	1454054		YPO_RS07455	3
VEL003.B0101_rmdup	1455372	1455390		YPO_RS07460	18
VEL003.B0101_rmdup	1461562	1461582		YPO_RS07485	20
VEL003.B0101_rmdup	1461784	1461824		YPO_RS07490	40
VEL003.B0101_rmdup	1462106	1462124		YPO_RS07490	18
VEL003.B0101_rmdup	1463113	1463133		psaA	20
VEL003.B0101_rmdup	1463379	1463402		YPO_RS07500	23
VEL003.B0101_rmdup	1463468	1463498		YPO_RS07500	30
VEL003.B0101_rmdup	1465139	1465145		psaC	6
VEL003.B0101_rmdup	1466298	1466300		psaC	2
VEL003.B0101_rmdup	1466545	1466547		psaC	2
VEL003.B0101_rmdup	1468624	1468638		YPO_RS07515	14
VEL003.B0101_rmdup	1470335	1470337		YPO_RS07520	2
VEL003.B0101_rmdup	1470896	1470908		YPO_RS07525	12
VEL003.B0101_rmdup	1475269	1475285		YPO_RS07540	16
VEL003.B0101_rmdup	1476999	1477022		YPO_RS07545	23
VEL003.B0101_rmdup	1477434	1477443		YPO_RS07545	9
VEL003.B0101_rmdup	1482384	1482407		YPO_RS07570	23
VEL003.B0101_rmdup	1482760	1482762		YPO_RS07570	2
VEL003.B0101_rmdup	1483590	1483594		YPO_RS07575	4
VEL003.B0101_rmdup	1484350	1484377		YPO_RS07580	27
VEL003.B0101_rmdup	1485065	1485068		YPO_RS07580	3
VEL003.B0101_rmdup	1498741	1498745		potH	4
VEL003.B0101_rmdup	1499918	1499950		potI	32
VEL003.B0101_rmdup	1503912	1503938		YPO_RS07670	26
VEL003.B0101_rmdup	1507341	1507342		YPO_RS07690	1
VEL003.B0101_rmdup	1508884	1508885		YPO_RS07700	1
VEL003.B0101_rmdup	1512955	1512979		YPO_RS07725	24
VEL003.B0101_rmdup	1514445	1514468		artQ	23
VEL003.B0101_rmdup	1517868	1517891		YPO_RS07760	23
VEL003.B0101_rmdup	1519627	1519645		YPO_RS07770	18
VEL003.B0101_rmdup	1522137	1522151		poxB	14
VEL003.B0101_rmdup	1529542	1529547		YPO_RS07800	5
VEL003.B0101_rmdup	1531069	1531070		macA	1
VEL003.B0101_rmdup	1536232	1536243		clpA	11
VEL003.B0101_rmdup	1539741	1539775		aat	34
VEL003.B0101_rmdup	1540513	1540518		cydC	5
VEL003.B0101_rmdup	1541024	1541027		cydC	3
VEL003.B0101_rmdup	1541241	1541246		cydC	5
VEL003.B0101_rmdup	1547013	1547018		YPO_RS07870	5
VEL003.B0101_rmdup	1551930	1551936		YPO_RS07880	6
VEL003.B0101_rmdup	1552086	1552097		YPO_RS07880	11
VEL003.B0101_rmdup	1552713	1552724		serS	11
VEL003.B0101_rmdup	1553182	1553186		serS	4
VEL003.B0101_rmdup	1554950	1554952		YPO_RS07890	2
VEL003.B0101_rmdup	1557654	1557698		YPO_RS07900	44
VEL003.B0101_rmdup	1563522	1563539		YPO_RS07915	17
VEL003.B0101_rmdup	1564293	1564322		ansB	29
VEL003.B0101_rmdup	1565987	1566043		YPO_RS07925	56
VEL003.B0101_rmdup	1566769	1566787		YPO_RS07930	18
VEL003.B0101_rmdup	1567520	1567536		YPO_RS07930	16
VEL003.B0101_rmdup	1567679	1567767		YPO_RS07930	88
VEL003.B0101_rmdup	1569473	1569493		serC	20
VEL003.B0101_rmdup	1579363	1579372		lpxK	9
VEL003.B0101_rmdup	1579452	1579483		lpxK	31
VEL003.B0101_rmdup	1580170	1580183		YPO_RS07975	13
VEL003.B0101_rmdup	1580772	1580792		YPO_RS07975	20
VEL003.B0101_rmdup	1580937	1580942		YPO_RS07975	5
VEL003.B0101_rmdup	1583100	1583114		kdsB	14
VEL003.B0101_rmdup	1583234	1583246		kdsB	12
VEL003.B0101_rmdup	1587715	1587725		mukF	10
VEL003.B0101_rmdup	1589327	1589340		mukB	13
VEL003.B0101_rmdup	1590261	1590267		mukB	6
VEL003.B0101_rmdup	1590411	1590436		mukB	25
VEL003.B0101_rmdup	1595703	1595767		ldtD	64
VEL003.B0101_rmdup	1598861	1598864		YPO_RS08045	3
VEL003.B0101_rmdup	1608021	1608022		pyrD	1
VEL003.B0101_rmdup	1612255	1612258		rlmKL	3
VEL003.B0101_rmdup	1613693	1613696		YPO_RS08090	3
VEL003.B0101_rmdup	1616099	1616104		pqiB	5
VEL003.B0101_rmdup	1617754	1617774		pqiC	20
VEL003.B0101_rmdup	1620783	1620784		YPO_RS08125	1
VEL003.B0101_rmdup	1625117	1625122		YPO_RS08150	5
VEL003.B0101_rmdup	1625669	1625675		YPO_RS08150	6
VEL003.B0101_rmdup	1627358	1627399		ompA	41
VEL003.B0101_rmdup	1627622	1627631		ompA	9
VEL003.B0101_rmdup	1631272	1631279		yccS	7
VEL003.B0101_rmdup	1632388	1632397		YPO_RS08185	9
VEL003.B0101_rmdup	1645231	1645232		YPO_RS08245	1
VEL003.B0101_rmdup	1647598	1647671		YPO_RS08260	73
VEL003.B0101_rmdup	1648484	1648508		YPO_RS08265	24
VEL003.B0101_rmdup	1648973	1648975		YPO_RS08265	2
VEL003.B0101_rmdup	1652099	1652100		YPO_RS08280	1
VEL003.B0101_rmdup	1652420	1652430		YPO_RS08285	10
VEL003.B0101_rmdup	1653168	1653171		YPO_RS08290	3
VEL003.B0101_rmdup	1653815	1653827		YPO_RS08295	12
VEL003.B0101_rmdup	1654830	1654851		YPO_RS08305	21
VEL003.B0101_rmdup	1658253	1658266		tssC	13
VEL003.B0101_rmdup	1658759	1658781		tssK	22
VEL003.B0101_rmdup	1659310	1659329		tssK	19
VEL003.B0101_rmdup	1659978	1659992		YPO_RS08325	14
VEL003.B0101_rmdup	1660844	1660846		YPO_RS08330	2
VEL003.B0101_rmdup	1660901	1660911		YPO_RS08330	10
VEL003.B0101_rmdup	1660974	1660983		YPO_RS08330	9
VEL003.B0101_rmdup	1661165	1661243		YPO_RS08330	78
VEL003.B0101_rmdup	1661391	1661402		YPO_RS08330	11
VEL003.B0101_rmdup	1661781	1661790		YPO_RS08330	9
VEL003.B0101_rmdup	1661835	1661838		YPO_RS08330	3
VEL003.B0101_rmdup	1662147	1662166		YPO_RS08330	19
VEL003.B0101_rmdup	1662764	1662765		YPO_RS08335	1
VEL003.B0101_rmdup	1663341	1663348		tssH	7
VEL003.B0101_rmdup	1664236	1664253		tssH	17
VEL003.B0101_rmdup	1664297	1664298		tssH	1
VEL003.B0101_rmdup	1664464	1664465		tssH	1
VEL003.B0101_rmdup	1665037	1665039		tssH	2
VEL003.B0101_rmdup	1665617	1665628		tssH	11
VEL003.B0101_rmdup	1665861	1665885		YPO_RS08345	24
VEL003.B0101_rmdup	1668249	1668250		YPO_RS08350	1
VEL003.B0101_rmdup	1670204	1670205		YPO_RS08350	1
VEL003.B0101_rmdup	1670494	1670502		YPO_RS08355	8
VEL003.B0101_rmdup	1670559	1670593		YPO_RS08355	34
VEL003.B0101_rmdup	1670930	1670937		YPO_RS08355	7
VEL003.B0101_rmdup	1674387	1674409		YPO_RS08370	22
VEL003.B0101_rmdup	1677068	1677081		YPO_RS08380	13
VEL003.B0101_rmdup	1677526	1677528		YPO_RS08380	2
VEL003.B0101_rmdup	1678168	1678181		YPO_RS08385	13
VEL003.B0101_rmdup	1678436	1678481		YPO_RS08385	45
VEL003.B0101_rmdup	1678581	1678593		YPO_RS08385	12
VEL003.B0101_rmdup	1678626	1678677		YPO_RS08385	51
VEL003.B0101_rmdup	1679107	1679119		YPO_RS08385	12
VEL003.B0101_rmdup	1679342	1679343		YPO_RS08385	1
VEL003.B0101_rmdup	1680288	1680308		YPO_RS08385	20
VEL003.B0101_rmdup	1680436	1680447		YPO_RS08385	11
VEL003.B0101_rmdup	1680599	1680602		YPO_RS08385	3
VEL003.B0101_rmdup	1681293	1681304		YPO_RS08385	11
VEL003.B0101_rmdup	1681348	1681396		tssA	48
VEL003.B0101_rmdup	1681901	1681909		tssA	8
VEL003.B0101_rmdup	1682340	1682354		tssA	14
VEL003.B0101_rmdup	1682493	1682528		tssA	35
VEL003.B0101_rmdup	1682910	1682927		tssA	17
VEL003.B0101_rmdup	1683454	1683462		YPO_RS08395	8
VEL003.B0101_rmdup	1683661	1683665		YPO_RS08395	4
VEL003.B0101_rmdup	1683773	1683774		YPO_RS08395	1
VEL003.B0101_rmdup	1684040	1684141		YPO_RS08400	101
VEL003.B0101_rmdup	1684197	1684199		YPO_RS08400	2
VEL003.B0101_rmdup	1684393	1684495		YPO_RS08400	102
VEL003.B0101_rmdup	1684843	1684851		tssF	8
VEL003.B0101_rmdup	1685407	1685414		tssF	7
VEL003.B0101_rmdup	1685658	1685678		tssF	20
VEL003.B0101_rmdup	1685802	1685809		tssF	7
VEL003.B0101_rmdup	1686023	1686035		tssF	12
VEL003.B0101_rmdup	1686159	1686179		tssF	20
VEL003.B0101_rmdup	1687356	1687358		tssG	2
VEL003.B0101_rmdup	1687394	1687415		tssG	21
VEL003.B0101_rmdup	1687611	1687617		tssJ	6
VEL003.B0101_rmdup	1687755	1687767		tssJ	12
VEL003.B0101_rmdup	1688064	1688073		tssJ	9
VEL003.B0101_rmdup	1688307	1688313		tssE	6
VEL003.B0101_rmdup	1688637	1688658		YPO_RS08425	21
VEL003.B0101_rmdup	1688919	1688937		YPO_RS08425	18
VEL003.B0101_rmdup	1690437	1690444		YPO_RS08430	7
VEL003.B0101_rmdup	1690635	1690693		YPO_RS08430	58
VEL003.B0101_rmdup	1692169	1692172		YPO_RS08435	3
VEL003.B0101_rmdup	1693019	1693020		YPO_RS08435	1
VEL003.B0101_rmdup	1693537	1693557		YPO_RS08440	20
VEL003.B0101_rmdup	1693883	1693922		YPO_RS08440	39
VEL003.B0101_rmdup	1693966	1693985		YPO_RS08445	19
VEL003.B0101_rmdup	1694439	1694484		YPO_RS08445	45
VEL003.B0101_rmdup	1694774	1694779		YPO_RS08445	5
VEL003.B0101_rmdup	1696250	1696254		moeA	4
VEL003.B0101_rmdup	1696604	1696626		moeA	22
VEL003.B0101_rmdup	1699071	1699162		darE	91
VEL003.B0101_rmdup	1700312	1700399		darC	87
VEL003.B0101_rmdup	1701148	1701166		darB	18
VEL003.B0101_rmdup	1701331	1701395		darB	64
VEL003.B0101_rmdup	1701529	1701540		darB	11
VEL003.B0101_rmdup	1701725	1701730		darB	5
VEL003.B0101_rmdup	1701833	1701863		darB	30
VEL003.B0101_rmdup	1702570	1702603		darB	33
VEL003.B0101_rmdup	1704646	1704647		fghA	1
VEL003.B0101_rmdup	1704781	1704786		fghA	5
VEL003.B0101_rmdup	1704822	1704841		fghA	19
VEL003.B0101_rmdup	1705771	1705773		YPO_RS08490	2
VEL003.B0101_rmdup	1706511	1706514		YPO_RS08495	3
VEL003.B0101_rmdup	1707888	1707903		YPO_RS08500	15
VEL003.B0101_rmdup	1711356	1711358		mglB	2
VEL003.B0101_rmdup	1712760	1712761		mglA	1
VEL003.B0101_rmdup	1712885	1712891		mglA	6
VEL003.B0101_rmdup	1714298	1714317		mglC	19
VEL003.B0101_rmdup	1716148	1716152		sanA	4
VEL003.B0101_rmdup	1716756	1716776		YPO_RS08535	20
VEL003.B0101_rmdup	1717426	1717436		YPO_RS08535	10
VEL003.B0101_rmdup	1717606	1717610		YPO_RS08535	4
VEL003.B0101_rmdup	1718205	1718220		YPO_RS08535	15
VEL003.B0101_rmdup	1720172	1720186		YPO_RS08545	14
VEL003.B0101_rmdup	1720590	1720591		YPO_RS08550	1
VEL003.B0101_rmdup	1721501	1721503		YPO_RS08555	2
VEL003.B0101_rmdup	1723147	1723161		YPO_RS08560	14
VEL003.B0101_rmdup	1724950	1724957		YPO_RS08565	7
VEL003.B0101_rmdup	1725719	1725720		YPO_RS08570	1
VEL003.B0101_rmdup	1725912	1725955		YPO_RS08570	43
VEL003.B0101_rmdup	1726277	1726342		YPO_RS08570	65
VEL003.B0101_rmdup	1727061	1727078		YPO_RS08575	17
VEL003.B0101_rmdup	1728404	1728409		YPO_RS08580	5
VEL003.B0101_rmdup	1729380	1729385		metG	5
VEL003.B0101_rmdup	1732159	1732186		apbC	27
VEL003.B0101_rmdup	1734080	1734083		dcd	3
VEL003.B0101_rmdup	1739303	1739320		YPO_RS08625	17
VEL003.B0101_rmdup	1739482	1739491		YPO_RS08625	9
VEL003.B0101_rmdup	1739698	1739772		YPO_RS08625	74
VEL003.B0101_rmdup	1740466	1740487		YPO_RS08625	21
VEL003.B0101_rmdup	1742598	1742606		YPO_RS08635	8
VEL003.B0101_rmdup	1742937	1742956		YPO_RS08640	19
VEL003.B0101_rmdup	1743865	1743872		YPO_RS08640	7
VEL003.B0101_rmdup	1745040	1745049		YPO_RS08645	9
VEL003.B0101_rmdup	1745454	1745459		YPO_RS08645	5
VEL003.B0101_rmdup	1745822	1745823		YPO_RS08650	1
VEL003.B0101_rmdup	1746235	1746240		YPO_RS08650	5
VEL003.B0101_rmdup	1746477	1746480		YPO_RS08650	3
VEL003.B0101_rmdup	1751039	1751043		YPO_RS08665	4
VEL003.B0101_rmdup	1751879	1751890		YPO_RS08670	11
VEL003.B0101_rmdup	1751942	1751982		YPO_RS08670	40
VEL003.B0101_rmdup	1752355	1752356		YPO_RS08670	1
VEL003.B0101_rmdup	1752690	1752702		YPO_RS08670	12
VEL003.B0101_rmdup	1753074	1753077		YPO_RS08670	3
VEL003.B0101_rmdup	1754158	1754164		galU	6
VEL003.B0101_rmdup	1754341	1754354		galU	13
VEL003.B0101_rmdup	1756796	1756807		gndA	11
VEL003.B0101_rmdup	1758375	1758376		YPO_RS08690	1
VEL003.B0101_rmdup	1758600	1758605		hisF	5
VEL003.B0101_rmdup	1763378	1763419		hisD	41
VEL003.B0101_rmdup	1763572	1763579		hisD	7
VEL003.B0101_rmdup	1763861	1763886		hisD	25
VEL003.B0101_rmdup	1765815	1765826		YPO_RS08735	11
VEL003.B0101_rmdup	1765978	1765980		YPO_RS08735	2
VEL003.B0101_rmdup	1769270	1769278		YPO_RS08755	8
VEL003.B0101_rmdup	1770546	1770561		YPO_RS08760	15
VEL003.B0101_rmdup	1770697	1770761		YPO_RS08760	64
VEL003.B0101_rmdup	1771597	1771632		YPO_RS08765	35
VEL003.B0101_rmdup	1774601	1774613		sbcB	12
VEL003.B0101_rmdup	1775958	1775962		YPO_RS08785	4
VEL003.B0101_rmdup	1776667	1776668		YPO_RS08785	1
VEL003.B0101_rmdup	1778246	1778249		YPO_RS08795	3
VEL003.B0101_rmdup	1780109	1780114		YPO_RS08800	5
VEL003.B0101_rmdup	1787502	1787515		YPO_RS08825	13
VEL003.B0101_rmdup	1790410	1790418		argG	8
VEL003.B0101_rmdup	1790985	1791005		argG	20
VEL003.B0101_rmdup	1793246	1793257		YPO_RS08845	11
VEL003.B0101_rmdup	1793623	1793628		YPO_RS08845	5
VEL003.B0101_rmdup	1796028	1796038		YPO_RS08855	10
VEL003.B0101_rmdup	1796139	1796187		YPO_RS08855	48
VEL003.B0101_rmdup	1798338	1798346		YPO_RS08870	8
VEL003.B0101_rmdup	1799730	1799766		YPO_RS08875	36
VEL003.B0101_rmdup	1802715	1802723		YPO_RS08890	8
VEL003.B0101_rmdup	1802897	1802899		YPO_RS08890	2
VEL003.B0101_rmdup	1803896	1803934		YPO_RS08900	38
VEL003.B0101_rmdup	1804067	1804076		YPO_RS08900	9
VEL003.B0101_rmdup	1806582	1806585		YPO_RS08905	3
VEL003.B0101_rmdup	1806991	1806998		YPO_RS08905	7
VEL003.B0101_rmdup	1808310	1808338		bssS	28
VEL003.B0101_rmdup	1811941	1811956		YPO_RS08940	15
VEL003.B0101_rmdup	1813475	1813479		rne	4
VEL003.B0101_rmdup	1814749	1814755		rne	6
VEL003.B0101_rmdup	1819953	1819960		yceD	7
VEL003.B0101_rmdup	1820312	1820355		plsX	43
VEL003.B0101_rmdup	1821891	1821900		YPO_RS08980	9
VEL003.B0101_rmdup	1822127	1822136		YPO_RS08980	9
VEL003.B0101_rmdup	1824574	1824587		fabF	13
VEL003.B0101_rmdup	1825006	1825033		fabF	27
VEL003.B0101_rmdup	1827129	1827139		pabC	10
VEL003.B0101_rmdup	1828339	1828375		mltG	36
VEL003.B0101_rmdup	1828723	1828739		mltG	16
VEL003.B0101_rmdup	1828999	1829001		YPO_RS09020	2
VEL003.B0101_rmdup	1830143	1830160		holB	17
VEL003.B0101_rmdup	1831963	1831972		ptsG	9
VEL003.B0101_rmdup	1835850	1835873		YPO_RS09055	23
VEL003.B0101_rmdup	1842005	1842029		YPO_RS09090	24
VEL003.B0101_rmdup	1842231	1842249		YPO_RS09090	18
VEL003.B0101_rmdup	1843193	1843208		YPO_RS09095	15
VEL003.B0101_rmdup	1843680	1843705		YPO_RS09095	25
VEL003.B0101_rmdup	1844534	1844536		YPO_RS09100	2
VEL003.B0101_rmdup	1844784	1844791		YPO_RS09100	7
VEL003.B0101_rmdup	1844834	1844846		YPO_RS09100	12
VEL003.B0101_rmdup	1845197	1845214		YPO_RS09105	17
VEL003.B0101_rmdup	1845548	1845560		YPO_RS09105	12
VEL003.B0101_rmdup	1845829	1845844		YPO_RS09105	15
VEL003.B0101_rmdup	1848272	1848287		mfd	15
VEL003.B0101_rmdup	1857507	1857519		YPO_RS09150	12
VEL003.B0101_rmdup	1860050	1860054		phoP	4
VEL003.B0101_rmdup	1861372	1861379		YPO_RS09165	7
VEL003.B0101_rmdup	1863589	1863591		hflD	2
VEL003.B0101_rmdup	1864165	1864179		mnmA	14
VEL003.B0101_rmdup	1866016	1866017		rluE	1
VEL003.B0101_rmdup	1866413	1866414		icd	1
VEL003.B0101_rmdup	1868087	1868090		YPO_RS09200	3
VEL003.B0101_rmdup	1869744	1869750		YPO_RS09210	6
VEL003.B0101_rmdup	1871930	1871937		YPO_RS09215	7
VEL003.B0101_rmdup	1873311	1873312		YPO_RS09225	1
VEL003.B0101_rmdup	1878292	1878350		YPO_RS09250	58
VEL003.B0101_rmdup	1882983	1882986		YPO_RS09260	3
VEL003.B0101_rmdup	1889305	1889309		mgtA	4
VEL003.B0101_rmdup	1893245	1893250		flhC	5
VEL003.B0101_rmdup	1894154	1894159		motA	5
VEL003.B0101_rmdup	1897708	1897723		cheA	15
VEL003.B0101_rmdup	1904236	1904243		yapJ	7
VEL003.B0101_rmdup	1905721	1905725		yapJ	4
VEL003.B0101_rmdup	1905776	1905804		yapJ	28
VEL003.B0101_rmdup	1907558	1907573		YPO_RS09345	15
VEL003.B0101_rmdup	1911260	1911291		YPO_RS09355	31
VEL003.B0101_rmdup	1915000	1915001		cheR	1
VEL003.B0101_rmdup	1915003	1915004		cheR	1
VEL003.B0101_rmdup	1920147	1920151		YPO_RS09390	4
VEL003.B0101_rmdup	1921185	1921192		YPO_RS09390	7
VEL003.B0101_rmdup	1921250	1921284		YPO_RS09390	34
VEL003.B0101_rmdup	1921517	1921535		YPO_RS09390	18
VEL003.B0101_rmdup	1921822	1921832		YPO_RS09395	10
VEL003.B0101_rmdup	1922609	1922626		YPO_RS09400	17
VEL003.B0101_rmdup	1930063	1930077		YPO_RS09435	14
VEL003.B0101_rmdup	1933802	1933831		YPO_RS09455	29
VEL003.B0101_rmdup	1937200	1937214		YPO_RS09465	14
VEL003.B0101_rmdup	1938039	1938050		YPO_RS09475	11
VEL003.B0101_rmdup	1938369	1938374		YPO_RS09475	5
VEL003.B0101_rmdup	1940597	1940610		YPO_RS09480	13
VEL003.B0101_rmdup	1940641	1940642		YPO_RS09480	1
VEL003.B0101_rmdup	1942255	1942259		yebS	4
VEL003.B0101_rmdup	1942418	1942419		yebS	1
VEL003.B0101_rmdup	1946096	1946104		prc	8
VEL003.B0101_rmdup	1947092	1947104		htpX	12
VEL003.B0101_rmdup	1948573	1948588		YPO_RS09510	15
VEL003.B0101_rmdup	1950474	1950481		YPO_RS09520	7
VEL003.B0101_rmdup	1951966	1951971		YPO_RS09520	5
VEL003.B0101_rmdup	1952005	1952042		YPO_RS09520	37
VEL003.B0101_rmdup	1955541	1955542		YPO_RS09535	1
VEL003.B0101_rmdup	1961578	1961589		YPO_RS09560	11
VEL003.B0101_rmdup	1963166	1963167		YPO_RS09565	1
VEL003.B0101_rmdup	1963465	1963478		YPO_RS09570	13
VEL003.B0101_rmdup	1964273	1964281		YPO_RS09570	8
VEL003.B0101_rmdup	1967865	1967888		YPO_RS09590	23
VEL003.B0101_rmdup	1969778	1969784		kduD	6
VEL003.B0101_rmdup	1970459	1970468		kduD	9
VEL003.B0101_rmdup	1972717	1972752		YPO_RS09610	35
VEL003.B0101_rmdup	1973370	1973375		YPO_RS09610	5
VEL003.B0101_rmdup	1975112	1975113		YPO_RS09620	1
VEL003.B0101_rmdup	1976752	1976757		YPO_RS09630	5
VEL003.B0101_rmdup	1992233	1992241		YPO_RS09730	8
VEL003.B0101_rmdup	1996046	1996069		YPO_RS09745	23
VEL003.B0101_rmdup	1997001	1997013		YPO_RS09750	12
VEL003.B0101_rmdup	1997102	1997111		YPO_RS09750	9
VEL003.B0101_rmdup	1999864	1999876		mntP	12
VEL003.B0101_rmdup	2000334	2000387		YPO_RS09760	53
VEL003.B0101_rmdup	2000471	2000474		YPO_RS09760	3
VEL003.B0101_rmdup	2002789	2002803		manX	14
VEL003.B0101_rmdup	2003716	2003724		manX	8
VEL003.B0101_rmdup	2005250	2005263		YPO_RS09780	13
VEL003.B0101_rmdup	2007012	2007015		YPO_RS09790	3
VEL003.B0101_rmdup	2010827	2010843		YPO_RS09810	16
VEL003.B0101_rmdup	2011706	2011715		hpaH	9
VEL003.B0101_rmdup	2012181	2012237		hpaI	56
VEL003.B0101_rmdup	2012912	2012920		hpaX	8
VEL003.B0101_rmdup	2013326	2013330		hpaX	4
VEL003.B0101_rmdup	2013734	2013738		hpaX	4
VEL003.B0101_rmdup	2015825	2015867		hpaC	42
VEL003.B0101_rmdup	2016999	2017000		YPO_RS09840	1
VEL003.B0101_rmdup	2018937	2018956		YPO_RS09845	19
VEL003.B0101_rmdup	2019318	2019334		pabB	16
VEL003.B0101_rmdup	2020127	2020157		pabB	30
VEL003.B0101_rmdup	2020273	2020294		pabB	21
VEL003.B0101_rmdup	2021149	2021170		purT	21
VEL003.B0101_rmdup	2023598	2023603		dbpA	5
VEL003.B0101_rmdup	2024821	2024823		YPO_RS09880	2
VEL003.B0101_rmdup	2026178	2026183		YPO_RS09885	5
VEL003.B0101_rmdup	2026350	2026353		YPO_RS09885	3
VEL003.B0101_rmdup	2027328	2027329		YPO_RS09885	1
VEL003.B0101_rmdup	2029131	2029181		pip	50
VEL003.B0101_rmdup	2033178	2033186		YPO_RS09920	8
VEL003.B0101_rmdup	2033246	2033252		YPO_RS09920	6
VEL003.B0101_rmdup	2035147	2035154		flhB	7
VEL003.B0101_rmdup	2035980	2035988		flhA	8
VEL003.B0101_rmdup	2036366	2036373		flhA	7
VEL003.B0101_rmdup	2036876	2036904		flhA	28
VEL003.B0101_rmdup	2044903	2044916		flgC	13
VEL003.B0101_rmdup	2047185	2047224		YPO_RS09990	39
VEL003.B0101_rmdup	2049796	2049801		YPO_RS10010	5
VEL003.B0101_rmdup	2050009	2050024		YPO_RS10010	15
VEL003.B0101_rmdup	2052948	2052958		flgK	10
VEL003.B0101_rmdup	2053328	2053338		flgK	10
VEL003.B0101_rmdup	2054835	2054845		flgL	10
VEL003.B0101_rmdup	2057211	2057216		YPO_RS10035	5
VEL003.B0101_rmdup	2059577	2059583		YPO_RS10040	6
VEL003.B0101_rmdup	2059759	2059789		YPO_RS10040	30
VEL003.B0101_rmdup	2060035	2060040		YPO_RS10045	5
VEL003.B0101_rmdup	2060382	2060389		YPO_RS10045	7
VEL003.B0101_rmdup	2060612	2060631		YPO_RS10045	19
VEL003.B0101_rmdup	2062933	2062934		YPO_RS10055	1
VEL003.B0101_rmdup	2063981	2063996		YPO_RS10060	15
VEL003.B0101_rmdup	2064210	2064241		YPO_RS10060	31
VEL003.B0101_rmdup	2067957	2067974		fliO	17
VEL003.B0101_rmdup	2069931	2069945		fliL	14
VEL003.B0101_rmdup	2070360	2070483		YPO_RS10110	123
VEL003.B0101_rmdup	2070943	2071001		YPO_RS10110	58
VEL003.B0101_rmdup	2071163	2071208		YPO_RS10110	45
VEL003.B0101_rmdup	2072521	2072566		fliI	45
VEL003.B0101_rmdup	2072611	2072621		fliI	10
VEL003.B0101_rmdup	2072845	2072852		fliI	7
VEL003.B0101_rmdup	2073590	2073626		fliI	36
VEL003.B0101_rmdup	2073611	2073626		fliH	15
VEL003.B0101_rmdup	2074477	2074497		fliG	20
VEL003.B0101_rmdup	2074811	2074819		fliG	8
VEL003.B0101_rmdup	2080806	2080837		YPO_RS10170	31
VEL003.B0101_rmdup	2081645	2081646		YPO_RS10170	1
VEL003.B0101_rmdup	2081765	2081782		YPO_RS10170	17
VEL003.B0101_rmdup	2081866	2081869		YPO_RS10170	3
VEL003.B0101_rmdup	2083385	2083387		YPO_RS10175	2
VEL003.B0101_rmdup	2083781	2083783		YPO_RS10175	2
VEL003.B0101_rmdup	2085550	2085554		fliD	4
VEL003.B0101_rmdup	2085669	2085746		fliD	77
VEL003.B0101_rmdup	2085862	2085871		fliD	9
VEL003.B0101_rmdup	2088779	2088781		YPO_RS10200	2
VEL003.B0101_rmdup	2089077	2089088		fliZ	11
VEL003.B0101_rmdup	2090018	2090040		YPO_RS10210	22
VEL003.B0101_rmdup	2090844	2090851		YPO_RS10210	7
VEL003.B0101_rmdup	2095271	2095299		putA	28
VEL003.B0101_rmdup	2096522	2096532		putA	10
VEL003.B0101_rmdup	2096706	2096718		putA	12
VEL003.B0101_rmdup	2096791	2096812		putA	21
VEL003.B0101_rmdup	2105609	2105625		YPO_RS10275	16
VEL003.B0101_rmdup	2106035	2106047		YPO_RS10275	12
VEL003.B0101_rmdup	2107216	2107247		cycA	31
VEL003.B0101_rmdup	2109269	2109270		YPO_RS10290	1
VEL003.B0101_rmdup	2112103	2112116		uvrY	13
VEL003.B0101_rmdup	2112781	2112785		uvrC	4
VEL003.B0101_rmdup	2114084	2114086		uvrC	2
VEL003.B0101_rmdup	2115317	2115328		YPO_RS10335	11
VEL003.B0101_rmdup	2117239	2117246		YPO_RS10350	7
VEL003.B0101_rmdup	2117349	2117357		YPO_RS10350	8
VEL003.B0101_rmdup	2117709	2117786		YPO_RS10355	77
VEL003.B0101_rmdup	2118026	2118091		hcp	65
VEL003.B0101_rmdup	2118331	2118347		hcp	16
VEL003.B0101_rmdup	2118674	2118686		YPO_RS10365	12
VEL003.B0101_rmdup	2118972	2118992		YPO_RS10365	20
VEL003.B0101_rmdup	2124161	2124167		YPO_RS10405	6
VEL003.B0101_rmdup	2126396	2126403		YPO_RS10415	7
VEL003.B0101_rmdup	2126462	2126464		YPO_RS10415	2
VEL003.B0101_rmdup	2126657	2126704		YPO_RS10420	47
VEL003.B0101_rmdup	2126762	2126778		YPO_RS10420	16
VEL003.B0101_rmdup	2128056	2128085		YPO_RS10430	29
VEL003.B0101_rmdup	2129558	2129583		YPO_RS10435	25
VEL003.B0101_rmdup	2131927	2131943		YPO_RS10445	16
VEL003.B0101_rmdup	2133068	2133069		YPO_RS10450	1
VEL003.B0101_rmdup	2133201	2133237		YPO_RS10450	36
VEL003.B0101_rmdup	2136220	2136221		YPO_RS10475	1
VEL003.B0101_rmdup	2137052	2137069		YPO_RS10480	17
VEL003.B0101_rmdup	2139276	2139281		YPO_RS10505	5
VEL003.B0101_rmdup	2140840	2140872		fyuA	32
VEL003.B0101_rmdup	2140903	2140918		fyuA	15
VEL003.B0101_rmdup	2141087	2141097		fyuA	10
VEL003.B0101_rmdup	2142375	2142380		fyuA	5
VEL003.B0101_rmdup	2142564	2142567		fyuA	3
VEL003.B0101_rmdup	2143226	2143252		ybtE	26
VEL003.B0101_rmdup	2143916	2143927		ybtE	11
VEL003.B0101_rmdup	2144025	2144058		ybtE	33
VEL003.B0101_rmdup	2145542	2145548		ybtU	6
VEL003.B0101_rmdup	2145601	2145637		ybtU	36
VEL003.B0101_rmdup	2146035	2146042		ybtU	7
VEL003.B0101_rmdup	2147158	2147169		irp1	11
VEL003.B0101_rmdup	2147652	2147696		irp1	44
VEL003.B0101_rmdup	2148094	2148096		irp1	2
VEL003.B0101_rmdup	2148134	2148143		irp1	9
VEL003.B0101_rmdup	2148588	2148637		irp1	49
VEL003.B0101_rmdup	2148834	2148906		irp1	72
VEL003.B0101_rmdup	2149486	2149492		irp1	6
VEL003.B0101_rmdup	2150263	2150277		irp1	14
VEL003.B0101_rmdup	2150847	2150872		irp1	25
VEL003.B0101_rmdup	2150968	2150987		irp1	19
VEL003.B0101_rmdup	2151950	2151962		irp1	12
VEL003.B0101_rmdup	2152138	2152142		irp1	4
VEL003.B0101_rmdup	2152238	2152248		irp1	10
VEL003.B0101_rmdup	2152402	2152406		irp1	4
VEL003.B0101_rmdup	2152636	2152662		irp1	26
VEL003.B0101_rmdup	2152996	2153034		irp1	38
VEL003.B0101_rmdup	2153359	2153381		irp1	22
VEL003.B0101_rmdup	2153544	2153550		irp1	6
VEL003.B0101_rmdup	2153701	2153708		irp1	7
VEL003.B0101_rmdup	2154272	2154347		irp1	75
VEL003.B0101_rmdup	2154551	2154553		irp1	2
VEL003.B0101_rmdup	2155143	2155187		irp1	44
VEL003.B0101_rmdup	2155564	2155594		irp1	30
VEL003.B0101_rmdup	2156346	2156377		irp2	31
VEL003.B0101_rmdup	2157040	2157051		irp2	11
VEL003.B0101_rmdup	2157419	2157441		irp2	22
VEL003.B0101_rmdup	2158488	2158489		irp2	1
VEL003.B0101_rmdup	2159142	2159178		irp2	36
VEL003.B0101_rmdup	2159637	2159643		irp2	6
VEL003.B0101_rmdup	2159762	2159780		irp2	18
VEL003.B0101_rmdup	2160018	2160023		irp2	5
VEL003.B0101_rmdup	2160103	2160117		irp2	14
VEL003.B0101_rmdup	2160162	2160175		irp2	13
VEL003.B0101_rmdup	2160476	2160506		irp2	30
VEL003.B0101_rmdup	2160630	2160641		irp2	11
VEL003.B0101_rmdup	2161342	2161345		irp2	3
VEL003.B0101_rmdup	2161915	2161930		irp2	15
VEL003.B0101_rmdup	2162092	2162121		irp2	29
VEL003.B0101_rmdup	2162603	2162612		ybtA	9
VEL003.B0101_rmdup	2162799	2162804		ybtA	5
VEL003.B0101_rmdup	2163597	2163630		ybtP	33
VEL003.B0101_rmdup	2164478	2164484		ybtP	6
VEL003.B0101_rmdup	2164603	2164656		ybtP	53
VEL003.B0101_rmdup	2164983	2164987		ybtP	4
VEL003.B0101_rmdup	2165214	2165227		ybtP	13
VEL003.B0101_rmdup	2165332	2165348		ybtQ	16
VEL003.B0101_rmdup	2165489	2165514		ybtQ	25
VEL003.B0101_rmdup	2165590	2165627		ybtQ	37
VEL003.B0101_rmdup	2165827	2165831		ybtQ	4
VEL003.B0101_rmdup	2165946	2166005		ybtQ	59
VEL003.B0101_rmdup	2166579	2166645		ybtQ	66
VEL003.B0101_rmdup	2167149	2167208		ybtX	59
VEL003.B0101_rmdup	2167609	2167633		ybtX	24
VEL003.B0101_rmdup	2168709	2168711		ybtS	2
VEL003.B0101_rmdup	2168925	2168930		ybtS	5
VEL003.B0101_rmdup	2169078	2169105		ybtS	27
VEL003.B0101_rmdup	2170137	2170139		YPO_RS10570	2
VEL003.B0101_rmdup	2170500	2170529		YPO_RS10570	29
VEL003.B0101_rmdup	2170996	2171024		YPO_RS10570	28
VEL003.B0101_rmdup	2171944	2171956		YPO_RS10580	12
VEL003.B0101_rmdup	2173372	2173379		YPO_RS10585	7
VEL003.B0101_rmdup	2174361	2174413		YPO_RS10590	52
VEL003.B0101_rmdup	2176668	2176675		YPO_RS10595	7
VEL003.B0101_rmdup	2178378	2178402		YPO_RS10605	24
VEL003.B0101_rmdup	2178524	2178562		YPO_RS10605	38
VEL003.B0101_rmdup	2179341	2179346		YPO_RS10605	5
VEL003.B0101_rmdup	2183680	2183731		YPO_RS10620	51
VEL003.B0101_rmdup	2184673	2184675		YPO_RS10620	2
VEL003.B0101_rmdup	2184927	2184936		YPO_RS10625	9
VEL003.B0101_rmdup	2185751	2185757		YPO_RS10630	6
VEL003.B0101_rmdup	2187162	2187167		YPO_RS10635	5
VEL003.B0101_rmdup	2187795	2187813		YPO_RS10645	18
VEL003.B0101_rmdup	2189870	2189894		YPO_RS10655	24
VEL003.B0101_rmdup	2190604	2190623		YPO_RS10655	19
VEL003.B0101_rmdup	2191359	2191386		YPO_RS10660	27
VEL003.B0101_rmdup	2193697	2193714		YPO_RS10670	17
VEL003.B0101_rmdup	2194561	2194574		ansP	13
VEL003.B0101_rmdup	2194944	2194946		ansP	2
VEL003.B0101_rmdup	2200598	2200611		YPO_RS10695	13
VEL003.B0101_rmdup	2204272	2204287		YPO_RS10705	15
VEL003.B0101_rmdup	2207063	2207079		YPO_RS10715	16
VEL003.B0101_rmdup	2207319	2207337		YPO_RS10715	18
VEL003.B0101_rmdup	2208687	2208690		YPO_RS10720	3
VEL003.B0101_rmdup	2209443	2209469		YPO_RS10725	26
VEL003.B0101_rmdup	2209603	2209609		YPO_RS10730	6
VEL003.B0101_rmdup	2212545	2212551		YPO_RS10745	6
VEL003.B0101_rmdup	2214248	2214253		pgaA	5
VEL003.B0101_rmdup	2215314	2215316		pgaA	2
VEL003.B0101_rmdup	2215663	2215670		pgaA	7
VEL003.B0101_rmdup	2217401	2217402		pgaB	1
VEL003.B0101_rmdup	2218036	2218057		YPO_RS10760	21
VEL003.B0101_rmdup	2220345	2220347		YPO_RS10770	2
VEL003.B0101_rmdup	2225066	2225070		narX	4
VEL003.B0101_rmdup	2226466	2226472		YPO_RS10800	6
VEL003.B0101_rmdup	2226557	2226564		YPO_RS10800	7
VEL003.B0101_rmdup	2226874	2226879		YPO_RS10800	5
VEL003.B0101_rmdup	2227547	2227564		YPO_RS10800	17
VEL003.B0101_rmdup	2228565	2228581		YPO_RS10805	16
VEL003.B0101_rmdup	2229243	2229277		YPO_RS10805	34
VEL003.B0101_rmdup	2234251	2234257		astE	6
VEL003.B0101_rmdup	2234345	2234350		astE	5
VEL003.B0101_rmdup	2237358	2237377		YPO_RS10835	19
VEL003.B0101_rmdup	2237453	2237468		YPO_RS10840	15
VEL003.B0101_rmdup	2237698	2237706		YPO_RS10840	8
VEL003.B0101_rmdup	2243540	2243575		YPO_RS10870	35
VEL003.B0101_rmdup	2244527	2244528		YPO_RS10875	1
VEL003.B0101_rmdup	2245134	2245137		YPO_RS10875	3
VEL003.B0101_rmdup	2247854	2247859		YPO_RS10885	5
VEL003.B0101_rmdup	2248315	2248340		YPO_RS10885	25
VEL003.B0101_rmdup	2249999	2250027		YPO_RS10895	28
VEL003.B0101_rmdup	2250615	2250624		YPO_RS10895	9
VEL003.B0101_rmdup	2251073	2251095		YPO_RS10900	22
VEL003.B0101_rmdup	2251193	2251198		YPO_RS10900	5
VEL003.B0101_rmdup	2251416	2251425		YPO_RS10900	9
VEL003.B0101_rmdup	2252951	2252971		YPO_RS10905	20
VEL003.B0101_rmdup	2252968	2252977		YPO_RS10910	9
VEL003.B0101_rmdup	2256135	2256147		YPO_RS10925	12
VEL003.B0101_rmdup	2257880	2257887		YPO_RS10930	7
VEL003.B0101_rmdup	2258489	2258516		YPO_RS10930	27
VEL003.B0101_rmdup	2258636	2258654		YPO_RS10935	18
VEL003.B0101_rmdup	2259145	2259187		YPO_RS10935	42
VEL003.B0101_rmdup	2260002	2260019		YPO_RS10935	17
VEL003.B0101_rmdup	2260768	2260782		YPO_RS10935	14
VEL003.B0101_rmdup	2261795	2261796		YPO_RS10940	1
VEL003.B0101_rmdup	2261838	2261843		YPO_RS10940	5
VEL003.B0101_rmdup	2262426	2262440		YPO_RS10940	14
VEL003.B0101_rmdup	2265664	2265710		YPO_RS10955	46
VEL003.B0101_rmdup	2265946	2265951		YPO_RS10955	5
VEL003.B0101_rmdup	2266240	2266246		YPO_RS10960	6
VEL003.B0101_rmdup	2266351	2266354		YPO_RS10965	3
VEL003.B0101_rmdup	2266423	2266463		YPO_RS10965	40
VEL003.B0101_rmdup	2267499	2267509		YPO_RS10970	10
VEL003.B0101_rmdup	2271421	2271425		YPO_RS10985	4
VEL003.B0101_rmdup	2273460	2273493		YPO_RS10995	33
VEL003.B0101_rmdup	2273578	2273599		YPO_RS10995	21
VEL003.B0101_rmdup	2275005	2275008		YPO_RS11005	3
VEL003.B0101_rmdup	2275253	2275259		YPO_RS11005	6
VEL003.B0101_rmdup	2277246	2277282		YPO_RS11015	36
VEL003.B0101_rmdup	2280601	2280604		YPO_RS11035	3
VEL003.B0101_rmdup	2283610	2283639		pth	29
VEL003.B0101_rmdup	2284537	2284538		ychH	1
VEL003.B0101_rmdup	2285488	2285520		YPO_RS11060	32
VEL003.B0101_rmdup	2286809	2286812		ispE	3
VEL003.B0101_rmdup	2288997	2289001		hemA	4
VEL003.B0101_rmdup	2289920	2289933		prfA	13
VEL003.B0101_rmdup	2290741	2290745		prmC	4
VEL003.B0101_rmdup	2290975	2290983		prmC	8
VEL003.B0101_rmdup	2299983	2300030		YPO_RS11135	47
VEL003.B0101_rmdup	2303321	2303374		YPO_RS11155	53
VEL003.B0101_rmdup	2303873	2303926		YPO_RS11155	53
VEL003.B0101_rmdup	2306066	2306084		YPO_RS11175	18
VEL003.B0101_rmdup	2306891	2306898		YPO_RS11175	7
VEL003.B0101_rmdup	2308421	2308433		YPO_RS11185	12
VEL003.B0101_rmdup	2308548	2308558		YPO_RS11190	10
VEL003.B0101_rmdup	2309996	2310006		YPO_RS11195	10
VEL003.B0101_rmdup	2310464	2310483		mdtH	19
VEL003.B0101_rmdup	2312843	2312844		YPO_RS11210	1
VEL003.B0101_rmdup	2313241	2313249		YPO_RS11210	8
VEL003.B0101_rmdup	2315251	2315259		murJ	8
VEL003.B0101_rmdup	2316457	2316520		YPO_RS11220	63
VEL003.B0101_rmdup	2316760	2316778		YPO_RS11220	18
VEL003.B0101_rmdup	2317089	2317137		YPO_RS11220	48
VEL003.B0101_rmdup	2317169	2317194		YPO_RS11220	25
VEL003.B0101_rmdup	2318098	2318102		YPO_RS11220	4
VEL003.B0101_rmdup	2318132	2318133		YPO_RS11225	1
VEL003.B0101_rmdup	2318293	2318296		YPO_RS11225	3
VEL003.B0101_rmdup	2318860	2318866		YPO_RS11225	6
VEL003.B0101_rmdup	2318958	2319008		YPO_RS11225	50
VEL003.B0101_rmdup	2319531	2319565		YPO_RS11225	34
VEL003.B0101_rmdup	2319792	2319794		YPO_RS11225	2
VEL003.B0101_rmdup	2320665	2320679		YPO_RS11225	14
VEL003.B0101_rmdup	2321401	2321419		YPO_RS11225	18
VEL003.B0101_rmdup	2321738	2321739		YPO_RS11225	1
VEL003.B0101_rmdup	2322820	2322837		YPO_RS11225	17
VEL003.B0101_rmdup	2324781	2324786		argS	5
VEL003.B0101_rmdup	2327584	2327590		cmoB	6
VEL003.B0101_rmdup	2328448	2328484		cmoA	36
VEL003.B0101_rmdup	2331848	2331871		aspS	23
VEL003.B0101_rmdup	2334966	2334967		ruvC	1
VEL003.B0101_rmdup	2336006	2336034		ruvA	28
VEL003.B0101_rmdup	2336459	2336480		ruvB	21
VEL003.B0101_rmdup	2336764	2336777		ruvB	13
VEL003.B0101_rmdup	2337723	2337732		znuB	9
VEL003.B0101_rmdup	2338726	2338728		znuC	2
VEL003.B0101_rmdup	2340703	2340713		mepM	10
VEL003.B0101_rmdup	2341416	2341417		mepM	1
VEL003.B0101_rmdup	2350183	2350243		YPO_RS11350	60
VEL003.B0101_rmdup	2355317	2355321		fadD	4
VEL003.B0101_rmdup	2360722	2360757		YPO_RS11405	35
VEL003.B0101_rmdup	2360934	2360943		YPO_RS11405	9
VEL003.B0101_rmdup	2362359	2362368		YPO_RS11410	9
VEL003.B0101_rmdup	2364656	2364660		YPO_RS11425	4
VEL003.B0101_rmdup	2365660	2365670		YPO_RS11430	10
VEL003.B0101_rmdup	2374920	2374933		YPO_RS11505	13
VEL003.B0101_rmdup	2375091	2375092		YPO_RS11505	1
VEL003.B0101_rmdup	2375096	2375102		YPO_RS11510	6
VEL003.B0101_rmdup	2375656	2375660		YPO_RS11510	4
VEL003.B0101_rmdup	2376094	2376105		YPO_RS11515	11
VEL003.B0101_rmdup	2376466	2376468		YPO_RS11515	2
VEL003.B0101_rmdup	2376952	2376969		YPO_RS11520	17
VEL003.B0101_rmdup	2389548	2389550		YPO_RS11590	2
VEL003.B0101_rmdup	2395599	2395631		YPO_RS11635	32
VEL003.B0101_rmdup	2396583	2396617		YPO_RS11645	34
VEL003.B0101_rmdup	2397018	2397030		YPO_RS11650	12
VEL003.B0101_rmdup	2398888	2398904		YPO_RS11660	16
VEL003.B0101_rmdup	2400716	2400741		YPO_RS11665	25
VEL003.B0101_rmdup	2401696	2401700		YPO_RS11665	4
VEL003.B0101_rmdup	2402284	2402291		YPO_RS11670	7
VEL003.B0101_rmdup	2405713	2405714		YPO_RS11685	1
VEL003.B0101_rmdup	2407321	2407341		YPO_RS11695	20
VEL003.B0101_rmdup	2409345	2409347		YPO_RS11700	2
VEL003.B0101_rmdup	2410814	2410831		nhaB	17
VEL003.B0101_rmdup	2414626	2414647		YPO_RS11720	21
VEL003.B0101_rmdup	2415688	2415724		YPO_RS11725	36
VEL003.B0101_rmdup	2416247	2416253		YPO_RS11725	6
VEL003.B0101_rmdup	2419444	2419478		YPO_RS11740	34
VEL003.B0101_rmdup	2419819	2419858		YPO_RS11740	39
VEL003.B0101_rmdup	2420355	2420367		YPO_RS11745	12
VEL003.B0101_rmdup	2424328	2424333		yeaG	5
VEL003.B0101_rmdup	2425677	2425683		YPO_RS11760	6
VEL003.B0101_rmdup	2426196	2426202		YPO_RS11765	6
VEL003.B0101_rmdup	2427374	2427381		gapA	7
VEL003.B0101_rmdup	2434000	2434002		selD	2
VEL003.B0101_rmdup	2434727	2434735		selD	8
VEL003.B0101_rmdup	2435575	2435585		YPO_RS11810	10
VEL003.B0101_rmdup	2435656	2435673		YPO_RS11810	17
VEL003.B0101_rmdup	2435705	2435729		YPO_RS11810	24
VEL003.B0101_rmdup	2436946	2436948		YPO_RS11810	2
VEL003.B0101_rmdup	2437359	2437364		YPO_RS11820	5
VEL003.B0101_rmdup	2437887	2437889		xthA	2
VEL003.B0101_rmdup	2439428	2439435		YPO_RS11830	7
VEL003.B0101_rmdup	2439564	2439614		YPO_RS11830	50
VEL003.B0101_rmdup	2439686	2439778		YPO_RS11830	92
VEL003.B0101_rmdup	2439893	2439929		YPO_RS11830	36
VEL003.B0101_rmdup	2439974	2440007		YPO_RS11830	33
VEL003.B0101_rmdup	2440190	2440224		YPO_RS11830	34
VEL003.B0101_rmdup	2441878	2441879		YPO_RS11850	1
VEL003.B0101_rmdup	2442021	2442022		YPO_RS11850	1
VEL003.B0101_rmdup	2443660	2443667		YPO_RS11860	7
VEL003.B0101_rmdup	2446001	2446015		rssB	14
VEL003.B0101_rmdup	2446828	2446852		YPO_RS11870	24
VEL003.B0101_rmdup	2452011	2452018		YPO_RS11890	7
VEL003.B0101_rmdup	2453248	2453267		adhE	19
VEL003.B0101_rmdup	2454772	2454810		adhE	38
VEL003.B0101_rmdup	2455145	2455149		adhE	4
VEL003.B0101_rmdup	2458132	2458133		oppA	1
VEL003.B0101_rmdup	2459204	2459206		oppA	2
VEL003.B0101_rmdup	2465291	2465318		cls	27
VEL003.B0101_rmdup	2467530	2467586		YPO_RS11950	56
VEL003.B0101_rmdup	2467978	2467986		YPO_RS11955	8
VEL003.B0101_rmdup	2470168	2470170		tonB	2
VEL003.B0101_rmdup	2470879	2470891		YPO_RS11975	12
VEL003.B0101_rmdup	2472593	2472598		YPO_RS11985	5
VEL003.B0101_rmdup	2472967	2472981		YPO_RS11990	14
VEL003.B0101_rmdup	2473247	2473250		YPO_RS11990	3
VEL003.B0101_rmdup	2475845	2475862		YPO_RS12005	17
VEL003.B0101_rmdup	2477776	2477796		trpA	20
VEL003.B0101_rmdup	2478588	2478626		trpB	38
VEL003.B0101_rmdup	2480324	2480339		trpCF	15
VEL003.B0101_rmdup	2486749	2486753		rluB	4
VEL003.B0101_rmdup	2487097	2487098		rluB	1
VEL003.B0101_rmdup	2487479	2487495		rluB	16
VEL003.B0101_rmdup	2489411	2489430		sohB	19
VEL003.B0101_rmdup	2489548	2489561		sohB	13
VEL003.B0101_rmdup	2489690	2489705		sohB	15
VEL003.B0101_rmdup	2490209	2490227		sohB	18
VEL003.B0101_rmdup	2491024	2491033		topA	9
VEL003.B0101_rmdup	2491145	2491234		topA	89
VEL003.B0101_rmdup	2494347	2494350		cysB	3
VEL003.B0101_rmdup	2495441	2495450		YPO_RS12105	9
VEL003.B0101_rmdup	2495457	2495458		YPO_RS12105	1
VEL003.B0101_rmdup	2495830	2495831		YPO_RS12105	1
VEL003.B0101_rmdup	2496840	2496882		acnA	42
VEL003.B0101_rmdup	2498679	2498687		acnA	8
VEL003.B0101_rmdup	2500874	2500898		pgpB	24
VEL003.B0101_rmdup	2501789	2501797		lapB	8
VEL003.B0101_rmdup	2502036	2502039		lapB	3
VEL003.B0101_rmdup	2503038	2503084		YPO_RS12135	46
VEL003.B0101_rmdup	2503328	2503331		YPO_RS12135	3
VEL003.B0101_rmdup	2508404	2508408		YPO_RS12175	4
VEL003.B0101_rmdup	2509065	2509071		YPO_RS12175	6
VEL003.B0101_rmdup	2514629	2514656		YPO_RS12190	27
VEL003.B0101_rmdup	2518453	2518466		rsxD	13
VEL003.B0101_rmdup	2518595	2518598		rsxD	3
VEL003.B0101_rmdup	2519275	2519323		YPO_RS12215	48
VEL003.B0101_rmdup	2521758	2521767		rsxC	9
VEL003.B0101_rmdup	2522294	2522299		rsxB	5
VEL003.B0101_rmdup	2529593	2529594		YPO_RS12255	1
VEL003.B0101_rmdup	2529656	2529659		YPO_RS12255	3
VEL003.B0101_rmdup	2532830	2532844		YPO_RS12265	14
VEL003.B0101_rmdup	2533857	2533872		YPO_RS12270	15
VEL003.B0101_rmdup	2535406	2535407		YPO_RS12275	1
VEL003.B0101_rmdup	2535776	2535778		YPO_RS12275	2
VEL003.B0101_rmdup	2539356	2539362		YPO_RS12290	6
VEL003.B0101_rmdup	2540141	2540168		YPO_RS12295	27
VEL003.B0101_rmdup	2543047	2543059		YPO_RS12305	12
VEL003.B0101_rmdup	2543792	2543807		manA	15
VEL003.B0101_rmdup	2545225	2545239		fumC	14
VEL003.B0101_rmdup	2545581	2545585		fumC	4
VEL003.B0101_rmdup	2548340	2548351		YPO_RS12325	11
VEL003.B0101_rmdup	2549108	2549109		YPO_RS12325	1
VEL003.B0101_rmdup	2549421	2549429		YPO_RS12330	8
VEL003.B0101_rmdup	2549512	2549513		YPO_RS12330	1
VEL003.B0101_rmdup	2553367	2553373		clcB	6
VEL003.B0101_rmdup	2553822	2553834		clcB	12
VEL003.B0101_rmdup	2554373	2554633		YPO_RS12355	260
VEL003.B0101_rmdup	2554658	2555065		YPO_RS12360	407
VEL003.B0101_rmdup	2555162	2555608		YPO_RS12365	446
VEL003.B0101_rmdup	2555780	2556832		YPO_RS12370	1052
VEL003.B0101_rmdup	2556844	2557161		YPO_RS12375	317
VEL003.B0101_rmdup	2557164	2557415		YPO_RS12380	251
VEL003.B0101_rmdup	2557451	2557684		YPO_RS12385	233
VEL003.B0101_rmdup	2557749	2559461		YPO_RS12390	1712
VEL003.B0101_rmdup	2559474	2559761		YPO_RS12395	287
VEL003.B0101_rmdup	2559765	2560790		YPO_RS12400	1025
VEL003.B0101_rmdup	2560790	2562034		YPO_RS12405	1244
VEL003.B0101_rmdup	2562123	2562371		YPO_RS12410	248
VEL003.B0101_rmdup	2562568	2562765		YPO_RS12415	197
VEL003.B0101_rmdup	2565812	2565866		YPO_RS12435	54
VEL003.B0101_rmdup	2567286	2567288		YPO_RS12440	2
VEL003.B0101_rmdup	2568125	2568126		YPO_RS12445	1
VEL003.B0101_rmdup	2568163	2568165		YPO_RS12445	2
VEL003.B0101_rmdup	2573068	2573098		YPO_RS12455	30
VEL003.B0101_rmdup	2577760	2577768		YPO_RS12465	8
VEL003.B0101_rmdup	2579726	2579738		ilvB	12
VEL003.B0101_rmdup	2582832	2582834		YPO_RS12495	2
VEL003.B0101_rmdup	2582963	2582968		YPO_RS12495	5
VEL003.B0101_rmdup	2587616	2587618		uspE	2
VEL003.B0101_rmdup	2590266	2590273		pntA	7
VEL003.B0101_rmdup	2591166	2591190		pntA	24
VEL003.B0101_rmdup	2592699	2592723		YPO_RS12530	24
VEL003.B0101_rmdup	2593884	2593900		YPO_RS12535	16
VEL003.B0101_rmdup	2595652	2595670		rstA	18
VEL003.B0101_rmdup	2604577	2604591		YPO_RS12575	14
VEL003.B0101_rmdup	2605063	2605070		YPO_RS12580	7
VEL003.B0101_rmdup	2606349	2606395		asr	46
VEL003.B0101_rmdup	2610640	2610644		hrpA	4
VEL003.B0101_rmdup	2612223	2612229		hrpA	6
VEL003.B0101_rmdup	2619659	2619660		YPO_RS12635	1
VEL003.B0101_rmdup	2620572	2620580		YPO_RS12640	8
VEL003.B0101_rmdup	2625480	2625482		nifJ	2
VEL003.B0101_rmdup	2625731	2625734		nifJ	3
VEL003.B0101_rmdup	2627136	2627138		nifJ	2
VEL003.B0101_rmdup	2628905	2628910		YPO_RS12675	5
VEL003.B0101_rmdup	2629258	2629260		YPO_RS12675	2
VEL003.B0101_rmdup	2630107	2630120		YPO_RS12680	13
VEL003.B0101_rmdup	2630520	2630530		YPO_RS12680	10
VEL003.B0101_rmdup	2631827	2631828		zntB	1
VEL003.B0101_rmdup	2640270	2640294		YPO_RS12725	24
VEL003.B0101_rmdup	2640528	2640552		YPO_RS12725	24
VEL003.B0101_rmdup	2645964	2645974		pspF	10
VEL003.B0101_rmdup	2650596	2650606		sapC	10
VEL003.B0101_rmdup	2651241	2651251		sapD	10
VEL003.B0101_rmdup	2656405	2656416		dtpA	11
VEL003.B0101_rmdup	2659837	2659850		YPO_RS12820	13
VEL003.B0101_rmdup	2660594	2660622		gstA	28
VEL003.B0101_rmdup	2664615	2664620		anmK	5
VEL003.B0101_rmdup	2665047	2665069		anmK	22
VEL003.B0101_rmdup	2666674	2666694		rovA	20
VEL003.B0101_rmdup	2669831	2669833		eptA	2
VEL003.B0101_rmdup	2673521	2673524		YPO_RS12890	3
VEL003.B0101_rmdup	2674566	2674575		YPO_RS12890	9
VEL003.B0101_rmdup	2675457	2675466		YPO_RS12890	9
VEL003.B0101_rmdup	2675763	2675807		YPO_RS12890	44
VEL003.B0101_rmdup	2676043	2676049		YPO_RS12890	6
VEL003.B0101_rmdup	2678146	2678163		YPO_RS12910	17
VEL003.B0101_rmdup	2679551	2679552		YPO_RS12915	1
VEL003.B0101_rmdup	2681614	2681620		purR	6
VEL003.B0101_rmdup	2682200	2682204		YPO_RS12935	4
VEL003.B0101_rmdup	2687067	2687070		YPO_RS12955	3
VEL003.B0101_rmdup	2691450	2691456		YPO_RS12980	6
VEL003.B0101_rmdup	2693104	2693106		YPO_RS12990	2
VEL003.B0101_rmdup	2693448	2693456		YPO_RS12990	8
VEL003.B0101_rmdup	2694629	2694651		YPO_RS13000	22
VEL003.B0101_rmdup	2695056	2695079		YPO_RS13000	23
VEL003.B0101_rmdup	2695532	2695568		YPO_RS13000	36
VEL003.B0101_rmdup	2696318	2696321		sufE	3
VEL003.B0101_rmdup	2696774	2696784		sufS	10
VEL003.B0101_rmdup	2697800	2697804		sufD	4
VEL003.B0101_rmdup	2698559	2698569		sufD	10
VEL003.B0101_rmdup	2698788	2698790		sufD	2
VEL003.B0101_rmdup	2699652	2699661		sufC	9
VEL003.B0101_rmdup	2705751	2705774		YPO_RS13040	23
VEL003.B0101_rmdup	2710260	2710265		ppsA	5
VEL003.B0101_rmdup	2712081	2712083		YPO_RS13065	2
VEL003.B0101_rmdup	2712789	2712793		YPO_RS13065	4
VEL003.B0101_rmdup	2716582	2716631		arnF	49
VEL003.B0101_rmdup	2718192	2718196		arnT	4
VEL003.B0101_rmdup	2722223	2722256		arnC	33
VEL003.B0101_rmdup	2725528	2725534		YPO_RS13130	6
VEL003.B0101_rmdup	2725884	2725885		btuC	1
VEL003.B0101_rmdup	2727438	2727442		YPO_RS13140	4
VEL003.B0101_rmdup	2735128	2735131		thrS	3
VEL003.B0101_rmdup	2736545	2736551		YPO_RS13190	6
VEL003.B0101_rmdup	2737727	2737746		YPO_RS13195	19
VEL003.B0101_rmdup	2738225	2738230		YPO_RS13200	5
VEL003.B0101_rmdup	2740802	2740814		yfeC	12
VEL003.B0101_rmdup	2742349	2742369		yfeD	20
VEL003.B0101_rmdup	2744698	2744702		hxpB	4
VEL003.B0101_rmdup	2745582	2745587		YPO_RS13245	5
VEL003.B0101_rmdup	2746013	2746021		YPO_RS13245	8
VEL003.B0101_rmdup	2754131	2754198		YPO_RS13285	67
VEL003.B0101_rmdup	2754954	2754973		YPO_RS13290	19
VEL003.B0101_rmdup	2755058	2755089		YPO_RS13290	31
VEL003.B0101_rmdup	2755140	2755141		YPO_RS13290	1
VEL003.B0101_rmdup	2756875	2756879		YPO_RS13295	4
VEL003.B0101_rmdup	2757509	2757520		YPO_RS13305	11
VEL003.B0101_rmdup	2763415	2763426		csy1	11
VEL003.B0101_rmdup	2763618	2763623		csy1	5
VEL003.B0101_rmdup	2764179	2764187		csy1	8
VEL003.B0101_rmdup	2765852	2765854		cas3f	2
VEL003.B0101_rmdup	2766962	2766965		cas3f	3
VEL003.B0101_rmdup	2767289	2767300		cas3f	11
VEL003.B0101_rmdup	2772110	2772129		YPO_RS13355	19
VEL003.B0101_rmdup	2772884	2772887		YPO_RS13355	3
VEL003.B0101_rmdup	2773432	2773467		YPO_RS13360	35
VEL003.B0101_rmdup	2775102	2775116		YPO_RS13365	14
VEL003.B0101_rmdup	2777510	2777515		YPO_RS13380	5
VEL003.B0101_rmdup	2777670	2777686		YPO_RS13380	16
VEL003.B0101_rmdup	2781015	2781033		YPO_RS13390	18
VEL003.B0101_rmdup	2781994	2782002		YPO_RS13395	8
VEL003.B0101_rmdup	2783302	2783344		ugpC	42
VEL003.B0101_rmdup	2787553	2787564		YPO_RS13430	11
VEL003.B0101_rmdup	2788795	2788831		YPO_RS13435	36
VEL003.B0101_rmdup	2789707	2789713		YPO_RS13445	6
VEL003.B0101_rmdup	2791127	2791131		cdiA	4
VEL003.B0101_rmdup	2791338	2791353		cdiA	15
VEL003.B0101_rmdup	2792623	2792652		cdiA	29
VEL003.B0101_rmdup	2793291	2793301		cdiA	10
VEL003.B0101_rmdup	2793411	2793418		cdiA	7
VEL003.B0101_rmdup	2794793	2794848		cdiA	55
VEL003.B0101_rmdup	2795003	2795008		cdiA	5
VEL003.B0101_rmdup	2795576	2795584		cdiA	8
VEL003.B0101_rmdup	2795994	2796000		cdiA	6
VEL003.B0101_rmdup	2796103	2796105		cdiA	2
VEL003.B0101_rmdup	2796407	2796412		cdiA	5
VEL003.B0101_rmdup	2796548	2796587		cdiA	39
VEL003.B0101_rmdup	2797289	2797290		cdiA	1
VEL003.B0101_rmdup	2799056	2799081		YPO_RS13455	25
VEL003.B0101_rmdup	2801029	2801091		YPO_RS13460	62
VEL003.B0101_rmdup	2801766	2801789		YPO_RS13465	23
VEL003.B0101_rmdup	2802569	2802570		YPO_RS13470	1
VEL003.B0101_rmdup	2808808	2808855		YPO_RS13490	47
VEL003.B0101_rmdup	2809596	2809601		YPO_RS13495	5
VEL003.B0101_rmdup	2809856	2809867		YPO_RS13495	11
VEL003.B0101_rmdup	2810757	2810771		YPO_RS13495	14
VEL003.B0101_rmdup	2811661	2811662		YPO_RS13500	1
VEL003.B0101_rmdup	2811720	2811726		YPO_RS13500	6
VEL003.B0101_rmdup	2813916	2814007		YPO_RS13510	91
VEL003.B0101_rmdup	2814142	2814185		YPO_RS13510	43
VEL003.B0101_rmdup	2814242	2814244		YPO_RS13510	2
VEL003.B0101_rmdup	2814299	2814311		YPO_RS13510	12
VEL003.B0101_rmdup	2814576	2814577		YPO_RS13515	1
VEL003.B0101_rmdup	2815522	2815533		YPO_RS13520	11
VEL003.B0101_rmdup	2815748	2815760		YPO_RS13520	12
VEL003.B0101_rmdup	2816291	2816294		YPO_RS13520	3
VEL003.B0101_rmdup	2816725	2816749		ompX	24
VEL003.B0101_rmdup	2816933	2816936		ompX	3
VEL003.B0101_rmdup	2819017	2819023		tam	6
VEL003.B0101_rmdup	2819582	2819584		tam	2
VEL003.B0101_rmdup	2826094	2826103		YPO_RS13570	9
VEL003.B0101_rmdup	2826165	2826173		YPO_RS13570	8
VEL003.B0101_rmdup	2826304	2826328		YPO_RS13575	24
VEL003.B0101_rmdup	2829850	2829879		rlmF	29
VEL003.B0101_rmdup	2830465	2830478		YPO_RS13595	13
VEL003.B0101_rmdup	2830868	2830871		ybiB	3
VEL003.B0101_rmdup	2831190	2831226		ybiB	36
VEL003.B0101_rmdup	2831576	2831602		ybiB	26
VEL003.B0101_rmdup	2832565	2832572		menE	7
VEL003.B0101_rmdup	2832884	2832887		menE	3
VEL003.B0101_rmdup	2834016	2834017		menC	1
VEL003.B0101_rmdup	2836026	2836054		menD	28
VEL003.B0101_rmdup	2836590	2836595		menD	5
VEL003.B0101_rmdup	2836938	2836948		menD	10
VEL003.B0101_rmdup	2838172	2838180		menF	8
VEL003.B0101_rmdup	2838824	2838831		menF	7
VEL003.B0101_rmdup	2842812	2842823		YPO_RS13645	11
VEL003.B0101_rmdup	2843007	2843008		YPO_RS13645	1
VEL003.B0101_rmdup	2844044	2844045		YPO_RS13645	1
VEL003.B0101_rmdup	2844144	2844148		YPO_RS13650	4
VEL003.B0101_rmdup	2844283	2844298		YPO_RS13650	15
VEL003.B0101_rmdup	2845079	2845117		YPO_RS13655	38
VEL003.B0101_rmdup	2845761	2845777		YPO_RS13655	16
VEL003.B0101_rmdup	2851591	2851607		idnO	16
VEL003.B0101_rmdup	2852063	2852067		idnO	4
VEL003.B0101_rmdup	2852628	2852646		YPO_RS13680	18
VEL003.B0101_rmdup	2853912	2853950		YPO_RS13690	38
VEL003.B0101_rmdup	2854048	2854076		YPO_RS13690	28
VEL003.B0101_rmdup	2854691	2854699		YPO_RS13690	8
VEL003.B0101_rmdup	2854785	2854793		YPO_RS13690	8
VEL003.B0101_rmdup	2855751	2855759		nuoN	8
VEL003.B0101_rmdup	2855948	2855960		nuoN	12
VEL003.B0101_rmdup	2857094	2857119		nuoM	25
VEL003.B0101_rmdup	2857324	2857344		nuoM	20
VEL003.B0101_rmdup	2857558	2857571		nuoM	13
VEL003.B0101_rmdup	2858780	2858799		nuoL	19
VEL003.B0101_rmdup	2859282	2859298		nuoL	16
VEL003.B0101_rmdup	2860011	2860049		nuoK	38
VEL003.B0101_rmdup	2863572	2863580		nuoG	8
VEL003.B0101_rmdup	2864199	2864234		nuoG	35
VEL003.B0101_rmdup	2864382	2864393		nuoG	11
VEL003.B0101_rmdup	2864874	2864893		nuoG	19
VEL003.B0101_rmdup	2865179	2865189		nuoF	10
VEL003.B0101_rmdup	2866762	2866782		nuoE	20
VEL003.B0101_rmdup	2869687	2869692		YPO_RS13750	5
VEL003.B0101_rmdup	2871844	2871869		lrhA	25
VEL003.B0101_rmdup	2873930	2873954		YPO_RS13765	24
VEL003.B0101_rmdup	2874015	2874023		YPO_RS13765	8
VEL003.B0101_rmdup	2879102	2879132		YPO_RS13790	30
VEL003.B0101_rmdup	2879908	2879934		ackA	26
VEL003.B0101_rmdup	2880434	2880463		ackA	29
VEL003.B0101_rmdup	2881932	2881941		pta	9
VEL003.B0101_rmdup	2883214	2883234		pta	20
VEL003.B0101_rmdup	2885539	2885593		YPO_RS13815	54
VEL003.B0101_rmdup	2885775	2885790		YPO_RS13815	15
VEL003.B0101_rmdup	2885812	2885838		YPO_RS13820	26
VEL003.B0101_rmdup	2886131	2886142		YPO_RS13820	11
VEL003.B0101_rmdup	2886320	2886325		YPO_RS13820	5
VEL003.B0101_rmdup	2887088	2887089		YPO_RS13825	1
VEL003.B0101_rmdup	2887261	2887268		YPO_RS13825	7
VEL003.B0101_rmdup	2887825	2887827		YPO_RS13825	2
VEL003.B0101_rmdup	2891691	2891716		YPO_RS13830	25
VEL003.B0101_rmdup	2897611	2897629		YPO_RS13845	18
VEL003.B0101_rmdup	2898209	2898214		YPO_RS13845	5
VEL003.B0101_rmdup	2898301	2898303		YPO_RS13845	2
VEL003.B0101_rmdup	2898633	2898642		iolD	9
VEL003.B0101_rmdup	2899046	2899048		iolD	2
VEL003.B0101_rmdup	2899430	2899448		iolD	18
VEL003.B0101_rmdup	2901790	2901796		YPO_RS13860	6
VEL003.B0101_rmdup	2901871	2901874		YPO_RS13860	3
VEL003.B0101_rmdup	2902725	2902739		YPO_RS13865	14
VEL003.B0101_rmdup	2904657	2904668		YPO_RS13870	11
VEL003.B0101_rmdup	2905321	2905323		YPO_RS13875	2
VEL003.B0101_rmdup	2905441	2905451		YPO_RS13875	10
VEL003.B0101_rmdup	2906270	2906291		YPO_RS13875	21
VEL003.B0101_rmdup	2906386	2906390		YPO_RS13875	4
VEL003.B0101_rmdup	2906739	2906745		iolC	6
VEL003.B0101_rmdup	2906860	2906862		iolC	2
VEL003.B0101_rmdup	2907015	2907016		iolC	1
VEL003.B0101_rmdup	2907398	2907415		iolC	17
VEL003.B0101_rmdup	2907898	2907919		iolC	21
VEL003.B0101_rmdup	2908013	2908017		iolC	4
VEL003.B0101_rmdup	2908104	2908111		iolC	7
VEL003.B0101_rmdup	2908162	2908211		iolC	49
VEL003.B0101_rmdup	2908948	2908967		iolE	19
VEL003.B0101_rmdup	2909503	2909521		iolB	18
VEL003.B0101_rmdup	2910268	2910290		iolB	22
VEL003.B0101_rmdup	2910493	2910498		YPO_RS13895	5
VEL003.B0101_rmdup	2911225	2911255		YPO_RS13900	30
VEL003.B0101_rmdup	2911758	2911770		YPO_RS13900	12
VEL003.B0101_rmdup	2912809	2912816		YPO_RS13905	7
VEL003.B0101_rmdup	2915441	2915442		YPO_RS13925	1
VEL003.B0101_rmdup	2922466	2922476		dacA	10
VEL003.B0101_rmdup	2923881	2923885		rlpA	4
VEL003.B0101_rmdup	2925189	2925197		mrdB	8
VEL003.B0101_rmdup	2926654	2926658		mrdA	4
VEL003.B0101_rmdup	2929701	2929712		holA	11
VEL003.B0101_rmdup	2929826	2929836		holA	10
VEL003.B0101_rmdup	2930708	2930715		lptE	7
VEL003.B0101_rmdup	2930827	2930831		lptE	4
VEL003.B0101_rmdup	2931439	2931443		leuS	4
VEL003.B0101_rmdup	2933768	2933787		YPO_RS14015	19
VEL003.B0101_rmdup	2934013	2934026		YPO_RS14015	13
VEL003.B0101_rmdup	2935238	2935250		gltK	12
VEL003.B0101_rmdup	2935366	2935372		gltK	6
VEL003.B0101_rmdup	2937238	2937249		YPO_RS14035	11
VEL003.B0101_rmdup	2938781	2938798		lnt	17
VEL003.B0101_rmdup	2939545	2939556		lnt	11
VEL003.B0101_rmdup	2941566	2941570		YPO_RS14055	4
VEL003.B0101_rmdup	2941909	2941910		YPO_RS14055	1
VEL003.B0101_rmdup	2942834	2942852		miaB	18
VEL003.B0101_rmdup	2943172	2943195		miaB	23
VEL003.B0101_rmdup	2945437	2945443		ubiF	6
VEL003.B0101_rmdup	2947283	2947302		asnB	19
VEL003.B0101_rmdup	2950802	2950811		YPO_RS14105	9
VEL003.B0101_rmdup	2951065	2951072		nagA	7
VEL003.B0101_rmdup	2951346	2951350		nagA	4
VEL003.B0101_rmdup	2953900	2953906		YPO_RS14120	6
VEL003.B0101_rmdup	2954879	2954882		YPO_RS14120	3
VEL003.B0101_rmdup	2957476	2957504		glnS	28
VEL003.B0101_rmdup	2964542	2964569		fldA	27
VEL003.B0101_rmdup	2974610	2974650		proV	40
VEL003.B0101_rmdup	2977133	2977139		nrdE	6
VEL003.B0101_rmdup	2977867	2977870		nrdE	3
VEL003.B0101_rmdup	2978334	2978339		nrdE	5
VEL003.B0101_rmdup	2980357	2980378		YPO_RS14235	21
VEL003.B0101_rmdup	2980430	2980622		YPO_RS14235	192
VEL003.B0101_rmdup	2981313	2981327		YPO_RS14240	14
VEL003.B0101_rmdup	2981720	2981746		YPO_RS14245	26
VEL003.B0101_rmdup	2982776	2982779		YPO_RS14250	3
VEL003.B0101_rmdup	2983042	2983049		YPO_RS14250	7
VEL003.B0101_rmdup	2983543	2983556		YPO_RS14250	13
VEL003.B0101_rmdup	2989653	2989655		YPO_RS14285	2
VEL003.B0101_rmdup	2992124	2992131		YPO_RS14295	7
VEL003.B0101_rmdup	2992628	2992642		YPO_RS14300	14
VEL003.B0101_rmdup	2996312	2996323		ureG	11
VEL003.B0101_rmdup	2998094	2998098		yut	4
VEL003.B0101_rmdup	2998359	2998365		yut	6
VEL003.B0101_rmdup	3000173	3000180		hdeB	7
VEL003.B0101_rmdup	3002811	3002821		crcB	10
VEL003.B0101_rmdup	3003147	3003150		YPO_RS14355	3
VEL003.B0101_rmdup	3006675	3006681		chbR	6
VEL003.B0101_rmdup	3007351	3007352		chbG	1
VEL003.B0101_rmdup	3008578	3008594		YPO_RS14385	16
VEL003.B0101_rmdup	3009260	3009271		seqA	11
VEL003.B0101_rmdup	3010748	3010767		pgm	19
VEL003.B0101_rmdup	3011084	3011085		pgm	1
VEL003.B0101_rmdup	3012173	3012220		YPO_RS14405	47
VEL003.B0101_rmdup	3014509	3014541		kdbD	32
VEL003.B0101_rmdup	3014754	3014756		kdbD	2
VEL003.B0101_rmdup	3016526	3016530		kdpC	4
VEL003.B0101_rmdup	3017900	3017928		kdpB	28
VEL003.B0101_rmdup	3018128	3018146		kdpB	18
VEL003.B0101_rmdup	3018758	3018760		kdpB	2
VEL003.B0101_rmdup	3019459	3019466		kdpA	7
VEL003.B0101_rmdup	3021083	3021162		YPO_RS14440	79
VEL003.B0101_rmdup	3024028	3024043		phrB	15
VEL003.B0101_rmdup	3024341	3024365		YPO_RS14460	24
VEL003.B0101_rmdup	3024665	3024686		YPO_RS14460	21
VEL003.B0101_rmdup	3027485	3027506		YPO_RS14480	21
VEL003.B0101_rmdup	3027561	3027564		YPO_RS14480	3
VEL003.B0101_rmdup	3030902	3030903		pcp	1
VEL003.B0101_rmdup	3031527	3031528		ung	1
VEL003.B0101_rmdup	3031932	3031933		ung	1
VEL003.B0101_rmdup	3033293	3033310		YPO_RS14515	17
VEL003.B0101_rmdup	3037261	3037264		YPO_RS14530	3
VEL003.B0101_rmdup	3040965	3040969		rseB	4
VEL003.B0101_rmdup	3042599	3042610		YPO_RS14560	11
VEL003.B0101_rmdup	3044409	3044427		lepA	18
VEL003.B0101_rmdup	3049062	3049085		YPO_RS14590	23
VEL003.B0101_rmdup	3049170	3049172		YPO_RS14590	2
VEL003.B0101_rmdup	3049354	3049355		YPO_RS14590	1
VEL003.B0101_rmdup	3051859	3051860		tssM	1
VEL003.B0101_rmdup	3053474	3053475		tssM	1
VEL003.B0101_rmdup	3054003	3054012		tssM	9
VEL003.B0101_rmdup	3054048	3054056		tssM	8
VEL003.B0101_rmdup	3054670	3054690		tssM	20
VEL003.B0101_rmdup	3055883	3055891		YPO_RS14610	8
VEL003.B0101_rmdup	3059704	3059718		YPO_RS14620	14
VEL003.B0101_rmdup	3062810	3062811		YPO_RS14645	1
VEL003.B0101_rmdup	3065223	3065229		YPO_RS14655	6
VEL003.B0101_rmdup	3065973	3065993		YPO_RS14660	20
VEL003.B0101_rmdup	3067690	3067691		ccmB	1
VEL003.B0101_rmdup	3075602	3075617		fadL	15
VEL003.B0101_rmdup	3076828	3076833		fadI	5
VEL003.B0101_rmdup	3077129	3077150		fadI	21
VEL003.B0101_rmdup	3077268	3077274		fadI	6
VEL003.B0101_rmdup	3083823	3083827		aroC	4
VEL003.B0101_rmdup	3083970	3083972		aroC	2
VEL003.B0101_rmdup	3084128	3084141		aroC	13
VEL003.B0101_rmdup	3084878	3084885		mepA	7
VEL003.B0101_rmdup	3087275	3087290		YPO_RS14770	15
VEL003.B0101_rmdup	3089289	3089301		mnmC	12
VEL003.B0101_rmdup	3097091	3097094		YPO_RS14805	3
VEL003.B0101_rmdup	3101838	3101853		YPO_RS14830	15
VEL003.B0101_rmdup	3106713	3106714		purF	1
VEL003.B0101_rmdup	3109681	3109697		hisJ	16
VEL003.B0101_rmdup	3110768	3110780		YPO_RS14875	12
VEL003.B0101_rmdup	3111731	3111737		hisP	6
VEL003.B0101_rmdup	3113697	3113703		YPO_RS14890	6
VEL003.B0101_rmdup	3115551	3115565		yfcD	14
VEL003.B0101_rmdup	3118508	3118518		YPO_RS14910	10
VEL003.B0101_rmdup	3121241	3121242		YPO_RS14925	1
VEL003.B0101_rmdup	3123926	3123977		YPO_RS14945	51
VEL003.B0101_rmdup	3125599	3125619		yapC	20
VEL003.B0101_rmdup	3125697	3125700		yapC	3
VEL003.B0101_rmdup	3127200	3127213		YPO_RS14960	13
VEL003.B0101_rmdup	3133357	3133372		YPO_RS14990	15
VEL003.B0101_rmdup	3135123	3135137		YPO_RS14990	14
VEL003.B0101_rmdup	3138377	3138378		YPO_RS15000	1
VEL003.B0101_rmdup	3138675	3138680		YPO_RS15005	5
VEL003.B0101_rmdup	3140551	3140587		YPO_RS15015	36
VEL003.B0101_rmdup	3143408	3143414		YPO_RS15030	6
VEL003.B0101_rmdup	3143731	3143732		YPO_RS15035	1
VEL003.B0101_rmdup	3144893	3144905		YPO_RS15040	12
VEL003.B0101_rmdup	3145276	3145299		YPO_RS15040	23
VEL003.B0101_rmdup	3146318	3146322		YPO_RS15040	4
VEL003.B0101_rmdup	3150521	3150527		YPO_RS15075	6
VEL003.B0101_rmdup	3151684	3151693		YPO_RS15090	9
VEL003.B0101_rmdup	3155693	3155707		purM	14
VEL003.B0101_rmdup	3156186	3156225		purN	39
VEL003.B0101_rmdup	3160018	3160033		pstA	15
VEL003.B0101_rmdup	3163405	3163413		YPO_RS15145	8
VEL003.B0101_rmdup	3164502	3164504		ppk1	2
VEL003.B0101_rmdup	3166458	3166469		ppx	11
VEL003.B0101_rmdup	3170329	3170333		yegD	4
VEL003.B0101_rmdup	3170845	3170871		yegD	26
VEL003.B0101_rmdup	3174884	3174908		YPO_RS15190	24
VEL003.B0101_rmdup	3176135	3176156		YPO_RS15195	21
VEL003.B0101_rmdup	3178768	3178780		YPO_RS15200	12
VEL003.B0101_rmdup	3179503	3179538		YPO_RS15205	35
VEL003.B0101_rmdup	3180933	3180959		YPO_RS15210	26
VEL003.B0101_rmdup	3181247	3181264		YPO_RS15210	17
VEL003.B0101_rmdup	3181972	3181975		YPO_RS15210	3
VEL003.B0101_rmdup	3182325	3182329		YPO_RS15210	4
VEL003.B0101_rmdup	3183176	3183179		YPO_RS15210	3
VEL003.B0101_rmdup	3183648	3183651		YPO_RS15210	3
VEL003.B0101_rmdup	3183934	3183948		mdtC	14
VEL003.B0101_rmdup	3184507	3184527		mdtC	20
VEL003.B0101_rmdup	3186335	3186340		mdtC	5
VEL003.B0101_rmdup	3186739	3186773		mdtC	34
VEL003.B0101_rmdup	3187138	3187143		YPO_RS15220	5
VEL003.B0101_rmdup	3187300	3187309		YPO_RS15220	9
VEL003.B0101_rmdup	3194133	3194159		yegS	26
VEL003.B0101_rmdup	3197462	3197469		YPO_RS15265	7
VEL003.B0101_rmdup	3197841	3197856		YPO_RS15265	15
VEL003.B0101_rmdup	3198264	3198281		YPO_RS15275	17
VEL003.B0101_rmdup	3200412	3200433		YPO_RS15285	21
VEL003.B0101_rmdup	3200537	3200587		YPO_RS15285	50
VEL003.B0101_rmdup	3200675	3200866		YPO_RS15290	191
VEL003.B0101_rmdup	3200973	3200979		YPO_RS15290	6
VEL003.B0101_rmdup	3201037	3201046		YPO_RS15290	9
VEL003.B0101_rmdup	3201302	3201336		YPO_RS15295	34
VEL003.B0101_rmdup	3201394	3201429		YPO_RS15295	35
VEL003.B0101_rmdup	3201567	3201805		YPO_RS15300	238
VEL003.B0101_rmdup	3201871	3201872		YPO_RS15300	1
VEL003.B0101_rmdup	3201927	3201952		YPO_RS15300	25
VEL003.B0101_rmdup	3202247	3202285		YPO_RS15305	38
VEL003.B0101_rmdup	3205319	3205322		guaB	3
VEL003.B0101_rmdup	3207419	3207433		xseA	14
VEL003.B0101_rmdup	3207541	3207542		xseA	1
VEL003.B0101_rmdup	3214434	3214456		hisS	22
VEL003.B0101_rmdup	3214635	3214640		hisS	5
VEL003.B0101_rmdup	3216184	3216209		rodZ	25
VEL003.B0101_rmdup	3220239	3220255		YPO_RS15385	16
VEL003.B0101_rmdup	3221641	3221672		YPO_RS15385	31
VEL003.B0101_rmdup	3221807	3221854		YPO_RS15385	47
VEL003.B0101_rmdup	3221967	3221968		YPO_RS15385	1
VEL003.B0101_rmdup	3222340	3222355		YPO_RS15385	15
VEL003.B0101_rmdup	3222540	3222552		YPO_RS15385	12
VEL003.B0101_rmdup	3222630	3222651		YPO_RS15385	21
VEL003.B0101_rmdup	3223573	3223575		yapA	2
VEL003.B0101_rmdup	3224224	3224227		yapA	3
VEL003.B0101_rmdup	3225011	3225014		yapA	3
VEL003.B0101_rmdup	3225226	3225232		yapA	6
VEL003.B0101_rmdup	3225529	3225535		yapA	6
VEL003.B0101_rmdup	3225629	3225644		yapA	15
VEL003.B0101_rmdup	3228358	3228392		YPO_RS15395	34
VEL003.B0101_rmdup	3228582	3228594		YPO_RS15395	12
VEL003.B0101_rmdup	3228696	3228705		YPO_RS15395	9
VEL003.B0101_rmdup	3229098	3229100		YPO_RS15395	2
VEL003.B0101_rmdup	3229894	3229918		YPO_RS15395	24
VEL003.B0101_rmdup	3230358	3230360		YPO_RS15395	2
VEL003.B0101_rmdup	3235251	3235260		hscA	9
VEL003.B0101_rmdup	3236975	3236977		hscA	2
VEL003.B0101_rmdup	3237714	3237725		hscB	11
VEL003.B0101_rmdup	3238836	3238837		iscU	1
VEL003.B0101_rmdup	3240308	3240309		iscR	1
VEL003.B0101_rmdup	3240551	3240553		iscR	2
VEL003.B0101_rmdup	3240880	3240886		trmJ	6
VEL003.B0101_rmdup	3240995	3241010		trmJ	15
VEL003.B0101_rmdup	3245368	3245369		csiE	1
VEL003.B0101_rmdup	3251789	3251799		hmpA	10
VEL003.B0101_rmdup	3255312	3255335		YPO_RS15525	23
VEL003.B0101_rmdup	3262648	3262752		YPO_RS15560	104
VEL003.B0101_rmdup	3263977	3263978		purL	1
VEL003.B0101_rmdup	3264665	3264684		purL	19
VEL003.B0101_rmdup	3265836	3265852		purL	16
VEL003.B0101_rmdup	3268531	3268532		mltF	1
VEL003.B0101_rmdup	3270229	3270243		yfhb	14
VEL003.B0101_rmdup	3271156	3271160		murQ	4
VEL003.B0101_rmdup	3272963	3272966		YPO_RS15600	3
VEL003.B0101_rmdup	3276894	3276916		YPO_RS15625	22
VEL003.B0101_rmdup	3278690	3278702		tssK	12
VEL003.B0101_rmdup	3280146	3280148		YPO_RS15645	2
VEL003.B0101_rmdup	3280765	3280790		tssC	25
VEL003.B0101_rmdup	3282765	3282769		YPO_RS15660	4
VEL003.B0101_rmdup	3284503	3284505		YPO_RS15665	2
VEL003.B0101_rmdup	3284969	3284980		YPO_RS15670	11
VEL003.B0101_rmdup	3285289	3285296		YPO_RS15670	7
VEL003.B0101_rmdup	3285772	3285781		YPO_RS15670	9
VEL003.B0101_rmdup	3285803	3285823		YPO_RS15675	20
VEL003.B0101_rmdup	3287495	3287508		YPO_RS15680	13
VEL003.B0101_rmdup	3287993	3287997		YPO_RS15680	4
VEL003.B0101_rmdup	3291255	3291272		tssH	17
VEL003.B0101_rmdup	3292707	3292718		tssF	11
VEL003.B0101_rmdup	3294146	3294147		tssF	1
VEL003.B0101_rmdup	3294916	3294918		tssG	2
VEL003.B0101_rmdup	3295447	3295460		tssG	13
VEL003.B0101_rmdup	3296544	3296555		YPO_RS15705	11
VEL003.B0101_rmdup	3297926	3297939		YPO_RS15715	13
VEL003.B0101_rmdup	3298136	3298138		YPO_RS15715	2
VEL003.B0101_rmdup	3298746	3298754		YPO_RS15715	8
VEL003.B0101_rmdup	3299189	3299203		YPO_RS15715	14
VEL003.B0101_rmdup	3299200	3299223		YPO_RS15720	23
VEL003.B0101_rmdup	3300373	3300395		YPO_RS15725	22
VEL003.B0101_rmdup	3302914	3302918		YPO_RS15735	4
VEL003.B0101_rmdup	3304545	3304547		mltB	2
VEL003.B0101_rmdup	3307039	3307046		YPO_RS15750	7
VEL003.B0101_rmdup	3308050	3308066		YPO_RS15750	16
VEL003.B0101_rmdup	3308753	3308788		YPO_RS15755	35
VEL003.B0101_rmdup	3309020	3309079		YPO_RS15755	59
VEL003.B0101_rmdup	3313704	3313707		YPO_RS15775	3
VEL003.B0101_rmdup	3314079	3314086		YPO_RS15775	7
VEL003.B0101_rmdup	3315130	3315131		YPO_RS15775	1
VEL003.B0101_rmdup	3315507	3315510		dmsB	3
VEL003.B0101_rmdup	3315947	3315970		YPO_RS15785	23
VEL003.B0101_rmdup	3317827	3317831		YPO_RS15795	4
VEL003.B0101_rmdup	3317861	3317868		YPO_RS15795	7
VEL003.B0101_rmdup	3318201	3318211		YPO_RS15795	10
VEL003.B0101_rmdup	3319162	3319166		YPO_RS15800	4
VEL003.B0101_rmdup	3320232	3320272		YPO_RS15810	40
VEL003.B0101_rmdup	3321726	3321735		YPO_RS15820	9
VEL003.B0101_rmdup	3323313	3323343		alaC	30
VEL003.B0101_rmdup	3330222	3330233		YPO_RS15860	11
VEL003.B0101_rmdup	3331640	3331646		YPO_RS15865	6
VEL003.B0101_rmdup	3334830	3334847		gltX	17
VEL003.B0101_rmdup	3342175	3342214		cysK	39
VEL003.B0101_rmdup	3347159	3347175		YPO_RS15975	16
VEL003.B0101_rmdup	3352764	3352768		YPO_RS15995	4
VEL003.B0101_rmdup	3353033	3353038		YPO_RS15995	5
VEL003.B0101_rmdup	3354173	3354174		YPO_RS15995	1
VEL003.B0101_rmdup	3356895	3356896		YPO_RS16010	1
VEL003.B0101_rmdup	3358248	3358302		YPO_RS16020	54
VEL003.B0101_rmdup	3362677	3362697		YPO_RS16035	20
VEL003.B0101_rmdup	3363710	3363734		YPO_RS16040	24
VEL003.B0101_rmdup	3363807	3363840		YPO_RS16040	33
VEL003.B0101_rmdup	3364182	3364210		YPO_RS16040	28
VEL003.B0101_rmdup	3364283	3364340		YPO_RS16040	57
VEL003.B0101_rmdup	3364675	3364737		YPO_RS16040	62
VEL003.B0101_rmdup	3365330	3365335		cysM	5
VEL003.B0101_rmdup	3371419	3371420		YPO_RS16070	1
VEL003.B0101_rmdup	3372681	3372682		YPO_RS16075	1
VEL003.B0101_rmdup	3374481	3374489		YPO_RS16085	8
VEL003.B0101_rmdup	3376514	3376534		YPO_RS16095	20
VEL003.B0101_rmdup	3376990	3376995		YPO_RS16095	5
VEL003.B0101_rmdup	3378603	3378604		YPO_RS16105	1
VEL003.B0101_rmdup	3378762	3378790		YPO_RS16105	28
VEL003.B0101_rmdup	3383727	3383754		YPO_RS16125	27
VEL003.B0101_rmdup	3383824	3383867		YPO_RS16125	43
VEL003.B0101_rmdup	3385318	3385328		hemF	10
VEL003.B0101_rmdup	3385913	3385932		hemF	19
VEL003.B0101_rmdup	3388088	3388091		maeB	3
VEL003.B0101_rmdup	3389282	3389294		nudK	12
VEL003.B0101_rmdup	3390653	3390663		napB	10
VEL003.B0101_rmdup	3391900	3391903		napA	3
VEL003.B0101_rmdup	3393479	3393483		napA	4
VEL003.B0101_rmdup	3396581	3396597		acrD	16
VEL003.B0101_rmdup	3398459	3398461		acrD	2
VEL003.B0101_rmdup	3398549	3398568		acrD	19
VEL003.B0101_rmdup	3399358	3399359		acrD	1
VEL003.B0101_rmdup	3399425	3399439		acrD	14
VEL003.B0101_rmdup	3403235	3403252		YPO_RS16210	17
VEL003.B0101_rmdup	3403421	3403443		YPO_RS16210	22
VEL003.B0101_rmdup	3404193	3404194		YPO_RS16210	1
VEL003.B0101_rmdup	3405639	3405659		YPO_RS16220	20
VEL003.B0101_rmdup	3407025	3407028		YPO_RS16225	3
VEL003.B0101_rmdup	3408102	3408104		YPO_RS16225	2
VEL003.B0101_rmdup	3410954	3410956		dapE	2
VEL003.B0101_rmdup	3411033	3411035		dapE	2
VEL003.B0101_rmdup	3413693	3413700		YPO_RS16260	7
VEL003.B0101_rmdup	3414047	3414066		YPO_RS16260	19
VEL003.B0101_rmdup	3414441	3414452		YPO_RS16260	11
VEL003.B0101_rmdup	3414644	3414647		YPO_RS16260	3
VEL003.B0101_rmdup	3415180	3415198		YPO_RS16265	18
VEL003.B0101_rmdup	3416385	3416398		YPO_RS16270	13
VEL003.B0101_rmdup	3422111	3422114		YPO_RS16305	3
VEL003.B0101_rmdup	3426919	3426924		hda	5
VEL003.B0101_rmdup	3429010	3429034		cysS	24
VEL003.B0101_rmdup	3429634	3429673		cysS	39
VEL003.B0101_rmdup	3430558	3430575		ppiB	17
VEL003.B0101_rmdup	3430920	3430923		YPO_RS16345	3
VEL003.B0101_rmdup	3431058	3431063		YPO_RS16345	5
VEL003.B0101_rmdup	3432088	3432133		purE	45
VEL003.B0101_rmdup	3433070	3433071		purK	1
VEL003.B0101_rmdup	3433299	3433323		purK	24
VEL003.B0101_rmdup	3435715	3435740		YPO_RS16360	25
VEL003.B0101_rmdup	3437910	3437911		YPO_RS16375	1
VEL003.B0101_rmdup	3441065	3441084		cueR	19
VEL003.B0101_rmdup	3442095	3442100		copA	5
VEL003.B0101_rmdup	3442484	3442487		copA	3
VEL003.B0101_rmdup	3442635	3442654		copA	19
VEL003.B0101_rmdup	3443825	3443834		copA	9
VEL003.B0101_rmdup	3445470	3445473		YPO_RS16405	3
VEL003.B0101_rmdup	3452755	3452771		YPO_RS16435	16
VEL003.B0101_rmdup	3452888	3452899		YPO_RS16435	11
VEL003.B0101_rmdup	3454408	3454443		fepE	35
VEL003.B0101_rmdup	3454563	3454575		fepE	12
VEL003.B0101_rmdup	3454812	3454894		fepE	82
VEL003.B0101_rmdup	3455009	3455035		cpsG	26
VEL003.B0101_rmdup	3455904	3455953		cpsG	49
VEL003.B0101_rmdup	3456490	3456495		YPO_RS16450	5
VEL003.B0101_rmdup	3456531	3456586		YPO_RS16450	55
VEL003.B0101_rmdup	3456642	3456661		YPO_RS16450	19
VEL003.B0101_rmdup	3456946	3456987		YPO_RS16450	41
VEL003.B0101_rmdup	3457122	3457130		YPO_RS16450	8
VEL003.B0101_rmdup	3457133	3457177		YPO_RS16455	44
VEL003.B0101_rmdup	3461654	3461660		YPO_RS16470	6
VEL003.B0101_rmdup	3463463	3463499		YPO_RS16480	36
VEL003.B0101_rmdup	3463726	3463828		YPO_RS16480	102
VEL003.B0101_rmdup	3463875	3463969		YPO_RS16480	94
VEL003.B0101_rmdup	3464115	3464174		YPO_RS16480	59
VEL003.B0101_rmdup	3464221	3464235		YPO_RS16480	14
VEL003.B0101_rmdup	3464843	3464873		YPO_RS16485	30
VEL003.B0101_rmdup	3465003	3465109		YPO_RS16485	106
VEL003.B0101_rmdup	3465447	3465453		YPO_RS16485	6
VEL003.B0101_rmdup	3465506	3465556		YPO_RS16485	50
VEL003.B0101_rmdup	3465567	3465593		YPO_RS16490	26
VEL003.B0101_rmdup	3465706	3465721		YPO_RS16490	15
VEL003.B0101_rmdup	3466017	3466031		YPO_RS16490	14
VEL003.B0101_rmdup	3466260	3466385		YPO_RS16490	125
VEL003.B0101_rmdup	3466577	3466644		YPO_RS16490	67
VEL003.B0101_rmdup	3466795	3466804		YPO_RS16490	9
VEL003.B0101_rmdup	3466984	3466996		YPO_RS16495	12
VEL003.B0101_rmdup	3467122	3467130		YPO_RS16495	8
VEL003.B0101_rmdup	3467565	3467570		YPO_RS16495	5
VEL003.B0101_rmdup	3468667	3468669		YPO_RS16500	2
VEL003.B0101_rmdup	3468979	3468981		YPO_RS16500	2
VEL003.B0101_rmdup	3469609	3469612		rfbH	3
VEL003.B0101_rmdup	3475648	3475649		adk	1
VEL003.B0101_rmdup	3477552	3477585		htpG	33
VEL003.B0101_rmdup	3479522	3479534		dnaX	12
VEL003.B0101_rmdup	3479761	3479762		dnaX	1
VEL003.B0101_rmdup	3480506	3480509		dnaX	3
VEL003.B0101_rmdup	3480638	3480643		dnaX	5
VEL003.B0101_rmdup	3486331	3486341		mscK	10
VEL003.B0101_rmdup	3486961	3487029		mscK	68
VEL003.B0101_rmdup	3489364	3489381		mscK	17
VEL003.B0101_rmdup	3490239	3490262		acrR	23
VEL003.B0101_rmdup	3492271	3492273		YPO_RS16605	2
VEL003.B0101_rmdup	3492808	3492823		YPO_RS16605	15
VEL003.B0101_rmdup	3495161	3495177		YPO_RS16605	16
VEL003.B0101_rmdup	3496941	3496962		YPO_RS16620	21
VEL003.B0101_rmdup	3497658	3497668		tomB	10
VEL003.B0101_rmdup	3506475	3506494		YPO_RS16670	19
VEL003.B0101_rmdup	3509067	3509080		cof	13
VEL003.B0101_rmdup	3509815	3509817		YPO_RS16690	2
VEL003.B0101_rmdup	3511882	3511895		queC	13
VEL003.B0101_rmdup	3513584	3513641		YPO_RS16705	57
VEL003.B0101_rmdup	3516257	3516280		hupB	23
VEL003.B0101_rmdup	3516851	3516857		lon	6
VEL003.B0101_rmdup	3517086	3517105		lon	19
VEL003.B0101_rmdup	3517956	3517962		lon	6
VEL003.B0101_rmdup	3519400	3519414		clpX	14
VEL003.B0101_rmdup	3520940	3520985		clpP	45
VEL003.B0101_rmdup	3521039	3521043		clpP	4
VEL003.B0101_rmdup	3527260	3527267		YPO_RS16755	7
VEL003.B0101_rmdup	3528878	3528882		cyoB	4
VEL003.B0101_rmdup	3534140	3534143		YPO_RS16785	3
VEL003.B0101_rmdup	3534619	3534625		YPO_RS16790	6
VEL003.B0101_rmdup	3541647	3541648		dxs	1
VEL003.B0101_rmdup	3546095	3546104		ribD	9
VEL003.B0101_rmdup	3546807	3546823		nrdR	16
VEL003.B0101_rmdup	3547439	3547490		YPO_RS16860	51
VEL003.B0101_rmdup	3547558	3547564		YPO_RS16860	6
VEL003.B0101_rmdup	3547746	3547766		YPO_RS16865	20
VEL003.B0101_rmdup	3547992	3548092		YPO_RS16865	100
VEL003.B0101_rmdup	3548149	3548188		YPO_RS16865	39
VEL003.B0101_rmdup	3551050	3551085		secD	35
VEL003.B0101_rmdup	3552000	3552028		secD	28
VEL003.B0101_rmdup	3552474	3552483		yajC	9
VEL003.B0101_rmdup	3553675	3553738		tgt	63
VEL003.B0101_rmdup	3554832	3554833		queA	1
VEL003.B0101_rmdup	3560229	3560247		YPO_RS16920	18
VEL003.B0101_rmdup	3560412	3560427		YPO_RS16925	15
VEL003.B0101_rmdup	3560586	3560600		malZ	14
VEL003.B0101_rmdup	3561676	3561681		malZ	5
VEL003.B0101_rmdup	3566292	3566319		YPO_RS16945	27
VEL003.B0101_rmdup	3568232	3568293		phoR	61
VEL003.B0101_rmdup	3568351	3568356		phoR	5
VEL003.B0101_rmdup	3569119	3569151		phoB	32
VEL003.B0101_rmdup	3571769	3571777		YPO_RS16965	8
VEL003.B0101_rmdup	3572094	3572134		YPO_RS16965	40
VEL003.B0101_rmdup	3575179	3575182		YPO_RS16970	3
VEL003.B0101_rmdup	3576218	3576228		YPO_RS16975	10
VEL003.B0101_rmdup	3581051	3581062		YPO_RS17000	11
VEL003.B0101_rmdup	3583079	3583093		YPO_RS17010	14
VEL003.B0101_rmdup	3584801	3584808		proA	7
VEL003.B0101_rmdup	3584916	3584929		proA	13
VEL003.B0101_rmdup	3590096	3590128		YPO_RS17045	32
VEL003.B0101_rmdup	3591793	3591794		YPO_RS17050	1
VEL003.B0101_rmdup	3592389	3592543		YPO_RS17055	154
VEL003.B0101_rmdup	3592662	3592668		YPO_RS17055	6
VEL003.B0101_rmdup	3592710	3592722		YPO_RS17055	12
VEL003.B0101_rmdup	3592852	3592914		YPO_RS17055	62
VEL003.B0101_rmdup	3593077	3593080		YPO_RS17055	3
VEL003.B0101_rmdup	3599086	3599096		YPO_RS17070	10
VEL003.B0101_rmdup	3599882	3599891		YPO_RS17080	9
VEL003.B0101_rmdup	3600014	3600040		YPO_RS17080	26
VEL003.B0101_rmdup	3600547	3600549		YPO_RS17080	2
VEL003.B0101_rmdup	3602972	3603012		YPO_RS17095	40
VEL003.B0101_rmdup	3611647	3611678		YPO_RS17130	31
VEL003.B0101_rmdup	3612309	3612313		YPO_RS17135	4
VEL003.B0101_rmdup	3612605	3612608		YPO_RS17135	3
VEL003.B0101_rmdup	3616598	3616599		YPO_RS17145	1
VEL003.B0101_rmdup	3616777	3616781		YPO_RS17145	4
VEL003.B0101_rmdup	3617427	3617431		YPO_RS17145	4
VEL003.B0101_rmdup	3618854	3618918		YPO_RS17145	64
VEL003.B0101_rmdup	3619142	3619180		YPO_RS17145	38
VEL003.B0101_rmdup	3619490	3619511		YPO_RS17145	21
VEL003.B0101_rmdup	3620701	3620730		YPO_RS17150	29
VEL003.B0101_rmdup	3623719	3623720		YPO_RS17160	1
VEL003.B0101_rmdup	3624205	3624218		YPO_RS17160	13
VEL003.B0101_rmdup	3627567	3627575		YPO_RS17180	8
VEL003.B0101_rmdup	3628769	3628784		YPO_RS17185	15
VEL003.B0101_rmdup	3629926	3629932		YPO_RS17195	6
VEL003.B0101_rmdup	3630524	3630538		YPO_RS17200	14
VEL003.B0101_rmdup	3632743	3632744		YPO_RS17215	1
VEL003.B0101_rmdup	3632846	3632874		YPO_RS17215	28
VEL003.B0101_rmdup	3633140	3633143		YPO_RS17215	3
VEL003.B0101_rmdup	3633593	3633605		YPO_RS17215	12
VEL003.B0101_rmdup	3633957	3633963		YPO_RS17215	6
VEL003.B0101_rmdup	3635280	3635315		YPO_RS17225	35
VEL003.B0101_rmdup	3637021	3637028		ygaH	7
VEL003.B0101_rmdup	3640458	3640469		emrB	11
VEL003.B0101_rmdup	3641046	3641053		emrB	7
VEL003.B0101_rmdup	3643342	3643356		YPO_RS17265	14
VEL003.B0101_rmdup	3644317	3644359		YPO_RS17270	42
VEL003.B0101_rmdup	3644391	3644401		YPO_RS17270	10
VEL003.B0101_rmdup	3645292	3645306		YPO_RS17270	14
VEL003.B0101_rmdup	3646227	3646240		YPO_RS17270	13
VEL003.B0101_rmdup	3647505	3647510		pssA	5
VEL003.B0101_rmdup	3655313	3655315		clpB	2
VEL003.B0101_rmdup	3657826	3657857		pgeF	31
VEL003.B0101_rmdup	3658569	3658593		rluD	24
VEL003.B0101_rmdup	3658837	3658845		rluD	8
VEL003.B0101_rmdup	3662821	3662822		YPO_RS17350	1
VEL003.B0101_rmdup	3664126	3664146		YPO_RS17355	20
VEL003.B0101_rmdup	3667445	3667449		yehT	4
VEL003.B0101_rmdup	3670474	3670488		YPO_RS17385	14
VEL003.B0101_rmdup	3671971	3671972		rplS	1
VEL003.B0101_rmdup	3672981	3673025		trmD	44
VEL003.B0101_rmdup	3674539	3674558		ffh	19
VEL003.B0101_rmdup	3674825	3674826		ffh	1
VEL003.B0101_rmdup	3674999	3675004		ffh	5
VEL003.B0101_rmdup	3675522	3675535		ffh	13
VEL003.B0101_rmdup	3680453	3680470		gshA	17
VEL003.B0101_rmdup	3682460	3682489		YPO_RS17460	29
VEL003.B0101_rmdup	3685851	3685855		alaS	4
VEL003.B0101_rmdup	3689547	3689554		YPO_RS17505	7
VEL003.B0101_rmdup	3693037	3693046		YPO_RS17515	9
VEL003.B0101_rmdup	3693749	3693755		YPO_RS17520	6
VEL003.B0101_rmdup	3695605	3695608		YPO_RS17525	3
VEL003.B0101_rmdup	3696536	3696556		YPO_RS17530	20
VEL003.B0101_rmdup	3697204	3697212		YPO_RS17535	8
VEL003.B0101_rmdup	3697548	3697554		YPO_RS17535	6
VEL003.B0101_rmdup	3698866	3698876		YPO_RS17540	10
VEL003.B0101_rmdup	3703948	3703949		katG	1
VEL003.B0101_rmdup	3704401	3704409		cybC	8
VEL003.B0101_rmdup	3704905	3704906		cybB	1
VEL003.B0101_rmdup	3705005	3705015		cybB	10
VEL003.B0101_rmdup	3705404	3705408		dmsD	4
VEL003.B0101_rmdup	3706426	3706453		YPO_RS17575	27
VEL003.B0101_rmdup	3709023	3709033		dmsA	10
VEL003.B0101_rmdup	3709609	3709611		dmsA	2
VEL003.B0101_rmdup	3709817	3709824		dmsA	7
VEL003.B0101_rmdup	3712125	3712138		YPO_RS17595	13
VEL003.B0101_rmdup	3715082	3715087		YPO_RS17610	5
VEL003.B0101_rmdup	3717132	3717136		YPO_RS17615	4
VEL003.B0101_rmdup	3717721	3717723		YPO_RS17620	2
VEL003.B0101_rmdup	3718659	3718661		YPO_RS17625	2
VEL003.B0101_rmdup	3720284	3720307		YPO_RS17630	23
VEL003.B0101_rmdup	3723969	3724000		map	31
VEL003.B0101_rmdup	3724864	3724869		YPO_RS17650	5
VEL003.B0101_rmdup	3725440	3725452		YPO_RS17650	12
VEL003.B0101_rmdup	3725672	3725679		YPO_RS17650	7
VEL003.B0101_rmdup	3728480	3728731		YPO_RS17660	251
VEL003.B0101_rmdup	3728968	3730347		YPO_RS17665	1379
VEL003.B0101_rmdup	3730418	3730766		YPO_RS17670	348
VEL003.B0101_rmdup	3731737	3731757		YPO_RS17675	20
VEL003.B0101_rmdup	3733599	3733602		arsB	3
VEL003.B0101_rmdup	3736311	3736314		dhaL	3
VEL003.B0101_rmdup	3736719	3736724		YPO_RS17705	5
VEL003.B0101_rmdup	3737913	3737915		YPO_RS17710	2
VEL003.B0101_rmdup	3742045	3742048		mutS	3
VEL003.B0101_rmdup	3745669	3745676		nlpD	7
VEL003.B0101_rmdup	3745714	3745734		nlpD	20
VEL003.B0101_rmdup	3745875	3745883		nlpD	8
VEL003.B0101_rmdup	3747641	3747647		surE	6
VEL003.B0101_rmdup	3748568	3748571		truD	3
VEL003.B0101_rmdup	3753544	3753551		cysD	7
VEL003.B0101_rmdup	3754597	3754603		cobA	6
VEL003.B0101_rmdup	3754685	3754694		cobA	9
VEL003.B0101_rmdup	3754887	3754905		cobA	18
VEL003.B0101_rmdup	3755289	3755304		cobA	15
VEL003.B0101_rmdup	3755700	3755717		cobA	17
VEL003.B0101_rmdup	3758768	3758776		cysI	8
VEL003.B0101_rmdup	3759249	3759260		cysI	11
VEL003.B0101_rmdup	3760423	3760461		cysJ	38
VEL003.B0101_rmdup	3764475	3764483		eno	8
VEL003.B0101_rmdup	3765815	3765821		pyrG	6
VEL003.B0101_rmdup	3768842	3768843		relA	1
VEL003.B0101_rmdup	3768932	3768941		relA	9
VEL003.B0101_rmdup	3769298	3769301		relA	3
VEL003.B0101_rmdup	3769635	3769639		relA	4
VEL003.B0101_rmdup	3773781	3773793		barA	12
VEL003.B0101_rmdup	3774353	3774388		degP	35
VEL003.B0101_rmdup	3775697	3775699		degP	2
VEL003.B0101_rmdup	3776677	3776703		dgt	26
VEL003.B0101_rmdup	3779275	3779288		btuF	13
VEL003.B0101_rmdup	3780849	3780853		clcA	4
VEL003.B0101_rmdup	3781176	3781202		clcA	26
VEL003.B0101_rmdup	3783772	3783774		hemL	2
VEL003.B0101_rmdup	3787393	3787398		fhuC	5
VEL003.B0101_rmdup	3791965	3791966		hrpB	1
VEL003.B0101_rmdup	3792013	3792019		hrpB	6
VEL003.B0101_rmdup	3793665	3793719		thpR	54
VEL003.B0101_rmdup	3793930	3793935		thpR	5
VEL003.B0101_rmdup	3794082	3794086		thpR	4
VEL003.B0101_rmdup	3796312	3796315		gluQRS	3
VEL003.B0101_rmdup	3797247	3797249		pcnB	2
VEL003.B0101_rmdup	3800161	3800174		panC	13
VEL003.B0101_rmdup	3801890	3801896		YPO_RS17990	6
VEL003.B0101_rmdup	3807005	3807007		cueO	2
VEL003.B0101_rmdup	3807384	3807408		cueO	24
VEL003.B0101_rmdup	3809510	3809515		speE	5
VEL003.B0101_rmdup	3809789	3809799		speE	10
VEL003.B0101_rmdup	3810573	3810580		speD	7
VEL003.B0101_rmdup	3812182	3812185		YPO_RS18035	3
VEL003.B0101_rmdup	3813556	3813558		acnB	2
VEL003.B0101_rmdup	3815543	3815550		acnB	7
VEL003.B0101_rmdup	3818758	3818771		aceF	13
VEL003.B0101_rmdup	3818818	3818833		aceF	15
VEL003.B0101_rmdup	3819254	3819256		aceF	2
VEL003.B0101_rmdup	3820040	3820051		aceF	11
VEL003.B0101_rmdup	3822235	3822238		aceE	3
VEL003.B0101_rmdup	3822833	3822834		aceE	1
VEL003.B0101_rmdup	3825563	3825566		YPO_RS18075	3
VEL003.B0101_rmdup	3826054	3826056		YPO_RS18075	2
VEL003.B0101_rmdup	3828208	3828217		ampD	9
VEL003.B0101_rmdup	3830235	3830240		gspE	5
VEL003.B0101_rmdup	3830759	3830767		gspE	8
VEL003.B0101_rmdup	3835038	3835057		coaE	19
VEL003.B0101_rmdup	3837041	3837050		YPO_RS18135	9
VEL003.B0101_rmdup	3838868	3838894		YPO_RS18145	26
VEL003.B0101_rmdup	3840208	3840209		YPO_RS18150	1
VEL003.B0101_rmdup	3841502	3841505		YPO_RS18150	3
VEL003.B0101_rmdup	3844105	3844138		lptG	33
VEL003.B0101_rmdup	3846721	3846742		pepA	21
VEL003.B0101_rmdup	3848870	3848917		YPO_RS18185	47
VEL003.B0101_rmdup	3849152	3849163		YPO_RS18185	11
VEL003.B0101_rmdup	3858577	3858585		YPO_RS18220	8
VEL003.B0101_rmdup	3859299	3859311		YPO_RS18225	12
VEL003.B0101_rmdup	3859729	3859744		YPO_RS18225	15
VEL003.B0101_rmdup	3862037	3862040		nrdD	3
VEL003.B0101_rmdup	3865283	3865287		phnH	4
VEL003.B0101_rmdup	3866191	3866214		YPO_RS18260	23
VEL003.B0101_rmdup	3866729	3866733		YPO_RS18260	4
VEL003.B0101_rmdup	3869146	3869162		phnL	16
VEL003.B0101_rmdup	3870498	3870511		phnM	13
VEL003.B0101_rmdup	3871811	3871815		phnP	4
VEL003.B0101_rmdup	3872312	3872319		YPO_RS18295	7
VEL003.B0101_rmdup	3873303	3873312		YPO_RS18300	9
VEL003.B0101_rmdup	3873703	3873709		YPO_RS18305	6
VEL003.B0101_rmdup	3874491	3874500		YPO_RS18305	9
VEL003.B0101_rmdup	3875363	3875374		ugpC	11
VEL003.B0101_rmdup	3877281	3877288		YPO_RS18320	7
VEL003.B0101_rmdup	3878170	3878174		YPO_RS18325	4
VEL003.B0101_rmdup	3879720	3879745		YPO_RS18330	25
VEL003.B0101_rmdup	3880637	3880644		YPO_RS18330	7
VEL003.B0101_rmdup	3881816	3881822		YPO_RS18335	6
VEL003.B0101_rmdup	3883526	3883530		YPO_RS18345	4
VEL003.B0101_rmdup	3887292	3887326		YPO_RS18365	34
VEL003.B0101_rmdup	3887990	3887993		YPO_RS18365	3
VEL003.B0101_rmdup	3888173	3888175		YPO_RS18365	2
VEL003.B0101_rmdup	3890661	3890688		YPO_RS18370	27
VEL003.B0101_rmdup	3896588	3896603		YPO_RS18400	15
VEL003.B0101_rmdup	3896880	3896883		YPO_RS18400	3
VEL003.B0101_rmdup	3898026	3898045		nlpI	19
VEL003.B0101_rmdup	3899873	3899904		pnp	31
VEL003.B0101_rmdup	3900897	3900902		YPO_RS18420	5
VEL003.B0101_rmdup	3901237	3901243		YPO_RS18420	6
VEL003.B0101_rmdup	3906267	3906268		infB	1
VEL003.B0101_rmdup	3906359	3906395		infB	36
VEL003.B0101_rmdup	3910025	3910036		glmM	11
VEL003.B0101_rmdup	3910974	3910980		glmM	6
VEL003.B0101_rmdup	3914189	3914203		rlmE	14
VEL003.B0101_rmdup	3917627	3917639		pmrA	12
VEL003.B0101_rmdup	3918263	3918264		pmrB	1
VEL003.B0101_rmdup	3918850	3918852		pmrB	2
VEL003.B0101_rmdup	3919258	3919267		pmrB	9
VEL003.B0101_rmdup	3920722	3920724		YPO_RS18520	2
VEL003.B0101_rmdup	3922701	3922767		ispB	66
VEL003.B0101_rmdup	3923424	3923442		ispB	18
VEL003.B0101_rmdup	3930386	3930389		ppa	3
VEL003.B0101_rmdup	3933718	3933719		YPO_RS18585	1
VEL003.B0101_rmdup	3934093	3934098		YPO_RS18585	5
VEL003.B0101_rmdup	3934289	3934315		YPO_RS18585	26
VEL003.B0101_rmdup	3934359	3934366		YPO_RS18585	7
VEL003.B0101_rmdup	3935206	3935211		YPO_RS18585	5
VEL003.B0101_rmdup	3935818	3935828		YPO_RS18590	10
VEL003.B0101_rmdup	3941145	3941164		cysQ	19
VEL003.B0101_rmdup	3946233	3946238		YPO_RS18635	5
VEL003.B0101_rmdup	3949792	3949810		yjfP	18
VEL003.B0101_rmdup	3956647	3956662		rsmI	15
VEL003.B0101_rmdup	3958528	3958529		YPO_RS18710	1
VEL003.B0101_rmdup	3960439	3960458		yraP	19
VEL003.B0101_rmdup	3962031	3962034		elbB	3
VEL003.B0101_rmdup	3963239	3963259		arcB	20
VEL003.B0101_rmdup	3963725	3963730		arcB	5
VEL003.B0101_rmdup	3967259	3967267		gltB	8
VEL003.B0101_rmdup	3971137	3971146		gltB	9
VEL003.B0101_rmdup	3971193	3971194		gltB	1
VEL003.B0101_rmdup	3971574	3971580		gltB	6
VEL003.B0101_rmdup	3972077	3972081		YPO_RS18755	4
VEL003.B0101_rmdup	3975596	3975601		YPO_RS18775	5
VEL003.B0101_rmdup	3976859	3976867		YPO_RS18790	8
VEL003.B0101_rmdup	3977837	3977867		YPO_RS18790	30
VEL003.B0101_rmdup	3981159	3981160		degS	1
VEL003.B0101_rmdup	3982865	3982871		murA	6
VEL003.B0101_rmdup	3984787	3984793		mlaC	6
VEL003.B0101_rmdup	3985082	3985084		mlaD	2
VEL003.B0101_rmdup	3989453	3989457		kdsD	4
VEL003.B0101_rmdup	3990484	3990510		kdsC	26
VEL003.B0101_rmdup	3991340	3991345		lptA	5
VEL003.B0101_rmdup	3992091	3992126		lptB	35
VEL003.B0101_rmdup	3992196	3992213		lptB	17
VEL003.B0101_rmdup	3993676	3993721		rpoN	45
VEL003.B0101_rmdup	3996113	3996128		npr	15
VEL003.B0101_rmdup	4000222	4000241		YPO_RS18925	19
VEL003.B0101_rmdup	4003117	4003123		tagH	6
VEL003.B0101_rmdup	4004952	4004954		tssK	2
VEL003.B0101_rmdup	4005330	4005332		tssK	2
VEL003.B0101_rmdup	4005945	4005954		tssK	9
VEL003.B0101_rmdup	4006705	4006710		YPO_RS18960	5
VEL003.B0101_rmdup	4006946	4006958		tssH	12
VEL003.B0101_rmdup	4008017	4008024		tssH	7
VEL003.B0101_rmdup	4008501	4008504		tssH	3
VEL003.B0101_rmdup	4010350	4010362		tagO	12
VEL003.B0101_rmdup	4011243	4011244		tssA	1
VEL003.B0101_rmdup	4011507	4011526		tssA	19
VEL003.B0101_rmdup	4011561	4011580		tssA	19
VEL003.B0101_rmdup	4011731	4011764		tssA	33
VEL003.B0101_rmdup	4016206	4016217		YPO_RS18990	11
VEL003.B0101_rmdup	4016321	4016338		YPO_RS18990	17
VEL003.B0101_rmdup	4016436	4016449		YPO_RS18990	13
VEL003.B0101_rmdup	4016613	4016627		YPO_RS18990	14
VEL003.B0101_rmdup	4016660	4016665		YPO_RS18990	5
VEL003.B0101_rmdup	4016900	4016902		YPO_RS18995	2
VEL003.B0101_rmdup	4016961	4016962		YPO_RS18995	1
VEL003.B0101_rmdup	4017823	4017867		YPO_RS19000	44
VEL003.B0101_rmdup	4018178	4018186		YPO_RS19000	8
VEL003.B0101_rmdup	4018693	4018707		YPO_RS19000	14
VEL003.B0101_rmdup	4019101	4019106		YPO_RS19000	5
VEL003.B0101_rmdup	4020342	4020371		YPO_RS19010	29
VEL003.B0101_rmdup	4022918	4022921		YPO_RS19010	3
VEL003.B0101_rmdup	4023133	4023182		YPO_RS19015	49
VEL003.B0101_rmdup	4023660	4023670		YPO_RS19015	10
VEL003.B0101_rmdup	4024557	4024566		YPO_RS19020	9
VEL003.B0101_rmdup	4026440	4026441		YPO_RS19045	1
VEL003.B0101_rmdup	4027116	4027117		YPO_RS19045	1
VEL003.B0101_rmdup	4027655	4027663		YPO_RS19045	8
VEL003.B0101_rmdup	4027886	4027913		YPO_RS19045	27
VEL003.B0101_rmdup	4029382	4029436		YPO_RS19055	54
VEL003.B0101_rmdup	4029538	4029563		YPO_RS19055	25
VEL003.B0101_rmdup	4030849	4030856		YPO_RS19055	7
VEL003.B0101_rmdup	4031888	4031929		YPO_RS19055	41
VEL003.B0101_rmdup	4031983	4032004		YPO_RS19055	21
VEL003.B0101_rmdup	4032112	4032113		YPO_RS19055	1
VEL003.B0101_rmdup	4032802	4032807		YPO_RS19055	5
VEL003.B0101_rmdup	4033648	4033711		YPO_RS19060	63
VEL003.B0101_rmdup	4033757	4033824		YPO_RS19060	67
VEL003.B0101_rmdup	4033958	4033968		YPO_RS19060	10
VEL003.B0101_rmdup	4034666	4034697		YPO_RS19065	31
VEL003.B0101_rmdup	4034936	4034939		YPO_RS19070	3
VEL003.B0101_rmdup	4038301	4038303		rbsD	2
VEL003.B0101_rmdup	4038875	4038883		YPO_RS19090	8
VEL003.B0101_rmdup	4039391	4039399		YPO_RS19090	8
VEL003.B0101_rmdup	4039451	4039463		YPO_RS19090	12
VEL003.B0101_rmdup	4040860	4040870		ssuE	10
VEL003.B0101_rmdup	4043095	4043108		ssuD	13
VEL003.B0101_rmdup	4043389	4043390		ssuD	1
VEL003.B0101_rmdup	4044885	4044904		ssuB	19
VEL003.B0101_rmdup	4046781	4046797		YPO_RS19135	16
VEL003.B0101_rmdup	4047559	4047561		YPO_RS19135	2
VEL003.B0101_rmdup	4048685	4048690		YPO_RS19140	5
VEL003.B0101_rmdup	4051873	4051887		lpxP	14
VEL003.B0101_rmdup	4055192	4055195		YPO_RS19160	3
VEL003.B0101_rmdup	4057581	4057584		YPO_RS19170	3
VEL003.B0101_rmdup	4063515	4063519		YPO_RS19195	4
VEL003.B0101_rmdup	4066487	4066500		YPO_RS19215	13
VEL003.B0101_rmdup	4068710	4068746		YPO_RS19225	36
VEL003.B0101_rmdup	4074039	4074053		dusB	14
VEL003.B0101_rmdup	4074214	4074217		dusB	3
VEL003.B0101_rmdup	4076456	4076473		panF	17
VEL003.B0101_rmdup	4077267	4077272		panF	5
VEL003.B0101_rmdup	4078603	4078618		YPO_RS19285	15
VEL003.B0101_rmdup	4078672	4078698		YPO_RS19285	26
VEL003.B0101_rmdup	4080642	4080688		accB	46
VEL003.B0101_rmdup	4082236	4082244		msrQ	8
VEL003.B0101_rmdup	4088923	4088925		mreC	2
VEL003.B0101_rmdup	4092226	4092228		YPO_RS19350	2
VEL003.B0101_rmdup	4092658	4092659		YPO_RS19350	1
VEL003.B0101_rmdup	4093798	4093799		YPO_RS19350	1
VEL003.B0101_rmdup	4094803	4094809		YPO_RS19350	6
VEL003.B0101_rmdup	4098413	4098423		tldD	10
VEL003.B0101_rmdup	4098633	4098682		YPO_RS19365	49
VEL003.B0101_rmdup	4098743	4098754		YPO_RS19365	11
VEL003.B0101_rmdup	4098803	4098823		YPO_RS19365	20
VEL003.B0101_rmdup	4098951	4098960		YPO_RS19365	9
VEL003.B0101_rmdup	4099026	4099030		YPO_RS19365	4
VEL003.B0101_rmdup	4099398	4099405		YPO_RS19365	7
VEL003.B0101_rmdup	4100288	4100291		YPO_RS19365	3
VEL003.B0101_rmdup	4101288	4101309		YPO_RS19365	21
VEL003.B0101_rmdup	4101664	4101679		YPO_RS19370	15
VEL003.B0101_rmdup	4101748	4101767		YPO_RS19370	19
VEL003.B0101_rmdup	4102141	4102147		YPO_RS19370	6
VEL003.B0101_rmdup	4104589	4104590		YPO_RS19375	1
VEL003.B0101_rmdup	4105096	4105109		YPO_RS19380	13
VEL003.B0101_rmdup	4106010	4106012		YPO_RS19390	2
VEL003.B0101_rmdup	4106393	4106418		YPO_RS19390	25
VEL003.B0101_rmdup	4107830	4107836		YPO_RS19390	6
VEL003.B0101_rmdup	4109201	4109237		YPO_RS19390	36
VEL003.B0101_rmdup	4109640	4109648		YPO_RS19390	8
VEL003.B0101_rmdup	4110041	4110056		YPO_RS19390	15
VEL003.B0101_rmdup	4110134	4110158		YPO_RS19390	24
VEL003.B0101_rmdup	4110926	4110931		YPO_RS19395	5
VEL003.B0101_rmdup	4112644	4112760		YPO_RS19400	116
VEL003.B0101_rmdup	4113273	4113329		YPO_RS19400	56
VEL003.B0101_rmdup	4113870	4113893		YPO_RS19400	23
VEL003.B0101_rmdup	4113988	4114076		YPO_RS19405	88
VEL003.B0101_rmdup	4115037	4115052		YPO_RS19405	15
VEL003.B0101_rmdup	4116732	4116748		YPO_RS19410	16
VEL003.B0101_rmdup	4116839	4116840		YPO_RS19410	1
VEL003.B0101_rmdup	4116995	4117009		YPO_RS19410	14
VEL003.B0101_rmdup	4117285	4117325		YPO_RS19410	40
VEL003.B0101_rmdup	4117507	4117535		YPO_RS19410	28
VEL003.B0101_rmdup	4118637	4118648		aaeR	11
VEL003.B0101_rmdup	4119549	4119559		aaeA	10
VEL003.B0101_rmdup	4119691	4119697		aaeA	6
VEL003.B0101_rmdup	4120069	4120071		aaeA	2
VEL003.B0101_rmdup	4120569	4120590		aaeB	21
VEL003.B0101_rmdup	4125073	4125095		YPO_RS19450	22
VEL003.B0101_rmdup	4125726	4125727		pmbA	1
VEL003.B0101_rmdup	4130840	4130848		treC	8
VEL003.B0101_rmdup	4131502	4131504		treB	2
VEL003.B0101_rmdup	4131726	4131736		treB	10
VEL003.B0101_rmdup	4133888	4133903		treR	15
VEL003.B0101_rmdup	4134241	4134255		YPO_RS19490	14
VEL003.B0101_rmdup	4136560	4136584		YPO_RS19500	24
VEL003.B0101_rmdup	4139857	4139867		tssC	10
VEL003.B0101_rmdup	4141134	4141159		tssB	25
VEL003.B0101_rmdup	4141474	4141476		tssB	2
VEL003.B0101_rmdup	4142040	4142050		YPO_RS19530	10
VEL003.B0101_rmdup	4142480	4142484		YPO_RS19530	4
VEL003.B0101_rmdup	4142772	4142793		YPO_RS19535	21
VEL003.B0101_rmdup	4147153	4147165		YPO_RS19555	12
VEL003.B0101_rmdup	4148082	4148091		malE	9
VEL003.B0101_rmdup	4148957	4148976		malE	19
VEL003.B0101_rmdup	4152040	4152059		psiE	19
VEL003.B0101_rmdup	4153754	4153763		pgi	9
VEL003.B0101_rmdup	4155123	4155132		lysC	9
VEL003.B0101_rmdup	4160191	4160198		YPO_RS19595	7
VEL003.B0101_rmdup	4160536	4160556		YPO_RS19595	20
VEL003.B0101_rmdup	4164095	4164098		metH	3
VEL003.B0101_rmdup	4165813	4165850		metH	37
VEL003.B0101_rmdup	4170415	4170416		aceA	1
VEL003.B0101_rmdup	4170975	4170981		aceA	6
VEL003.B0101_rmdup	4172054	4172068		aceB	14
VEL003.B0101_rmdup	4172134	4172135		aceB	1
VEL003.B0101_rmdup	4173691	4173696		metA	5
VEL003.B0101_rmdup	4176641	4176643		YPO_RS19645	2
VEL003.B0101_rmdup	4184213	4184214		YPO_RS19680	1
VEL003.B0101_rmdup	4184904	4184915		hupA	11
VEL003.B0101_rmdup	4186274	4186294		nfi	20
VEL003.B0101_rmdup	4186558	4186565		nfi	7
VEL003.B0101_rmdup	4186824	4186831		hemE	7
VEL003.B0101_rmdup	4187328	4187369		hemE	41
VEL003.B0101_rmdup	4188286	4188321		YPO_RS19705	35
VEL003.B0101_rmdup	4188599	4188615		YPO_RS19705	16
VEL003.B0101_rmdup	4192056	4192080		thiC	24
VEL003.B0101_rmdup	4192707	4192710		thiE	3
VEL003.B0101_rmdup	4194460	4194510		YPO_RS19740	50
VEL003.B0101_rmdup	4196164	4196172		thiH	8
VEL003.B0101_rmdup	4199705	4199708		rpoC	3
VEL003.B0101_rmdup	4199808	4199811		rpoC	3
VEL003.B0101_rmdup	4204359	4204362		rpoB	3
VEL003.B0101_rmdup	4206207	4206229		rplL	22
VEL003.B0101_rmdup	4208894	4208901		nusG	7
VEL003.B0101_rmdup	4213747	4213776		YPO_RS19825	29
VEL003.B0101_rmdup	4213921	4213925		YPO_RS19830	4
VEL003.B0101_rmdup	4216386	4216465		birA	79
VEL003.B0101_rmdup	4216594	4216606		birA	12
VEL003.B0101_rmdup	4216749	4216801		murB	52
VEL003.B0101_rmdup	4218454	4218456		YPO_RS19855	2
VEL003.B0101_rmdup	4219518	4219522		YPO_RS19855	4
VEL003.B0101_rmdup	4224290	4224300		hemG	10
VEL003.B0101_rmdup	4226757	4226758		YPO_RS19895	1
VEL003.B0101_rmdup	4226987	4226995		YPO_RS19900	8
VEL003.B0101_rmdup	4228308	4228324		pepQ	16
VEL003.B0101_rmdup	4230967	4230991		fadB	24
VEL003.B0101_rmdup	4231075	4231079		fadA	4
VEL003.B0101_rmdup	4231313	4231316		fadA	3
VEL003.B0101_rmdup	4232441	4232442		fre	1
VEL003.B0101_rmdup	4233324	4233338		ubiD	14
VEL003.B0101_rmdup	4233882	4233921		ubiD	39
VEL003.B0101_rmdup	4234122	4234127		ubiD	5
VEL003.B0101_rmdup	4235786	4235793		hemB	7
VEL003.B0101_rmdup	4237774	4237785		YPO_RS19950	11
VEL003.B0101_rmdup	4237964	4237978		YPO_RS19950	14
VEL003.B0101_rmdup	4238317	4238331		YPO_RS19950	14
VEL003.B0101_rmdup	4242457	4242465		ubiB	8
VEL003.B0101_rmdup	4242682	4242694		ubiB	12
VEL003.B0101_rmdup	4243392	4243412		YPO_RS19980	20
VEL003.B0101_rmdup	4243984	4243988		ubiE	4
VEL003.B0101_rmdup	4249580	4249581		YPO_RS20005	1
VEL003.B0101_rmdup	4250070	4250072		udp	2
VEL003.B0101_rmdup	4253165	4253192		metE	27
VEL003.B0101_rmdup	4253892	4253895		metE	3
VEL003.B0101_rmdup	4255400	4255404		metR	4
VEL003.B0101_rmdup	4255400	4255421		YPO_RS20030	21
VEL003.B0101_rmdup	4257934	4257951		ugpQ	17
VEL003.B0101_rmdup	4258489	4258490		YPO_RS20045	1
VEL003.B0101_rmdup	4259731	4259734		ugpE	3
VEL003.B0101_rmdup	4260410	4260430		ugpA	20
VEL003.B0101_rmdup	4261528	4261532		ugpB	4
VEL003.B0101_rmdup	4263354	4263363		YPO_RS20065	9
VEL003.B0101_rmdup	4263497	4263501		YPO_RS20065	4
VEL003.B0101_rmdup	4264087	4264145		YPO_RS20070	58
VEL003.B0101_rmdup	4265993	4265998		YPO_RS20070	5
VEL003.B0101_rmdup	4268313	4268321		YPO_RS20085	8
VEL003.B0101_rmdup	4268924	4268929		YPO_RS20090	5
VEL003.B0101_rmdup	4269432	4269433		YPO_RS20090	1
VEL003.B0101_rmdup	4269655	4269674		YPO_RS20095	19
VEL003.B0101_rmdup	4280214	4280219		ftsY	5
VEL003.B0101_rmdup	4280865	4280911		ftsY	46
VEL003.B0101_rmdup	4280945	4280947		ftsY	2
VEL003.B0101_rmdup	4281434	4281470		ftsY	36
VEL003.B0101_rmdup	4283022	4283027		YPO_RS20165	5
VEL003.B0101_rmdup	4284260	4284268		YPO_RS20175	8
VEL003.B0101_rmdup	4284323	4284327		YPO_RS20175	4
VEL003.B0101_rmdup	4286504	4286505		YPO_RS20180	1
VEL003.B0101_rmdup	4291919	4291920		glpB	1
VEL003.B0101_rmdup	4294539	4294571		glpQ	32
VEL003.B0101_rmdup	4297403	4297418		yigL	15
VEL003.B0101_rmdup	4298054	4298112		pldB	58
VEL003.B0101_rmdup	4300053	4300056		rhtC	3
VEL003.B0101_rmdup	4301992	4302006		recQ	14
VEL003.B0101_rmdup	4304728	4304758		rarD	30
VEL003.B0101_rmdup	4304790	4304862		rarD	72
VEL003.B0101_rmdup	4307642	4307656		YPO_RS20280	14
VEL003.B0101_rmdup	4308779	4308784		YPO_RS20280	5
VEL003.B0101_rmdup	4310100	4310109		uvrD	9
VEL003.B0101_rmdup	4310416	4310447		uvrD	31
VEL003.B0101_rmdup	4310981	4310983		uvrD	2
VEL003.B0101_rmdup	4312751	4312759		yigB	8
VEL003.B0101_rmdup	4313250	4313252		xerC	2
VEL003.B0101_rmdup	4313839	4313840		xerC	1
VEL003.B0101_rmdup	4314488	4314504		YPO_RS20305	16
VEL003.B0101_rmdup	4314610	4314618		YPO_RS20305	8
VEL003.B0101_rmdup	4315900	4315902		YPO_RS20315	2
VEL003.B0101_rmdup	4316716	4316723		YPO_RS20325	7
VEL003.B0101_rmdup	4318191	4318199		YPO_RS20325	8
VEL003.B0101_rmdup	4320244	4320252		hemC	8
VEL003.B0101_rmdup	4320632	4320639		hemD	7
VEL003.B0101_rmdup	4321407	4321417		hemX	10
VEL003.B0101_rmdup	4322971	4322986		hemY	15
VEL003.B0101_rmdup	4326384	4326395		YPO_RS20380	11
VEL003.B0101_rmdup	4328067	4328069		rffM	2
VEL003.B0101_rmdup	4328247	4328283		rffM	36
VEL003.B0101_rmdup	4328872	4328884		wzyE	12
VEL003.B0101_rmdup	4329847	4329868		wzyE	21
VEL003.B0101_rmdup	4330776	4330777		YPO_RS20395	1
VEL003.B0101_rmdup	4331674	4331691		wzxE	17
VEL003.B0101_rmdup	4332357	4332361		rffA	4
VEL003.B0101_rmdup	4336281	4336284		rffG	3
VEL003.B0101_rmdup	4338414	4338417		wecB	3
VEL003.B0101_rmdup	4339688	4339695		wzzE	7
VEL003.B0101_rmdup	4342092	4342098		rho	6
VEL003.B0101_rmdup	4344075	4344076		rhlB	1
VEL003.B0101_rmdup	4347583	4347586		rep	3
VEL003.B0101_rmdup	4349967	4350008		YPO_RS20480	41
VEL003.B0101_rmdup	4350711	4350714		YPO_RS20485	3
VEL003.B0101_rmdup	4351233	4351262		YPO_RS20485	29
VEL003.B0101_rmdup	4351714	4351740		YPO_RS20485	26
VEL003.B0101_rmdup	4353072	4353080		YPO_RS20490	8
VEL003.B0101_rmdup	4353937	4353940		YPO_RS20500	3
VEL003.B0101_rmdup	4353986	4353995		YPO_RS20500	9
VEL003.B0101_rmdup	4355596	4355608		YPO_RS20500	12
VEL003.B0101_rmdup	4355838	4355849		YPO_RS20500	11
VEL003.B0101_rmdup	4356307	4356310		YPO_RS20500	3
VEL003.B0101_rmdup	4358227	4358244		YPO_RS20510	17
VEL003.B0101_rmdup	4359333	4359384		YPO_RS20515	51
VEL003.B0101_rmdup	4359504	4359510		YPO_RS20515	6
VEL003.B0101_rmdup	4360198	4360239		YPO_RS20525	41
VEL003.B0101_rmdup	4360689	4360694		YPO_RS20530	5
VEL003.B0101_rmdup	4364594	4364596		ilvY	2
VEL003.B0101_rmdup	4366433	4366512		YPO_RS20560	79
VEL003.B0101_rmdup	4367948	4367953		YPO_RS20575	5
VEL003.B0101_rmdup	4368043	4368067		YPO_RS20575	24
VEL003.B0101_rmdup	4368343	4368345		YPO_RS20575	2
VEL003.B0101_rmdup	4369964	4369986		ilvA	22
VEL003.B0101_rmdup	4375250	4375251		ilvL	1
VEL003.B0101_rmdup	4375970	4375975		YPO_RS20610	5
VEL003.B0101_rmdup	4376218	4376239		YPO_RS20610	21
VEL003.B0101_rmdup	4376529	4376530		YPO_RS20610	1
VEL003.B0101_rmdup	4380524	4380537		YPO_RS20630	13
VEL003.B0101_rmdup	4380617	4380620		YPO_RS20630	3
VEL003.B0101_rmdup	4383083	4383096		YPO_RS20640	13
VEL003.B0101_rmdup	4384947	4384953		YPO_RS20660	6
VEL003.B0101_rmdup	4386004	4386008		YPO_RS20660	4
VEL003.B0101_rmdup	4390888	4390930		murI	42
VEL003.B0101_rmdup	4392675	4392693		btuB	18
VEL003.B0101_rmdup	4392880	4392898		btuB	18
VEL003.B0101_rmdup	4395570	4395571		fabR	1
VEL003.B0101_rmdup	4399284	4399289		YPO_RS20720	5
VEL003.B0101_rmdup	4400743	4400797		YPO_RS20725	54
VEL003.B0101_rmdup	4401536	4401546		YPO_RS20725	10
VEL003.B0101_rmdup	4402523	4402532		YPO_RS20730	9
VEL003.B0101_rmdup	4405292	4405295		YPO_RS20740	3
VEL003.B0101_rmdup	4408278	4408320		YPO_RS20745	42
VEL003.B0101_rmdup	4410686	4410717		argB	31
VEL003.B0101_rmdup	4411592	4411601		argC	9
VEL003.B0101_rmdup	4415975	4415977		ppc	2
VEL003.B0101_rmdup	4418869	4418892		YPO_RS20775	23
VEL003.B0101_rmdup	4421276	4421277		glpD	1
VEL003.B0101_rmdup	4421862	4421872		glpD	10
VEL003.B0101_rmdup	4423874	4423886		glgP	12
VEL003.B0101_rmdup	4425924	4425933		glgA	9
VEL003.B0101_rmdup	4428886	4428898		glgX	12
VEL003.B0101_rmdup	4430188	4430232		glgX	44
VEL003.B0101_rmdup	4433756	4433769		YPO_RS20825	13
VEL003.B0101_rmdup	4433903	4433918		YPO_RS20825	15
VEL003.B0101_rmdup	4435715	4435722		YPO_RS20830	7
VEL003.B0101_rmdup	4436503	4436511		YPO_RS20830	8
VEL003.B0101_rmdup	4437128	4437137		YPO_RS20830	9
VEL003.B0101_rmdup	4438324	4438332		YPO_RS20830	8
VEL003.B0101_rmdup	4439941	4439945		YPO_RS20830	4
VEL003.B0101_rmdup	4440306	4440340		YPO_RS20830	34
VEL003.B0101_rmdup	4440892	4440915		YPO_RS20830	23
VEL003.B0101_rmdup	4442881	4442899		YPO_RS20830	18
VEL003.B0101_rmdup	4443708	4443721		YPO_RS20830	13
VEL003.B0101_rmdup	4448914	4448933		YPO_RS20865	19
VEL003.B0101_rmdup	4452730	4452737		gntR	7
VEL003.B0101_rmdup	4453403	4453407		gntR	4
VEL003.B0101_rmdup	4454782	4454787		YPO_RS20900	5
VEL003.B0101_rmdup	4455645	4455711		YPO_RS20905	66
VEL003.B0101_rmdup	4456501	4456506		YPO_RS20910	5
VEL003.B0101_rmdup	4456754	4456778		YPO_RS20910	24
VEL003.B0101_rmdup	4456998	4457000		YPO_RS20910	2
VEL003.B0101_rmdup	4458382	4458393		YPO_RS20920	11
VEL003.B0101_rmdup	4458966	4458968		YPO_RS20925	2
VEL003.B0101_rmdup	4460006	4460011		YPO_RS20930	5
VEL003.B0101_rmdup	4460820	4460838		YPO_RS20930	18
VEL003.B0101_rmdup	4462707	4462752		YPO_RS20940	45
VEL003.B0101_rmdup	4464021	4464024		YPO_RS20940	3
VEL003.B0101_rmdup	4464430	4464441		YPO_RS20940	11
VEL003.B0101_rmdup	4464819	4464820		YPO_RS20940	1
VEL003.B0101_rmdup	4465424	4465452		YPO_RS20945	28
VEL003.B0101_rmdup	4472980	4472990		YPO_RS20975	10
VEL003.B0101_rmdup	4474328	4474331		rsmJ	3
VEL003.B0101_rmdup	4477138	4477141		YPO_RS20990	3
VEL003.B0101_rmdup	4477785	4477809		YPO_RS20990	24
VEL003.B0101_rmdup	4478409	4478431		gorA	22
VEL003.B0101_rmdup	4479333	4479336		gorA	3
VEL003.B0101_rmdup	4480264	4480268		YPO_RS21000	4
VEL003.B0101_rmdup	4480624	4480671		YPO_RS21000	47
VEL003.B0101_rmdup	4480652	4480671		YPO_RS21005	19
VEL003.B0101_rmdup	4481942	4481961		YPO_RS21010	19
VEL003.B0101_rmdup	4482558	4482564		YPO_RS21015	6
VEL003.B0101_rmdup	4483112	4483133		YPO_RS21015	21
VEL003.B0101_rmdup	4483603	4483701		YPO_RS21020	98
VEL003.B0101_rmdup	4483767	4483817		YPO_RS21020	50
VEL003.B0101_rmdup	4484438	4484484		YPO_RS21025	46
VEL003.B0101_rmdup	4484947	4485013		YPO_RS21030	66
VEL003.B0101_rmdup	4485114	4485120		YPO_RS21030	6
VEL003.B0101_rmdup	4487794	4487797		yapE	3
VEL003.B0101_rmdup	4491397	4491429		YPO_RS21050	32
VEL003.B0101_rmdup	4491526	4491549		YPO_RS21050	23
VEL003.B0101_rmdup	4491846	4491862		YPO_RS21050	16
VEL003.B0101_rmdup	4495719	4495721		YPO_RS21065	2
VEL003.B0101_rmdup	4498604	4498608		YPO_RS21075	4
VEL003.B0101_rmdup	4500832	4500842		YPO_RS21085	10
VEL003.B0101_rmdup	4503364	4503366		YPO_RS21090	2
VEL003.B0101_rmdup	4509161	4509163		dppD	2
VEL003.B0101_rmdup	4514647	4514650		YPO_RS21135	3
VEL003.B0101_rmdup	4515982	4515994		YPO_RS21140	12
VEL003.B0101_rmdup	4516097	4516103		YPO_RS21140	6
VEL003.B0101_rmdup	4516756	4516825		YPO_RS21140	69
VEL003.B0101_rmdup	4517272	4517345		YPO_RS21140	73
VEL003.B0101_rmdup	4519671	4519712		YPO_RS21155	41
VEL003.B0101_rmdup	4520786	4520794		YPO_RS21160	8
VEL003.B0101_rmdup	4521245	4521247		YPO_RS21165	2
VEL003.B0101_rmdup	4525072	4525078		eptB	6
VEL003.B0101_rmdup	4530449	4530463		hutH	14
VEL003.B0101_rmdup	4533443	4533448		YPO_RS21205	5
VEL003.B0101_rmdup	4533882	4533895		YPO_RS21205	13
VEL003.B0101_rmdup	4534817	4534875		YPO_RS21210	58
VEL003.B0101_rmdup	4535158	4535173		YPO_RS21215	15
VEL003.B0101_rmdup	4535568	4535573		YPO_RS21215	5
VEL003.B0101_rmdup	4536728	4536737		YPO_RS21220	9
VEL003.B0101_rmdup	4540481	4540488		YPO_RS21235	7
VEL003.B0101_rmdup	4545619	4545629		YPO_RS21280	10
VEL003.B0101_rmdup	4545793	4545831		YPO_RS21280	38
VEL003.B0101_rmdup	4546302	4546338		YPO_RS21280	36
VEL003.B0101_rmdup	4555582	4555583		xylB	1
VEL003.B0101_rmdup	4555995	4556002		xylB	7
VEL003.B0101_rmdup	4558124	4558137		YPO_RS21330	13
VEL003.B0101_rmdup	4558561	4558569		YPO_RS21330	8
VEL003.B0101_rmdup	4561515	4561541		YPO_RS21340	26
VEL003.B0101_rmdup	4561589	4561603		YPO_RS21340	14
VEL003.B0101_rmdup	4564759	4564789		YPO_RS21355	30
VEL003.B0101_rmdup	4565396	4565424		YPO_RS21355	28
VEL003.B0101_rmdup	4566123	4566135		YPO_RS21360	12
VEL003.B0101_rmdup	4568479	4568486		YPO_RS21380	7
VEL003.B0101_rmdup	4570190	4570203		selB	13
VEL003.B0101_rmdup	4572573	4572581		YPO_RS21400	8
VEL003.B0101_rmdup	4573188	4573192		fdhE	4
VEL003.B0101_rmdup	4573438	4573447		fdhE	9
VEL003.B0101_rmdup	4573732	4573747		fdhE	15
VEL003.B0101_rmdup	4575003	4575041		fdxH	38
VEL003.B0101_rmdup	4578236	4578243		fdnG	7
VEL003.B0101_rmdup	4581251	4581263		YPO_RS21435	12
VEL003.B0101_rmdup	4582571	4582577		YPO_RS21435	6
VEL003.B0101_rmdup	4585021	4585038		YPO_RS21450	17
VEL003.B0101_rmdup	4586395	4586402		YPO_RS21460	7
VEL003.B0101_rmdup	4588257	4588258		YPO_RS21465	1
VEL003.B0101_rmdup	4588269	4588270		YPO_RS21465	1
VEL003.B0101_rmdup	4589151	4589161		YPO_RS21465	10
VEL003.B0101_rmdup	4593627	4593642		glyQ	15
VEL003.B0101_rmdup	4594947	4594954		YPO_RS21490	7
VEL003.B0101_rmdup	4596320	4596369		YPO_RS21500	49
VEL003.B0101_rmdup	4596414	4596453		YPO_RS21500	39
VEL003.B0101_rmdup	4597185	4597189		YPO_RS21505	4
VEL003.B0101_rmdup	4599770	4599771		YPO_RS21515	1
VEL003.B0101_rmdup	4601649	4601721		YPO_RS21520	72
VEL003.B0101_rmdup	4601897	4601909		YPO_RS21520	12
VEL003.B0101_rmdup	4602003	4602037		YPO_RS21520	34
VEL003.B0101_rmdup	4603996	4604005		YPO_RS21530	9
VEL003.B0101_rmdup	4609278	4609289		YPO_RS21555	11
VEL003.B0101_rmdup	4612094	4612096		YPO_RS21565	2
VEL003.B0101_rmdup	4612519	4612562		yidA	43
VEL003.B0101_rmdup	4614248	4614264		gyrB	16
VEL003.B0101_rmdup	4616188	4616227		recF	39
VEL003.B0101_rmdup	4617474	4617478		dnaN	4
VEL003.B0101_rmdup	4623779	4623788		mnmE	9
VEL003.B0101_rmdup	4624657	4624672		YPO_RS21620	15
VEL003.B0101_rmdup	4625276	4625302		YPO_RS21620	26
VEL003.B0101_rmdup	4625893	4625898		YPO_RS21625	5
VEL003.B0101_rmdup	4626233	4626310		YPO_RS21630	77
VEL003.B0101_rmdup	4627805	4627828		YPO_RS21640	23
VEL003.B0101_rmdup	4633472	4633503		YPO_RS21670	31
VEL003.B0101_rmdup	4634565	4634577		phoU	12
VEL003.B0101_rmdup	4635321	4635328		pstB	7
VEL003.B0101_rmdup	4646969	4646984		atpA	15
VEL003.B0101_rmdup	4647315	4647329		atpA	14
VEL003.B0101_rmdup	4648569	4648586		atpF	17
VEL003.B0101_rmdup	4649940	4649942		atpI	2
VEL003.B0101_rmdup	4651576	4651579		rsmG	3
VEL003.B0101_rmdup	4652829	4652833		mnmG	4
VLI092.A0101_rmdup	4020	4064		ravA	44
VLI092.A0101_rmdup	14915	14918		YPO_RS01080	3
VLI092.A0101_rmdup	19639	19660		mobB	21
VLI092.A0101_rmdup	73926	73930		envC	4
VLI092.A0101_rmdup	106581	106586		YPO_RS01520	5
VLI092.A0101_rmdup	116441	116446		cytR	5
VLI092.A0101_rmdup	135779	135784		malP	5
VLI092.A0101_rmdup	196663	196665		YPO_RS01895	2
VLI092.A0101_rmdup	197737	197743		YPO_RS01900	6
VLI092.A0101_rmdup	232788	232795		rpsM	7
VLI092.A0101_rmdup	315087	315103		yapK	16
VLI092.A0101_rmdup	342219	342226		rhaR	7
VLI092.A0101_rmdup	345943	345958		YPO_RS02695	15
VLI092.A0101_rmdup	373617	373627		mscM	10
VLI092.A0101_rmdup	387199	387210		miaA	11
VLI092.A0101_rmdup	407810	407826		YPO_RS02955	16
VLI092.A0101_rmdup	409424	409426		YPO_RS02960	2
VLI092.A0101_rmdup	409614	409634		YPO_RS02965	20
VLI092.A0101_rmdup	409689	409697		YPO_RS02965	8
VLI092.A0101_rmdup	410841	410891		YPO_RS02965	50
VLI092.A0101_rmdup	431293	431335		YPO_RS03065	42
VLI092.A0101_rmdup	446217	446219		YPO_RS03120	2
VLI092.A0101_rmdup	493535	493548		YPO_RS03325	13
VLI092.A0101_rmdup	495031	495058		YPO_RS03330	27
VLI092.A0101_rmdup	495256	495319		YPO_RS03330	63
VLI092.A0101_rmdup	495730	495787		YPO_RS03330	57
VLI092.A0101_rmdup	495870	495919		YPO_RS03330	49
VLI092.A0101_rmdup	540258	540259		tssH	1
VLI092.A0101_rmdup	562655	562664		YPO_RS03600	9
VLI092.A0101_rmdup	573991	573993		leuD	2
VLI092.A0101_rmdup	650186	650187		cdiA	1
VLI092.A0101_rmdup	656701	656702		cdiA	1
VLI092.A0101_rmdup	660129	660162		YPO_RS04005	33
VLI092.A0101_rmdup	708564	708575		YPO_RS04230	11
VLI092.A0101_rmdup	731253	731254		parC	1
VLI092.A0101_rmdup	743617	743639		metC	22
VLI092.A0101_rmdup	749634	749636		YPO_RS04405	2
VLI092.A0101_rmdup	749634	749636		YPO_RS04410	2
VLI092.A0101_rmdup	750219	750244		YPO_RS04410	25
VLI092.A0101_rmdup	750492	750539		YPO_RS04415	47
VLI092.A0101_rmdup	751029	751103		YPO_RS04415	74
VLI092.A0101_rmdup	752607	752612		YPO_RS04420	5
VLI092.A0101_rmdup	753734	753747		YPO_RS04425	13
VLI092.A0101_rmdup	755318	755372		YPO_RS04440	54
VLI092.A0101_rmdup	755369	755382		YPO_RS04445	13
VLI092.A0101_rmdup	755570	755581		YPO_RS04445	11
VLI092.A0101_rmdup	758458	758464		YPO_RS04465	6
VLI092.A0101_rmdup	772966	772967		YPO_RS04525	1
VLI092.A0101_rmdup	785299	785333		YPO_RS04600	34
VLI092.A0101_rmdup	796055	796089		YPO_RS04660	34
VLI092.A0101_rmdup	803234	803245		YPO_RS04695	11
VLI092.A0101_rmdup	804378	804379		YPO_RS04700	1
VLI092.A0101_rmdup	806687	806688		YPO_RS04715	1
VLI092.A0101_rmdup	807629	807696		YPO_RS04720	67
VLI092.A0101_rmdup	807690	807696		YPO_RS04725	6
VLI092.A0101_rmdup	808994	808996		YPO_RS04735	2
VLI092.A0101_rmdup	809186	809227		YPO_RS04735	41
VLI092.A0101_rmdup	816730	816731		YPO_RS04765	1
VLI092.A0101_rmdup	838397	838404		YPO_RS04810	7
VLI092.A0101_rmdup	838884	838910		YPO_RS04815	26
VLI092.A0101_rmdup	842073	842075		YPO_RS04830	2
VLI092.A0101_rmdup	843450	843452		YPO_RS04835	2
VLI092.A0101_rmdup	845404	845624		YPO_RS04835	220
VLI092.A0101_rmdup	884321	884368		YPO_RS04965	47
VLI092.A0101_rmdup	884454	884465		YPO_RS04965	11
VLI092.A0101_rmdup	885676	885689		YPO_RS04975	13
VLI092.A0101_rmdup	886598	886674		YPO_RS04980	76
VLI092.A0101_rmdup	888107	888209		YPO_RS04990	102
VLI092.A0101_rmdup	889938	889970		gspI	32
VLI092.A0101_rmdup	893762	893817		gspD	55
VLI092.A0101_rmdup	895454	895477		gspD	23
VLI092.A0101_rmdup	895537	895539		gspD	2
VLI092.A0101_rmdup	895698	895709		YPO_RS05030	11
VLI092.A0101_rmdup	896431	896441		YPO_RS05035	10
VLI092.A0101_rmdup	908120	908125		tnpA	5
VLI092.A0101_rmdup	940529	940549		YPO_RS05205	20
VLI092.A0101_rmdup	950158	950159		YPO_RS05235	1
VLI092.A0101_rmdup	953701	953780		YPO_RS05260	79
VLI092.A0101_rmdup	963548	963555		YPO_RS05310	7
VLI092.A0101_rmdup	997024	997027		ubiI	3
VLI092.A0101_rmdup	1038767	1038779		YPO_RS05675	12
VLI092.A0101_rmdup	1042875	1042879		YPO_RS05675	4
VLI092.A0101_rmdup	1043932	1043964		YPO_RS05675	32
VLI092.A0101_rmdup	1044473	1044492		YPO_RS05675	19
VLI092.A0101_rmdup	1044625	1044645		YPO_RS05675	20
VLI092.A0101_rmdup	1045031	1045040		YPO_RS05675	9
VLI092.A0101_rmdup	1045528	1045588		YPO_RS05675	60
VLI092.A0101_rmdup	1046699	1046717		YPO_RS05675	18
VLI092.A0101_rmdup	1053169	1053172		mltC	3
VLI092.A0101_rmdup	1066994	1066995		YPO_RS05765	1
VLI092.A0101_rmdup	1067324	1067383		YPO_RS05765	59
VLI092.A0101_rmdup	1067376	1067383		YPO_RS05770	7
VLI092.A0101_rmdup	1068151	1068166		YPO_RS05770	15
VLI092.A0101_rmdup	1073119	1073123		YPO_RS05795	4
VLI092.A0101_rmdup	1089072	1089082		YPO_RS05845	10
VLI092.A0101_rmdup	1095849	1095856		YPO_RS05870	7
VLI092.A0101_rmdup	1116986	1116991		YPO_RS05940	5
VLI092.A0101_rmdup	1117066	1117097		YPO_RS05940	31
VLI092.A0101_rmdup	1117287	1117316		YPO_RS05940	29
VLI092.A0101_rmdup	1154161	1154165		ptrA	4
VLI092.A0101_rmdup	1166424	1166432		mltA	8
VLI092.A0101_rmdup	1220119	1220121		YPO_RS06340	2
VLI092.A0101_rmdup	1221219	1221220		YPO_RS06340	1
VLI092.A0101_rmdup	1221601	1221608		YPO_RS06340	7
VLI092.A0101_rmdup	1232287	1232292		YPO_RS06405	5
VLI092.A0101_rmdup	1237299	1237305		YPO_RS06440	6
VLI092.A0101_rmdup	1241050	1241121		YPO_RS06465	71
VLI092.A0101_rmdup	1241535	1241542		YPO_RS06465	7
VLI092.A0101_rmdup	1242011	1242034		YPO_RS06465	23
VLI092.A0101_rmdup	1258792	1258797		sucA	5
VLI092.A0101_rmdup	1269589	1269644		tolA	55
VLI092.A0101_rmdup	1272112	1272116		cpoB	4
VLI092.A0101_rmdup	1315928	1315940		YPO_RS06845	12
VLI092.A0101_rmdup	1322386	1322405		YPO_RS06875	19
VLI092.A0101_rmdup	1331059	1331076		phnC	17
VLI092.A0101_rmdup	1385457	1385469		ampH	12
VLI092.A0101_rmdup	1449833	1449835		YPO_RS07435	2
VLI092.A0101_rmdup	1451360	1451364		xylB	4
VLI092.A0101_rmdup	1463379	1463409		YPO_RS07500	30
VLI092.A0101_rmdup	1477015	1477021		YPO_RS07545	6
VLI092.A0101_rmdup	1505626	1505634		YPO_RS07680	8
VLI092.A0101_rmdup	1539713	1539726		aat	13
VLI092.A0101_rmdup	1565994	1566006		YPO_RS07925	12
VLI092.A0101_rmdup	1566377	1566387		YPO_RS07930	10
VLI092.A0101_rmdup	1567736	1567755		YPO_RS07930	19
VLI092.A0101_rmdup	1632397	1632410		YPO_RS08185	13
VLI092.A0101_rmdup	1646383	1646385		YPO_RS08250	2
VLI092.A0101_rmdup	1647598	1647647		YPO_RS08260	49
VLI092.A0101_rmdup	1653813	1653843		YPO_RS08295	30
VLI092.A0101_rmdup	1661200	1661201		YPO_RS08330	1
VLI092.A0101_rmdup	1661809	1661813		YPO_RS08330	4
VLI092.A0101_rmdup	1668237	1668238		YPO_RS08350	1
VLI092.A0101_rmdup	1670473	1670534		YPO_RS08355	61
VLI092.A0101_rmdup	1673354	1673364		YPO_RS08365	10
VLI092.A0101_rmdup	1673831	1673845		YPO_RS08365	14
VLI092.A0101_rmdup	1684057	1684158		YPO_RS08400	101
VLI092.A0101_rmdup	1690316	1690334		YPO_RS08430	18
VLI092.A0101_rmdup	1690444	1690458		YPO_RS08430	14
VLI092.A0101_rmdup	1692041	1692045		YPO_RS08435	4
VLI092.A0101_rmdup	1698666	1698676		darE	10
VLI092.A0101_rmdup	1700030	1700040		darC	10
VLI092.A0101_rmdup	1700301	1700309		darC	8
VLI092.A0101_rmdup	1701135	1701142		darC	7
VLI092.A0101_rmdup	1706496	1706524		YPO_RS08495	28
VLI092.A0101_rmdup	1722689	1722692		YPO_RS08560	3
VLI092.A0101_rmdup	1725932	1725948		YPO_RS08570	16
VLI092.A0101_rmdup	1796154	1796155		YPO_RS08855	1
VLI092.A0101_rmdup	1808278	1808308		bssS	30
VLI092.A0101_rmdup	1878315	1878350		YPO_RS09250	35
VLI092.A0101_rmdup	1904870	1904871		yapJ	1
VLI092.A0101_rmdup	1933837	1933857		YPO_RS09455	20
VLI092.A0101_rmdup	1999858	1999870		mntP	12
VLI092.A0101_rmdup	2000350	2000371		YPO_RS09760	21
VLI092.A0101_rmdup	2060366	2060369		YPO_RS10045	3
VLI092.A0101_rmdup	2062931	2062937		YPO_RS10055	6
VLI092.A0101_rmdup	2070471	2070473		YPO_RS10110	2
VLI092.A0101_rmdup	2090847	2090851		YPO_RS10210	4
VLI092.A0101_rmdup	2117713	2117784		YPO_RS10355	71
VLI092.A0101_rmdup	2118023	2118032		hcp	9
VLI092.A0101_rmdup	2126762	2126796		YPO_RS10420	34
VLI092.A0101_rmdup	2148605	2148609		irp1	4
VLI092.A0101_rmdup	2150876	2150882		irp1	6
VLI092.A0101_rmdup	2159339	2159340		irp2	1
VLI092.A0101_rmdup	2166015	2166017		ybtQ	2
VLI092.A0101_rmdup	2183699	2183707		YPO_RS10620	8
VLI092.A0101_rmdup	2207450	2207457		YPO_RS10715	7
VLI092.A0101_rmdup	2237356	2237377		YPO_RS10835	21
VLI092.A0101_rmdup	2250017	2250018		YPO_RS10895	1
VLI092.A0101_rmdup	2258636	2258644		YPO_RS10935	8
VLI092.A0101_rmdup	2265708	2265714		YPO_RS10955	6
VLI092.A0101_rmdup	2269863	2269871		YPO_RS10980	8
VLI092.A0101_rmdup	2277257	2277284		YPO_RS11015	27
VLI092.A0101_rmdup	2300020	2300030		YPO_RS11135	10
VLI092.A0101_rmdup	2300849	2300866		YPO_RS11140	17
VLI092.A0101_rmdup	2306895	2306902		YPO_RS11175	7
VLI092.A0101_rmdup	2316455	2316461		YPO_RS11220	6
VLI092.A0101_rmdup	2316501	2316506		YPO_RS11220	5
VLI092.A0101_rmdup	2317372	2317387		YPO_RS11220	15
VLI092.A0101_rmdup	2318145	2318164		YPO_RS11225	19
VLI092.A0101_rmdup	2319540	2319543		YPO_RS11225	3
VLI092.A0101_rmdup	2328463	2328464		cmoA	1
VLI092.A0101_rmdup	2340702	2340706		mepM	4
VLI092.A0101_rmdup	2376963	2376967		YPO_RS11520	4
VLI092.A0101_rmdup	2400848	2400849		YPO_RS11665	1
VLI092.A0101_rmdup	2418597	2418598		YPO_RS11735	1
VLI092.A0101_rmdup	2439728	2439776		YPO_RS11830	48
VLI092.A0101_rmdup	2439926	2439931		YPO_RS11830	5
VLI092.A0101_rmdup	2442368	2442377		purU	9
VLI092.A0101_rmdup	2445266	2445281		rssB	15
VLI092.A0101_rmdup	2454810	2454812		adhE	2
VLI092.A0101_rmdup	2489417	2489421		sohB	4
VLI092.A0101_rmdup	2491168	2491216		topA	48
VLI092.A0101_rmdup	2495379	2495389		YPO_RS12105	10
VLI092.A0101_rmdup	2495433	2495436		YPO_RS12105	3
VLI092.A0101_rmdup	2503061	2503075		YPO_RS12135	14
VLI092.A0101_rmdup	2519275	2519296		YPO_RS12215	21
VLI092.A0101_rmdup	2521119	2521120		rsxC	1
VLI092.A0101_rmdup	2535709	2535712		YPO_RS12275	3
VLI092.A0101_rmdup	2536870	2536872		YPO_RS12280	2
VLI092.A0101_rmdup	2548345	2548348		YPO_RS12325	3
VLI092.A0101_rmdup	2549502	2549515		YPO_RS12330	13
VLI092.A0101_rmdup	2554373	2554633		YPO_RS12355	260
VLI092.A0101_rmdup	2554658	2555065		YPO_RS12360	407
VLI092.A0101_rmdup	2555162	2555608		YPO_RS12365	446
VLI092.A0101_rmdup	2555780	2556832		YPO_RS12370	1052
VLI092.A0101_rmdup	2556844	2557161		YPO_RS12375	317
VLI092.A0101_rmdup	2557164	2557415		YPO_RS12380	251
VLI092.A0101_rmdup	2557451	2557684		YPO_RS12385	233
VLI092.A0101_rmdup	2557749	2559461		YPO_RS12390	1712
VLI092.A0101_rmdup	2559474	2559761		YPO_RS12395	287
VLI092.A0101_rmdup	2559765	2560790		YPO_RS12400	1025
VLI092.A0101_rmdup	2560790	2562034		YPO_RS12405	1244
VLI092.A0101_rmdup	2562123	2562371		YPO_RS12410	248
VLI092.A0101_rmdup	2562568	2562765		YPO_RS12415	197
VLI092.A0101_rmdup	2565808	2565838		YPO_RS12435	30
VLI092.A0101_rmdup	2606362	2606376		asr	14
VLI092.A0101_rmdup	2630107	2630112		YPO_RS12680	5
VLI092.A0101_rmdup	2694630	2694631		YPO_RS13000	1
VLI092.A0101_rmdup	2716632	2716640		arnF	8
VLI092.A0101_rmdup	2716945	2716949		arnF	4
VLI092.A0101_rmdup	2717999	2718004		arnT	5
VLI092.A0101_rmdup	2748808	2748834		YPO_RS13255	26
VLI092.A0101_rmdup	2754131	2754169		YPO_RS13285	38
VLI092.A0101_rmdup	2763981	2763983		csy1	2
VLI092.A0101_rmdup	2785301	2785312		YPO_RS13415	11
VLI092.A0101_rmdup	2796560	2796585		cdiA	25
VLI092.A0101_rmdup	2802567	2802578		YPO_RS13470	11
VLI092.A0101_rmdup	2813943	2813981		YPO_RS13510	38
VLI092.A0101_rmdup	2814142	2814150		YPO_RS13510	8
VLI092.A0101_rmdup	2831190	2831227		ybiB	37
VLI092.A0101_rmdup	2845095	2845103		YPO_RS13655	8
VLI092.A0101_rmdup	2853927	2853944		YPO_RS13690	17
VLI092.A0101_rmdup	2885771	2885776		YPO_RS13815	5
VLI092.A0101_rmdup	2910276	2910290		iolB	14
VLI092.A0101_rmdup	2922470	2922473		dacA	3
VLI092.A0101_rmdup	2980428	2980564		YPO_RS14235	136
VLI092.A0101_rmdup	2983548	2983556		YPO_RS14250	8
VLI092.A0101_rmdup	3012183	3012220		YPO_RS14405	37
VLI092.A0101_rmdup	3017900	3017901		kdpB	1
VLI092.A0101_rmdup	3021133	3021147		YPO_RS14440	14
VLI092.A0101_rmdup	3037256	3037264		YPO_RS14530	8
VLI092.A0101_rmdup	3042589	3042595		YPO_RS14560	6
VLI092.A0101_rmdup	3050880	3050885		tssL	5
VLI092.A0101_rmdup	3078870	3078871		fadJ	1
VLI092.A0101_rmdup	3114638	3114642		yfcE	4
VLI092.A0101_rmdup	3121234	3121247		YPO_RS14925	13
VLI092.A0101_rmdup	3121613	3121638		YPO_RS14925	25
VLI092.A0101_rmdup	3123953	3123977		YPO_RS14945	24
VLI092.A0101_rmdup	3127185	3127214		YPO_RS14960	29
VLI092.A0101_rmdup	3197564	3197577		YPO_RS15265	13
VLI092.A0101_rmdup	3197868	3197871		YPO_RS15265	3
VLI092.A0101_rmdup	3200346	3200432		YPO_RS15285	86
VLI092.A0101_rmdup	3200732	3200904		YPO_RS15290	172
VLI092.A0101_rmdup	3201040	3201046		YPO_RS15290	6
VLI092.A0101_rmdup	3201162	3201167		YPO_RS15295	5
VLI092.A0101_rmdup	3201317	3201325		YPO_RS15295	8
VLI092.A0101_rmdup	3201597	3201702		YPO_RS15300	105
VLI092.A0101_rmdup	3202251	3202261		YPO_RS15305	10
VLI092.A0101_rmdup	3221810	3221860		YPO_RS15385	50
VLI092.A0101_rmdup	3222644	3222651		YPO_RS15385	7
VLI092.A0101_rmdup	3236973	3236975		hscA	2
VLI092.A0101_rmdup	3260335	3260364		YPO_RS15550	29
VLI092.A0101_rmdup	3262866	3262898		YPO_RS15560	32
VLI092.A0101_rmdup	3284501	3284506		YPO_RS15665	5
VLI092.A0101_rmdup	3285808	3285813		YPO_RS15675	5
VLI092.A0101_rmdup	3297936	3297944		YPO_RS15715	8
VLI092.A0101_rmdup	3311458	3311472		YPO_RS15770	14
VLI092.A0101_rmdup	3320265	3320272		YPO_RS15810	7
VLI092.A0101_rmdup	3331648	3331662		YPO_RS15865	14
VLI092.A0101_rmdup	3355113	3355117		YPO_RS16000	4
VLI092.A0101_rmdup	3363728	3363772		YPO_RS16040	44
VLI092.A0101_rmdup	3363815	3363819		YPO_RS16040	4
VLI092.A0101_rmdup	3364218	3364225		YPO_RS16040	7
VLI092.A0101_rmdup	3364733	3364737		YPO_RS16040	4
VLI092.A0101_rmdup	3383583	3383586		YPO_RS16125	3
VLI092.A0101_rmdup	3405638	3405657		YPO_RS16220	19
VLI092.A0101_rmdup	3422115	3422123		YPO_RS16305	8
VLI092.A0101_rmdup	3454809	3454861		fepE	52
VLI092.A0101_rmdup	3455907	3455934		cpsG	27
VLI092.A0101_rmdup	3456585	3456607		YPO_RS16450	22
VLI092.A0101_rmdup	3457108	3457111		YPO_RS16450	3
VLI092.A0101_rmdup	3461853	3461854		YPO_RS16470	1
VLI092.A0101_rmdup	3463323	3463334		YPO_RS16480	11
VLI092.A0101_rmdup	3463461	3463474		YPO_RS16480	13
VLI092.A0101_rmdup	3463749	3463813		YPO_RS16480	64
VLI092.A0101_rmdup	3463879	3463956		YPO_RS16480	77
VLI092.A0101_rmdup	3464134	3464167		YPO_RS16480	33
VLI092.A0101_rmdup	3464843	3464873		YPO_RS16485	30
VLI092.A0101_rmdup	3465042	3465088		YPO_RS16485	46
VLI092.A0101_rmdup	3465309	3465330		YPO_RS16485	21
VLI092.A0101_rmdup	3465522	3465556		YPO_RS16485	34
VLI092.A0101_rmdup	3465567	3465574		YPO_RS16490	7
VLI092.A0101_rmdup	3466256	3466383		YPO_RS16490	127
VLI092.A0101_rmdup	3468658	3468699		YPO_RS16500	41
VLI092.A0101_rmdup	3469124	3469125		YPO_RS16500	1
VLI092.A0101_rmdup	3506487	3506490		YPO_RS16670	3
VLI092.A0101_rmdup	3516278	3516283		hupB	5
VLI092.A0101_rmdup	3527212	3527267		YPO_RS16755	55
VLI092.A0101_rmdup	3536334	3536335		yajL	1
VLI092.A0101_rmdup	3548030	3548123		YPO_RS16865	93
VLI092.A0101_rmdup	3560407	3560414		YPO_RS16925	7
VLI092.A0101_rmdup	3572102	3572127		YPO_RS16965	25
VLI092.A0101_rmdup	3574423	3574434		YPO_RS16965	11
VLI092.A0101_rmdup	3582249	3582250		YPO_RS17005	1
VLI092.A0101_rmdup	3590126	3590128		YPO_RS17045	2
VLI092.A0101_rmdup	3592450	3592532		YPO_RS17055	82
VLI092.A0101_rmdup	3595739	3595747		pepD	8
VLI092.A0101_rmdup	3598568	3598572		YPO_RS17070	4
VLI092.A0101_rmdup	3635301	3635302		YPO_RS17225	1
VLI092.A0101_rmdup	3640033	3640034		emrB	1
VLI092.A0101_rmdup	3673001	3673012		trmD	11
VLI092.A0101_rmdup	3701750	3701758		katG	8
VLI092.A0101_rmdup	3754885	3754887		cobA	2
VLI092.A0101_rmdup	3759113	3759121		cysI	8
VLI092.A0101_rmdup	3771238	3771246		YPO_RS17870	8
VLI092.A0101_rmdup	3773774	3773781		barA	7
VLI092.A0101_rmdup	3809791	3809797		speE	6
VLI092.A0101_rmdup	3809834	3809848		speE	14
VLI092.A0101_rmdup	3812178	3812182		YPO_RS18035	4
VLI092.A0101_rmdup	3835023	3835048		coaE	25
VLI092.A0101_rmdup	3903559	3903560		truB	1
VLI092.A0101_rmdup	3906352	3906372		infB	20
VLI092.A0101_rmdup	3949240	3949246		rpsF	6
VLI092.A0101_rmdup	3949726	3949738		yjfP	12
VLI092.A0101_rmdup	3950381	3950383		yjfP	2
VLI092.A0101_rmdup	3980186	3980191		degQ	5
VLI092.A0101_rmdup	3982861	3982864		murA	3
VLI092.A0101_rmdup	3990495	3990507		kdsC	12
VLI092.A0101_rmdup	4011531	4011558		tssA	27
VLI092.A0101_rmdup	4016675	4016677		YPO_RS18990	2
VLI092.A0101_rmdup	4029402	4029427		YPO_RS19055	25
VLI092.A0101_rmdup	4033790	4033814		YPO_RS19060	24
VLI092.A0101_rmdup	4082223	4082236		msrQ	13
VLI092.A0101_rmdup	4098633	4098652		YPO_RS19365	19
VLI092.A0101_rmdup	4098936	4098958		YPO_RS19365	22
VLI092.A0101_rmdup	4099371	4099395		YPO_RS19365	24
VLI092.A0101_rmdup	4101634	4101652		YPO_RS19370	18
VLI092.A0101_rmdup	4112642	4112768		YPO_RS19400	126
VLI092.A0101_rmdup	4113883	4113893		YPO_RS19400	10
VLI092.A0101_rmdup	4114044	4114061		YPO_RS19405	17
VLI092.A0101_rmdup	4142784	4142802		YPO_RS19535	18
VLI092.A0101_rmdup	4156561	4156578		YPO_RS19590	17
VLI092.A0101_rmdup	4156661	4156666		YPO_RS19590	5
VLI092.A0101_rmdup	4175178	4175183		YPO_RS19635	5
VLI092.A0101_rmdup	4176215	4176221		YPO_RS19645	6
VLI092.A0101_rmdup	4206222	4206228		rplL	6
VLI092.A0101_rmdup	4213921	4213922		YPO_RS19830	1
VLI092.A0101_rmdup	4216769	4216801		murB	32
VLI092.A0101_rmdup	4217486	4217508		murB	22
VLI092.A0101_rmdup	4219432	4219434		YPO_RS19855	2
VLI092.A0101_rmdup	4221487	4221488		YPO_RS19860	1
VLI092.A0101_rmdup	4223144	4223145		YPO_RS19870	1
VLI092.A0101_rmdup	4226963	4226995		YPO_RS19900	32
VLI092.A0101_rmdup	4257920	4257925		ugpQ	5
VLI092.A0101_rmdup	4269659	4269669		YPO_RS20095	10
VLI092.A0101_rmdup	4280849	4280853		ftsY	4
VLI092.A0101_rmdup	4328873	4328883		wzyE	10
VLI092.A0101_rmdup	4359333	4359370		YPO_RS20515	37
VLI092.A0101_rmdup	4389733	4389735		YPO_RS20670	2
VLI092.A0101_rmdup	4400763	4400767		YPO_RS20725	4
VLI092.A0101_rmdup	4408290	4408320		YPO_RS20745	30
VLI092.A0101_rmdup	4442493	4442512		YPO_RS20830	19
VLI092.A0101_rmdup	4444019	4444023		YPO_RS20830	4
VLI092.A0101_rmdup	4483607	4483657		YPO_RS21020	50
VLI092.A0101_rmdup	4483815	4483880		YPO_RS21020	65
VLI092.A0101_rmdup	4484594	4484599		YPO_RS21025	5
VLI092.A0101_rmdup	4484601	4484633		YPO_RS21030	32
VLI092.A0101_rmdup	4516793	4516796		YPO_RS21140	3
VLI092.A0101_rmdup	4533479	4533483		YPO_RS21205	4
VLI092.A0101_rmdup	4534849	4534851		YPO_RS21210	2
VLI092.A0101_rmdup	4545812	4545820		YPO_RS21280	8
VLI092.A0101_rmdup	4546418	4546422		YPO_RS21280	4
VLI092.A0101_rmdup	4567722	4567756		YPO_RS21370	34
VLI092.A0101_rmdup	4569619	4569633		selB	14
VLI092.A0101_rmdup	4578220	4578238		fdnG	18
VLI092.A0101_rmdup	4601725	4601733		YPO_RS21520	8
VLI092.A0101_rmdup	4602028	4602037		YPO_RS21520	9
VLI092.A0101_rmdup	4612090	4612100		YPO_RS21565	10
VLI092.A0101_rmdup	4626181	4626185		YPO_RS21630	4
VLI092.A0101_rmdup	4626274	4626297		YPO_RS21630	23
XXX001.A18956-61_libmerged	1435	1436		YPO_RS01015	1
XXX001.A18956-61_libmerged	4026	4047		ravA	21
XXX001.A18956-61_libmerged	7236	7240		kup	4
XXX001.A18956-61_libmerged	10214	10233		YPO_RS01055	19
XXX001.A18956-61_libmerged	10658	10661		YPO_RS01055	3
XXX001.A18956-61_libmerged	11149	11159		YPO_RS01060	10
XXX001.A18956-61_libmerged	11222	11230		YPO_RS01060	8
XXX001.A18956-61_libmerged	14916	14922		YPO_RS01080	6
XXX001.A18956-61_libmerged	19619	19630		mobB	11
XXX001.A18956-61_libmerged	23890	23903		polA	13
XXX001.A18956-61_libmerged	37833	37837		yihX	4
XXX001.A18956-61_libmerged	51565	51570		spoT	5
XXX001.A18956-61_libmerged	54091	54092		ligB	1
XXX001.A18956-61_libmerged	58217	58235		rph	18
XXX001.A18956-61_libmerged	62336	62343		YPO_RS01280	7
XXX001.A18956-61_libmerged	63094	63095		rpmG	1
XXX001.A18956-61_libmerged	64519	64534		YPO_RS01310	15
XXX001.A18956-61_libmerged	64855	64857		YPO_RS01310	2
XXX001.A18956-61_libmerged	67077	67087		rfaC	10
XXX001.A18956-61_libmerged	73922	73929		envC	7
XXX001.A18956-61_libmerged	74633	74651		envC	18
XXX001.A18956-61_libmerged	77652	77654		grxC	2
XXX001.A18956-61_libmerged	79233	79237		gpsA	4
XXX001.A18956-61_libmerged	82536	82592		cpxA	56
XXX001.A18956-61_libmerged	90881	90883		YPO_RS01440	2
XXX001.A18956-61_libmerged	95572	95575		YPO_RS01460	3
XXX001.A18956-61_libmerged	97328	97336		YPO_RS01470	8
XXX001.A18956-61_libmerged	97653	97657		YPO_RS01470	4
XXX001.A18956-61_libmerged	106577	106585		YPO_RS01520	8
XXX001.A18956-61_libmerged	134749	134756		malP	7
XXX001.A18956-61_libmerged	135772	135816		malP	44
XXX001.A18956-61_libmerged	141542	141546		YPO_RS01665	4
XXX001.A18956-61_libmerged	141864	141872		YPO_RS01670	8
XXX001.A18956-61_libmerged	146538	146540		YPO_RS01685	2
XXX001.A18956-61_libmerged	151661	151671		pckA	10
XXX001.A18956-61_libmerged	153948	153953		hslR	5
XXX001.A18956-61_libmerged	160838	160843		mrcA	5
XXX001.A18956-61_libmerged	163179	163183		YPO_RS01750	4
XXX001.A18956-61_libmerged	177062	177063		YPO_RS01815	1
XXX001.A18956-61_libmerged	177472	177478		YPO_RS01815	6
XXX001.A18956-61_libmerged	177509	177530		YPO_RS01815	21
XXX001.A18956-61_libmerged	188556	188565		YPO_RS01850	9
XXX001.A18956-61_libmerged	196578	196599		YPO_RS01895	21
XXX001.A18956-61_libmerged	196646	196709		YPO_RS01895	63
XXX001.A18956-61_libmerged	224998	225002		rplV	4
XXX001.A18956-61_libmerged	225706	225707		rpsC	1
XXX001.A18956-61_libmerged	236481	236494		YPO_RS02185	13
XXX001.A18956-61_libmerged	242155	242159		dprA	4
XXX001.A18956-61_libmerged	256946	256952		YPO_RS02285	6
XXX001.A18956-61_libmerged	258216	258224		YPO_RS02285	8
XXX001.A18956-61_libmerged	258765	258787		YPO_RS02290	22
XXX001.A18956-61_libmerged	259802	259807		YPO_RS02290	5
XXX001.A18956-61_libmerged	267838	267854		YPO_RS02345	16
XXX001.A18956-61_libmerged	270831	270835		sctR	4
XXX001.A18956-61_libmerged	276377	276381		YPO_RS02395	4
XXX001.A18956-61_libmerged	279205	279212		YPO_RS02410	7
XXX001.A18956-61_libmerged	282111	282114		YPO_RS02425	3
XXX001.A18956-61_libmerged	288331	288341		YPO_RS02455	10
XXX001.A18956-61_libmerged	288507	288520		YPO_RS02455	13
XXX001.A18956-61_libmerged	288871	288945		YPO_RS02455	74
XXX001.A18956-61_libmerged	289057	289063		YPO_RS02455	6
XXX001.A18956-61_libmerged	289431	289433		YPO_RS02460	2
XXX001.A18956-61_libmerged	291536	291541		YPO_RS02470	5
XXX001.A18956-61_libmerged	292364	292380		YPO_RS02475	16
XXX001.A18956-61_libmerged	297447	297468		YPO_RS02500	21
XXX001.A18956-61_libmerged	302713	302734		YPO_RS02530	21
XXX001.A18956-61_libmerged	303038	303049		YPO_RS02530	11
XXX001.A18956-61_libmerged	315058	315080		yapK	22
XXX001.A18956-61_libmerged	320875	320888		plsB	13
XXX001.A18956-61_libmerged	326957	326977		dnaB	20
XXX001.A18956-61_libmerged	331945	331954		uvrA	9
XXX001.A18956-61_libmerged	335079	335112		ssb1	33
XXX001.A18956-61_libmerged	342596	342600		rhaR	4
XXX001.A18956-61_libmerged	344915	344928		YPO_RS02690	13
XXX001.A18956-61_libmerged	345930	345955		YPO_RS02695	25
XXX001.A18956-61_libmerged	346668	346688		YPO_RS02695	20
XXX001.A18956-61_libmerged	347079	347082		YPO_RS02695	3
XXX001.A18956-61_libmerged	347186	347237		YPO_RS02695	51
XXX001.A18956-61_libmerged	347390	347421		YPO_RS02695	31
XXX001.A18956-61_libmerged	347488	347520		YPO_RS02695	32
XXX001.A18956-61_libmerged	347739	347758		YPO_RS02695	19
XXX001.A18956-61_libmerged	347962	348010		YPO_RS02695	48
XXX001.A18956-61_libmerged	348158	348167		YPO_RS02695	9
XXX001.A18956-61_libmerged	360457	360482		fxsA	25
XXX001.A18956-61_libmerged	371071	371158		YPO_RS02805	87
XXX001.A18956-61_libmerged	386856	386865		mutL	9
XXX001.A18956-61_libmerged	387419	387434		miaA	15
XXX001.A18956-61_libmerged	401045	401046		YPO_RS02925	1
XXX001.A18956-61_libmerged	404332	404341		YPO_RS02940	9
XXX001.A18956-61_libmerged	405914	405921		YPO_RS02945	7
XXX001.A18956-61_libmerged	407792	407803		YPO_RS02955	11
XXX001.A18956-61_libmerged	407849	407883		YPO_RS02955	34
XXX001.A18956-61_libmerged	408056	408081		YPO_RS02955	25
XXX001.A18956-61_libmerged	408155	408199		YPO_RS02955	44
XXX001.A18956-61_libmerged	408251	408338		YPO_RS02955	87
XXX001.A18956-61_libmerged	408400	408467		YPO_RS02955	67
XXX001.A18956-61_libmerged	409512	409536		YPO_RS02960	24
XXX001.A18956-61_libmerged	409518	409536		YPO_RS02965	18
XXX001.A18956-61_libmerged	409840	409879		YPO_RS02965	39
XXX001.A18956-61_libmerged	410022	410033		YPO_RS02965	11
XXX001.A18956-61_libmerged	410365	410379		YPO_RS02965	14
XXX001.A18956-61_libmerged	410566	410604		YPO_RS02965	38
XXX001.A18956-61_libmerged	410824	410891		YPO_RS02965	67
XXX001.A18956-61_libmerged	409587	409702		YPO_RS02965	115
XXX001.A18956-61_libmerged	415841	415862		YPO_RS02990	21
XXX001.A18956-61_libmerged	416445	416447		YPO_RS02995	2
XXX001.A18956-61_libmerged	417000	417012		YPO_RS02995	12
XXX001.A18956-61_libmerged	431301	431328		YPO_RS03065	27
XXX001.A18956-61_libmerged	449189	449191		YPO_RS03140	2
XXX001.A18956-61_libmerged	451861	451867		osmY	6
XXX001.A18956-61_libmerged	455472	455474		YPO_RS03175	2
XXX001.A18956-61_libmerged	455544	455547		YPO_RS03175	3
XXX001.A18956-61_libmerged	460115	460121		deoB	6
XXX001.A18956-61_libmerged	463260	463264		serB	4
XXX001.A18956-61_libmerged	467654	467676		YPO_RS03220	22
XXX001.A18956-61_libmerged	475410	475412		YPO_RS03245	2
XXX001.A18956-61_libmerged	490058	490063		YPO_RS03310	5
XXX001.A18956-61_libmerged	492018	492024		mog	6
XXX001.A18956-61_libmerged	494473	494499		YPO_RS03330	26
XXX001.A18956-61_libmerged	494964	495027		YPO_RS03330	63
XXX001.A18956-61_libmerged	495132	495178		YPO_RS03330	46
XXX001.A18956-61_libmerged	495282	495315		YPO_RS03330	33
XXX001.A18956-61_libmerged	495397	495410		YPO_RS03330	13
XXX001.A18956-61_libmerged	495499	495501		YPO_RS03330	2
XXX001.A18956-61_libmerged	495723	495807		YPO_RS03330	84
XXX001.A18956-61_libmerged	495891	495894		YPO_RS03330	3
XXX001.A18956-61_libmerged	497683	497684		dnaK	1
XXX001.A18956-61_libmerged	502898	502902		nhaR	4
XXX001.A18956-61_libmerged	504955	504977		ileS	22
XXX001.A18956-61_libmerged	507245	507256		ileS	11
XXX001.A18956-61_libmerged	519575	519581		folA	6
XXX001.A18956-61_libmerged	520816	520844		YPO_RS03445	28
XXX001.A18956-61_libmerged	521134	521162		YPO_RS03450	28
XXX001.A18956-61_libmerged	532259	532275		YPO_RS03495	16
XXX001.A18956-61_libmerged	533773	533800		tssB	27
XXX001.A18956-61_libmerged	552899	552900		tssM	1
XXX001.A18956-61_libmerged	562662	562682		YPO_RS03600	20
XXX001.A18956-61_libmerged	573226	573229		YPO_RS03645	3
XXX001.A18956-61_libmerged	583164	583170		YPO_RS03685	6
XXX001.A18956-61_libmerged	584125	584131		ilvI	6
XXX001.A18956-61_libmerged	588832	588835		YPO_RS03710	3
XXX001.A18956-61_libmerged	590597	590611		rsmH	14
XXX001.A18956-61_libmerged	592044	592053		YPO_RS03735	9
XXX001.A18956-61_libmerged	592197	592202		YPO_RS03735	5
XXX001.A18956-61_libmerged	595323	595362		murF	39
XXX001.A18956-61_libmerged	600597	600601		murG	4
XXX001.A18956-61_libmerged	609376	609386		secA	10
XXX001.A18956-61_libmerged	617242	617251		YPO_RS03855	9
XXX001.A18956-61_libmerged	618630	618632		YPO_RS03865	2
XXX001.A18956-61_libmerged	634505	634511		yapG	6
XXX001.A18956-61_libmerged	635498	635518		yapG	20
XXX001.A18956-61_libmerged	642529	642534		YPO_RS03950	5
XXX001.A18956-61_libmerged	646464	646472		YPO_RS03970	8
XXX001.A18956-61_libmerged	646510	646514		YPO_RS03970	4
XXX001.A18956-61_libmerged	651038	651040		cdiA	2
XXX001.A18956-61_libmerged	653717	653735		cdiA	18
XXX001.A18956-61_libmerged	657004	657008		cdiA	4
XXX001.A18956-61_libmerged	658160	658165		cdiA	5
XXX001.A18956-61_libmerged	659234	659300		cdiI	66
XXX001.A18956-61_libmerged	659359	659433		cdiI	74
XXX001.A18956-61_libmerged	660142	660195		YPO_RS04005	53
XXX001.A18956-61_libmerged	666544	666546		YPO_RS04030	2
XXX001.A18956-61_libmerged	667976	667987		YPO_RS04035	11
XXX001.A18956-61_libmerged	672595	672621		YPO_RS04050	26
XXX001.A18956-61_libmerged	673945	673972		YPO_RS04055	27
XXX001.A18956-61_libmerged	680340	680342		YPO_RS04080	2
XXX001.A18956-61_libmerged	684595	684598		YPO_RS04100	3
XXX001.A18956-61_libmerged	684663	684685		YPO_RS04100	22
XXX001.A18956-61_libmerged	686047	686051		YPO_RS04105	4
XXX001.A18956-61_libmerged	686672	686675		YPO_RS04105	3
XXX001.A18956-61_libmerged	687080	687111		YPO_RS04110	31
XXX001.A18956-61_libmerged	687150	687166		YPO_RS04110	16
XXX001.A18956-61_libmerged	687270	687301		YPO_RS04110	31
XXX001.A18956-61_libmerged	687947	687966		YPO_RS04115	19
XXX001.A18956-61_libmerged	688326	688348		YPO_RS04120	22
XXX001.A18956-61_libmerged	705007	705021		plsY	14
XXX001.A18956-61_libmerged	707579	707585		YPO_RS04230	6
XXX001.A18956-61_libmerged	720404	720407		YPO_RS04275	3
XXX001.A18956-61_libmerged	728995	729000		YPO_RS04315	5
XXX001.A18956-61_libmerged	743141	743143		metC	2
XXX001.A18956-61_libmerged	744841	744853		exbB	12
XXX001.A18956-61_libmerged	746370	746412		YPO_RS04390	42
XXX001.A18956-61_libmerged	747096	747099		YPO_RS04390	3
XXX001.A18956-61_libmerged	747589	747594		YPO_RS04390	5
XXX001.A18956-61_libmerged	747758	747769		YPO_RS04390	11
XXX001.A18956-61_libmerged	749295	749390		YPO_RS04405	95
XXX001.A18956-61_libmerged	749625	749645		YPO_RS04405	20
XXX001.A18956-61_libmerged	749629	749649		YPO_RS04410	20
XXX001.A18956-61_libmerged	750074	750093		YPO_RS04410	19
XXX001.A18956-61_libmerged	750201	750262		YPO_RS04410	61
XXX001.A18956-61_libmerged	750463	750535		YPO_RS04415	72
XXX001.A18956-61_libmerged	750991	751101		YPO_RS04415	110
XXX001.A18956-61_libmerged	751196	751202		YPO_RS04415	6
XXX001.A18956-61_libmerged	752024	752025		YPO_RS04420	1
XXX001.A18956-61_libmerged	752460	752475		YPO_RS04420	15
XXX001.A18956-61_libmerged	752608	752617		YPO_RS04420	9
XXX001.A18956-61_libmerged	752629	752693		YPO_RS04425	64
XXX001.A18956-61_libmerged	753537	753547		YPO_RS04425	10
XXX001.A18956-61_libmerged	753594	753641		YPO_RS04425	47
XXX001.A18956-61_libmerged	753737	753756		YPO_RS04425	19
XXX001.A18956-61_libmerged	753767	753791		YPO_RS04430	24
XXX001.A18956-61_libmerged	753868	753924		YPO_RS04430	56
XXX001.A18956-61_libmerged	754784	754786		YPO_RS04440	2
XXX001.A18956-61_libmerged	754826	754857		YPO_RS04440	31
XXX001.A18956-61_libmerged	754896	754902		YPO_RS04440	6
XXX001.A18956-61_libmerged	754988	755018		YPO_RS04440	30
XXX001.A18956-61_libmerged	755292	755372		YPO_RS04440	80
XXX001.A18956-61_libmerged	755369	755381		YPO_RS04445	12
XXX001.A18956-61_libmerged	755546	755578		YPO_RS04445	32
XXX001.A18956-61_libmerged	755795	755807		YPO_RS04445	12
XXX001.A18956-61_libmerged	755908	755915		YPO_RS04445	7
XXX001.A18956-61_libmerged	756046	756053		YPO_RS04445	7
XXX001.A18956-61_libmerged	756214	756229		YPO_RS04445	15
XXX001.A18956-61_libmerged	756528	756536		YPO_RS04450	8
XXX001.A18956-61_libmerged	756613	756663		YPO_RS04450	50
XXX001.A18956-61_libmerged	764925	764930		YPO_RS04485	5
XXX001.A18956-61_libmerged	769598	769601		flhB	3
XXX001.A18956-61_libmerged	769868	769893		flhB	25
XXX001.A18956-61_libmerged	772603	772606		YPO_RS04525	3
XXX001.A18956-61_libmerged	772950	773009		YPO_RS04525	59
XXX001.A18956-61_libmerged	781499	781519		flgA	20
XXX001.A18956-61_libmerged	782250	782254		flgA	4
XXX001.A18956-61_libmerged	784149	784154		flaE	5
XXX001.A18956-61_libmerged	785300	785335		YPO_RS04600	35
XXX001.A18956-61_libmerged	791774	791791		flgL	17
XXX001.A18956-61_libmerged	796063	796082		YPO_RS04660	19
XXX001.A18956-61_libmerged	801269	801276		fliD	7
XXX001.A18956-61_libmerged	801466	801489		fliS	23
XXX001.A18956-61_libmerged	803194	803195		YPO_RS04690	1
XXX001.A18956-61_libmerged	803311	803315		YPO_RS04695	4
XXX001.A18956-61_libmerged	804380	804382		YPO_RS04700	2
XXX001.A18956-61_libmerged	806658	806713		YPO_RS04715	55
XXX001.A18956-61_libmerged	806987	807010		YPO_RS04715	23
XXX001.A18956-61_libmerged	807621	807706		YPO_RS04720	85
XXX001.A18956-61_libmerged	807690	807726		YPO_RS04725	36
XXX001.A18956-61_libmerged	808022	808032		YPO_RS04725	10
XXX001.A18956-61_libmerged	808987	809040		YPO_RS04735	53
XXX001.A18956-61_libmerged	809175	809219		YPO_RS04735	44
XXX001.A18956-61_libmerged	812566	812573		YPO_RS04750	7
XXX001.A18956-61_libmerged	815473	815484		YPO_RS04760	11
XXX001.A18956-61_libmerged	816395	816416		YPO_RS04765	21
XXX001.A18956-61_libmerged	816471	816474		YPO_RS04765	3
XXX001.A18956-61_libmerged	816868	816875		YPO_RS04770	7
XXX001.A18956-61_libmerged	817169	817170		YPO_RS04770	1
XXX001.A18956-61_libmerged	822818	822827		vgrG	9
XXX001.A18956-61_libmerged	833835	833860		YPO_RS04800	25
XXX001.A18956-61_libmerged	838391	838397		YPO_RS04810	6
XXX001.A18956-61_libmerged	838851	838910		YPO_RS04815	59
XXX001.A18956-61_libmerged	841208	841216		YPO_RS04825	8
XXX001.A18956-61_libmerged	841500	841506		YPO_RS04825	6
XXX001.A18956-61_libmerged	844873	844879		YPO_RS04835	6
XXX001.A18956-61_libmerged	845409	845614		YPO_RS04835	205
XXX001.A18956-61_libmerged	845915	845919		YPO_RS04835	4
XXX001.A18956-61_libmerged	846129	846146		YPO_RS04835	17
XXX001.A18956-61_libmerged	847614	847617		YPO_RS04835	3
XXX001.A18956-61_libmerged	849035	849045		YPO_RS04840	10
XXX001.A18956-61_libmerged	850361	850364		YPO_RS04845	3
XXX001.A18956-61_libmerged	856523	856533		YPO_RS04845	10
XXX001.A18956-61_libmerged	858884	858885		YPO_RS04860	1
XXX001.A18956-61_libmerged	867751	867759		YPO_RS04900	8
XXX001.A18956-61_libmerged	881726	881731		YPO_RS04950	5
XXX001.A18956-61_libmerged	883490	883495		YPO_RS04955	5
XXX001.A18956-61_libmerged	883946	883968		YPO_RS04960	22
XXX001.A18956-61_libmerged	884084	884106		YPO_RS04960	22
XXX001.A18956-61_libmerged	884313	884331		YPO_RS04965	18
XXX001.A18956-61_libmerged	884371	884393		YPO_RS04965	22
XXX001.A18956-61_libmerged	884446	884473		YPO_RS04965	27
XXX001.A18956-61_libmerged	884513	884522		YPO_RS04965	9
XXX001.A18956-61_libmerged	885548	885551		YPO_RS04975	3
XXX001.A18956-61_libmerged	885649	885717		YPO_RS04975	68
XXX001.A18956-61_libmerged	886047	886050		YPO_RS04975	3
XXX001.A18956-61_libmerged	886157	886239		YPO_RS04975	82
XXX001.A18956-61_libmerged	886489	886498		YPO_RS04980	9
XXX001.A18956-61_libmerged	886578	886693		YPO_RS04980	115
XXX001.A18956-61_libmerged	886765	886785		YPO_RS04980	20
XXX001.A18956-61_libmerged	887077	887137		gspL	60
XXX001.A18956-61_libmerged	887749	887786		gspL	37
XXX001.A18956-61_libmerged	887889	887915		gspL	26
XXX001.A18956-61_libmerged	888142	888258		YPO_RS04990	116
XXX001.A18956-61_libmerged	888418	888440		YPO_RS04990	22
XXX001.A18956-61_libmerged	888606	888621		YPO_RS04990	15
XXX001.A18956-61_libmerged	888699	888730		YPO_RS04990	31
XXX001.A18956-61_libmerged	888900	888915		YPO_RS04990	15
XXX001.A18956-61_libmerged	889196	889210		gspJ	14
XXX001.A18956-61_libmerged	889384	889408		gspJ	24
XXX001.A18956-61_libmerged	889492	889539		gspJ	47
XXX001.A18956-61_libmerged	889891	889970		gspI	79
XXX001.A18956-61_libmerged	889984	890050		YPO_RS05005	66
XXX001.A18956-61_libmerged	890151	890171		YPO_RS05005	20
XXX001.A18956-61_libmerged	890256	890266		YPO_RS05005	10
XXX001.A18956-61_libmerged	890949	890968		gspG	19
XXX001.A18956-61_libmerged	893685	893687		gspE	2
XXX001.A18956-61_libmerged	893685	893824		gspD	139
XXX001.A18956-61_libmerged	893896	893907		gspD	11
XXX001.A18956-61_libmerged	894067	894083		gspD	16
XXX001.A18956-61_libmerged	894334	894347		gspD	13
XXX001.A18956-61_libmerged	894456	894470		gspD	14
XXX001.A18956-61_libmerged	894705	894723		gspD	18
XXX001.A18956-61_libmerged	894847	894859		gspD	12
XXX001.A18956-61_libmerged	894943	894951		gspD	8
XXX001.A18956-61_libmerged	895447	895559		gspD	112
XXX001.A18956-61_libmerged	895687	895705		YPO_RS05030	18
XXX001.A18956-61_libmerged	895747	895762		YPO_RS05030	15
XXX001.A18956-61_libmerged	895894	895972		YPO_RS05030	78
XXX001.A18956-61_libmerged	896038	896077		YPO_RS05030	39
XXX001.A18956-61_libmerged	896134	896190		YPO_RS05030	56
XXX001.A18956-61_libmerged	896258	896314		YPO_RS05035	56
XXX001.A18956-61_libmerged	903769	903771		YPO_RS05060	2
XXX001.A18956-61_libmerged	904402	904404		YPO_RS05060	2
XXX001.A18956-61_libmerged	919761	919767		YPO_RS05130	6
XXX001.A18956-61_libmerged	922966	922980		YPO_RS05140	14
XXX001.A18956-61_libmerged	924727	924731		YPO_RS05145	4
XXX001.A18956-61_libmerged	925989	925993		YPO_RS05150	4
XXX001.A18956-61_libmerged	927907	927915		YPO_RS05160	8
XXX001.A18956-61_libmerged	928021	928025		YPO_RS05160	4
XXX001.A18956-61_libmerged	929307	929318		YPO_RS05165	11
XXX001.A18956-61_libmerged	936528	936533		YPO_RS05190	5
XXX001.A18956-61_libmerged	939392	939400		YPO_RS05195	8
XXX001.A18956-61_libmerged	939476	939477		YPO_RS05195	1
XXX001.A18956-61_libmerged	939482	939491		YPO_RS05200	9
XXX001.A18956-61_libmerged	940531	940576		YPO_RS05205	45
XXX001.A18956-61_libmerged	949932	949951		YPO_RS05235	19
XXX001.A18956-61_libmerged	950161	950200		YPO_RS05235	39
XXX001.A18956-61_libmerged	950340	950353		YPO_RS05235	13
XXX001.A18956-61_libmerged	952604	952607		YPO_RS05245	3
XXX001.A18956-61_libmerged	953650	953784		YPO_RS05260	134
XXX001.A18956-61_libmerged	954409	954417		YPO_RS05260	8
XXX001.A18956-61_libmerged	957684	957689		YPO_RS05270	5
XXX001.A18956-61_libmerged	958588	958590		YPO_RS05275	2
XXX001.A18956-61_libmerged	963555	963557		YPO_RS05310	2
XXX001.A18956-61_libmerged	963667	963679		YPO_RS05310	12
XXX001.A18956-61_libmerged	964077	964117		YPO_RS05315	40
XXX001.A18956-61_libmerged	965251	965258		YPO_RS05330	7
XXX001.A18956-61_libmerged	976988	977004		dsbC	16
XXX001.A18956-61_libmerged	978699	978705		creD	6
XXX001.A18956-61_libmerged	986325	986328		YPO_RS05440	3
XXX001.A18956-61_libmerged	986428	986444		YPO_RS05440	16
XXX001.A18956-61_libmerged	986768	986773		YPO_RS05440	5
XXX001.A18956-61_libmerged	993956	993961		gcvP	5
XXX001.A18956-61_libmerged	997023	997034		ubiI	11
XXX001.A18956-61_libmerged	1006264	1006265		YPO_RS05520	1
XXX001.A18956-61_libmerged	1039753	1039784		YPO_RS05675	31
XXX001.A18956-61_libmerged	1039825	1039853		YPO_RS05675	28
XXX001.A18956-61_libmerged	1040309	1040329		YPO_RS05675	20
XXX001.A18956-61_libmerged	1040501	1040503		YPO_RS05675	2
XXX001.A18956-61_libmerged	1040871	1040910		YPO_RS05675	39
XXX001.A18956-61_libmerged	1042520	1042521		YPO_RS05675	1
XXX001.A18956-61_libmerged	1042856	1042875		YPO_RS05675	19
XXX001.A18956-61_libmerged	1043457	1043468		YPO_RS05675	11
XXX001.A18956-61_libmerged	1043772	1043781		YPO_RS05675	9
XXX001.A18956-61_libmerged	1043945	1043972		YPO_RS05675	27
XXX001.A18956-61_libmerged	1044238	1044273		YPO_RS05675	35
XXX001.A18956-61_libmerged	1044411	1044542		YPO_RS05675	131
XXX001.A18956-61_libmerged	1044639	1044654		YPO_RS05675	15
XXX001.A18956-61_libmerged	1044803	1044876		YPO_RS05675	73
XXX001.A18956-61_libmerged	1044966	1045102		YPO_RS05675	136
XXX001.A18956-61_libmerged	1045286	1045319		YPO_RS05675	33
XXX001.A18956-61_libmerged	1045507	1045581		YPO_RS05675	74
XXX001.A18956-61_libmerged	1045648	1045663		YPO_RS05675	15
XXX001.A18956-61_libmerged	1046483	1046578		YPO_RS05675	95
XXX001.A18956-61_libmerged	1046679	1046716		YPO_RS05675	37
XXX001.A18956-61_libmerged	1053145	1053175		mltC	30
XXX001.A18956-61_libmerged	1053212	1053214		mltC	2
XXX001.A18956-61_libmerged	1055408	1055418		YPO_RS05720	10
XXX001.A18956-61_libmerged	1063222	1063250		speF	28
XXX001.A18956-61_libmerged	1066871	1066877		YPO_RS05765	6
XXX001.A18956-61_libmerged	1067007	1067010		YPO_RS05765	3
XXX001.A18956-61_libmerged	1067201	1067223		YPO_RS05765	22
XXX001.A18956-61_libmerged	1067267	1067275		YPO_RS05765	8
XXX001.A18956-61_libmerged	1067324	1067388		YPO_RS05765	64
XXX001.A18956-61_libmerged	1067376	1067388		YPO_RS05770	12
XXX001.A18956-61_libmerged	1067531	1067544		YPO_RS05770	13
XXX001.A18956-61_libmerged	1068123	1068192		YPO_RS05770	69
XXX001.A18956-61_libmerged	1071650	1071685		YPO_RS05785	35
XXX001.A18956-61_libmerged	1073123	1073143		YPO_RS05795	20
XXX001.A18956-61_libmerged	1075664	1075667		YPO_RS05800	3
XXX001.A18956-61_libmerged	1076166	1076167		YPO_RS05800	1
XXX001.A18956-61_libmerged	1080999	1081022		YPO_RS05815	23
XXX001.A18956-61_libmerged	1085648	1085649		tssC	1
XXX001.A18956-61_libmerged	1088689	1088719		YPO_RS05845	30
XXX001.A18956-61_libmerged	1089048	1089080		YPO_RS05845	32
XXX001.A18956-61_libmerged	1091414	1091416		YPO_RS05855	2
XXX001.A18956-61_libmerged	1092557	1092562		YPO_RS05860	5
XXX001.A18956-61_libmerged	1093603	1093611		YPO_RS05865	8
XXX001.A18956-61_libmerged	1095841	1095885		YPO_RS05870	44
XXX001.A18956-61_libmerged	1106419	1106440		YPO_RS05910	21
XXX001.A18956-61_libmerged	1110743	1110770		YPO_RS05920	27
XXX001.A18956-61_libmerged	1112257	1112263		YPO_RS05930	6
XXX001.A18956-61_libmerged	1116716	1116717		YPO_RS05940	1
XXX001.A18956-61_libmerged	1116838	1116840		YPO_RS05940	2
XXX001.A18956-61_libmerged	1116916	1117127		YPO_RS05940	211
XXX001.A18956-61_libmerged	1117271	1117346		YPO_RS05940	75
XXX001.A18956-61_libmerged	1117761	1117786		YPO_RS05940	25
XXX001.A18956-61_libmerged	1117892	1117898		YPO_RS05940	6
XXX001.A18956-61_libmerged	1118082	1118110		YPO_RS05940	28
XXX001.A18956-61_libmerged	1120406	1120410		yapH	4
XXX001.A18956-61_libmerged	1121003	1121007		yapH	4
XXX001.A18956-61_libmerged	1121553	1121568		yapH	15
XXX001.A18956-61_libmerged	1124433	1124439		yapH	6
XXX001.A18956-61_libmerged	1130922	1130946		yapH	24
XXX001.A18956-61_libmerged	1131541	1131543		YPO_RS05955	2
XXX001.A18956-61_libmerged	1135055	1135063		YPO_RS05970	8
XXX001.A18956-61_libmerged	1136383	1136392		YPO_RS05970	9
XXX001.A18956-61_libmerged	1137289	1137312		YPO_RS05975	23
XXX001.A18956-61_libmerged	1140856	1140870		YPO_RS05985	14
XXX001.A18956-61_libmerged	1141631	1141638		YPO_RS05985	7
XXX001.A18956-61_libmerged	1141695	1141719		YPO_RS05985	24
XXX001.A18956-61_libmerged	1142067	1142108		YPO_RS05985	41
XXX001.A18956-61_libmerged	1142193	1142241		YPO_RS05985	48
XXX001.A18956-61_libmerged	1142423	1142437		YPO_RS05985	14
XXX001.A18956-61_libmerged	1152209	1152216		recC	7
XXX001.A18956-61_libmerged	1154165	1154173		ptrA	8
XXX001.A18956-61_libmerged	1156053	1156058		recB	5
XXX001.A18956-61_libmerged	1162094	1162096		argA	2
XXX001.A18956-61_libmerged	1167424	1167434		tcdA	10
XXX001.A18956-61_libmerged	1171381	1171397		YPO_RS06095	16
XXX001.A18956-61_libmerged	1171394	1171397		rlmM	3
XXX001.A18956-61_libmerged	1172751	1172757		xni	6
XXX001.A18956-61_libmerged	1183902	1183905		glnD	3
XXX001.A18956-61_libmerged	1217368	1217381		YPO_RS06325	13
XXX001.A18956-61_libmerged	1218461	1218462		YPO_RS06330	1
XXX001.A18956-61_libmerged	1220120	1220124		YPO_RS06340	4
XXX001.A18956-61_libmerged	1221195	1221227		YPO_RS06340	32
XXX001.A18956-61_libmerged	1221601	1221602		YPO_RS06340	1
XXX001.A18956-61_libmerged	1230425	1230434		YPO_RS06400	9
XXX001.A18956-61_libmerged	1230537	1230539		YPO_RS06400	2
XXX001.A18956-61_libmerged	1237283	1237301		YPO_RS06440	18
XXX001.A18956-61_libmerged	1240666	1240682		YPO_RS06465	16
XXX001.A18956-61_libmerged	1240946	1240957		YPO_RS06465	11
XXX001.A18956-61_libmerged	1241019	1241161		YPO_RS06465	142
XXX001.A18956-61_libmerged	1241693	1241697		YPO_RS06465	4
XXX001.A18956-61_libmerged	1241932	1241950		YPO_RS06465	18
XXX001.A18956-61_libmerged	1241988	1242048		YPO_RS06465	60
XXX001.A18956-61_libmerged	1242322	1242395		YPO_RS06470	73
XXX001.A18956-61_libmerged	1242550	1242610		YPO_RS06470	60
XXX001.A18956-61_libmerged	1242769	1242779		YPO_RS06470	10
XXX001.A18956-61_libmerged	1243029	1243062		YPO_RS06470	33
XXX001.A18956-61_libmerged	1243174	1243238		YPO_RS06470	64
XXX001.A18956-61_libmerged	1243484	1243499		YPO_RS06475	15
XXX001.A18956-61_libmerged	1245885	1245889		ssrA	4
XXX001.A18956-61_libmerged	1246805	1246807		YPO_RS06495	2
XXX001.A18956-61_libmerged	1246848	1246865		YPO_RS06495	17
XXX001.A18956-61_libmerged	1251914	1251920		YPO_RS06525	6
XXX001.A18956-61_libmerged	1254868	1254874		sdhA	6
XXX001.A18956-61_libmerged	1260328	1260342		odhB	14
XXX001.A18956-61_libmerged	1269576	1269647		tolA	71
XXX001.A18956-61_libmerged	1269755	1269762		tolA	7
XXX001.A18956-61_libmerged	1271104	1271116		tolB	12
XXX001.A18956-61_libmerged	1277522	1277553		aroG	31
XXX001.A18956-61_libmerged	1280019	1280020		YPO_RS06670	1
XXX001.A18956-61_libmerged	1280073	1280091		YPO_RS06670	18
XXX001.A18956-61_libmerged	1282177	1282183		galM	6
XXX001.A18956-61_libmerged	1285926	1285936		galE	10
XXX001.A18956-61_libmerged	1286121	1286139		galE	18
XXX001.A18956-61_libmerged	1291530	1291534		modA	4
XXX001.A18956-61_libmerged	1292427	1292432		modC	5
XXX001.A18956-61_libmerged	1292479	1292481		modC	2
XXX001.A18956-61_libmerged	1294002	1294015		YPO_RS06745	13
XXX001.A18956-61_libmerged	1297345	1297346		bioB	1
XXX001.A18956-61_libmerged	1307281	1307285		moaA	4
XXX001.A18956-61_libmerged	1308729	1308731		moaE	2
XXX001.A18956-61_libmerged	1311746	1311748		betA	2
XXX001.A18956-61_libmerged	1317108	1317123		YPO_RS06845	15
XXX001.A18956-61_libmerged	1317599	1317621		YPO_RS06850	22
XXX001.A18956-61_libmerged	1318002	1318006		YPO_RS06850	4
XXX001.A18956-61_libmerged	1322145	1322153		YPO_RS06875	8
XXX001.A18956-61_libmerged	1322392	1322403		YPO_RS06875	11
XXX001.A18956-61_libmerged	1322721	1322773		YPO_RS06875	52
XXX001.A18956-61_libmerged	1322818	1322836		YPO_RS06875	18
XXX001.A18956-61_libmerged	1322976	1322988		YPO_RS06875	12
XXX001.A18956-61_libmerged	1324305	1324312		dusC	7
XXX001.A18956-61_libmerged	1329957	1329974		YPO_RS06910	17
XXX001.A18956-61_libmerged	1331046	1331079		phnC	33
XXX001.A18956-61_libmerged	1331243	1331254		phnC	11
XXX001.A18956-61_libmerged	1331478	1331488		phnC	10
XXX001.A18956-61_libmerged	1331643	1331653		phnC	10
XXX001.A18956-61_libmerged	1331718	1331744		phnD	26
XXX001.A18956-61_libmerged	1331874	1331888		phnD	14
XXX001.A18956-61_libmerged	1334490	1334494		phnE	4
XXX001.A18956-61_libmerged	1334763	1334781		YPO_RS06940	18
XXX001.A18956-61_libmerged	1337572	1337585		urtB	13
XXX001.A18956-61_libmerged	1338596	1338610		urtB	14
XXX001.A18956-61_libmerged	1338809	1338816		urtC	7
XXX001.A18956-61_libmerged	1339827	1339831		urtD	4
XXX001.A18956-61_libmerged	1339935	1339939		urtD	4
XXX001.A18956-61_libmerged	1340323	1340325		urtD	2
XXX001.A18956-61_libmerged	1341158	1341167		urtE	9
XXX001.A18956-61_libmerged	1341480	1341505		YPO_RS06970	25
XXX001.A18956-61_libmerged	1342048	1342059		YPO_RS06970	11
XXX001.A18956-61_libmerged	1342767	1342778		YPO_RS06975	11
XXX001.A18956-61_libmerged	1343908	1343917		sseA	9
XXX001.A18956-61_libmerged	1345846	1345856		YPO_RS06985	10
XXX001.A18956-61_libmerged	1346418	1346430		YPO_RS06990	12
XXX001.A18956-61_libmerged	1350154	1350162		adiC	8
XXX001.A18956-61_libmerged	1355599	1355642		ompF2	43
XXX001.A18956-61_libmerged	1357678	1357680		dinG	2
XXX001.A18956-61_libmerged	1374547	1374571		rcsC	24
XXX001.A18956-61_libmerged	1375118	1375122		rcsC	4
XXX001.A18956-61_libmerged	1376895	1376981		rcsB	86
XXX001.A18956-61_libmerged	1377541	1377568		YPO_RS07100	27
XXX001.A18956-61_libmerged	1379099	1379108		rcsD	9
XXX001.A18956-61_libmerged	1382212	1382243		YPO_RS07115	31
XXX001.A18956-61_libmerged	1383252	1383261		YPO_RS07115	9
XXX001.A18956-61_libmerged	1385415	1385420		ampH	5
XXX001.A18956-61_libmerged	1391798	1391800		ycoA	2
XXX001.A18956-61_libmerged	1397841	1397875		YPO_RS07190	34
XXX001.A18956-61_libmerged	1398961	1398996		YPO_RS07195	35
XXX001.A18956-61_libmerged	1406485	1406487		YPO_RS07235	2
XXX001.A18956-61_libmerged	1407096	1407098		YPO_RS07240	2
XXX001.A18956-61_libmerged	1407923	1407928		YPO_RS07250	5
XXX001.A18956-61_libmerged	1410486	1410554		YPO_RS07270	68
XXX001.A18956-61_libmerged	1410738	1410764		YPO_RS07270	26
XXX001.A18956-61_libmerged	1410883	1410884		YPO_RS07270	1
XXX001.A18956-61_libmerged	1411199	1411214		YPO_RS07270	15
XXX001.A18956-61_libmerged	1413159	1413192		YPO_RS07280	33
XXX001.A18956-61_libmerged	1414353	1414376		YPO_RS07285	23
XXX001.A18956-61_libmerged	1424523	1424529		YPO_RS07340	6
XXX001.A18956-61_libmerged	1426903	1426916		yejF	13
XXX001.A18956-61_libmerged	1430138	1430145		YPO_RS07360	7
XXX001.A18956-61_libmerged	1430539	1430563		YPO_RS07360	24
XXX001.A18956-61_libmerged	1431478	1431489		YPO_RS07365	11
XXX001.A18956-61_libmerged	1432773	1432793		YPO_RS07370	20
XXX001.A18956-61_libmerged	1433395	1433402		YPO_RS07370	7
XXX001.A18956-61_libmerged	1433983	1434002		YPO_RS07370	19
XXX001.A18956-61_libmerged	1438661	1438665		YPO_RS07390	4
XXX001.A18956-61_libmerged	1445557	1445563		YPO_RS07420	6
XXX001.A18956-61_libmerged	1445997	1446002		YPO_RS07425	5
XXX001.A18956-61_libmerged	1446374	1446397		YPO_RS07425	23
XXX001.A18956-61_libmerged	1449465	1449472		YPO_RS07435	7
XXX001.A18956-61_libmerged	1450090	1450115		xylB	25
XXX001.A18956-61_libmerged	1450968	1450980		xylB	12
XXX001.A18956-61_libmerged	1451309	1451313		xylB	4
XXX001.A18956-61_libmerged	1452476	1452478		YPO_RS07450	2
XXX001.A18956-61_libmerged	1454599	1454601		YPO_RS07455	2
XXX001.A18956-61_libmerged	1458971	1458972		fruK	1
XXX001.A18956-61_libmerged	1461392	1461409		YPO_RS07485	17
XXX001.A18956-61_libmerged	1461777	1461833		YPO_RS07490	56
XXX001.A18956-61_libmerged	1461905	1461907		YPO_RS07490	2
XXX001.A18956-61_libmerged	1462229	1462231		YPO_RS07490	2
XXX001.A18956-61_libmerged	1463130	1463141		psaA	11
XXX001.A18956-61_libmerged	1463379	1463429		YPO_RS07500	50
XXX001.A18956-61_libmerged	1463576	1463578		YPO_RS07500	2
XXX001.A18956-61_libmerged	1463858	1463888		YPO_RS07500	30
XXX001.A18956-61_libmerged	1463924	1463952		YPO_RS07500	28
XXX001.A18956-61_libmerged	1464899	1464906		psaC	7
XXX001.A18956-61_libmerged	1465307	1465317		psaC	10
XXX001.A18956-61_libmerged	1473112	1473132		YPO_RS07530	20
XXX001.A18956-61_libmerged	1476992	1477011		YPO_RS07545	19
XXX001.A18956-61_libmerged	1477523	1477535		YPO_RS07545	12
XXX001.A18956-61_libmerged	1483603	1483613		YPO_RS07575	10
XXX001.A18956-61_libmerged	1490865	1490871		YPO_RS07605	6
XXX001.A18956-61_libmerged	1493693	1493696		YPO_RS07610	3
XXX001.A18956-61_libmerged	1498750	1498753		potH	3
XXX001.A18956-61_libmerged	1501666	1501697		rlmC	31
XXX001.A18956-61_libmerged	1501752	1501755		rlmC	3
XXX001.A18956-61_libmerged	1505625	1505634		YPO_RS07680	9
XXX001.A18956-61_libmerged	1505975	1505978		YPO_RS07685	3
XXX001.A18956-61_libmerged	1506175	1506201		YPO_RS07685	26
XXX001.A18956-61_libmerged	1506391	1506395		YPO_RS07685	4
XXX001.A18956-61_libmerged	1506487	1506492		YPO_RS07685	5
XXX001.A18956-61_libmerged	1510221	1510238		YPO_RS07710	17
XXX001.A18956-61_libmerged	1510230	1510238		YPO_RS07715	8
XXX001.A18956-61_libmerged	1514440	1514450		artQ	10
XXX001.A18956-61_libmerged	1517044	1517053		YPO_RS07755	9
XXX001.A18956-61_libmerged	1520569	1520581		YPO_RS07770	12
XXX001.A18956-61_libmerged	1530065	1530083		YPO_RS07805	18
XXX001.A18956-61_libmerged	1534071	1534072		macB	1
XXX001.A18956-61_libmerged	1548159	1548167		YPO_RS07870	8
XXX001.A18956-61_libmerged	1551955	1551959		YPO_RS07880	4
XXX001.A18956-61_libmerged	1552299	1552303		YPO_RS07880	4
XXX001.A18956-61_libmerged	1555271	1555287		YPO_RS07890	16
XXX001.A18956-61_libmerged	1557509	1557550		YPO_RS07900	41
XXX001.A18956-61_libmerged	1557640	1557694		YPO_RS07900	54
XXX001.A18956-61_libmerged	1561079	1561080		focA	1
XXX001.A18956-61_libmerged	1563532	1563547		YPO_RS07915	15
XXX001.A18956-61_libmerged	1565880	1565916		YPO_RS07925	36
XXX001.A18956-61_libmerged	1566009	1566024		YPO_RS07925	15
XXX001.A18956-61_libmerged	1566703	1566710		YPO_RS07930	7
XXX001.A18956-61_libmerged	1566896	1566938		YPO_RS07930	42
XXX001.A18956-61_libmerged	1567662	1567686		YPO_RS07930	24
XXX001.A18956-61_libmerged	1567763	1567898		YPO_RS07930	135
XXX001.A18956-61_libmerged	1579358	1579370		lpxK	12
XXX001.A18956-61_libmerged	1579675	1579678		lpxK	3
XXX001.A18956-61_libmerged	1580140	1580151		YPO_RS07975	11
XXX001.A18956-61_libmerged	1580940	1580965		YPO_RS07975	25
XXX001.A18956-61_libmerged	1582805	1582810		YPO_RS07985	5
XXX001.A18956-61_libmerged	1583236	1583244		kdsB	8
XXX001.A18956-61_libmerged	1592691	1592707		mukB	16
XXX001.A18956-61_libmerged	1592973	1592980		mukB	7
XXX001.A18956-61_libmerged	1595729	1595790		ldtD	61
XXX001.A18956-61_libmerged	1596175	1596176		YPO_RS08030	1
XXX001.A18956-61_libmerged	1615550	1615553		pqiA	3
XXX001.A18956-61_libmerged	1615991	1615997		pqiA	6
XXX001.A18956-61_libmerged	1626359	1626373		matP	14
XXX001.A18956-61_libmerged	1628611	1628620		sulA	9
XXX001.A18956-61_libmerged	1632394	1632452		YPO_RS08185	58
XXX001.A18956-61_libmerged	1635761	1635766		YPO_RS08200	5
XXX001.A18956-61_libmerged	1645366	1645370		YPO_RS08245	4
XXX001.A18956-61_libmerged	1646377	1646385		YPO_RS08250	8
XXX001.A18956-61_libmerged	1647598	1647648		YPO_RS08260	50
XXX001.A18956-61_libmerged	1647947	1647948		YPO_RS08260	1
XXX001.A18956-61_libmerged	1648181	1648201		YPO_RS08265	20
XXX001.A18956-61_libmerged	1649993	1650012		YPO_RS08270	19
XXX001.A18956-61_libmerged	1650888	1650931		YPO_RS08275	43
XXX001.A18956-61_libmerged	1652095	1652100		YPO_RS08280	5
XXX001.A18956-61_libmerged	1652102	1652137		YPO_RS08285	35
XXX001.A18956-61_libmerged	1652424	1652430		YPO_RS08285	6
XXX001.A18956-61_libmerged	1653804	1653835		YPO_RS08295	31
XXX001.A18956-61_libmerged	1653883	1653917		YPO_RS08295	34
XXX001.A18956-61_libmerged	1654230	1654245		YPO_RS08300	15
XXX001.A18956-61_libmerged	1655070	1655119		YPO_RS08305	49
XXX001.A18956-61_libmerged	1657140	1657143		tssC	3
XXX001.A18956-61_libmerged	1658762	1658773		tssK	11
XXX001.A18956-61_libmerged	1670159	1670187		YPO_RS08350	28
XXX001.A18956-61_libmerged	1670474	1670617		YPO_RS08355	143
XXX001.A18956-61_libmerged	1670942	1670953		YPO_RS08355	11
XXX001.A18956-61_libmerged	1673336	1673453		YPO_RS08365	117
XXX001.A18956-61_libmerged	1673752	1673845		YPO_RS08365	93
XXX001.A18956-61_libmerged	1674106	1674115		YPO_RS08370	9
XXX001.A18956-61_libmerged	1674222	1674266		YPO_RS08370	44
XXX001.A18956-61_libmerged	1674328	1674354		YPO_RS08370	26
XXX001.A18956-61_libmerged	1680184	1680203		YPO_RS08385	19
XXX001.A18956-61_libmerged	1681262	1681278		YPO_RS08385	16
XXX001.A18956-61_libmerged	1682925	1682930		tssA	5
XXX001.A18956-61_libmerged	1683385	1683447		YPO_RS08395	62
XXX001.A18956-61_libmerged	1683588	1683597		YPO_RS08395	9
XXX001.A18956-61_libmerged	1683829	1683833		YPO_RS08395	4
XXX001.A18956-61_libmerged	1684015	1684025		YPO_RS08395	10
XXX001.A18956-61_libmerged	1684040	1684196		YPO_RS08400	156
XXX001.A18956-61_libmerged	1684412	1684495		YPO_RS08400	83
XXX001.A18956-61_libmerged	1685367	1685370		tssF	3
XXX001.A18956-61_libmerged	1688610	1688654		YPO_RS08425	44
XXX001.A18956-61_libmerged	1689463	1689475		YPO_RS08425	12
XXX001.A18956-61_libmerged	1690194	1690236		YPO_RS08430	42
XXX001.A18956-61_libmerged	1690311	1690322		YPO_RS08430	11
XXX001.A18956-61_libmerged	1690382	1690435		YPO_RS08430	53
XXX001.A18956-61_libmerged	1690615	1690680		YPO_RS08430	65
XXX001.A18956-61_libmerged	1692164	1692171		YPO_RS08435	7
XXX001.A18956-61_libmerged	1692711	1692716		YPO_RS08435	5
XXX001.A18956-61_libmerged	1693418	1693435		YPO_RS08440	17
XXX001.A18956-61_libmerged	1693524	1693533		YPO_RS08440	9
XXX001.A18956-61_libmerged	1693771	1693778		YPO_RS08440	7
XXX001.A18956-61_libmerged	1693869	1693891		YPO_RS08440	22
XXX001.A18956-61_libmerged	1696241	1696243		moeA	2
XXX001.A18956-61_libmerged	1698369	1698384		darE	15
XXX001.A18956-61_libmerged	1698447	1698478		darE	31
XXX001.A18956-61_libmerged	1698546	1698549		darE	3
XXX001.A18956-61_libmerged	1698675	1698733		darE	58
XXX001.A18956-61_libmerged	1699085	1699100		darE	15
XXX001.A18956-61_libmerged	1699165	1699172		darE	7
XXX001.A18956-61_libmerged	1699247	1699261		darD	14
XXX001.A18956-61_libmerged	1699591	1699618		darD	27
XXX001.A18956-61_libmerged	1699851	1699879		darD	28
XXX001.A18956-61_libmerged	1699881	1699890		darC	9
XXX001.A18956-61_libmerged	1700040	1700061		darC	21
XXX001.A18956-61_libmerged	1700299	1700358		darC	59
XXX001.A18956-61_libmerged	1700492	1700502		darC	10
XXX001.A18956-61_libmerged	1700544	1700565		darC	21
XXX001.A18956-61_libmerged	1700653	1700673		darC	20
XXX001.A18956-61_libmerged	1701039	1701054		darC	15
XXX001.A18956-61_libmerged	1701096	1701129		darC	33
XXX001.A18956-61_libmerged	1701260	1701279		darB	19
XXX001.A18956-61_libmerged	1701348	1701390		darB	42
XXX001.A18956-61_libmerged	1701506	1701525		darB	19
XXX001.A18956-61_libmerged	1701761	1701772		darB	11
XXX001.A18956-61_libmerged	1701858	1701867		darB	9
XXX001.A18956-61_libmerged	1702562	1702607		darB	45
XXX001.A18956-61_libmerged	1702642	1702664		darB	22
XXX001.A18956-61_libmerged	1703691	1703737		darA-c	46
XXX001.A18956-61_libmerged	1704105	1704106		fghA	1
XXX001.A18956-61_libmerged	1706502	1706511		YPO_RS08495	9
XXX001.A18956-61_libmerged	1707130	1707141		YPO_RS08495	11
XXX001.A18956-61_libmerged	1707971	1707972		YPO_RS08500	1
XXX001.A18956-61_libmerged	1710323	1710337		YPO_RS08510	14
XXX001.A18956-61_libmerged	1711412	1711419		mglB	7
XXX001.A18956-61_libmerged	1711639	1711641		mglB	2
XXX001.A18956-61_libmerged	1712879	1712890		mglA	11
XXX001.A18956-61_libmerged	1713735	1713743		mglA	8
XXX001.A18956-61_libmerged	1714083	1714084		mglC	1
XXX001.A18956-61_libmerged	1716149	1716150		sanA	1
XXX001.A18956-61_libmerged	1723733	1723745		YPO_RS08560	12
XXX001.A18956-61_libmerged	1725938	1725954		YPO_RS08570	16
XXX001.A18956-61_libmerged	1726238	1726337		YPO_RS08570	99
XXX001.A18956-61_libmerged	1729399	1729406		metG	7
XXX001.A18956-61_libmerged	1733147	1733164		udk	17
XXX001.A18956-61_libmerged	1738532	1738556		fhuF	24
XXX001.A18956-61_libmerged	1738922	1738942		fhuF	20
XXX001.A18956-61_libmerged	1739303	1739386		YPO_RS08625	83
XXX001.A18956-61_libmerged	1741107	1741171		YPO_RS08630	64
XXX001.A18956-61_libmerged	1742592	1742604		YPO_RS08635	12
XXX001.A18956-61_libmerged	1743875	1743876		YPO_RS08640	1
XXX001.A18956-61_libmerged	1748618	1748621		YPO_RS08660	3
XXX001.A18956-61_libmerged	1751045	1751050		YPO_RS08665	5
XXX001.A18956-61_libmerged	1751944	1752014		YPO_RS08670	70
XXX001.A18956-61_libmerged	1752078	1752090		YPO_RS08670	12
XXX001.A18956-61_libmerged	1754237	1754259		galU	22
XXX001.A18956-61_libmerged	1758580	1758583		hisF	3
XXX001.A18956-61_libmerged	1763532	1763556		hisD	24
XXX001.A18956-61_libmerged	1771594	1771609		YPO_RS08765	15
XXX001.A18956-61_libmerged	1773146	1773156		YPO_RS08770	10
XXX001.A18956-61_libmerged	1776458	1776462		YPO_RS08785	4
XXX001.A18956-61_libmerged	1785475	1785483		YPO_RS08815	8
XXX001.A18956-61_libmerged	1788874	1788875		lldD	1
XXX001.A18956-61_libmerged	1789167	1789172		lldD	5
XXX001.A18956-61_libmerged	1793016	1793019		YPO_RS08840	3
XXX001.A18956-61_libmerged	1794366	1794382		YPO_RS08845	16
XXX001.A18956-61_libmerged	1795901	1795962		YPO_RS08855	61
XXX001.A18956-61_libmerged	1796049	1796055		YPO_RS08855	6
XXX001.A18956-61_libmerged	1796159	1796194		YPO_RS08855	35
XXX001.A18956-61_libmerged	1796352	1796364		YPO_RS08855	12
XXX001.A18956-61_libmerged	1796884	1796900		YPO_RS08860	16
XXX001.A18956-61_libmerged	1796967	1796985		YPO_RS08860	18
XXX001.A18956-61_libmerged	1798383	1798391		YPO_RS08870	8
XXX001.A18956-61_libmerged	1798711	1798721		YPO_RS08870	10
XXX001.A18956-61_libmerged	1803543	1803546		YPO_RS08895	3
XXX001.A18956-61_libmerged	1803900	1803935		YPO_RS08900	35
XXX001.A18956-61_libmerged	1806998	1806999		YPO_RS08905	1
XXX001.A18956-61_libmerged	1808326	1808337		bssS	11
XXX001.A18956-61_libmerged	1820324	1820340		plsX	16
XXX001.A18956-61_libmerged	1820862	1820882		plsX	20
XXX001.A18956-61_libmerged	1828724	1828736		mltG	12
XXX001.A18956-61_libmerged	1828933	1828942		YPO_RS09020	9
XXX001.A18956-61_libmerged	1829967	1829980		holB	13
XXX001.A18956-61_libmerged	1830552	1830568		YPO_RS09030	16
XXX001.A18956-61_libmerged	1835882	1835959		YPO_RS09055	77
XXX001.A18956-61_libmerged	1837736	1837755		nagZ	19
XXX001.A18956-61_libmerged	1841809	1841850		YPO_RS09085	41
XXX001.A18956-61_libmerged	1842265	1842280		YPO_RS09090	15
XXX001.A18956-61_libmerged	1851858	1851871		lolD	13
XXX001.A18956-61_libmerged	1857505	1857516		YPO_RS09150	11
XXX001.A18956-61_libmerged	1857951	1857965		YPO_RS09150	14
XXX001.A18956-61_libmerged	1861610	1861614		purB	4
XXX001.A18956-61_libmerged	1864524	1864545		mnmA	21
XXX001.A18956-61_libmerged	1866007	1866015		rluE	8
XXX001.A18956-61_libmerged	1878285	1878342		YPO_RS09250	57
XXX001.A18956-61_libmerged	1882042	1882043		YPO_RS09260	1
XXX001.A18956-61_libmerged	1888563	1888597		mgtA	34
XXX001.A18956-61_libmerged	1888775	1888812		mgtA	37
XXX001.A18956-61_libmerged	1899888	1899895		YPO_RS09320	7
XXX001.A18956-61_libmerged	1901687	1901689		YPO_RS09335	2
XXX001.A18956-61_libmerged	1901989	1902005		YPO_RS09335	16
XXX001.A18956-61_libmerged	1902166	1902181		YPO_RS09335	15
XXX001.A18956-61_libmerged	1903595	1903606		yapJ	11
XXX001.A18956-61_libmerged	1904869	1904872		yapJ	3
XXX001.A18956-61_libmerged	1905787	1905796		yapJ	9
XXX001.A18956-61_libmerged	1907162	1907180		YPO_RS09345	18
XXX001.A18956-61_libmerged	1910655	1910667		YPO_RS09350	12
XXX001.A18956-61_libmerged	1911916	1911920		YPO_RS09355	4
XXX001.A18956-61_libmerged	1918291	1918313		YPO_RS09385	22
XXX001.A18956-61_libmerged	1919051	1919055		YPO_RS09385	4
XXX001.A18956-61_libmerged	1919625	1919669		YPO_RS09390	44
XXX001.A18956-61_libmerged	1921508	1921545		YPO_RS09390	37
XXX001.A18956-61_libmerged	1922623	1922646		YPO_RS09400	23
XXX001.A18956-61_libmerged	1922872	1922899		YPO_RS09400	27
XXX001.A18956-61_libmerged	1924480	1924487		YPO_RS09405	7
XXX001.A18956-61_libmerged	1933829	1933845		YPO_RS09455	16
XXX001.A18956-61_libmerged	1936650	1936665		YPO_RS09460	15
XXX001.A18956-61_libmerged	1938036	1938044		YPO_RS09475	8
XXX001.A18956-61_libmerged	1938346	1938374		YPO_RS09475	28
XXX001.A18956-61_libmerged	1940608	1940654		YPO_RS09480	46
XXX001.A18956-61_libmerged	1941305	1941311		YPO_RS09480	6
XXX001.A18956-61_libmerged	1943980	1943992		proQ	12
XXX001.A18956-61_libmerged	1948904	1948905		YPO_RS09510	1
XXX001.A18956-61_libmerged	1949835	1949837		YPO_RS09515	2
XXX001.A18956-61_libmerged	1949928	1949934		YPO_RS09520	6
XXX001.A18956-61_libmerged	1954387	1954389		YPO_RS09530	2
XXX001.A18956-61_libmerged	1961565	1961596		YPO_RS09560	31
XXX001.A18956-61_libmerged	1963465	1963472		YPO_RS09570	7
XXX001.A18956-61_libmerged	1964066	1964079		YPO_RS09570	13
XXX001.A18956-61_libmerged	1964140	1964158		YPO_RS09570	18
XXX001.A18956-61_libmerged	1967591	1967611		YPO_RS09585	20
XXX001.A18956-61_libmerged	1967668	1967686		YPO_RS09585	18
XXX001.A18956-61_libmerged	1976637	1976644		YPO_RS09630	7
XXX001.A18956-61_libmerged	1976752	1976757		YPO_RS09630	5
XXX001.A18956-61_libmerged	1981310	1981326		YPO_RS09655	16
XXX001.A18956-61_libmerged	1983835	1983858		YPO_RS09675	23
XXX001.A18956-61_libmerged	1985787	1985814		YPO_RS09695	27
XXX001.A18956-61_libmerged	1992193	1992235		YPO_RS09730	42
XXX001.A18956-61_libmerged	1995169	1995170		YPO_RS09745	1
XXX001.A18956-61_libmerged	1996049	1996064		YPO_RS09745	15
XXX001.A18956-61_libmerged	2000334	2000379		YPO_RS09760	45
XXX001.A18956-61_libmerged	2000458	2000491		YPO_RS09760	33
XXX001.A18956-61_libmerged	2002783	2002797		manX	14
XXX001.A18956-61_libmerged	2005260	2005264		YPO_RS09780	4
XXX001.A18956-61_libmerged	2009636	2009641		YPO_RS09800	5
XXX001.A18956-61_libmerged	2010146	2010155		hpaD	9
XXX001.A18956-61_libmerged	2012172	2012228		hpaI	56
XXX001.A18956-61_libmerged	2013555	2013565		hpaX	10
XXX001.A18956-61_libmerged	2015848	2015864		hpaC	16
XXX001.A18956-61_libmerged	2018953	2018954		YPO_RS09845	1
XXX001.A18956-61_libmerged	2021175	2021182		purT	7
XXX001.A18956-61_libmerged	2021311	2021315		purT	4
XXX001.A18956-61_libmerged	2026159	2026163		YPO_RS09885	4
XXX001.A18956-61_libmerged	2027319	2027338		YPO_RS09885	19
XXX001.A18956-61_libmerged	2031372	2031375		copD	3
XXX001.A18956-61_libmerged	2033183	2033191		YPO_RS09920	8
XXX001.A18956-61_libmerged	2033224	2033257		YPO_RS09920	33
XXX001.A18956-61_libmerged	2034412	2034418		flhB	6
XXX001.A18956-61_libmerged	2047215	2047226		YPO_RS09990	11
XXX001.A18956-61_libmerged	2048442	2048443		flgG	1
XXX001.A18956-61_libmerged	2048968	2048978		flgH	10
XXX001.A18956-61_libmerged	2050010	2050030		YPO_RS10010	20
XXX001.A18956-61_libmerged	2051065	2051079		flgJ	14
XXX001.A18956-61_libmerged	2053340	2053344		flgK	4
XXX001.A18956-61_libmerged	2054157	2054158		flgK	1
XXX001.A18956-61_libmerged	2059575	2059576		YPO_RS10040	1
XXX001.A18956-61_libmerged	2060366	2060381		YPO_RS10045	15
XXX001.A18956-61_libmerged	2061398	2061399		YPO_RS10050	1
XXX001.A18956-61_libmerged	2061741	2061744		YPO_RS10050	3
XXX001.A18956-61_libmerged	2062933	2062940		YPO_RS10055	7
XXX001.A18956-61_libmerged	2067281	2067284		fliP	3
XXX001.A18956-61_libmerged	2067961	2067970		fliO	9
XXX001.A18956-61_libmerged	2070373	2070374		YPO_RS10110	1
XXX001.A18956-61_libmerged	2070457	2070486		YPO_RS10110	29
XXX001.A18956-61_libmerged	2072531	2072558		fliI	27
XXX001.A18956-61_libmerged	2072854	2072855		fliI	1
XXX001.A18956-61_libmerged	2078724	2078739		YPO_RS10155	15
XXX001.A18956-61_libmerged	2080233	2080259		YPO_RS10165	26
XXX001.A18956-61_libmerged	2081159	2081176		YPO_RS10170	17
XXX001.A18956-61_libmerged	2081551	2081552		YPO_RS10170	1
XXX001.A18956-61_libmerged	2081675	2081691		YPO_RS10170	16
XXX001.A18956-61_libmerged	2081933	2081950		YPO_RS10170	17
XXX001.A18956-61_libmerged	2083384	2083428		YPO_RS10175	44
XXX001.A18956-61_libmerged	2085116	2085126		fliD	10
XXX001.A18956-61_libmerged	2089516	2089526		fliZ	10
XXX001.A18956-61_libmerged	2090050	2090067		YPO_RS10210	17
XXX001.A18956-61_libmerged	2090843	2090851		YPO_RS10210	8
XXX001.A18956-61_libmerged	2091684	2091700		tcyJ	16
XXX001.A18956-61_libmerged	2092212	2092217		tcyL	5
XXX001.A18956-61_libmerged	2093958	2093976		YPO_RS10235	18
XXX001.A18956-61_libmerged	2104521	2104522		wrbA	1
XXX001.A18956-61_libmerged	2107227	2107231		cycA	4
XXX001.A18956-61_libmerged	2110314	2110355		YPO_RS10295	41
XXX001.A18956-61_libmerged	2112005	2112025		uvrY	20
XXX001.A18956-61_libmerged	2112092	2112101		uvrY	9
XXX001.A18956-61_libmerged	2112783	2112785		uvrC	2
XXX001.A18956-61_libmerged	2113379	2113394		uvrC	15
XXX001.A18956-61_libmerged	2117239	2117240		YPO_RS10350	1
XXX001.A18956-61_libmerged	2117604	2117632		YPO_RS10355	28
XXX001.A18956-61_libmerged	2117740	2117786		YPO_RS10355	46
XXX001.A18956-61_libmerged	2118003	2118045		hcp	42
XXX001.A18956-61_libmerged	2122634	2122673		YPO_RS10395	39
XXX001.A18956-61_libmerged	2123434	2123481		YPO_RS10405	47
XXX001.A18956-61_libmerged	2124144	2124146		YPO_RS10405	2
XXX001.A18956-61_libmerged	2124199	2124210		YPO_RS10405	11
XXX001.A18956-61_libmerged	2126304	2126371		YPO_RS10415	67
XXX001.A18956-61_libmerged	2126473	2126552		YPO_RS10415	79
XXX001.A18956-61_libmerged	2126564	2126588		YPO_RS10420	24
XXX001.A18956-61_libmerged	2126750	2126783		YPO_RS10420	33
XXX001.A18956-61_libmerged	2126880	2126893		YPO_RS10420	13
XXX001.A18956-61_libmerged	2128447	2128448		YPO_RS10430	1
XXX001.A18956-61_libmerged	2138525	2138526		YPO_RS10495	1
XXX001.A18956-61_libmerged	2139280	2139286		YPO_RS10505	6
XXX001.A18956-61_libmerged	2139401	2139413		YPO_RS10505	12
XXX001.A18956-61_libmerged	2143218	2143237		ybtE	19
XXX001.A18956-61_libmerged	2143451	2143460		ybtE	9
XXX001.A18956-61_libmerged	2143863	2143866		ybtE	3
XXX001.A18956-61_libmerged	2144035	2144047		ybtE	12
XXX001.A18956-61_libmerged	2146048	2146055		ybtU	7
XXX001.A18956-61_libmerged	2148516	2148526		irp1	10
XXX001.A18956-61_libmerged	2148601	2148628		irp1	27
XXX001.A18956-61_libmerged	2150857	2150892		irp1	35
XXX001.A18956-61_libmerged	2150982	2150994		irp1	12
XXX001.A18956-61_libmerged	2152389	2152401		irp1	12
XXX001.A18956-61_libmerged	2152649	2152662		irp1	13
XXX001.A18956-61_libmerged	2152802	2152803		irp1	1
XXX001.A18956-61_libmerged	2154414	2154441		irp1	27
XXX001.A18956-61_libmerged	2154525	2154547		irp1	22
XXX001.A18956-61_libmerged	2158217	2158220		irp2	3
XXX001.A18956-61_libmerged	2158467	2158476		irp2	9
XXX001.A18956-61_libmerged	2158692	2158693		irp2	1
XXX001.A18956-61_libmerged	2159318	2159355		irp2	37
XXX001.A18956-61_libmerged	2161520	2161524		irp2	4
XXX001.A18956-61_libmerged	2161620	2161624		irp2	4
XXX001.A18956-61_libmerged	2164472	2164486		ybtP	14
XXX001.A18956-61_libmerged	2164607	2164610		ybtP	3
XXX001.A18956-61_libmerged	2165600	2165606		ybtQ	6
XXX001.A18956-61_libmerged	2165650	2165656		ybtQ	6
XXX001.A18956-61_libmerged	2165819	2165851		ybtQ	32
XXX001.A18956-61_libmerged	2166585	2166621		ybtQ	36
XXX001.A18956-61_libmerged	2167138	2167140		ybtX	2
XXX001.A18956-61_libmerged	2167206	2167215		ybtX	9
XXX001.A18956-61_libmerged	2167684	2167688		ybtX	4
XXX001.A18956-61_libmerged	2171932	2171934		YPO_RS10580	2
XXX001.A18956-61_libmerged	2174320	2174327		YPO_RS10590	7
XXX001.A18956-61_libmerged	2176167	2176201		YPO_RS10590	34
XXX001.A18956-61_libmerged	2178517	2178534		YPO_RS10605	17
XXX001.A18956-61_libmerged	2180006	2180016		YPO_RS10605	10
XXX001.A18956-61_libmerged	2181257	2181265		YPO_RS10610	8
XXX001.A18956-61_libmerged	2182296	2182321		YPO_RS10615	25
XXX001.A18956-61_libmerged	2187795	2187818		YPO_RS10645	23
XXX001.A18956-61_libmerged	2189870	2189879		YPO_RS10655	9
XXX001.A18956-61_libmerged	2191010	2191011		YPO_RS10660	1
XXX001.A18956-61_libmerged	2192682	2192686		nqrE	4
XXX001.A18956-61_libmerged	2195721	2195723		ansP	2
XXX001.A18956-61_libmerged	2200728	2200742		YPO_RS10695	14
XXX001.A18956-61_libmerged	2202442	2202469		YPO_RS10700	27
XXX001.A18956-61_libmerged	2204274	2204280		YPO_RS10705	6
XXX001.A18956-61_libmerged	2207065	2207075		YPO_RS10715	10
XXX001.A18956-61_libmerged	2207756	2207759		YPO_RS10720	3
XXX001.A18956-61_libmerged	2208168	2208182		YPO_RS10720	14
XXX001.A18956-61_libmerged	2211520	2211550		YPO_RS10745	30
XXX001.A18956-61_libmerged	2212736	2212737		YPO_RS10745	1
XXX001.A18956-61_libmerged	2213406	2213411		pgaA	5
XXX001.A18956-61_libmerged	2213682	2213683		pgaA	1
XXX001.A18956-61_libmerged	2213978	2213984		pgaA	6
XXX001.A18956-61_libmerged	2214378	2214397		pgaA	19
XXX001.A18956-61_libmerged	2214766	2214777		pgaA	11
XXX001.A18956-61_libmerged	2218045	2218048		YPO_RS10760	3
XXX001.A18956-61_libmerged	2218350	2218356		YPO_RS10760	6
XXX001.A18956-61_libmerged	2218609	2218612		YPO_RS10760	3
XXX001.A18956-61_libmerged	2219328	2219335		pgaD	7
XXX001.A18956-61_libmerged	2221406	2221407		YPO_RS10775	1
XXX001.A18956-61_libmerged	2229243	2229268		YPO_RS10805	25
XXX001.A18956-61_libmerged	2231667	2231706		astD	39
XXX001.A18956-61_libmerged	2237356	2237374		YPO_RS10835	18
XXX001.A18956-61_libmerged	2243548	2243550		YPO_RS10870	2
XXX001.A18956-61_libmerged	2245069	2245122		YPO_RS10875	53
XXX001.A18956-61_libmerged	2248308	2248326		YPO_RS10885	18
XXX001.A18956-61_libmerged	2249981	2250000		YPO_RS10895	19
XXX001.A18956-61_libmerged	2251900	2251903		YPO_RS10905	3
XXX001.A18956-61_libmerged	2252124	2252125		YPO_RS10905	1
XXX001.A18956-61_libmerged	2253390	2253397		YPO_RS10910	7
XXX001.A18956-61_libmerged	2254332	2254336		YPO_RS10915	4
XXX001.A18956-61_libmerged	2254707	2254730		YPO_RS10915	23
XXX001.A18956-61_libmerged	2255271	2255277		YPO_RS10920	6
XXX001.A18956-61_libmerged	2256125	2256136		YPO_RS10925	11
XXX001.A18956-61_libmerged	2256542	2256548		YPO_RS10925	6
XXX001.A18956-61_libmerged	2258636	2258638		YPO_RS10935	2
XXX001.A18956-61_libmerged	2258962	2258969		YPO_RS10935	7
XXX001.A18956-61_libmerged	2259767	2259774		YPO_RS10935	7
XXX001.A18956-61_libmerged	2261849	2261854		YPO_RS10940	5
XXX001.A18956-61_libmerged	2263322	2263342		YPO_RS10940	20
XXX001.A18956-61_libmerged	2264634	2264637		YPO_RS10950	3
XXX001.A18956-61_libmerged	2265579	2265585		YPO_RS10955	6
XXX001.A18956-61_libmerged	2265683	2265707		YPO_RS10955	24
XXX001.A18956-61_libmerged	2266349	2266356		YPO_RS10965	7
XXX001.A18956-61_libmerged	2266420	2266421		YPO_RS10965	1
XXX001.A18956-61_libmerged	2266696	2266711		YPO_RS10965	15
XXX001.A18956-61_libmerged	2267201	2267218		YPO_RS10965	17
XXX001.A18956-61_libmerged	2267449	2267451		YPO_RS10970	2
XXX001.A18956-61_libmerged	2267645	2267674		YPO_RS10970	29
XXX001.A18956-61_libmerged	2267988	2267998		YPO_RS10970	10
XXX001.A18956-61_libmerged	2268805	2268836		YPO_RS10975	31
XXX001.A18956-61_libmerged	2268883	2268889		YPO_RS10975	6
XXX001.A18956-61_libmerged	2269863	2269889		YPO_RS10980	26
XXX001.A18956-61_libmerged	2272691	2272693		YPO_RS10995	2
XXX001.A18956-61_libmerged	2274981	2274986		YPO_RS11005	5
XXX001.A18956-61_libmerged	2277248	2277303		YPO_RS11015	55
XXX001.A18956-61_libmerged	2277593	2277612		YPO_RS11020	19
XXX001.A18956-61_libmerged	2279416	2279422		YPO_RS11025	6
XXX001.A18956-61_libmerged	2280752	2280770		YPO_RS11035	18
XXX001.A18956-61_libmerged	2282356	2282375		ychF	19
XXX001.A18956-61_libmerged	2286383	2286392		ispE	9
XXX001.A18956-61_libmerged	2287193	2287207		lolB	14
XXX001.A18956-61_libmerged	2288685	2288693		hemA	8
XXX001.A18956-61_libmerged	2294432	2294433		YPO_RS11110	1
XXX001.A18956-61_libmerged	2300020	2300030		YPO_RS11135	10
XXX001.A18956-61_libmerged	2300840	2300862		YPO_RS11140	22
XXX001.A18956-61_libmerged	2303328	2303365		YPO_RS11155	37
XXX001.A18956-61_libmerged	2303915	2303926		YPO_RS11155	11
XXX001.A18956-61_libmerged	2308409	2308413		YPO_RS11185	4
XXX001.A18956-61_libmerged	2311595	2311614		mdtH	19
XXX001.A18956-61_libmerged	2312482	2312495		rimJ	13
XXX001.A18956-61_libmerged	2316453	2316529		YPO_RS11220	76
XXX001.A18956-61_libmerged	2316626	2316635		YPO_RS11220	9
XXX001.A18956-61_libmerged	2317070	2317095		YPO_RS11220	25
XXX001.A18956-61_libmerged	2317132	2317133		YPO_RS11220	1
XXX001.A18956-61_libmerged	2317198	2317205		YPO_RS11220	7
XXX001.A18956-61_libmerged	2317616	2317647		YPO_RS11220	31
XXX001.A18956-61_libmerged	2317853	2317856		YPO_RS11220	3
XXX001.A18956-61_libmerged	2318132	2318160		YPO_RS11225	28
XXX001.A18956-61_libmerged	2318212	2318217		YPO_RS11225	5
XXX001.A18956-61_libmerged	2318832	2318847		YPO_RS11225	15
XXX001.A18956-61_libmerged	2318911	2318930		YPO_RS11225	19
XXX001.A18956-61_libmerged	2318973	2318987		YPO_RS11225	14
XXX001.A18956-61_libmerged	2319121	2319165		YPO_RS11225	44
XXX001.A18956-61_libmerged	2319458	2319551		YPO_RS11225	93
XXX001.A18956-61_libmerged	2319774	2319794		YPO_RS11225	20
XXX001.A18956-61_libmerged	2320017	2320055		YPO_RS11225	38
XXX001.A18956-61_libmerged	2320310	2320314		YPO_RS11225	4
XXX001.A18956-61_libmerged	2320595	2320607		YPO_RS11225	12
XXX001.A18956-61_libmerged	2320747	2320749		YPO_RS11225	2
XXX001.A18956-61_libmerged	2320827	2320828		YPO_RS11225	1
XXX001.A18956-61_libmerged	2322797	2322823		YPO_RS11225	26
XXX001.A18956-61_libmerged	2324794	2324800		argS	6
XXX001.A18956-61_libmerged	2326018	2326021		YPO_RS11235	3
XXX001.A18956-61_libmerged	2327008	2327017		cutC	9
XXX001.A18956-61_libmerged	2328455	2328466		cmoA	11
XXX001.A18956-61_libmerged	2329207	2329224		YPO_RS11255	17
XXX001.A18956-61_libmerged	2333782	2333790		nudB	8
XXX001.A18956-61_libmerged	2335243	2335248		ruvC	5
XXX001.A18956-61_libmerged	2336765	2336777		ruvB	12
XXX001.A18956-61_libmerged	2336816	2336820		ruvB	4
XXX001.A18956-61_libmerged	2341390	2341393		mepM	3
XXX001.A18956-61_libmerged	2345621	2345632		YPO_RS11325	11
XXX001.A18956-61_libmerged	2346381	2346384		zwf	3
XXX001.A18956-61_libmerged	2351010	2351015		YPO_RS11355	5
XXX001.A18956-61_libmerged	2353869	2353874		YPO_RS11370	5
XXX001.A18956-61_libmerged	2354604	2354606		fadD	2
XXX001.A18956-61_libmerged	2355317	2355325		fadD	8
XXX001.A18956-61_libmerged	2369608	2369610		YPO_RS11465	2
XXX001.A18956-61_libmerged	2371867	2371873		YPO_RS11490	6
XXX001.A18956-61_libmerged	2373977	2373988		YPO_RS11500	11
XXX001.A18956-61_libmerged	2374917	2374949		YPO_RS11505	32
XXX001.A18956-61_libmerged	2381198	2381201		YPO_RS11540	3
XXX001.A18956-61_libmerged	2387435	2387444		YPO_RS11590	9
XXX001.A18956-61_libmerged	2395646	2395653		YPO_RS11635	7
XXX001.A18956-61_libmerged	2395770	2395796		YPO_RS11635	26
XXX001.A18956-61_libmerged	2401507	2401541		YPO_RS11665	34
XXX001.A18956-61_libmerged	2401691	2401700		YPO_RS11665	9
XXX001.A18956-61_libmerged	2405307	2405320		YPO_RS11685	13
XXX001.A18956-61_libmerged	2405382	2405387		YPO_RS11685	5
XXX001.A18956-61_libmerged	2406542	2406550		YPO_RS11690	8
XXX001.A18956-61_libmerged	2411801	2411812		nhaB	11
XXX001.A18956-61_libmerged	2413803	2413820		YPO_RS11720	17
XXX001.A18956-61_libmerged	2417797	2417799		YPO_RS11730	2
XXX001.A18956-61_libmerged	2419822	2419850		YPO_RS11740	28
XXX001.A18956-61_libmerged	2420948	2420963		YPO_RS11745	15
XXX001.A18956-61_libmerged	2421035	2421044		YPO_RS11745	9
XXX001.A18956-61_libmerged	2424291	2424296		yeaG	5
XXX001.A18956-61_libmerged	2427693	2427697		gapA	4
XXX001.A18956-61_libmerged	2428797	2428801		msrB	4
XXX001.A18956-61_libmerged	2432817	2432821		sppA	4
XXX001.A18956-61_libmerged	2432927	2432961		sppA	34
XXX001.A18956-61_libmerged	2439580	2439586		YPO_RS11830	6
XXX001.A18956-61_libmerged	2439687	2439695		YPO_RS11830	8
XXX001.A18956-61_libmerged	2439740	2439785		YPO_RS11830	45
XXX001.A18956-61_libmerged	2439884	2439940		YPO_RS11830	56
XXX001.A18956-61_libmerged	2440148	2440259		YPO_RS11830	111
XXX001.A18956-61_libmerged	2440692	2440721		YPO_RS11840	29
XXX001.A18956-61_libmerged	2442332	2442339		YPO_RS11850	7
XXX001.A18956-61_libmerged	2442332	2442343		purU	11
XXX001.A18956-61_libmerged	2442374	2442379		purU	5
XXX001.A18956-61_libmerged	2442602	2442609		purU	7
XXX001.A18956-61_libmerged	2445244	2445294		rssB	50
XXX001.A18956-61_libmerged	2445693	2445712		rssB	19
XXX001.A18956-61_libmerged	2446790	2446853		YPO_RS11870	63
XXX001.A18956-61_libmerged	2449698	2449699		YPO_RS11880	1
XXX001.A18956-61_libmerged	2452637	2452644		adhE	7
XXX001.A18956-61_libmerged	2454758	2454812		adhE	54
XXX001.A18956-61_libmerged	2454881	2454898		adhE	17
XXX001.A18956-61_libmerged	2458226	2458253		oppA	27
XXX001.A18956-61_libmerged	2458449	2458458		oppA	9
XXX001.A18956-61_libmerged	2459399	2459405		oppB	6
XXX001.A18956-61_libmerged	2459509	2459526		oppB	17
XXX001.A18956-61_libmerged	2460815	2460824		oppC	9
XXX001.A18956-61_libmerged	2462147	2462150		YPO_RS11920	3
XXX001.A18956-61_libmerged	2462147	2462156		YPO_RS11925	9
XXX001.A18956-61_libmerged	2462196	2462230		YPO_RS11925	34
XXX001.A18956-61_libmerged	2463709	2463761		YPO_RS11930	52
XXX001.A18956-61_libmerged	2465278	2465328		cls	50
XXX001.A18956-61_libmerged	2467980	2467993		YPO_RS11955	13
XXX001.A18956-61_libmerged	2474854	2474859		YPO_RS12000	5
XXX001.A18956-61_libmerged	2475834	2475868		YPO_RS12005	34
XXX001.A18956-61_libmerged	2476085	2476090		ompW	5
XXX001.A18956-61_libmerged	2480699	2480703		trpCF	4
XXX001.A18956-61_libmerged	2485480	2485508		YPO_RS12055	28
XXX001.A18956-61_libmerged	2485525	2485565		YPO_RS12060	40
XXX001.A18956-61_libmerged	2489383	2489433		sohB	50
XXX001.A18956-61_libmerged	2490370	2490376		YPO_RS12085	6
XXX001.A18956-61_libmerged	2490935	2490945		YPO_RS12090	10
XXX001.A18956-61_libmerged	2491162	2491233		topA	71
XXX001.A18956-61_libmerged	2494983	2495010		cysB	27
XXX001.A18956-61_libmerged	2495431	2495452		YPO_RS12105	21
XXX001.A18956-61_libmerged	2495829	2495981		YPO_RS12105	152
XXX001.A18956-61_libmerged	2496856	2496865		acnA	9
XXX001.A18956-61_libmerged	2498632	2498638		acnA	6
XXX001.A18956-61_libmerged	2498688	2498694		acnA	6
XXX001.A18956-61_libmerged	2499581	2499587		ribA	6
XXX001.A18956-61_libmerged	2501140	2501145		pgpB	5
XXX001.A18956-61_libmerged	2503038	2503089		YPO_RS12135	51
XXX001.A18956-61_libmerged	2508393	2508436		YPO_RS12175	43
XXX001.A18956-61_libmerged	2511504	2511516		YPO_RS12180	12
XXX001.A18956-61_libmerged	2513787	2513804		YPO_RS12185	17
XXX001.A18956-61_libmerged	2514650	2514659		YPO_RS12190	9
XXX001.A18956-61_libmerged	2515047	2515054		YPO_RS12190	7
XXX001.A18956-61_libmerged	2527431	2527435		YPO_RS12245	4
XXX001.A18956-61_libmerged	2529594	2529603		YPO_RS12255	9
XXX001.A18956-61_libmerged	2532845	2532847		YPO_RS12265	2
XXX001.A18956-61_libmerged	2541354	2541360		YPO_RS12300	6
XXX001.A18956-61_libmerged	2541509	2541513		YPO_RS12300	4
XXX001.A18956-61_libmerged	2541698	2541722		YPO_RS12300	24
XXX001.A18956-61_libmerged	2541916	2541933		YPO_RS12300	17
XXX001.A18956-61_libmerged	2543292	2543299		YPO_RS12305	7
XXX001.A18956-61_libmerged	2545580	2545583		fumC	3
XXX001.A18956-61_libmerged	2547625	2547627		YPO_RS12320	2
XXX001.A18956-61_libmerged	2547670	2547671		YPO_RS12320	1
XXX001.A18956-61_libmerged	2548336	2548355		YPO_RS12325	19
XXX001.A18956-61_libmerged	2549033	2549045		YPO_RS12325	12
XXX001.A18956-61_libmerged	2549416	2549447		YPO_RS12330	31
XXX001.A18956-61_libmerged	2549506	2549509		YPO_RS12330	3
XXX001.A18956-61_libmerged	2549729	2549731		YPO_RS12335	2
XXX001.A18956-61_libmerged	2550500	2551537		YPO_RS12340	1037
XXX001.A18956-61_libmerged	2553160	2553166		clcB	6
XXX001.A18956-61_libmerged	2553212	2553251		clcB	39
XXX001.A18956-61_libmerged	2554373	2554633		YPO_RS12355	260
XXX001.A18956-61_libmerged	2554658	2555065		YPO_RS12360	407
XXX001.A18956-61_libmerged	2555162	2555608		YPO_RS12365	446
XXX001.A18956-61_libmerged	2555780	2556832		YPO_RS12370	1052
XXX001.A18956-61_libmerged	2556844	2557161		YPO_RS12375	317
XXX001.A18956-61_libmerged	2557164	2557415		YPO_RS12380	251
XXX001.A18956-61_libmerged	2557451	2557684		YPO_RS12385	233
XXX001.A18956-61_libmerged	2557749	2559461		YPO_RS12390	1712
XXX001.A18956-61_libmerged	2559474	2559761		YPO_RS12395	287
XXX001.A18956-61_libmerged	2559765	2560790		YPO_RS12400	1025
XXX001.A18956-61_libmerged	2560790	2562034		YPO_RS12405	1244
XXX001.A18956-61_libmerged	2562123	2562371		YPO_RS12410	248
XXX001.A18956-61_libmerged	2562568	2562765		YPO_RS12415	197
XXX001.A18956-61_libmerged	2565808	2565866		YPO_RS12435	58
XXX001.A18956-61_libmerged	2565977	2565981		YPO_RS12435	4
XXX001.A18956-61_libmerged	2566522	2566545		YPO_RS12435	23
XXX001.A18956-61_libmerged	2566830	2566839		YPO_RS12435	9
XXX001.A18956-61_libmerged	2566843	2566858		YPO_RS12440	15
XXX001.A18956-61_libmerged	2567280	2567282		YPO_RS12440	2
XXX001.A18956-61_libmerged	2568107	2568169		YPO_RS12445	62
XXX001.A18956-61_libmerged	2569943	2569949		YPO_RS12450	6
XXX001.A18956-61_libmerged	2571564	2571593		YPO_RS12455	29
XXX001.A18956-61_libmerged	2572448	2572452		YPO_RS12455	4
XXX001.A18956-61_libmerged	2573077	2573105		YPO_RS12455	28
XXX001.A18956-61_libmerged	2573754	2573842		YPO_RS12455	88
XXX001.A18956-61_libmerged	2577440	2577478		YPO_RS12465	38
XXX001.A18956-61_libmerged	2577783	2577794		YPO_RS12465	11
XXX001.A18956-61_libmerged	2579771	2579785		ilvB	14
XXX001.A18956-61_libmerged	2580167	2580180		ilvN	13
XXX001.A18956-61_libmerged	2581404	2581405		YPO_RS12490	1
XXX001.A18956-61_libmerged	2582811	2582834		YPO_RS12495	23
XXX001.A18956-61_libmerged	2586151	2586153		ogt	2
XXX001.A18956-61_libmerged	2606353	2606405		asr	52
XXX001.A18956-61_libmerged	2606835	2606839		YPO_RS12590	4
XXX001.A18956-61_libmerged	2609370	2609381		hrpA	11
XXX001.A18956-61_libmerged	2612425	2612428		hrpA	3
XXX001.A18956-61_libmerged	2628368	2628378		ttcA	10
XXX001.A18956-61_libmerged	2629260	2629269		YPO_RS12675	9
XXX001.A18956-61_libmerged	2630107	2630144		YPO_RS12680	37
XXX001.A18956-61_libmerged	2630473	2630530		YPO_RS12680	57
XXX001.A18956-61_libmerged	2631966	2631969		zntB	3
XXX001.A18956-61_libmerged	2640503	2640545		YPO_RS12725	42
XXX001.A18956-61_libmerged	2643663	2643669		pspC	6
XXX001.A18956-61_libmerged	2645905	2645911		pspF	6
XXX001.A18956-61_libmerged	2650593	2650605		sapC	12
XXX001.A18956-61_libmerged	2651249	2651254		sapD	5
XXX001.A18956-61_libmerged	2651314	2651319		sapD	5
XXX001.A18956-61_libmerged	2653352	2653353		YPO_RS12795	1
XXX001.A18956-61_libmerged	2655836	2655859		dtpA	23
XXX001.A18956-61_libmerged	2657876	2657883		YPO_RS12810	7
XXX001.A18956-61_libmerged	2660494	2660505		gstA	11
XXX001.A18956-61_libmerged	2660582	2660588		gstA	6
XXX001.A18956-61_libmerged	2660621	2660636		gstA	15
XXX001.A18956-61_libmerged	2666674	2666698		rovA	24
XXX001.A18956-61_libmerged	2668194	2668207		YPO_RS12865	13
XXX001.A18956-61_libmerged	2669569	2669583		eptA	14
XXX001.A18956-61_libmerged	2669824	2669887		eptA	63
XXX001.A18956-61_libmerged	2670022	2670056		eptA	34
XXX001.A18956-61_libmerged	2670431	2670455		eptA	24
XXX001.A18956-61_libmerged	2672801	2672811		YPO_RS12885	10
XXX001.A18956-61_libmerged	2679519	2679522		YPO_RS12915	3
XXX001.A18956-61_libmerged	2681304	2681325		purR	21
XXX001.A18956-61_libmerged	2681593	2681596		purR	3
XXX001.A18956-61_libmerged	2683013	2683026		YPO_RS12935	13
XXX001.A18956-61_libmerged	2684150	2684153		YPO_RS12940	3
XXX001.A18956-61_libmerged	2686590	2686599		YPO_RS12950	9
XXX001.A18956-61_libmerged	2687091	2687114		YPO_RS12955	23
XXX001.A18956-61_libmerged	2699619	2699651		sufC	32
XXX001.A18956-61_libmerged	2704970	2704988		YPO_RS13040	18
XXX001.A18956-61_libmerged	2711190	2711192		YPO_RS13060	2
XXX001.A18956-61_libmerged	2712071	2712077		YPO_RS13065	6
XXX001.A18956-61_libmerged	2716582	2716610		arnF	28
XXX001.A18956-61_libmerged	2720754	2720760		arnA	6
XXX001.A18956-61_libmerged	2724343	2724349		btuD	6
XXX001.A18956-61_libmerged	2724386	2724393		btuD	7
XXX001.A18956-61_libmerged	2725533	2725534		YPO_RS13130	1
XXX001.A18956-61_libmerged	2725891	2725906		btuC	15
XXX001.A18956-61_libmerged	2727423	2727442		YPO_RS13140	19
XXX001.A18956-61_libmerged	2727776	2727780		ihfA	4
XXX001.A18956-61_libmerged	2738114	2738124		YPO_RS13200	10
XXX001.A18956-61_libmerged	2738742	2738754		yfeA	12
XXX001.A18956-61_libmerged	2743944	2743953		YPO_RS13235	9
XXX001.A18956-61_libmerged	2748756	2748759		YPO_RS13255	3
XXX001.A18956-61_libmerged	2749097	2749126		YPO_RS13255	29
XXX001.A18956-61_libmerged	2749576	2749578		YPO_RS13260	2
XXX001.A18956-61_libmerged	2754449	2754453		YPO_RS13285	4
XXX001.A18956-61_libmerged	2754635	2754646		YPO_RS13285	11
XXX001.A18956-61_libmerged	2755057	2755081		YPO_RS13290	24
XXX001.A18956-61_libmerged	2755185	2755188		YPO_RS13290	3
XXX001.A18956-61_libmerged	2755347	2755362		YPO_RS13290	15
XXX001.A18956-61_libmerged	2755413	2755505		YPO_RS13290	92
XXX001.A18956-61_libmerged	2757048	2757065		YPO_RS13300	17
XXX001.A18956-61_libmerged	2760229	2760255		YPO_RS13315	26
XXX001.A18956-61_libmerged	2761973	2761990		csy2	17
XXX001.A18956-61_libmerged	2763391	2763403		csy1	12
XXX001.A18956-61_libmerged	2763742	2763746		csy1	4
XXX001.A18956-61_libmerged	2763974	2763989		csy1	15
XXX001.A18956-61_libmerged	2766972	2766978		cas3f	6
XXX001.A18956-61_libmerged	2767632	2767638		cas3f	6
XXX001.A18956-61_libmerged	2768864	2768869		cas1f	5
XXX001.A18956-61_libmerged	2772125	2772150		YPO_RS13355	25
XXX001.A18956-61_libmerged	2773280	2773286		YPO_RS13360	6
XXX001.A18956-61_libmerged	2773437	2773447		YPO_RS13360	10
XXX001.A18956-61_libmerged	2775595	2775601		YPO_RS13370	6
XXX001.A18956-61_libmerged	2778342	2778357		YPO_RS13380	15
XXX001.A18956-61_libmerged	2781032	2781038		YPO_RS13390	6
XXX001.A18956-61_libmerged	2784078	2784097		YPO_RS13405	19
XXX001.A18956-61_libmerged	2784346	2784353		YPO_RS13405	7
XXX001.A18956-61_libmerged	2784779	2784904		YPO_RS13410	125
XXX001.A18956-61_libmerged	2785306	2785319		YPO_RS13415	13
XXX001.A18956-61_libmerged	2785399	2785458		YPO_RS13415	59
XXX001.A18956-61_libmerged	2786704	2786710		YPO_RS13430	6
XXX001.A18956-61_libmerged	2788771	2788822		YPO_RS13435	51
XXX001.A18956-61_libmerged	2788883	2788906		YPO_RS13435	23
XXX001.A18956-61_libmerged	2789702	2789709		YPO_RS13445	7
XXX001.A18956-61_libmerged	2789797	2789848		YPO_RS13445	51
XXX001.A18956-61_libmerged	2789893	2789923		YPO_RS13445	30
XXX001.A18956-61_libmerged	2790058	2790121		YPO_RS13445	63
XXX001.A18956-61_libmerged	2790123	2790132		cdiA	9
XXX001.A18956-61_libmerged	2792615	2792620		cdiA	5
XXX001.A18956-61_libmerged	2794599	2794605		cdiA	6
XXX001.A18956-61_libmerged	2794822	2794823		cdiA	1
XXX001.A18956-61_libmerged	2796566	2796568		cdiA	2
XXX001.A18956-61_libmerged	2799518	2799540		YPO_RS13455	22
XXX001.A18956-61_libmerged	2800279	2800281		YPO_RS13460	2
XXX001.A18956-61_libmerged	2802542	2802573		YPO_RS13470	31
XXX001.A18956-61_libmerged	2804999	2805000		YPO_RS13475	1
XXX001.A18956-61_libmerged	2807809	2807816		YPO_RS13485	7
XXX001.A18956-61_libmerged	2807869	2807879		YPO_RS13485	10
XXX001.A18956-61_libmerged	2807954	2807969		YPO_RS13485	15
XXX001.A18956-61_libmerged	2808834	2808841		YPO_RS13490	7
XXX001.A18956-61_libmerged	2813926	2813986		YPO_RS13510	60
XXX001.A18956-61_libmerged	2814038	2814059		YPO_RS13510	21
XXX001.A18956-61_libmerged	2814182	2814217		YPO_RS13510	35
XXX001.A18956-61_libmerged	2814302	2814330		YPO_RS13510	28
XXX001.A18956-61_libmerged	2814620	2814625		YPO_RS13515	5
XXX001.A18956-61_libmerged	2814860	2814870		YPO_RS13515	10
XXX001.A18956-61_libmerged	2815874	2815880		YPO_RS13520	6
XXX001.A18956-61_libmerged	2818907	2818923		YPO_RS13535	16
XXX001.A18956-61_libmerged	2821046	2821049		YPO_RS13550	3
XXX001.A18956-61_libmerged	2821142	2821149		YPO_RS13550	7
XXX001.A18956-61_libmerged	2826173	2826177		YPO_RS13570	4
XXX001.A18956-61_libmerged	2829869	2829894		rlmF	25
XXX001.A18956-61_libmerged	2830480	2830486		YPO_RS13595	6
XXX001.A18956-61_libmerged	2831177	2831226		ybiB	49
XXX001.A18956-61_libmerged	2838851	2838869		menF	18
XXX001.A18956-61_libmerged	2845068	2845111		YPO_RS13655	43
XXX001.A18956-61_libmerged	2846500	2846515		YPO_RS13660	15
XXX001.A18956-61_libmerged	2853931	2853976		YPO_RS13690	45
XXX001.A18956-61_libmerged	2854044	2854083		YPO_RS13690	39
XXX001.A18956-61_libmerged	2854175	2854204		YPO_RS13690	29
XXX001.A18956-61_libmerged	2854369	2854371		YPO_RS13690	2
XXX001.A18956-61_libmerged	2854651	2854697		YPO_RS13690	46
XXX001.A18956-61_libmerged	2857320	2857331		nuoM	11
XXX001.A18956-61_libmerged	2857704	2857706		nuoM	2
XXX001.A18956-61_libmerged	2860044	2860048		nuoK	4
XXX001.A18956-61_libmerged	2864215	2864221		nuoG	6
XXX001.A18956-61_libmerged	2880453	2880465		ackA	12
XXX001.A18956-61_libmerged	2883219	2883226		pta	7
XXX001.A18956-61_libmerged	2884098	2884110		YPO_RS13805	12
XXX001.A18956-61_libmerged	2885536	2885554		YPO_RS13815	18
XXX001.A18956-61_libmerged	2885596	2885597		YPO_RS13815	1
XXX001.A18956-61_libmerged	2887085	2887086		YPO_RS13825	1
XXX001.A18956-61_libmerged	2898616	2898622		iolD	6
XXX001.A18956-61_libmerged	2899951	2899958		iolD	7
XXX001.A18956-61_libmerged	2902436	2902443		YPO_RS13860	7
XXX001.A18956-61_libmerged	2906293	2906294		YPO_RS13875	1
XXX001.A18956-61_libmerged	2906514	2906520		iolC	6
XXX001.A18956-61_libmerged	2907384	2907408		iolC	24
XXX001.A18956-61_libmerged	2909500	2909509		iolB	9
XXX001.A18956-61_libmerged	2910251	2910290		iolB	39
XXX001.A18956-61_libmerged	2910511	2910514		YPO_RS13895	3
XXX001.A18956-61_libmerged	2911506	2911513		YPO_RS13900	7
XXX001.A18956-61_libmerged	2912813	2912841		YPO_RS13905	28
XXX001.A18956-61_libmerged	2914702	2914711		YPO_RS13920	9
XXX001.A18956-61_libmerged	2915433	2915478		YPO_RS13925	45
XXX001.A18956-61_libmerged	2915570	2915572		YPO_RS13925	2
XXX001.A18956-61_libmerged	2930812	2930813		lptE	1
XXX001.A18956-61_libmerged	2938578	2938584		lnt	6
XXX001.A18956-61_libmerged	2941485	2941496		YPO_RS14055	11
XXX001.A18956-61_libmerged	2947046	2947051		asnB	5
XXX001.A18956-61_libmerged	2954535	2954542		YPO_RS14120	7
XXX001.A18956-61_libmerged	2954869	2954891		YPO_RS14120	22
XXX001.A18956-61_libmerged	2963925	2963928		fur	3
XXX001.A18956-61_libmerged	2964557	2964558		fldA	1
XXX001.A18956-61_libmerged	2971967	2971972		proX	5
XXX001.A18956-61_libmerged	2974055	2974067		proV	12
XXX001.A18956-61_libmerged	2980342	2980346		YPO_RS14235	4
XXX001.A18956-61_libmerged	2980420	2980603		YPO_RS14235	183
XXX001.A18956-61_libmerged	2981725	2981752		YPO_RS14245	27
XXX001.A18956-61_libmerged	2994598	2994605		ureE	7
XXX001.A18956-61_libmerged	2999269	2999281		YPO_RS14330	12
XXX001.A18956-61_libmerged	3000024	3000028		hdeB	4
XXX001.A18956-61_libmerged	3000971	3000979		kch	8
XXX001.A18956-61_libmerged	3001106	3001120		kch	14
XXX001.A18956-61_libmerged	3001330	3001337		kch	7
XXX001.A18956-61_libmerged	3002781	3002789		crcB	8
XXX001.A18956-61_libmerged	3002830	3002833		crcB	3
XXX001.A18956-61_libmerged	3003284	3003305		YPO_RS14355	21
XXX001.A18956-61_libmerged	3006655	3006658		chbR	3
XXX001.A18956-61_libmerged	3009264	3009272		seqA	8
XXX001.A18956-61_libmerged	3010745	3010767		pgm	22
XXX001.A18956-61_libmerged	3013044	3013058		kdpE	14
XXX001.A18956-61_libmerged	3016186	3016188		kdbD	2
XXX001.A18956-61_libmerged	3017899	3017912		kdpB	13
XXX001.A18956-61_libmerged	3021099	3021146		YPO_RS14440	47
XXX001.A18956-61_libmerged	3032105	3032122		ung	17
XXX001.A18956-61_libmerged	3035058	3035069		srmB	11
XXX001.A18956-61_libmerged	3037119	3037120		YPO_RS14530	1
XXX001.A18956-61_libmerged	3037246	3037264		YPO_RS14530	18
XXX001.A18956-61_libmerged	3038349	3038359		nadB	10
XXX001.A18956-61_libmerged	3039613	3039614		rpoE	1
XXX001.A18956-61_libmerged	3042025	3042037		rseC	12
XXX001.A18956-61_libmerged	3042108	3042248		YPO_RS14560	140
XXX001.A18956-61_libmerged	3042376	3042391		YPO_RS14560	15
XXX001.A18956-61_libmerged	3042579	3042598		YPO_RS14560	19
XXX001.A18956-61_libmerged	3042827	3042837		YPO_RS14560	10
XXX001.A18956-61_libmerged	3042902	3042912		YPO_RS14560	10
XXX001.A18956-61_libmerged	3045687	3045711		lepB	24
XXX001.A18956-61_libmerged	3054578	3054582		tssM	4
XXX001.A18956-61_libmerged	3055901	3055909		YPO_RS14610	8
XXX001.A18956-61_libmerged	3056165	3056199		YPO_RS14610	34
XXX001.A18956-61_libmerged	3063294	3063313		YPO_RS14645	19
XXX001.A18956-61_libmerged	3065876	3065880		YPO_RS14660	4
XXX001.A18956-61_libmerged	3066643	3066660		ccmA	17
XXX001.A18956-61_libmerged	3072306	3072325		YPO_RS14700	19
XXX001.A18956-61_libmerged	3084877	3084878		mepA	1
XXX001.A18956-61_libmerged	3097091	3097093		YPO_RS14805	2
XXX001.A18956-61_libmerged	3102358	3102362		accD	4
XXX001.A18956-61_libmerged	3106712	3106720		purF	8
XXX001.A18956-61_libmerged	3110775	3110782		YPO_RS14875	7
XXX001.A18956-61_libmerged	3115042	3115046		yfcE	4
XXX001.A18956-61_libmerged	3115557	3115566		yfcD	9
XXX001.A18956-61_libmerged	3117067	3117072		YPO_RS14905	5
XXX001.A18956-61_libmerged	3121234	3121258		YPO_RS14925	24
XXX001.A18956-61_libmerged	3121589	3121630		YPO_RS14925	41
XXX001.A18956-61_libmerged	3121670	3121679		YPO_RS14925	9
XXX001.A18956-61_libmerged	3122348	3122365		YPO_RS14930	17
XXX001.A18956-61_libmerged	3122914	3122925		YPO_RS14935	11
XXX001.A18956-61_libmerged	3123130	3123134		YPO_RS14940	4
XXX001.A18956-61_libmerged	3123312	3123326		YPO_RS14940	14
XXX001.A18956-61_libmerged	3123415	3123446		YPO_RS14940	31
XXX001.A18956-61_libmerged	3123923	3123977		YPO_RS14945	54
XXX001.A18956-61_libmerged	3124106	3124135		YPO_RS14950	29
XXX001.A18956-61_libmerged	3127186	3127226		YPO_RS14960	40
XXX001.A18956-61_libmerged	3130356	3130359		YPO_RS14980	3
XXX001.A18956-61_libmerged	3138564	3138570		YPO_RS15005	6
XXX001.A18956-61_libmerged	3143387	3143405		YPO_RS15030	18
XXX001.A18956-61_libmerged	3144857	3144887		YPO_RS15040	30
XXX001.A18956-61_libmerged	3164198	3164208		ppk1	10
XXX001.A18956-61_libmerged	3165575	3165612		ppk1	37
XXX001.A18956-61_libmerged	3165906	3165919		ppk1	13
XXX001.A18956-61_libmerged	3187402	3187414		YPO_RS15220	12
XXX001.A18956-61_libmerged	3197465	3197504		YPO_RS15265	39
XXX001.A18956-61_libmerged	3197608	3197615		YPO_RS15265	7
XXX001.A18956-61_libmerged	3197815	3197850		YPO_RS15265	35
XXX001.A18956-61_libmerged	3198148	3198160		YPO_RS15270	12
XXX001.A18956-61_libmerged	3200082	3200100		YPO_RS15280	18
XXX001.A18956-61_libmerged	3200200	3200217		YPO_RS15285	17
XXX001.A18956-61_libmerged	3200384	3200432		YPO_RS15285	48
XXX001.A18956-61_libmerged	3200581	3200587		YPO_RS15285	6
XXX001.A18956-61_libmerged	3200732	3200777		YPO_RS15290	45
XXX001.A18956-61_libmerged	3200811	3200900		YPO_RS15290	89
XXX001.A18956-61_libmerged	3200933	3200966		YPO_RS15290	33
XXX001.A18956-61_libmerged	3201041	3201046		YPO_RS15290	5
XXX001.A18956-61_libmerged	3201313	3201336		YPO_RS15295	23
XXX001.A18956-61_libmerged	3201421	3201431		YPO_RS15295	10
XXX001.A18956-61_libmerged	3201491	3201503		YPO_RS15295	12
XXX001.A18956-61_libmerged	3201567	3201686		YPO_RS15300	119
XXX001.A18956-61_libmerged	3201775	3201881		YPO_RS15300	106
XXX001.A18956-61_libmerged	3201943	3201961		YPO_RS15300	18
XXX001.A18956-61_libmerged	3202286	3202306		YPO_RS15305	20
XXX001.A18956-61_libmerged	3202458	3202468		YPO_RS15305	10
XXX001.A18956-61_libmerged	3216187	3216224		rodZ	37
XXX001.A18956-61_libmerged	3221363	3221392		YPO_RS15385	29
XXX001.A18956-61_libmerged	3221777	3221877		YPO_RS15385	100
XXX001.A18956-61_libmerged	3221952	3221971		YPO_RS15385	19
XXX001.A18956-61_libmerged	3222070	3222072		YPO_RS15385	2
XXX001.A18956-61_libmerged	3222322	3222339		YPO_RS15385	17
XXX001.A18956-61_libmerged	3222606	3222651		YPO_RS15385	45
XXX001.A18956-61_libmerged	3223341	3223349		yapA	8
XXX001.A18956-61_libmerged	3223956	3223989		yapA	33
XXX001.A18956-61_libmerged	3228358	3228366		YPO_RS15395	8
XXX001.A18956-61_libmerged	3228565	3228586		YPO_RS15395	21
XXX001.A18956-61_libmerged	3229203	3229210		YPO_RS15395	7
XXX001.A18956-61_libmerged	3229871	3229874		YPO_RS15395	3
XXX001.A18956-61_libmerged	3230076	3230077		YPO_RS15395	1
XXX001.A18956-61_libmerged	3247664	3247672		YPO_RS15490	8
XXX001.A18956-61_libmerged	3248206	3248210		ail	4
XXX001.A18956-61_libmerged	3259129	3259138		YPO_RS15540	9
XXX001.A18956-61_libmerged	3260318	3260369		YPO_RS15550	51
XXX001.A18956-61_libmerged	3262449	3262462		YPO_RS15560	13
XXX001.A18956-61_libmerged	3262673	3262727		YPO_RS15560	54
XXX001.A18956-61_libmerged	3265841	3265855		purL	14
XXX001.A18956-61_libmerged	3269240	3269255		tadA	15
XXX001.A18956-61_libmerged	3278247	3278264		tssK	17
XXX001.A18956-61_libmerged	3282765	3282770		YPO_RS15660	5
XXX001.A18956-61_libmerged	3288011	3288017		YPO_RS15680	6
XXX001.A18956-61_libmerged	3288241	3288242		YPO_RS15680	1
XXX001.A18956-61_libmerged	3294134	3294144		tssF	10
XXX001.A18956-61_libmerged	3295733	3295738		YPO_RS15705	5
XXX001.A18956-61_libmerged	3297264	3297279		YPO_RS15710	15
XXX001.A18956-61_libmerged	3299224	3299235		YPO_RS15720	11
XXX001.A18956-61_libmerged	3302708	3302725		YPO_RS15735	17
XXX001.A18956-61_libmerged	3302773	3302791		YPO_RS15735	18
XXX001.A18956-61_libmerged	3302923	3302941		YPO_RS15735	18
XXX001.A18956-61_libmerged	3307348	3307349		YPO_RS15750	1
XXX001.A18956-61_libmerged	3311861	3311877		YPO_RS15770	16
XXX001.A18956-61_libmerged	3317388	3317389		YPO_RS15790	1
XXX001.A18956-61_libmerged	3320249	3320272		YPO_RS15810	23
XXX001.A18956-61_libmerged	3321727	3321728		YPO_RS15820	1
XXX001.A18956-61_libmerged	3329843	3329848		YPO_RS15860	5
XXX001.A18956-61_libmerged	3340282	3340295		zipA	13
XXX001.A18956-61_libmerged	3342098	3342102		cysK	4
XXX001.A18956-61_libmerged	3342437	3342441		cysK	4
XXX001.A18956-61_libmerged	3348669	3348670		YPO_RS15980	1
XXX001.A18956-61_libmerged	3354128	3354147		YPO_RS15995	19
XXX001.A18956-61_libmerged	3354976	3354981		YPO_RS16000	5
XXX001.A18956-61_libmerged	3355123	3355125		YPO_RS16000	2
XXX001.A18956-61_libmerged	3355434	3355472		YPO_RS16000	38
XXX001.A18956-61_libmerged	3355692	3355704		YPO_RS16000	12
XXX001.A18956-61_libmerged	3356083	3356101		YPO_RS16010	18
XXX001.A18956-61_libmerged	3356136	3356165		YPO_RS16010	29
XXX001.A18956-61_libmerged	3356905	3356907		YPO_RS16010	2
XXX001.A18956-61_libmerged	3356949	3356983		YPO_RS16010	34
XXX001.A18956-61_libmerged	3357139	3357167		YPO_RS16015	28
XXX001.A18956-61_libmerged	3357272	3357291		YPO_RS16015	19
XXX001.A18956-61_libmerged	3363701	3363791		YPO_RS16040	90
XXX001.A18956-61_libmerged	3363835	3363838		YPO_RS16040	3
XXX001.A18956-61_libmerged	3364192	3364299		YPO_RS16040	107
XXX001.A18956-61_libmerged	3364346	3364389		YPO_RS16040	43
XXX001.A18956-61_libmerged	3364663	3364737		YPO_RS16040	74
XXX001.A18956-61_libmerged	3365334	3365347		cysM	13
XXX001.A18956-61_libmerged	3372721	3372745		YPO_RS16075	24
XXX001.A18956-61_libmerged	3381105	3381112		yapL	7
XXX001.A18956-61_libmerged	3382583	3382590		yapL	7
XXX001.A18956-61_libmerged	3383532	3383584		YPO_RS16125	52
XXX001.A18956-61_libmerged	3383647	3383678		YPO_RS16125	31
XXX001.A18956-61_libmerged	3383744	3383751		YPO_RS16125	7
XXX001.A18956-61_libmerged	3383804	3383808		YPO_RS16125	4
XXX001.A18956-61_libmerged	3383840	3383881		YPO_RS16125	41
XXX001.A18956-61_libmerged	3385908	3385942		hemF	34
XXX001.A18956-61_libmerged	3389641	3389662		nudK	21
XXX001.A18956-61_libmerged	3389929	3389931		napC	2
XXX001.A18956-61_libmerged	3393385	3393390		napA	5
XXX001.A18956-61_libmerged	3402530	3402539		YPO_RS16205	9
XXX001.A18956-61_libmerged	3402895	3402909		YPO_RS16205	14
XXX001.A18956-61_libmerged	3403108	3403121		YPO_RS16205	13
XXX001.A18956-61_libmerged	3403235	3403268		YPO_RS16210	33
XXX001.A18956-61_libmerged	3403410	3403436		YPO_RS16210	26
XXX001.A18956-61_libmerged	3405648	3405662		YPO_RS16220	14
XXX001.A18956-61_libmerged	3406074	3406076		YPO_RS16220	2
XXX001.A18956-61_libmerged	3409394	3409401		YPO_RS16230	7
XXX001.A18956-61_libmerged	3411961	3412013		YPO_RS16250	52
XXX001.A18956-61_libmerged	3416072	3416075		YPO_RS16270	3
XXX001.A18956-61_libmerged	3422070	3422107		YPO_RS16305	37
XXX001.A18956-61_libmerged	3426934	3426943		hda	9
XXX001.A18956-61_libmerged	3430265	3430277		ppiB	12
XXX001.A18956-61_libmerged	3445969	3445976		ybaK	7
XXX001.A18956-61_libmerged	3449784	3449798		YPO_RS16425	14
XXX001.A18956-61_libmerged	3451134	3451149		YPO_RS16430	15
XXX001.A18956-61_libmerged	3452889	3452893		YPO_RS16435	4
XXX001.A18956-61_libmerged	3454017	3454025		fepE	8
XXX001.A18956-61_libmerged	3454267	3454278		fepE	11
XXX001.A18956-61_libmerged	3454575	3454582		fepE	7
XXX001.A18956-61_libmerged	3454809	3454851		fepE	42
XXX001.A18956-61_libmerged	3455009	3455039		cpsG	30
XXX001.A18956-61_libmerged	3455134	3455136		cpsG	2
XXX001.A18956-61_libmerged	3455563	3455602		cpsG	39
XXX001.A18956-61_libmerged	3455798	3455815		cpsG	17
XXX001.A18956-61_libmerged	3455946	3455950		cpsG	4
XXX001.A18956-61_libmerged	3456244	3456254		cpsG	10
XXX001.A18956-61_libmerged	3456549	3456580		YPO_RS16450	31
XXX001.A18956-61_libmerged	3456614	3456681		YPO_RS16450	67
XXX001.A18956-61_libmerged	3456720	3456781		YPO_RS16450	61
XXX001.A18956-61_libmerged	3456943	3456955		YPO_RS16450	12
XXX001.A18956-61_libmerged	3457106	3457109		YPO_RS16450	3
XXX001.A18956-61_libmerged	3457643	3457668		YPO_RS16455	25
XXX001.A18956-61_libmerged	3460846	3460856		YPO_RS16470	10
XXX001.A18956-61_libmerged	3461352	3461360		YPO_RS16470	8
XXX001.A18956-61_libmerged	3461641	3461705		YPO_RS16470	64
XXX001.A18956-61_libmerged	3461828	3461854		YPO_RS16470	26
XXX001.A18956-61_libmerged	3463321	3463335		YPO_RS16480	14
XXX001.A18956-61_libmerged	3463451	3463497		YPO_RS16480	46
XXX001.A18956-61_libmerged	3463701	3463829		YPO_RS16480	128
XXX001.A18956-61_libmerged	3463888	3463978		YPO_RS16480	90
XXX001.A18956-61_libmerged	3464128	3464177		YPO_RS16480	49
XXX001.A18956-61_libmerged	3464432	3464463		YPO_RS16480	31
XXX001.A18956-61_libmerged	3464843	3464873		YPO_RS16485	30
XXX001.A18956-61_libmerged	3465018	3465124		YPO_RS16485	106
XXX001.A18956-61_libmerged	3465315	3465337		YPO_RS16485	22
XXX001.A18956-61_libmerged	3465427	3465556		YPO_RS16485	129
XXX001.A18956-61_libmerged	3465567	3465608		YPO_RS16490	41
XXX001.A18956-61_libmerged	3465706	3465707		YPO_RS16490	1
XXX001.A18956-61_libmerged	3465944	3465954		YPO_RS16490	10
XXX001.A18956-61_libmerged	3466026	3466039		YPO_RS16490	13
XXX001.A18956-61_libmerged	3466269	3466467		YPO_RS16490	198
XXX001.A18956-61_libmerged	3466556	3466671		YPO_RS16490	115
XXX001.A18956-61_libmerged	3466835	3466868		YPO_RS16490	33
XXX001.A18956-61_libmerged	3466984	3467003		YPO_RS16495	19
XXX001.A18956-61_libmerged	3467097	3467105		YPO_RS16495	8
XXX001.A18956-61_libmerged	3467363	3467385		YPO_RS16495	22
XXX001.A18956-61_libmerged	3467517	3467518		YPO_RS16495	1
XXX001.A18956-61_libmerged	3467689	3467700		YPO_RS16495	11
XXX001.A18956-61_libmerged	3468553	3468564		YPO_RS16500	11
XXX001.A18956-61_libmerged	3468683	3468721		YPO_RS16500	38
XXX001.A18956-61_libmerged	3468983	3468989		YPO_RS16500	6
XXX001.A18956-61_libmerged	3469111	3469125		YPO_RS16500	14
XXX001.A18956-61_libmerged	3469610	3469630		rfbH	20
XXX001.A18956-61_libmerged	3472834	3472843		YPO_RS16520	9
XXX001.A18956-61_libmerged	3472937	3472961		YPO_RS16520	24
XXX001.A18956-61_libmerged	3473082	3473086		YPO_RS16520	4
XXX001.A18956-61_libmerged	3476432	3476439		htpG	7
XXX001.A18956-61_libmerged	3479578	3479593		dnaX	15
XXX001.A18956-61_libmerged	3481655	3481696		apt	41
XXX001.A18956-61_libmerged	3482084	3482086		apt	2
XXX001.A18956-61_libmerged	3492269	3492272		YPO_RS16605	3
XXX001.A18956-61_libmerged	3496975	3496977		YPO_RS16620	2
XXX001.A18956-61_libmerged	3506492	3506495		YPO_RS16670	3
XXX001.A18956-61_libmerged	3516250	3516283		hupB	33
XXX001.A18956-61_libmerged	3522665	3522689		tig	24
XXX001.A18956-61_libmerged	3525685	3525687		ampG	2
XXX001.A18956-61_libmerged	3527252	3527267		YPO_RS16755	15
XXX001.A18956-61_libmerged	3536369	3536372		yajL	3
XXX001.A18956-61_libmerged	3537836	3537859		thiI	23
XXX001.A18956-61_libmerged	3539629	3539633		ispA	4
XXX001.A18956-61_libmerged	3543526	3543527		thiL	1
XXX001.A18956-61_libmerged	3546207	3546208		ribD	1
XXX001.A18956-61_libmerged	3547289	3547290		YPO_RS16860	1
XXX001.A18956-61_libmerged	3547337	3547346		YPO_RS16860	9
XXX001.A18956-61_libmerged	3547420	3547559		YPO_RS16860	139
XXX001.A18956-61_libmerged	3547566	3547567		YPO_RS16860	1
XXX001.A18956-61_libmerged	3548025	3548139		YPO_RS16865	114
XXX001.A18956-61_libmerged	3551059	3551066		secD	7
XXX001.A18956-61_libmerged	3551999	3552011		secD	12
XXX001.A18956-61_libmerged	3560428	3560436		YPO_RS16925	8
XXX001.A18956-61_libmerged	3564373	3564376		brnQ	3
XXX001.A18956-61_libmerged	3565307	3565308		brnQ	1
XXX001.A18956-61_libmerged	3568270	3568297		phoR	27
XXX001.A18956-61_libmerged	3569065	3569103		phoB	38
XXX001.A18956-61_libmerged	3572100	3572104		YPO_RS16965	4
XXX001.A18956-61_libmerged	3582761	3582762		YPO_RS17005	1
XXX001.A18956-61_libmerged	3583053	3583082		YPO_RS17010	29
XXX001.A18956-61_libmerged	3590106	3590128		YPO_RS17045	22
XXX001.A18956-61_libmerged	3592416	3592539		YPO_RS17055	123
XXX001.A18956-61_libmerged	3592641	3592648		YPO_RS17055	7
XXX001.A18956-61_libmerged	3592928	3592932		YPO_RS17055	4
XXX001.A18956-61_libmerged	3593003	3593101		YPO_RS17055	98
XXX001.A18956-61_libmerged	3598163	3598165		YPO_RS17070	2
XXX001.A18956-61_libmerged	3600208	3600212		YPO_RS17080	4
XXX001.A18956-61_libmerged	3602979	3603015		YPO_RS17095	36
XXX001.A18956-61_libmerged	3606469	3606471		YPO_RS17110	2
XXX001.A18956-61_libmerged	3613238	3613246		YPO_RS17140	8
XXX001.A18956-61_libmerged	3614517	3614550		YPO_RS17140	33
XXX001.A18956-61_libmerged	3616544	3616570		YPO_RS17145	26
XXX001.A18956-61_libmerged	3616765	3616776		YPO_RS17145	11
XXX001.A18956-61_libmerged	3617445	3617449		YPO_RS17145	4
XXX001.A18956-61_libmerged	3617588	3617646		YPO_RS17145	58
XXX001.A18956-61_libmerged	3618863	3618900		YPO_RS17145	37
XXX001.A18956-61_libmerged	3619195	3619196		YPO_RS17145	1
XXX001.A18956-61_libmerged	3619498	3619510		YPO_RS17145	12
XXX001.A18956-61_libmerged	3620030	3620040		YPO_RS17145	10
XXX001.A18956-61_libmerged	3629916	3629940		YPO_RS17195	24
XXX001.A18956-61_libmerged	3631391	3631404		YPO_RS17205	13
XXX001.A18956-61_libmerged	3633581	3633614		YPO_RS17215	33
XXX001.A18956-61_libmerged	3635297	3635307		YPO_RS17225	10
XXX001.A18956-61_libmerged	3643001	3643027		trxC	26
XXX001.A18956-61_libmerged	3644359	3644385		YPO_RS17270	26
XXX001.A18956-61_libmerged	3646246	3646255		YPO_RS17270	9
XXX001.A18956-61_libmerged	3649935	3649939		YPO_RS17290	4
XXX001.A18956-61_libmerged	3665927	3665943		tyrA	16
XXX001.A18956-61_libmerged	3672978	3673005		trmD	27
XXX001.A18956-61_libmerged	3682300	3682304		YPO_RS17455	4
XXX001.A18956-61_libmerged	3685848	3685853		alaS	5
XXX001.A18956-61_libmerged	3693044	3693060		YPO_RS17515	16
XXX001.A18956-61_libmerged	3701185	3701200		YPO_RS17550	15
XXX001.A18956-61_libmerged	3701889	3701907		katG	18
XXX001.A18956-61_libmerged	3703101	3703102		katG	1
XXX001.A18956-61_libmerged	3705008	3705022		cybB	14
XXX001.A18956-61_libmerged	3710929	3710930		YPO_RS17590	1
XXX001.A18956-61_libmerged	3712146	3712157		YPO_RS17595	11
XXX001.A18956-61_libmerged	3720282	3720308		YPO_RS17630	26
XXX001.A18956-61_libmerged	3728646	3728673		YPO_RS17660	27
XXX001.A18956-61_libmerged	3731749	3731801		YPO_RS17675	52
XXX001.A18956-61_libmerged	3732054	3732079		YPO_RS17680	25
XXX001.A18956-61_libmerged	3735179	3735184		YPO_RS17695	5
XXX001.A18956-61_libmerged	3746093	3746097		nlpD	4
XXX001.A18956-61_libmerged	3754884	3754887		cobA	3
XXX001.A18956-61_libmerged	3756243	3756276		YPO_RS17795	33
XXX001.A18956-61_libmerged	3758323	3758325		cysI	2
XXX001.A18956-61_libmerged	3759110	3759123		cysI	13
XXX001.A18956-61_libmerged	3759712	3759713		cysI	1
XXX001.A18956-61_libmerged	3768914	3768927		relA	13
XXX001.A18956-61_libmerged	3769298	3769302		relA	4
XXX001.A18956-61_libmerged	3770694	3770695		relA	1
XXX001.A18956-61_libmerged	3773777	3773782		barA	5
XXX001.A18956-61_libmerged	3775792	3775798		degP	6
XXX001.A18956-61_libmerged	3782922	3782924		hemL	2
XXX001.A18956-61_libmerged	3790991	3790999		hrpB	8
XXX001.A18956-61_libmerged	3796321	3796331		gluQRS	10
XXX001.A18956-61_libmerged	3799957	3799968		panB	11
XXX001.A18956-61_libmerged	3800362	3800364		panC	2
XXX001.A18956-61_libmerged	3804674	3804690		YPO_RS18000	16
XXX001.A18956-61_libmerged	3809804	3809821		speE	17
XXX001.A18956-61_libmerged	3819405	3819412		aceF	7
XXX001.A18956-61_libmerged	3820301	3820311		aceE	10
XXX001.A18956-61_libmerged	3827750	3827764		ampD	14
XXX001.A18956-61_libmerged	3835002	3835058		coaE	56
XXX001.A18956-61_libmerged	3842687	3842703		YPO_RS18155	16
XXX001.A18956-61_libmerged	3848215	3848224		YPO_RS18180	9
XXX001.A18956-61_libmerged	3859735	3859743		YPO_RS18225	8
XXX001.A18956-61_libmerged	3870458	3870460		phnM	2
XXX001.A18956-61_libmerged	3878247	3878266		YPO_RS18325	19
XXX001.A18956-61_libmerged	3888499	3888503		YPO_RS18370	4
XXX001.A18956-61_libmerged	3903566	3903573		truB	7
XXX001.A18956-61_libmerged	3906338	3906379		infB	41
XXX001.A18956-61_libmerged	3911555	3911573		folP	18
XXX001.A18956-61_libmerged	3914191	3914224		rlmE	33
XXX001.A18956-61_libmerged	3948544	3948548		rpsR	4
XXX001.A18956-61_libmerged	3949237	3949240		rpsF	3
XXX001.A18956-61_libmerged	3949711	3949731		yjfP	20
XXX001.A18956-61_libmerged	3960455	3960475		yraP	20
XXX001.A18956-61_libmerged	3963593	3963604		arcB	11
XXX001.A18956-61_libmerged	3963730	3963732		arcB	2
XXX001.A18956-61_libmerged	3968461	3968471		gltB	10
XXX001.A18956-61_libmerged	3983697	3983713		ibaG	16
XXX001.A18956-61_libmerged	3987767	3987771		YPO_RS18850	4
XXX001.A18956-61_libmerged	3990500	3990507		kdsC	7
XXX001.A18956-61_libmerged	4005934	4005935		tssK	1
XXX001.A18956-61_libmerged	4006707	4006710		YPO_RS18960	3
XXX001.A18956-61_libmerged	4011524	4011563		tssA	39
XXX001.A18956-61_libmerged	4012871	4012878		tssM	7
XXX001.A18956-61_libmerged	4020008	4020013		YPO_RS19005	5
XXX001.A18956-61_libmerged	4024707	4024756		YPO_RS19020	49
XXX001.A18956-61_libmerged	4026652	4026666		YPO_RS19045	14
XXX001.A18956-61_libmerged	4029420	4029430		YPO_RS19055	10
XXX001.A18956-61_libmerged	4033538	4033566		YPO_RS19055	28
XXX001.A18956-61_libmerged	4033609	4033631		YPO_RS19060	22
XXX001.A18956-61_libmerged	4033779	4033820		YPO_RS19060	41
XXX001.A18956-61_libmerged	4033956	4033967		YPO_RS19060	11
XXX001.A18956-61_libmerged	4034648	4034713		YPO_RS19065	65
XXX001.A18956-61_libmerged	4043090	4043103		ssuD	13
XXX001.A18956-61_libmerged	4074055	4074059		dusB	4
XXX001.A18956-61_libmerged	4078603	4078608		YPO_RS19285	5
XXX001.A18956-61_libmerged	4081762	4081780		msrQ	18
XXX001.A18956-61_libmerged	4082222	4082238		msrQ	16
XXX001.A18956-61_libmerged	4086481	4086483		csrD	2
XXX001.A18956-61_libmerged	4086734	4086744		csrD	10
XXX001.A18956-61_libmerged	4090728	4090734		rng	6
XXX001.A18956-61_libmerged	4098633	4098672		YPO_RS19365	39
XXX001.A18956-61_libmerged	4098722	4098728		YPO_RS19365	6
XXX001.A18956-61_libmerged	4098939	4098959		YPO_RS19365	20
XXX001.A18956-61_libmerged	4099009	4099026		YPO_RS19365	17
XXX001.A18956-61_libmerged	4099382	4099457		YPO_RS19365	75
XXX001.A18956-61_libmerged	4101516	4101535		YPO_RS19370	19
XXX001.A18956-61_libmerged	4101635	4101702		YPO_RS19370	67
XXX001.A18956-61_libmerged	4102137	4102141		YPO_RS19370	4
XXX001.A18956-61_libmerged	4102290	4102304		YPO_RS19370	14
XXX001.A18956-61_libmerged	4104601	4104620		YPO_RS19375	19
XXX001.A18956-61_libmerged	4110143	4110193		YPO_RS19390	50
XXX001.A18956-61_libmerged	4112685	4112799		YPO_RS19400	114
XXX001.A18956-61_libmerged	4112923	4112933		YPO_RS19400	10
XXX001.A18956-61_libmerged	4113360	4113372		YPO_RS19400	12
XXX001.A18956-61_libmerged	4113675	4113683		YPO_RS19400	8
XXX001.A18956-61_libmerged	4114018	4114076		YPO_RS19405	58
XXX001.A18956-61_libmerged	4114115	4114118		YPO_RS19405	3
XXX001.A18956-61_libmerged	4114193	4114227		YPO_RS19405	34
XXX001.A18956-61_libmerged	4116743	4116851		YPO_RS19410	108
XXX001.A18956-61_libmerged	4117184	4117210		YPO_RS19410	26
XXX001.A18956-61_libmerged	4117268	4117332		YPO_RS19410	64
XXX001.A18956-61_libmerged	4117511	4117529		YPO_RS19410	18
XXX001.A18956-61_libmerged	4117798	4117808		aaeR	10
XXX001.A18956-61_libmerged	4121402	4121411		aaeB	9
XXX001.A18956-61_libmerged	4125247	4125262		YPO_RS19450	15
XXX001.A18956-61_libmerged	4127405	4127417		YPO_RS19460	12
XXX001.A18956-61_libmerged	4128918	4128930		rnk	12
XXX001.A18956-61_libmerged	4141133	4141138		tssB	5
XXX001.A18956-61_libmerged	4142770	4142872		YPO_RS19535	102
XXX001.A18956-61_libmerged	4150443	4150449		malF	6
XXX001.A18956-61_libmerged	4152822	4152827		pgi	5
XXX001.A18956-61_libmerged	4156562	4156563		YPO_RS19590	1
XXX001.A18956-61_libmerged	4156646	4156648		YPO_RS19590	2
XXX001.A18956-61_libmerged	4174123	4174150		metA	27
XXX001.A18956-61_libmerged	4176219	4176223		YPO_RS19645	4
XXX001.A18956-61_libmerged	4181773	4181777		purH	4
XXX001.A18956-61_libmerged	4188612	4188617		YPO_RS19705	5
XXX001.A18956-61_libmerged	4206214	4206230		rplL	16
XXX001.A18956-61_libmerged	4215630	4215633		coaA	3
XXX001.A18956-61_libmerged	4216385	4216427		birA	42
XXX001.A18956-61_libmerged	4216590	4216592		birA	2
XXX001.A18956-61_libmerged	4216765	4216798		murB	33
XXX001.A18956-61_libmerged	4217473	4217476		murB	3
XXX001.A18956-61_libmerged	4223144	4223152		YPO_RS19870	8
XXX001.A18956-61_libmerged	4226965	4226966		YPO_RS19900	1
XXX001.A18956-61_libmerged	4232347	4232351		fre	4
XXX001.A18956-61_libmerged	4233914	4233916		ubiD	2
XXX001.A18956-61_libmerged	4235794	4235796		hemB	2
XXX001.A18956-61_libmerged	4242454	4242457		ubiB	3
XXX001.A18956-61_libmerged	4253158	4253173		metE	15
XXX001.A18956-61_libmerged	4263374	4263375		YPO_RS20065	1
XXX001.A18956-61_libmerged	4264085	4264088		YPO_RS20070	3
XXX001.A18956-61_libmerged	4264340	4264382		YPO_RS20070	42
XXX001.A18956-61_libmerged	4268305	4268321		YPO_RS20085	16
XXX001.A18956-61_libmerged	4269655	4269669		YPO_RS20095	14
XXX001.A18956-61_libmerged	4271145	4271150		YPO_RS20105	5
XXX001.A18956-61_libmerged	4280866	4280881		ftsY	15
XXX001.A18956-61_libmerged	4281434	4281436		ftsY	2
XXX001.A18956-61_libmerged	4281818	4281819		rsmD	1
XXX001.A18956-61_libmerged	4282894	4282897		YPO_RS20165	3
XXX001.A18956-61_libmerged	4290090	4290094		glpC	4
XXX001.A18956-61_libmerged	4294558	4294580		glpQ	22
XXX001.A18956-61_libmerged	4313574	4313588		xerC	14
XXX001.A18956-61_libmerged	4315896	4315902		YPO_RS20315	6
XXX001.A18956-61_libmerged	4321404	4321421		hemX	17
XXX001.A18956-61_libmerged	4342702	4342703		rho	1
XXX001.A18956-61_libmerged	4349644	4349687		YPO_RS20480	43
XXX001.A18956-61_libmerged	4349951	4350015		YPO_RS20480	64
XXX001.A18956-61_libmerged	4350130	4350149		YPO_RS20480	19
XXX001.A18956-61_libmerged	4353459	4353460		YPO_RS20495	1
XXX001.A18956-61_libmerged	4353968	4353974		YPO_RS20500	6
XXX001.A18956-61_libmerged	4359333	4359366		YPO_RS20515	33
XXX001.A18956-61_libmerged	4359552	4359553		YPO_RS20515	1
XXX001.A18956-61_libmerged	4360361	4360399		YPO_RS20530	38
XXX001.A18956-61_libmerged	4360705	4360729		YPO_RS20530	24
XXX001.A18956-61_libmerged	4366499	4366529		YPO_RS20560	30
XXX001.A18956-61_libmerged	4367180	4367205		YPO_RS20565	25
XXX001.A18956-61_libmerged	4367712	4367737		YPO_RS20570	25
XXX001.A18956-61_libmerged	4368046	4368072		YPO_RS20575	26
XXX001.A18956-61_libmerged	4368263	4368296		YPO_RS20575	33
XXX001.A18956-61_libmerged	4389733	4389741		YPO_RS20670	8
XXX001.A18956-61_libmerged	4389790	4389793		YPO_RS20675	3
XXX001.A18956-61_libmerged	4398338	4398343		YPO_RS20715	5
XXX001.A18956-61_libmerged	4400743	4400794		YPO_RS20725	51
XXX001.A18956-61_libmerged	4401533	4401546		YPO_RS20725	13
XXX001.A18956-61_libmerged	4405587	4405606		YPO_RS20740	19
XXX001.A18956-61_libmerged	4405926	4405965		YPO_RS20745	39
XXX001.A18956-61_libmerged	4406434	4406442		YPO_RS20745	8
XXX001.A18956-61_libmerged	4408299	4408320		YPO_RS20745	21
XXX001.A18956-61_libmerged	4419434	4419459		YPO_RS20780	25
XXX001.A18956-61_libmerged	4420160	4420170		YPO_RS20785	10
XXX001.A18956-61_libmerged	4420162	4420170		YPO_RS20790	8
XXX001.A18956-61_libmerged	4420287	4420303		YPO_RS20790	16
XXX001.A18956-61_libmerged	4434735	4434741		YPO_RS20825	6
XXX001.A18956-61_libmerged	4435713	4435724		YPO_RS20830	11
XXX001.A18956-61_libmerged	4442682	4442686		YPO_RS20830	4
XXX001.A18956-61_libmerged	4443701	4443717		YPO_RS20830	16
XXX001.A18956-61_libmerged	4443998	4444023		YPO_RS20830	25
XXX001.A18956-61_libmerged	4446668	4446674		YPO_RS20855	6
XXX001.A18956-61_libmerged	4446773	4446790		YPO_RS20855	17
XXX001.A18956-61_libmerged	4471648	4471660		gdhA	12
XXX001.A18956-61_libmerged	4474565	4474583		rsmJ	18
XXX001.A18956-61_libmerged	4480636	4480658		YPO_RS21000	22
XXX001.A18956-61_libmerged	4480652	4480658		YPO_RS21005	6
XXX001.A18956-61_libmerged	4480956	4480958		YPO_RS21010	2
XXX001.A18956-61_libmerged	4481965	4481967		YPO_RS21010	2
XXX001.A18956-61_libmerged	4483595	4483656		YPO_RS21020	61
XXX001.A18956-61_libmerged	4483704	4483759		YPO_RS21020	55
XXX001.A18956-61_libmerged	4483804	4483910		YPO_RS21020	106
XXX001.A18956-61_libmerged	4484182	4484237		YPO_RS21025	55
XXX001.A18956-61_libmerged	4484383	4484400		YPO_RS21025	17
XXX001.A18956-61_libmerged	4484439	4484470		YPO_RS21025	31
XXX001.A18956-61_libmerged	4484584	4484599		YPO_RS21025	15
XXX001.A18956-61_libmerged	4484601	4484615		YPO_RS21030	14
XXX001.A18956-61_libmerged	4484977	4485022		YPO_RS21030	45
XXX001.A18956-61_libmerged	4499626	4499632		YPO_RS21075	6
XXX001.A18956-61_libmerged	4502883	4502889		YPO_RS21090	6
XXX001.A18956-61_libmerged	4505789	4505805		hmsP	16
XXX001.A18956-61_libmerged	4514629	4514639		YPO_RS21135	10
XXX001.A18956-61_libmerged	4515993	4515996		YPO_RS21140	3
XXX001.A18956-61_libmerged	4516281	4516344		YPO_RS21140	63
XXX001.A18956-61_libmerged	4516795	4516804		YPO_RS21140	9
XXX001.A18956-61_libmerged	4517265	4517292		YPO_RS21140	27
XXX001.A18956-61_libmerged	4517352	4517373		YPO_RS21140	21
XXX001.A18956-61_libmerged	4519305	4519326		YPO_RS21155	21
XXX001.A18956-61_libmerged	4519691	4519704		YPO_RS21155	13
XXX001.A18956-61_libmerged	4533469	4533485		YPO_RS21205	16
XXX001.A18956-61_libmerged	4533897	4533920		YPO_RS21205	23
XXX001.A18956-61_libmerged	4534345	4534359		YPO_RS21205	14
XXX001.A18956-61_libmerged	4534356	4534363		YPO_RS21210	7
XXX001.A18956-61_libmerged	4534501	4534513		YPO_RS21210	12
XXX001.A18956-61_libmerged	4534644	4534660		YPO_RS21210	16
XXX001.A18956-61_libmerged	4534828	4534899		YPO_RS21210	71
XXX001.A18956-61_libmerged	4540609	4540622		YPO_RS21235	13
XXX001.A18956-61_libmerged	4540619	4540626		YPO_RS21240	7
XXX001.A18956-61_libmerged	4545393	4545397		YPO_RS21280	4
XXX001.A18956-61_libmerged	4545619	4545680		YPO_RS21280	61
XXX001.A18956-61_libmerged	4545802	4545849		YPO_RS21280	47
XXX001.A18956-61_libmerged	4545895	4545928		YPO_RS21280	33
XXX001.A18956-61_libmerged	4546021	4546043		YPO_RS21280	22
XXX001.A18956-61_libmerged	4546296	4546318		YPO_RS21280	22
XXX001.A18956-61_libmerged	4546406	4546423		YPO_RS21280	17
XXX001.A18956-61_libmerged	4546634	4546636		YPO_RS21285	2
XXX001.A18956-61_libmerged	4548030	4548050		YPO_RS21290	20
XXX001.A18956-61_libmerged	4552386	4552401		xylF	15
XXX001.A18956-61_libmerged	4555573	4555588		xylB	15
XXX001.A18956-61_libmerged	4556866	4556869		YPO_RS21325	3
XXX001.A18956-61_libmerged	4558107	4558134		YPO_RS21330	27
XXX001.A18956-61_libmerged	4561520	4561537		YPO_RS21340	17
XXX001.A18956-61_libmerged	4561579	4561602		YPO_RS21340	23
XXX001.A18956-61_libmerged	4561852	4561867		YPO_RS21340	15
XXX001.A18956-61_libmerged	4563873	4563898		YPO_RS21350	25
XXX001.A18956-61_libmerged	4567667	4567694		YPO_RS21370	27
XXX001.A18956-61_libmerged	4567736	4567791		YPO_RS21370	55
XXX001.A18956-61_libmerged	4568466	4568503		YPO_RS21380	37
XXX001.A18956-61_libmerged	4568597	4568618		YPO_RS21380	21
XXX001.A18956-61_libmerged	4568791	4568797		YPO_RS21380	6
XXX001.A18956-61_libmerged	4569626	4569662		selB	36
XXX001.A18956-61_libmerged	4573258	4573261		fdhE	3
XXX001.A18956-61_libmerged	4577778	4577781		fdnG	3
XXX001.A18956-61_libmerged	4581409	4581416		YPO_RS21435	7
XXX001.A18956-61_libmerged	4583339	4583364		YPO_RS21440	25
XXX001.A18956-61_libmerged	4583563	4583604		YPO_RS21440	41
XXX001.A18956-61_libmerged	4596357	4596362		YPO_RS21500	5
XXX001.A18956-61_libmerged	4601624	4601641		YPO_RS21520	17
XXX001.A18956-61_libmerged	4601679	4601716		YPO_RS21520	37
XXX001.A18956-61_libmerged	4601879	4601895		YPO_RS21520	16
XXX001.A18956-61_libmerged	4602017	4602039		YPO_RS21520	22
XXX001.A18956-61_libmerged	4602522	4602533		YPO_RS21525	11
XXX001.A18956-61_libmerged	4621871	4621879		yidC	8
XXX001.A18956-61_libmerged	4625900	4625918		YPO_RS21625	18
XXX001.A18956-61_libmerged	4626277	4626301		YPO_RS21630	24
XXX001.A18956-61_libmerged	4626524	4626527		YPO_RS21635	3
XXX001.A18956-61_libmerged	4627806	4627809		YPO_RS21640	3
XXX001.A18956-61_libmerged	4629420	4629424		YPO_RS21645	4
XXX001.A18956-61_libmerged	4633481	4633509		YPO_RS21670	28
XXX001.A18956-61_libmerged	4634566	4634571		phoU	5
XXX001.A18956-61_libmerged	4635600	4635604		pstA	4
XXX001.A18956-61_libmerged	4651578	4651582		rsmG	4
XXX001.A18956-61_libmerged	4652813	4652819		mnmG	6
XXX001.A18962-69-72_libmerged	4046	4053		ravA	7
XXX001.A18962-69-72_libmerged	9633	9644		YPO_RS01055	11
XXX001.A18962-69-72_libmerged	14916	14917		YPO_RS01080	1
XXX001.A18962-69-72_libmerged	27421	27422		YPO_RS01130	1
XXX001.A18962-69-72_libmerged	28667	28668		yihI	1
XXX001.A18962-69-72_libmerged	29308	29310		hemN	2
XXX001.A18962-69-72_libmerged	33887	33902		glnA	15
XXX001.A18962-69-72_libmerged	41552	41562		fabY	10
XXX001.A18962-69-72_libmerged	46305	46312		gltS	7
XXX001.A18962-69-72_libmerged	48487	48495		recG	8
XXX001.A18962-69-72_libmerged	51094	51107		spoT	13
XXX001.A18962-69-72_libmerged	51472	51480		spoT	8
XXX001.A18962-69-72_libmerged	53816	53829		ligB	13
XXX001.A18962-69-72_libmerged	54064	54068		ligB	4
XXX001.A18962-69-72_libmerged	54147	54154		ligB	7
XXX001.A18962-69-72_libmerged	54677	54692		ligB	15
XXX001.A18962-69-72_libmerged	55080	55088		ligB	8
XXX001.A18962-69-72_libmerged	71595	71596		tdh	1
XXX001.A18962-69-72_libmerged	75052	75061		gpmM	9
XXX001.A18962-69-72_libmerged	81875	81887		ada	12
XXX001.A18962-69-72_libmerged	82071	82095		ada	24
XXX001.A18962-69-72_libmerged	84069	84075		cpxR	6
XXX001.A18962-69-72_libmerged	85574	85585		YPO_RS01415	11
XXX001.A18962-69-72_libmerged	106581	106588		YPO_RS01520	7
XXX001.A18962-69-72_libmerged	108392	108397		YPO_RS01530	5
XXX001.A18962-69-72_libmerged	111306	111316		YPO_RS01540	10
XXX001.A18962-69-72_libmerged	112389	112391		YPO_RS01550	2
XXX001.A18962-69-72_libmerged	114759	114765		hslV	6
XXX001.A18962-69-72_libmerged	114989	114993		hslV	4
XXX001.A18962-69-72_libmerged	116545	116550		cytR	5
XXX001.A18962-69-72_libmerged	118490	118502		priA	12
XXX001.A18962-69-72_libmerged	120922	120924		YPO_RS01585	2
XXX001.A18962-69-72_libmerged	129835	129839		glpG	4
XXX001.A18962-69-72_libmerged	131427	131430		malT	3
XXX001.A18962-69-72_libmerged	133353	133363		malT	10
XXX001.A18962-69-72_libmerged	135777	135780		malP	3
XXX001.A18962-69-72_libmerged	141397	141407		YPO_RS01665	10
XXX001.A18962-69-72_libmerged	141841	141847		YPO_RS01670	6
XXX001.A18962-69-72_libmerged	142605	142606		feoB	1
XXX001.A18962-69-72_libmerged	146522	146537		YPO_RS01685	15
XXX001.A18962-69-72_libmerged	150604	150607		envZ	3
XXX001.A18962-69-72_libmerged	159826	159838		mrcA	12
XXX001.A18962-69-72_libmerged	160339	160347		mrcA	8
XXX001.A18962-69-72_libmerged	166091	166092		aroB	1
XXX001.A18962-69-72_libmerged	166154	166162		aroB	8
XXX001.A18962-69-72_libmerged	176295	176302		YPO_RS01815	7
XXX001.A18962-69-72_libmerged	178408	178415		YPO_RS01820	7
XXX001.A18962-69-72_libmerged	178828	178829		YPO_RS01820	1
XXX001.A18962-69-72_libmerged	182709	182711		YPO_RS01830	2
XXX001.A18962-69-72_libmerged	183892	183902		YPO_RS01835	10
XXX001.A18962-69-72_libmerged	194633	194640		YPO_RS01880	7
XXX001.A18962-69-72_libmerged	196674	196697		YPO_RS01895	23
XXX001.A18962-69-72_libmerged	196801	196803		YPO_RS01895	2
XXX001.A18962-69-72_libmerged	199014	199022		YPO_RS01910	8
XXX001.A18962-69-72_libmerged	202473	202478		tauC	5
XXX001.A18962-69-72_libmerged	203782	203785		tauD	3
XXX001.A18962-69-72_libmerged	209498	209508		kefB	10
XXX001.A18962-69-72_libmerged	232053	232062		secY	9
XXX001.A18962-69-72_libmerged	235889	235892		zntR	3
XXX001.A18962-69-72_libmerged	236448	236486		YPO_RS02185	38
XXX001.A18962-69-72_libmerged	236809	236814		mscL	5
XXX001.A18962-69-72_libmerged	241608	241626		dprA	18
XXX001.A18962-69-72_libmerged	245396	245415		YPO_RS02240	19
XXX001.A18962-69-72_libmerged	248233	248238		YPO_RS02255	5
XXX001.A18962-69-72_libmerged	255269	255285		YPO_RS02280	16
XXX001.A18962-69-72_libmerged	258193	258208		YPO_RS02285	15
XXX001.A18962-69-72_libmerged	258974	258987		YPO_RS02290	13
XXX001.A18962-69-72_libmerged	262518	262523		sctF	5
XXX001.A18962-69-72_libmerged	265956	265962		YPO_RS02340	6
XXX001.A18962-69-72_libmerged	266496	266498		YPO_RS02340	2
XXX001.A18962-69-72_libmerged	267771	267772		YPO_RS02345	1
XXX001.A18962-69-72_libmerged	269656	269658		YPO_RS02360	2
XXX001.A18962-69-72_libmerged	271525	271534		YPO_RS02370	9
XXX001.A18962-69-72_libmerged	271945	271949		sctT	4
XXX001.A18962-69-72_libmerged	272646	272668		YPO_RS02380	22
XXX001.A18962-69-72_libmerged	273979	273988		yedE	9
XXX001.A18962-69-72_libmerged	274971	274978		yedE	7
XXX001.A18962-69-72_libmerged	280647	280652		YPO_RS02415	5
XXX001.A18962-69-72_libmerged	285711	285717		YPO_RS02440	6
XXX001.A18962-69-72_libmerged	288863	288923		YPO_RS02455	60
XXX001.A18962-69-72_libmerged	293605	293608		YPO_RS02480	3
XXX001.A18962-69-72_libmerged	303717	303720		YPO_RS02530	3
XXX001.A18962-69-72_libmerged	305414	305415		YPO_RS02535	1
XXX001.A18962-69-72_libmerged	310923	310925		YPO_RS02555	2
XXX001.A18962-69-72_libmerged	311348	311354		YPO_RS02555	6
XXX001.A18962-69-72_libmerged	311536	311548		YPO_RS02555	12
XXX001.A18962-69-72_libmerged	313948	313961		yapK	13
XXX001.A18962-69-72_libmerged	314205	314231		yapK	26
XXX001.A18962-69-72_libmerged	314454	314462		yapK	8
XXX001.A18962-69-72_libmerged	315056	315128		yapK	72
XXX001.A18962-69-72_libmerged	316990	316997		ubiC	7
XXX001.A18962-69-72_libmerged	317730	317734		ubiA	4
XXX001.A18962-69-72_libmerged	326918	326929		dnaB	11
XXX001.A18962-69-72_libmerged	333158	333160		uvrA	2
XXX001.A18962-69-72_libmerged	335061	335095		ssb1	34
XXX001.A18962-69-72_libmerged	337558	337582		rhaD	24
XXX001.A18962-69-72_libmerged	343661	343663		rhaT	2
XXX001.A18962-69-72_libmerged	345081	345124		YPO_RS02690	43
XXX001.A18962-69-72_libmerged	345953	345955		YPO_RS02695	2
XXX001.A18962-69-72_libmerged	346677	346681		YPO_RS02695	4
XXX001.A18962-69-72_libmerged	346909	346913		YPO_RS02695	4
XXX001.A18962-69-72_libmerged	347660	347673		YPO_RS02695	13
XXX001.A18962-69-72_libmerged	350381	350400		aegA	19
XXX001.A18962-69-72_libmerged	358893	358896		aspA	3
XXX001.A18962-69-72_libmerged	360471	360496		fxsA	25
XXX001.A18962-69-72_libmerged	373629	373631		mscM	2
XXX001.A18962-69-72_libmerged	374180	374201		mscM	21
XXX001.A18962-69-72_libmerged	376044	376092		psd	48
XXX001.A18962-69-72_libmerged	381878	381882		nnr	4
XXX001.A18962-69-72_libmerged	383542	383547		amiB	5
XXX001.A18962-69-72_libmerged	383777	383807		amiB	30
XXX001.A18962-69-72_libmerged	386411	386414		mutL	3
XXX001.A18962-69-72_libmerged	387200	387206		miaA	6
XXX001.A18962-69-72_libmerged	393428	393429		YPO_RS02895	1
XXX001.A18962-69-72_libmerged	396149	396152		rnr	3
XXX001.A18962-69-72_libmerged	399601	399606		YPO_RS02915	5
XXX001.A18962-69-72_libmerged	405282	405289		YPO_RS02945	7
XXX001.A18962-69-72_libmerged	407841	407896		YPO_RS02955	55
XXX001.A18962-69-72_libmerged	408488	408489		YPO_RS02955	1
XXX001.A18962-69-72_libmerged	409419	409420		YPO_RS02960	1
XXX001.A18962-69-72_libmerged	409611	409769		YPO_RS02965	158
XXX001.A18962-69-72_libmerged	409852	409867		YPO_RS02965	15
XXX001.A18962-69-72_libmerged	410071	410084		YPO_RS02965	13
XXX001.A18962-69-72_libmerged	410572	410596		YPO_RS02965	24
XXX001.A18962-69-72_libmerged	410629	410630		YPO_RS02965	1
XXX001.A18962-69-72_libmerged	410857	410891		YPO_RS02965	34
XXX001.A18962-69-72_libmerged	411358	411359		YPO_RS02970	1
XXX001.A18962-69-72_libmerged	413818	413825		YPO_RS02985	7
XXX001.A18962-69-72_libmerged	415640	415642		YPO_RS02990	2
XXX001.A18962-69-72_libmerged	415849	415859		YPO_RS02990	10
XXX001.A18962-69-72_libmerged	416443	416446		YPO_RS02995	3
XXX001.A18962-69-72_libmerged	422200	422228		ptsP	28
XXX001.A18962-69-72_libmerged	425976	425981		lsrF	5
XXX001.A18962-69-72_libmerged	426085	426104		lsrF	19
XXX001.A18962-69-72_libmerged	427342	427343		lsrB	1
XXX001.A18962-69-72_libmerged	431044	431048		lsrA	4
XXX001.A18962-69-72_libmerged	431290	431384		YPO_RS03065	94
XXX001.A18962-69-72_libmerged	440805	440809		YPO_RS03100	4
XXX001.A18962-69-72_libmerged	447860	447861		rsmC	1
XXX001.A18962-69-72_libmerged	449050	449057		YPO_RS03140	7
XXX001.A18962-69-72_libmerged	449186	449190		YPO_RS03140	4
XXX001.A18962-69-72_libmerged	453097	453101		YPO_RS03165	4
XXX001.A18962-69-72_libmerged	453359	453384		YPO_RS03165	25
XXX001.A18962-69-72_libmerged	454634	454642		YPO_RS03170	8
XXX001.A18962-69-72_libmerged	461178	461182		deoD	4
XXX001.A18962-69-72_libmerged	464728	464740		radA	12
XXX001.A18962-69-72_libmerged	470944	470945		YPO_RS03235	1
XXX001.A18962-69-72_libmerged	471528	471530		YPO_RS03235	2
XXX001.A18962-69-72_libmerged	472208	472218		YPO_RS03240	10
XXX001.A18962-69-72_libmerged	474332	474335		YPO_RS03245	3
XXX001.A18962-69-72_libmerged	477479	477484		sltY	5
XXX001.A18962-69-72_libmerged	491642	491643		mog	1
XXX001.A18962-69-72_libmerged	493383	493388		YPO_RS03325	5
XXX001.A18962-69-72_libmerged	494228	494246		YPO_RS03330	18
XXX001.A18962-69-72_libmerged	495055	495064		YPO_RS03330	9
XXX001.A18962-69-72_libmerged	495156	495162		YPO_RS03330	6
XXX001.A18962-69-72_libmerged	495316	495324		YPO_RS03330	8
XXX001.A18962-69-72_libmerged	495368	495403		YPO_RS03330	35
XXX001.A18962-69-72_libmerged	495754	495794		YPO_RS03330	40
XXX001.A18962-69-72_libmerged	497517	497522		dnaK	5
XXX001.A18962-69-72_libmerged	498462	498464		dnaK	2
XXX001.A18962-69-72_libmerged	500835	500840		nhaA	5
XXX001.A18962-69-72_libmerged	501108	501120		nhaA	12
XXX001.A18962-69-72_libmerged	502127	502130		nhaR	3
XXX001.A18962-69-72_libmerged	507636	507642		lspA	6
XXX001.A18962-69-72_libmerged	511403	511417		dapB	14
XXX001.A18962-69-72_libmerged	521134	521140		YPO_RS03450	6
XXX001.A18962-69-72_libmerged	521260	521277		YPO_RS03450	17
XXX001.A18962-69-72_libmerged	539406	539407		tssG	1
XXX001.A18962-69-72_libmerged	540246	540250		tssH	4
XXX001.A18962-69-72_libmerged	540784	540799		tssH	15
XXX001.A18962-69-72_libmerged	541493	541498		tssH	5
XXX001.A18962-69-72_libmerged	541819	541838		tssH	19
XXX001.A18962-69-72_libmerged	541964	541966		tssH	2
XXX001.A18962-69-72_libmerged	542766	542782		vgrG	16
XXX001.A18962-69-72_libmerged	544526	544527		vgrG	1
XXX001.A18962-69-72_libmerged	544645	544646		vgrG	1
XXX001.A18962-69-72_libmerged	547176	547180		YPO_RS03555	4
XXX001.A18962-69-72_libmerged	547460	547465		YPO_RS03555	5
XXX001.A18962-69-72_libmerged	549452	549472		tssJ	20
XXX001.A18962-69-72_libmerged	550690	550691		tssK	1
XXX001.A18962-69-72_libmerged	550794	550814		tssK	20
XXX001.A18962-69-72_libmerged	551797	551811		YPO_RS03580	14
XXX001.A18962-69-72_libmerged	551904	551916		YPO_RS03580	12
XXX001.A18962-69-72_libmerged	552466	552472		YPO_RS03580	6
XXX001.A18962-69-72_libmerged	556958	556964		rapA	6
XXX001.A18962-69-72_libmerged	559476	559480		rapA	4
XXX001.A18962-69-72_libmerged	560313	560315		YPO_RS03600	2
XXX001.A18962-69-72_libmerged	564015	564031		thiQ	16
XXX001.A18962-69-72_libmerged	564627	564628		thiP	1
XXX001.A18962-69-72_libmerged	579549	579553		YPO_RS03675	4
XXX001.A18962-69-72_libmerged	584137	584163		ilvI	26
XXX001.A18962-69-72_libmerged	588409	588413		cra	4
XXX001.A18962-69-72_libmerged	589517	589531		YPO_RS03715	14
XXX001.A18962-69-72_libmerged	592017	592056		YPO_RS03735	39
XXX001.A18962-69-72_libmerged	592187	592198		YPO_RS03735	11
XXX001.A18962-69-72_libmerged	593793	593794		murE	1
XXX001.A18962-69-72_libmerged	594087	594091		murE	4
XXX001.A18962-69-72_libmerged	595226	595229		murF	3
XXX001.A18962-69-72_libmerged	595332	595354		murF	22
XXX001.A18962-69-72_libmerged	596033	596064		murF	31
XXX001.A18962-69-72_libmerged	599252	599255		ftsW	3
XXX001.A18962-69-72_libmerged	600395	600404		murG	9
XXX001.A18962-69-72_libmerged	602105	602106		murC	1
XXX001.A18962-69-72_libmerged	602377	602398		murC	21
XXX001.A18962-69-72_libmerged	602538	602553		murC	15
XXX001.A18962-69-72_libmerged	604433	604440		ftsQ	7
XXX001.A18962-69-72_libmerged	608584	608588		YPO_RS03800	4
XXX001.A18962-69-72_libmerged	610041	610049		secA	8
XXX001.A18962-69-72_libmerged	611737	611744		secA	7
XXX001.A18962-69-72_libmerged	618121	618147		YPO_RS03865	26
XXX001.A18962-69-72_libmerged	618418	618421		YPO_RS03865	3
XXX001.A18962-69-72_libmerged	620902	620915		YPO_RS03880	13
XXX001.A18962-69-72_libmerged	623413	623414		uxaC	1
XXX001.A18962-69-72_libmerged	626925	626930		YPO_RS03895	5
XXX001.A18962-69-72_libmerged	628043	628050		YPO_RS03900	7
XXX001.A18962-69-72_libmerged	629135	629136		sstT	1
XXX001.A18962-69-72_libmerged	629180	629188		sstT	8
XXX001.A18962-69-72_libmerged	633802	633806		yapG	4
XXX001.A18962-69-72_libmerged	634175	634177		yapG	2
XXX001.A18962-69-72_libmerged	635496	635497		yapG	1
XXX001.A18962-69-72_libmerged	637344	637350		YPO_RS03935	6
XXX001.A18962-69-72_libmerged	637690	637716		YPO_RS03935	26
XXX001.A18962-69-72_libmerged	642393	642402		YPO_RS03950	9
XXX001.A18962-69-72_libmerged	642994	643003		YPO_RS03950	9
XXX001.A18962-69-72_libmerged	647607	647610		YPO_RS03975	3
XXX001.A18962-69-72_libmerged	648685	648695		YPO_RS03975	10
XXX001.A18962-69-72_libmerged	649175	649186		YPO_RS03975	11
XXX001.A18962-69-72_libmerged	650540	650574		cdiA	34
XXX001.A18962-69-72_libmerged	650689	650692		cdiA	3
XXX001.A18962-69-72_libmerged	653711	653742		cdiA	31
XXX001.A18962-69-72_libmerged	656690	656699		cdiA	9
XXX001.A18962-69-72_libmerged	656995	656997		cdiA	2
XXX001.A18962-69-72_libmerged	658648	658657		cdiA	9
XXX001.A18962-69-72_libmerged	659374	659401		cdiI	27
XXX001.A18962-69-72_libmerged	660135	660159		YPO_RS04005	24
XXX001.A18962-69-72_libmerged	660479	660482		YPO_RS04010	3
XXX001.A18962-69-72_libmerged	662485	662491		yapF	6
XXX001.A18962-69-72_libmerged	663891	663895		yapF	4
XXX001.A18962-69-72_libmerged	666542	666546		YPO_RS04030	4
XXX001.A18962-69-72_libmerged	667975	667987		YPO_RS04035	12
XXX001.A18962-69-72_libmerged	671103	671108		YPO_RS04040	5
XXX001.A18962-69-72_libmerged	671605	671607		YPO_RS04045	2
XXX001.A18962-69-72_libmerged	672637	672639		YPO_RS04050	2
XXX001.A18962-69-72_libmerged	673938	673941		YPO_RS04055	3
XXX001.A18962-69-72_libmerged	676772	676776		YPO_RS04070	4
XXX001.A18962-69-72_libmerged	680644	680646		YPO_RS04080	2
XXX001.A18962-69-72_libmerged	682398	682406		mdtN	8
XXX001.A18962-69-72_libmerged	684927	684929		YPO_RS04100	2
XXX001.A18962-69-72_libmerged	685262	685271		YPO_RS04100	9
XXX001.A18962-69-72_libmerged	687932	687973		YPO_RS04115	41
XXX001.A18962-69-72_libmerged	696902	696927		YPO_RS04170	25
XXX001.A18962-69-72_libmerged	704985	705033		plsY	48
XXX001.A18962-69-72_libmerged	706735	706737		bacA	2
XXX001.A18962-69-72_libmerged	708563	708578		YPO_RS04230	15
XXX001.A18962-69-72_libmerged	709279	709280		YPO_RS04235	1
XXX001.A18962-69-72_libmerged	709769	709777		YPO_RS04240	8
XXX001.A18962-69-72_libmerged	712105	712112		glnE	7
XXX001.A18962-69-72_libmerged	715080	715081		hldE	1
XXX001.A18962-69-72_libmerged	715877	715878		yjeH	1
XXX001.A18962-69-72_libmerged	719460	719466		ygiD	6
XXX001.A18962-69-72_libmerged	722892	722894		tolC	2
XXX001.A18962-69-72_libmerged	728989	728995		YPO_RS04315	6
XXX001.A18962-69-72_libmerged	730276	730282		YPO_RS04320	6
XXX001.A18962-69-72_libmerged	740212	740215		yqhD	3
XXX001.A18962-69-72_libmerged	741243	741245		YPO_RS04365	2
XXX001.A18962-69-72_libmerged	743879	743886		metC	7
XXX001.A18962-69-72_libmerged	744825	744839		exbB	14
XXX001.A18962-69-72_libmerged	745042	745043		exbB	1
XXX001.A18962-69-72_libmerged	746138	746152		exbD	14
XXX001.A18962-69-72_libmerged	747759	747797		YPO_RS04390	38
XXX001.A18962-69-72_libmerged	749293	749373		YPO_RS04405	80
XXX001.A18962-69-72_libmerged	749624	749644		YPO_RS04405	20
XXX001.A18962-69-72_libmerged	749629	749644		YPO_RS04410	15
XXX001.A18962-69-72_libmerged	750212	750280		YPO_RS04410	68
XXX001.A18962-69-72_libmerged	750471	750534		YPO_RS04415	63
XXX001.A18962-69-72_libmerged	753866	753913		YPO_RS04430	47
XXX001.A18962-69-72_libmerged	754765	754766		YPO_RS04440	1
XXX001.A18962-69-72_libmerged	754852	754855		YPO_RS04440	3
XXX001.A18962-69-72_libmerged	755325	755364		YPO_RS04440	39
XXX001.A18962-69-72_libmerged	755577	755584		YPO_RS04445	7
XXX001.A18962-69-72_libmerged	756586	756590		YPO_RS04450	4
XXX001.A18962-69-72_libmerged	758454	758465		YPO_RS04465	11
XXX001.A18962-69-72_libmerged	761138	761141		YPO_RS04470	3
XXX001.A18962-69-72_libmerged	761976	761998		YPO_RS04475	22
XXX001.A18962-69-72_libmerged	765774	765781		YPO_RS04485	7
XXX001.A18962-69-72_libmerged	769538	769543		flhB	5
XXX001.A18962-69-72_libmerged	769718	769720		flhB	2
XXX001.A18962-69-72_libmerged	771734	771740		fliP	6
XXX001.A18962-69-72_libmerged	772971	773002		YPO_RS04525	31
XXX001.A18962-69-72_libmerged	774196	774201		YPO_RS04530	5
XXX001.A18962-69-72_libmerged	779651	779673		fliI	22
XXX001.A18962-69-72_libmerged	781092	781094		flgM	2
XXX001.A18962-69-72_libmerged	781457	781464		flgA	7
XXX001.A18962-69-72_libmerged	781494	781513		flgA	19
XXX001.A18962-69-72_libmerged	782242	782244		flgA	2
XXX001.A18962-69-72_libmerged	783290	783295		flgD	5
XXX001.A18962-69-72_libmerged	783883	783884		flgD	1
XXX001.A18962-69-72_libmerged	784084	784086		flaE	2
XXX001.A18962-69-72_libmerged	785300	785345		YPO_RS04600	45
XXX001.A18962-69-72_libmerged	786258	786260		flgF	2
XXX001.A18962-69-72_libmerged	787662	787668		flgH	6
XXX001.A18962-69-72_libmerged	791170	791175		flgL	5
XXX001.A18962-69-72_libmerged	791873	791878		flgL	5
XXX001.A18962-69-72_libmerged	792746	792750		YPO_RS04645	4
XXX001.A18962-69-72_libmerged	793107	793108		YPO_RS04645	1
XXX001.A18962-69-72_libmerged	793400	793412		YPO_RS04650	12
XXX001.A18962-69-72_libmerged	794753	794755		YPO_RS04655	2
XXX001.A18962-69-72_libmerged	796053	796080		YPO_RS04660	27
XXX001.A18962-69-72_libmerged	797812	797835		YPO_RS04665	23
XXX001.A18962-69-72_libmerged	798716	798717		YPO_RS04670	1
XXX001.A18962-69-72_libmerged	799314	799329		YPO_RS04670	15
XXX001.A18962-69-72_libmerged	801481	801483		fliS	2
XXX001.A18962-69-72_libmerged	803182	803195		YPO_RS04690	13
XXX001.A18962-69-72_libmerged	804392	804395		YPO_RS04700	3
XXX001.A18962-69-72_libmerged	805853	805862		lafU	9
XXX001.A18962-69-72_libmerged	807674	807706		YPO_RS04720	32
XXX001.A18962-69-72_libmerged	807690	807714		YPO_RS04725	24
XXX001.A18962-69-72_libmerged	808980	809038		YPO_RS04735	58
XXX001.A18962-69-72_libmerged	809185	809235		YPO_RS04735	50
XXX001.A18962-69-72_libmerged	811817	811818		YPO_RS04745	1
XXX001.A18962-69-72_libmerged	812746	812757		YPO_RS04750	11
XXX001.A18962-69-72_libmerged	816678	816681		YPO_RS04765	3
XXX001.A18962-69-72_libmerged	816727	816737		YPO_RS04765	10
XXX001.A18962-69-72_libmerged	817143	817150		YPO_RS04770	7
XXX001.A18962-69-72_libmerged	820453	820467		YPO_RS04770	14
XXX001.A18962-69-72_libmerged	830337	830339		gntP	2
XXX001.A18962-69-72_libmerged	833835	833842		YPO_RS04800	7
XXX001.A18962-69-72_libmerged	834331	834359		YPO_RS04800	28
XXX001.A18962-69-72_libmerged	835973	835998		YPO_RS04805	25
XXX001.A18962-69-72_libmerged	836199	836203		YPO_RS04805	4
XXX001.A18962-69-72_libmerged	837349	837376		YPO_RS04810	27
XXX001.A18962-69-72_libmerged	837441	837453		YPO_RS04810	12
XXX001.A18962-69-72_libmerged	838424	838428		YPO_RS04810	4
XXX001.A18962-69-72_libmerged	838826	838891		YPO_RS04815	65
XXX001.A18962-69-72_libmerged	842065	842099		YPO_RS04830	34
XXX001.A18962-69-72_libmerged	842977	842979		YPO_RS04835	2
XXX001.A18962-69-72_libmerged	843451	843452		YPO_RS04835	1
XXX001.A18962-69-72_libmerged	845399	845611		YPO_RS04835	212
XXX001.A18962-69-72_libmerged	845896	845918		YPO_RS04835	22
XXX001.A18962-69-72_libmerged	846160	846162		YPO_RS04835	2
XXX001.A18962-69-72_libmerged	849375	849379		YPO_RS04840	4
XXX001.A18962-69-72_libmerged	854319	854333		YPO_RS04845	14
XXX001.A18962-69-72_libmerged	860721	860726		lgt	5
XXX001.A18962-69-72_libmerged	862326	862331		ptsP	5
XXX001.A18962-69-72_libmerged	867733	867738		YPO_RS04900	5
XXX001.A18962-69-72_libmerged	868001	868003		lplT	2
XXX001.A18962-69-72_libmerged	868060	868063		lplT	3
XXX001.A18962-69-72_libmerged	869637	869638		aas	1
XXX001.A18962-69-72_libmerged	869956	869971		aas	15
XXX001.A18962-69-72_libmerged	877553	877568		YPO_RS04930	15
XXX001.A18962-69-72_libmerged	881371	881376		YPO_RS04950	5
XXX001.A18962-69-72_libmerged	881610	881611		YPO_RS04950	1
XXX001.A18962-69-72_libmerged	881716	881729		YPO_RS04950	13
XXX001.A18962-69-72_libmerged	883336	883339		YPO_RS04955	3
XXX001.A18962-69-72_libmerged	884094	884096		YPO_RS04960	2
XXX001.A18962-69-72_libmerged	884196	884226		YPO_RS04965	30
XXX001.A18962-69-72_libmerged	884301	884306		YPO_RS04965	5
XXX001.A18962-69-72_libmerged	884442	884471		YPO_RS04965	29
XXX001.A18962-69-72_libmerged	885548	885554		YPO_RS04975	6
XXX001.A18962-69-72_libmerged	885666	885691		YPO_RS04975	25
XXX001.A18962-69-72_libmerged	886091	886093		YPO_RS04975	2
XXX001.A18962-69-72_libmerged	886170	886221		YPO_RS04975	51
XXX001.A18962-69-72_libmerged	886317	886326		YPO_RS04975	9
XXX001.A18962-69-72_libmerged	886605	886669		YPO_RS04980	64
XXX001.A18962-69-72_libmerged	887103	887104		gspL	1
XXX001.A18962-69-72_libmerged	887752	887775		gspL	23
XXX001.A18962-69-72_libmerged	888115	888198		YPO_RS04990	83
XXX001.A18962-69-72_libmerged	888233	888266		YPO_RS04990	33
XXX001.A18962-69-72_libmerged	889198	889206		gspJ	8
XXX001.A18962-69-72_libmerged	889310	889416		gspJ	106
XXX001.A18962-69-72_libmerged	889504	889523		gspJ	19
XXX001.A18962-69-72_libmerged	889987	890039		YPO_RS05005	52
XXX001.A18962-69-72_libmerged	890138	890140		YPO_RS05005	2
XXX001.A18962-69-72_libmerged	893724	893836		gspD	112
XXX001.A18962-69-72_libmerged	894195	894196		gspD	1
XXX001.A18962-69-72_libmerged	894432	894479		gspD	47
XXX001.A18962-69-72_libmerged	894752	894753		gspD	1
XXX001.A18962-69-72_libmerged	895551	895553		gspD	2
XXX001.A18962-69-72_libmerged	895687	895718		YPO_RS05030	31
XXX001.A18962-69-72_libmerged	895888	895915		YPO_RS05030	27
XXX001.A18962-69-72_libmerged	896039	896053		YPO_RS05030	14
XXX001.A18962-69-72_libmerged	896173	896190		YPO_RS05030	17
XXX001.A18962-69-72_libmerged	896258	896262		YPO_RS05035	4
XXX001.A18962-69-72_libmerged	896346	896365		YPO_RS05035	19
XXX001.A18962-69-72_libmerged	898045	898060		YPO_RS05040	15
XXX001.A18962-69-72_libmerged	898715	898721		YPO_RS05045	6
XXX001.A18962-69-72_libmerged	900365	900372		YPO_RS05050	7
XXX001.A18962-69-72_libmerged	904274	904277		YPO_RS05060	3
XXX001.A18962-69-72_libmerged	904465	904468		YPO_RS05060	3
XXX001.A18962-69-72_libmerged	908125	908126		tnpA	1
XXX001.A18962-69-72_libmerged	909218	909224		YPO_RS05080	6
XXX001.A18962-69-72_libmerged	909672	909679		YPO_RS05080	7
XXX001.A18962-69-72_libmerged	910175	910185		YPO_RS05080	10
XXX001.A18962-69-72_libmerged	910446	910455		YPO_RS05080	9
XXX001.A18962-69-72_libmerged	914476	914489		YPO_RS05095	13
XXX001.A18962-69-72_libmerged	919229	919242		kduD	13
XXX001.A18962-69-72_libmerged	919754	919765		YPO_RS05130	11
XXX001.A18962-69-72_libmerged	921003	921005		YPO_RS05135	2
XXX001.A18962-69-72_libmerged	922477	922479		YPO_RS05140	2
XXX001.A18962-69-72_libmerged	924739	924745		YPO_RS05145	6
XXX001.A18962-69-72_libmerged	925188	925191		YPO_RS05145	3
XXX001.A18962-69-72_libmerged	925957	925966		YPO_RS05150	9
XXX001.A18962-69-72_libmerged	930405	930408		YPO_RS05170	3
XXX001.A18962-69-72_libmerged	934460	934462		YPO_RS05180	2
XXX001.A18962-69-72_libmerged	934958	934964		YPO_RS05180	6
XXX001.A18962-69-72_libmerged	935172	935193		YPO_RS05180	21
XXX001.A18962-69-72_libmerged	940558	940566		YPO_RS05205	8
XXX001.A18962-69-72_libmerged	946313	946317		YPO_RS05220	4
XXX001.A18962-69-72_libmerged	946972	946984		YPO_RS05225	12
XXX001.A18962-69-72_libmerged	950114	950160		YPO_RS05235	46
XXX001.A18962-69-72_libmerged	953023	953031		YPO_RS05250	8
XXX001.A18962-69-72_libmerged	953663	953706		YPO_RS05260	43
XXX001.A18962-69-72_libmerged	953744	953765		YPO_RS05260	21
XXX001.A18962-69-72_libmerged	954136	954147		YPO_RS05260	11
XXX001.A18962-69-72_libmerged	956821	956830		YPO_RS05270	9
XXX001.A18962-69-72_libmerged	957876	957885		YPO_RS05270	9
XXX001.A18962-69-72_libmerged	960375	960376		YPO_RS05290	1
XXX001.A18962-69-72_libmerged	961729	961735		YPO_RS05295	6
XXX001.A18962-69-72_libmerged	963334	963356		YPO_RS05305	22
XXX001.A18962-69-72_libmerged	964077	964134		YPO_RS05315	57
XXX001.A18962-69-72_libmerged	966183	966190		YPO_RS05330	7
XXX001.A18962-69-72_libmerged	966449	966451		YPO_RS05330	2
XXX001.A18962-69-72_libmerged	966508	966516		YPO_RS05330	8
XXX001.A18962-69-72_libmerged	971823	971828		lysS	5
XXX001.A18962-69-72_libmerged	978711	978736		creD	25
XXX001.A18962-69-72_libmerged	980588	980592		creC	4
XXX001.A18962-69-72_libmerged	980817	980819		creC	2
XXX001.A18962-69-72_libmerged	985181	985192		YPO_RS05435	11
XXX001.A18962-69-72_libmerged	986315	986322		YPO_RS05440	7
XXX001.A18962-69-72_libmerged	986735	986738		YPO_RS05440	3
XXX001.A18962-69-72_libmerged	993255	993258		gcvP	3
XXX001.A18962-69-72_libmerged	993949	993997		gcvP	48
XXX001.A18962-69-72_libmerged	999148	999173		ubiH	25
XXX001.A18962-69-72_libmerged	1002696	1002700		YPO_RS05505	4
XXX001.A18962-69-72_libmerged	1007966	1007972		argO	6
XXX001.A18962-69-72_libmerged	1010820	1010829		fbaA	9
XXX001.A18962-69-72_libmerged	1033889	1033901		YPO_RS05650	12
XXX001.A18962-69-72_libmerged	1037129	1037132		hemW	3
XXX001.A18962-69-72_libmerged	1039885	1039890		YPO_RS05675	5
XXX001.A18962-69-72_libmerged	1040871	1040895		YPO_RS05675	24
XXX001.A18962-69-72_libmerged	1043766	1043776		YPO_RS05675	10
XXX001.A18962-69-72_libmerged	1043944	1043975		YPO_RS05675	31
XXX001.A18962-69-72_libmerged	1044404	1044492		YPO_RS05675	88
XXX001.A18962-69-72_libmerged	1044627	1044677		YPO_RS05675	50
XXX001.A18962-69-72_libmerged	1044791	1044796		YPO_RS05675	5
XXX001.A18962-69-72_libmerged	1045014	1045089		YPO_RS05675	75
XXX001.A18962-69-72_libmerged	1045282	1045321		YPO_RS05675	39
XXX001.A18962-69-72_libmerged	1045529	1045568		YPO_RS05675	39
XXX001.A18962-69-72_libmerged	1045836	1045849		YPO_RS05675	13
XXX001.A18962-69-72_libmerged	1046455	1046508		YPO_RS05675	53
XXX001.A18962-69-72_libmerged	1046549	1046552		YPO_RS05675	3
XXX001.A18962-69-72_libmerged	1046684	1046710		YPO_RS05675	26
XXX001.A18962-69-72_libmerged	1052128	1052140		YPO_RS05705	12
XXX001.A18962-69-72_libmerged	1053156	1053169		mltC	13
XXX001.A18962-69-72_libmerged	1057282	1057288		YPO_RS05725	6
XXX001.A18962-69-72_libmerged	1066378	1066381		YPO_RS05760	3
XXX001.A18962-69-72_libmerged	1066867	1066868		YPO_RS05765	1
XXX001.A18962-69-72_libmerged	1067007	1067020		YPO_RS05765	13
XXX001.A18962-69-72_libmerged	1067348	1067389		YPO_RS05765	41
XXX001.A18962-69-72_libmerged	1067376	1067393		YPO_RS05770	17
XXX001.A18962-69-72_libmerged	1068147	1068168		YPO_RS05770	21
XXX001.A18962-69-72_libmerged	1071938	1071947		YPO_RS05790	9
XXX001.A18962-69-72_libmerged	1073119	1073128		YPO_RS05795	9
XXX001.A18962-69-72_libmerged	1079545	1079552		tssH	7
XXX001.A18962-69-72_libmerged	1081581	1081583		YPO_RS05815	2
XXX001.A18962-69-72_libmerged	1085031	1085042		tssC	11
XXX001.A18962-69-72_libmerged	1088710	1088718		YPO_RS05845	8
XXX001.A18962-69-72_libmerged	1088938	1088942		YPO_RS05845	4
XXX001.A18962-69-72_libmerged	1091415	1091421		YPO_RS05855	6
XXX001.A18962-69-72_libmerged	1093577	1093582		YPO_RS05865	5
XXX001.A18962-69-72_libmerged	1094203	1094206		YPO_RS05865	3
XXX001.A18962-69-72_libmerged	1096049	1096051		YPO_RS05875	2
XXX001.A18962-69-72_libmerged	1096624	1096625		YPO_RS05880	1
XXX001.A18962-69-72_libmerged	1099293	1099298		YPO_RS05890	5
XXX001.A18962-69-72_libmerged	1103786	1103787		YPO_RS05905	1
XXX001.A18962-69-72_libmerged	1110763	1110795		YPO_RS05920	32
XXX001.A18962-69-72_libmerged	1112233	1112269		YPO_RS05930	36
XXX001.A18962-69-72_libmerged	1113222	1113235		YPO_RS05930	13
XXX001.A18962-69-72_libmerged	1115262	1115271		YPO_RS05935	9
XXX001.A18962-69-72_libmerged	1116716	1116717		YPO_RS05940	1
XXX001.A18962-69-72_libmerged	1117063	1117116		YPO_RS05940	53
XXX001.A18962-69-72_libmerged	1117272	1117291		YPO_RS05940	19
XXX001.A18962-69-72_libmerged	1118072	1118109		YPO_RS05940	37
XXX001.A18962-69-72_libmerged	1118906	1118913		YPO_RS05945	7
XXX001.A18962-69-72_libmerged	1120404	1120426		yapH	22
XXX001.A18962-69-72_libmerged	1121459	1121460		yapH	1
XXX001.A18962-69-72_libmerged	1121564	1121596		yapH	32
XXX001.A18962-69-72_libmerged	1122628	1122661		yapH	33
XXX001.A18962-69-72_libmerged	1123975	1124001		yapH	26
XXX001.A18962-69-72_libmerged	1124074	1124104		yapH	30
XXX001.A18962-69-72_libmerged	1124156	1124191		yapH	35
XXX001.A18962-69-72_libmerged	1124223	1124227		yapH	4
XXX001.A18962-69-72_libmerged	1124281	1124289		yapH	8
XXX001.A18962-69-72_libmerged	1124371	1124402		yapH	31
XXX001.A18962-69-72_libmerged	1124458	1124496		yapH	38
XXX001.A18962-69-72_libmerged	1124531	1124541		yapH	10
XXX001.A18962-69-72_libmerged	1124609	1124618		yapH	9
XXX001.A18962-69-72_libmerged	1124692	1124876		yapH	184
XXX001.A18962-69-72_libmerged	1124923	1124935		yapH	12
XXX001.A18962-69-72_libmerged	1125009	1125017		yapH	8
XXX001.A18962-69-72_libmerged	1125104	1125123		yapH	19
XXX001.A18962-69-72_libmerged	1125167	1125392		yapH	225
XXX001.A18962-69-72_libmerged	1125443	1125469		yapH	26
XXX001.A18962-69-72_libmerged	1125538	1125607		yapH	69
XXX001.A18962-69-72_libmerged	1125660	1125677		yapH	17
XXX001.A18962-69-72_libmerged	1125976	1125984		yapH	8
XXX001.A18962-69-72_libmerged	1126183	1126185		yapH	2
XXX001.A18962-69-72_libmerged	1126571	1126589		yapH	18
XXX001.A18962-69-72_libmerged	1127125	1127136		yapH	11
XXX001.A18962-69-72_libmerged	1127167	1127174		yapH	7
XXX001.A18962-69-72_libmerged	1128240	1128251		yapH	11
XXX001.A18962-69-72_libmerged	1128844	1128870		yapH	26
XXX001.A18962-69-72_libmerged	1133649	1133671		YPO_RS05965	22
XXX001.A18962-69-72_libmerged	1134355	1134367		YPO_RS05965	12
XXX001.A18962-69-72_libmerged	1135690	1135707		YPO_RS05970	17
XXX001.A18962-69-72_libmerged	1137284	1137293		YPO_RS05975	9
XXX001.A18962-69-72_libmerged	1138563	1138587		YPO_RS05975	24
XXX001.A18962-69-72_libmerged	1138635	1138643		YPO_RS05975	8
XXX001.A18962-69-72_libmerged	1139410	1139411		pepT	1
XXX001.A18962-69-72_libmerged	1141716	1141727		YPO_RS05985	11
XXX001.A18962-69-72_libmerged	1142101	1142103		YPO_RS05985	2
XXX001.A18962-69-72_libmerged	1142419	1142437		YPO_RS05985	18
XXX001.A18962-69-72_libmerged	1152220	1152221		recC	1
XXX001.A18962-69-72_libmerged	1154160	1154173		ptrA	13
XXX001.A18962-69-72_libmerged	1154909	1154919		ptrA	10
XXX001.A18962-69-72_libmerged	1156050	1156082		recB	32
XXX001.A18962-69-72_libmerged	1157961	1157969		recB	8
XXX001.A18962-69-72_libmerged	1162084	1162086		argA	2
XXX001.A18962-69-72_libmerged	1163767	1163771		YPO_RS06050	4
XXX001.A18962-69-72_libmerged	1164155	1164163		YPO_RS06050	8
XXX001.A18962-69-72_libmerged	1164421	1164422		YPO_RS06050	1
XXX001.A18962-69-72_libmerged	1166428	1166433		mltA	5
XXX001.A18962-69-72_libmerged	1167079	1167084		tcdA	5
XXX001.A18962-69-72_libmerged	1167601	1167616		csdE	15
XXX001.A18962-69-72_libmerged	1174565	1174569		YPO_RS06110	4
XXX001.A18962-69-72_libmerged	1184335	1184342		map	7
XXX001.A18962-69-72_libmerged	1184821	1184827		map	6
XXX001.A18962-69-72_libmerged	1192811	1192823		rseP	12
XXX001.A18962-69-72_libmerged	1194817	1194829		bamA	12
XXX001.A18962-69-72_libmerged	1195435	1195437		bamA	2
XXX001.A18962-69-72_libmerged	1198434	1198466		lpxA	32
XXX001.A18962-69-72_libmerged	1199274	1199285		lpxB	11
XXX001.A18962-69-72_libmerged	1202453	1202460		dnaE	7
XXX001.A18962-69-72_libmerged	1206574	1206582		tilS	8
XXX001.A18962-69-72_libmerged	1214760	1214765		metI	5
XXX001.A18962-69-72_libmerged	1216207	1216216		metN	9
XXX001.A18962-69-72_libmerged	1220120	1220121		YPO_RS06340	1
XXX001.A18962-69-72_libmerged	1221217	1221220		YPO_RS06340	3
XXX001.A18962-69-72_libmerged	1221601	1221602		YPO_RS06340	1
XXX001.A18962-69-72_libmerged	1228470	1228481		YPO_RS06380	11
XXX001.A18962-69-72_libmerged	1231277	1231278		YPO_RS06400	1
XXX001.A18962-69-72_libmerged	1232281	1232282		YPO_RS06405	1
XXX001.A18962-69-72_libmerged	1239050	1239054		YPO_RS06455	4
XXX001.A18962-69-72_libmerged	1240725	1240730		YPO_RS06465	5
XXX001.A18962-69-72_libmerged	1240945	1241004		YPO_RS06465	59
XXX001.A18962-69-72_libmerged	1241050	1241121		YPO_RS06465	71
XXX001.A18962-69-72_libmerged	1241400	1241405		YPO_RS06465	5
XXX001.A18962-69-72_libmerged	1241736	1241737		YPO_RS06465	1
XXX001.A18962-69-72_libmerged	1241988	1242017		YPO_RS06465	29
XXX001.A18962-69-72_libmerged	1243021	1243034		YPO_RS06470	13
XXX001.A18962-69-72_libmerged	1251903	1251906		YPO_RS06525	3
XXX001.A18962-69-72_libmerged	1257715	1257718		sucA	3
XXX001.A18962-69-72_libmerged	1259040	1259051		sucA	11
XXX001.A18962-69-72_libmerged	1260340	1260345		odhB	5
XXX001.A18962-69-72_libmerged	1266882	1266885		ybgE	3
XXX001.A18962-69-72_libmerged	1269591	1269618		tolA	27
XXX001.A18962-69-72_libmerged	1269753	1269768		tolA	15
XXX001.A18962-69-72_libmerged	1269944	1269946		tolA	2
XXX001.A18962-69-72_libmerged	1274553	1274560		nadA	7
XXX001.A18962-69-72_libmerged	1275282	1275289		YPO_RS06645	7
XXX001.A18962-69-72_libmerged	1277551	1277564		aroG	13
XXX001.A18962-69-72_libmerged	1278055	1278062		aroG	7
XXX001.A18962-69-72_libmerged	1286118	1286121		galE	3
XXX001.A18962-69-72_libmerged	1288549	1288551		modF	2
XXX001.A18962-69-72_libmerged	1289888	1289901		modE	13
XXX001.A18962-69-72_libmerged	1292899	1292912		modC	13
XXX001.A18962-69-72_libmerged	1294007	1294015		YPO_RS06745	8
XXX001.A18962-69-72_libmerged	1295326	1295327		pgl	1
XXX001.A18962-69-72_libmerged	1295486	1295502		pgl	16
XXX001.A18962-69-72_libmerged	1295733	1295742		bioA	9
XXX001.A18962-69-72_libmerged	1298686	1298700		bioF	14
XXX001.A18962-69-72_libmerged	1300128	1300149		bioD	21
XXX001.A18962-69-72_libmerged	1303411	1303412		uvrB	1
XXX001.A18962-69-72_libmerged	1311954	1311986		betA	32
XXX001.A18962-69-72_libmerged	1314378	1314381		betI	3
XXX001.A18962-69-72_libmerged	1315934	1315935		YPO_RS06845	1
XXX001.A18962-69-72_libmerged	1318002	1318021		YPO_RS06850	19
XXX001.A18962-69-72_libmerged	1322732	1322736		YPO_RS06875	4
XXX001.A18962-69-72_libmerged	1327221	1327224		dld	3
XXX001.A18962-69-72_libmerged	1329178	1329179		YPO_RS06910	1
XXX001.A18962-69-72_libmerged	1330023	1330028		YPO_RS06910	5
XXX001.A18962-69-72_libmerged	1331059	1331063		phnC	4
XXX001.A18962-69-72_libmerged	1331873	1331882		phnD	9
XXX001.A18962-69-72_libmerged	1334740	1334764		YPO_RS06940	24
XXX001.A18962-69-72_libmerged	1337920	1337931		urtB	11
XXX001.A18962-69-72_libmerged	1339296	1339299		urtC	3
XXX001.A18962-69-72_libmerged	1339546	1339548		urtC	2
XXX001.A18962-69-72_libmerged	1340469	1340480		urtD	11
XXX001.A18962-69-72_libmerged	1341151	1341161		urtE	10
XXX001.A18962-69-72_libmerged	1343050	1343052		YPO_RS06975	2
XXX001.A18962-69-72_libmerged	1344008	1344022		sseA	14
XXX001.A18962-69-72_libmerged	1347753	1347768		YPO_RS06995	15
XXX001.A18962-69-72_libmerged	1348491	1348498		YPO_RS07000	7
XXX001.A18962-69-72_libmerged	1349000	1349011		YPO_RS07005	11
XXX001.A18962-69-72_libmerged	1350443	1350450		adiC	7
XXX001.A18962-69-72_libmerged	1350955	1350966		adiC	11
XXX001.A18962-69-72_libmerged	1351562	1351566		YPO_RS07015	4
XXX001.A18962-69-72_libmerged	1354681	1354689		yedA	8
XXX001.A18962-69-72_libmerged	1355023	1355029		yedA	6
XXX001.A18962-69-72_libmerged	1362118	1362124		tyrP	6
XXX001.A18962-69-72_libmerged	1362914	1362916		tyrP	2
XXX001.A18962-69-72_libmerged	1366279	1366281		nrdB	2
XXX001.A18962-69-72_libmerged	1373184	1373185		gyrA	1
XXX001.A18962-69-72_libmerged	1374490	1374520		rcsC	30
XXX001.A18962-69-72_libmerged	1379107	1379119		rcsD	12
XXX001.A18962-69-72_libmerged	1388792	1388793		YPO_RS07145	1
XXX001.A18962-69-72_libmerged	1390705	1390708		YPO_RS07150	3
XXX001.A18962-69-72_libmerged	1391793	1391797		ycoA	4
XXX001.A18962-69-72_libmerged	1392300	1392317		ycoA	17
XXX001.A18962-69-72_libmerged	1393376	1393377		YPO_RS07165	1
XXX001.A18962-69-72_libmerged	1394019	1394030		YPO_RS07170	11
XXX001.A18962-69-72_libmerged	1398182	1398187		YPO_RS07190	5
XXX001.A18962-69-72_libmerged	1399586	1399588		YPO_RS07200	2
XXX001.A18962-69-72_libmerged	1405577	1405607		YPO_RS07235	30
XXX001.A18962-69-72_libmerged	1407285	1407295		YPO_RS07245	10
XXX001.A18962-69-72_libmerged	1407466	1407491		YPO_RS07245	25
XXX001.A18962-69-72_libmerged	1407554	1407560		YPO_RS07245	6
XXX001.A18962-69-72_libmerged	1407918	1407919		YPO_RS07250	1
XXX001.A18962-69-72_libmerged	1408776	1408789		YPO_RS07255	13
XXX001.A18962-69-72_libmerged	1410910	1410917		YPO_RS07270	7
XXX001.A18962-69-72_libmerged	1411105	1411109		YPO_RS07270	4
XXX001.A18962-69-72_libmerged	1413167	1413198		YPO_RS07280	31
XXX001.A18962-69-72_libmerged	1414341	1414355		YPO_RS07285	14
XXX001.A18962-69-72_libmerged	1414930	1414933		YPO_RS07290	3
XXX001.A18962-69-72_libmerged	1424767	1424768		YPO_RS07340	1
XXX001.A18962-69-72_libmerged	1432767	1432769		YPO_RS07370	2
XXX001.A18962-69-72_libmerged	1433350	1433436		YPO_RS07370	86
XXX001.A18962-69-72_libmerged	1436049	1436059		YPO_RS07380	10
XXX001.A18962-69-72_libmerged	1436361	1436384		YPO_RS07380	23
XXX001.A18962-69-72_libmerged	1442149	1442153		uxuA	4
XXX001.A18962-69-72_libmerged	1444020	1444021		mtr	1
XXX001.A18962-69-72_libmerged	1445629	1445632		YPO_RS07420	3
XXX001.A18962-69-72_libmerged	1446570	1446573		YPO_RS07425	3
XXX001.A18962-69-72_libmerged	1447874	1447882		YPO_RS07430	8
XXX001.A18962-69-72_libmerged	1448533	1448539		YPO_RS07435	6
XXX001.A18962-69-72_libmerged	1449096	1449097		YPO_RS07435	1
XXX001.A18962-69-72_libmerged	1449254	1449255		YPO_RS07435	1
XXX001.A18962-69-72_libmerged	1449535	1449543		YPO_RS07435	8
XXX001.A18962-69-72_libmerged	1450101	1450104		xylB	3
XXX001.A18962-69-72_libmerged	1451112	1451124		xylB	12
XXX001.A18962-69-72_libmerged	1451304	1451307		xylB	3
XXX001.A18962-69-72_libmerged	1451385	1451387		xylB	2
XXX001.A18962-69-72_libmerged	1452727	1452735		YPO_RS07450	8
XXX001.A18962-69-72_libmerged	1460418	1460428		fruA	10
XXX001.A18962-69-72_libmerged	1461790	1461844		YPO_RS07490	54
XXX001.A18962-69-72_libmerged	1463115	1463151		psaA	36
XXX001.A18962-69-72_libmerged	1463225	1463226		psaA	1
XXX001.A18962-69-72_libmerged	1463379	1463420		YPO_RS07500	41
XXX001.A18962-69-72_libmerged	1466516	1466518		psaC	2
XXX001.A18962-69-72_libmerged	1470894	1470900		YPO_RS07525	6
XXX001.A18962-69-72_libmerged	1471300	1471303		YPO_RS07525	3
XXX001.A18962-69-72_libmerged	1477004	1477017		YPO_RS07545	13
XXX001.A18962-69-72_libmerged	1480684	1480686		YPO_RS07560	2
XXX001.A18962-69-72_libmerged	1486241	1486253		YPO_RS07585	12
XXX001.A18962-69-72_libmerged	1490931	1490943		YPO_RS07605	12
XXX001.A18962-69-72_libmerged	1492163	1492169		YPO_RS07610	6
XXX001.A18962-69-72_libmerged	1495765	1495773		YPO_RS07625	8
XXX001.A18962-69-72_libmerged	1497081	1497084		potF	3
XXX001.A18962-69-72_libmerged	1499912	1499924		potI	12
XXX001.A18962-69-72_libmerged	1508018	1508022		YPO_RS07690	4
XXX001.A18962-69-72_libmerged	1508523	1508526		YPO_RS07695	3
XXX001.A18962-69-72_libmerged	1514472	1514477		artQ	5
XXX001.A18962-69-72_libmerged	1517052	1517054		YPO_RS07755	2
XXX001.A18962-69-72_libmerged	1525396	1525404		hcp	8
XXX001.A18962-69-72_libmerged	1532565	1532567		macB	2
XXX001.A18962-69-72_libmerged	1533682	1533685		macB	3
XXX001.A18962-69-72_libmerged	1539724	1539742		aat	18
XXX001.A18962-69-72_libmerged	1545774	1545780		lrp	6
XXX001.A18962-69-72_libmerged	1548253	1548256		YPO_RS07870	3
XXX001.A18962-69-72_libmerged	1548592	1548599		YPO_RS07870	7
XXX001.A18962-69-72_libmerged	1549903	1549912		YPO_RS07870	9
XXX001.A18962-69-72_libmerged	1552290	1552293		YPO_RS07880	3
XXX001.A18962-69-72_libmerged	1553275	1553277		serS	2
XXX001.A18962-69-72_libmerged	1554940	1554944		YPO_RS07890	4
XXX001.A18962-69-72_libmerged	1557826	1557835		YPO_RS07900	9
XXX001.A18962-69-72_libmerged	1562532	1562535		YPO_RS07915	3
XXX001.A18962-69-72_libmerged	1562906	1562911		YPO_RS07915	5
XXX001.A18962-69-72_libmerged	1566042	1566049		YPO_RS07925	7
XXX001.A18962-69-72_libmerged	1566378	1566380		YPO_RS07930	2
XXX001.A18962-69-72_libmerged	1567526	1567537		YPO_RS07930	11
XXX001.A18962-69-72_libmerged	1567679	1567783		YPO_RS07930	104
XXX001.A18962-69-72_libmerged	1567849	1567864		YPO_RS07930	15
XXX001.A18962-69-72_libmerged	1568864	1568867		serC	3
XXX001.A18962-69-72_libmerged	1569975	1569980		aroA	5
XXX001.A18962-69-72_libmerged	1570040	1570041		aroA	1
XXX001.A18962-69-72_libmerged	1574857	1574867		YPO_RS07960	10
XXX001.A18962-69-72_libmerged	1575207	1575215		YPO_RS07960	8
XXX001.A18962-69-72_libmerged	1575966	1575970		YPO_RS07960	4
XXX001.A18962-69-72_libmerged	1579124	1579125		lpxK	1
XXX001.A18962-69-72_libmerged	1579373	1579381		lpxK	8
XXX001.A18962-69-72_libmerged	1580500	1580514		YPO_RS07975	14
XXX001.A18962-69-72_libmerged	1585895	1585901		cmoM	6
XXX001.A18962-69-72_libmerged	1587572	1587585		mukF	13
XXX001.A18962-69-72_libmerged	1595099	1595120		ldtD	21
XXX001.A18962-69-72_libmerged	1595731	1595748		ldtD	17
XXX001.A18962-69-72_libmerged	1602756	1602758		pncB	2
XXX001.A18962-69-72_libmerged	1611205	1611207		rlmKL	2
XXX001.A18962-69-72_libmerged	1614809	1614825		pqiA	16
XXX001.A18962-69-72_libmerged	1616073	1616075		pqiB	2
XXX001.A18962-69-72_libmerged	1618623	1618629		rmf	6
XXX001.A18962-69-72_libmerged	1631355	1631357		yccS	2
XXX001.A18962-69-72_libmerged	1633150	1633153		helD	3
XXX001.A18962-69-72_libmerged	1636693	1636694		YPO_RS08205	1
XXX001.A18962-69-72_libmerged	1643522	1643523		YPO_RS08245	1
XXX001.A18962-69-72_libmerged	1643693	1643696		YPO_RS08245	3
XXX001.A18962-69-72_libmerged	1647598	1647649		YPO_RS08260	51
XXX001.A18962-69-72_libmerged	1647693	1647701		YPO_RS08260	8
XXX001.A18962-69-72_libmerged	1651515	1651521		YPO_RS08280	6
XXX001.A18962-69-72_libmerged	1652098	1652100		YPO_RS08280	2
XXX001.A18962-69-72_libmerged	1652102	1652106		YPO_RS08285	4
XXX001.A18962-69-72_libmerged	1652413	1652430		YPO_RS08285	17
XXX001.A18962-69-72_libmerged	1652504	1652512		YPO_RS08285	8
XXX001.A18962-69-72_libmerged	1653815	1653826		YPO_RS08295	11
XXX001.A18962-69-72_libmerged	1658413	1658415		tssC	2
XXX001.A18962-69-72_libmerged	1661778	1661780		YPO_RS08330	2
XXX001.A18962-69-72_libmerged	1665724	1665735		tssH	11
XXX001.A18962-69-72_libmerged	1666955	1666962		YPO_RS08345	7
XXX001.A18962-69-72_libmerged	1668237	1668238		YPO_RS08350	1
XXX001.A18962-69-72_libmerged	1670168	1670184		YPO_RS08350	16
XXX001.A18962-69-72_libmerged	1670491	1670509		YPO_RS08355	18
XXX001.A18962-69-72_libmerged	1670837	1670846		YPO_RS08355	9
XXX001.A18962-69-72_libmerged	1670941	1670952		YPO_RS08355	11
XXX001.A18962-69-72_libmerged	1671642	1671646		YPO_RS08360	4
XXX001.A18962-69-72_libmerged	1673356	1673382		YPO_RS08365	26
XXX001.A18962-69-72_libmerged	1673812	1673845		YPO_RS08365	33
XXX001.A18962-69-72_libmerged	1674222	1674252		YPO_RS08370	30
XXX001.A18962-69-72_libmerged	1677573	1677589		YPO_RS08380	16
XXX001.A18962-69-72_libmerged	1682191	1682193		tssA	2
XXX001.A18962-69-72_libmerged	1683670	1683709		YPO_RS08395	39
XXX001.A18962-69-72_libmerged	1684015	1684025		YPO_RS08395	10
XXX001.A18962-69-72_libmerged	1684040	1684158		YPO_RS08400	118
XXX001.A18962-69-72_libmerged	1684327	1684328		YPO_RS08400	1
XXX001.A18962-69-72_libmerged	1684394	1684405		YPO_RS08400	11
XXX001.A18962-69-72_libmerged	1686171	1686182		tssF	11
XXX001.A18962-69-72_libmerged	1687249	1687250		tssG	1
XXX001.A18962-69-72_libmerged	1688467	1688483		tssE	16
XXX001.A18962-69-72_libmerged	1688625	1688657		YPO_RS08425	32
XXX001.A18962-69-72_libmerged	1690316	1690324		YPO_RS08430	8
XXX001.A18962-69-72_libmerged	1693428	1693440		YPO_RS08440	12
XXX001.A18962-69-72_libmerged	1693756	1693760		YPO_RS08440	4
XXX001.A18962-69-72_libmerged	1695519	1695528		moeB	9
XXX001.A18962-69-72_libmerged	1699099	1699134		darE	35
XXX001.A18962-69-72_libmerged	1700032	1700034		darC	2
XXX001.A18962-69-72_libmerged	1700325	1700384		darC	59
XXX001.A18962-69-72_libmerged	1700558	1700583		darC	25
XXX001.A18962-69-72_libmerged	1700655	1700660		darC	5
XXX001.A18962-69-72_libmerged	1701101	1701139		darC	38
XXX001.A18962-69-72_libmerged	1701288	1701290		darB	2
XXX001.A18962-69-72_libmerged	1701326	1701353		darB	27
XXX001.A18962-69-72_libmerged	1702597	1702623		darB	26
XXX001.A18962-69-72_libmerged	1703378	1703380		darB	2
XXX001.A18962-69-72_libmerged	1706512	1706534		YPO_RS08495	22
XXX001.A18962-69-72_libmerged	1706686	1706689		YPO_RS08495	3
XXX001.A18962-69-72_libmerged	1707135	1707139		YPO_RS08495	4
XXX001.A18962-69-72_libmerged	1707564	1707568		YPO_RS08500	4
XXX001.A18962-69-72_libmerged	1707727	1707729		YPO_RS08500	2
XXX001.A18962-69-72_libmerged	1708309	1708313		YPO_RS08500	4
XXX001.A18962-69-72_libmerged	1711351	1711361		mglB	10
XXX001.A18962-69-72_libmerged	1714318	1714322		mglC	4
XXX001.A18962-69-72_libmerged	1719453	1719455		cdd	2
XXX001.A18962-69-72_libmerged	1719962	1719964		YPO_RS08545	2
XXX001.A18962-69-72_libmerged	1720182	1720183		YPO_RS08545	1
XXX001.A18962-69-72_libmerged	1720588	1720603		YPO_RS08550	15
XXX001.A18962-69-72_libmerged	1723156	1723161		YPO_RS08560	5
XXX001.A18962-69-72_libmerged	1724938	1724944		YPO_RS08565	6
XXX001.A18962-69-72_libmerged	1724980	1724989		YPO_RS08565	9
XXX001.A18962-69-72_libmerged	1725921	1725950		YPO_RS08570	29
XXX001.A18962-69-72_libmerged	1726293	1726331		YPO_RS08570	38
XXX001.A18962-69-72_libmerged	1729709	1729715		metG	6
XXX001.A18962-69-72_libmerged	1729962	1729963		metG	1
XXX001.A18962-69-72_libmerged	1732063	1732064		apbC	1
XXX001.A18962-69-72_libmerged	1734668	1734681		asmA	13
XXX001.A18962-69-72_libmerged	1739303	1739316		YPO_RS08625	13
XXX001.A18962-69-72_libmerged	1739575	1739584		YPO_RS08625	9
XXX001.A18962-69-72_libmerged	1739679	1739689		YPO_RS08625	10
XXX001.A18962-69-72_libmerged	1742919	1742928		YPO_RS08640	9
XXX001.A18962-69-72_libmerged	1744242	1744243		YPO_RS08640	1
XXX001.A18962-69-72_libmerged	1746212	1746234		YPO_RS08650	22
XXX001.A18962-69-72_libmerged	1746787	1746792		YPO_RS08655	5
XXX001.A18962-69-72_libmerged	1760213	1760220		hisH	7
XXX001.A18962-69-72_libmerged	1763384	1763417		hisD	33
XXX001.A18962-69-72_libmerged	1765827	1765840		YPO_RS08735	13
XXX001.A18962-69-72_libmerged	1770545	1770570		YPO_RS08760	25
XXX001.A18962-69-72_libmerged	1770756	1770757		YPO_RS08760	1
XXX001.A18962-69-72_libmerged	1772295	1772300		YPO_RS08770	5
XXX001.A18962-69-72_libmerged	1774595	1774597		sbcB	2
XXX001.A18962-69-72_libmerged	1775716	1775717		YPO_RS08785	1
XXX001.A18962-69-72_libmerged	1775829	1775839		YPO_RS08785	10
XXX001.A18962-69-72_libmerged	1788843	1788844		lldD	1
XXX001.A18962-69-72_libmerged	1789153	1789164		lldD	11
XXX001.A18962-69-72_libmerged	1793912	1793917		YPO_RS08845	5
XXX001.A18962-69-72_libmerged	1794380	1794381		YPO_RS08845	1
XXX001.A18962-69-72_libmerged	1796139	1796174		YPO_RS08855	35
XXX001.A18962-69-72_libmerged	1798382	1798388		YPO_RS08870	6
XXX001.A18962-69-72_libmerged	1799256	1799268		YPO_RS08875	12
XXX001.A18962-69-72_libmerged	1803528	1803542		YPO_RS08895	14
XXX001.A18962-69-72_libmerged	1803756	1803762		YPO_RS08900	6
XXX001.A18962-69-72_libmerged	1803917	1803929		YPO_RS08900	12
XXX001.A18962-69-72_libmerged	1806981	1806998		YPO_RS08905	17
XXX001.A18962-69-72_libmerged	1808299	1808310		bssS	11
XXX001.A18962-69-72_libmerged	1812799	1812803		rne	4
XXX001.A18962-69-72_libmerged	1812941	1812949		rne	8
XXX001.A18962-69-72_libmerged	1820335	1820356		plsX	21
XXX001.A18962-69-72_libmerged	1822670	1822671		fabD	1
XXX001.A18962-69-72_libmerged	1825014	1825019		fabF	5
XXX001.A18962-69-72_libmerged	1827110	1827115		pabC	5
XXX001.A18962-69-72_libmerged	1828928	1828938		YPO_RS09020	10
XXX001.A18962-69-72_libmerged	1829199	1829207		YPO_RS09020	8
XXX001.A18962-69-72_libmerged	1834753	1834758		YPO_RS09045	5
XXX001.A18962-69-72_libmerged	1835633	1835645		YPO_RS09055	12
XXX001.A18962-69-72_libmerged	1837729	1837775		nagZ	46
XXX001.A18962-69-72_libmerged	1839093	1839097		YPO_RS09075	4
XXX001.A18962-69-72_libmerged	1842260	1842267		YPO_RS09090	7
XXX001.A18962-69-72_libmerged	1851609	1851614		lolC	5
XXX001.A18962-69-72_libmerged	1851852	1851853		lolD	1
XXX001.A18962-69-72_libmerged	1853377	1853390		lolE	13
XXX001.A18962-69-72_libmerged	1861626	1861628		purB	2
XXX001.A18962-69-72_libmerged	1869353	1869357		YPO_RS09210	4
XXX001.A18962-69-72_libmerged	1873955	1873956		YPO_RS09230	1
XXX001.A18962-69-72_libmerged	1878296	1878350		YPO_RS09250	54
XXX001.A18962-69-72_libmerged	1882004	1882008		YPO_RS09260	4
XXX001.A18962-69-72_libmerged	1884238	1884249		dsrB	11
XXX001.A18962-69-72_libmerged	1895422	1895424		motB	2
XXX001.A18962-69-72_libmerged	1897431	1897433		cheA	2
XXX001.A18962-69-72_libmerged	1901297	1901304		YPO_RS09330	7
XXX001.A18962-69-72_libmerged	1902961	1902974		yapJ	13
XXX001.A18962-69-72_libmerged	1903268	1903273		yapJ	5
XXX001.A18962-69-72_libmerged	1904400	1904406		yapJ	6
XXX001.A18962-69-72_libmerged	1904870	1904872		yapJ	2
XXX001.A18962-69-72_libmerged	1915006	1915011		cheR	5
XXX001.A18962-69-72_libmerged	1916248	1916254		YPO_RS09370	6
XXX001.A18962-69-72_libmerged	1918291	1918293		YPO_RS09385	2
XXX001.A18962-69-72_libmerged	1918568	1918573		YPO_RS09385	5
XXX001.A18962-69-72_libmerged	1919051	1919055		YPO_RS09385	4
XXX001.A18962-69-72_libmerged	1920094	1920111		YPO_RS09390	17
XXX001.A18962-69-72_libmerged	1920641	1920650		YPO_RS09390	9
XXX001.A18962-69-72_libmerged	1920805	1920810		YPO_RS09390	5
XXX001.A18962-69-72_libmerged	1921272	1921277		YPO_RS09390	5
XXX001.A18962-69-72_libmerged	1921911	1921939		YPO_RS09395	28
XXX001.A18962-69-72_libmerged	1923936	1923941		YPO_RS09405	5
XXX001.A18962-69-72_libmerged	1924146	1924154		YPO_RS09405	8
XXX001.A18962-69-72_libmerged	1932949	1932952		YPO_RS09450	3
XXX001.A18962-69-72_libmerged	1933819	1933852		YPO_RS09455	33
XXX001.A18962-69-72_libmerged	1934361	1934365		YPO_RS09455	4
XXX001.A18962-69-72_libmerged	1936835	1936838		YPO_RS09465	3
XXX001.A18962-69-72_libmerged	1938365	1938374		YPO_RS09475	9
XXX001.A18962-69-72_libmerged	1939350	1939356		YPO_RS09480	6
XXX001.A18962-69-72_libmerged	1939593	1939603		YPO_RS09480	10
XXX001.A18962-69-72_libmerged	1945861	1945865		prc	4
XXX001.A18962-69-72_libmerged	1951993	1951996		YPO_RS09520	3
XXX001.A18962-69-72_libmerged	1952836	1952841		YPO_RS09525	5
XXX001.A18962-69-72_libmerged	1963158	1963167		YPO_RS09565	9
XXX001.A18962-69-72_libmerged	1964644	1964649		YPO_RS09570	5
XXX001.A18962-69-72_libmerged	1966987	1966994		YPO_RS09585	7
XXX001.A18962-69-72_libmerged	1967671	1967672		YPO_RS09585	1
XXX001.A18962-69-72_libmerged	1976636	1976656		YPO_RS09630	20
XXX001.A18962-69-72_libmerged	1976756	1976762		YPO_RS09630	6
XXX001.A18962-69-72_libmerged	1977459	1977460		mtfA	1
XXX001.A18962-69-72_libmerged	1983842	1983853		YPO_RS09675	11
XXX001.A18962-69-72_libmerged	1986196	1986200		YPO_RS09700	4
XXX001.A18962-69-72_libmerged	1988226	1988242		YPO_RS09705	16
XXX001.A18962-69-72_libmerged	1991328	1991332		rlmA	4
XXX001.A18962-69-72_libmerged	1995110	1995114		YPO_RS09745	4
XXX001.A18962-69-72_libmerged	1995267	1995274		YPO_RS09745	7
XXX001.A18962-69-72_libmerged	1995682	1995685		YPO_RS09745	3
XXX001.A18962-69-72_libmerged	1997594	1997596		YPO_RS09750	2
XXX001.A18962-69-72_libmerged	1999860	1999872		mntP	12
XXX001.A18962-69-72_libmerged	2000359	2000381		YPO_RS09760	22
XXX001.A18962-69-72_libmerged	2000489	2000490		YPO_RS09760	1
XXX001.A18962-69-72_libmerged	2004649	2004652		YPO_RS09780	3
XXX001.A18962-69-72_libmerged	2005242	2005249		YPO_RS09780	7
XXX001.A18962-69-72_libmerged	2011222	2011225		hpaH	3
XXX001.A18962-69-72_libmerged	2011820	2011823		hpaH	3
XXX001.A18962-69-72_libmerged	2012628	2012644		hpaI	16
XXX001.A18962-69-72_libmerged	2013319	2013330		hpaX	11
XXX001.A18962-69-72_libmerged	2016695	2016703		YPO_RS09840	8
XXX001.A18962-69-72_libmerged	2018938	2018960		YPO_RS09845	22
XXX001.A18962-69-72_libmerged	2023809	2023814		dbpA	5
XXX001.A18962-69-72_libmerged	2024813	2024817		YPO_RS09880	4
XXX001.A18962-69-72_libmerged	2025106	2025108		YPO_RS09880	2
XXX001.A18962-69-72_libmerged	2025554	2025559		YPO_RS09885	5
XXX001.A18962-69-72_libmerged	2031485	2031492		copD	7
XXX001.A18962-69-72_libmerged	2033434	2033444		YPO_RS09925	10
XXX001.A18962-69-72_libmerged	2033493	2033517		YPO_RS09925	24
XXX001.A18962-69-72_libmerged	2037929	2037938		YPO_RS09940	9
XXX001.A18962-69-72_libmerged	2044916	2044920		flgC	4
XXX001.A18962-69-72_libmerged	2045640	2045642		flgD	2
XXX001.A18962-69-72_libmerged	2047209	2047212		YPO_RS09990	3
XXX001.A18962-69-72_libmerged	2049796	2049798		YPO_RS10010	2
XXX001.A18962-69-72_libmerged	2058943	2058957		YPO_RS10040	14
XXX001.A18962-69-72_libmerged	2059898	2059901		YPO_RS10045	3
XXX001.A18962-69-72_libmerged	2060022	2060040		YPO_RS10045	18
XXX001.A18962-69-72_libmerged	2062311	2062319		YPO_RS10050	8
XXX001.A18962-69-72_libmerged	2062934	2062941		YPO_RS10055	7
XXX001.A18962-69-72_libmerged	2063374	2063380		YPO_RS10055	6
XXX001.A18962-69-72_libmerged	2067956	2067980		fliO	24
XXX001.A18962-69-72_libmerged	2070443	2070468		YPO_RS10110	25
XXX001.A18962-69-72_libmerged	2071618	2071623		YPO_RS10110	5
XXX001.A18962-69-72_libmerged	2075208	2075217		fliG	9
XXX001.A18962-69-72_libmerged	2080008	2080011		YPO_RS10165	3
XXX001.A18962-69-72_libmerged	2081648	2081657		YPO_RS10170	9
XXX001.A18962-69-72_libmerged	2081760	2081777		YPO_RS10170	17
XXX001.A18962-69-72_libmerged	2084194	2084210		fliT	16
XXX001.A18962-69-72_libmerged	2085730	2085738		fliD	8
XXX001.A18962-69-72_libmerged	2090844	2090851		YPO_RS10210	7
XXX001.A18962-69-72_libmerged	2093967	2093974		YPO_RS10235	7
XXX001.A18962-69-72_libmerged	2094152	2094157		YPO_RS10235	5
XXX001.A18962-69-72_libmerged	2104040	2104045		efeB	5
XXX001.A18962-69-72_libmerged	2104732	2104748		wrbA	16
XXX001.A18962-69-72_libmerged	2107219	2107230		cycA	11
XXX001.A18962-69-72_libmerged	2110573	2110582		YPO_RS10300	9
XXX001.A18962-69-72_libmerged	2110657	2110659		YPO_RS10300	2
XXX001.A18962-69-72_libmerged	2112091	2112109		uvrY	18
XXX001.A18962-69-72_libmerged	2113659	2113665		uvrC	6
XXX001.A18962-69-72_libmerged	2117726	2117786		YPO_RS10355	60
XXX001.A18962-69-72_libmerged	2118092	2118132		hcp	40
XXX001.A18962-69-72_libmerged	2118344	2118347		hcp	3
XXX001.A18962-69-72_libmerged	2119123	2119126		YPO_RS10365	3
XXX001.A18962-69-72_libmerged	2122650	2122653		YPO_RS10395	3
XXX001.A18962-69-72_libmerged	2126489	2126552		YPO_RS10415	63
XXX001.A18962-69-72_libmerged	2126757	2126794		YPO_RS10420	37
XXX001.A18962-69-72_libmerged	2127967	2127974		YPO_RS10430	7
XXX001.A18962-69-72_libmerged	2130742	2130745		YPO_RS10440	3
XXX001.A18962-69-72_libmerged	2130890	2130894		YPO_RS10440	4
XXX001.A18962-69-72_libmerged	2131342	2131343		YPO_RS10440	1
XXX001.A18962-69-72_libmerged	2132038	2132042		YPO_RS10445	4
XXX001.A18962-69-72_libmerged	2133381	2133383		YPO_RS10450	2
XXX001.A18962-69-72_libmerged	2144996	2144997		ybtT	1
XXX001.A18962-69-72_libmerged	2145635	2145646		ybtU	11
XXX001.A18962-69-72_libmerged	2150870	2150895		irp1	25
XXX001.A18962-69-72_libmerged	2152660	2152665		irp1	5
XXX001.A18962-69-72_libmerged	2154535	2154542		irp1	7
XXX001.A18962-69-72_libmerged	2154598	2154615		irp1	17
XXX001.A18962-69-72_libmerged	2156797	2156800		irp2	3
XXX001.A18962-69-72_libmerged	2159088	2159102		irp2	14
XXX001.A18962-69-72_libmerged	2159629	2159630		irp2	1
XXX001.A18962-69-72_libmerged	2166595	2166623		ybtQ	28
XXX001.A18962-69-72_libmerged	2166920	2166929		ybtQ	9
XXX001.A18962-69-72_libmerged	2167353	2167364		ybtX	11
XXX001.A18962-69-72_libmerged	2171007	2171008		YPO_RS10570	1
XXX001.A18962-69-72_libmerged	2172539	2172561		YPO_RS10585	22
XXX001.A18962-69-72_libmerged	2173174	2173176		YPO_RS10585	2
XXX001.A18962-69-72_libmerged	2173941	2173942		YPO_RS10590	1
XXX001.A18962-69-72_libmerged	2175004	2175006		YPO_RS10590	2
XXX001.A18962-69-72_libmerged	2178335	2178350		YPO_RS10605	15
XXX001.A18962-69-72_libmerged	2180792	2180807		YPO_RS10610	15
XXX001.A18962-69-72_libmerged	2182613	2182620		YPO_RS10615	7
XXX001.A18962-69-72_libmerged	2183741	2183748		YPO_RS10620	7
XXX001.A18962-69-72_libmerged	2184113	2184130		YPO_RS10620	17
XXX001.A18962-69-72_libmerged	2184659	2184671		YPO_RS10620	12
XXX001.A18962-69-72_libmerged	2186018	2186028		YPO_RS10630	10
XXX001.A18962-69-72_libmerged	2187666	2187692		YPO_RS10640	26
XXX001.A18962-69-72_libmerged	2187796	2187810		YPO_RS10645	14
XXX001.A18962-69-72_libmerged	2189870	2189877		YPO_RS10655	7
XXX001.A18962-69-72_libmerged	2191381	2191384		YPO_RS10660	3
XXX001.A18962-69-72_libmerged	2199270	2199290		glsA	20
XXX001.A18962-69-72_libmerged	2204119	2204122		YPO_RS10705	3
XXX001.A18962-69-72_libmerged	2206956	2206971		YPO_RS10715	15
XXX001.A18962-69-72_libmerged	2207449	2207454		YPO_RS10715	5
XXX001.A18962-69-72_libmerged	2209603	2209614		YPO_RS10730	11
XXX001.A18962-69-72_libmerged	2215095	2215097		pgaA	2
XXX001.A18962-69-72_libmerged	2218035	2218045		YPO_RS10760	10
XXX001.A18962-69-72_libmerged	2218353	2218356		YPO_RS10760	3
XXX001.A18962-69-72_libmerged	2226509	2226511		YPO_RS10800	2
XXX001.A18962-69-72_libmerged	2226562	2226568		YPO_RS10800	6
XXX001.A18962-69-72_libmerged	2232436	2232448		astB	12
XXX001.A18962-69-72_libmerged	2237356	2237375		YPO_RS10835	19
XXX001.A18962-69-72_libmerged	2241179	2241187		hutC	8
XXX001.A18962-69-72_libmerged	2252447	2252460		YPO_RS10905	13
XXX001.A18962-69-72_libmerged	2252980	2252982		YPO_RS10910	2
XXX001.A18962-69-72_libmerged	2253391	2253393		YPO_RS10910	2
XXX001.A18962-69-72_libmerged	2253740	2253743		YPO_RS10915	3
XXX001.A18962-69-72_libmerged	2254340	2254350		YPO_RS10915	10
XXX001.A18962-69-72_libmerged	2256115	2256154		YPO_RS10925	39
XXX001.A18962-69-72_libmerged	2258636	2258637		YPO_RS10935	1
XXX001.A18962-69-72_libmerged	2259139	2259156		YPO_RS10935	17
XXX001.A18962-69-72_libmerged	2259702	2259766		YPO_RS10935	64
XXX001.A18962-69-72_libmerged	2259843	2259866		YPO_RS10935	23
XXX001.A18962-69-72_libmerged	2259901	2259912		YPO_RS10935	11
XXX001.A18962-69-72_libmerged	2261794	2261795		YPO_RS10940	1
XXX001.A18962-69-72_libmerged	2265382	2265383		YPO_RS10955	1
XXX001.A18962-69-72_libmerged	2265589	2265603		YPO_RS10955	14
XXX001.A18962-69-72_libmerged	2267344	2267345		YPO_RS10970	1
XXX001.A18962-69-72_libmerged	2269863	2269878		YPO_RS10980	15
XXX001.A18962-69-72_libmerged	2270396	2270400		YPO_RS10980	4
XXX001.A18962-69-72_libmerged	2271721	2271731		YPO_RS10990	10
XXX001.A18962-69-72_libmerged	2274817	2274827		YPO_RS11005	10
XXX001.A18962-69-72_libmerged	2274981	2275003		YPO_RS11005	22
XXX001.A18962-69-72_libmerged	2277268	2277294		YPO_RS11015	26
XXX001.A18962-69-72_libmerged	2280749	2280751		YPO_RS11035	2
XXX001.A18962-69-72_libmerged	2282347	2282360		ychF	13
XXX001.A18962-69-72_libmerged	2289004	2289005		hemA	1
XXX001.A18962-69-72_libmerged	2290915	2290921		prmC	6
XXX001.A18962-69-72_libmerged	2299970	2300030		YPO_RS11135	60
XXX001.A18962-69-72_libmerged	2301533	2301536		YPO_RS11145	3
XXX001.A18962-69-72_libmerged	2302022	2302025		YPO_RS11145	3
XXX001.A18962-69-72_libmerged	2306087	2306090		YPO_RS11175	3
XXX001.A18962-69-72_libmerged	2306171	2306172		YPO_RS11175	1
XXX001.A18962-69-72_libmerged	2308430	2308438		YPO_RS11185	8
XXX001.A18962-69-72_libmerged	2311293	2311306		mdtH	13
XXX001.A18962-69-72_libmerged	2315255	2315267		murJ	12
XXX001.A18962-69-72_libmerged	2316442	2316509		YPO_RS11220	67
XXX001.A18962-69-72_libmerged	2318132	2318160		YPO_RS11225	28
XXX001.A18962-69-72_libmerged	2318373	2318376		YPO_RS11225	3
XXX001.A18962-69-72_libmerged	2318938	2318941		YPO_RS11225	3
XXX001.A18962-69-72_libmerged	2318991	2318992		YPO_RS11225	1
XXX001.A18962-69-72_libmerged	2319531	2319570		YPO_RS11225	39
XXX001.A18962-69-72_libmerged	2321685	2321689		YPO_RS11225	4
XXX001.A18962-69-72_libmerged	2322818	2322840		YPO_RS11225	22
XXX001.A18962-69-72_libmerged	2326360	2326365		cutC	5
XXX001.A18962-69-72_libmerged	2326557	2326561		cutC	4
XXX001.A18962-69-72_libmerged	2326986	2326997		cutC	11
XXX001.A18962-69-72_libmerged	2328461	2328465		cmoA	4
XXX001.A18962-69-72_libmerged	2334052	2334059		YPO_RS11275	7
XXX001.A18962-69-72_libmerged	2335230	2335235		ruvC	5
XXX001.A18962-69-72_libmerged	2336192	2336196		ruvA	4
XXX001.A18962-69-72_libmerged	2346745	2346752		zwf	7
XXX001.A18962-69-72_libmerged	2351772	2351773		YPO_RS11355	1
XXX001.A18962-69-72_libmerged	2351999	2352003		YPO_RS11355	4
XXX001.A18962-69-72_libmerged	2360757	2360774		YPO_RS11405	17
XXX001.A18962-69-72_libmerged	2361784	2361795		YPO_RS11410	11
XXX001.A18962-69-72_libmerged	2362833	2362852		YPO_RS11415	19
XXX001.A18962-69-72_libmerged	2370718	2370726		YPO_RS11475	8
XXX001.A18962-69-72_libmerged	2371840	2371846		YPO_RS11490	6
XXX001.A18962-69-72_libmerged	2374554	2374581		YPO_RS11500	27
XXX001.A18962-69-72_libmerged	2374907	2374923		YPO_RS11505	16
XXX001.A18962-69-72_libmerged	2381929	2381953		YPO_RS11545	24
XXX001.A18962-69-72_libmerged	2387309	2387322		YPO_RS11590	13
XXX001.A18962-69-72_libmerged	2387413	2387418		YPO_RS11590	5
XXX001.A18962-69-72_libmerged	2395419	2395420		YPO_RS11635	1
XXX001.A18962-69-72_libmerged	2395777	2395791		YPO_RS11635	14
XXX001.A18962-69-72_libmerged	2397046	2397049		YPO_RS11650	3
XXX001.A18962-69-72_libmerged	2398460	2398476		YPO_RS11660	16
XXX001.A18962-69-72_libmerged	2405166	2405170		YPO_RS11685	4
XXX001.A18962-69-72_libmerged	2406152	2406179		YPO_RS11690	27
XXX001.A18962-69-72_libmerged	2406533	2406540		YPO_RS11690	7
XXX001.A18962-69-72_libmerged	2411932	2411946		nhaB	14
XXX001.A18962-69-72_libmerged	2412023	2412033		nhaB	10
XXX001.A18962-69-72_libmerged	2415460	2415469		YPO_RS11725	9
XXX001.A18962-69-72_libmerged	2416591	2416593		YPO_RS11725	2
XXX001.A18962-69-72_libmerged	2416708	2416713		YPO_RS11730	5
XXX001.A18962-69-72_libmerged	2419447	2419474		YPO_RS11740	27
XXX001.A18962-69-72_libmerged	2421846	2421865		YPO_RS11750	19
XXX001.A18962-69-72_libmerged	2422335	2422338		YPO_RS11750	3
XXX001.A18962-69-72_libmerged	2423128	2423130		yeaG	2
XXX001.A18962-69-72_libmerged	2424301	2424302		yeaG	1
XXX001.A18962-69-72_libmerged	2425676	2425686		YPO_RS11760	10
XXX001.A18962-69-72_libmerged	2426683	2426686		YPO_RS11765	3
XXX001.A18962-69-72_libmerged	2429938	2429940		pncA	2
XXX001.A18962-69-72_libmerged	2432763	2432771		sppA	8
XXX001.A18962-69-72_libmerged	2434275	2434285		selD	10
XXX001.A18962-69-72_libmerged	2435658	2435668		YPO_RS11810	10
XXX001.A18962-69-72_libmerged	2439686	2439694		YPO_RS11830	8
XXX001.A18962-69-72_libmerged	2439754	2439765		YPO_RS11830	11
XXX001.A18962-69-72_libmerged	2439915	2439945		YPO_RS11830	30
XXX001.A18962-69-72_libmerged	2440170	2440202		YPO_RS11830	32
XXX001.A18962-69-72_libmerged	2440237	2440246		YPO_RS11830	9
XXX001.A18962-69-72_libmerged	2442375	2442376		purU	1
XXX001.A18962-69-72_libmerged	2443667	2443668		YPO_RS11860	1
XXX001.A18962-69-72_libmerged	2446844	2446849		YPO_RS11870	5
XXX001.A18962-69-72_libmerged	2457840	2457844		oppA	4
XXX001.A18962-69-72_libmerged	2458613	2458618		oppA	5
XXX001.A18962-69-72_libmerged	2463709	2463710		YPO_RS11930	1
XXX001.A18962-69-72_libmerged	2466107	2466109		cls	2
XXX001.A18962-69-72_libmerged	2474156	2474161		YPO_RS11995	5
XXX001.A18962-69-72_libmerged	2475843	2475864		YPO_RS12005	21
XXX001.A18962-69-72_libmerged	2479363	2479364		trpB	1
XXX001.A18962-69-72_libmerged	2480320	2480325		trpCF	5
XXX001.A18962-69-72_libmerged	2483167	2483172		YPO_RS12045	5
XXX001.A18962-69-72_libmerged	2484668	2484691		YPO_RS12055	23
XXX001.A18962-69-72_libmerged	2489394	2489424		sohB	30
XXX001.A18962-69-72_libmerged	2491193	2491221		topA	28
XXX001.A18962-69-72_libmerged	2492987	2492990		topA	3
XXX001.A18962-69-72_libmerged	2494214	2494215		cysB	1
XXX001.A18962-69-72_libmerged	2497525	2497532		acnA	7
XXX001.A18962-69-72_libmerged	2499145	2499158		acnA	13
XXX001.A18962-69-72_libmerged	2506415	2506420		araD	5
XXX001.A18962-69-72_libmerged	2508643	2508647		YPO_RS12175	4
XXX001.A18962-69-72_libmerged	2509046	2509050		YPO_RS12175	4
XXX001.A18962-69-72_libmerged	2513788	2513792		YPO_RS12185	4
XXX001.A18962-69-72_libmerged	2516178	2516179		nth	1
XXX001.A18962-69-72_libmerged	2516760	2516763		YPO_RS12200	3
XXX001.A18962-69-72_libmerged	2517717	2517722		rsxD	5
XXX001.A18962-69-72_libmerged	2518472	2518479		rsxD	7
XXX001.A18962-69-72_libmerged	2519275	2519288		YPO_RS12215	13
XXX001.A18962-69-72_libmerged	2521114	2521140		rsxC	26
XXX001.A18962-69-72_libmerged	2521957	2521986		rsxC	29
XXX001.A18962-69-72_libmerged	2522346	2522356		rsxB	10
XXX001.A18962-69-72_libmerged	2522568	2522572		rsxB	4
XXX001.A18962-69-72_libmerged	2522985	2523007		rsxA	22
XXX001.A18962-69-72_libmerged	2527693	2527697		YPO_RS12250	4
XXX001.A18962-69-72_libmerged	2529614	2529624		YPO_RS12255	10
XXX001.A18962-69-72_libmerged	2536027	2536030		YPO_RS12275	3
XXX001.A18962-69-72_libmerged	2536857	2536868		YPO_RS12280	11
XXX001.A18962-69-72_libmerged	2537045	2537046		YPO_RS12280	1
XXX001.A18962-69-72_libmerged	2539390	2539392		YPO_RS12290	2
XXX001.A18962-69-72_libmerged	2540364	2540370		YPO_RS12295	6
XXX001.A18962-69-72_libmerged	2540638	2540640		YPO_RS12295	2
XXX001.A18962-69-72_libmerged	2542194	2542204		YPO_RS12305	10
XXX001.A18962-69-72_libmerged	2544039	2544042		manA	3
XXX001.A18962-69-72_libmerged	2544223	2544237		manA	14
XXX001.A18962-69-72_libmerged	2545225	2545237		fumC	12
XXX001.A18962-69-72_libmerged	2548346	2548350		YPO_RS12325	4
XXX001.A18962-69-72_libmerged	2549446	2549447		YPO_RS12330	1
XXX001.A18962-69-72_libmerged	2549509	2549515		YPO_RS12330	6
XXX001.A18962-69-72_libmerged	2551203	2551206		YPO_RS12340	3
XXX001.A18962-69-72_libmerged	2554373	2554633		YPO_RS12355	260
XXX001.A18962-69-72_libmerged	2554658	2555065		YPO_RS12360	407
XXX001.A18962-69-72_libmerged	2555162	2555608		YPO_RS12365	446
XXX001.A18962-69-72_libmerged	2555780	2556832		YPO_RS12370	1052
XXX001.A18962-69-72_libmerged	2556844	2557161		YPO_RS12375	317
XXX001.A18962-69-72_libmerged	2557164	2557415		YPO_RS12380	251
XXX001.A18962-69-72_libmerged	2557451	2557668		YPO_RS12385	217
XXX001.A18962-69-72_libmerged	2557749	2559461		YPO_RS12390	1712
XXX001.A18962-69-72_libmerged	2559474	2559761		YPO_RS12395	287
XXX001.A18962-69-72_libmerged	2559765	2560790		YPO_RS12400	1025
XXX001.A18962-69-72_libmerged	2560790	2561078		YPO_RS12405	288
XXX001.A18962-69-72_libmerged	2561120	2561499		YPO_RS12405	379
XXX001.A18962-69-72_libmerged	2561541	2561730		YPO_RS12405	189
XXX001.A18962-69-72_libmerged	2561772	2562034		YPO_RS12405	262
XXX001.A18962-69-72_libmerged	2562123	2562371		YPO_RS12410	248
XXX001.A18962-69-72_libmerged	2562568	2562699		YPO_RS12415	131
XXX001.A18962-69-72_libmerged	2562752	2562765		YPO_RS12415	13
XXX001.A18962-69-72_libmerged	2563340	2563357		YPO_RS12420	17
XXX001.A18962-69-72_libmerged	2565808	2565865		YPO_RS12435	57
XXX001.A18962-69-72_libmerged	2565904	2565916		YPO_RS12435	12
XXX001.A18962-69-72_libmerged	2566244	2566250		YPO_RS12435	6
XXX001.A18962-69-72_libmerged	2567282	2567286		YPO_RS12440	4
XXX001.A18962-69-72_libmerged	2568166	2568169		YPO_RS12445	3
XXX001.A18962-69-72_libmerged	2572469	2572480		YPO_RS12455	11
XXX001.A18962-69-72_libmerged	2573726	2573727		YPO_RS12455	1
XXX001.A18962-69-72_libmerged	2577757	2577769		YPO_RS12465	12
XXX001.A18962-69-72_libmerged	2579137	2579149		ilvB	12
XXX001.A18962-69-72_libmerged	2579933	2579944		ilvB	11
XXX001.A18962-69-72_libmerged	2580086	2580103		ilvN	17
XXX001.A18962-69-72_libmerged	2582838	2582840		YPO_RS12495	2
XXX001.A18962-69-72_libmerged	2587836	2587848		uspE	12
XXX001.A18962-69-72_libmerged	2606362	2606381		asr	19
XXX001.A18962-69-72_libmerged	2607310	2607311		YPO_RS12590	1
XXX001.A18962-69-72_libmerged	2611155	2611175		hrpA	20
XXX001.A18962-69-72_libmerged	2614442	2614447		YPO_RS12615	5
XXX001.A18962-69-72_libmerged	2614941	2614942		YPO_RS12620	1
XXX001.A18962-69-72_libmerged	2615601	2615603		YPO_RS12620	2
XXX001.A18962-69-72_libmerged	2617738	2617740		YPO_RS12635	2
XXX001.A18962-69-72_libmerged	2617991	2617992		YPO_RS12635	1
XXX001.A18962-69-72_libmerged	2618936	2618944		YPO_RS12635	8
XXX001.A18962-69-72_libmerged	2622288	2622291		YPO_RS12655	3
XXX001.A18962-69-72_libmerged	2630107	2630119		YPO_RS12680	12
XXX001.A18962-69-72_libmerged	2635709	2635721		ycjG	12
XXX001.A18962-69-72_libmerged	2638994	2638999		tyrR	5
XXX001.A18962-69-72_libmerged	2640270	2640275		YPO_RS12725	5
XXX001.A18962-69-72_libmerged	2640381	2640389		YPO_RS12725	8
XXX001.A18962-69-72_libmerged	2640502	2640529		YPO_RS12725	27
XXX001.A18962-69-72_libmerged	2640615	2640618		YPO_RS12725	3
XXX001.A18962-69-72_libmerged	2643798	2643816		pspC	18
XXX001.A18962-69-72_libmerged	2647689	2647700		sapA	11
XXX001.A18962-69-72_libmerged	2650490	2650502		sapC	12
XXX001.A18962-69-72_libmerged	2651308	2651315		sapD	7
XXX001.A18962-69-72_libmerged	2656374	2656402		dtpA	28
XXX001.A18962-69-72_libmerged	2660608	2660610		gstA	2
XXX001.A18962-69-72_libmerged	2668165	2668196		YPO_RS12865	31
XXX001.A18962-69-72_libmerged	2671221	2671231		YPO_RS12880	10
XXX001.A18962-69-72_libmerged	2672567	2672568		YPO_RS12885	1
XXX001.A18962-69-72_libmerged	2681292	2681324		purR	32
XXX001.A18962-69-72_libmerged	2683805	2683811		YPO_RS12940	6
XXX001.A18962-69-72_libmerged	2694629	2694652		YPO_RS13000	23
XXX001.A18962-69-72_libmerged	2695535	2695566		YPO_RS13000	31
XXX001.A18962-69-72_libmerged	2700092	2700094		sufB	2
XXX001.A18962-69-72_libmerged	2702538	2702543		YPO_RS13035	5
XXX001.A18962-69-72_libmerged	2708019	2708023		rprA	4
XXX001.A18962-69-72_libmerged	2711292	2711306		YPO_RS13060	14
XXX001.A18962-69-72_libmerged	2714921	2714928		YPO_RS13075	7
XXX001.A18962-69-72_libmerged	2716943	2716951		arnF	8
XXX001.A18962-69-72_libmerged	2718143	2718154		arnT	11
XXX001.A18962-69-72_libmerged	2719309	2719311		YPO_RS13105	2
XXX001.A18962-69-72_libmerged	2722183	2722188		arnC	5
XXX001.A18962-69-72_libmerged	2726061	2726064		btuC	3
XXX001.A18962-69-72_libmerged	2727439	2727442		YPO_RS13140	3
XXX001.A18962-69-72_libmerged	2735126	2735130		thrS	4
XXX001.A18962-69-72_libmerged	2739139	2739150		yfeA	11
XXX001.A18962-69-72_libmerged	2742173	2742174		yfeD	1
XXX001.A18962-69-72_libmerged	2742598	2742599		YPO_RS13225	1
XXX001.A18962-69-72_libmerged	2742869	2742877		YPO_RS13230	8
XXX001.A18962-69-72_libmerged	2743896	2743900		YPO_RS13235	4
XXX001.A18962-69-72_libmerged	2746062	2746065		YPO_RS13245	3
XXX001.A18962-69-72_libmerged	2748814	2748816		YPO_RS13255	2
XXX001.A18962-69-72_libmerged	2754131	2754159		YPO_RS13285	28
XXX001.A18962-69-72_libmerged	2755017	2755029		YPO_RS13290	12
XXX001.A18962-69-72_libmerged	2755429	2755475		YPO_RS13290	46
XXX001.A18962-69-72_libmerged	2759261	2759265		fae	4
XXX001.A18962-69-72_libmerged	2761986	2761990		csy2	4
XXX001.A18962-69-72_libmerged	2766251	2766262		cas3f	11
XXX001.A18962-69-72_libmerged	2767361	2767371		cas3f	10
XXX001.A18962-69-72_libmerged	2773431	2773437		YPO_RS13360	6
XXX001.A18962-69-72_libmerged	2774376	2774395		YPO_RS13360	19
XXX001.A18962-69-72_libmerged	2775575	2775582		YPO_RS13370	7
XXX001.A18962-69-72_libmerged	2784943	2784948		YPO_RS13410	5
XXX001.A18962-69-72_libmerged	2785308	2785319		YPO_RS13415	11
XXX001.A18962-69-72_libmerged	2785605	2785609		YPO_RS13415	4
XXX001.A18962-69-72_libmerged	2786610	2786629		YPO_RS13430	19
XXX001.A18962-69-72_libmerged	2786844	2786848		YPO_RS13430	4
XXX001.A18962-69-72_libmerged	2789705	2789712		YPO_RS13445	7
XXX001.A18962-69-72_libmerged	2794203	2794235		cdiA	32
XXX001.A18962-69-72_libmerged	2794497	2794503		cdiA	6
XXX001.A18962-69-72_libmerged	2794612	2794613		cdiA	1
XXX001.A18962-69-72_libmerged	2795003	2795017		cdiA	14
XXX001.A18962-69-72_libmerged	2796005	2796015		cdiA	10
XXX001.A18962-69-72_libmerged	2796607	2796624		cdiA	17
XXX001.A18962-69-72_libmerged	2797699	2797700		cdiA	1
XXX001.A18962-69-72_libmerged	2803846	2803853		YPO_RS13470	7
XXX001.A18962-69-72_libmerged	2807953	2807985		YPO_RS13485	32
XXX001.A18962-69-72_libmerged	2808407	2808431		YPO_RS13490	24
XXX001.A18962-69-72_libmerged	2808987	2808999		YPO_RS13490	12
XXX001.A18962-69-72_libmerged	2812475	2812485		YPO_RS13505	10
XXX001.A18962-69-72_libmerged	2813934	2813957		YPO_RS13510	23
XXX001.A18962-69-72_libmerged	2814166	2814179		YPO_RS13510	13
XXX001.A18962-69-72_libmerged	2814224	2814231		YPO_RS13510	7
XXX001.A18962-69-72_libmerged	2819276	2819287		tam	11
XXX001.A18962-69-72_libmerged	2821139	2821176		YPO_RS13550	37
XXX001.A18962-69-72_libmerged	2826170	2826177		YPO_RS13570	7
XXX001.A18962-69-72_libmerged	2829566	2829580		rlmF	14
XXX001.A18962-69-72_libmerged	2831195	2831211		ybiB	16
XXX001.A18962-69-72_libmerged	2834199	2834224		menC	25
XXX001.A18962-69-72_libmerged	2835345	2835351		menH	6
XXX001.A18962-69-72_libmerged	2836054	2836066		menD	12
XXX001.A18962-69-72_libmerged	2837124	2837131		menD	7
XXX001.A18962-69-72_libmerged	2838844	2838845		menF	1
XXX001.A18962-69-72_libmerged	2842581	2842593		YPO_RS13645	12
XXX001.A18962-69-72_libmerged	2844022	2844053		YPO_RS13645	31
XXX001.A18962-69-72_libmerged	2844804	2844817		YPO_RS13655	13
XXX001.A18962-69-72_libmerged	2845421	2845424		YPO_RS13655	3
XXX001.A18962-69-72_libmerged	2849964	2849974		YPO_RS13670	10
XXX001.A18962-69-72_libmerged	2851887	2851900		idnO	13
XXX001.A18962-69-72_libmerged	2853259	2853276		YPO_RS13685	17
XXX001.A18962-69-72_libmerged	2853917	2853929		YPO_RS13690	12
XXX001.A18962-69-72_libmerged	2854059	2854069		YPO_RS13690	10
XXX001.A18962-69-72_libmerged	2854156	2854202		YPO_RS13690	46
XXX001.A18962-69-72_libmerged	2854323	2854329		YPO_RS13690	6
XXX001.A18962-69-72_libmerged	2854665	2854694		YPO_RS13690	29
XXX001.A18962-69-72_libmerged	2854781	2854791		YPO_RS13690	10
XXX001.A18962-69-72_libmerged	2858525	2858550		nuoL	25
XXX001.A18962-69-72_libmerged	2860106	2860107		nuoK	1
XXX001.A18962-69-72_libmerged	2867959	2867960		nuoC	1
XXX001.A18962-69-72_libmerged	2873489	2873492		YPO_RS13765	3
XXX001.A18962-69-72_libmerged	2879087	2879091		YPO_RS13790	4
XXX001.A18962-69-72_libmerged	2880446	2880455		ackA	9
XXX001.A18962-69-72_libmerged	2885774	2885777		YPO_RS13815	3
XXX001.A18962-69-72_libmerged	2887821	2887823		YPO_RS13825	2
XXX001.A18962-69-72_libmerged	2888424	2888435		YPO_RS13830	11
XXX001.A18962-69-72_libmerged	2890738	2890744		YPO_RS13830	6
XXX001.A18962-69-72_libmerged	2897802	2897806		YPO_RS13845	4
XXX001.A18962-69-72_libmerged	2898061	2898088		YPO_RS13845	27
XXX001.A18962-69-72_libmerged	2898296	2898303		YPO_RS13845	7
XXX001.A18962-69-72_libmerged	2898621	2898630		iolD	9
XXX001.A18962-69-72_libmerged	2899432	2899447		iolD	15
XXX001.A18962-69-72_libmerged	2904630	2904660		YPO_RS13870	30
XXX001.A18962-69-72_libmerged	2904984	2904989		YPO_RS13870	5
XXX001.A18962-69-72_libmerged	2905296	2905302		YPO_RS13875	6
XXX001.A18962-69-72_libmerged	2907267	2907270		iolC	3
XXX001.A18962-69-72_libmerged	2907546	2907554		iolC	8
XXX001.A18962-69-72_libmerged	2910277	2910290		iolB	13
XXX001.A18962-69-72_libmerged	2912060	2912071		YPO_RS13900	11
XXX001.A18962-69-72_libmerged	2914013	2914014		YPO_RS13920	1
XXX001.A18962-69-72_libmerged	2915447	2915452		YPO_RS13925	5
XXX001.A18962-69-72_libmerged	2923689	2923693		rlpA	4
XXX001.A18962-69-72_libmerged	2926656	2926674		mrdA	18
XXX001.A18962-69-72_libmerged	2927172	2927177		mrdA	5
XXX001.A18962-69-72_libmerged	2927730	2927733		rlmH	3
XXX001.A18962-69-72_libmerged	2928216	2928228		rsfS	12
XXX001.A18962-69-72_libmerged	2930676	2930678		lptE	2
XXX001.A18962-69-72_libmerged	2934711	2934715		YPO_RS14020	4
XXX001.A18962-69-72_libmerged	2935302	2935311		gltK	9
XXX001.A18962-69-72_libmerged	2945356	2945360		ubiF	4
XXX001.A18962-69-72_libmerged	2952601	2952603		nagB	2
XXX001.A18962-69-72_libmerged	2952881	2952888		nagB	7
XXX001.A18962-69-72_libmerged	2954136	2954144		YPO_RS14120	8
XXX001.A18962-69-72_libmerged	2966680	2966681		ybfF	1
XXX001.A18962-69-72_libmerged	2972900	2972919		proW	19
XXX001.A18962-69-72_libmerged	2979329	2979344		nrdI	15
XXX001.A18962-69-72_libmerged	2980432	2980565		YPO_RS14235	133
XXX001.A18962-69-72_libmerged	2986331	2986335		YPO_RS14265	4
XXX001.A18962-69-72_libmerged	2994963	2994971		ureE	8
XXX001.A18962-69-72_libmerged	2997964	2997998		yut	34
XXX001.A18962-69-72_libmerged	2999278	2999287		YPO_RS14330	9
XXX001.A18962-69-72_libmerged	3002677	3002683		crcB	6
XXX001.A18962-69-72_libmerged	3003133	3003138		YPO_RS14355	5
XXX001.A18962-69-72_libmerged	3009986	3009992		pgm	6
XXX001.A18962-69-72_libmerged	3010752	3010763		pgm	11
XXX001.A18962-69-72_libmerged	3012185	3012220		YPO_RS14405	35
XXX001.A18962-69-72_libmerged	3012444	3012450		YPO_RS14405	6
XXX001.A18962-69-72_libmerged	3014607	3014610		kdbD	3
XXX001.A18962-69-72_libmerged	3015424	3015429		kdbD	5
XXX001.A18962-69-72_libmerged	3016182	3016183		kdbD	1
XXX001.A18962-69-72_libmerged	3018311	3018324		kdpB	13
XXX001.A18962-69-72_libmerged	3021133	3021142		YPO_RS14440	9
XXX001.A18962-69-72_libmerged	3023314	3023355		phrB	41
XXX001.A18962-69-72_libmerged	3027688	3027693		YPO_RS14480	5
XXX001.A18962-69-72_libmerged	3027925	3027945		YPO_RS14480	20
XXX001.A18962-69-72_libmerged	3028479	3028491		pxpA	12
XXX001.A18962-69-72_libmerged	3029360	3029388		YPO_RS14490	28
XXX001.A18962-69-72_libmerged	3036159	3036176		srmB	17
XXX001.A18962-69-72_libmerged	3036518	3036523		YPO_RS14530	5
XXX001.A18962-69-72_libmerged	3037232	3037264		YPO_RS14530	32
XXX001.A18962-69-72_libmerged	3039639	3039649		rpoE	10
XXX001.A18962-69-72_libmerged	3047148	3047166		rnc	18
XXX001.A18962-69-72_libmerged	3051046	3051051		tssL	5
XXX001.A18962-69-72_libmerged	3057505	3057507		YPO_RS14610	2
XXX001.A18962-69-72_libmerged	3057639	3057640		YPO_RS14610	1
XXX001.A18962-69-72_libmerged	3061354	3061357		YPO_RS14635	3
XXX001.A18962-69-72_libmerged	3066536	3066539		ccmA	3
XXX001.A18962-69-72_libmerged	3069673	3069676		YPO_RS14690	3
XXX001.A18962-69-72_libmerged	3070789	3070795		YPO_RS14690	6
XXX001.A18962-69-72_libmerged	3074029	3074049		mlaA	20
XXX001.A18962-69-72_libmerged	3075633	3075634		fadL	1
XXX001.A18962-69-72_libmerged	3078506	3078507		fadJ	1
XXX001.A18962-69-72_libmerged	3080989	3081002		sixA	13
XXX001.A18962-69-72_libmerged	3084133	3084147		aroC	14
XXX001.A18962-69-72_libmerged	3084866	3084867		mepA	1
XXX001.A18962-69-72_libmerged	3085740	3085747		YPO_RS14760	7
XXX001.A18962-69-72_libmerged	3087007	3087018		YPO_RS14765	11
XXX001.A18962-69-72_libmerged	3090665	3090668		fabB	3
XXX001.A18962-69-72_libmerged	3097084	3097097		YPO_RS14805	13
XXX001.A18962-69-72_libmerged	3100624	3100639		truA	15
XXX001.A18962-69-72_libmerged	3102589	3102590		accD	1
XXX001.A18962-69-72_libmerged	3106349	3106352		purF	3
XXX001.A18962-69-72_libmerged	3108378	3108382		YPO_RS14860	4
XXX001.A18962-69-72_libmerged	3111013	3111014		YPO_RS14875	1
XXX001.A18962-69-72_libmerged	3114806	3114811		yfcE	5
XXX001.A18962-69-72_libmerged	3121593	3121597		YPO_RS14925	4
XXX001.A18962-69-72_libmerged	3121662	3121696		YPO_RS14925	34
XXX001.A18962-69-72_libmerged	3122375	3122389		YPO_RS14930	14
XXX001.A18962-69-72_libmerged	3123277	3123298		YPO_RS14940	21
XXX001.A18962-69-72_libmerged	3123951	3123977		YPO_RS14945	26
XXX001.A18962-69-72_libmerged	3124254	3124255		YPO_RS14950	1
XXX001.A18962-69-72_libmerged	3127187	3127221		YPO_RS14960	34
XXX001.A18962-69-72_libmerged	3131511	3131517		YPO_RS14980	6
XXX001.A18962-69-72_libmerged	3132532	3132534		YPO_RS14985	2
XXX001.A18962-69-72_libmerged	3133306	3133310		YPO_RS14990	4
XXX001.A18962-69-72_libmerged	3133874	3133875		YPO_RS14990	1
XXX001.A18962-69-72_libmerged	3136302	3136303		YPO_RS14995	1
XXX001.A18962-69-72_libmerged	3144647	3144654		YPO_RS15035	7
XXX001.A18962-69-72_libmerged	3144875	3144897		YPO_RS15040	22
XXX001.A18962-69-72_libmerged	3145307	3145315		YPO_RS15040	8
XXX001.A18962-69-72_libmerged	3146709	3146713		YPO_RS15045	4
XXX001.A18962-69-72_libmerged	3149199	3149202		YPO_RS15060	3
XXX001.A18962-69-72_libmerged	3151689	3151693		YPO_RS15090	4
XXX001.A18962-69-72_libmerged	3152181	3152188		folD	7
XXX001.A18962-69-72_libmerged	3152753	3152756		folD	3
XXX001.A18962-69-72_libmerged	3160033	3160060		pstA	27
XXX001.A18962-69-72_libmerged	3163342	3163343		YPO_RS15145	1
XXX001.A18962-69-72_libmerged	3163427	3163432		YPO_RS15145	5
XXX001.A18962-69-72_libmerged	3164868	3164869		ppk1	1
XXX001.A18962-69-72_libmerged	3165603	3165625		ppk1	22
XXX001.A18962-69-72_libmerged	3170373	3170375		yegD	2
XXX001.A18962-69-72_libmerged	3170906	3170916		yegD	10
XXX001.A18962-69-72_libmerged	3171848	3171851		YPO_RS15175	3
XXX001.A18962-69-72_libmerged	3172554	3172556		YPO_RS15180	2
XXX001.A18962-69-72_libmerged	3173004	3173009		YPO_RS15180	5
XXX001.A18962-69-72_libmerged	3174969	3174986		YPO_RS15190	17
XXX001.A18962-69-72_libmerged	3178124	3178133		YPO_RS15200	9
XXX001.A18962-69-72_libmerged	3178975	3178977		YPO_RS15200	2
XXX001.A18962-69-72_libmerged	3179518	3179519		YPO_RS15205	1
XXX001.A18962-69-72_libmerged	3180535	3180537		YPO_RS15205	2
XXX001.A18962-69-72_libmerged	3192533	3192534		YPO_RS15240	1
XXX001.A18962-69-72_libmerged	3198221	3198235		YPO_RS15270	14
XXX001.A18962-69-72_libmerged	3200228	3200232		YPO_RS15285	4
XXX001.A18962-69-72_libmerged	3200395	3200419		YPO_RS15285	24
XXX001.A18962-69-72_libmerged	3200487	3200494		YPO_RS15285	7
XXX001.A18962-69-72_libmerged	3200576	3200587		YPO_RS15285	11
XXX001.A18962-69-72_libmerged	3200680	3200751		YPO_RS15290	71
XXX001.A18962-69-72_libmerged	3200822	3200889		YPO_RS15290	67
XXX001.A18962-69-72_libmerged	3200934	3200936		YPO_RS15290	2
XXX001.A18962-69-72_libmerged	3201263	3201266		YPO_RS15295	3
XXX001.A18962-69-72_libmerged	3201305	3201337		YPO_RS15295	32
XXX001.A18962-69-72_libmerged	3201608	3201687		YPO_RS15300	79
XXX001.A18962-69-72_libmerged	3201732	3201761		YPO_RS15300	29
XXX001.A18962-69-72_libmerged	3201871	3201886		YPO_RS15300	15
XXX001.A18962-69-72_libmerged	3201953	3201965		YPO_RS15300	12
XXX001.A18962-69-72_libmerged	3202250	3202272		YPO_RS15305	22
XXX001.A18962-69-72_libmerged	3207380	3207385		xseA	5
XXX001.A18962-69-72_libmerged	3209359	3209363		YPO_RS15335	4
XXX001.A18962-69-72_libmerged	3216816	3216821		rodZ	5
XXX001.A18962-69-72_libmerged	3217796	3217811		pilW	15
XXX001.A18962-69-72_libmerged	3218533	3218539		trmG/rlmN	6
XXX001.A18962-69-72_libmerged	3221523	3221529		YPO_RS15385	6
XXX001.A18962-69-72_libmerged	3221780	3221859		YPO_RS15385	79
XXX001.A18962-69-72_libmerged	3221948	3221970		YPO_RS15385	22
XXX001.A18962-69-72_libmerged	3228360	3228361		YPO_RS15395	1
XXX001.A18962-69-72_libmerged	3228540	3228546		YPO_RS15395	6
XXX001.A18962-69-72_libmerged	3229641	3229648		YPO_RS15395	7
XXX001.A18962-69-72_libmerged	3229835	3229859		YPO_RS15395	24
XXX001.A18962-69-72_libmerged	3230376	3230379		YPO_RS15395	3
XXX001.A18962-69-72_libmerged	3230791	3230807		YPO_RS15395	16
XXX001.A18962-69-72_libmerged	3231856	3231862		YPO_RS15405	6
XXX001.A18962-69-72_libmerged	3234263	3234271		pepB	8
XXX001.A18962-69-72_libmerged	3236975	3236981		hscA	6
XXX001.A18962-69-72_libmerged	3238981	3238987		YPO_RS15450	6
XXX001.A18962-69-72_libmerged	3246433	3246468		csiE	35
XXX001.A18962-69-72_libmerged	3254477	3254481		YPO_RS15525	4
XXX001.A18962-69-72_libmerged	3256526	3256533		glrR	7
XXX001.A18962-69-72_libmerged	3260323	3260324		YPO_RS15550	1
XXX001.A18962-69-72_libmerged	3261534	3261539		YPO_RS15555	5
XXX001.A18962-69-72_libmerged	3262449	3262452		YPO_RS15560	3
XXX001.A18962-69-72_libmerged	3262853	3262877		YPO_RS15560	24
XXX001.A18962-69-72_libmerged	3265845	3265859		purL	14
XXX001.A18962-69-72_libmerged	3269941	3269967		yfhb	26
XXX001.A18962-69-72_libmerged	3270030	3270037		yfhb	7
XXX001.A18962-69-72_libmerged	3281144	3281149		tssC	5
XXX001.A18962-69-72_libmerged	3285812	3285822		YPO_RS15675	10
XXX001.A18962-69-72_libmerged	3287481	3287497		YPO_RS15680	16
XXX001.A18962-69-72_libmerged	3288013	3288016		YPO_RS15680	3
XXX001.A18962-69-72_libmerged	3289940	3289947		tssH	7
XXX001.A18962-69-72_libmerged	3291491	3291516		tssH	25
XXX001.A18962-69-72_libmerged	3294237	3294247		tssF	10
XXX001.A18962-69-72_libmerged	3296514	3296515		YPO_RS15705	1
XXX001.A18962-69-72_libmerged	3298758	3298760		YPO_RS15715	2
XXX001.A18962-69-72_libmerged	3309839	3309843		YPO_RS15760	4
XXX001.A18962-69-72_libmerged	3311459	3311463		YPO_RS15770	4
XXX001.A18962-69-72_libmerged	3314730	3314732		YPO_RS15775	2
XXX001.A18962-69-72_libmerged	3315998	3316017		YPO_RS15785	19
XXX001.A18962-69-72_libmerged	3317883	3317907		YPO_RS15795	24
XXX001.A18962-69-72_libmerged	3320248	3320272		YPO_RS15810	24
XXX001.A18962-69-72_libmerged	3329695	3329701		YPO_RS15860	6
XXX001.A18962-69-72_libmerged	3329951	3329955		YPO_RS15860	4
XXX001.A18962-69-72_libmerged	3330008	3330020		YPO_RS15860	12
XXX001.A18962-69-72_libmerged	3331954	3331958		YPO_RS15865	4
XXX001.A18962-69-72_libmerged	3341349	3341350		cysZ	1
XXX001.A18962-69-72_libmerged	3342442	3342457		cysK	15
XXX001.A18962-69-72_libmerged	3345948	3345950		crr	2
XXX001.A18962-69-72_libmerged	3350259	3350265		YPO_RS15985	6
XXX001.A18962-69-72_libmerged	3352774	3352785		YPO_RS15995	11
XXX001.A18962-69-72_libmerged	3356138	3356165		YPO_RS16010	27
XXX001.A18962-69-72_libmerged	3356950	3356954		YPO_RS16010	4
XXX001.A18962-69-72_libmerged	3357172	3357183		YPO_RS16015	11
XXX001.A18962-69-72_libmerged	3358285	3358287		YPO_RS16020	2
XXX001.A18962-69-72_libmerged	3363701	3363732		YPO_RS16040	31
XXX001.A18962-69-72_libmerged	3364206	3364233		YPO_RS16040	27
XXX001.A18962-69-72_libmerged	3364281	3364294		YPO_RS16040	13
XXX001.A18962-69-72_libmerged	3364671	3364737		YPO_RS16040	66
XXX001.A18962-69-72_libmerged	3369352	3369353		YPO_RS16065	1
XXX001.A18962-69-72_libmerged	3369776	3369780		YPO_RS16065	4
XXX001.A18962-69-72_libmerged	3374051	3374064		YPO_RS16085	13
XXX001.A18962-69-72_libmerged	3378772	3378777		YPO_RS16105	5
XXX001.A18962-69-72_libmerged	3381105	3381122		yapL	17
XXX001.A18962-69-72_libmerged	3383556	3383570		YPO_RS16125	14
XXX001.A18962-69-72_libmerged	3383735	3383738		YPO_RS16125	3
XXX001.A18962-69-72_libmerged	3383844	3383858		YPO_RS16125	14
XXX001.A18962-69-72_libmerged	3385081	3385085		hemF	4
XXX001.A18962-69-72_libmerged	3390907	3390912		napB	5
XXX001.A18962-69-72_libmerged	3396580	3396581		acrD	1
XXX001.A18962-69-72_libmerged	3398572	3398591		acrD	19
XXX001.A18962-69-72_libmerged	3401019	3401022		YPO_RS16200	3
XXX001.A18962-69-72_libmerged	3403429	3403433		YPO_RS16210	4
XXX001.A18962-69-72_libmerged	3405296	3405306		YPO_RS16215	10
XXX001.A18962-69-72_libmerged	3405635	3405660		YPO_RS16220	25
XXX001.A18962-69-72_libmerged	3408132	3408149		YPO_RS16225	17
XXX001.A18962-69-72_libmerged	3412675	3412678		YPO_RS16255	3
XXX001.A18962-69-72_libmerged	3412746	3412758		YPO_RS16255	12
XXX001.A18962-69-72_libmerged	3413139	3413154		YPO_RS16260	15
XXX001.A18962-69-72_libmerged	3415697	3415698		YPO_RS16270	1
XXX001.A18962-69-72_libmerged	3416435	3416438		YPO_RS16270	3
XXX001.A18962-69-72_libmerged	3433073	3433082		purK	9
XXX001.A18962-69-72_libmerged	3434751	3434827		YPO_RS16360	76
XXX001.A18962-69-72_libmerged	3438194	3438199		YPO_RS16375	5
XXX001.A18962-69-72_libmerged	3443266	3443271		copA	5
XXX001.A18962-69-72_libmerged	3449309	3449327		YPO_RS16425	18
XXX001.A18962-69-72_libmerged	3450146	3450162		YPO_RS16425	16
XXX001.A18962-69-72_libmerged	3454800	3454814		fepE	14
XXX001.A18962-69-72_libmerged	3454943	3454944		fepE	1
XXX001.A18962-69-72_libmerged	3455009	3455034		cpsG	25
XXX001.A18962-69-72_libmerged	3455583	3455596		cpsG	13
XXX001.A18962-69-72_libmerged	3455897	3455915		cpsG	18
XXX001.A18962-69-72_libmerged	3456249	3456263		cpsG	14
XXX001.A18962-69-72_libmerged	3456551	3456593		YPO_RS16450	42
XXX001.A18962-69-72_libmerged	3457111	3457117		YPO_RS16450	6
XXX001.A18962-69-72_libmerged	3457401	3457414		YPO_RS16455	13
XXX001.A18962-69-72_libmerged	3461361	3461371		YPO_RS16470	10
XXX001.A18962-69-72_libmerged	3461650	3461668		YPO_RS16470	18
XXX001.A18962-69-72_libmerged	3463389	3463396		YPO_RS16480	7
XXX001.A18962-69-72_libmerged	3463470	3463501		YPO_RS16480	31
XXX001.A18962-69-72_libmerged	3463736	3463824		YPO_RS16480	88
XXX001.A18962-69-72_libmerged	3463879	3463961		YPO_RS16480	82
XXX001.A18962-69-72_libmerged	3464142	3464181		YPO_RS16480	39
XXX001.A18962-69-72_libmerged	3464843	3464849		YPO_RS16485	6
XXX001.A18962-69-72_libmerged	3465004	3465137		YPO_RS16485	133
XXX001.A18962-69-72_libmerged	3465312	3465334		YPO_RS16485	22
XXX001.A18962-69-72_libmerged	3465533	3465556		YPO_RS16485	23
XXX001.A18962-69-72_libmerged	3465567	3465581		YPO_RS16490	14
XXX001.A18962-69-72_libmerged	3466026	3466046		YPO_RS16490	20
XXX001.A18962-69-72_libmerged	3466257	3466388		YPO_RS16490	131
XXX001.A18962-69-72_libmerged	3466588	3466668		YPO_RS16490	80
XXX001.A18962-69-72_libmerged	3466813	3466821		YPO_RS16490	8
XXX001.A18962-69-72_libmerged	3467466	3467470		YPO_RS16495	4
XXX001.A18962-69-72_libmerged	3467500	3467535		YPO_RS16495	35
XXX001.A18962-69-72_libmerged	3467592	3467601		YPO_RS16495	9
XXX001.A18962-69-72_libmerged	3468390	3468393		YPO_RS16500	3
XXX001.A18962-69-72_libmerged	3468606	3468617		YPO_RS16500	11
XXX001.A18962-69-72_libmerged	3468678	3468687		YPO_RS16500	9
XXX001.A18962-69-72_libmerged	3469112	3469125		YPO_RS16500	13
XXX001.A18962-69-72_libmerged	3469632	3469635		rfbH	3
XXX001.A18962-69-72_libmerged	3469797	3469804		rfbH	7
XXX001.A18962-69-72_libmerged	3476161	3476162		htpG	1
XXX001.A18962-69-72_libmerged	3479765	3479766		dnaX	1
XXX001.A18962-69-72_libmerged	3481696	3481699		apt	3
XXX001.A18962-69-72_libmerged	3486644	3486645		mscK	1
XXX001.A18962-69-72_libmerged	3489860	3489868		YPO_RS16590	8
XXX001.A18962-69-72_libmerged	3492271	3492276		YPO_RS16605	5
XXX001.A18962-69-72_libmerged	3492394	3492408		YPO_RS16605	14
XXX001.A18962-69-72_libmerged	3502369	3502371		amtB	2
XXX001.A18962-69-72_libmerged	3504998	3505018		YPO_RS16665	20
XXX001.A18962-69-72_libmerged	3505220	3505228		YPO_RS16670	8
XXX001.A18962-69-72_libmerged	3505489	3505499		YPO_RS16670	10
XXX001.A18962-69-72_libmerged	3506107	3506135		YPO_RS16670	28
XXX001.A18962-69-72_libmerged	3506447	3506483		YPO_RS16670	36
XXX001.A18962-69-72_libmerged	3506760	3506764		YPO_RS16670	4
XXX001.A18962-69-72_libmerged	3509079	3509085		cof	6
XXX001.A18962-69-72_libmerged	3509815	3509818		YPO_RS16690	3
XXX001.A18962-69-72_libmerged	3516255	3516268		hupB	13
XXX001.A18962-69-72_libmerged	3518673	3518678		lon	5
XXX001.A18962-69-72_libmerged	3520936	3520947		clpP	11
XXX001.A18962-69-72_libmerged	3525158	3525169		ampG	11
XXX001.A18962-69-72_libmerged	3527251	3527267		YPO_RS16755	16
XXX001.A18962-69-72_libmerged	3529048	3529051		cyoB	3
XXX001.A18962-69-72_libmerged	3531291	3531301		YPO_RS16775	10
XXX001.A18962-69-72_libmerged	3531636	3531647		cyoE	11
XXX001.A18962-69-72_libmerged	3533522	3533526		YPO_RS16785	4
XXX001.A18962-69-72_libmerged	3537895	3537897		thiI	2
XXX001.A18962-69-72_libmerged	3538601	3538605		xseB	4
XXX001.A18962-69-72_libmerged	3541195	3541198		dxs	3
XXX001.A18962-69-72_libmerged	3543515	3543531		thiL	16
XXX001.A18962-69-72_libmerged	3545405	3545425		ribD	20
XXX001.A18962-69-72_libmerged	3547268	3547272		YPO_RS16860	4
XXX001.A18962-69-72_libmerged	3547439	3547456		YPO_RS16860	17
XXX001.A18962-69-72_libmerged	3548080	3548101		YPO_RS16865	21
XXX001.A18962-69-72_libmerged	3552005	3552009		secD	4
XXX001.A18962-69-72_libmerged	3560389	3560415		YPO_RS16925	26
XXX001.A18962-69-72_libmerged	3560523	3560549		malZ	26
XXX001.A18962-69-72_libmerged	3560726	3560740		malZ	14
XXX001.A18962-69-72_libmerged	3561678	3561697		malZ	19
XXX001.A18962-69-72_libmerged	3562167	3562170		malZ	3
XXX001.A18962-69-72_libmerged	3566285	3566311		YPO_RS16945	26
XXX001.A18962-69-72_libmerged	3568336	3568350		phoR	14
XXX001.A18962-69-72_libmerged	3572087	3572111		YPO_RS16965	24
XXX001.A18962-69-72_libmerged	3579606	3579616		ppnP	10
XXX001.A18962-69-72_libmerged	3581426	3581429		YPO_RS17000	3
XXX001.A18962-69-72_libmerged	3583067	3583078		YPO_RS17010	11
XXX001.A18962-69-72_libmerged	3584788	3584789		proA	1
XXX001.A18962-69-72_libmerged	3592460	3592465		YPO_RS17055	5
XXX001.A18962-69-72_libmerged	3592587	3592611		YPO_RS17055	24
XXX001.A18962-69-72_libmerged	3593053	3593099		YPO_RS17055	46
XXX001.A18962-69-72_libmerged	3597577	3597578		dinB	1
XXX001.A18962-69-72_libmerged	3598163	3598183		YPO_RS17070	20
XXX001.A18962-69-72_libmerged	3600013	3600015		YPO_RS17080	2
XXX001.A18962-69-72_libmerged	3600212	3600224		YPO_RS17080	12
XXX001.A18962-69-72_libmerged	3600751	3600753		nqrF	2
XXX001.A18962-69-72_libmerged	3603237	3603242		YPO_RS17100	5
XXX001.A18962-69-72_libmerged	3609529	3609533		YPO_RS17130	4
XXX001.A18962-69-72_libmerged	3611416	3611427		YPO_RS17130	11
XXX001.A18962-69-72_libmerged	3612307	3612319		YPO_RS17135	12
XXX001.A18962-69-72_libmerged	3615530	3615559		YPO_RS17145	29
XXX001.A18962-69-72_libmerged	3617437	3617447		YPO_RS17145	10
XXX001.A18962-69-72_libmerged	3617938	3617948		YPO_RS17145	10
XXX001.A18962-69-72_libmerged	3618877	3618886		YPO_RS17145	9
XXX001.A18962-69-72_libmerged	3619151	3619160		YPO_RS17145	9
XXX001.A18962-69-72_libmerged	3619190	3619208		YPO_RS17145	18
XXX001.A18962-69-72_libmerged	3620026	3620037		YPO_RS17145	11
XXX001.A18962-69-72_libmerged	3621420	3621422		YPO_RS17150	2
XXX001.A18962-69-72_libmerged	3629917	3629924		YPO_RS17195	7
XXX001.A18962-69-72_libmerged	3632881	3632882		YPO_RS17215	1
XXX001.A18962-69-72_libmerged	3636436	3636442		YPO_RS17230	6
XXX001.A18962-69-72_libmerged	3644390	3644405		YPO_RS17270	15
XXX001.A18962-69-72_libmerged	3647101	3647104		pssA	3
XXX001.A18962-69-72_libmerged	3649934	3649936		YPO_RS17290	2
XXX001.A18962-69-72_libmerged	3655127	3655130		clpB	3
XXX001.A18962-69-72_libmerged	3657836	3657854		pgeF	18
XXX001.A18962-69-72_libmerged	3658556	3658562		rluD	6
XXX001.A18962-69-72_libmerged	3665914	3665940		tyrA	26
XXX001.A18962-69-72_libmerged	3667899	3667901		yehT	2
XXX001.A18962-69-72_libmerged	3672994	3673015		trmD	21
XXX001.A18962-69-72_libmerged	3674539	3674550		ffh	11
XXX001.A18962-69-72_libmerged	3679380	3679388		gshA	8
XXX001.A18962-69-72_libmerged	3680170	3680175		gshA	5
XXX001.A18962-69-72_libmerged	3682376	3682386		YPO_RS17455	10
XXX001.A18962-69-72_libmerged	3685852	3685868		alaS	16
XXX001.A18962-69-72_libmerged	3687043	3687044		recX	1
XXX001.A18962-69-72_libmerged	3692709	3692710		YPO_RS17515	1
XXX001.A18962-69-72_libmerged	3695861	3695867		YPO_RS17530	6
XXX001.A18962-69-72_libmerged	3696538	3696547		YPO_RS17530	9
XXX001.A18962-69-72_libmerged	3697206	3697211		YPO_RS17535	5
XXX001.A18962-69-72_libmerged	3698329	3698332		YPO_RS17540	3
XXX001.A18962-69-72_libmerged	3700523	3700533		YPO_RS17550	10
XXX001.A18962-69-72_libmerged	3700758	3700763		YPO_RS17550	5
XXX001.A18962-69-72_libmerged	3700879	3700882		YPO_RS17550	3
XXX001.A18962-69-72_libmerged	3701736	3701738		katG	2
XXX001.A18962-69-72_libmerged	3702314	3702315		katG	1
XXX001.A18962-69-72_libmerged	3703642	3703645		katG	3
XXX001.A18962-69-72_libmerged	3704392	3704409		cybC	17
XXX001.A18962-69-72_libmerged	3706451	3706470		YPO_RS17575	19
XXX001.A18962-69-72_libmerged	3707751	3707758		dmsA	7
XXX001.A18962-69-72_libmerged	3710925	3710931		YPO_RS17590	6
XXX001.A18962-69-72_libmerged	3713085	3713099		YPO_RS17600	14
XXX001.A18962-69-72_libmerged	3713793	3713794		YPO_RS17600	1
XXX001.A18962-69-72_libmerged	3715588	3715589		YPO_RS17610	1
XXX001.A18962-69-72_libmerged	3720339	3720343		YPO_RS17630	4
XXX001.A18962-69-72_libmerged	3722314	3722319		YPO_RS17635	5
XXX001.A18962-69-72_libmerged	3723497	3723500		map	3
XXX001.A18962-69-72_libmerged	3725436	3725462		YPO_RS17650	26
XXX001.A18962-69-72_libmerged	3728655	3728660		YPO_RS17660	5
XXX001.A18962-69-72_libmerged	3736482	3736490		dhaL	8
XXX001.A18962-69-72_libmerged	3738599	3738611		YPO_RS17715	12
XXX001.A18962-69-72_libmerged	3739412	3739421		YPO_RS17715	9
XXX001.A18962-69-72_libmerged	3745880	3745901		nlpD	21
XXX001.A18962-69-72_libmerged	3746176	3746179		nlpD	3
XXX001.A18962-69-72_libmerged	3746851	3746861		YPO_RS17740	10
XXX001.A18962-69-72_libmerged	3747803	3747804		truD	1
XXX001.A18962-69-72_libmerged	3747899	3747903		truD	4
XXX001.A18962-69-72_libmerged	3749582	3749596		ispD	14
XXX001.A18962-69-72_libmerged	3754067	3754076		cysD	9
XXX001.A18962-69-72_libmerged	3754605	3754608		cobA	3
XXX001.A18962-69-72_libmerged	3759107	3759121		cysI	14
XXX001.A18962-69-72_libmerged	3759549	3759557		cysI	8
XXX001.A18962-69-72_libmerged	3760428	3760438		cysJ	10
XXX001.A18962-69-72_libmerged	3769868	3769884		relA	16
XXX001.A18962-69-72_libmerged	3769964	3769969		relA	5
XXX001.A18962-69-72_libmerged	3771833	3771837		barA	4
XXX001.A18962-69-72_libmerged	3773773	3773798		barA	25
XXX001.A18962-69-72_libmerged	3776602	3776616		dgt	14
XXX001.A18962-69-72_libmerged	3778125	3778135		mtnN	10
XXX001.A18962-69-72_libmerged	3779306	3779308		btuF	2
XXX001.A18962-69-72_libmerged	3779485	3779492		YPO_RS17900	7
XXX001.A18962-69-72_libmerged	3780732	3780733		clcA	1
XXX001.A18962-69-72_libmerged	3784815	3784817		fhuB	2
XXX001.A18962-69-72_libmerged	3785898	3785904		fhuB	6
XXX001.A18962-69-72_libmerged	3787327	3787337		fhuC	10
XXX001.A18962-69-72_libmerged	3787412	3787413		fhuC	1
XXX001.A18962-69-72_libmerged	3797309	3797310		pcnB	1
XXX001.A18962-69-72_libmerged	3804778	3804782		YPO_RS18000	4
XXX001.A18962-69-72_libmerged	3811562	3811575		YPO_RS18035	13
XXX001.A18962-69-72_libmerged	3812180	3812186		YPO_RS18035	6
XXX001.A18962-69-72_libmerged	3812272	3812305		YPO_RS18035	33
XXX001.A18962-69-72_libmerged	3814928	3814936		acnB	8
XXX001.A18962-69-72_libmerged	3817901	3817902		lpdA	1
XXX001.A18962-69-72_libmerged	3819397	3819404		aceF	7
XXX001.A18962-69-72_libmerged	3819507	3819510		aceF	3
XXX001.A18962-69-72_libmerged	3820051	3820056		aceF	5
XXX001.A18962-69-72_libmerged	3826689	3826690		ampE	1
XXX001.A18962-69-72_libmerged	3827200	3827208		ampE	8
XXX001.A18962-69-72_libmerged	3830244	3830249		gspE	5
XXX001.A18962-69-72_libmerged	3832356	3832357		hofC	1
XXX001.A18962-69-72_libmerged	3835058	3835066		coaE	8
XXX001.A18962-69-72_libmerged	3858741	3858750		YPO_RS18220	9
XXX001.A18962-69-72_libmerged	3859668	3859669		YPO_RS18225	1
XXX001.A18962-69-72_libmerged	3859717	3859719		YPO_RS18225	2
XXX001.A18962-69-72_libmerged	3864639	3864641		phnF	2
XXX001.A18962-69-72_libmerged	3864867	3864871		phnG	4
XXX001.A18962-69-72_libmerged	3868198	3868227		phnK	29
XXX001.A18962-69-72_libmerged	3873219	3873235		YPO_RS18300	16
XXX001.A18962-69-72_libmerged	3873982	3873983		YPO_RS18305	1
XXX001.A18962-69-72_libmerged	3877224	3877229		YPO_RS18320	5
XXX001.A18962-69-72_libmerged	3880962	3880966		YPO_RS18335	4
XXX001.A18962-69-72_libmerged	3881575	3881581		YPO_RS18335	6
XXX001.A18962-69-72_libmerged	3882441	3882446		YPO_RS18335	5
XXX001.A18962-69-72_libmerged	3886625	3886628		YPO_RS18360	3
XXX001.A18962-69-72_libmerged	3888386	3888390		YPO_RS18370	4
XXX001.A18962-69-72_libmerged	3889305	3889307		YPO_RS18370	2
XXX001.A18962-69-72_libmerged	3891973	3891977		YPO_RS18375	4
XXX001.A18962-69-72_libmerged	3893127	3893129		YPO_RS18380	2
XXX001.A18962-69-72_libmerged	3898148	3898152		nlpI	4
XXX001.A18962-69-72_libmerged	3905034	3905036		infB	2
XXX001.A18962-69-72_libmerged	3906344	3906380		infB	36
XXX001.A18962-69-72_libmerged	3917766	3917774		pmrA	8
XXX001.A18962-69-72_libmerged	3920050	3920055		cgtA	5
XXX001.A18962-69-72_libmerged	3921417	3921418		YPO_RS18520	1
XXX001.A18962-69-72_libmerged	3931031	3931050		YPO_RS18580	19
XXX001.A18962-69-72_libmerged	3932466	3932470		YPO_RS18585	4
XXX001.A18962-69-72_libmerged	3932861	3932868		YPO_RS18585	7
XXX001.A18962-69-72_libmerged	3940719	3940723		YPO_RS18610	4
XXX001.A18962-69-72_libmerged	3942590	3942594		YPO_RS18620	4
XXX001.A18962-69-72_libmerged	3946234	3946238		YPO_RS18635	4
XXX001.A18962-69-72_libmerged	3955026	3955028		YPO_RS18695	2
XXX001.A18962-69-72_libmerged	3956960	3956988		rsmI	28
XXX001.A18962-69-72_libmerged	3958065	3958078		YPO_RS18710	13
XXX001.A18962-69-72_libmerged	3960439	3960461		yraP	22
XXX001.A18962-69-72_libmerged	3970211	3970217		gltB	6
XXX001.A18962-69-72_libmerged	3983717	3983718		ibaG	1
XXX001.A18962-69-72_libmerged	3990059	3990061		kdsC	2
XXX001.A18962-69-72_libmerged	3990492	3990501		kdsC	9
XXX001.A18962-69-72_libmerged	3992721	3992728		rpoN	7
XXX001.A18962-69-72_libmerged	3993746	3993750		rpoN	4
XXX001.A18962-69-72_libmerged	4004700	4004702		tssJ	2
XXX001.A18962-69-72_libmerged	4006155	4006157		YPO_RS18960	2
XXX001.A18962-69-72_libmerged	4006228	4006230		YPO_RS18960	2
XXX001.A18962-69-72_libmerged	4006299	4006300		YPO_RS18960	1
XXX001.A18962-69-72_libmerged	4011715	4011716		tssA	1
XXX001.A18962-69-72_libmerged	4011774	4011775		tssA	1
XXX001.A18962-69-72_libmerged	4016437	4016444		YPO_RS18990	7
XXX001.A18962-69-72_libmerged	4016703	4016730		YPO_RS18990	27
XXX001.A18962-69-72_libmerged	4020409	4020426		YPO_RS19010	17
XXX001.A18962-69-72_libmerged	4023793	4023805		YPO_RS19015	12
XXX001.A18962-69-72_libmerged	4026643	4026649		YPO_RS19045	6
XXX001.A18962-69-72_libmerged	4027618	4027621		YPO_RS19045	3
XXX001.A18962-69-72_libmerged	4028916	4028921		YPO_RS19050	5
XXX001.A18962-69-72_libmerged	4029403	4029461		YPO_RS19055	58
XXX001.A18962-69-72_libmerged	4030607	4030626		YPO_RS19055	19
XXX001.A18962-69-72_libmerged	4032703	4032705		YPO_RS19055	2
XXX001.A18962-69-72_libmerged	4033773	4033820		YPO_RS19060	47
XXX001.A18962-69-72_libmerged	4033963	4033964		YPO_RS19060	1
XXX001.A18962-69-72_libmerged	4034653	4034674		YPO_RS19065	21
XXX001.A18962-69-72_libmerged	4040210	4040212		deoC	2
XXX001.A18962-69-72_libmerged	4042054	4042057		YPO_RS19105	3
XXX001.A18962-69-72_libmerged	4049557	4049581		YPO_RS19140	24
XXX001.A18962-69-72_libmerged	4057813	4057814		YPO_RS19170	1
XXX001.A18962-69-72_libmerged	4070105	4070109		YPO_RS19235	4
XXX001.A18962-69-72_libmerged	4071023	4071034		YPO_RS19235	11
XXX001.A18962-69-72_libmerged	4076130	4076133		panF	3
XXX001.A18962-69-72_libmerged	4078603	4078621		YPO_RS19285	18
XXX001.A18962-69-72_libmerged	4079642	4079643		accC	1
XXX001.A18962-69-72_libmerged	4082226	4082243		msrQ	17
XXX001.A18962-69-72_libmerged	4084222	4084231		YPO_RS19315	9
XXX001.A18962-69-72_libmerged	4085918	4085925		csrD	7
XXX001.A18962-69-72_libmerged	4086345	4086351		csrD	6
XXX001.A18962-69-72_libmerged	4087477	4087484		YPO_RS19325	7
XXX001.A18962-69-72_libmerged	4089472	4089480		mreC	8
XXX001.A18962-69-72_libmerged	4095959	4095965		YPO_RS19350	6
XXX001.A18962-69-72_libmerged	4098354	4098358		tldD	4
XXX001.A18962-69-72_libmerged	4098633	4098683		YPO_RS19365	50
XXX001.A18962-69-72_libmerged	4098793	4098808		YPO_RS19365	15
XXX001.A18962-69-72_libmerged	4098934	4098975		YPO_RS19365	41
XXX001.A18962-69-72_libmerged	4099393	4099457		YPO_RS19365	64
XXX001.A18962-69-72_libmerged	4101521	4101537		YPO_RS19370	16
XXX001.A18962-69-72_libmerged	4101623	4101715		YPO_RS19370	92
XXX001.A18962-69-72_libmerged	4101748	4101752		YPO_RS19370	4
XXX001.A18962-69-72_libmerged	4101881	4101917		YPO_RS19370	36
XXX001.A18962-69-72_libmerged	4107019	4107025		YPO_RS19390	6
XXX001.A18962-69-72_libmerged	4108787	4108790		YPO_RS19390	3
XXX001.A18962-69-72_libmerged	4110154	4110190		YPO_RS19390	36
XXX001.A18962-69-72_libmerged	4111894	4111896		YPO_RS19395	2
XXX001.A18962-69-72_libmerged	4112693	4112785		YPO_RS19400	92
XXX001.A18962-69-72_libmerged	4113670	4113694		YPO_RS19400	24
XXX001.A18962-69-72_libmerged	4113881	4113893		YPO_RS19400	12
XXX001.A18962-69-72_libmerged	4113986	4114051		YPO_RS19405	65
XXX001.A18962-69-72_libmerged	4114227	4114230		YPO_RS19405	3
XXX001.A18962-69-72_libmerged	4115221	4115227		YPO_RS19405	6
XXX001.A18962-69-72_libmerged	4115624	4115628		YPO_RS19405	4
XXX001.A18962-69-72_libmerged	4117197	4117199		YPO_RS19410	2
XXX001.A18962-69-72_libmerged	4126108	4126113		pmbA	5
XXX001.A18962-69-72_libmerged	4127396	4127404		YPO_RS19460	8
XXX001.A18962-69-72_libmerged	4132587	4132588		treB	1
XXX001.A18962-69-72_libmerged	4133501	4133504		treR	3
XXX001.A18962-69-72_libmerged	4133851	4133855		treR	4
XXX001.A18962-69-72_libmerged	4139868	4139870		tssC	2
XXX001.A18962-69-72_libmerged	4142754	4142756		YPO_RS19535	2
XXX001.A18962-69-72_libmerged	4142809	4142832		YPO_RS19535	23
XXX001.A18962-69-72_libmerged	4146219	4146223		malK	4
XXX001.A18962-69-72_libmerged	4147112	4147120		YPO_RS19555	8
XXX001.A18962-69-72_libmerged	4150432	4150438		malF	6
XXX001.A18962-69-72_libmerged	4151319	4151325		malG	6
XXX001.A18962-69-72_libmerged	4152817	4152822		pgi	5
XXX001.A18962-69-72_libmerged	4153549	4153563		pgi	14
XXX001.A18962-69-72_libmerged	4156567	4156586		YPO_RS19590	19
XXX001.A18962-69-72_libmerged	4158672	4158675		YPO_RS19595	3
XXX001.A18962-69-72_libmerged	4164017	4164025		metH	8
XXX001.A18962-69-72_libmerged	4164941	4164951		metH	10
XXX001.A18962-69-72_libmerged	4169274	4169277		aceK	3
XXX001.A18962-69-72_libmerged	4170168	4170184		aceA	16
XXX001.A18962-69-72_libmerged	4176214	4176220		YPO_RS19645	6
XXX001.A18962-69-72_libmerged	4187194	4187219		hemE	25
XXX001.A18962-69-72_libmerged	4188440	4188445		YPO_RS19705	5
XXX001.A18962-69-72_libmerged	4188476	4188477		YPO_RS19705	1
XXX001.A18962-69-72_libmerged	4189613	4189615		nudC	2
XXX001.A18962-69-72_libmerged	4196095	4196099		thiH	4
XXX001.A18962-69-72_libmerged	4208370	4208372		rplK	2
XXX001.A18962-69-72_libmerged	4216388	4216393		birA	5
XXX001.A18962-69-72_libmerged	4224768	4224774		trkH	6
XXX001.A18962-69-72_libmerged	4226971	4226991		YPO_RS19900	20
XXX001.A18962-69-72_libmerged	4231066	4231080		fadA	14
XXX001.A18962-69-72_libmerged	4231851	4231854		fadA	3
XXX001.A18962-69-72_libmerged	4233723	4233725		ubiD	2
XXX001.A18962-69-72_libmerged	4235788	4235792		hemB	4
XXX001.A18962-69-72_libmerged	4242672	4242690		ubiB	18
XXX001.A18962-69-72_libmerged	4247208	4247209		YPO_RS20000	1
XXX001.A18962-69-72_libmerged	4248057	4248077		YPO_RS20000	20
XXX001.A18962-69-72_libmerged	4249791	4249796		YPO_RS20005	5
XXX001.A18962-69-72_libmerged	4251568	4251570		YPO_RS20015	2
XXX001.A18962-69-72_libmerged	4251762	4251776		YPO_RS20015	14
XXX001.A18962-69-72_libmerged	4257417	4257418		YPO_RS20035	1
XXX001.A18962-69-72_libmerged	4258599	4258608		YPO_RS20045	9
XXX001.A18962-69-72_libmerged	4260430	4260436		ugpA	6
XXX001.A18962-69-72_libmerged	4263474	4263500		YPO_RS20065	26
XXX001.A18962-69-72_libmerged	4264346	4264362		YPO_RS20070	16
XXX001.A18962-69-72_libmerged	4268315	4268321		YPO_RS20085	6
XXX001.A18962-69-72_libmerged	4268925	4268943		YPO_RS20090	18
XXX001.A18962-69-72_libmerged	4269655	4269664		YPO_RS20095	9
XXX001.A18962-69-72_libmerged	4269730	4269732		YPO_RS20095	2
XXX001.A18962-69-72_libmerged	4275256	4275262		YPO_RS20120	6
XXX001.A18962-69-72_libmerged	4280940	4280957		ftsY	17
XXX001.A18962-69-72_libmerged	4284198	4284204		YPO_RS20175	6
XXX001.A18962-69-72_libmerged	4284342	4284345		YPO_RS20175	3
XXX001.A18962-69-72_libmerged	4286493	4286525		YPO_RS20180	32
XXX001.A18962-69-72_libmerged	4286720	4286732		YPO_RS20180	12
XXX001.A18962-69-72_libmerged	4294541	4294551		glpQ	10
XXX001.A18962-69-72_libmerged	4297446	4297452		yigL	6
XXX001.A18962-69-72_libmerged	4299263	4299274		rhtB	11
XXX001.A18962-69-72_libmerged	4299307	4299311		rhtB	4
XXX001.A18962-69-72_libmerged	4307488	4307506		YPO_RS20275	18
XXX001.A18962-69-72_libmerged	4313244	4313248		xerC	4
XXX001.A18962-69-72_libmerged	4314490	4314504		YPO_RS20305	14
XXX001.A18962-69-72_libmerged	4320244	4320245		hemC	1
XXX001.A18962-69-72_libmerged	4322960	4323006		hemY	46
XXX001.A18962-69-72_libmerged	4328243	4328252		rffM	9
XXX001.A18962-69-72_libmerged	4340494	4340499		wecA	5
XXX001.A18962-69-72_libmerged	4341074	4341086		wecA	12
XXX001.A18962-69-72_libmerged	4345070	4345081		rhlB	11
XXX001.A18962-69-72_libmerged	4349670	4349692		YPO_RS20480	22
XXX001.A18962-69-72_libmerged	4349954	4349960		YPO_RS20480	6
XXX001.A18962-69-72_libmerged	4353959	4353969		YPO_RS20500	10
XXX001.A18962-69-72_libmerged	4357746	4357753		stbD	7
XXX001.A18962-69-72_libmerged	4359333	4359385		YPO_RS20515	52
XXX001.A18962-69-72_libmerged	4359534	4359543		YPO_RS20515	9
XXX001.A18962-69-72_libmerged	4360677	4360689		YPO_RS20530	12
XXX001.A18962-69-72_libmerged	4364592	4364600		ilvY	8
XXX001.A18962-69-72_libmerged	4369740	4369755		ilvA	15
XXX001.A18962-69-72_libmerged	4370922	4370923		ilvD	1
XXX001.A18962-69-72_libmerged	4376216	4376219		YPO_RS20610	3
XXX001.A18962-69-72_libmerged	4376335	4376340		YPO_RS20610	5
XXX001.A18962-69-72_libmerged	4376511	4376513		YPO_RS20610	2
XXX001.A18962-69-72_libmerged	4389733	4389737		YPO_RS20670	4
XXX001.A18962-69-72_libmerged	4392459	4392466		btuB	7
XXX001.A18962-69-72_libmerged	4400745	4400795		YPO_RS20725	50
XXX001.A18962-69-72_libmerged	4401545	4401546		YPO_RS20725	1
XXX001.A18962-69-72_libmerged	4403850	4403854		YPO_RS20735	4
XXX001.A18962-69-72_libmerged	4404567	4404594		YPO_RS20735	27
XXX001.A18962-69-72_libmerged	4408193	4408200		YPO_RS20745	7
XXX001.A18962-69-72_libmerged	4408288	4408320		YPO_RS20745	32
XXX001.A18962-69-72_libmerged	4420167	4420172		YPO_RS20785	5
XXX001.A18962-69-72_libmerged	4420167	4420172		YPO_RS20790	5
XXX001.A18962-69-72_libmerged	4421968	4421971		glpD	3
XXX001.A18962-69-72_libmerged	4422400	4422422		glpD	22
XXX001.A18962-69-72_libmerged	4425927	4425935		glgA	8
XXX001.A18962-69-72_libmerged	4429841	4429859		glgX	18
XXX001.A18962-69-72_libmerged	4433384	4433385		YPO_RS20825	1
XXX001.A18962-69-72_libmerged	4433876	4433881		YPO_RS20825	5
XXX001.A18962-69-72_libmerged	4436222	4436226		YPO_RS20830	4
XXX001.A18962-69-72_libmerged	4442882	4442913		YPO_RS20830	31
XXX001.A18962-69-72_libmerged	4448919	4448925		YPO_RS20865	6
XXX001.A18962-69-72_libmerged	4452730	4452740		gntR	10
XXX001.A18962-69-72_libmerged	4464956	4464957		YPO_RS20940	1
XXX001.A18962-69-72_libmerged	4469324	4469325		uspB	1
XXX001.A18962-69-72_libmerged	4471976	4471978		gdhA	2
XXX001.A18962-69-72_libmerged	4477803	4477822		YPO_RS20990	19
XXX001.A18962-69-72_libmerged	4480306	4480307		YPO_RS21000	1
XXX001.A18962-69-72_libmerged	4480613	4480624		YPO_RS21000	11
XXX001.A18962-69-72_libmerged	4481871	4481877		YPO_RS21010	6
XXX001.A18962-69-72_libmerged	4481952	4481962		YPO_RS21010	10
XXX001.A18962-69-72_libmerged	4483575	4483629		YPO_RS21020	54
XXX001.A18962-69-72_libmerged	4483824	4483831		YPO_RS21020	7
XXX001.A18962-69-72_libmerged	4483889	4483896		YPO_RS21020	7
XXX001.A18962-69-72_libmerged	4484162	4484213		YPO_RS21025	51
XXX001.A18962-69-72_libmerged	4484572	4484595		YPO_RS21025	23
XXX001.A18962-69-72_libmerged	4484938	4484968		YPO_RS21030	30
XXX001.A18962-69-72_libmerged	4486230	4486232		yapE	2
XXX001.A18962-69-72_libmerged	4486642	4486643		yapE	1
XXX001.A18962-69-72_libmerged	4487790	4487796		yapE	6
XXX001.A18962-69-72_libmerged	4488027	4488030		yapE	3
XXX001.A18962-69-72_libmerged	4488500	4488506		yapE	6
XXX001.A18962-69-72_libmerged	4489845	4489853		yhjD	8
XXX001.A18962-69-72_libmerged	4497126	4497147		YPO_RS21070	21
XXX001.A18962-69-72_libmerged	4499460	4499462		YPO_RS21075	2
XXX001.A18962-69-72_libmerged	4503362	4503366		YPO_RS21090	4
XXX001.A18962-69-72_libmerged	4504578	4504595		hmsP	17
XXX001.A18962-69-72_libmerged	4507309	4507313		YPO_RS21105	4
XXX001.A18962-69-72_libmerged	4509503	4509509		dppD	6
XXX001.A18962-69-72_libmerged	4510989	4510990		dppB	1
XXX001.A18962-69-72_libmerged	4512507	4512514		YPO_RS21130	7
XXX001.A18962-69-72_libmerged	4514630	4514652		YPO_RS21135	22
XXX001.A18962-69-72_libmerged	4516143	4516156		YPO_RS21140	13
XXX001.A18962-69-72_libmerged	4516746	4516765		YPO_RS21140	19
XXX001.A18962-69-72_libmerged	4517253	4517261		YPO_RS21140	8
XXX001.A18962-69-72_libmerged	4517368	4517373		YPO_RS21140	5
XXX001.A18962-69-72_libmerged	4518390	4518397		YPO_RS21150	7
XXX001.A18962-69-72_libmerged	4525065	4525071		eptB	6
XXX001.A18962-69-72_libmerged	4527741	4527757		YPO_RS21190	16
XXX001.A18962-69-72_libmerged	4528684	4528686		YPO_RS21190	2
XXX001.A18962-69-72_libmerged	4528836	4528846		YPO_RS21190	10
XXX001.A18962-69-72_libmerged	4533453	4533454		YPO_RS21205	1
XXX001.A18962-69-72_libmerged	4533615	4533627		YPO_RS21205	12
XXX001.A18962-69-72_libmerged	4534807	4534828		YPO_RS21210	21
XXX001.A18962-69-72_libmerged	4535154	4535164		YPO_RS21215	10
XXX001.A18962-69-72_libmerged	4540489	4540490		YPO_RS21235	1
XXX001.A18962-69-72_libmerged	4542383	4542384		YPO_RS21255	1
XXX001.A18962-69-72_libmerged	4545347	4545350		YPO_RS21280	3
XXX001.A18962-69-72_libmerged	4545686	4545697		YPO_RS21280	11
XXX001.A18962-69-72_libmerged	4545800	4545882		YPO_RS21280	82
XXX001.A18962-69-72_libmerged	4546399	4546404		YPO_RS21280	5
XXX001.A18962-69-72_libmerged	4550285	4550294		YPO_RS21300	9
XXX001.A18962-69-72_libmerged	4551758	4551772		YPO_RS21305	14
XXX001.A18962-69-72_libmerged	4554004	4554011		xylA	7
XXX001.A18962-69-72_libmerged	4558126	4558130		YPO_RS21330	4
XXX001.A18962-69-72_libmerged	4561504	4561524		YPO_RS21340	20
XXX001.A18962-69-72_libmerged	4563161	4563167		YPO_RS21345	6
XXX001.A18962-69-72_libmerged	4563345	4563355		YPO_RS21345	10
XXX001.A18962-69-72_libmerged	4566398	4566416		YPO_RS21360	18
XXX001.A18962-69-72_libmerged	4566639	4566644		YPO_RS21360	5
XXX001.A18962-69-72_libmerged	4567743	4567773		YPO_RS21370	30
XXX001.A18962-69-72_libmerged	4569613	4569630		selB	17
XXX001.A18962-69-72_libmerged	4572778	4572802		YPO_RS21400	24
XXX001.A18962-69-72_libmerged	4579401	4579403		fdhD	2
XXX001.A18962-69-72_libmerged	4593757	4593764		glyQ	7
XXX001.A18962-69-72_libmerged	4594607	4594614		YPO_RS21490	7
XXX001.A18962-69-72_libmerged	4596426	4596447		YPO_RS21500	21
XXX001.A18962-69-72_libmerged	4596928	4596930		YPO_RS21505	2
XXX001.A18962-69-72_libmerged	4599449	4599450		YPO_RS21515	1
XXX001.A18962-69-72_libmerged	4601643	4601752		YPO_RS21520	109
XXX001.A18962-69-72_libmerged	4601902	4601903		YPO_RS21520	1
XXX001.A18962-69-72_libmerged	4602065	4602067		YPO_RS21520	2
XXX001.A18962-69-72_libmerged	4602559	4602563		YPO_RS21525	4
XXX001.A18962-69-72_libmerged	4607560	4607564		YPO_RS21545	4
XXX001.A18962-69-72_libmerged	4609003	4609004		YPO_RS21555	1
XXX001.A18962-69-72_libmerged	4609858	4609864		YPO_RS21560	6
XXX001.A18962-69-72_libmerged	4612042	4612045		YPO_RS21565	3
XXX001.A18962-69-72_libmerged	4612910	4612919		yidA	9
XXX001.A18962-69-72_libmerged	4612996	4612999		yidA	3
XXX001.A18962-69-72_libmerged	4614237	4614279		gyrB	42
XXX001.A18962-69-72_libmerged	4615707	4615710		gyrB	3
XXX001.A18962-69-72_libmerged	4620970	4620973		yidD	3
XXX001.A18962-69-72_libmerged	4623267	4623272		mnmE	5
XXX001.A18962-69-72_libmerged	4623769	4623778		mnmE	9
XXX001.A18962-69-72_libmerged	4626181	4626185		YPO_RS21630	4
XXX001.A18962-69-72_libmerged	4626266	4626316		YPO_RS21630	50
XXX001.A18962-69-72_libmerged	4628543	4628550		YPO_RS21640	7
XXX001.A18962-69-72_libmerged	4629423	4629425		YPO_RS21645	2
XXX001.A18962-69-72_libmerged	4633216	4633228		YPO_RS21670	12
XXX001.A18962-69-72_libmerged	4633500	4633501		YPO_RS21670	1
XXX001.A18962-69-72_libmerged	4638594	4638596		pstS	2
XXX001.A18962-69-72_libmerged	4640546	4640549		glmS	3
XXX001.A18962-69-72_libmerged	4640791	4640795		glmS	4
XXX001.A18962-69-72_libmerged	4649447	4649449		atpB	2
XXX001.A18962-69-72_libmerged	4653560	4653567		mnmG	7
Y.pseudo.0.1_32.fq	12187	12192		YPO_RS01065	5
Y.pseudo.0.1_32.fq	14916	14918		YPO_RS01080	2
Y.pseudo.0.1_32.fq	106548	106593		YPO_RS01520	45
Y.pseudo.0.1_32.fq	194692	194696		YPO_RS01880	4
Y.pseudo.0.1_32.fq	255236	255244		YPO_RS02280	8
Y.pseudo.0.1_32.fq	256455	256458		YPO_RS02285	3
Y.pseudo.0.1_32.fq	312344	312345		yapK	1
Y.pseudo.0.1_32.fq	313615	313656		yapK	41
Y.pseudo.0.1_32.fq	313926	313958		yapK	32
Y.pseudo.0.1_32.fq	340674	340692		YPO_RS02665	18
Y.pseudo.0.1_32.fq	373995	373996		mscM	1
Y.pseudo.0.1_32.fq	401052	401061		YPO_RS02925	9
Y.pseudo.0.1_32.fq	403049	405112		YPO_RS02940	2063
Y.pseudo.0.1_32.fq	405109	406425		YPO_RS02945	1316
Y.pseudo.0.1_32.fq	407449	408774		YPO_RS02955	1325
Y.pseudo.0.1_32.fq	408824	409546		YPO_RS02960	722
Y.pseudo.0.1_32.fq	409518	410891		YPO_RS02965	1373
Y.pseudo.0.1_32.fq	411235	411573		YPO_RS02970	338
Y.pseudo.0.1_32.fq	411724	411921		YPO_RS02975	197
Y.pseudo.0.1_32.fq	412163	413551		YPO_RS02980	1388
Y.pseudo.0.1_32.fq	413548	414702		YPO_RS02985	1154
Y.pseudo.0.1_32.fq	437024	437054		YPO_RS03085	30
Y.pseudo.0.1_32.fq	456465	456466		YPO_RS03175	1
Y.pseudo.0.1_32.fq	493893	493894		YPO_RS03330	1
Y.pseudo.0.1_32.fq	493997	494095		YPO_RS03330	98
Y.pseudo.0.1_32.fq	494582	494753		YPO_RS03330	171
Y.pseudo.0.1_32.fq	495043	495253		YPO_RS03330	210
Y.pseudo.0.1_32.fq	495367	495388		YPO_RS03330	21
Y.pseudo.0.1_32.fq	495781	495902		YPO_RS03330	121
Y.pseudo.0.1_32.fq	516926	516941		YPO_RS03420	15
Y.pseudo.0.1_32.fq	633931	633932		yapG	1
Y.pseudo.0.1_32.fq	643446	643543		YPO_RS03950	97
Y.pseudo.0.1_32.fq	651538	651539		cdiA	1
Y.pseudo.0.1_32.fq	658554	659206		cdiA	652
Y.pseudo.0.1_32.fq	659203	659436		cdiI	233
Y.pseudo.0.1_32.fq	659498	659647		YPO_RS03990	149
Y.pseudo.0.1_32.fq	659702	659929		YPO_RS03995	227
Y.pseudo.0.1_32.fq	659865	660023		YPO_RS04000	158
Y.pseudo.0.1_32.fq	660025	660441		YPO_RS04005	416
Y.pseudo.0.1_32.fq	660474	660478		YPO_RS04010	4
Y.pseudo.0.1_32.fq	660597	660599		YPO_RS04010	2
Y.pseudo.0.1_32.fq	661023	661025		YPO_RS04010	2
Y.pseudo.0.1_32.fq	661227	661229		YPO_RS04010	2
Y.pseudo.0.1_32.fq	696161	696202		YPO_RS04170	41
Y.pseudo.0.1_32.fq	754862	754863		YPO_RS04440	1
Y.pseudo.0.1_32.fq	755198	755211		YPO_RS04440	13
Y.pseudo.0.1_32.fq	755392	755399		YPO_RS04445	7
Y.pseudo.0.1_32.fq	755893	755955		YPO_RS04445	62
Y.pseudo.0.1_32.fq	762245	762307		YPO_RS04475	62
Y.pseudo.0.1_32.fq	784637	784681		flaE	44
Y.pseudo.0.1_32.fq	785300	785305		YPO_RS04600	5
Y.pseudo.0.1_32.fq	790809	790874		flgK	65
Y.pseudo.0.1_32.fq	791459	791465		flgL	6
Y.pseudo.0.1_32.fq	791617	791794		flgL	177
Y.pseudo.0.1_32.fq	793536	793554		YPO_RS04650	18
Y.pseudo.0.1_32.fq	795520	795663		YPO_RS04660	143
Y.pseudo.0.1_32.fq	795876	796355		YPO_RS04660	479
Y.pseudo.0.1_32.fq	797110	797181		YPO_RS04665	71
Y.pseudo.0.1_32.fq	797548	798032		YPO_RS04665	484
Y.pseudo.0.1_32.fq	798266	798309		YPO_RS04665	43
Y.pseudo.0.1_32.fq	798718	798732		YPO_RS04670	14
Y.pseudo.0.1_32.fq	798882	799505		YPO_RS04670	623
Y.pseudo.0.1_32.fq	799679	799706		YPO_RS04670	27
Y.pseudo.0.1_32.fq	800017	800362		fliD	345
Y.pseudo.0.1_32.fq	800570	800730		fliD	160
Y.pseudo.0.1_32.fq	800931	801294		fliD	363
Y.pseudo.0.1_32.fq	801304	801384		fliS	80
Y.pseudo.0.1_32.fq	801729	801770		YPO_RS04685	41
Y.pseudo.0.1_32.fq	802972	803083		YPO_RS04690	111
Y.pseudo.0.1_32.fq	802540	802844		YPO_RS04690	304
Y.pseudo.0.1_32.fq	803234	803339		YPO_RS04695	105
Y.pseudo.0.1_32.fq	816868	817066		YPO_RS04770	198
Y.pseudo.0.1_32.fq	839801	839859		YPO_RS04815	58
Y.pseudo.0.1_32.fq	839849	839864		YPO_RS04820	15
Y.pseudo.0.1_32.fq	845426	845574		YPO_RS04835	148
Y.pseudo.0.1_32.fq	851709	851711		YPO_RS04845	2
Y.pseudo.0.1_32.fq	854608	854767		YPO_RS04845	159
Y.pseudo.0.1_32.fq	856405	856432		YPO_RS04845	27
Y.pseudo.0.1_32.fq	856533	856540		YPO_RS04845	7
Y.pseudo.0.1_32.fq	858880	858881		YPO_RS04860	1
Y.pseudo.0.1_32.fq	862346	862350		ptsP	4
Y.pseudo.0.1_32.fq	888500	888612		YPO_RS04990	112
Y.pseudo.0.1_32.fq	888751	888830		YPO_RS04990	79
Y.pseudo.0.1_32.fq	889270	889505		gspJ	235
Y.pseudo.0.1_32.fq	889677	889737		gspI	60
Y.pseudo.0.1_32.fq	908126	908130		tnpA	4
Y.pseudo.0.1_32.fq	959307	959429		YPO_RS05285	122
Y.pseudo.0.1_32.fq	959426	959738		YPO_RS05290	312
Y.pseudo.0.1_32.fq	963501	963611		YPO_RS05310	110
Y.pseudo.0.1_32.fq	1017646	1017658		tkt	12
Y.pseudo.0.1_32.fq	1019782	1019813		YPO_RS05580	31
Y.pseudo.0.1_32.fq	1034290	1034291		YPO_RS05650	1
Y.pseudo.0.1_32.fq	1034850	1034933		YPO_RS05655	83
Y.pseudo.0.1_32.fq	1035092	1035177		YPO_RS05655	85
Y.pseudo.0.1_32.fq	1043777	1044025		YPO_RS05675	248
Y.pseudo.0.1_32.fq	1044269	1044954		YPO_RS05675	685
Y.pseudo.0.1_32.fq	1045273	1045318		YPO_RS05675	45
Y.pseudo.0.1_32.fq	1045440	1045771		YPO_RS05675	331
Y.pseudo.0.1_32.fq	1045878	1045935		YPO_RS05675	57
Y.pseudo.0.1_32.fq	1046149	1046188		YPO_RS05675	39
Y.pseudo.0.1_32.fq	1046349	1046811		YPO_RS05675	462
Y.pseudo.0.1_32.fq	1065131	1065168		YPO_RS05755	37
Y.pseudo.0.1_32.fq	1068902	1068906		YPO_RS05770	4
Y.pseudo.0.1_32.fq	1070114	1070196		YPO_RS05775	82
Y.pseudo.0.1_32.fq	1074923	1074924		YPO_RS05800	1
Y.pseudo.0.1_32.fq	1075291	1075316		YPO_RS05800	25
Y.pseudo.0.1_32.fq	1077187	1077634		tssH	447
Y.pseudo.0.1_32.fq	1077857	1077936		tssH	79
Y.pseudo.0.1_32.fq	1078773	1078804		tssH	31
Y.pseudo.0.1_32.fq	1079128	1079151		tssH	23
Y.pseudo.0.1_32.fq	1079369	1079422		tssH	53
Y.pseudo.0.1_32.fq	1080603	1080625		YPO_RS05815	22
Y.pseudo.0.1_32.fq	1080762	1080830		YPO_RS05815	68
Y.pseudo.0.1_32.fq	1083348	1083359		tssK	11
Y.pseudo.0.1_32.fq	1083930	1083931		tssK	1
Y.pseudo.0.1_32.fq	1084884	1085293		tssC	409
Y.pseudo.0.1_32.fq	1118035	1118110		YPO_RS05940	75
Y.pseudo.0.1_32.fq	1123724	1123776		yapH	52
Y.pseudo.0.1_32.fq	1124281	1124303		yapH	22
Y.pseudo.0.1_32.fq	1124696	1124857		yapH	161
Y.pseudo.0.1_32.fq	1126358	1126418		yapH	60
Y.pseudo.0.1_32.fq	1126931	1126932		yapH	1
Y.pseudo.0.1_32.fq	1131049	1131050		YPO_RS05955	1
Y.pseudo.0.1_32.fq	1131353	1131510		YPO_RS05955	157
Y.pseudo.0.1_32.fq	1131626	1131630		YPO_RS05955	4
Y.pseudo.0.1_32.fq	1131766	1131825		YPO_RS05955	59
Y.pseudo.0.1_32.fq	1131927	1132929		YPO_RS05955	1002
Y.pseudo.0.1_32.fq	1133325	1133411		YPO_RS05960	86
Y.pseudo.0.1_32.fq	1133492	1134234		YPO_RS05965	742
Y.pseudo.0.1_32.fq	1134974	1134986		YPO_RS05970	12
Y.pseudo.0.1_32.fq	1135145	1135159		YPO_RS05970	14
Y.pseudo.0.1_32.fq	1135286	1136392		YPO_RS05970	1106
Y.pseudo.0.1_32.fq	1140390	1140391		YPO_RS05985	1
Y.pseudo.0.1_32.fq	1142001	1142134		YPO_RS05985	133
Y.pseudo.0.1_32.fq	1142250	1142251		YPO_RS05985	1
Y.pseudo.0.1_32.fq	1218461	1218462		YPO_RS06330	1
Y.pseudo.0.1_32.fq	1220120	1220121		YPO_RS06340	1
Y.pseudo.0.1_32.fq	1220652	1220661		YPO_RS06340	9
Y.pseudo.0.1_32.fq	1221219	1221221		YPO_RS06340	2
Y.pseudo.0.1_32.fq	1221601	1221603		YPO_RS06340	2
Y.pseudo.0.1_32.fq	1234752	1235063		YPO_RS06425	311
Y.pseudo.0.1_32.fq	1235077	1235391		YPO_RS06430	314
Y.pseudo.0.1_32.fq	1235740	1236828		YPO_RS06435	1088
Y.pseudo.0.1_32.fq	1236825	1237784		YPO_RS06440	959
Y.pseudo.0.1_32.fq	1237777	1238319		YPO_RS06445	542
Y.pseudo.0.1_32.fq	1238319	1238519		YPO_RS06450	200
Y.pseudo.0.1_32.fq	1238512	1239399		YPO_RS06455	887
Y.pseudo.0.1_32.fq	1240207	1240434		YPO_RS06460	227
Y.pseudo.0.1_32.fq	1240596	1242266		YPO_RS06465	1670
Y.pseudo.0.1_32.fq	1242317	1243405		YPO_RS06470	1088
Y.pseudo.0.1_32.fq	1243484	1244522		YPO_RS06475	1038
Y.pseudo.0.1_32.fq	1244668	1244683		YPO_RS06475	15
Y.pseudo.0.1_32.fq	1322763	1322802		YPO_RS06875	39
Y.pseudo.0.1_32.fq	1409708	1410182		YPO_RS07265	474
Y.pseudo.0.1_32.fq	1414135	1414623		YPO_RS07285	488
Y.pseudo.0.1_32.fq	1414636	1415144		YPO_RS07290	508
Y.pseudo.0.1_32.fq	1416275	1416306		YPO_RS07295	31
Y.pseudo.0.1_32.fq	1447066	1447067		YPO_RS07430	1
Y.pseudo.0.1_32.fq	1499883	1499895		potI	12
Y.pseudo.0.1_32.fq	1505432	1505465		YPO_RS07680	33
Y.pseudo.0.1_32.fq	1593536	1593545		YPO_RS08020	9
Y.pseudo.0.1_32.fq	1599189	1599219		ompF	30
Y.pseudo.0.1_32.fq	1599348	1599446		ompF	98
Y.pseudo.0.1_32.fq	1600079	1600085		ompF	6
Y.pseudo.0.1_32.fq	1656669	1656774		tssB	105
Y.pseudo.0.1_32.fq	1656878	1656879		tssB	1
Y.pseudo.0.1_32.fq	1657913	1657921		tssC	8
Y.pseudo.0.1_32.fq	1658412	1658487		tssC	75
Y.pseudo.0.1_32.fq	1658499	1658600		tssK	101
Y.pseudo.0.1_32.fq	1658778	1658779		tssK	1
Y.pseudo.0.1_32.fq	1659013	1659014		tssK	1
Y.pseudo.0.1_32.fq	1659299	1659308		tssK	9
Y.pseudo.0.1_32.fq	1660461	1660462		YPO_RS08325	1
Y.pseudo.0.1_32.fq	1661201	1661205		YPO_RS08330	4
Y.pseudo.0.1_32.fq	1663510	1663597		tssH	87
Y.pseudo.0.1_32.fq	1663751	1663770		tssH	19
Y.pseudo.0.1_32.fq	1663889	1663890		tssH	1
Y.pseudo.0.1_32.fq	1664162	1664163		tssH	1
Y.pseudo.0.1_32.fq	1665230	1665282		tssH	52
Y.pseudo.0.1_32.fq	1665479	1665586		tssH	107
Y.pseudo.0.1_32.fq	1665770	1665795		tssH	25
Y.pseudo.0.1_32.fq	1665798	1665961		YPO_RS08345	163
Y.pseudo.0.1_32.fq	1666851	1666856		YPO_RS08345	5
Y.pseudo.0.1_32.fq	1667600	1667648		YPO_RS08345	48
Y.pseudo.0.1_32.fq	1667845	1667919		YPO_RS08345	74
Y.pseudo.0.1_32.fq	1668237	1668238		YPO_RS08350	1
Y.pseudo.0.1_32.fq	1668387	1668390		YPO_RS08350	3
Y.pseudo.0.1_32.fq	1669633	1670462		YPO_RS08350	829
Y.pseudo.0.1_32.fq	1670459	1671232		YPO_RS08355	773
Y.pseudo.0.1_32.fq	1671563	1671646		YPO_RS08360	83
Y.pseudo.0.1_32.fq	1671386	1671404		YPO_RS08360	18
Y.pseudo.0.1_32.fq	1671662	1673845		YPO_RS08365	2183
Y.pseudo.0.1_32.fq	1674018	1674488		YPO_RS08370	470
Y.pseudo.0.1_32.fq	1678198	1678199		YPO_RS08385	1
Y.pseudo.0.1_32.fq	1682622	1682637		tssA	15
Y.pseudo.0.1_32.fq	1688688	1688787		YPO_RS08425	99
Y.pseudo.0.1_32.fq	1690224	1690340		YPO_RS08430	116
Y.pseudo.0.1_32.fq	1693808	1693922		YPO_RS08440	114
Y.pseudo.0.1_32.fq	1694509	1694522		YPO_RS08445	13
Y.pseudo.0.1_32.fq	1700574	1700639		darC	65
Y.pseudo.0.1_32.fq	1701462	1701471		darB	9
Y.pseudo.0.1_32.fq	1807715	1807725		YPO_RS08910	10
Y.pseudo.0.1_32.fq	1811998	1812001		YPO_RS08940	3
Y.pseudo.0.1_32.fq	1817449	1817453		rluC	4
Y.pseudo.0.1_32.fq	1843149	1843156		YPO_RS09095	7
Y.pseudo.0.1_32.fq	1898862	1900097		YPO_RS09320	1235
Y.pseudo.0.1_32.fq	1900110	1900487		YPO_RS09325	377
Y.pseudo.0.1_32.fq	1900484	1901470		YPO_RS09330	986
Y.pseudo.0.1_32.fq	1901660	1902325		YPO_RS09335	665
Y.pseudo.0.1_32.fq	1904870	1904873		yapJ	3
Y.pseudo.0.1_32.fq	1905015	1905197		yapJ	182
Y.pseudo.0.1_32.fq	1905486	1905512		yapJ	26
Y.pseudo.0.1_32.fq	1905721	1905937		yapJ	216
Y.pseudo.0.1_32.fq	1902800	1904479		yapJ	1679
Y.pseudo.0.1_32.fq	1907296	1907520		YPO_RS09345	224
Y.pseudo.0.1_32.fq	1919589	1919729		YPO_RS09390	140
Y.pseudo.0.1_32.fq	1920173	1920510		YPO_RS09390	337
Y.pseudo.0.1_32.fq	1972834	1972839		YPO_RS09610	5
Y.pseudo.0.1_32.fq	1998539	1998563		YPO_RS09750	24
Y.pseudo.0.1_32.fq	2039888	2039901		YPO_RS09950	13
Y.pseudo.0.1_32.fq	2064772	2065191		YPO_RS10065	419
Y.pseudo.0.1_32.fq	2065236	2065418		YPO_RS10070	182
Y.pseudo.0.1_32.fq	2072194	2072197		fliI	3
Y.pseudo.0.1_32.fq	2115469	2115601		YPO_RS10340	132
Y.pseudo.0.1_32.fq	2237344	2237376		YPO_RS10835	32
Y.pseudo.0.1_32.fq	2257946	2257961		YPO_RS10930	15
Y.pseudo.0.1_32.fq	2279066	2279722		YPO_RS11025	656
Y.pseudo.0.1_32.fq	2279719	2280549		YPO_RS11030	830
Y.pseudo.0.1_32.fq	2280557	2280955		YPO_RS11035	398
Y.pseudo.0.1_32.fq	2303849	2303893		YPO_RS11155	44
Y.pseudo.0.1_32.fq	2316441	2316650		YPO_RS11220	209
Y.pseudo.0.1_32.fq	2317202	2317310		YPO_RS11220	108
Y.pseudo.0.1_32.fq	2317846	2318000		YPO_RS11220	154
Y.pseudo.0.1_32.fq	2319167	2319168		YPO_RS11225	1
Y.pseudo.0.1_32.fq	2321149	2321150		YPO_RS11225	1
Y.pseudo.0.1_32.fq	2322351	2322779		YPO_RS11225	428
Y.pseudo.0.1_32.fq	2363016	2364233		YPO_RS11420	1217
Y.pseudo.0.1_32.fq	2364680	2364682		YPO_RS11425	2
Y.pseudo.0.1_32.fq	2366293	2366553		YPO_RS11435	260
Y.pseudo.0.1_32.fq	2366853	2367602		YPO_RS11440	749
Y.pseudo.0.1_32.fq	2367578	2368024		YPO_RS11445	446
Y.pseudo.0.1_32.fq	2368098	2368703		YPO_RS11450	605
Y.pseudo.0.1_32.fq	2368704	2369093		YPO_RS11455	389
Y.pseudo.0.1_32.fq	2369097	2369315		YPO_RS11460	218
Y.pseudo.0.1_32.fq	2369364	2369927		YPO_RS11465	563
Y.pseudo.0.1_32.fq	2370351	2370560		YPO_RS11470	209
Y.pseudo.0.1_32.fq	2370557	2370832		YPO_RS11475	275
Y.pseudo.0.1_32.fq	2371078	2371275		YPO_RS11480	197
Y.pseudo.0.1_32.fq	2371306	2371818		YPO_RS11485	512
Y.pseudo.0.1_32.fq	2371803	2372261		YPO_RS11490	458
Y.pseudo.0.1_32.fq	2372807	2373520		YPO_RS11495	713
Y.pseudo.0.1_32.fq	2373977	2374612		YPO_RS11500	635
Y.pseudo.0.1_32.fq	2374643	2375092		YPO_RS11505	449
Y.pseudo.0.1_32.fq	2375096	2375657		YPO_RS11510	561
Y.pseudo.0.1_32.fq	2376975	2377915		YPO_RS11520	940
Y.pseudo.0.1_32.fq	2377915	2378643		YPO_RS11525	728
Y.pseudo.0.1_32.fq	2378662	2379303		YPO_RS11530	641
Y.pseudo.0.1_32.fq	2379304	2380416		YPO_RS11535	1112
Y.pseudo.0.1_32.fq	2380538	2381311		YPO_RS11540	773
Y.pseudo.0.1_32.fq	2381325	2382530		YPO_RS11545	1205
Y.pseudo.0.1_32.fq	2382578	2383060		YPO_RS11550	482
Y.pseudo.0.1_32.fq	2383057	2383311		YPO_RS11555	254
Y.pseudo.0.1_32.fq	2383313	2383663		YPO_RS11560	350
Y.pseudo.0.1_32.fq	2383665	2384249		YPO_RS11565	584
Y.pseudo.0.1_32.fq	2384246	2384653		YPO_RS11570	407
Y.pseudo.0.1_32.fq	2384719	2385639		YPO_RS11575	920
Y.pseudo.0.1_32.fq	2385652	2385963		YPO_RS11580	311
Y.pseudo.0.1_32.fq	2386011	2386271		YPO_RS11585	260
Y.pseudo.0.1_32.fq	2386272	2389775		YPO_RS11590	3503
Y.pseudo.0.1_32.fq	2389778	2390119		YPO_RS11595	341
Y.pseudo.0.1_32.fq	2391003	2391755		YPO_RS11605	752
Y.pseudo.0.1_32.fq	2391758	2392468		YPO_RS11610	710
Y.pseudo.0.1_32.fq	2392729	2393361		YPO_RS11615	632
Y.pseudo.0.1_32.fq	2393440	2393871		YPO_RS11620	431
Y.pseudo.0.1_32.fq	2393995	2394162		YPO_RS11625	167
Y.pseudo.0.1_32.fq	2394236	2395243		YPO_RS11630	1007
Y.pseudo.0.1_32.fq	2395342	2395893		YPO_RS11635	551
Y.pseudo.0.1_32.fq	2396036	2396251		YPO_RS11640	215
Y.pseudo.0.1_32.fq	2396307	2396927		YPO_RS11645	620
Y.pseudo.0.1_32.fq	2396969	2397133		YPO_RS11650	164
Y.pseudo.0.1_32.fq	2397102	2397323		YPO_RS11655	221
Y.pseudo.0.1_32.fq	2397499	2400702		YPO_RS11660	3203
Y.pseudo.0.1_32.fq	2400702	2401700		YPO_RS11665	998
Y.pseudo.0.1_32.fq	2401717	2402634		YPO_RS11670	917
Y.pseudo.0.1_32.fq	2402974	2403064		YPO_RS11675	90
Y.pseudo.0.1_32.fq	2402696	2402849		YPO_RS11675	153
Y.pseudo.0.1_32.fq	2403828	2403842		YPO_RS11680	14
Y.pseudo.0.1_32.fq	2441778	2441787		YPO_RS11850	9
Y.pseudo.0.1_32.fq	2442371	2442372		purU	1
Y.pseudo.0.1_32.fq	2470763	2470764		YPO_RS11975	1
Y.pseudo.0.1_32.fq	2479707	2479714		trpCF	7
Y.pseudo.0.1_32.fq	2534099	2534108		YPO_RS12270	9
Y.pseudo.0.1_32.fq	2541334	2541926		YPO_RS12300	592
Y.pseudo.0.1_32.fq	2554373	2554633		YPO_RS12355	260
Y.pseudo.0.1_32.fq	2554658	2555065		YPO_RS12360	407
Y.pseudo.0.1_32.fq	2555162	2555608		YPO_RS12365	446
Y.pseudo.0.1_32.fq	2555780	2556832		YPO_RS12370	1052
Y.pseudo.0.1_32.fq	2556844	2557161		YPO_RS12375	317
Y.pseudo.0.1_32.fq	2557164	2557415		YPO_RS12380	251
Y.pseudo.0.1_32.fq	2557451	2557684		YPO_RS12385	233
Y.pseudo.0.1_32.fq	2557749	2559461		YPO_RS12390	1712
Y.pseudo.0.1_32.fq	2559474	2559761		YPO_RS12395	287
Y.pseudo.0.1_32.fq	2559765	2560790		YPO_RS12400	1025
Y.pseudo.0.1_32.fq	2560790	2562034		YPO_RS12405	1244
Y.pseudo.0.1_32.fq	2562123	2562371		YPO_RS12410	248
Y.pseudo.0.1_32.fq	2562568	2562765		YPO_RS12415	197
Y.pseudo.0.1_32.fq	2563325	2563436		YPO_RS12420	111
Y.pseudo.0.1_32.fq	2694626	2694629		YPO_RS13000	3
Y.pseudo.0.1_32.fq	2746113	2746116		YPO_RS13245	3
Y.pseudo.0.1_32.fq	2762723	2762728		csy2	5
Y.pseudo.0.1_32.fq	2763497	2764029		csy1	532
Y.pseudo.0.1_32.fq	2764256	2764262		csy1	6
Y.pseudo.0.1_32.fq	2775213	2775214		YPO_RS13365	1
Y.pseudo.0.1_32.fq	2785019	2785023		YPO_RS13410	4
Y.pseudo.0.1_32.fq	2785296	2785700		YPO_RS13415	404
Y.pseudo.0.1_32.fq	2786212	2786409		YPO_RS13425	197
Y.pseudo.0.1_32.fq	2787321	2787409		YPO_RS13430	88
Y.pseudo.0.1_32.fq	2787592	2787817		YPO_RS13430	225
Y.pseudo.0.1_32.fq	2788194	2788198		YPO_RS13430	4
Y.pseudo.0.1_32.fq	2786419	2787174		YPO_RS13430	755
Y.pseudo.0.1_32.fq	2791475	2791481		cdiA	6
Y.pseudo.0.1_32.fq	2813712	2814380		YPO_RS13510	668
Y.pseudo.0.1_32.fq	2814576	2815093		YPO_RS13515	517
Y.pseudo.0.1_32.fq	2836947	2836948		menD	1
Y.pseudo.0.1_32.fq	2843236	2843252		YPO_RS13645	16
Y.pseudo.0.1_32.fq	2853940	2854841		YPO_RS13690	901
Y.pseudo.0.1_32.fq	2886364	2886371		YPO_RS13820	7
Y.pseudo.0.1_32.fq	2894374	2894922		YPO_RS13835	548
Y.pseudo.0.1_32.fq	2982999	2983002		YPO_RS14250	3
Y.pseudo.0.1_32.fq	3117978	3117982		YPO_RS14910	4
Y.pseudo.0.1_32.fq	3127788	3127795		YPO_RS14965	7
Y.pseudo.0.1_32.fq	3132250	3132272		YPO_RS14980	22
Y.pseudo.0.1_32.fq	3197560	3197688		YPO_RS15265	128
Y.pseudo.0.1_32.fq	3200953	3200983		YPO_RS15290	30
Y.pseudo.0.1_32.fq	3201121	3201365		YPO_RS15295	244
Y.pseudo.0.1_32.fq	3201779	3201932		YPO_RS15300	153
Y.pseudo.0.1_32.fq	3216382	3216393		rodZ	11
Y.pseudo.0.1_32.fq	3220231	3220294		YPO_RS15385	63
Y.pseudo.0.1_32.fq	3220398	3220399		YPO_RS15385	1
Y.pseudo.0.1_32.fq	3220596	3220633		YPO_RS15385	37
Y.pseudo.0.1_32.fq	3220884	3220924		YPO_RS15385	40
Y.pseudo.0.1_32.fq	3221774	3221775		YPO_RS15385	1
Y.pseudo.0.1_32.fq	3221886	3221911		YPO_RS15385	25
Y.pseudo.0.1_32.fq	3222069	3222240		YPO_RS15385	171
Y.pseudo.0.1_32.fq	3223371	3223810		yapA	439
Y.pseudo.0.1_32.fq	3224020	3224668		yapA	648
Y.pseudo.0.1_32.fq	3224819	3224948		yapA	129
Y.pseudo.0.1_32.fq	3225649	3225713		yapA	64
Y.pseudo.0.1_32.fq	3228855	3229399		YPO_RS15395	544
Y.pseudo.0.1_32.fq	3236873	3236890		hscA	17
Y.pseudo.0.1_32.fq	3259993	3260021		YPO_RS15545	28
Y.pseudo.0.1_32.fq	3282966	3282986		YPO_RS15660	20
Y.pseudo.0.1_32.fq	3283471	3283478		YPO_RS15665	7
Y.pseudo.0.1_32.fq	3283984	3283985		YPO_RS15665	1
Y.pseudo.0.1_32.fq	3285221	3285226		YPO_RS15670	5
Y.pseudo.0.1_32.fq	3289158	3289162		tssH	4
Y.pseudo.0.1_32.fq	3289410	3289411		tssH	1
Y.pseudo.0.1_32.fq	3290514	3290519		tssH	5
Y.pseudo.0.1_32.fq	3297560	3297579		YPO_RS15710	19
Y.pseudo.0.1_32.fq	3300080	3300081		YPO_RS15725	1
Y.pseudo.0.1_32.fq	3308268	3308269		YPO_RS15750	1
Y.pseudo.0.1_32.fq	3314815	3314845		YPO_RS15775	30
Y.pseudo.0.1_32.fq	3320236	3320272		YPO_RS15810	36
Y.pseudo.0.1_32.fq	3346834	3346852		YPO_RS15975	18
Y.pseudo.0.1_32.fq	3353836	3353837		YPO_RS15995	1
Y.pseudo.0.1_32.fq	3384484	3384532		YPO_RS16130	48
Y.pseudo.0.1_32.fq	3413197	3413198		YPO_RS16260	1
Y.pseudo.0.1_32.fq	3465596	3465714		YPO_RS16490	118
Y.pseudo.0.1_32.fq	3466136	3466569		YPO_RS16490	433
Y.pseudo.0.1_32.fq	3516949	3516950		lon	1
Y.pseudo.0.1_32.fq	3574424	3574430		YPO_RS16965	6
Y.pseudo.0.1_32.fq	3575246	3575247		YPO_RS16970	1
Y.pseudo.0.1_32.fq	3615775	3615778		YPO_RS17145	3
Y.pseudo.0.1_32.fq	3623524	3623547		YPO_RS17160	23
Y.pseudo.0.1_32.fq	3649935	3649937		YPO_RS17290	2
Y.pseudo.0.1_32.fq	3682366	3682386		YPO_RS17455	20
Y.pseudo.0.1_32.fq	3682539	3682558		YPO_RS17460	19
Y.pseudo.0.1_32.fq	3696884	3696909		YPO_RS17535	25
Y.pseudo.0.1_32.fq	3773273	3773274		barA	1
Y.pseudo.0.1_32.fq	3787152	3787213		fhuD	61
Y.pseudo.0.1_32.fq	3798431	3798432		pcnB	1
Y.pseudo.0.1_32.fq	3838873	3839959		YPO_RS18145	1086
Y.pseudo.0.1_32.fq	3839952	3841862		YPO_RS18150	1910
Y.pseudo.0.1_32.fq	3842016	3842187		YPO_RS18155	171
Y.pseudo.0.1_32.fq	3842402	3842508		YPO_RS18155	106
Y.pseudo.0.1_32.fq	3843094	3843213		YPO_RS18155	119
Y.pseudo.0.1_32.fq	3943886	3943908		YPO_RS18620	22
Y.pseudo.0.1_32.fq	3998139	3998140		ridA	1
Y.pseudo.0.1_32.fq	4000975	4000977		YPO_RS18935	2
Y.pseudo.0.1_32.fq	4017811	4017864		YPO_RS19000	53
Y.pseudo.0.1_32.fq	4019092	4019095		YPO_RS19000	3
Y.pseudo.0.1_32.fq	4024089	4024503		YPO_RS19015	414
Y.pseudo.0.1_32.fq	4024505	4024990		YPO_RS19020	485
Y.pseudo.0.1_32.fq	4025040	4025065		YPO_RS19025	25
Y.pseudo.0.1_32.fq	4026413	4026414		YPO_RS19045	1
Y.pseudo.0.1_32.fq	4026783	4026896		YPO_RS19045	113
Y.pseudo.0.1_32.fq	4027249	4027251		YPO_RS19045	2
Y.pseudo.0.1_32.fq	4027372	4027373		YPO_RS19045	1
Y.pseudo.0.1_32.fq	4027652	4027775		YPO_RS19045	123
Y.pseudo.0.1_32.fq	4028117	4028150		YPO_RS19045	33
Y.pseudo.0.1_32.fq	4033192	4033587		YPO_RS19055	395
Y.pseudo.0.1_32.fq	4033596	4034390		YPO_RS19060	794
Y.pseudo.0.1_32.fq	4098633	4099396		YPO_RS19365	763
Y.pseudo.0.1_32.fq	4099503	4099504		YPO_RS19365	1
Y.pseudo.0.1_32.fq	4099900	4100079		YPO_RS19365	179
Y.pseudo.0.1_32.fq	4100277	4100312		YPO_RS19365	35
Y.pseudo.0.1_32.fq	4100557	4100607		YPO_RS19365	50
Y.pseudo.0.1_32.fq	4100871	4101058		YPO_RS19365	187
Y.pseudo.0.1_32.fq	4101165	4101184		YPO_RS19365	19
Y.pseudo.0.1_32.fq	4101355	4101491		YPO_RS19365	136
Y.pseudo.0.1_32.fq	4101516	4102368		YPO_RS19370	852
Y.pseudo.0.1_32.fq	4102470	4102559		YPO_RS19370	89
Y.pseudo.0.1_32.fq	4103213	4103262		YPO_RS19370	49
Y.pseudo.0.1_32.fq	4103725	4103804		YPO_RS19370	79
Y.pseudo.0.1_32.fq	4103910	4104039		YPO_RS19370	129
Y.pseudo.0.1_32.fq	4104210	4104347		YPO_RS19370	137
Y.pseudo.0.1_32.fq	4105900	4106135		YPO_RS19390	235
Y.pseudo.0.1_32.fq	4106251	4106384		YPO_RS19390	133
Y.pseudo.0.1_32.fq	4106497	4106798		YPO_RS19390	301
Y.pseudo.0.1_32.fq	4107298	4107381		YPO_RS19390	83
Y.pseudo.0.1_32.fq	4107685	4107782		YPO_RS19390	97
Y.pseudo.0.1_32.fq	4107946	4108040		YPO_RS19390	94
Y.pseudo.0.1_32.fq	4108396	4108421		YPO_RS19390	25
Y.pseudo.0.1_32.fq	4109339	4109597		YPO_RS19390	258
Y.pseudo.0.1_32.fq	4112436	4112442		YPO_RS19395	6
Y.pseudo.0.1_32.fq	4112511	4113474		YPO_RS19400	963
Y.pseudo.0.1_32.fq	4115604	4115973		YPO_RS19405	369
Y.pseudo.0.1_32.fq	4124993	4124994		YPO_RS19450	1
Y.pseudo.0.1_32.fq	4158116	4158141		YPO_RS19595	25
Y.pseudo.0.1_32.fq	4176219	4176220		YPO_RS19645	1
Y.pseudo.0.1_32.fq	4180535	4180537		YPO_RS19665	2
Y.pseudo.0.1_32.fq	4219432	4219434		YPO_RS19855	2
Y.pseudo.0.1_32.fq	4220079	4220088		YPO_RS19855	9
Y.pseudo.0.1_32.fq	4223144	4223145		YPO_RS19870	1
Y.pseudo.0.1_32.fq	4223398	4223400		YPO_RS19875	2
Y.pseudo.0.1_32.fq	4236794	4236802		YPO_RS19940	8
Y.pseudo.0.1_32.fq	4263796	4263806		YPO_RS20065	10
Y.pseudo.0.1_32.fq	4267187	4267189		YPO_RS20080	2
Y.pseudo.0.1_32.fq	4268451	4268982		YPO_RS20090	531
Y.pseudo.0.1_32.fq	4269212	4269217		YPO_RS20090	5
Y.pseudo.0.1_32.fq	4269694	4269702		YPO_RS20095	8
Y.pseudo.0.1_32.fq	4269857	4269877		YPO_RS20095	20
Y.pseudo.0.1_32.fq	4270093	4270103		YPO_RS20095	10
Y.pseudo.0.1_32.fq	4315768	4315778		YPO_RS20315	10
Y.pseudo.0.1_32.fq	4316337	4316374		cyaY	37
Y.pseudo.0.1_32.fq	4351184	4351189		YPO_RS20485	5
Y.pseudo.0.1_32.fq	4359333	4359590		YPO_RS20515	257
Y.pseudo.0.1_32.fq	4359592	4359840		YPO_RS20520	248
Y.pseudo.0.1_32.fq	4367832	4367833		YPO_RS20570	1
Y.pseudo.0.1_32.fq	4385876	4385877		YPO_RS20660	1
Y.pseudo.0.1_32.fq	4389733	4389734		YPO_RS20670	1
Y.pseudo.0.1_32.fq	4389836	4389837		YPO_RS20675	1
Y.pseudo.0.1_32.fq	4391178	4391309		btuB	131
Y.pseudo.0.1_32.fq	4391440	4392659		btuB	1219
Y.pseudo.0.1_32.fq	4405837	4405846		YPO_RS20745	9
Y.pseudo.0.1_32.fq	4433258	4433343		YPO_RS20825	85
Y.pseudo.0.1_32.fq	4434713	4434774		YPO_RS20825	61
Y.pseudo.0.1_32.fq	4434982	4435339		YPO_RS20830	357
Y.pseudo.0.1_32.fq	4435502	4435610		YPO_RS20830	108
Y.pseudo.0.1_32.fq	4435893	4436073		YPO_RS20830	180
Y.pseudo.0.1_32.fq	4436187	4436525		YPO_RS20830	338
Y.pseudo.0.1_32.fq	4436901	4437072		YPO_RS20830	171
Y.pseudo.0.1_32.fq	4437508	4437519		YPO_RS20830	11
Y.pseudo.0.1_32.fq	4437782	4437914		YPO_RS20830	132
Y.pseudo.0.1_32.fq	4438092	4438093		YPO_RS20830	1
Y.pseudo.0.1_32.fq	4438212	4438466		YPO_RS20830	254
Y.pseudo.0.1_32.fq	4439247	4439289		YPO_RS20830	42
Y.pseudo.0.1_32.fq	4440290	4440328		YPO_RS20830	38
Y.pseudo.0.1_32.fq	4440809	4440908		YPO_RS20830	99
Y.pseudo.0.1_32.fq	4441884	4441891		YPO_RS20830	7
Y.pseudo.0.1_32.fq	4442152	4442154		YPO_RS20830	2
Y.pseudo.0.1_32.fq	4439607	4440132		YPO_RS20830	525
Y.pseudo.0.1_32.fq	4445759	4446046		YPO_RS20840	287
Y.pseudo.0.1_32.fq	4446053	4446352		YPO_RS20845	299
Y.pseudo.0.1_32.fq	4446372	4446521		YPO_RS20850	149
Y.pseudo.0.1_32.fq	4446668	4446949		YPO_RS20855	281
Y.pseudo.0.1_32.fq	4472669	4472673		YPO_RS20975	4
Y.pseudo.0.1_32.fq	4472851	4472859		YPO_RS20975	8
Y.pseudo.0.1_32.fq	4472996	4473045		YPO_RS20975	49
Y.pseudo.0.1_32.fq	4477822	4477832		YPO_RS20990	10
Y.pseudo.0.1_32.fq	4481522	4481569		YPO_RS21010	47
Y.pseudo.0.1_32.fq	4483667	4484034		YPO_RS21020	367
Y.pseudo.0.1_32.fq	4484102	4484599		YPO_RS21025	497
Y.pseudo.0.1_32.fq	4484601	4485015		YPO_RS21030	414
Y.pseudo.0.1_32.fq	4485812	4485829		yapE	17
Y.pseudo.0.1_32.fq	4488176	4488197		yapE	21
Y.pseudo.0.1_32.fq	4488487	4488488		yapE	1
Y.pseudo.0.1_32.fq	4491248	4491249		YPO_RS21045	1
Y.pseudo.0.1_32.fq	4492775	4492838		YPO_RS21050	63
Y.pseudo.0.1_32.fq	4533729	4534359		YPO_RS21205	630
Y.pseudo.0.1_32.fq	4534356	4534363		YPO_RS21210	7
Y.pseudo.0.1_32.fq	4542110	4542295		YPO_RS21250	185
Y.pseudo.0.1_32.fq	4542292	4542465		YPO_RS21255	173
Y.pseudo.0.1_32.fq	4543227	4543589		YPO_RS21265	362
Y.pseudo.0.1_32.fq	4544734	4544979		YPO_RS21275	245
Y.pseudo.0.1_32.fq	4545247	4546626		YPO_RS21280	1379
Y.pseudo.0.1_32.fq	4546613	4547615		YPO_RS21285	1002
Y.pseudo.0.1_32.fq	4607704	4607795		YPO_RS21545	91
